,Date,Origin Country Code,State of Entry,Total Arrivals,Male Arrivals,Female Arrivals,Nationality
0,1/1/2020,ABW,Kedah,0,0,0,Aruba
1,1/1/2020,ABW,Pulau Pinang,0,0,0,Aruba
2,1/1/2020,AFG,Johor,2,0,2,Afghanistan
3,1/1/2020,AFG,Kedah,1,1,0,Afghanistan
4,1/1/2020,AFG,Perlis,0,0,0,Afghanistan
5,1/1/2020,AFG,Pulau Pinang,0,0,0,Afghanistan
6,1/1/2020,AFG,Sarawak,0,0,0,Afghanistan
7,1/1/2020,AFG,Selangor,180,161,19,Afghanistan
8,1/1/2020,AGO,Johor,0,0,0,Angola
9,1/1/2020,AGO,Kedah,0,0,0,Angola
10,1/1/2020,AGO,Sabah,0,0,0,Angola
11,1/1/2020,AGO,Selangor,9,6,3,Angola
12,1/1/2020,AIA,Selangor,0,0,0,Anguilla
13,1/1/2020,ALB,Johor,35,17,18,Albania
14,1/1/2020,ALB,Kedah,6,4,2,Albania
15,1/1/2020,ALB,Perak,1,1,0,Albania
16,1/1/2020,ALB,Perlis,1,1,0,Albania
17,1/1/2020,ALB,Pulau Pinang,2,0,2,Albania
18,1/1/2020,ALB,Sabah,1,1,0,Albania
19,1/1/2020,ALB,Sarawak,1,1,0,Albania
20,1/1/2020,ALB,Selangor,62,31,31,Albania
21,1/1/2020,AND,Johor,0,0,0,Andorra
22,1/1/2020,AND,Kedah,0,0,0,Andorra
23,1/1/2020,AND,Perlis,0,0,0,Andorra
24,1/1/2020,AND,Pulau Pinang,0,0,0,Andorra
25,1/1/2020,AND,Selangor,5,3,2,Andorra
26,1/1/2020,ANT,Selangor,0,0,0,Netherlands Antilles
27,1/1/2020,ARE,Johor,22,14,8,United Arab Emirates
28,1/1/2020,ARE,Kedah,4,3,1,United Arab Emirates
29,1/1/2020,ARE,Kelantan,0,0,0,United Arab Emirates
30,1/1/2020,ARE,Perak,0,0,0,United Arab Emirates
31,1/1/2020,ARE,Perlis,0,0,0,United Arab Emirates
32,1/1/2020,ARE,Pulau Pinang,4,3,1,United Arab Emirates
33,1/1/2020,ARE,Sabah,0,0,0,United Arab Emirates
34,1/1/2020,ARE,Sarawak,0,0,0,United Arab Emirates
35,1/1/2020,ARE,Selangor,371,252,119,United Arab Emirates
36,1/1/2020,ARG,Johor,221,133,88,Argentina
37,1/1/2020,ARG,Kedah,304,148,156,Argentina
38,1/1/2020,ARG,Kelantan,5,2,3,Argentina
39,1/1/2020,ARG,Melaka,0,0,0,Argentina
40,1/1/2020,ARG,Perak,0,0,0,Argentina
41,1/1/2020,ARG,Perlis,20,11,9,Argentina
42,1/1/2020,ARG,Pulau Pinang,5,2,3,Argentina
43,1/1/2020,ARG,Sabah,3,1,2,Argentina
44,1/1/2020,ARG,Sarawak,1,1,0,Argentina
45,1/1/2020,ARG,Selangor,908,464,444,Argentina
46,1/1/2020,ARG,W.P. Labuan,0,0,0,Argentina
47,1/1/2020,ARM,Johor,5,2,3,Armenia
48,1/1/2020,ARM,Kedah,3,1,2,Armenia
49,1/1/2020,ARM,Kelantan,1,1,0,Armenia
50,1/1/2020,ARM,Perak,2,0,2,Armenia
51,1/1/2020,ARM,Perlis,0,0,0,Armenia
52,1/1/2020,ARM,Pulau Pinang,1,1,0,Armenia
53,1/1/2020,ARM,Sabah,0,0,0,Armenia
54,1/1/2020,ARM,Sarawak,0,0,0,Armenia
55,1/1/2020,ARM,Selangor,79,22,57,Armenia
56,1/1/2020,ATA,Selangor,0,0,0,Antarctica
57,1/1/2020,ATG,Johor,6,3,3,Antigua and Barbuda
58,1/1/2020,ATG,Kedah,0,0,0,Antigua and Barbuda
59,1/1/2020,ATG,Pulau Pinang,0,0,0,Antigua and Barbuda
60,1/1/2020,ATG,Sarawak,0,0,0,Antigua and Barbuda
61,1/1/2020,ATG,Selangor,22,12,10,Antigua and Barbuda
62,1/1/2020,AUS,Johor,8923,4980,3943,Australia
63,1/1/2020,AUS,Kedah,1138,636,502,Australia
64,1/1/2020,AUS,Kelantan,21,15,6,Australia
65,1/1/2020,AUS,Melaka,10,7,3,Australia
66,1/1/2020,AUS,Negeri Sembilan,0,0,0,Australia
67,1/1/2020,AUS,Pahang,52,23,29,Australia
68,1/1/2020,AUS,Perak,282,156,126,Australia
69,1/1/2020,AUS,Perlis,115,64,51,Australia
70,1/1/2020,AUS,Pulau Pinang,2617,1339,1278,Australia
71,1/1/2020,AUS,Sabah,908,464,444,Australia
72,1/1/2020,AUS,Sarawak,956,535,421,Australia
73,1/1/2020,AUS,Selangor,36952,20700,16252,Australia
74,1/1/2020,AUS,Terengganu,0,0,0,Australia
75,1/1/2020,AUS,W.P. Labuan,24,17,7,Australia
76,1/1/2020,AUT,Johor,242,159,83,Austria
77,1/1/2020,AUT,Kedah,170,97,73,Austria
78,1/1/2020,AUT,Kelantan,8,7,1,Austria
79,1/1/2020,AUT,Melaka,0,0,0,Austria
80,1/1/2020,AUT,Negeri Sembilan,0,0,0,Austria
81,1/1/2020,AUT,Pahang,0,0,0,Austria
82,1/1/2020,AUT,Perak,8,7,1,Austria
83,1/1/2020,AUT,Perlis,28,19,9,Austria
84,1/1/2020,AUT,Pulau Pinang,75,57,18,Austria
85,1/1/2020,AUT,Sabah,26,15,11,Austria
86,1/1/2020,AUT,Sarawak,18,13,5,Austria
87,1/1/2020,AUT,Selangor,904,585,319,Austria
88,1/1/2020,AUT,Terengganu,0,0,0,Austria
89,1/1/2020,AUT,W.P. Labuan,1,1,0,Austria
90,1/1/2020,AZE,Johor,6,5,1,Azerbaijan
91,1/1/2020,AZE,Kedah,9,8,1,Azerbaijan
92,1/1/2020,AZE,Kelantan,0,0,0,Azerbaijan
93,1/1/2020,AZE,Melaka,2,1,1,Azerbaijan
94,1/1/2020,AZE,Perlis,0,0,0,Azerbaijan
95,1/1/2020,AZE,Pulau Pinang,0,0,0,Azerbaijan
96,1/1/2020,AZE,Sabah,3,2,1,Azerbaijan
97,1/1/2020,AZE,Sarawak,3,1,2,Azerbaijan
98,1/1/2020,AZE,Selangor,159,89,70,Azerbaijan
99,1/1/2020,AZE,W.P. Labuan,1,1,0,Azerbaijan
100,1/1/2020,BDI,Pulau Pinang,0,0,0,Burundi
101,1/1/2020,BDI,Sarawak,0,0,0,Burundi
102,1/1/2020,BDI,Selangor,2,2,0,Burundi
103,1/1/2020,BEL,Johor,265,171,94,Belgium
104,1/1/2020,BEL,Kedah,140,80,60,Belgium
105,1/1/2020,BEL,Kelantan,5,3,2,Belgium
106,1/1/2020,BEL,Melaka,0,0,0,Belgium
107,1/1/2020,BEL,Negeri Sembilan,0,0,0,Belgium
108,1/1/2020,BEL,Pahang,0,0,0,Belgium
109,1/1/2020,BEL,Perak,2,0,2,Belgium
110,1/1/2020,BEL,Perlis,14,8,6,Belgium
111,1/1/2020,BEL,Pulau Pinang,76,53,23,Belgium
112,1/1/2020,BEL,Sabah,17,12,5,Belgium
113,1/1/2020,BEL,Sarawak,15,12,3,Belgium
114,1/1/2020,BEL,Selangor,1243,812,431,Belgium
115,1/1/2020,BEL,W.P. Labuan,2,2,0,Belgium
116,1/1/2020,BEN,Johor,0,0,0,Benin
117,1/1/2020,BEN,Kedah,0,0,0,Benin
118,1/1/2020,BEN,Perak,0,0,0,Benin
119,1/1/2020,BEN,Pulau Pinang,0,0,0,Benin
120,1/1/2020,BEN,Sabah,1,1,0,Benin
121,1/1/2020,BEN,Sarawak,0,0,0,Benin
122,1/1/2020,BEN,Selangor,6,5,1,Benin
123,1/1/2020,BFA,Perak,0,0,0,Burkina Faso
124,1/1/2020,BFA,Pulau Pinang,0,0,0,Burkina Faso
125,1/1/2020,BFA,Selangor,5,5,0,Burkina Faso
126,1/1/2020,BGD,Johor,5428,4954,474,Bangladesh
127,1/1/2020,BGD,Kedah,72,35,37,Bangladesh
128,1/1/2020,BGD,Kelantan,1,1,0,Bangladesh
129,1/1/2020,BGD,Melaka,17,17,0,Bangladesh
130,1/1/2020,BGD,Negeri Sembilan,0,0,0,Bangladesh
131,1/1/2020,BGD,Pahang,1,1,0,Bangladesh
132,1/1/2020,BGD,Perak,0,0,0,Bangladesh
133,1/1/2020,BGD,Perlis,0,0,0,Bangladesh
134,1/1/2020,BGD,Pulau Pinang,81,74,7,Bangladesh
135,1/1/2020,BGD,Sabah,14,7,7,Bangladesh
136,1/1/2020,BGD,Sarawak,167,151,16,Bangladesh
137,1/1/2020,BGD,Selangor,21150,17904,3246,Bangladesh
138,1/1/2020,BGD,W.P. Labuan,24,24,0,Bangladesh
139,1/1/2020,BGR,Johor,73,49,24,Bulgaria
140,1/1/2020,BGR,Kedah,68,32,36,Bulgaria
141,1/1/2020,BGR,Kelantan,0,0,0,Bulgaria
142,1/1/2020,BGR,Pahang,0,0,0,Bulgaria
143,1/1/2020,BGR,Perak,0,0,0,Bulgaria
144,1/1/2020,BGR,Perlis,1,1,0,Bulgaria
145,1/1/2020,BGR,Pulau Pinang,2,1,1,Bulgaria
146,1/1/2020,BGR,Sabah,3,2,1,Bulgaria
147,1/1/2020,BGR,Sarawak,1,1,0,Bulgaria
148,1/1/2020,BGR,Selangor,495,252,243,Bulgaria
149,1/1/2020,BGR,W.P. Labuan,2,1,1,Bulgaria
150,1/1/2020,BHR,Johor,7,4,3,Bahrain
151,1/1/2020,BHR,Kedah,5,3,2,Bahrain
152,1/1/2020,BHR,Kelantan,1,1,0,Bahrain
153,1/1/2020,BHR,Perlis,0,0,0,Bahrain
154,1/1/2020,BHR,Pulau Pinang,0,0,0,Bahrain
155,1/1/2020,BHR,Sabah,0,0,0,Bahrain
156,1/1/2020,BHR,Sarawak,4,4,0,Bahrain
157,1/1/2020,BHR,Selangor,454,260,194,Bahrain
158,1/1/2020,BHS,Johor,1,0,1,Bahamas
159,1/1/2020,BHS,Kedah,0,0,0,Bahamas
160,1/1/2020,BHS,Perak,0,0,0,Bahamas
161,1/1/2020,BHS,Sabah,1,1,0,Bahamas
162,1/1/2020,BHS,Sarawak,0,0,0,Bahamas
163,1/1/2020,BHS,Selangor,5,2,3,Bahamas
164,1/1/2020,BIH,Johor,9,4,5,Bosnia and Herzegovina
165,1/1/2020,BIH,Kedah,10,6,4,Bosnia and Herzegovina
166,1/1/2020,BIH,Perlis,0,0,0,Bosnia and Herzegovina
167,1/1/2020,BIH,Pulau Pinang,3,3,0,Bosnia and Herzegovina
168,1/1/2020,BIH,Sabah,0,0,0,Bosnia and Herzegovina
169,1/1/2020,BIH,Sarawak,2,2,0,Bosnia and Herzegovina
170,1/1/2020,BIH,Selangor,85,44,41,Bosnia and Herzegovina
171,1/1/2020,BLR,Johor,19,10,9,Belarus
172,1/1/2020,BLR,Kedah,42,19,23,Belarus
173,1/1/2020,BLR,Kelantan,2,1,1,Belarus
174,1/1/2020,BLR,Pahang,0,0,0,Belarus
175,1/1/2020,BLR,Perak,0,0,0,Belarus
176,1/1/2020,BLR,Perlis,0,0,0,Belarus
177,1/1/2020,BLR,Pulau Pinang,16,8,8,Belarus
178,1/1/2020,BLR,Sabah,10,7,3,Belarus
179,1/1/2020,BLR,Sarawak,3,1,2,Belarus
180,1/1/2020,BLR,Selangor,423,189,234,Belarus
181,1/1/2020,BLR,W.P. Labuan,0,0,0,Belarus
182,1/1/2020,BLZ,Johor,3,1,2,Belize
183,1/1/2020,BLZ,Pulau Pinang,0,0,0,Belize
184,1/1/2020,BLZ,Sarawak,0,0,0,Belize
185,1/1/2020,BLZ,Selangor,7,4,3,Belize
186,1/1/2020,BMU,Selangor,0,0,0,Bermuda
187,1/1/2020,BOL,Johor,6,2,4,Bolivia
188,1/1/2020,BOL,Kedah,0,0,0,Bolivia
189,1/1/2020,BOL,Melaka,0,0,0,Bolivia
190,1/1/2020,BOL,Perak,2,0,2,Bolivia
191,1/1/2020,BOL,Perlis,0,0,0,Bolivia
192,1/1/2020,BOL,Pulau Pinang,0,0,0,Bolivia
193,1/1/2020,BOL,Sabah,0,0,0,Bolivia
194,1/1/2020,BOL,Sarawak,0,0,0,Bolivia
195,1/1/2020,BOL,Selangor,30,15,15,Bolivia
196,1/1/2020,BRA,Johor,293,173,120,Brazil
197,1/1/2020,BRA,Kedah,163,72,91,Brazil
198,1/1/2020,BRA,Kelantan,1,0,1,Brazil
199,1/1/2020,BRA,Melaka,0,0,0,Brazil
200,1/1/2020,BRA,Pahang,0,0,0,Brazil
201,1/1/2020,BRA,Perak,6,4,2,Brazil
202,1/1/2020,BRA,Perlis,10,4,6,Brazil
203,1/1/2020,BRA,Pulau Pinang,18,12,6,Brazil
204,1/1/2020,BRA,Sabah,17,8,9,Brazil
205,1/1/2020,BRA,Sarawak,17,9,8,Brazil
206,1/1/2020,BRA,Selangor,1480,828,652,Brazil
207,1/1/2020,BRA,W.P. Labuan,0,0,0,Brazil
208,1/1/2020,BRB,Johor,1,1,0,Barbados
209,1/1/2020,BRB,Kedah,0,0,0,Barbados
210,1/1/2020,BRB,Perlis,0,0,0,Barbados
211,1/1/2020,BRB,Pulau Pinang,0,0,0,Barbados
212,1/1/2020,BRB,Selangor,10,3,7,Barbados
213,1/1/2020,BRN,Johor,496,231,265,Brunei Darussalam
214,1/1/2020,BRN,Kedah,13,9,4,Brunei Darussalam
215,1/1/2020,BRN,Kelantan,10,6,4,Brunei Darussalam
216,1/1/2020,BRN,Melaka,0,0,0,Brunei Darussalam
217,1/1/2020,BRN,Pahang,0,0,0,Brunei Darussalam
218,1/1/2020,BRN,Perak,3,2,1,Brunei Darussalam
219,1/1/2020,BRN,Perlis,13,9,4,Brunei Darussalam
220,1/1/2020,BRN,Pulau Pinang,10,4,6,Brunei Darussalam
221,1/1/2020,BRN,Sabah,1023,499,524,Brunei Darussalam
222,1/1/2020,BRN,Sarawak,77835,43927,33908,Brunei Darussalam
223,1/1/2020,BRN,Selangor,6217,3079,3138,Brunei Darussalam
224,1/1/2020,BRN,W.P. Labuan,2881,1815,1066,Brunei Darussalam
225,1/1/2020,BTN,Johor,8,6,2,Bhutan
226,1/1/2020,BTN,Kedah,1,1,0,Bhutan
227,1/1/2020,BTN,Perak,0,0,0,Bhutan
228,1/1/2020,BTN,Perlis,0,0,0,Bhutan
229,1/1/2020,BTN,Pulau Pinang,2,0,2,Bhutan
230,1/1/2020,BTN,Sabah,0,0,0,Bhutan
231,1/1/2020,BTN,Sarawak,0,0,0,Bhutan
232,1/1/2020,BTN,Selangor,66,48,18,Bhutan
233,1/1/2020,BWA,Johor,2,2,0,Botswana
234,1/1/2020,BWA,Kedah,0,0,0,Botswana
235,1/1/2020,BWA,Perlis,0,0,0,Botswana
236,1/1/2020,BWA,Pulau Pinang,0,0,0,Botswana
237,1/1/2020,BWA,Sabah,0,0,0,Botswana
238,1/1/2020,BWA,Sarawak,2,2,0,Botswana
239,1/1/2020,BWA,Selangor,25,10,15,Botswana
240,1/1/2020,CAF,Kedah,0,0,0,Central African Republic
241,1/1/2020,CAF,Selangor,0,0,0,Central African Republic
242,1/1/2020,CAN,Johor,2001,1124,877,Canada
243,1/1/2020,CAN,Kedah,320,178,142,Canada
244,1/1/2020,CAN,Kelantan,15,9,6,Canada
245,1/1/2020,CAN,Melaka,2,1,1,Canada
246,1/1/2020,CAN,Negeri Sembilan,0,0,0,Canada
247,1/1/2020,CAN,Pahang,0,0,0,Canada
248,1/1/2020,CAN,Perak,22,15,7,Canada
249,1/1/2020,CAN,Perlis,59,38,21,Canada
250,1/1/2020,CAN,Pulau Pinang,489,262,227,Canada
251,1/1/2020,CAN,Sabah,273,143,130,Canada
252,1/1/2020,CAN,Sarawak,544,303,241,Canada
253,1/1/2020,CAN,Selangor,5740,3274,2466,Canada
254,1/1/2020,CAN,Terengganu,0,0,0,Canada
255,1/1/2020,CAN,W.P. Labuan,13,11,2,Canada
256,1/1/2020,CCK,Selangor,0,0,0,Cocos (Keeling) Islands
257,1/1/2020,CHE,Johor,426,264,162,Switzerland
258,1/1/2020,CHE,Kedah,288,159,129,Switzerland
259,1/1/2020,CHE,Kelantan,11,4,7,Switzerland
260,1/1/2020,CHE,Melaka,2,1,1,Switzerland
261,1/1/2020,CHE,Negeri Sembilan,0,0,0,Switzerland
262,1/1/2020,CHE,Pahang,1,1,0,Switzerland
263,1/1/2020,CHE,Perak,17,10,7,Switzerland
264,1/1/2020,CHE,Perlis,62,44,18,Switzerland
265,1/1/2020,CHE,Pulau Pinang,151,84,67,Switzerland
266,1/1/2020,CHE,Sabah,35,22,13,Switzerland
267,1/1/2020,CHE,Sarawak,33,17,16,Switzerland
268,1/1/2020,CHE,Selangor,1413,893,520,Switzerland
269,1/1/2020,CHE,W.P. Labuan,7,6,1,Switzerland
270,1/1/2020,CHL,Johor,57,26,31,Chile
271,1/1/2020,CHL,Kedah,54,30,24,Chile
272,1/1/2020,CHL,Kelantan,1,1,0,Chile
273,1/1/2020,CHL,Melaka,0,0,0,Chile
274,1/1/2020,CHL,Pahang,0,0,0,Chile
275,1/1/2020,CHL,Perak,0,0,0,Chile
276,1/1/2020,CHL,Perlis,7,3,4,Chile
277,1/1/2020,CHL,Pulau Pinang,19,6,13,Chile
278,1/1/2020,CHL,Sabah,1,0,1,Chile
279,1/1/2020,CHL,Sarawak,1,0,1,Chile
280,1/1/2020,CHL,Selangor,366,190,176,Chile
281,1/1/2020,CHN,Johor,92472,38137,54335,China
282,1/1/2020,CHN,Kedah,5069,2188,2881,China
283,1/1/2020,CHN,Kelantan,26,11,15,China
284,1/1/2020,CHN,Melaka,2,0,2,China
285,1/1/2020,CHN,Pahang,43,21,22,China
286,1/1/2020,CHN,Perak,236,89,147,China
287,1/1/2020,CHN,Perlis,136,72,64,China
288,1/1/2020,CHN,Pulau Pinang,10906,5180,5726,China
289,1/1/2020,CHN,Sabah,12574,5703,6871,China
290,1/1/2020,CHN,Sarawak,1192,446,746,China
291,1/1/2020,CHN,Selangor,163242,75519,87723,China
292,1/1/2020,CHN,Terengganu,0,0,0,China
293,1/1/2020,CHN,W.P. Labuan,60,30,30,China
294,1/1/2020,CIV,Johor,0,0,0,C��te d'Iv
295,1/1/2020,CIV,Kedah,1,1,0,C��te d'Iv
296,1/1/2020,CIV,Pulau Pinang,1,1,0,C��te d'Iv
297,1/1/2020,CIV,Sabah,0,0,0,C��te d'Iv
298,1/1/2020,CIV,Sarawak,0,0,0,C��te d'Iv
299,1/1/2020,CIV,Selangor,36,27,9,C��te d'Iv
300,1/1/2020,CMR,Johor,3,3,0,Cameroon
301,1/1/2020,CMR,Kedah,0,0,0,Cameroon
302,1/1/2020,CMR,Pulau Pinang,0,0,0,Cameroon
303,1/1/2020,CMR,Sabah,0,0,0,Cameroon
304,1/1/2020,CMR,Sarawak,1,1,0,Cameroon
305,1/1/2020,CMR,Selangor,33,23,10,Cameroon
306,1/1/2020,COD,Johor,0,0,0,"Congo, the Democratic Republic of the"
307,1/1/2020,COD,Pulau Pinang,0,0,0,"Congo, the Democratic Republic of the"
308,1/1/2020,COD,Sarawak,0,0,0,"Congo, the Democratic Republic of the"
309,1/1/2020,COD,Selangor,9,4,5,"Congo, the Democratic Republic of the"
310,1/1/2020,COG,Johor,1,1,0,Congo
311,1/1/2020,COG,Kedah,0,0,0,Congo
312,1/1/2020,COG,Selangor,2,2,0,Congo
313,1/1/2020,COK,Selangor,0,0,0,Cook Islands
314,1/1/2020,COL,Johor,28,17,11,Colombia
315,1/1/2020,COL,Kedah,0,0,0,Colombia
316,1/1/2020,COL,Perak,0,0,0,Colombia
317,1/1/2020,COL,Pulau Pinang,2,0,2,Colombia
318,1/1/2020,COL,Sabah,0,0,0,Colombia
319,1/1/2020,COL,Sarawak,0,0,0,Colombia
320,1/1/2020,COL,Selangor,217,114,103,Colombia
321,1/1/2020,COL,W.P. Labuan,0,0,0,Colombia
322,1/1/2020,COM,Johor,0,0,0,Comoros
323,1/1/2020,COM,Kedah,1,0,1,Comoros
324,1/1/2020,COM,Selangor,19,13,6,Comoros
325,1/1/2020,CPV,Johor,1,0,1,Cape Verde
326,1/1/2020,CPV,Kedah,0,0,0,Cape Verde
327,1/1/2020,CPV,Pulau Pinang,0,0,0,Cape Verde
328,1/1/2020,CPV,Sabah,0,0,0,Cape Verde
329,1/1/2020,CPV,Selangor,3,2,1,Cape Verde
330,1/1/2020,CRI,Johor,9,6,3,Costa Rica
331,1/1/2020,CRI,Kedah,1,1,0,Costa Rica
332,1/1/2020,CRI,Perak,1,0,1,Costa Rica
333,1/1/2020,CRI,Perlis,0,0,0,Costa Rica
334,1/1/2020,CRI,Pulau Pinang,2,1,1,Costa Rica
335,1/1/2020,CRI,Sabah,1,0,1,Costa Rica
336,1/1/2020,CRI,Sarawak,0,0,0,Costa Rica
337,1/1/2020,CRI,Selangor,73,44,29,Costa Rica
338,1/1/2020,CUB,Johor,7,7,0,Cuba
339,1/1/2020,CUB,Kedah,0,0,0,Cuba
340,1/1/2020,CUB,Perlis,0,0,0,Cuba
341,1/1/2020,CUB,Pulau Pinang,1,1,0,Cuba
342,1/1/2020,CUB,Sabah,0,0,0,Cuba
343,1/1/2020,CUB,Sarawak,0,0,0,Cuba
344,1/1/2020,CUB,Selangor,40,21,19,Cuba
345,1/1/2020,CYP,Johor,15,9,6,Cyprus
346,1/1/2020,CYP,Kedah,7,3,4,Cyprus
347,1/1/2020,CYP,Perak,0,0,0,Cyprus
348,1/1/2020,CYP,Perlis,0,0,0,Cyprus
349,1/1/2020,CYP,Pulau Pinang,4,2,2,Cyprus
350,1/1/2020,CYP,Sabah,0,0,0,Cyprus
351,1/1/2020,CYP,Sarawak,1,0,1,Cyprus
352,1/1/2020,CYP,Selangor,61,37,24,Cyprus
353,1/1/2020,CZE,Johor,163,99,64,Czech Republic
354,1/1/2020,CZE,Kedah,492,251,241,Czech Republic
355,1/1/2020,CZE,Kelantan,3,2,1,Czech Republic
356,1/1/2020,CZE,Melaka,2,2,0,Czech Republic
357,1/1/2020,CZE,Negeri Sembilan,0,0,0,Czech Republic
358,1/1/2020,CZE,Perak,0,0,0,Czech Republic
359,1/1/2020,CZE,Perlis,18,12,6,Czech Republic
360,1/1/2020,CZE,Pulau Pinang,89,43,46,Czech Republic
361,1/1/2020,CZE,Sabah,30,18,12,Czech Republic
362,1/1/2020,CZE,Sarawak,15,8,7,Czech Republic
363,1/1/2020,CZE,Selangor,966,559,407,Czech Republic
364,1/1/2020,CZE,W.P. Labuan,5,4,1,Czech Republic
365,1/1/2020,DEU,Johor,2320,1507,813,Germany
366,1/1/2020,DEU,Kedah,1336,695,641,Germany
367,1/1/2020,DEU,Kelantan,39,31,8,Germany
368,1/1/2020,DEU,Melaka,3,2,1,Germany
369,1/1/2020,DEU,Negeri Sembilan,1,1,0,Germany
370,1/1/2020,DEU,Pahang,12,7,5,Germany
371,1/1/2020,DEU,Perak,34,25,9,Germany
372,1/1/2020,DEU,Perlis,255,166,89,Germany
373,1/1/2020,DEU,Pulau Pinang,550,378,172,Germany
374,1/1/2020,DEU,Sabah,143,100,43,Germany
375,1/1/2020,DEU,Sarawak,241,156,85,Germany
376,1/1/2020,DEU,Selangor,6725,4268,2457,Germany
377,1/1/2020,DEU,Terengganu,0,0,0,Germany
378,1/1/2020,DEU,W.P. Labuan,14,9,5,Germany
379,1/1/2020,DJI,Johor,0,0,0,Djibouti
380,1/1/2020,DJI,Selangor,9,3,6,Djibouti
381,1/1/2020,DMA,Johor,9,7,2,Dominica
382,1/1/2020,DMA,Kedah,0,0,0,Dominica
383,1/1/2020,DMA,Pulau Pinang,0,0,0,Dominica
384,1/1/2020,DMA,Sabah,6,5,1,Dominica
385,1/1/2020,DMA,Sarawak,1,1,0,Dominica
386,1/1/2020,DMA,Selangor,41,33,8,Dominica
387,1/1/2020,DMA,W.P. Labuan,0,0,0,Dominica
388,1/1/2020,DNK,Johor,349,236,113,Denmark
389,1/1/2020,DNK,Kedah,416,205,211,Denmark
390,1/1/2020,DNK,Kelantan,2,2,0,Denmark
391,1/1/2020,DNK,Melaka,1,1,0,Denmark
392,1/1/2020,DNK,Negeri Sembilan,0,0,0,Denmark
393,1/1/2020,DNK,Pahang,0,0,0,Denmark
394,1/1/2020,DNK,Perak,20,12,8,Denmark
395,1/1/2020,DNK,Perlis,20,12,8,Denmark
396,1/1/2020,DNK,Pulau Pinang,148,89,59,Denmark
397,1/1/2020,DNK,Sabah,44,27,17,Denmark
398,1/1/2020,DNK,Sarawak,16,10,6,Denmark
399,1/1/2020,DNK,Selangor,1755,1049,706,Denmark
400,1/1/2020,DNK,W.P. Labuan,1,1,0,Denmark
401,1/1/2020,DOM,Johor,2,1,1,Dominican Republic
402,1/1/2020,DOM,Kedah,0,0,0,Dominican Republic
403,1/1/2020,DOM,Perak,0,0,0,Dominican Republic
404,1/1/2020,DOM,Perlis,1,1,0,Dominican Republic
405,1/1/2020,DOM,Pulau Pinang,0,0,0,Dominican Republic
406,1/1/2020,DOM,Sabah,1,1,0,Dominican Republic
407,1/1/2020,DOM,Sarawak,0,0,0,Dominican Republic
408,1/1/2020,DOM,Selangor,19,10,9,Dominican Republic
409,1/1/2020,DZA,Johor,27,23,4,Algeria
410,1/1/2020,DZA,Kedah,18,12,6,Algeria
411,1/1/2020,DZA,Kelantan,0,0,0,Algeria
412,1/1/2020,DZA,Melaka,0,0,0,Algeria
413,1/1/2020,DZA,Perak,0,0,0,Algeria
414,1/1/2020,DZA,Perlis,3,1,2,Algeria
415,1/1/2020,DZA,Pulau Pinang,9,6,3,Algeria
416,1/1/2020,DZA,Sabah,1,1,0,Algeria
417,1/1/2020,DZA,Sarawak,6,3,3,Algeria
418,1/1/2020,DZA,Selangor,719,524,195,Algeria
419,1/1/2020,DZA,W.P. Labuan,0,0,0,Algeria
420,1/1/2020,ECU,Johor,26,9,17,Ecuador
421,1/1/2020,ECU,Kedah,2,1,1,Ecuador
422,1/1/2020,ECU,Perak,0,0,0,Ecuador
423,1/1/2020,ECU,Perlis,0,0,0,Ecuador
424,1/1/2020,ECU,Pulau Pinang,0,0,0,Ecuador
425,1/1/2020,ECU,Sabah,0,0,0,Ecuador
426,1/1/2020,ECU,Sarawak,2,0,2,Ecuador
427,1/1/2020,ECU,Selangor,77,38,39,Ecuador
428,1/1/2020,EGY,Johor,244,184,60,Egypt
429,1/1/2020,EGY,Kedah,33,14,19,Egypt
430,1/1/2020,EGY,Kelantan,4,4,0,Egypt
431,1/1/2020,EGY,Melaka,0,0,0,Egypt
432,1/1/2020,EGY,Pahang,0,0,0,Egypt
433,1/1/2020,EGY,Perak,0,0,0,Egypt
434,1/1/2020,EGY,Perlis,0,0,0,Egypt
435,1/1/2020,EGY,Pulau Pinang,9,8,1,Egypt
436,1/1/2020,EGY,Sabah,5,4,1,Egypt
437,1/1/2020,EGY,Sarawak,87,53,34,Egypt
438,1/1/2020,EGY,Selangor,2697,1661,1036,Egypt
439,1/1/2020,EGY,Terengganu,0,0,0,Egypt
440,1/1/2020,EGY,W.P. Labuan,0,0,0,Egypt
441,1/1/2020,ERI,Johor,0,0,0,Eritrea
442,1/1/2020,ERI,Pulau Pinang,0,0,0,Eritrea
443,1/1/2020,ERI,Sabah,0,0,0,Eritrea
444,1/1/2020,ERI,Selangor,31,20,11,Eritrea
445,1/1/2020,ESP,Johor,490,291,199,Spain
446,1/1/2020,ESP,Kedah,358,180,178,Spain
447,1/1/2020,ESP,Kelantan,6,5,1,Spain
448,1/1/2020,ESP,Melaka,2,1,1,Spain
449,1/1/2020,ESP,Negeri Sembilan,0,0,0,Spain
450,1/1/2020,ESP,Pahang,1,1,0,Spain
451,1/1/2020,ESP,Perak,6,4,2,Spain
452,1/1/2020,ESP,Perlis,34,19,15,Spain
453,1/1/2020,ESP,Pulau Pinang,71,43,28,Spain
454,1/1/2020,ESP,Sabah,44,24,20,Spain
455,1/1/2020,ESP,Sarawak,35,19,16,Spain
456,1/1/2020,ESP,Selangor,2140,1298,842,Spain
457,1/1/2020,ESP,W.P. Labuan,8,6,2,Spain
458,1/1/2020,EST,Johor,91,47,44,Estonia
459,1/1/2020,EST,Kedah,107,56,51,Estonia
460,1/1/2020,EST,Kelantan,0,0,0,Estonia
461,1/1/2020,EST,Pahang,0,0,0,Estonia
462,1/1/2020,EST,Perak,3,2,1,Estonia
463,1/1/2020,EST,Perlis,1,1,0,Estonia
464,1/1/2020,EST,Pulau Pinang,6,4,2,Estonia
465,1/1/2020,EST,Sabah,16,10,6,Estonia
466,1/1/2020,EST,Sarawak,4,3,1,Estonia
467,1/1/2020,EST,Selangor,254,135,119,Estonia
468,1/1/2020,EST,W.P. Labuan,0,0,0,Estonia
469,1/1/2020,ETH,Johor,5,4,1,Ethiopia
470,1/1/2020,ETH,Kedah,0,0,0,Ethiopia
471,1/1/2020,ETH,Pulau Pinang,0,0,0,Ethiopia
472,1/1/2020,ETH,Sarawak,2,0,2,Ethiopia
473,1/1/2020,ETH,Selangor,41,25,16,Ethiopia
474,1/1/2020,FIN,Johor,335,208,127,Finland
475,1/1/2020,FIN,Kedah,476,209,267,Finland
476,1/1/2020,FIN,Kelantan,3,1,2,Finland
477,1/1/2020,FIN,Melaka,0,0,0,Finland
478,1/1/2020,FIN,Negeri Sembilan,0,0,0,Finland
479,1/1/2020,FIN,Pahang,0,0,0,Finland
480,1/1/2020,FIN,Perak,3,2,1,Finland
481,1/1/2020,FIN,Perlis,19,11,8,Finland
482,1/1/2020,FIN,Pulau Pinang,129,76,53,Finland
483,1/1/2020,FIN,Sabah,24,15,9,Finland
484,1/1/2020,FIN,Sarawak,16,9,7,Finland
485,1/1/2020,FIN,Selangor,1417,756,661,Finland
486,1/1/2020,FIN,W.P. Labuan,2,1,1,Finland
487,1/1/2020,FJI,Johor,77,37,40,Fiji
488,1/1/2020,FJI,Kedah,4,0,4,Fiji
489,1/1/2020,FJI,Kelantan,0,0,0,Fiji
490,1/1/2020,FJI,Perak,0,0,0,Fiji
491,1/1/2020,FJI,Perlis,4,0,4,Fiji
492,1/1/2020,FJI,Pulau Pinang,1,1,0,Fiji
493,1/1/2020,FJI,Sabah,0,0,0,Fiji
494,1/1/2020,FJI,Sarawak,0,0,0,Fiji
495,1/1/2020,FJI,Selangor,151,84,67,Fiji
496,1/1/2020,FRA,Johor,1957,1214,743,France
497,1/1/2020,FRA,Kedah,1149,671,478,France
498,1/1/2020,FRA,Kelantan,50,38,12,France
499,1/1/2020,FRA,Melaka,2,2,0,France
500,1/1/2020,FRA,Negeri Sembilan,1,1,0,France
501,1/1/2020,FRA,Pahang,12,5,7,France
502,1/1/2020,FRA,Perak,29,20,9,France
503,1/1/2020,FRA,Perlis,142,88,54,France
504,1/1/2020,FRA,Pulau Pinang,508,299,209,France
505,1/1/2020,FRA,Sabah,135,71,64,France
506,1/1/2020,FRA,Sarawak,100,68,32,France
507,1/1/2020,FRA,Selangor,8663,5373,3290,France
508,1/1/2020,FRA,Terengganu,0,0,0,France
509,1/1/2020,FRA,W.P. Labuan,5,3,2,France
510,1/1/2020,FSM,Johor,1,1,0,"Micronesia, Federated States of"
511,1/1/2020,FSM,Pulau Pinang,1,0,1,"Micronesia, Federated States of"
512,1/1/2020,FSM,Selangor,1,1,0,"Micronesia, Federated States of"
513,1/1/2020,GAB,Johor,1,1,0,Gabon
514,1/1/2020,GAB,Pulau Pinang,0,0,0,Gabon
515,1/1/2020,GAB,Sarawak,0,0,0,Gabon
516,1/1/2020,GAB,Selangor,3,1,2,Gabon
517,1/1/2020,GBR,Johor,5448,3473,1975,United Kingdom
518,1/1/2020,GBR,Kedah,2148,1206,942,United Kingdom
519,1/1/2020,GBR,Kelantan,37,31,6,United Kingdom
520,1/1/2020,GBR,Melaka,5,5,0,United Kingdom
521,1/1/2020,GBR,Negeri Sembilan,0,0,0,United Kingdom
522,1/1/2020,GBR,Pahang,18,13,5,United Kingdom
523,1/1/2020,GBR,Perak,75,50,25,United Kingdom
524,1/1/2020,GBR,Perlis,289,186,103,United Kingdom
525,1/1/2020,GBR,Pulau Pinang,1412,841,571,United Kingdom
526,1/1/2020,GBR,Sabah,581,327,254,United Kingdom
527,1/1/2020,GBR,Sarawak,1261,822,439,United Kingdom
528,1/1/2020,GBR,Selangor,20246,12997,7249,United Kingdom
529,1/1/2020,GBR,Terengganu,0,0,0,United Kingdom
530,1/1/2020,GBR,W.P. Labuan,119,74,45,United Kingdom
531,1/1/2020,GEO,Johor,3,2,1,Georgia
532,1/1/2020,GEO,Kedah,4,1,3,Georgia
533,1/1/2020,GEO,Melaka,1,1,0,Georgia
534,1/1/2020,GEO,Perak,0,0,0,Georgia
535,1/1/2020,GEO,Perlis,0,0,0,Georgia
536,1/1/2020,GEO,Pulau Pinang,3,2,1,Georgia
537,1/1/2020,GEO,Sabah,0,0,0,Georgia
538,1/1/2020,GEO,Sarawak,0,0,0,Georgia
539,1/1/2020,GEO,Selangor,46,24,22,Georgia
540,1/1/2020,GHA,Johor,14,11,3,Ghana
541,1/1/2020,GHA,Kedah,0,0,0,Ghana
542,1/1/2020,GHA,Kelantan,1,1,0,Ghana
543,1/1/2020,GHA,Pulau Pinang,1,1,0,Ghana
544,1/1/2020,GHA,Sabah,0,0,0,Ghana
545,1/1/2020,GHA,Sarawak,2,2,0,Ghana
546,1/1/2020,GHA,Selangor,82,50,32,Ghana
547,1/1/2020,GIB,Johor,0,0,0,Gibraltar
548,1/1/2020,GIB,Sarawak,0,0,0,Gibraltar
549,1/1/2020,GIN,Johor,14,14,0,Guinea
550,1/1/2020,GIN,Kedah,0,0,0,Guinea
551,1/1/2020,GIN,Kelantan,1,1,0,Guinea
552,1/1/2020,GIN,Perlis,0,0,0,Guinea
553,1/1/2020,GIN,Pulau Pinang,0,0,0,Guinea
554,1/1/2020,GIN,Sabah,0,0,0,Guinea
555,1/1/2020,GIN,Sarawak,2,1,1,Guinea
556,1/1/2020,GIN,Selangor,81,70,11,Guinea
557,1/1/2020,GLP,Selangor,0,0,0,Guadeloupe
558,1/1/2020,GMB,Johor,11,6,5,Gambia
559,1/1/2020,GMB,Kedah,0,0,0,Gambia
560,1/1/2020,GMB,Kelantan,2,2,0,Gambia
561,1/1/2020,GMB,Pulau Pinang,0,0,0,Gambia
562,1/1/2020,GMB,Sabah,0,0,0,Gambia
563,1/1/2020,GMB,Sarawak,0,0,0,Gambia
564,1/1/2020,GMB,Selangor,67,52,15,Gambia
565,1/1/2020,GNB,Johor,2,2,0,Guinea-Bissau
566,1/1/2020,GNB,Selangor,3,3,0,Guinea-Bissau
567,1/1/2020,GNQ,Johor,0,0,0,Equatorial Guinea
568,1/1/2020,GNQ,Selangor,7,4,3,Equatorial Guinea
569,1/1/2020,GRC,Johor,65,53,12,Greece
570,1/1/2020,GRC,Kedah,41,21,20,Greece
571,1/1/2020,GRC,Kelantan,1,1,0,Greece
572,1/1/2020,GRC,Melaka,4,3,1,Greece
573,1/1/2020,GRC,Negeri Sembilan,0,0,0,Greece
574,1/1/2020,GRC,Pahang,0,0,0,Greece
575,1/1/2020,GRC,Perak,3,1,2,Greece
576,1/1/2020,GRC,Perlis,7,4,3,Greece
577,1/1/2020,GRC,Pulau Pinang,7,6,1,Greece
578,1/1/2020,GRC,Sabah,2,2,0,Greece
579,1/1/2020,GRC,Sarawak,8,4,4,Greece
580,1/1/2020,GRC,Selangor,258,183,75,Greece
581,1/1/2020,GRD,Johor,12,10,2,Grenada
582,1/1/2020,GRD,Kedah,0,0,0,Grenada
583,1/1/2020,GRD,Pulau Pinang,1,1,0,Grenada
584,1/1/2020,GRD,Sabah,0,0,0,Grenada
585,1/1/2020,GRD,Sarawak,0,0,0,Grenada
586,1/1/2020,GRD,Selangor,25,15,10,Grenada
587,1/1/2020,GRL,Johor,0,0,0,Greenland
588,1/1/2020,GRL,Selangor,0,0,0,Greenland
589,1/1/2020,GTM,Johor,0,0,0,Guatemala
590,1/1/2020,GTM,Kedah,0,0,0,Guatemala
591,1/1/2020,GTM,Pahang,1,0,1,Guatemala
592,1/1/2020,GTM,Perak,0,0,0,Guatemala
593,1/1/2020,GTM,Pulau Pinang,0,0,0,Guatemala
594,1/1/2020,GTM,Sabah,0,0,0,Guatemala
595,1/1/2020,GTM,Sarawak,0,0,0,Guatemala
596,1/1/2020,GTM,Selangor,26,15,11,Guatemala
597,1/1/2020,GTM,W.P. Labuan,0,0,0,Guatemala
598,1/1/2020,GUY,Johor,2,2,0,Guyana
599,1/1/2020,GUY,Kedah,0,0,0,Guyana
600,1/1/2020,GUY,Pulau Pinang,0,0,0,Guyana
601,1/1/2020,GUY,Sarawak,0,0,0,Guyana
602,1/1/2020,GUY,Selangor,8,4,4,Guyana
603,1/1/2020,HKG,Johor,0,0,0,Hong Kong
604,1/1/2020,HKG,Kedah,0,0,0,Hong Kong
605,1/1/2020,HKG,Kelantan,0,0,0,Hong Kong
606,1/1/2020,HKG,Pahang,0,0,0,Hong Kong
607,1/1/2020,HKG,Perak,25,13,12,Hong Kong
608,1/1/2020,HKG,Perlis,0,0,0,Hong Kong
609,1/1/2020,HKG,Pulau Pinang,0,0,0,Hong Kong
610,1/1/2020,HKG,Sabah,3,1,2,Hong Kong
611,1/1/2020,HKG,Sarawak,7,5,2,Hong Kong
612,1/1/2020,HKG,Selangor,0,0,0,Hong Kong
613,1/1/2020,HKG,Terengganu,0,0,0,Hong Kong
614,1/1/2020,HMD,Johor,0,0,0,Heard Island and McDonald Islands
615,1/1/2020,HND,Johor,10,4,6,Honduras
616,1/1/2020,HND,Kedah,2,1,1,Honduras
617,1/1/2020,HND,Perak,0,0,0,Honduras
618,1/1/2020,HND,Pulau Pinang,0,0,0,Honduras
619,1/1/2020,HND,Sabah,1,1,0,Honduras
620,1/1/2020,HND,Sarawak,0,0,0,Honduras
621,1/1/2020,HND,Selangor,21,13,8,Honduras
622,1/1/2020,HRV,Johor,72,44,28,Croatia
623,1/1/2020,HRV,Kedah,26,17,9,Croatia
624,1/1/2020,HRV,Kelantan,0,0,0,Croatia
625,1/1/2020,HRV,Melaka,0,0,0,Croatia
626,1/1/2020,HRV,Pahang,1,1,0,Croatia
627,1/1/2020,HRV,Perak,1,0,1,Croatia
628,1/1/2020,HRV,Perlis,1,1,0,Croatia
629,1/1/2020,HRV,Pulau Pinang,8,7,1,Croatia
630,1/1/2020,HRV,Sabah,0,0,0,Croatia
631,1/1/2020,HRV,Sarawak,9,8,1,Croatia
632,1/1/2020,HRV,Selangor,340,207,133,Croatia
633,1/1/2020,HTI,Johor,0,0,0,Haiti
634,1/1/2020,HTI,Kedah,0,0,0,Haiti
635,1/1/2020,HTI,Kelantan,0,0,0,Haiti
636,1/1/2020,HTI,Perak,0,0,0,Haiti
637,1/1/2020,HTI,Pulau Pinang,0,0,0,Haiti
638,1/1/2020,HTI,Sabah,0,0,0,Haiti
639,1/1/2020,HTI,Selangor,5,4,1,Haiti
640,1/1/2020,HUN,Johor,93,56,37,Hungary
641,1/1/2020,HUN,Kedah,281,148,133,Hungary
642,1/1/2020,HUN,Kelantan,1,0,1,Hungary
643,1/1/2020,HUN,Pahang,0,0,0,Hungary
644,1/1/2020,HUN,Perak,0,0,0,Hungary
645,1/1/2020,HUN,Perlis,6,3,3,Hungary
646,1/1/2020,HUN,Pulau Pinang,77,46,31,Hungary
647,1/1/2020,HUN,Sabah,20,12,8,Hungary
648,1/1/2020,HUN,Sarawak,19,14,5,Hungary
649,1/1/2020,HUN,Selangor,1067,555,512,Hungary
650,1/1/2020,HUN,W.P. Labuan,0,0,0,Hungary
651,1/1/2020,IDN,Johor,146428,75004,71424,Indonesia
652,1/1/2020,IDN,Kedah,5574,2183,3391,Indonesia
653,1/1/2020,IDN,Kelantan,195,91,104,Indonesia
654,1/1/2020,IDN,Melaka,5852,2696,3156,Indonesia
655,1/1/2020,IDN,Negeri Sembilan,3379,2169,1210,Indonesia
656,1/1/2020,IDN,Pahang,24,12,12,Indonesia
657,1/1/2020,IDN,Perak,228,78,150,Indonesia
658,1/1/2020,IDN,Perlis,648,307,341,Indonesia
659,1/1/2020,IDN,Pulau Pinang,25021,8736,16285,Indonesia
660,1/1/2020,IDN,Sabah,4962,2523,2439,Indonesia
661,1/1/2020,IDN,Sarawak,43648,25764,17884,Indonesia
662,1/1/2020,IDN,Selangor,137859,65764,72095,Indonesia
663,1/1/2020,IDN,Terengganu,0,0,0,Indonesia
664,1/1/2020,IDN,W.P. Labuan,134,87,47,Indonesia
665,1/1/2020,IND,Johor,25250,18364,6886,India
666,1/1/2020,IND,Kedah,953,553,400,India
667,1/1/2020,IND,Kelantan,22,20,2,India
668,1/1/2020,IND,Melaka,20,16,4,India
669,1/1/2020,IND,Negeri Sembilan,1,1,0,India
670,1/1/2020,IND,Pahang,16,15,1,India
671,1/1/2020,IND,Perak,357,248,109,India
672,1/1/2020,IND,Perlis,30,27,3,India
673,1/1/2020,IND,Pulau Pinang,736,524,212,India
674,1/1/2020,IND,Sabah,102,64,38,India
675,1/1/2020,IND,Sarawak,1989,1666,323,India
676,1/1/2020,IND,Selangor,69072,48859,20213,India
677,1/1/2020,IND,Terengganu,0,0,0,India
678,1/1/2020,IND,W.P. Labuan,118,107,11,India
679,1/1/2020,IOT,Pulau Pinang,0,0,0,British Indian Ocean Territory
680,1/1/2020,IOT,Selangor,0,0,0,British Indian Ocean Territory
681,1/1/2020,IRL,Johor,323,214,109,Ireland
682,1/1/2020,IRL,Kedah,128,74,54,Ireland
683,1/1/2020,IRL,Kelantan,3,3,0,Ireland
684,1/1/2020,IRL,Negeri Sembilan,0,0,0,Ireland
685,1/1/2020,IRL,Pahang,2,2,0,Ireland
686,1/1/2020,IRL,Perak,8,7,1,Ireland
687,1/1/2020,IRL,Perlis,17,9,8,Ireland
688,1/1/2020,IRL,Pulau Pinang,132,89,43,Ireland
689,1/1/2020,IRL,Sabah,36,23,13,Ireland
690,1/1/2020,IRL,Sarawak,35,22,13,Ireland
691,1/1/2020,IRL,Selangor,1463,921,542,Ireland
692,1/1/2020,IRL,Terengganu,0,0,0,Ireland
693,1/1/2020,IRL,W.P. Labuan,4,4,0,Ireland
694,1/1/2020,IRN,Johor,443,245,198,Iran
695,1/1/2020,IRN,Kedah,20,15,5,Iran
696,1/1/2020,IRN,Kelantan,1,1,0,Iran
697,1/1/2020,IRN,Perak,0,0,0,Iran
698,1/1/2020,IRN,Perlis,1,1,0,Iran
699,1/1/2020,IRN,Pulau Pinang,3,2,1,Iran
700,1/1/2020,IRN,Sabah,10,6,4,Iran
701,1/1/2020,IRN,Sarawak,8,7,1,Iran
702,1/1/2020,IRN,Selangor,4149,2272,1877,Iran
703,1/1/2020,IRN,W.P. Labuan,1,1,0,Iran
704,1/1/2020,IRQ,Johor,95,64,31,Iraq
705,1/1/2020,IRQ,Kedah,10,7,3,Iraq
706,1/1/2020,IRQ,Kelantan,0,0,0,Iraq
707,1/1/2020,IRQ,Melaka,0,0,0,Iraq
708,1/1/2020,IRQ,Pahang,0,0,0,Iraq
709,1/1/2020,IRQ,Perak,0,0,0,Iraq
710,1/1/2020,IRQ,Perlis,0,0,0,Iraq
711,1/1/2020,IRQ,Pulau Pinang,9,7,2,Iraq
712,1/1/2020,IRQ,Sabah,2,2,0,Iraq
713,1/1/2020,IRQ,Sarawak,0,0,0,Iraq
714,1/1/2020,IRQ,Selangor,1635,1185,450,Iraq
715,1/1/2020,ISL,Johor,7,4,3,Iceland
716,1/1/2020,ISL,Kedah,6,4,2,Iceland
717,1/1/2020,ISL,Kelantan,0,0,0,Iceland
718,1/1/2020,ISL,Perak,0,0,0,Iceland
719,1/1/2020,ISL,Perlis,4,1,3,Iceland
720,1/1/2020,ISL,Pulau Pinang,1,1,0,Iceland
721,1/1/2020,ISL,Sabah,1,1,0,Iceland
722,1/1/2020,ISL,Sarawak,3,2,1,Iceland
723,1/1/2020,ISL,Selangor,104,57,47,Iceland
724,1/1/2020,ISL,W.P. Labuan,0,0,0,Iceland
725,1/1/2020,ISR,Pulau Pinang,0,0,0,Israel
726,1/1/2020,ITA,Johor,696,498,198,Italy
727,1/1/2020,ITA,Kedah,1186,613,573,Italy
728,1/1/2020,ITA,Kelantan,10,9,1,Italy
729,1/1/2020,ITA,Melaka,1,1,0,Italy
730,1/1/2020,ITA,Negeri Sembilan,2,2,0,Italy
731,1/1/2020,ITA,Pahang,0,0,0,Italy
732,1/1/2020,ITA,Perak,14,12,2,Italy
733,1/1/2020,ITA,Perlis,47,35,12,Italy
734,1/1/2020,ITA,Pulau Pinang,157,98,59,Italy
735,1/1/2020,ITA,Sabah,53,33,20,Italy
736,1/1/2020,ITA,Sarawak,35,23,12,Italy
737,1/1/2020,ITA,Selangor,3411,2241,1170,Italy
738,1/1/2020,ITA,W.P. Labuan,2,0,2,Italy
739,1/1/2020,JAM,Johor,5,0,5,Jamaica
740,1/1/2020,JAM,Kedah,1,0,1,Jamaica
741,1/1/2020,JAM,Perak,0,0,0,Jamaica
742,1/1/2020,JAM,Pulau Pinang,0,0,0,Jamaica
743,1/1/2020,JAM,Sabah,0,0,0,Jamaica
744,1/1/2020,JAM,Sarawak,0,0,0,Jamaica
745,1/1/2020,JAM,Selangor,40,11,29,Jamaica
746,1/1/2020,JAM,W.P. Labuan,0,0,0,Jamaica
747,1/1/2020,JOR,Johor,74,28,46,Jordan
748,1/1/2020,JOR,Kedah,33,17,16,Jordan
749,1/1/2020,JOR,Kelantan,1,1,0,Jordan
750,1/1/2020,JOR,Melaka,0,0,0,Jordan
751,1/1/2020,JOR,Perlis,1,1,0,Jordan
752,1/1/2020,JOR,Pulau Pinang,24,7,17,Jordan
753,1/1/2020,JOR,Sabah,9,8,1,Jordan
754,1/1/2020,JOR,Sarawak,2,2,0,Jordan
755,1/1/2020,JOR,Selangor,1227,751,476,Jordan
756,1/1/2020,JOR,W.P. Labuan,0,0,0,Jordan
757,1/1/2020,JPN,Johor,9179,5771,3408,Japan
758,1/1/2020,JPN,Kedah,892,477,415,Japan
759,1/1/2020,JPN,Kelantan,18,17,1,Japan
760,1/1/2020,JPN,Melaka,2,2,0,Japan
761,1/1/2020,JPN,Negeri Sembilan,0,0,0,Japan
762,1/1/2020,JPN,Pahang,17,12,5,Japan
763,1/1/2020,JPN,Perak,74,51,23,Japan
764,1/1/2020,JPN,Perlis,123,86,37,Japan
765,1/1/2020,JPN,Pulau Pinang,1891,1286,605,Japan
766,1/1/2020,JPN,Sabah,899,424,475,Japan
767,1/1/2020,JPN,Sarawak,317,225,92,Japan
768,1/1/2020,JPN,Selangor,30603,18965,11638,Japan
769,1/1/2020,JPN,W.P. Labuan,14,10,4,Japan
770,1/1/2020,KAZ,Johor,69,28,41,Kazakhstan
771,1/1/2020,KAZ,Kedah,475,213,262,Kazakhstan
772,1/1/2020,KAZ,Kelantan,3,0,3,Kazakhstan
773,1/1/2020,KAZ,Melaka,0,0,0,Kazakhstan
774,1/1/2020,KAZ,Perak,0,0,0,Kazakhstan
775,1/1/2020,KAZ,Perlis,9,4,5,Kazakhstan
776,1/1/2020,KAZ,Pulau Pinang,12,5,7,Kazakhstan
777,1/1/2020,KAZ,Sabah,2,2,0,Kazakhstan
778,1/1/2020,KAZ,Sarawak,10,5,5,Kazakhstan
779,1/1/2020,KAZ,Selangor,3602,1509,2093,Kazakhstan
780,1/1/2020,KAZ,W.P. Labuan,1,0,1,Kazakhstan
781,1/1/2020,KEN,Johor,139,62,77,Kenya
782,1/1/2020,KEN,Kedah,2,2,0,Kenya
783,1/1/2020,KEN,Kelantan,0,0,0,Kenya
784,1/1/2020,KEN,Perak,0,0,0,Kenya
785,1/1/2020,KEN,Perlis,2,1,1,Kenya
786,1/1/2020,KEN,Pulau Pinang,4,2,2,Kenya
787,1/1/2020,KEN,Sabah,0,0,0,Kenya
788,1/1/2020,KEN,Sarawak,2,2,0,Kenya
789,1/1/2020,KEN,Selangor,386,209,177,Kenya
790,1/1/2020,KGZ,Johor,25,16,9,Kyrgyzstan
791,1/1/2020,KGZ,Kedah,37,17,20,Kyrgyzstan
792,1/1/2020,KGZ,Kelantan,0,0,0,Kyrgyzstan
793,1/1/2020,KGZ,Perak,0,0,0,Kyrgyzstan
794,1/1/2020,KGZ,Perlis,3,0,3,Kyrgyzstan
795,1/1/2020,KGZ,Pulau Pinang,3,1,2,Kyrgyzstan
796,1/1/2020,KGZ,Sabah,2,1,1,Kyrgyzstan
797,1/1/2020,KGZ,Sarawak,0,0,0,Kyrgyzstan
798,1/1/2020,KGZ,Selangor,717,334,383,Kyrgyzstan
799,1/1/2020,KHM,Johor,2942,1236,1706,Cambodia
800,1/1/2020,KHM,Kedah,209,121,88,Cambodia
801,1/1/2020,KHM,Kelantan,1111,831,280,Cambodia
802,1/1/2020,KHM,Melaka,0,0,0,Cambodia
803,1/1/2020,KHM,Negeri Sembilan,0,0,0,Cambodia
804,1/1/2020,KHM,Pahang,0,0,0,Cambodia
805,1/1/2020,KHM,Perak,24,18,6,Cambodia
806,1/1/2020,KHM,Perlis,801,629,172,Cambodia
807,1/1/2020,KHM,Pulau Pinang,4,0,4,Cambodia
808,1/1/2020,KHM,Sabah,2,1,1,Cambodia
809,1/1/2020,KHM,Sarawak,29,15,14,Cambodia
810,1/1/2020,KHM,Selangor,4784,2186,2598,Cambodia
811,1/1/2020,KHM,W.P. Labuan,0,0,0,Cambodia
812,1/1/2020,KIR,Johor,4,4,0,Kiribati
813,1/1/2020,KIR,Sabah,0,0,0,Kiribati
814,1/1/2020,KIR,Selangor,1,1,0,Kiribati
815,1/1/2020,KNA,Johor,10,7,3,Saint Kitts and Nevis
816,1/1/2020,KNA,Kedah,0,0,0,Saint Kitts and Nevis
817,1/1/2020,KNA,Perlis,0,0,0,Saint Kitts and Nevis
818,1/1/2020,KNA,Pulau Pinang,4,2,2,Saint Kitts and Nevis
819,1/1/2020,KNA,Sabah,1,1,0,Saint Kitts and Nevis
820,1/1/2020,KNA,Selangor,48,34,14,Saint Kitts and Nevis
821,1/1/2020,KNA,W.P. Labuan,0,0,0,Saint Kitts and Nevis
822,1/1/2020,KOR,Johor,29631,13776,15855,"Korea, Republic of (South Korea)"
823,1/1/2020,KOR,Kedah,548,266,282,"Korea, Republic of (South Korea)"
824,1/1/2020,KOR,Kelantan,7,5,2,"Korea, Republic of (South Korea)"
825,1/1/2020,KOR,Melaka,1,1,0,"Korea, Republic of (South Korea)"
826,1/1/2020,KOR,Negeri Sembilan,7,4,3,"Korea, Republic of (South Korea)"
827,1/1/2020,KOR,Pahang,19,9,10,"Korea, Republic of (South Korea)"
828,1/1/2020,KOR,Perak,17,8,9,"Korea, Republic of (South Korea)"
829,1/1/2020,KOR,Perlis,111,80,31,"Korea, Republic of (South Korea)"
830,1/1/2020,KOR,Pulau Pinang,765,379,386,"Korea, Republic of (South Korea)"
831,1/1/2020,KOR,Sabah,33316,14024,19292,"Korea, Republic of (South Korea)"
832,1/1/2020,KOR,Sarawak,425,258,167,"Korea, Republic of (South Korea)"
833,1/1/2020,KOR,Selangor,33486,16434,17052,"Korea, Republic of (South Korea)"
834,1/1/2020,KOR,Terengganu,0,0,0,"Korea, Republic of (South Korea)"
835,1/1/2020,KOR,W.P. Labuan,24,16,8,"Korea, Republic of (South Korea)"
836,1/1/2020,KWT,Johor,174,71,103,Kuwait
837,1/1/2020,KWT,Kedah,6,3,3,Kuwait
838,1/1/2020,KWT,Kelantan,0,0,0,Kuwait
839,1/1/2020,KWT,Perak,0,0,0,Kuwait
840,1/1/2020,KWT,Perlis,0,0,0,Kuwait
841,1/1/2020,KWT,Pulau Pinang,9,2,7,Kuwait
842,1/1/2020,KWT,Sabah,0,0,0,Kuwait
843,1/1/2020,KWT,Sarawak,0,0,0,Kuwait
844,1/1/2020,KWT,Selangor,1032,540,492,Kuwait
845,1/1/2020,KWT,W.P. Labuan,0,0,0,Kuwait
846,1/1/2020,LAO,Johor,228,72,156,Lao People's Democratic Republic
847,1/1/2020,LAO,Kedah,1165,87,1078,Lao People's Democratic Republic
848,1/1/2020,LAO,Kelantan,209,78,131,Lao People's Democratic Republic
849,1/1/2020,LAO,Melaka,0,0,0,Lao People's Democratic Republic
850,1/1/2020,LAO,Perak,16,0,16,Lao People's Democratic Republic
851,1/1/2020,LAO,Perlis,533,134,399,Lao People's Democratic Republic
852,1/1/2020,LAO,Pulau Pinang,10,2,8,Lao People's Democratic Republic
853,1/1/2020,LAO,Sabah,1,0,1,Lao People's Democratic Republic
854,1/1/2020,LAO,Sarawak,0,0,0,Lao People's Democratic Republic
855,1/1/2020,LAO,Selangor,462,159,303,Lao People's Democratic Republic
856,1/1/2020,LAO,W.P. Labuan,0,0,0,Lao People's Democratic Republic
857,1/1/2020,LBN,Johor,20,13,7,Lebanon
858,1/1/2020,LBN,Kedah,2,2,0,Lebanon
859,1/1/2020,LBN,Kelantan,0,0,0,Lebanon
860,1/1/2020,LBN,Pahang,0,0,0,Lebanon
861,1/1/2020,LBN,Perak,0,0,0,Lebanon
862,1/1/2020,LBN,Perlis,0,0,0,Lebanon
863,1/1/2020,LBN,Pulau Pinang,4,1,3,Lebanon
864,1/1/2020,LBN,Sabah,0,0,0,Lebanon
865,1/1/2020,LBN,Sarawak,1,1,0,Lebanon
866,1/1/2020,LBN,Selangor,258,160,98,Lebanon
867,1/1/2020,LBN,W.P. Labuan,0,0,0,Lebanon
868,1/1/2020,LBR,Johor,5,5,0,Liberia
869,1/1/2020,LBR,Kedah,0,0,0,Liberia
870,1/1/2020,LBR,Sabah,0,0,0,Liberia
871,1/1/2020,LBR,Sarawak,0,0,0,Liberia
872,1/1/2020,LBR,Selangor,10,8,2,Liberia
873,1/1/2020,LBY,Johor,22,14,8,Libyan Arab Jamahiriya
874,1/1/2020,LBY,Kedah,2,2,0,Libyan Arab Jamahiriya
875,1/1/2020,LBY,Perlis,0,0,0,Libyan Arab Jamahiriya
876,1/1/2020,LBY,Pulau Pinang,7,3,4,Libyan Arab Jamahiriya
877,1/1/2020,LBY,Sabah,1,1,0,Libyan Arab Jamahiriya
878,1/1/2020,LBY,Sarawak,1,0,1,Libyan Arab Jamahiriya
879,1/1/2020,LBY,Selangor,867,637,230,Libyan Arab Jamahiriya
880,1/1/2020,LCA,Johor,4,2,2,Saint Lucia
881,1/1/2020,LCA,Kedah,0,0,0,Saint Lucia
882,1/1/2020,LCA,Pulau Pinang,0,0,0,Saint Lucia
883,1/1/2020,LCA,Sarawak,0,0,0,Saint Lucia
884,1/1/2020,LCA,Selangor,14,12,2,Saint Lucia
885,1/1/2020,LIE,Johor,4,4,0,Liechtenstein
886,1/1/2020,LIE,Kedah,2,2,0,Liechtenstein
887,1/1/2020,LIE,Perlis,0,0,0,Liechtenstein
888,1/1/2020,LIE,Pulau Pinang,1,1,0,Liechtenstein
889,1/1/2020,LIE,Sabah,0,0,0,Liechtenstein
890,1/1/2020,LIE,Sarawak,0,0,0,Liechtenstein
891,1/1/2020,LIE,Selangor,7,4,3,Liechtenstein
892,1/1/2020,LKA,Johor,1199,841,358,Sri Lanka
893,1/1/2020,LKA,Kedah,17,11,6,Sri Lanka
894,1/1/2020,LKA,Kelantan,0,0,0,Sri Lanka
895,1/1/2020,LKA,Melaka,0,0,0,Sri Lanka
896,1/1/2020,LKA,Pahang,1,1,0,Sri Lanka
897,1/1/2020,LKA,Perak,4,3,1,Sri Lanka
898,1/1/2020,LKA,Perlis,0,0,0,Sri Lanka
899,1/1/2020,LKA,Pulau Pinang,50,33,17,Sri Lanka
900,1/1/2020,LKA,Sabah,0,0,0,Sri Lanka
901,1/1/2020,LKA,Sarawak,20,16,4,Sri Lanka
902,1/1/2020,LKA,Selangor,3454,2153,1301,Sri Lanka
903,1/1/2020,LKA,W.P. Labuan,1,0,1,Sri Lanka
904,1/1/2020,LSO,Johor,0,0,0,Lesotho
905,1/1/2020,LSO,Kedah,0,0,0,Lesotho
906,1/1/2020,LSO,Pulau Pinang,0,0,0,Lesotho
907,1/1/2020,LSO,Sarawak,0,0,0,Lesotho
908,1/1/2020,LSO,Selangor,6,4,2,Lesotho
909,1/1/2020,LTU,Johor,91,41,50,Lithuania
910,1/1/2020,LTU,Kedah,48,25,23,Lithuania
911,1/1/2020,LTU,Kelantan,2,1,1,Lithuania
912,1/1/2020,LTU,Pahang,0,0,0,Lithuania
913,1/1/2020,LTU,Perak,0,0,0,Lithuania
914,1/1/2020,LTU,Perlis,12,9,3,Lithuania
915,1/1/2020,LTU,Pulau Pinang,3,0,3,Lithuania
916,1/1/2020,LTU,Sabah,9,6,3,Lithuania
917,1/1/2020,LTU,Sarawak,10,5,5,Lithuania
918,1/1/2020,LTU,Selangor,344,175,169,Lithuania
919,1/1/2020,LTU,W.P. Labuan,0,0,0,Lithuania
920,1/1/2020,LUX,Johor,11,8,3,Luxembourg
921,1/1/2020,LUX,Kedah,2,1,1,Luxembourg
922,1/1/2020,LUX,Kelantan,0,0,0,Luxembourg
923,1/1/2020,LUX,Perak,0,0,0,Luxembourg
924,1/1/2020,LUX,Perlis,1,1,0,Luxembourg
925,1/1/2020,LUX,Pulau Pinang,2,1,1,Luxembourg
926,1/1/2020,LUX,Sabah,0,0,0,Luxembourg
927,1/1/2020,LUX,Sarawak,0,0,0,Luxembourg
928,1/1/2020,LUX,Selangor,38,23,15,Luxembourg
929,1/1/2020,LVA,Johor,61,27,34,Latvia
930,1/1/2020,LVA,Kedah,44,21,23,Latvia
931,1/1/2020,LVA,Kelantan,0,0,0,Latvia
932,1/1/2020,LVA,Pahang,0,0,0,Latvia
933,1/1/2020,LVA,Perak,0,0,0,Latvia
934,1/1/2020,LVA,Perlis,3,3,0,Latvia
935,1/1/2020,LVA,Pulau Pinang,6,4,2,Latvia
936,1/1/2020,LVA,Sabah,68,29,39,Latvia
937,1/1/2020,LVA,Sarawak,1,1,0,Latvia
938,1/1/2020,LVA,Selangor,254,119,135,Latvia
939,1/1/2020,LVA,W.P. Labuan,0,0,0,Latvia
940,1/1/2020,MAC,Johor,0,0,0,Macao
941,1/1/2020,MAC,Pahang,0,0,0,Macao
942,1/1/2020,MAC,Perak,0,0,0,Macao
943,1/1/2020,MAC,Selangor,0,0,0,Macao
944,1/1/2020,MAC,W.P. Labuan,0,0,0,Macao
945,1/1/2020,MAR,Johor,59,49,10,Morocco
946,1/1/2020,MAR,Kedah,17,14,3,Morocco
947,1/1/2020,MAR,Kelantan,1,1,0,Morocco
948,1/1/2020,MAR,Melaka,0,0,0,Morocco
949,1/1/2020,MAR,Pahang,0,0,0,Morocco
950,1/1/2020,MAR,Perak,0,0,0,Morocco
951,1/1/2020,MAR,Perlis,0,0,0,Morocco
952,1/1/2020,MAR,Pulau Pinang,6,2,4,Morocco
953,1/1/2020,MAR,Sabah,5,2,3,Morocco
954,1/1/2020,MAR,Sarawak,7,5,2,Morocco
955,1/1/2020,MAR,Selangor,858,438,420,Morocco
956,1/1/2020,MAR,W.P. Labuan,0,0,0,Morocco
957,1/1/2020,MCO,Johor,1,0,1,Monaco
958,1/1/2020,MCO,Kedah,0,0,0,Monaco
959,1/1/2020,MCO,Sabah,0,0,0,Monaco
960,1/1/2020,MCO,Selangor,2,1,1,Monaco
961,1/1/2020,MDA,Johor,3,2,1,"Moldova, Republic of"
962,1/1/2020,MDA,Kedah,11,6,5,"Moldova, Republic of"
963,1/1/2020,MDA,Kelantan,2,1,1,"Moldova, Republic of"
964,1/1/2020,MDA,Negeri Sembilan,0,0,0,"Moldova, Republic of"
965,1/1/2020,MDA,Perlis,0,0,0,"Moldova, Republic of"
966,1/1/2020,MDA,Pulau Pinang,2,0,2,"Moldova, Republic of"
967,1/1/2020,MDA,Sabah,9,5,4,"Moldova, Republic of"
968,1/1/2020,MDA,Sarawak,0,0,0,"Moldova, Republic of"
969,1/1/2020,MDA,Selangor,32,10,22,"Moldova, Republic of"
970,1/1/2020,MDG,Johor,18,9,9,Madagascar
971,1/1/2020,MDG,Kedah,3,1,2,Madagascar
972,1/1/2020,MDG,Perak,0,0,0,Madagascar
973,1/1/2020,MDG,Perlis,0,0,0,Madagascar
974,1/1/2020,MDG,Pulau Pinang,0,0,0,Madagascar
975,1/1/2020,MDG,Sabah,0,0,0,Madagascar
976,1/1/2020,MDG,Sarawak,0,0,0,Madagascar
977,1/1/2020,MDG,Selangor,55,32,23,Madagascar
978,1/1/2020,MDV,Johor,295,144,151,Maldives
979,1/1/2020,MDV,Kedah,1,1,0,Maldives
980,1/1/2020,MDV,Kelantan,0,0,0,Maldives
981,1/1/2020,MDV,Perak,0,0,0,Maldives
982,1/1/2020,MDV,Perlis,2,1,1,Maldives
983,1/1/2020,MDV,Pulau Pinang,2,1,1,Maldives
984,1/1/2020,MDV,Sabah,0,0,0,Maldives
985,1/1/2020,MDV,Sarawak,0,0,0,Maldives
986,1/1/2020,MDV,Selangor,2241,1185,1056,Maldives
987,1/1/2020,MEX,Johor,151,78,73,Mexico
988,1/1/2020,MEX,Kedah,11,3,8,Mexico
989,1/1/2020,MEX,Kelantan,0,0,0,Mexico
990,1/1/2020,MEX,Pahang,0,0,0,Mexico
991,1/1/2020,MEX,Perak,2,1,1,Mexico
992,1/1/2020,MEX,Perlis,1,1,0,Mexico
993,1/1/2020,MEX,Pulau Pinang,27,17,10,Mexico
994,1/1/2020,MEX,Sabah,3,2,1,Mexico
995,1/1/2020,MEX,Sarawak,8,6,2,Mexico
996,1/1/2020,MEX,Selangor,554,313,241,Mexico
997,1/1/2020,MEX,W.P. Labuan,0,0,0,Mexico
998,1/1/2020,MHL,Johor,0,0,0,Marshall Islands
999,1/1/2020,MHL,Kedah,0,0,0,Marshall Islands
1000,1/1/2020,MHL,Perak,0,0,0,Marshall Islands
1001,1/1/2020,MHL,Pulau Pinang,0,0,0,Marshall Islands
1002,1/1/2020,MHL,Sabah,0,0,0,Marshall Islands
1003,1/1/2020,MHL,Selangor,1,1,0,Marshall Islands
1004,1/1/2020,MKD,Johor,10,5,5,"Macedonia, the former Yugoslav Republic of"
1005,1/1/2020,MKD,Kedah,2,2,0,"Macedonia, the former Yugoslav Republic of"
1006,1/1/2020,MKD,Perak,0,0,0,"Macedonia, the former Yugoslav Republic of"
1007,1/1/2020,MKD,Pulau Pinang,0,0,0,"Macedonia, the former Yugoslav Republic of"
1008,1/1/2020,MKD,Sabah,2,1,1,"Macedonia, the former Yugoslav Republic of"
1009,1/1/2020,MKD,Sarawak,1,1,0,"Macedonia, the former Yugoslav Republic of"
1010,1/1/2020,MKD,Selangor,22,16,6,"Macedonia, the former Yugoslav Republic of"
1011,1/1/2020,MLI,Johor,0,0,0,Mali
1012,1/1/2020,MLI,Sabah,0,0,0,Mali
1013,1/1/2020,MLI,Selangor,11,8,3,Mali
1014,1/1/2020,MLT,Johor,9,7,2,Malta
1015,1/1/2020,MLT,Kedah,3,3,0,Malta
1016,1/1/2020,MLT,Kelantan,0,0,0,Malta
1017,1/1/2020,MLT,Perak,2,0,2,Malta
1018,1/1/2020,MLT,Perlis,0,0,0,Malta
1019,1/1/2020,MLT,Pulau Pinang,0,0,0,Malta
1020,1/1/2020,MLT,Sabah,1,1,0,Malta
1021,1/1/2020,MLT,Sarawak,0,0,0,Malta
1022,1/1/2020,MLT,Selangor,47,31,16,Malta
1023,1/1/2020,MLT,W.P. Labuan,2,1,1,Malta
1024,1/1/2020,MMR,Johor,5305,1824,3481,Myanmar
1025,1/1/2020,MMR,Kedah,12,6,6,Myanmar
1026,1/1/2020,MMR,Kelantan,3,1,2,Myanmar
1027,1/1/2020,MMR,Negeri Sembilan,0,0,0,Myanmar
1028,1/1/2020,MMR,Pahang,2,1,1,Myanmar
1029,1/1/2020,MMR,Perak,14,3,11,Myanmar
1030,1/1/2020,MMR,Perlis,5,0,5,Myanmar
1031,1/1/2020,MMR,Pulau Pinang,310,168,142,Myanmar
1032,1/1/2020,MMR,Sabah,8,0,8,Myanmar
1033,1/1/2020,MMR,Sarawak,121,63,58,Myanmar
1034,1/1/2020,MMR,Selangor,10964,8342,2622,Myanmar
1035,1/1/2020,MMR,Terengganu,0,0,0,Myanmar
1036,1/1/2020,MMR,W.P. Labuan,0,0,0,Myanmar
1037,1/1/2020,MNE,Johor,1,1,0,Montenegro
1038,1/1/2020,MNE,Kedah,0,0,0,Montenegro
1039,1/1/2020,MNE,Pulau Pinang,1,1,0,Montenegro
1040,1/1/2020,MNE,Sabah,0,0,0,Montenegro
1041,1/1/2020,MNE,Sarawak,0,0,0,Montenegro
1042,1/1/2020,MNE,Selangor,22,17,5,Montenegro
1043,1/1/2020,MNG,Johor,273,118,155,Mongolia
1044,1/1/2020,MNG,Kedah,14,2,12,Mongolia
1045,1/1/2020,MNG,Kelantan,0,0,0,Mongolia
1046,1/1/2020,MNG,Perak,0,0,0,Mongolia
1047,1/1/2020,MNG,Perlis,1,0,1,Mongolia
1048,1/1/2020,MNG,Pulau Pinang,9,7,2,Mongolia
1049,1/1/2020,MNG,Sabah,10,5,5,Mongolia
1050,1/1/2020,MNG,Sarawak,5,5,0,Mongolia
1051,1/1/2020,MNG,Selangor,607,249,358,Mongolia
1052,1/1/2020,MNP,Selangor,2,2,0,Northern Mariana Islands
1053,1/1/2020,MOZ,Johor,0,0,0,Mozambique
1054,1/1/2020,MOZ,Kedah,0,0,0,Mozambique
1055,1/1/2020,MOZ,Perak,1,1,0,Mozambique
1056,1/1/2020,MOZ,Pulau Pinang,0,0,0,Mozambique
1057,1/1/2020,MOZ,Sabah,1,1,0,Mozambique
1058,1/1/2020,MOZ,Sarawak,0,0,0,Mozambique
1059,1/1/2020,MOZ,Selangor,86,51,35,Mozambique
1060,1/1/2020,MRT,Johor,1,1,0,Mauritania
1061,1/1/2020,MRT,Kedah,1,1,0,Mauritania
1062,1/1/2020,MRT,Pulau Pinang,0,0,0,Mauritania
1063,1/1/2020,MRT,Sabah,0,0,0,Mauritania
1064,1/1/2020,MRT,Sarawak,0,0,0,Mauritania
1065,1/1/2020,MRT,Selangor,34,22,12,Mauritania
1066,1/1/2020,MUS,Johor,305,158,147,Mauritius
1067,1/1/2020,MUS,Kedah,2,1,1,Mauritius
1068,1/1/2020,MUS,Kelantan,0,0,0,Mauritius
1069,1/1/2020,MUS,Pahang,0,0,0,Mauritius
1070,1/1/2020,MUS,Perak,0,0,0,Mauritius
1071,1/1/2020,MUS,Perlis,1,0,1,Mauritius
1072,1/1/2020,MUS,Pulau Pinang,3,1,2,Mauritius
1073,1/1/2020,MUS,Sabah,4,3,1,Mauritius
1074,1/1/2020,MUS,Sarawak,0,0,0,Mauritius
1075,1/1/2020,MUS,Selangor,1261,623,638,Mauritius
1076,1/1/2020,MWI,Johor,0,0,0,Malawi
1077,1/1/2020,MWI,Pulau Pinang,0,0,0,Malawi
1078,1/1/2020,MWI,Sabah,0,0,0,Malawi
1079,1/1/2020,MWI,Sarawak,0,0,0,Malawi
1080,1/1/2020,MWI,Selangor,37,15,22,Malawi
1081,1/1/2020,MYT,Selangor,1,0,1,Mayotte
1082,1/1/2020,NAM,Johor,2,1,1,Namibia
1083,1/1/2020,NAM,Kedah,1,0,1,Namibia
1084,1/1/2020,NAM,Perak,0,0,0,Namibia
1085,1/1/2020,NAM,Perlis,0,0,0,Namibia
1086,1/1/2020,NAM,Pulau Pinang,0,0,0,Namibia
1087,1/1/2020,NAM,Sabah,0,0,0,Namibia
1088,1/1/2020,NAM,Sarawak,0,0,0,Namibia
1089,1/1/2020,NAM,Selangor,25,7,18,Namibia
1090,1/1/2020,NCL,Selangor,0,0,0,New Caledonia
1091,1/1/2020,NER,Johor,0,0,0,Niger
1092,1/1/2020,NER,Sabah,0,0,0,Niger
1093,1/1/2020,NER,Selangor,7,6,1,Niger
1094,1/1/2020,NGA,Johor,31,23,8,Nigeria
1095,1/1/2020,NGA,Kedah,2,2,0,Nigeria
1096,1/1/2020,NGA,Perlis,1,1,0,Nigeria
1097,1/1/2020,NGA,Pulau Pinang,9,7,2,Nigeria
1098,1/1/2020,NGA,Sabah,0,0,0,Nigeria
1099,1/1/2020,NGA,Sarawak,5,3,2,Nigeria
1100,1/1/2020,NGA,Selangor,790,625,165,Nigeria
1101,1/1/2020,NIC,Johor,5,3,2,Nicaragua
1102,1/1/2020,NIC,Kedah,0,0,0,Nicaragua
1103,1/1/2020,NIC,Pulau Pinang,1,1,0,Nicaragua
1104,1/1/2020,NIC,Sabah,0,0,0,Nicaragua
1105,1/1/2020,NIC,Selangor,6,1,5,Nicaragua
1106,1/1/2020,NLD,Johor,1035,663,372,Netherlands
1107,1/1/2020,NLD,Kedah,559,284,275,Netherlands
1108,1/1/2020,NLD,Kelantan,7,6,1,Netherlands
1109,1/1/2020,NLD,Melaka,1,1,0,Netherlands
1110,1/1/2020,NLD,Negeri Sembilan,0,0,0,Netherlands
1111,1/1/2020,NLD,Pahang,1,1,0,Netherlands
1112,1/1/2020,NLD,Perak,24,14,10,Netherlands
1113,1/1/2020,NLD,Perlis,74,46,28,Netherlands
1114,1/1/2020,NLD,Pulau Pinang,280,177,103,Netherlands
1115,1/1/2020,NLD,Sabah,71,41,30,Netherlands
1116,1/1/2020,NLD,Sarawak,228,154,74,Netherlands
1117,1/1/2020,NLD,Selangor,4862,3023,1839,Netherlands
1118,1/1/2020,NLD,Terengganu,0,0,0,Netherlands
1119,1/1/2020,NLD,W.P. Labuan,9,7,2,Netherlands
1120,1/1/2020,NOR,Johor,244,150,94,Norway
1121,1/1/2020,NOR,Kedah,232,122,110,Norway
1122,1/1/2020,NOR,Kelantan,0,0,0,Norway
1123,1/1/2020,NOR,Melaka,0,0,0,Norway
1124,1/1/2020,NOR,Pahang,4,2,2,Norway
1125,1/1/2020,NOR,Perak,2,2,0,Norway
1126,1/1/2020,NOR,Perlis,12,9,3,Norway
1127,1/1/2020,NOR,Pulau Pinang,63,39,24,Norway
1128,1/1/2020,NOR,Sabah,14,11,3,Norway
1129,1/1/2020,NOR,Sarawak,32,22,10,Norway
1130,1/1/2020,NOR,Selangor,1148,679,469,Norway
1131,1/1/2020,NOR,W.P. Labuan,2,2,0,Norway
1132,1/1/2020,NPL,Johor,1993,1713,280,Nepal
1133,1/1/2020,NPL,Kedah,20,16,4,Nepal
1134,1/1/2020,NPL,Pahang,0,0,0,Nepal
1135,1/1/2020,NPL,Perak,0,0,0,Nepal
1136,1/1/2020,NPL,Perlis,1,1,0,Nepal
1137,1/1/2020,NPL,Pulau Pinang,75,72,3,Nepal
1138,1/1/2020,NPL,Sabah,1,1,0,Nepal
1139,1/1/2020,NPL,Sarawak,211,152,59,Nepal
1140,1/1/2020,NPL,Selangor,11790,11056,734,Nepal
1141,1/1/2020,NPL,W.P. Labuan,126,105,21,Nepal
1142,1/1/2020,NRU,Johor,0,0,0,Nauru
1143,1/1/2020,NRU,Pulau Pinang,0,0,0,Nauru
1144,1/1/2020,NRU,Selangor,1,1,0,Nauru
1145,1/1/2020,NZL,Johor,1294,731,563,New Zealand
1146,1/1/2020,NZL,Kedah,173,102,71,New Zealand
1147,1/1/2020,NZL,Kelantan,7,4,3,New Zealand
1148,1/1/2020,NZL,Melaka,5,2,3,New Zealand
1149,1/1/2020,NZL,Negeri Sembilan,0,0,0,New Zealand
1150,1/1/2020,NZL,Pahang,2,2,0,New Zealand
1151,1/1/2020,NZL,Perak,32,21,11,New Zealand
1152,1/1/2020,NZL,Perlis,38,26,12,New Zealand
1153,1/1/2020,NZL,Pulau Pinang,286,160,126,New Zealand
1154,1/1/2020,NZL,Sabah,103,60,43,New Zealand
1155,1/1/2020,NZL,Sarawak,235,128,107,New Zealand
1156,1/1/2020,NZL,Selangor,4014,2286,1728,New Zealand
1157,1/1/2020,NZL,Terengganu,0,0,0,New Zealand
1158,1/1/2020,NZL,W.P. Labuan,5,4,1,New Zealand
1159,1/1/2020,OMN,Johor,71,47,24,Oman
1160,1/1/2020,OMN,Kedah,15,9,6,Oman
1161,1/1/2020,OMN,Kelantan,0,0,0,Oman
1162,1/1/2020,OMN,Melaka,0,0,0,Oman
1163,1/1/2020,OMN,Perak,0,0,0,Oman
1164,1/1/2020,OMN,Perlis,4,4,0,Oman
1165,1/1/2020,OMN,Pulau Pinang,17,8,9,Oman
1166,1/1/2020,OMN,Sabah,0,0,0,Oman
1167,1/1/2020,OMN,Sarawak,19,9,10,Oman
1168,1/1/2020,OMN,Selangor,2213,1245,968,Oman
1169,1/1/2020,PAK,Johor,984,729,255,Pakistan
1170,1/1/2020,PAK,Kedah,150,100,50,Pakistan
1171,1/1/2020,PAK,Kelantan,11,11,0,Pakistan
1172,1/1/2020,PAK,Melaka,0,0,0,Pakistan
1173,1/1/2020,PAK,Negeri Sembilan,0,0,0,Pakistan
1174,1/1/2020,PAK,Pahang,0,0,0,Pakistan
1175,1/1/2020,PAK,Perak,8,7,1,Pakistan
1176,1/1/2020,PAK,Perlis,13,13,0,Pakistan
1177,1/1/2020,PAK,Pulau Pinang,61,48,13,Pakistan
1178,1/1/2020,PAK,Sabah,17,12,5,Pakistan
1179,1/1/2020,PAK,Sarawak,360,326,34,Pakistan
1180,1/1/2020,PAK,Selangor,12658,10329,2329,Pakistan
1181,1/1/2020,PAK,W.P. Labuan,12,12,0,Pakistan
1182,1/1/2020,PAN,Johor,13,9,4,Panama
1183,1/1/2020,PAN,Kedah,1,0,1,Panama
1184,1/1/2020,PAN,Perak,0,0,0,Panama
1185,1/1/2020,PAN,Perlis,0,0,0,Panama
1186,1/1/2020,PAN,Pulau Pinang,2,2,0,Panama
1187,1/1/2020,PAN,Sabah,3,2,1,Panama
1188,1/1/2020,PAN,Sarawak,0,0,0,Panama
1189,1/1/2020,PAN,Selangor,53,25,28,Panama
1190,1/1/2020,PER,Johor,44,21,23,Peru
1191,1/1/2020,PER,Kedah,15,6,9,Peru
1192,1/1/2020,PER,Kelantan,1,1,0,Peru
1193,1/1/2020,PER,Pahang,0,0,0,Peru
1194,1/1/2020,PER,Perak,0,0,0,Peru
1195,1/1/2020,PER,Perlis,1,0,1,Peru
1196,1/1/2020,PER,Pulau Pinang,1,0,1,Peru
1197,1/1/2020,PER,Sabah,1,0,1,Peru
1198,1/1/2020,PER,Sarawak,0,0,0,Peru
1199,1/1/2020,PER,Selangor,159,85,74,Peru
1200,1/1/2020,PER,W.P. Labuan,0,0,0,Peru
1201,1/1/2020,PHL,Johor,21386,6642,14744,Philippines
1202,1/1/2020,PHL,Kedah,1217,415,802,Philippines
1203,1/1/2020,PHL,Kelantan,50,19,31,Philippines
1204,1/1/2020,PHL,Melaka,0,0,0,Philippines
1205,1/1/2020,PHL,Negeri Sembilan,1,0,1,Philippines
1206,1/1/2020,PHL,Pahang,9,5,4,Philippines
1207,1/1/2020,PHL,Perak,77,24,53,Philippines
1208,1/1/2020,PHL,Perlis,169,59,110,Philippines
1209,1/1/2020,PHL,Pulau Pinang,430,180,250,Philippines
1210,1/1/2020,PHL,Sabah,2502,1221,1281,Philippines
1211,1/1/2020,PHL,Sarawak,3771,1536,2235,Philippines
1212,1/1/2020,PHL,Selangor,16643,6462,10181,Philippines
1213,1/1/2020,PHL,Terengganu,0,0,0,Philippines
1214,1/1/2020,PHL,W.P. Labuan,195,83,112,Philippines
1215,1/1/2020,PLW,Johor,0,0,0,Palau
1216,1/1/2020,PLW,Pulau Pinang,0,0,0,Palau
1217,1/1/2020,PLW,Selangor,0,0,0,Palau
1218,1/1/2020,PNG,Johor,21,15,6,Papua New Guinea
1219,1/1/2020,PNG,Kedah,0,0,0,Papua New Guinea
1220,1/1/2020,PNG,Kelantan,1,0,1,Papua New Guinea
1221,1/1/2020,PNG,Perak,0,0,0,Papua New Guinea
1222,1/1/2020,PNG,Pulau Pinang,1,0,1,Papua New Guinea
1223,1/1/2020,PNG,Sabah,1,1,0,Papua New Guinea
1224,1/1/2020,PNG,Sarawak,3,1,2,Papua New Guinea
1225,1/1/2020,PNG,Selangor,82,43,39,Papua New Guinea
1226,1/1/2020,POL,Johor,828,397,431,Poland
1227,1/1/2020,POL,Kedah,554,274,280,Poland
1228,1/1/2020,POL,Kelantan,5,1,4,Poland
1229,1/1/2020,POL,Melaka,1,1,0,Poland
1230,1/1/2020,POL,Negeri Sembilan,1,1,0,Poland
1231,1/1/2020,POL,Pahang,0,0,0,Poland
1232,1/1/2020,POL,Perak,3,1,2,Poland
1233,1/1/2020,POL,Perlis,75,40,35,Poland
1234,1/1/2020,POL,Pulau Pinang,108,59,49,Poland
1235,1/1/2020,POL,Sabah,65,25,40,Poland
1236,1/1/2020,POL,Sarawak,41,17,24,Poland
1237,1/1/2020,POL,Selangor,2079,1071,1008,Poland
1238,1/1/2020,POL,Terengganu,0,0,0,Poland
1239,1/1/2020,POL,W.P. Labuan,3,2,1,Poland
1240,1/1/2020,PRK,Selangor,3,3,0,"Korea, Democratic People's Republic of"
1241,1/1/2020,PRT,Johor,199,104,95,Portugal
1242,1/1/2020,PRT,Kedah,155,72,83,Portugal
1243,1/1/2020,PRT,Kelantan,1,1,0,Portugal
1244,1/1/2020,PRT,Melaka,0,0,0,Portugal
1245,1/1/2020,PRT,Pahang,0,0,0,Portugal
1246,1/1/2020,PRT,Perak,3,2,1,Portugal
1247,1/1/2020,PRT,Perlis,14,7,7,Portugal
1248,1/1/2020,PRT,Pulau Pinang,20,11,9,Portugal
1249,1/1/2020,PRT,Sabah,27,12,15,Portugal
1250,1/1/2020,PRT,Sarawak,11,6,5,Portugal
1251,1/1/2020,PRT,Selangor,646,356,290,Portugal
1252,1/1/2020,PRT,W.P. Labuan,1,1,0,Portugal
1253,1/1/2020,PRY,Johor,4,2,2,Paraguay
1254,1/1/2020,PRY,Kedah,0,0,0,Paraguay
1255,1/1/2020,PRY,Perak,0,0,0,Paraguay
1256,1/1/2020,PRY,Perlis,0,0,0,Paraguay
1257,1/1/2020,PRY,Pulau Pinang,0,0,0,Paraguay
1258,1/1/2020,PRY,Sabah,0,0,0,Paraguay
1259,1/1/2020,PRY,Sarawak,0,0,0,Paraguay
1260,1/1/2020,PRY,Selangor,6,1,5,Paraguay
1261,1/1/2020,PSE,Johor,4,1,3,"Palestinian Territory, Occupied"
1262,1/1/2020,PSE,Kedah,17,10,7,"Palestinian Territory, Occupied"
1263,1/1/2020,PSE,Kelantan,0,0,0,"Palestinian Territory, Occupied"
1264,1/1/2020,PSE,Melaka,0,0,0,"Palestinian Territory, Occupied"
1265,1/1/2020,PSE,Perak,0,0,0,"Palestinian Territory, Occupied"
1266,1/1/2020,PSE,Perlis,0,0,0,"Palestinian Territory, Occupied"
1267,1/1/2020,PSE,Pulau Pinang,5,3,2,"Palestinian Territory, Occupied"
1268,1/1/2020,PSE,Sabah,2,2,0,"Palestinian Territory, Occupied"
1269,1/1/2020,PSE,Sarawak,1,1,0,"Palestinian Territory, Occupied"
1270,1/1/2020,PSE,Selangor,518,377,141,"Palestinian Territory, Occupied"
1271,1/1/2020,QAT,Johor,5,3,2,Qatar
1272,1/1/2020,QAT,Kedah,9,4,5,Qatar
1273,1/1/2020,QAT,Perlis,0,0,0,Qatar
1274,1/1/2020,QAT,Pulau Pinang,2,1,1,Qatar
1275,1/1/2020,QAT,Sabah,0,0,0,Qatar
1276,1/1/2020,QAT,Sarawak,1,1,0,Qatar
1277,1/1/2020,QAT,Selangor,122,88,34,Qatar
1278,1/1/2020,REU,Johor,0,0,0,Reunion
1279,1/1/2020,REU,Sarawak,0,0,0,Reunion
1280,1/1/2020,ROU,Johor,204,115,89,Romania
1281,1/1/2020,ROU,Kedah,275,128,147,Romania
1282,1/1/2020,ROU,Kelantan,2,2,0,Romania
1283,1/1/2020,ROU,Negeri Sembilan,2,2,0,Romania
1284,1/1/2020,ROU,Pahang,0,0,0,Romania
1285,1/1/2020,ROU,Perak,2,2,0,Romania
1286,1/1/2020,ROU,Perlis,3,0,3,Romania
1287,1/1/2020,ROU,Pulau Pinang,33,21,12,Romania
1288,1/1/2020,ROU,Sabah,11,5,6,Romania
1289,1/1/2020,ROU,Sarawak,10,4,6,Romania
1290,1/1/2020,ROU,Selangor,1053,533,520,Romania
1291,1/1/2020,ROU,W.P. Labuan,2,1,1,Romania
1292,1/1/2020,RUS,Johor,538,307,231,Russia
1293,1/1/2020,RUS,Kedah,1788,849,939,Russia
1294,1/1/2020,RUS,Kelantan,93,45,48,Russia
1295,1/1/2020,RUS,Melaka,4,4,0,Russia
1296,1/1/2020,RUS,Negeri Sembilan,0,0,0,Russia
1297,1/1/2020,RUS,Pahang,6,4,2,Russia
1298,1/1/2020,RUS,Perak,6,4,2,Russia
1299,1/1/2020,RUS,Perlis,284,151,133,Russia
1300,1/1/2020,RUS,Pulau Pinang,151,83,68,Russia
1301,1/1/2020,RUS,Sabah,213,86,127,Russia
1302,1/1/2020,RUS,Sarawak,64,38,26,Russia
1303,1/1/2020,RUS,Selangor,11045,5134,5911,Russia
1304,1/1/2020,RUS,W.P. Labuan,9,5,4,Russia
1305,1/1/2020,RWA,Johor,0,0,0,Rwanda
1306,1/1/2020,RWA,Kedah,0,0,0,Rwanda
1307,1/1/2020,RWA,Pulau Pinang,0,0,0,Rwanda
1308,1/1/2020,RWA,Selangor,13,5,8,Rwanda
1309,1/1/2020,SAU,Johor,316,151,165,Saudi Arabia
1310,1/1/2020,SAU,Kedah,72,32,40,Saudi Arabia
1311,1/1/2020,SAU,Kelantan,5,2,3,Saudi Arabia
1312,1/1/2020,SAU,Melaka,0,0,0,Saudi Arabia
1313,1/1/2020,SAU,Perak,2,1,1,Saudi Arabia
1314,1/1/2020,SAU,Perlis,1,1,0,Saudi Arabia
1315,1/1/2020,SAU,Pulau Pinang,52,26,26,Saudi Arabia
1316,1/1/2020,SAU,Sabah,2,2,0,Saudi Arabia
1317,1/1/2020,SAU,Sarawak,10,9,1,Saudi Arabia
1318,1/1/2020,SAU,Selangor,19141,9733,9408,Saudi Arabia
1319,1/1/2020,SAU,W.P. Labuan,0,0,0,Saudi Arabia
1320,1/1/2020,SDN,Johor,6,6,0,Sudan
1321,1/1/2020,SDN,Kedah,1,1,0,Sudan
1322,1/1/2020,SDN,Kelantan,0,0,0,Sudan
1323,1/1/2020,SDN,Perlis,2,1,1,Sudan
1324,1/1/2020,SDN,Pulau Pinang,2,1,1,Sudan
1325,1/1/2020,SDN,Sabah,1,1,0,Sudan
1326,1/1/2020,SDN,Sarawak,4,4,0,Sudan
1327,1/1/2020,SDN,Selangor,1503,877,626,Sudan
1328,1/1/2020,SDN,W.P. Labuan,0,0,0,Sudan
1329,1/1/2020,SEN,Johor,11,7,4,Senegal
1330,1/1/2020,SEN,Kedah,1,1,0,Senegal
1331,1/1/2020,SEN,Kelantan,0,0,0,Senegal
1332,1/1/2020,SEN,Perak,0,0,0,Senegal
1333,1/1/2020,SEN,Perlis,0,0,0,Senegal
1334,1/1/2020,SEN,Pulau Pinang,0,0,0,Senegal
1335,1/1/2020,SEN,Sabah,0,0,0,Senegal
1336,1/1/2020,SEN,Sarawak,0,0,0,Senegal
1337,1/1/2020,SEN,Selangor,59,46,13,Senegal
1338,1/1/2020,SGP,Johor,1209142,702096,507046,Singapore
1339,1/1/2020,SGP,Kedah,2162,1276,886,Singapore
1340,1/1/2020,SGP,Kelantan,373,182,191,Singapore
1341,1/1/2020,SGP,Melaka,38,28,10,Singapore
1342,1/1/2020,SGP,Negeri Sembilan,0,0,0,Singapore
1343,1/1/2020,SGP,Pahang,471,239,232,Singapore
1344,1/1/2020,SGP,Perak,4672,2349,2323,Singapore
1345,1/1/2020,SGP,Perlis,260,157,103,Singapore
1346,1/1/2020,SGP,Pulau Pinang,9240,4852,4388,Singapore
1347,1/1/2020,SGP,Sabah,1800,950,850,Singapore
1348,1/1/2020,SGP,Sarawak,3672,2056,1616,Singapore
1349,1/1/2020,SGP,Selangor,33173,19025,14148,Singapore
1350,1/1/2020,SGP,Terengganu,0,0,0,Singapore
1351,1/1/2020,SGP,W.P. Labuan,31,27,4,Singapore
1352,1/1/2020,SGS,Johor,0,0,0,South Georgia and the South Sandwich Islands
1353,1/1/2020,SGS,Sabah,0,0,0,South Georgia and the South Sandwich Islands
1354,1/1/2020,SGS,Selangor,0,0,0,South Georgia and the South Sandwich Islands
1355,1/1/2020,SHN,Sarawak,0,0,0,"Saint Helena, Ascension and Tristan da Cunha"
1356,1/1/2020,SLB,Johor,5,5,0,Solomon Islands
1357,1/1/2020,SLB,Perlis,0,0,0,Solomon Islands
1358,1/1/2020,SLB,Pulau Pinang,0,0,0,Solomon Islands
1359,1/1/2020,SLB,Sabah,0,0,0,Solomon Islands
1360,1/1/2020,SLB,Sarawak,18,6,12,Solomon Islands
1361,1/1/2020,SLB,Selangor,12,4,8,Solomon Islands
1362,1/1/2020,SLB,W.P. Labuan,0,0,0,Solomon Islands
1363,1/1/2020,SLE,Johor,2,1,1,Sierra Leone
1364,1/1/2020,SLE,Kedah,0,0,0,Sierra Leone
1365,1/1/2020,SLE,Perak,0,0,0,Sierra Leone
1366,1/1/2020,SLE,Pulau Pinang,0,0,0,Sierra Leone
1367,1/1/2020,SLE,Sabah,0,0,0,Sierra Leone
1368,1/1/2020,SLE,Selangor,52,33,19,Sierra Leone
1369,1/1/2020,SLV,Johor,1,0,1,El Salvador
1370,1/1/2020,SLV,Kedah,1,0,1,El Salvador
1371,1/1/2020,SLV,Perak,0,0,0,El Salvador
1372,1/1/2020,SLV,Perlis,0,0,0,El Salvador
1373,1/1/2020,SLV,Pulau Pinang,1,0,1,El Salvador
1374,1/1/2020,SLV,Sabah,2,1,1,El Salvador
1375,1/1/2020,SLV,Selangor,19,8,11,El Salvador
1376,1/1/2020,SLV,W.P. Labuan,0,0,0,El Salvador
1377,1/1/2020,SMR,Johor,0,0,0,San Marino
1378,1/1/2020,SMR,Selangor,3,2,1,San Marino
1379,1/1/2020,SOM,Johor,6,6,0,Somalia
1380,1/1/2020,SOM,Kedah,2,2,0,Somalia
1381,1/1/2020,SOM,Kelantan,0,0,0,Somalia
1382,1/1/2020,SOM,Perlis,1,0,1,Somalia
1383,1/1/2020,SOM,Sabah,0,0,0,Somalia
1384,1/1/2020,SOM,Sarawak,0,0,0,Somalia
1385,1/1/2020,SOM,Selangor,343,194,149,Somalia
1386,1/1/2020,SRB,Johor,18,11,7,Serbia
1387,1/1/2020,SRB,Kedah,12,6,6,Serbia
1388,1/1/2020,SRB,Kelantan,0,0,0,Serbia
1389,1/1/2020,SRB,Pahang,0,0,0,Serbia
1390,1/1/2020,SRB,Perak,0,0,0,Serbia
1391,1/1/2020,SRB,Perlis,0,0,0,Serbia
1392,1/1/2020,SRB,Pulau Pinang,1,1,0,Serbia
1393,1/1/2020,SRB,Sabah,7,4,3,Serbia
1394,1/1/2020,SRB,Sarawak,0,0,0,Serbia
1395,1/1/2020,SRB,Selangor,153,85,68,Serbia
1396,1/1/2020,STP,Selangor,8,3,5,Sao Tome and Principe
1397,1/1/2020,SUR,Johor,6,3,3,Suriname
1398,1/1/2020,SUR,Kedah,0,0,0,Suriname
1399,1/1/2020,SUR,Kelantan,0,0,0,Suriname
1400,1/1/2020,SUR,Perak,1,0,1,Suriname
1401,1/1/2020,SUR,Perlis,0,0,0,Suriname
1402,1/1/2020,SUR,Pulau Pinang,0,0,0,Suriname
1403,1/1/2020,SUR,Sabah,0,0,0,Suriname
1404,1/1/2020,SUR,Sarawak,1,1,0,Suriname
1405,1/1/2020,SUR,Selangor,7,5,2,Suriname
1406,1/1/2020,SVK,Johor,34,19,15,Slovakia
1407,1/1/2020,SVK,Kedah,242,126,116,Slovakia
1408,1/1/2020,SVK,Kelantan,1,1,0,Slovakia
1409,1/1/2020,SVK,Negeri Sembilan,0,0,0,Slovakia
1410,1/1/2020,SVK,Pahang,1,0,1,Slovakia
1411,1/1/2020,SVK,Perak,1,0,1,Slovakia
1412,1/1/2020,SVK,Perlis,3,1,2,Slovakia
1413,1/1/2020,SVK,Pulau Pinang,13,6,7,Slovakia
1414,1/1/2020,SVK,Sabah,16,10,6,Slovakia
1415,1/1/2020,SVK,Sarawak,7,4,3,Slovakia
1416,1/1/2020,SVK,Selangor,571,311,260,Slovakia
1417,1/1/2020,SVK,W.P. Labuan,2,2,0,Slovakia
1418,1/1/2020,SVN,Johor,25,15,10,Slovenia
1419,1/1/2020,SVN,Kedah,30,19,11,Slovenia
1420,1/1/2020,SVN,Kelantan,0,0,0,Slovenia
1421,1/1/2020,SVN,Perak,0,0,0,Slovenia
1422,1/1/2020,SVN,Perlis,3,2,1,Slovenia
1423,1/1/2020,SVN,Pulau Pinang,3,2,1,Slovenia
1424,1/1/2020,SVN,Sabah,2,1,1,Slovenia
1425,1/1/2020,SVN,Sarawak,4,3,1,Slovenia
1426,1/1/2020,SVN,Selangor,138,81,57,Slovenia
1427,1/1/2020,SVN,W.P. Labuan,0,0,0,Slovenia
1428,1/1/2020,SWE,Johor,491,277,214,Sweden
1429,1/1/2020,SWE,Kedah,1241,609,632,Sweden
1430,1/1/2020,SWE,Kelantan,15,12,3,Sweden
1431,1/1/2020,SWE,Melaka,0,0,0,Sweden
1432,1/1/2020,SWE,Negeri Sembilan,0,0,0,Sweden
1433,1/1/2020,SWE,Pahang,3,1,2,Sweden
1434,1/1/2020,SWE,Perak,8,6,2,Sweden
1435,1/1/2020,SWE,Perlis,32,22,10,Sweden
1436,1/1/2020,SWE,Pulau Pinang,172,107,65,Sweden
1437,1/1/2020,SWE,Sabah,33,20,13,Sweden
1438,1/1/2020,SWE,Sarawak,19,11,8,Sweden
1439,1/1/2020,SWE,Selangor,2777,1614,1163,Sweden
1440,1/1/2020,SWE,W.P. Labuan,1,1,0,Sweden
1441,1/1/2020,SWZ,Johor,1,0,1,Swaziland
1442,1/1/2020,SWZ,Kedah,0,0,0,Swaziland
1443,1/1/2020,SWZ,Pulau Pinang,0,0,0,Swaziland
1444,1/1/2020,SWZ,Sabah,0,0,0,Swaziland
1445,1/1/2020,SWZ,Selangor,9,4,5,Swaziland
1446,1/1/2020,SYC,Johor,17,9,8,Seychelles
1447,1/1/2020,SYC,Kedah,0,0,0,Seychelles
1448,1/1/2020,SYC,Pulau Pinang,0,0,0,Seychelles
1449,1/1/2020,SYC,Sabah,0,0,0,Seychelles
1450,1/1/2020,SYC,Sarawak,4,3,1,Seychelles
1451,1/1/2020,SYC,Selangor,149,72,77,Seychelles
1452,1/1/2020,SYR,Johor,23,16,7,Syrian Arab Republic
1453,1/1/2020,SYR,Kedah,11,6,5,Syrian Arab Republic
1454,1/1/2020,SYR,Kelantan,0,0,0,Syrian Arab Republic
1455,1/1/2020,SYR,Pahang,8,8,0,Syrian Arab Republic
1456,1/1/2020,SYR,Perlis,0,0,0,Syrian Arab Republic
1457,1/1/2020,SYR,Pulau Pinang,3,3,0,Syrian Arab Republic
1458,1/1/2020,SYR,Sabah,2,2,0,Syrian Arab Republic
1459,1/1/2020,SYR,Sarawak,2,1,1,Syrian Arab Republic
1460,1/1/2020,SYR,Selangor,1021,660,361,Syrian Arab Republic
1461,1/1/2020,SYR,W.P. Labuan,0,0,0,Syrian Arab Republic
1462,1/1/2020,TCA,Perlis,0,0,0,Turks and Caicos
1463,1/1/2020,TCD,Johor,2,1,1,Chad
1464,1/1/2020,TCD,Kedah,0,0,0,Chad
1465,1/1/2020,TCD,Perlis,0,0,0,Chad
1466,1/1/2020,TCD,Selangor,25,19,6,Chad
1467,1/1/2020,TGO,Johor,2,2,0,Togo
1468,1/1/2020,TGO,Perak,0,0,0,Togo
1469,1/1/2020,TGO,Pulau Pinang,0,0,0,Togo
1470,1/1/2020,TGO,Selangor,14,12,2,Togo
1471,1/1/2020,THA,Johor,5760,1637,4123,Thailand
1472,1/1/2020,THA,Kedah,47467,17473,29994,Thailand
1473,1/1/2020,THA,Kelantan,37479,19581,17898,Thailand
1474,1/1/2020,THA,Melaka,5,4,1,Thailand
1475,1/1/2020,THA,Negeri Sembilan,0,0,0,Thailand
1476,1/1/2020,THA,Pahang,0,0,0,Thailand
1477,1/1/2020,THA,Perak,14561,6674,7887,Thailand
1478,1/1/2020,THA,Perlis,47565,27702,19863,Thailand
1479,1/1/2020,THA,Pulau Pinang,1053,407,646,Thailand
1480,1/1/2020,THA,Sabah,56,15,41,Thailand
1481,1/1/2020,THA,Sarawak,660,263,397,Thailand
1482,1/1/2020,THA,Selangor,10453,4338,6115,Thailand
1483,1/1/2020,THA,Terengganu,0,0,0,Thailand
1484,1/1/2020,THA,W.P. Labuan,14,2,12,Thailand
1485,1/1/2020,TJK,Johor,2,1,1,Tajikistan
1486,1/1/2020,TJK,Kedah,3,3,0,Tajikistan
1487,1/1/2020,TJK,Perlis,0,0,0,Tajikistan
1488,1/1/2020,TJK,Pulau Pinang,1,0,1,Tajikistan
1489,1/1/2020,TJK,Sabah,2,2,0,Tajikistan
1490,1/1/2020,TJK,Selangor,142,96,46,Tajikistan
1491,1/1/2020,TKL,Selangor,2,2,0,Tokelau
1492,1/1/2020,TKM,Johor,4,2,2,Turkmenistan
1493,1/1/2020,TKM,Kedah,0,0,0,Turkmenistan
1494,1/1/2020,TKM,Kelantan,0,0,0,Turkmenistan
1495,1/1/2020,TKM,Perlis,0,0,0,Turkmenistan
1496,1/1/2020,TKM,Pulau Pinang,0,0,0,Turkmenistan
1497,1/1/2020,TKM,Sabah,5,2,3,Turkmenistan
1498,1/1/2020,TKM,Sarawak,0,0,0,Turkmenistan
1499,1/1/2020,TKM,Selangor,225,128,97,Turkmenistan
1500,1/1/2020,TLS,Johor,4,2,2,Timor-Leste
1501,1/1/2020,TLS,Kedah,0,0,0,Timor-Leste
1502,1/1/2020,TLS,Perlis,0,0,0,Timor-Leste
1503,1/1/2020,TLS,Pulau Pinang,10,5,5,Timor-Leste
1504,1/1/2020,TLS,Sabah,0,0,0,Timor-Leste
1505,1/1/2020,TLS,Sarawak,2,1,1,Timor-Leste
1506,1/1/2020,TLS,Selangor,105,53,52,Timor-Leste
1507,1/1/2020,TON,Johor,1,1,0,Tonga
1508,1/1/2020,TON,Pulau Pinang,1,0,1,Tonga
1509,1/1/2020,TON,Sarawak,1,0,1,Tonga
1510,1/1/2020,TON,Selangor,10,7,3,Tonga
1511,1/1/2020,TTO,Johor,17,13,4,Trinidad and Tobago
1512,1/1/2020,TTO,Kedah,0,0,0,Trinidad and Tobago
1513,1/1/2020,TTO,Pahang,0,0,0,Trinidad and Tobago
1514,1/1/2020,TTO,Pulau Pinang,2,1,1,Trinidad and Tobago
1515,1/1/2020,TTO,Sabah,0,0,0,Trinidad and Tobago
1516,1/1/2020,TTO,Sarawak,1,1,0,Trinidad and Tobago
1517,1/1/2020,TTO,Selangor,32,18,14,Trinidad and Tobago
1518,1/1/2020,TUN,Johor,15,12,3,Tunisia
1519,1/1/2020,TUN,Kedah,19,11,8,Tunisia
1520,1/1/2020,TUN,Kelantan,0,0,0,Tunisia
1521,1/1/2020,TUN,Melaka,0,0,0,Tunisia
1522,1/1/2020,TUN,Perak,0,0,0,Tunisia
1523,1/1/2020,TUN,Perlis,0,0,0,Tunisia
1524,1/1/2020,TUN,Pulau Pinang,3,2,1,Tunisia
1525,1/1/2020,TUN,Sabah,2,0,2,Tunisia
1526,1/1/2020,TUN,Sarawak,2,1,1,Tunisia
1527,1/1/2020,TUN,Selangor,363,194,169,Tunisia
1528,1/1/2020,TUN,W.P. Labuan,0,0,0,Tunisia
1529,1/1/2020,TUR,Johor,301,206,95,Turkey
1530,1/1/2020,TUR,Kedah,88,65,23,Turkey
1531,1/1/2020,TUR,Kelantan,6,6,0,Turkey
1532,1/1/2020,TUR,Melaka,1,1,0,Turkey
1533,1/1/2020,TUR,Negeri Sembilan,0,0,0,Turkey
1534,1/1/2020,TUR,Pahang,2,0,2,Turkey
1535,1/1/2020,TUR,Perak,0,0,0,Turkey
1536,1/1/2020,TUR,Perlis,8,7,1,Turkey
1537,1/1/2020,TUR,Pulau Pinang,13,8,5,Turkey
1538,1/1/2020,TUR,Sabah,13,10,3,Turkey
1539,1/1/2020,TUR,Sarawak,30,23,7,Turkey
1540,1/1/2020,TUR,Selangor,1359,877,482,Turkey
1541,1/1/2020,TUR,W.P. Labuan,0,0,0,Turkey
1542,1/1/2020,TUV,Selangor,0,0,0,Tuvalu
1543,1/1/2020,TWN,Johor,9852,4268,5584,Taiwan
1544,1/1/2020,TWN,Kedah,184,78,106,Taiwan
1545,1/1/2020,TWN,Kelantan,6,4,2,Taiwan
1546,1/1/2020,TWN,Melaka,12,5,7,Taiwan
1547,1/1/2020,TWN,Negeri Sembilan,0,0,0,Taiwan
1548,1/1/2020,TWN,Pahang,318,154,164,Taiwan
1549,1/1/2020,TWN,Perak,32,10,22,Taiwan
1550,1/1/2020,TWN,Perlis,29,16,13,Taiwan
1551,1/1/2020,TWN,Pulau Pinang,3817,1903,1914,Taiwan
1552,1/1/2020,TWN,Sabah,3684,1751,1933,Taiwan
1553,1/1/2020,TWN,Sarawak,362,145,217,Taiwan
1554,1/1/2020,TWN,Selangor,21324,10163,11161,Taiwan
1555,1/1/2020,TWN,W.P. Labuan,11,4,7,Taiwan
1556,1/1/2020,TZA,Johor,48,31,17,"Tanzania, United Republic of"
1557,1/1/2020,TZA,Kedah,1,1,0,"Tanzania, United Republic of"
1558,1/1/2020,TZA,Perak,0,0,0,"Tanzania, United Republic of"
1559,1/1/2020,TZA,Perlis,0,0,0,"Tanzania, United Republic of"
1560,1/1/2020,TZA,Pulau Pinang,0,0,0,"Tanzania, United Republic of"
1561,1/1/2020,TZA,Sabah,0,0,0,"Tanzania, United Republic of"
1562,1/1/2020,TZA,Sarawak,1,0,1,"Tanzania, United Republic of"
1563,1/1/2020,TZA,Selangor,272,142,130,"Tanzania, United Republic of"
1564,1/1/2020,UGA,Johor,52,17,35,Uganda
1565,1/1/2020,UGA,Kedah,1,0,1,Uganda
1566,1/1/2020,UGA,Perak,0,0,0,Uganda
1567,1/1/2020,UGA,Perlis,0,0,0,Uganda
1568,1/1/2020,UGA,Pulau Pinang,1,0,1,Uganda
1569,1/1/2020,UGA,Sabah,1,0,1,Uganda
1570,1/1/2020,UGA,Sarawak,0,0,0,Uganda
1571,1/1/2020,UGA,Selangor,132,63,69,Uganda
1572,1/1/2020,UKR,Johor,115,66,49,Ukraine
1573,1/1/2020,UKR,Kedah,489,232,257,Ukraine
1574,1/1/2020,UKR,Kelantan,18,12,6,Ukraine
1575,1/1/2020,UKR,Melaka,0,0,0,Ukraine
1576,1/1/2020,UKR,Negeri Sembilan,1,1,0,Ukraine
1577,1/1/2020,UKR,Pahang,3,3,0,Ukraine
1578,1/1/2020,UKR,Perak,1,1,0,Ukraine
1579,1/1/2020,UKR,Perlis,38,21,17,Ukraine
1580,1/1/2020,UKR,Pulau Pinang,49,21,28,Ukraine
1581,1/1/2020,UKR,Sabah,35,12,23,Ukraine
1582,1/1/2020,UKR,Sarawak,30,20,10,Ukraine
1583,1/1/2020,UKR,Selangor,2165,1037,1128,Ukraine
1584,1/1/2020,UKR,W.P. Labuan,7,4,3,Ukraine
1585,1/1/2020,URY,Johor,8,3,5,Uruguay
1586,1/1/2020,URY,Kedah,3,1,2,Uruguay
1587,1/1/2020,URY,Kelantan,0,0,0,Uruguay
1588,1/1/2020,URY,Perak,0,0,0,Uruguay
1589,1/1/2020,URY,Perlis,2,1,1,Uruguay
1590,1/1/2020,URY,Pulau Pinang,1,1,0,Uruguay
1591,1/1/2020,URY,Sabah,0,0,0,Uruguay
1592,1/1/2020,URY,Sarawak,0,0,0,Uruguay
1593,1/1/2020,URY,Selangor,81,40,41,Uruguay
1594,1/1/2020,URY,W.P. Labuan,0,0,0,Uruguay
1595,1/1/2020,USA,Johor,5788,3284,2504,United States Of America
1596,1/1/2020,USA,Kedah,800,429,371,United States Of America
1597,1/1/2020,USA,Kelantan,32,21,11,United States Of America
1598,1/1/2020,USA,Melaka,1,1,0,United States Of America
1599,1/1/2020,USA,Negeri Sembilan,0,0,0,United States Of America
1600,1/1/2020,USA,Pahang,14,5,9,United States Of America
1601,1/1/2020,USA,Perak,101,57,44,United States Of America
1602,1/1/2020,USA,Perlis,128,80,48,United States Of America
1603,1/1/2020,USA,Pulau Pinang,2264,1332,932,United States Of America
1604,1/1/2020,USA,Sabah,528,285,243,United States Of America
1605,1/1/2020,USA,Sarawak,439,266,173,United States Of America
1606,1/1/2020,USA,Selangor,19067,10998,8069,United States Of America
1607,1/1/2020,USA,Terengganu,0,0,0,United States Of America
1608,1/1/2020,USA,W.P. Labuan,18,12,6,United States Of America
1609,1/1/2020,UZB,Johor,99,69,30,Uzbekistan
1610,1/1/2020,UZB,Kedah,114,39,75,Uzbekistan
1611,1/1/2020,UZB,Kelantan,5,4,1,Uzbekistan
1612,1/1/2020,UZB,Perak,0,0,0,Uzbekistan
1613,1/1/2020,UZB,Perlis,1,0,1,Uzbekistan
1614,1/1/2020,UZB,Pulau Pinang,24,11,13,Uzbekistan
1615,1/1/2020,UZB,Sabah,7,7,0,Uzbekistan
1616,1/1/2020,UZB,Sarawak,1,1,0,Uzbekistan
1617,1/1/2020,UZB,Selangor,2055,1226,829,Uzbekistan
1618,1/1/2020,VAT,Johor,1,1,0,Holy See (Vatican City State)
1619,1/1/2020,VAT,Sarawak,0,0,0,Holy See (Vatican City State)
1620,1/1/2020,VAT,Selangor,2,2,0,Holy See (Vatican City State)
1621,1/1/2020,VCT,Johor,1,0,1,Saint Vincent and the Grenadines
1622,1/1/2020,VCT,Kedah,0,0,0,Saint Vincent and the Grenadines
1623,1/1/2020,VCT,Pulau Pinang,0,0,0,Saint Vincent and the Grenadines
1624,1/1/2020,VCT,Sarawak,0,0,0,Saint Vincent and the Grenadines
1625,1/1/2020,VCT,Selangor,0,0,0,Saint Vincent and the Grenadines
1626,1/1/2020,VEN,Johor,22,13,9,Venezuela
1627,1/1/2020,VEN,Kedah,4,3,1,Venezuela
1628,1/1/2020,VEN,Kelantan,1,1,0,Venezuela
1629,1/1/2020,VEN,Melaka,1,0,1,Venezuela
1630,1/1/2020,VEN,Perak,1,0,1,Venezuela
1631,1/1/2020,VEN,Perlis,0,0,0,Venezuela
1632,1/1/2020,VEN,Pulau Pinang,4,3,1,Venezuela
1633,1/1/2020,VEN,Sabah,5,4,1,Venezuela
1634,1/1/2020,VEN,Sarawak,8,5,3,Venezuela
1635,1/1/2020,VEN,Selangor,98,55,43,Venezuela
1636,1/1/2020,VEN,W.P. Labuan,0,0,0,Venezuela
1637,1/1/2020,VNM,Johor,13125,4305,8820,Vietnam
1638,1/1/2020,VNM,Kedah,581,55,526,Vietnam
1639,1/1/2020,VNM,Kelantan,20,6,14,Vietnam
1640,1/1/2020,VNM,Melaka,4,0,4,Vietnam
1641,1/1/2020,VNM,Negeri Sembilan,2,2,0,Vietnam
1642,1/1/2020,VNM,Pahang,1,0,1,Vietnam
1643,1/1/2020,VNM,Perak,80,17,63,Vietnam
1644,1/1/2020,VNM,Perlis,147,24,123,Vietnam
1645,1/1/2020,VNM,Pulau Pinang,946,248,698,Vietnam
1646,1/1/2020,VNM,Sabah,41,17,24,Vietnam
1647,1/1/2020,VNM,Sarawak,421,101,320,Vietnam
1648,1/1/2020,VNM,Selangor,17898,6592,11306,Vietnam
1649,1/1/2020,VNM,Terengganu,0,0,0,Vietnam
1650,1/1/2020,VNM,W.P. Labuan,12,9,3,Vietnam
1651,1/1/2020,VUT,Johor,40,28,12,Vanuatu
1652,1/1/2020,VUT,Kedah,1,1,0,Vanuatu
1653,1/1/2020,VUT,Pulau Pinang,7,5,2,Vanuatu
1654,1/1/2020,VUT,Sabah,1,1,0,Vanuatu
1655,1/1/2020,VUT,Sarawak,0,0,0,Vanuatu
1656,1/1/2020,VUT,Selangor,66,52,14,Vanuatu
1657,1/1/2020,WSM,Johor,0,0,0,Samoa
1658,1/1/2020,WSM,Sarawak,0,0,0,Samoa
1659,1/1/2020,WSM,Selangor,5,4,1,Samoa
1660,1/1/2020,YEM,Johor,54,35,19,Yemen
1661,1/1/2020,YEM,Kedah,3,3,0,Yemen
1662,1/1/2020,YEM,Kelantan,0,0,0,Yemen
1663,1/1/2020,YEM,Melaka,8,6,2,Yemen
1664,1/1/2020,YEM,Pahang,0,0,0,Yemen
1665,1/1/2020,YEM,Perak,0,0,0,Yemen
1666,1/1/2020,YEM,Perlis,0,0,0,Yemen
1667,1/1/2020,YEM,Pulau Pinang,5,5,0,Yemen
1668,1/1/2020,YEM,Sabah,0,0,0,Yemen
1669,1/1/2020,YEM,Sarawak,3,1,2,Yemen
1670,1/1/2020,YEM,Selangor,2339,1610,729,Yemen
1671,1/1/2020,YEM,W.P. Labuan,0,0,0,Yemen
1672,1/1/2020,ZAF,Johor,485,278,207,South Africa
1673,1/1/2020,ZAF,Kedah,116,67,49,South Africa
1674,1/1/2020,ZAF,Kelantan,15,5,10,South Africa
1675,1/1/2020,ZAF,Melaka,2,0,2,South Africa
1676,1/1/2020,ZAF,Pahang,2,1,1,South Africa
1677,1/1/2020,ZAF,Perak,1,1,0,South Africa
1678,1/1/2020,ZAF,Perlis,23,11,12,South Africa
1679,1/1/2020,ZAF,Pulau Pinang,64,33,31,South Africa
1680,1/1/2020,ZAF,Sabah,20,10,10,South Africa
1681,1/1/2020,ZAF,Sarawak,63,42,21,South Africa
1682,1/1/2020,ZAF,Selangor,1869,986,883,South Africa
1683,1/1/2020,ZAF,Terengganu,0,0,0,South Africa
1684,1/1/2020,ZAF,W.P. Labuan,16,7,9,South Africa
1685,1/1/2020,ZMB,Johor,8,5,3,Zambia
1686,1/1/2020,ZMB,Kedah,0,0,0,Zambia
1687,1/1/2020,ZMB,Perak,0,0,0,Zambia
1688,1/1/2020,ZMB,Perlis,0,0,0,Zambia
1689,1/1/2020,ZMB,Pulau Pinang,3,1,2,Zambia
1690,1/1/2020,ZMB,Sabah,0,0,0,Zambia
1691,1/1/2020,ZMB,Sarawak,0,0,0,Zambia
1692,1/1/2020,ZMB,Selangor,102,52,50,Zambia
1693,1/1/2020,ZWE,Johor,21,13,8,Zimbabwe
1694,1/1/2020,ZWE,Kedah,0,0,0,Zimbabwe
1695,1/1/2020,ZWE,Kelantan,2,2,0,Zimbabwe
1696,1/1/2020,ZWE,Perak,0,0,0,Zimbabwe
1697,1/1/2020,ZWE,Perlis,1,1,0,Zimbabwe
1698,1/1/2020,ZWE,Pulau Pinang,1,1,0,Zimbabwe
1699,1/1/2020,ZWE,Sabah,4,2,2,Zimbabwe
1700,1/1/2020,ZWE,Sarawak,1,0,1,Zimbabwe
1701,1/1/2020,ZWE,Selangor,192,100,92,Zimbabwe
1702,2/1/2020,ABW,Kedah,0,0,0,Aruba
1703,2/1/2020,ABW,Pulau Pinang,0,0,0,Aruba
1704,2/1/2020,AFG,Johor,2,1,1,Afghanistan
1705,2/1/2020,AFG,Kedah,3,3,0,Afghanistan
1706,2/1/2020,AFG,Perlis,0,0,0,Afghanistan
1707,2/1/2020,AFG,Pulau Pinang,0,0,0,Afghanistan
1708,2/1/2020,AFG,Sarawak,0,0,0,Afghanistan
1709,2/1/2020,AFG,Selangor,249,187,62,Afghanistan
1710,2/1/2020,AGO,Johor,0,0,0,Angola
1711,2/1/2020,AGO,Kedah,0,0,0,Angola
1712,2/1/2020,AGO,Sabah,0,0,0,Angola
1713,2/1/2020,AGO,Selangor,8,6,2,Angola
1714,2/1/2020,AIA,Selangor,0,0,0,Anguilla
1715,2/1/2020,ALB,Johor,28,15,13,Albania
1716,2/1/2020,ALB,Kedah,0,0,0,Albania
1717,2/1/2020,ALB,Perak,0,0,0,Albania
1718,2/1/2020,ALB,Perlis,0,0,0,Albania
1719,2/1/2020,ALB,Pulau Pinang,0,0,0,Albania
1720,2/1/2020,ALB,Sabah,0,0,0,Albania
1721,2/1/2020,ALB,Sarawak,0,0,0,Albania
1722,2/1/2020,ALB,Selangor,29,15,14,Albania
1723,2/1/2020,AND,Johor,0,0,0,Andorra
1724,2/1/2020,AND,Kedah,0,0,0,Andorra
1725,2/1/2020,AND,Perlis,0,0,0,Andorra
1726,2/1/2020,AND,Pulau Pinang,0,0,0,Andorra
1727,2/1/2020,AND,Selangor,9,5,4,Andorra
1728,2/1/2020,ANT,Selangor,0,0,0,Netherlands Antilles
1729,2/1/2020,ARE,Johor,7,5,2,United Arab Emirates
1730,2/1/2020,ARE,Kedah,5,3,2,United Arab Emirates
1731,2/1/2020,ARE,Kelantan,0,0,0,United Arab Emirates
1732,2/1/2020,ARE,Perak,0,0,0,United Arab Emirates
1733,2/1/2020,ARE,Perlis,0,0,0,United Arab Emirates
1734,2/1/2020,ARE,Pulau Pinang,2,0,2,United Arab Emirates
1735,2/1/2020,ARE,Sabah,1,1,0,United Arab Emirates
1736,2/1/2020,ARE,Sarawak,1,1,0,United Arab Emirates
1737,2/1/2020,ARE,Selangor,236,171,65,United Arab Emirates
1738,2/1/2020,ARG,Johor,87,43,44,Argentina
1739,2/1/2020,ARG,Kedah,122,62,60,Argentina
1740,2/1/2020,ARG,Kelantan,3,1,2,Argentina
1741,2/1/2020,ARG,Melaka,0,0,0,Argentina
1742,2/1/2020,ARG,Perak,0,0,0,Argentina
1743,2/1/2020,ARG,Perlis,4,3,1,Argentina
1744,2/1/2020,ARG,Pulau Pinang,7,4,3,Argentina
1745,2/1/2020,ARG,Sabah,10,5,5,Argentina
1746,2/1/2020,ARG,Sarawak,5,3,2,Argentina
1747,2/1/2020,ARG,Selangor,586,323,263,Argentina
1748,2/1/2020,ARG,W.P. Labuan,0,0,0,Argentina
1749,2/1/2020,ARM,Johor,5,2,3,Armenia
1750,2/1/2020,ARM,Kedah,3,2,1,Armenia
1751,2/1/2020,ARM,Kelantan,0,0,0,Armenia
1752,2/1/2020,ARM,Perak,0,0,0,Armenia
1753,2/1/2020,ARM,Perlis,0,0,0,Armenia
1754,2/1/2020,ARM,Pulau Pinang,0,0,0,Armenia
1755,2/1/2020,ARM,Sabah,0,0,0,Armenia
1756,2/1/2020,ARM,Sarawak,0,0,0,Armenia
1757,2/1/2020,ARM,Selangor,61,34,27,Armenia
1758,2/1/2020,ATA,Selangor,1,0,1,Antarctica
1759,2/1/2020,ATG,Johor,0,0,0,Antigua and Barbuda
1760,2/1/2020,ATG,Kedah,0,0,0,Antigua and Barbuda
1761,2/1/2020,ATG,Pulau Pinang,0,0,0,Antigua and Barbuda
1762,2/1/2020,ATG,Sarawak,0,0,0,Antigua and Barbuda
1763,2/1/2020,ATG,Selangor,13,8,5,Antigua and Barbuda
1764,2/1/2020,AUS,Johor,3385,2170,1215,Australia
1765,2/1/2020,AUS,Kedah,470,271,199,Australia
1766,2/1/2020,AUS,Kelantan,24,10,14,Australia
1767,2/1/2020,AUS,Melaka,3,2,1,Australia
1768,2/1/2020,AUS,Negeri Sembilan,0,0,0,Australia
1769,2/1/2020,AUS,Pahang,21,11,10,Australia
1770,2/1/2020,AUS,Perak,123,72,51,Australia
1771,2/1/2020,AUS,Perlis,66,40,26,Australia
1772,2/1/2020,AUS,Pulau Pinang,1270,711,559,Australia
1773,2/1/2020,AUS,Sabah,390,183,207,Australia
1774,2/1/2020,AUS,Sarawak,402,260,142,Australia
1775,2/1/2020,AUS,Selangor,16651,10384,6267,Australia
1776,2/1/2020,AUS,Terengganu,0,0,0,Australia
1777,2/1/2020,AUS,W.P. Labuan,13,8,5,Australia
1778,2/1/2020,AUT,Johor,205,138,67,Austria
1779,2/1/2020,AUT,Kedah,168,94,74,Austria
1780,2/1/2020,AUT,Kelantan,11,10,1,Austria
1781,2/1/2020,AUT,Melaka,1,1,0,Austria
1782,2/1/2020,AUT,Negeri Sembilan,0,0,0,Austria
1783,2/1/2020,AUT,Pahang,0,0,0,Austria
1784,2/1/2020,AUT,Perak,14,9,5,Austria
1785,2/1/2020,AUT,Perlis,32,18,14,Austria
1786,2/1/2020,AUT,Pulau Pinang,54,32,22,Austria
1787,2/1/2020,AUT,Sabah,20,10,10,Austria
1788,2/1/2020,AUT,Sarawak,17,11,6,Austria
1789,2/1/2020,AUT,Selangor,1106,656,450,Austria
1790,2/1/2020,AUT,Terengganu,0,0,0,Austria
1791,2/1/2020,AUT,W.P. Labuan,1,0,1,Austria
1792,2/1/2020,AZE,Johor,3,1,2,Azerbaijan
1793,2/1/2020,AZE,Kedah,6,3,3,Azerbaijan
1794,2/1/2020,AZE,Kelantan,0,0,0,Azerbaijan
1795,2/1/2020,AZE,Melaka,0,0,0,Azerbaijan
1796,2/1/2020,AZE,Perlis,0,0,0,Azerbaijan
1797,2/1/2020,AZE,Pulau Pinang,0,0,0,Azerbaijan
1798,2/1/2020,AZE,Sabah,0,0,0,Azerbaijan
1799,2/1/2020,AZE,Sarawak,1,0,1,Azerbaijan
1800,2/1/2020,AZE,Selangor,90,56,34,Azerbaijan
1801,2/1/2020,AZE,W.P. Labuan,0,0,0,Azerbaijan
1802,2/1/2020,BDI,Pulau Pinang,0,0,0,Burundi
1803,2/1/2020,BDI,Sarawak,0,0,0,Burundi
1804,2/1/2020,BDI,Selangor,1,0,1,Burundi
1805,2/1/2020,BEL,Johor,242,171,71,Belgium
1806,2/1/2020,BEL,Kedah,160,84,76,Belgium
1807,2/1/2020,BEL,Kelantan,8,6,2,Belgium
1808,2/1/2020,BEL,Melaka,1,1,0,Belgium
1809,2/1/2020,BEL,Negeri Sembilan,2,1,1,Belgium
1810,2/1/2020,BEL,Pahang,1,0,1,Belgium
1811,2/1/2020,BEL,Perak,7,6,1,Belgium
1812,2/1/2020,BEL,Perlis,30,19,11,Belgium
1813,2/1/2020,BEL,Pulau Pinang,62,35,27,Belgium
1814,2/1/2020,BEL,Sabah,23,13,10,Belgium
1815,2/1/2020,BEL,Sarawak,15,7,8,Belgium
1816,2/1/2020,BEL,Selangor,1206,803,403,Belgium
1817,2/1/2020,BEL,W.P. Labuan,3,2,1,Belgium
1818,2/1/2020,BEN,Johor,3,1,2,Benin
1819,2/1/2020,BEN,Kedah,0,0,0,Benin
1820,2/1/2020,BEN,Perak,0,0,0,Benin
1821,2/1/2020,BEN,Pulau Pinang,0,0,0,Benin
1822,2/1/2020,BEN,Sabah,0,0,0,Benin
1823,2/1/2020,BEN,Sarawak,0,0,0,Benin
1824,2/1/2020,BEN,Selangor,4,2,2,Benin
1825,2/1/2020,BFA,Perak,0,0,0,Burkina Faso
1826,2/1/2020,BFA,Pulau Pinang,0,0,0,Burkina Faso
1827,2/1/2020,BFA,Selangor,7,7,0,Burkina Faso
1828,2/1/2020,BGD,Johor,1625,1366,259,Bangladesh
1829,2/1/2020,BGD,Kedah,11,6,5,Bangladesh
1830,2/1/2020,BGD,Kelantan,1,0,1,Bangladesh
1831,2/1/2020,BGD,Melaka,0,0,0,Bangladesh
1832,2/1/2020,BGD,Negeri Sembilan,0,0,0,Bangladesh
1833,2/1/2020,BGD,Pahang,0,0,0,Bangladesh
1834,2/1/2020,BGD,Perak,0,0,0,Bangladesh
1835,2/1/2020,BGD,Perlis,0,0,0,Bangladesh
1836,2/1/2020,BGD,Pulau Pinang,90,80,10,Bangladesh
1837,2/1/2020,BGD,Sabah,9,9,0,Bangladesh
1838,2/1/2020,BGD,Sarawak,158,134,24,Bangladesh
1839,2/1/2020,BGD,Selangor,17763,15754,2009,Bangladesh
1840,2/1/2020,BGD,W.P. Labuan,11,11,0,Bangladesh
1841,2/1/2020,BGR,Johor,36,24,12,Bulgaria
1842,2/1/2020,BGR,Kedah,66,37,29,Bulgaria
1843,2/1/2020,BGR,Kelantan,0,0,0,Bulgaria
1844,2/1/2020,BGR,Pahang,4,4,0,Bulgaria
1845,2/1/2020,BGR,Perak,4,4,0,Bulgaria
1846,2/1/2020,BGR,Perlis,0,0,0,Bulgaria
1847,2/1/2020,BGR,Pulau Pinang,5,3,2,Bulgaria
1848,2/1/2020,BGR,Sabah,3,1,2,Bulgaria
1849,2/1/2020,BGR,Sarawak,0,0,0,Bulgaria
1850,2/1/2020,BGR,Selangor,369,211,158,Bulgaria
1851,2/1/2020,BGR,W.P. Labuan,0,0,0,Bulgaria
1852,2/1/2020,BHR,Johor,17,8,9,Bahrain
1853,2/1/2020,BHR,Kedah,0,0,0,Bahrain
1854,2/1/2020,BHR,Kelantan,0,0,0,Bahrain
1855,2/1/2020,BHR,Perlis,0,0,0,Bahrain
1856,2/1/2020,BHR,Pulau Pinang,0,0,0,Bahrain
1857,2/1/2020,BHR,Sabah,1,1,0,Bahrain
1858,2/1/2020,BHR,Sarawak,4,4,0,Bahrain
1859,2/1/2020,BHR,Selangor,72,48,24,Bahrain
1860,2/1/2020,BHS,Johor,1,1,0,Bahamas
1861,2/1/2020,BHS,Kedah,0,0,0,Bahamas
1862,2/1/2020,BHS,Perak,0,0,0,Bahamas
1863,2/1/2020,BHS,Sabah,1,0,1,Bahamas
1864,2/1/2020,BHS,Sarawak,0,0,0,Bahamas
1865,2/1/2020,BHS,Selangor,3,3,0,Bahamas
1866,2/1/2020,BIH,Johor,5,3,2,Bosnia and Herzegovina
1867,2/1/2020,BIH,Kedah,7,2,5,Bosnia and Herzegovina
1868,2/1/2020,BIH,Perlis,2,2,0,Bosnia and Herzegovina
1869,2/1/2020,BIH,Pulau Pinang,1,0,1,Bosnia and Herzegovina
1870,2/1/2020,BIH,Sabah,0,0,0,Bosnia and Herzegovina
1871,2/1/2020,BIH,Sarawak,0,0,0,Bosnia and Herzegovina
1872,2/1/2020,BIH,Selangor,67,37,30,Bosnia and Herzegovina
1873,2/1/2020,BLR,Johor,13,7,6,Belarus
1874,2/1/2020,BLR,Kedah,32,15,17,Belarus
1875,2/1/2020,BLR,Kelantan,3,1,2,Belarus
1876,2/1/2020,BLR,Pahang,0,0,0,Belarus
1877,2/1/2020,BLR,Perak,0,0,0,Belarus
1878,2/1/2020,BLR,Perlis,4,2,2,Belarus
1879,2/1/2020,BLR,Pulau Pinang,2,0,2,Belarus
1880,2/1/2020,BLR,Sabah,2,2,0,Belarus
1881,2/1/2020,BLR,Sarawak,4,1,3,Belarus
1882,2/1/2020,BLR,Selangor,444,207,237,Belarus
1883,2/1/2020,BLR,W.P. Labuan,0,0,0,Belarus
1884,2/1/2020,BLZ,Johor,1,1,0,Belize
1885,2/1/2020,BLZ,Pulau Pinang,0,0,0,Belize
1886,2/1/2020,BLZ,Sarawak,0,0,0,Belize
1887,2/1/2020,BLZ,Selangor,6,3,3,Belize
1888,2/1/2020,BMU,Selangor,0,0,0,Bermuda
1889,2/1/2020,BOL,Johor,0,0,0,Bolivia
1890,2/1/2020,BOL,Kedah,1,0,1,Bolivia
1891,2/1/2020,BOL,Melaka,0,0,0,Bolivia
1892,2/1/2020,BOL,Perak,0,0,0,Bolivia
1893,2/1/2020,BOL,Perlis,0,0,0,Bolivia
1894,2/1/2020,BOL,Pulau Pinang,0,0,0,Bolivia
1895,2/1/2020,BOL,Sabah,0,0,0,Bolivia
1896,2/1/2020,BOL,Sarawak,0,0,0,Bolivia
1897,2/1/2020,BOL,Selangor,21,12,9,Bolivia
1898,2/1/2020,BRA,Johor,153,88,65,Brazil
1899,2/1/2020,BRA,Kedah,75,38,37,Brazil
1900,2/1/2020,BRA,Kelantan,0,0,0,Brazil
1901,2/1/2020,BRA,Melaka,0,0,0,Brazil
1902,2/1/2020,BRA,Pahang,0,0,0,Brazil
1903,2/1/2020,BRA,Perak,5,3,2,Brazil
1904,2/1/2020,BRA,Perlis,10,4,6,Brazil
1905,2/1/2020,BRA,Pulau Pinang,25,15,10,Brazil
1906,2/1/2020,BRA,Sabah,11,8,3,Brazil
1907,2/1/2020,BRA,Sarawak,12,3,9,Brazil
1908,2/1/2020,BRA,Selangor,1114,627,487,Brazil
1909,2/1/2020,BRA,W.P. Labuan,0,0,0,Brazil
1910,2/1/2020,BRB,Johor,2,1,1,Barbados
1911,2/1/2020,BRB,Kedah,0,0,0,Barbados
1912,2/1/2020,BRB,Perlis,0,0,0,Barbados
1913,2/1/2020,BRB,Pulau Pinang,0,0,0,Barbados
1914,2/1/2020,BRB,Selangor,6,1,5,Barbados
1915,2/1/2020,BRN,Johor,167,70,97,Brunei Darussalam
1916,2/1/2020,BRN,Kedah,6,3,3,Brunei Darussalam
1917,2/1/2020,BRN,Kelantan,4,2,2,Brunei Darussalam
1918,2/1/2020,BRN,Melaka,0,0,0,Brunei Darussalam
1919,2/1/2020,BRN,Pahang,0,0,0,Brunei Darussalam
1920,2/1/2020,BRN,Perak,1,1,0,Brunei Darussalam
1921,2/1/2020,BRN,Perlis,6,1,5,Brunei Darussalam
1922,2/1/2020,BRN,Pulau Pinang,5,5,0,Brunei Darussalam
1923,2/1/2020,BRN,Sabah,474,254,220,Brunei Darussalam
1924,2/1/2020,BRN,Sarawak,58473,34982,23491,Brunei Darussalam
1925,2/1/2020,BRN,Selangor,4037,2042,1995,Brunei Darussalam
1926,2/1/2020,BRN,W.P. Labuan,1556,1064,492,Brunei Darussalam
1927,2/1/2020,BTN,Johor,6,6,0,Bhutan
1928,2/1/2020,BTN,Kedah,2,2,0,Bhutan
1929,2/1/2020,BTN,Perak,0,0,0,Bhutan
1930,2/1/2020,BTN,Perlis,0,0,0,Bhutan
1931,2/1/2020,BTN,Pulau Pinang,2,1,1,Bhutan
1932,2/1/2020,BTN,Sabah,0,0,0,Bhutan
1933,2/1/2020,BTN,Sarawak,1,1,0,Bhutan
1934,2/1/2020,BTN,Selangor,32,18,14,Bhutan
1935,2/1/2020,BWA,Johor,5,0,5,Botswana
1936,2/1/2020,BWA,Kedah,0,0,0,Botswana
1937,2/1/2020,BWA,Perlis,0,0,0,Botswana
1938,2/1/2020,BWA,Pulau Pinang,0,0,0,Botswana
1939,2/1/2020,BWA,Sabah,0,0,0,Botswana
1940,2/1/2020,BWA,Sarawak,0,0,0,Botswana
1941,2/1/2020,BWA,Selangor,15,9,6,Botswana
1942,2/1/2020,CAF,Kedah,0,0,0,Central African Republic
1943,2/1/2020,CAF,Selangor,1,1,0,Central African Republic
1944,2/1/2020,CAN,Johor,1156,696,460,Canada
1945,2/1/2020,CAN,Kedah,288,169,119,Canada
1946,2/1/2020,CAN,Kelantan,16,9,7,Canada
1947,2/1/2020,CAN,Melaka,0,0,0,Canada
1948,2/1/2020,CAN,Negeri Sembilan,0,0,0,Canada
1949,2/1/2020,CAN,Pahang,2,2,0,Canada
1950,2/1/2020,CAN,Perak,31,16,15,Canada
1951,2/1/2020,CAN,Perlis,84,51,33,Canada
1952,2/1/2020,CAN,Pulau Pinang,361,212,149,Canada
1953,2/1/2020,CAN,Sabah,183,102,81,Canada
1954,2/1/2020,CAN,Sarawak,383,233,150,Canada
1955,2/1/2020,CAN,Selangor,4474,2676,1798,Canada
1956,2/1/2020,CAN,Terengganu,0,0,0,Canada
1957,2/1/2020,CAN,W.P. Labuan,15,10,5,Canada
1958,2/1/2020,CCK,Selangor,0,0,0,Cocos (Keeling) Islands
1959,2/1/2020,CHE,Johor,401,240,161,Switzerland
1960,2/1/2020,CHE,Kedah,279,140,139,Switzerland
1961,2/1/2020,CHE,Kelantan,10,8,2,Switzerland
1962,2/1/2020,CHE,Melaka,1,1,0,Switzerland
1963,2/1/2020,CHE,Negeri Sembilan,0,0,0,Switzerland
1964,2/1/2020,CHE,Pahang,4,2,2,Switzerland
1965,2/1/2020,CHE,Perak,12,9,3,Switzerland
1966,2/1/2020,CHE,Perlis,51,29,22,Switzerland
1967,2/1/2020,CHE,Pulau Pinang,135,84,51,Switzerland
1968,2/1/2020,CHE,Sabah,51,25,26,Switzerland
1969,2/1/2020,CHE,Sarawak,48,27,21,Switzerland
1970,2/1/2020,CHE,Selangor,1420,866,554,Switzerland
1971,2/1/2020,CHE,W.P. Labuan,7,5,2,Switzerland
1972,2/1/2020,CHL,Johor,36,23,13,Chile
1973,2/1/2020,CHL,Kedah,58,27,31,Chile
1974,2/1/2020,CHL,Kelantan,2,1,1,Chile
1975,2/1/2020,CHL,Melaka,0,0,0,Chile
1976,2/1/2020,CHL,Pahang,0,0,0,Chile
1977,2/1/2020,CHL,Perak,1,1,0,Chile
1978,2/1/2020,CHL,Perlis,7,3,4,Chile
1979,2/1/2020,CHL,Pulau Pinang,9,3,6,Chile
1980,2/1/2020,CHL,Sabah,6,2,4,Chile
1981,2/1/2020,CHL,Sarawak,2,2,0,Chile
1982,2/1/2020,CHL,Selangor,471,217,254,Chile
1983,2/1/2020,CHN,Johor,8884,3906,4978,China
1984,2/1/2020,CHN,Kedah,749,298,451,China
1985,2/1/2020,CHN,Kelantan,10,6,4,China
1986,2/1/2020,CHN,Melaka,6,3,3,China
1987,2/1/2020,CHN,Pahang,6,3,3,China
1988,2/1/2020,CHN,Perak,255,89,166,China
1989,2/1/2020,CHN,Perlis,126,54,72,China
1990,2/1/2020,CHN,Pulau Pinang,2571,1330,1241,China
1991,2/1/2020,CHN,Sabah,772,370,402,China
1992,2/1/2020,CHN,Sarawak,446,147,299,China
1993,2/1/2020,CHN,Selangor,57021,32622,24399,China
1994,2/1/2020,CHN,Terengganu,0,0,0,China
1995,2/1/2020,CHN,W.P. Labuan,19,10,9,China
1996,2/1/2020,CIV,Johor,0,0,0,C��te d'Iv
1997,2/1/2020,CIV,Kedah,0,0,0,C��te d'Iv
1998,2/1/2020,CIV,Pulau Pinang,0,0,0,C��te d'Iv
1999,2/1/2020,CIV,Sabah,0,0,0,C��te d'Iv
2000,2/1/2020,CIV,Sarawak,0,0,0,C��te d'Iv
2001,2/1/2020,CIV,Selangor,12,6,6,C��te d'Iv
2002,2/1/2020,CMR,Johor,1,1,0,Cameroon
2003,2/1/2020,CMR,Kedah,0,0,0,Cameroon
2004,2/1/2020,CMR,Pulau Pinang,2,0,2,Cameroon
2005,2/1/2020,CMR,Sabah,1,1,0,Cameroon
2006,2/1/2020,CMR,Sarawak,2,2,0,Cameroon
2007,2/1/2020,CMR,Selangor,25,17,8,Cameroon
2008,2/1/2020,COD,Johor,0,0,0,"Congo, the Democratic Republic of the"
2009,2/1/2020,COD,Pulau Pinang,1,1,0,"Congo, the Democratic Republic of the"
2010,2/1/2020,COD,Sarawak,0,0,0,"Congo, the Democratic Republic of the"
2011,2/1/2020,COD,Selangor,9,8,1,"Congo, the Democratic Republic of the"
2012,2/1/2020,COG,Johor,0,0,0,Congo
2013,2/1/2020,COG,Kedah,0,0,0,Congo
2014,2/1/2020,COG,Selangor,3,1,2,Congo
2015,2/1/2020,COK,Selangor,0,0,0,Cook Islands
2016,2/1/2020,COL,Johor,7,5,2,Colombia
2017,2/1/2020,COL,Kedah,3,1,2,Colombia
2018,2/1/2020,COL,Perak,0,0,0,Colombia
2019,2/1/2020,COL,Pulau Pinang,3,3,0,Colombia
2020,2/1/2020,COL,Sabah,4,3,1,Colombia
2021,2/1/2020,COL,Sarawak,0,0,0,Colombia
2022,2/1/2020,COL,Selangor,120,57,63,Colombia
2023,2/1/2020,COL,W.P. Labuan,0,0,0,Colombia
2024,2/1/2020,COM,Johor,0,0,0,Comoros
2025,2/1/2020,COM,Kedah,0,0,0,Comoros
2026,2/1/2020,COM,Selangor,18,14,4,Comoros
2027,2/1/2020,CPV,Johor,2,2,0,Cape Verde
2028,2/1/2020,CPV,Kedah,0,0,0,Cape Verde
2029,2/1/2020,CPV,Pulau Pinang,0,0,0,Cape Verde
2030,2/1/2020,CPV,Sabah,0,0,0,Cape Verde
2031,2/1/2020,CPV,Selangor,3,2,1,Cape Verde
2032,2/1/2020,CRI,Johor,5,3,2,Costa Rica
2033,2/1/2020,CRI,Kedah,1,0,1,Costa Rica
2034,2/1/2020,CRI,Perak,0,0,0,Costa Rica
2035,2/1/2020,CRI,Perlis,0,0,0,Costa Rica
2036,2/1/2020,CRI,Pulau Pinang,1,0,1,Costa Rica
2037,2/1/2020,CRI,Sabah,0,0,0,Costa Rica
2038,2/1/2020,CRI,Sarawak,0,0,0,Costa Rica
2039,2/1/2020,CRI,Selangor,68,47,21,Costa Rica
2040,2/1/2020,CUB,Johor,6,6,0,Cuba
2041,2/1/2020,CUB,Kedah,0,0,0,Cuba
2042,2/1/2020,CUB,Perlis,0,0,0,Cuba
2043,2/1/2020,CUB,Pulau Pinang,0,0,0,Cuba
2044,2/1/2020,CUB,Sabah,0,0,0,Cuba
2045,2/1/2020,CUB,Sarawak,0,0,0,Cuba
2046,2/1/2020,CUB,Selangor,31,18,13,Cuba
2047,2/1/2020,CYP,Johor,11,6,5,Cyprus
2048,2/1/2020,CYP,Kedah,0,0,0,Cyprus
2049,2/1/2020,CYP,Perak,0,0,0,Cyprus
2050,2/1/2020,CYP,Perlis,0,0,0,Cyprus
2051,2/1/2020,CYP,Pulau Pinang,3,1,2,Cyprus
2052,2/1/2020,CYP,Sabah,3,2,1,Cyprus
2053,2/1/2020,CYP,Sarawak,0,0,0,Cyprus
2054,2/1/2020,CYP,Selangor,58,34,24,Cyprus
2055,2/1/2020,CZE,Johor,236,122,114,Czech Republic
2056,2/1/2020,CZE,Kedah,636,320,316,Czech Republic
2057,2/1/2020,CZE,Kelantan,4,4,0,Czech Republic
2058,2/1/2020,CZE,Melaka,0,0,0,Czech Republic
2059,2/1/2020,CZE,Negeri Sembilan,0,0,0,Czech Republic
2060,2/1/2020,CZE,Perak,0,0,0,Czech Republic
2061,2/1/2020,CZE,Perlis,13,7,6,Czech Republic
2062,2/1/2020,CZE,Pulau Pinang,109,47,62,Czech Republic
2063,2/1/2020,CZE,Sabah,51,25,26,Czech Republic
2064,2/1/2020,CZE,Sarawak,44,24,20,Czech Republic
2065,2/1/2020,CZE,Selangor,1050,585,465,Czech Republic
2066,2/1/2020,CZE,W.P. Labuan,8,5,3,Czech Republic
2067,2/1/2020,DEU,Johor,2021,1274,747,Germany
2068,2/1/2020,DEU,Kedah,1216,611,605,Germany
2069,2/1/2020,DEU,Kelantan,41,26,15,Germany
2070,2/1/2020,DEU,Melaka,5,2,3,Germany
2071,2/1/2020,DEU,Negeri Sembilan,0,0,0,Germany
2072,2/1/2020,DEU,Pahang,6,4,2,Germany
2073,2/1/2020,DEU,Perak,78,52,26,Germany
2074,2/1/2020,DEU,Perlis,247,137,110,Germany
2075,2/1/2020,DEU,Pulau Pinang,562,376,186,Germany
2076,2/1/2020,DEU,Sabah,254,133,121,Germany
2077,2/1/2020,DEU,Sarawak,283,174,109,Germany
2078,2/1/2020,DEU,Selangor,7642,4704,2938,Germany
2079,2/1/2020,DEU,Terengganu,0,0,0,Germany
2080,2/1/2020,DEU,W.P. Labuan,31,24,7,Germany
2081,2/1/2020,DJI,Johor,0,0,0,Djibouti
2082,2/1/2020,DJI,Selangor,24,15,9,Djibouti
2083,2/1/2020,DMA,Johor,3,2,1,Dominica
2084,2/1/2020,DMA,Kedah,0,0,0,Dominica
2085,2/1/2020,DMA,Pulau Pinang,1,1,0,Dominica
2086,2/1/2020,DMA,Sabah,0,0,0,Dominica
2087,2/1/2020,DMA,Sarawak,0,0,0,Dominica
2088,2/1/2020,DMA,Selangor,40,32,8,Dominica
2089,2/1/2020,DMA,W.P. Labuan,1,1,0,Dominica
2090,2/1/2020,DNK,Johor,352,222,130,Denmark
2091,2/1/2020,DNK,Kedah,472,209,263,Denmark
2092,2/1/2020,DNK,Kelantan,2,1,1,Denmark
2093,2/1/2020,DNK,Melaka,2,2,0,Denmark
2094,2/1/2020,DNK,Negeri Sembilan,0,0,0,Denmark
2095,2/1/2020,DNK,Pahang,0,0,0,Denmark
2096,2/1/2020,DNK,Perak,0,0,0,Denmark
2097,2/1/2020,DNK,Perlis,24,19,5,Denmark
2098,2/1/2020,DNK,Pulau Pinang,190,86,104,Denmark
2099,2/1/2020,DNK,Sabah,105,64,41,Denmark
2100,2/1/2020,DNK,Sarawak,39,20,19,Denmark
2101,2/1/2020,DNK,Selangor,1816,1042,774,Denmark
2102,2/1/2020,DNK,W.P. Labuan,7,4,3,Denmark
2103,2/1/2020,DOM,Johor,3,2,1,Dominican Republic
2104,2/1/2020,DOM,Kedah,0,0,0,Dominican Republic
2105,2/1/2020,DOM,Perak,0,0,0,Dominican Republic
2106,2/1/2020,DOM,Perlis,0,0,0,Dominican Republic
2107,2/1/2020,DOM,Pulau Pinang,1,1,0,Dominican Republic
2108,2/1/2020,DOM,Sabah,0,0,0,Dominican Republic
2109,2/1/2020,DOM,Sarawak,1,1,0,Dominican Republic
2110,2/1/2020,DOM,Selangor,30,19,11,Dominican Republic
2111,2/1/2020,DZA,Johor,26,25,1,Algeria
2112,2/1/2020,DZA,Kedah,29,21,8,Algeria
2113,2/1/2020,DZA,Kelantan,0,0,0,Algeria
2114,2/1/2020,DZA,Melaka,0,0,0,Algeria
2115,2/1/2020,DZA,Perak,0,0,0,Algeria
2116,2/1/2020,DZA,Perlis,0,0,0,Algeria
2117,2/1/2020,DZA,Pulau Pinang,12,7,5,Algeria
2118,2/1/2020,DZA,Sabah,0,0,0,Algeria
2119,2/1/2020,DZA,Sarawak,6,2,4,Algeria
2120,2/1/2020,DZA,Selangor,843,604,239,Algeria
2121,2/1/2020,DZA,W.P. Labuan,0,0,0,Algeria
2122,2/1/2020,ECU,Johor,9,7,2,Ecuador
2123,2/1/2020,ECU,Kedah,2,0,2,Ecuador
2124,2/1/2020,ECU,Perak,0,0,0,Ecuador
2125,2/1/2020,ECU,Perlis,0,0,0,Ecuador
2126,2/1/2020,ECU,Pulau Pinang,0,0,0,Ecuador
2127,2/1/2020,ECU,Sabah,0,0,0,Ecuador
2128,2/1/2020,ECU,Sarawak,6,1,5,Ecuador
2129,2/1/2020,ECU,Selangor,63,32,31,Ecuador
2130,2/1/2020,EGY,Johor,193,170,23,Egypt
2131,2/1/2020,EGY,Kedah,15,9,6,Egypt
2132,2/1/2020,EGY,Kelantan,3,3,0,Egypt
2133,2/1/2020,EGY,Melaka,0,0,0,Egypt
2134,2/1/2020,EGY,Pahang,0,0,0,Egypt
2135,2/1/2020,EGY,Perak,0,0,0,Egypt
2136,2/1/2020,EGY,Perlis,2,2,0,Egypt
2137,2/1/2020,EGY,Pulau Pinang,7,6,1,Egypt
2138,2/1/2020,EGY,Sabah,5,2,3,Egypt
2139,2/1/2020,EGY,Sarawak,43,36,7,Egypt
2140,2/1/2020,EGY,Selangor,2590,1764,826,Egypt
2141,2/1/2020,EGY,Terengganu,0,0,0,Egypt
2142,2/1/2020,EGY,W.P. Labuan,4,4,0,Egypt
2143,2/1/2020,ERI,Johor,0,0,0,Eritrea
2144,2/1/2020,ERI,Pulau Pinang,0,0,0,Eritrea
2145,2/1/2020,ERI,Sabah,2,1,1,Eritrea
2146,2/1/2020,ERI,Selangor,29,20,9,Eritrea
2147,2/1/2020,ESP,Johor,330,215,115,Spain
2148,2/1/2020,ESP,Kedah,254,117,137,Spain
2149,2/1/2020,ESP,Kelantan,10,6,4,Spain
2150,2/1/2020,ESP,Melaka,1,1,0,Spain
2151,2/1/2020,ESP,Negeri Sembilan,0,0,0,Spain
2152,2/1/2020,ESP,Pahang,0,0,0,Spain
2153,2/1/2020,ESP,Perak,6,4,2,Spain
2154,2/1/2020,ESP,Perlis,35,21,14,Spain
2155,2/1/2020,ESP,Pulau Pinang,67,40,27,Spain
2156,2/1/2020,ESP,Sabah,61,38,23,Spain
2157,2/1/2020,ESP,Sarawak,54,29,25,Spain
2158,2/1/2020,ESP,Selangor,2058,1246,812,Spain
2159,2/1/2020,ESP,W.P. Labuan,7,3,4,Spain
2160,2/1/2020,EST,Johor,59,29,30,Estonia
2161,2/1/2020,EST,Kedah,115,56,59,Estonia
2162,2/1/2020,EST,Kelantan,0,0,0,Estonia
2163,2/1/2020,EST,Pahang,0,0,0,Estonia
2164,2/1/2020,EST,Perak,0,0,0,Estonia
2165,2/1/2020,EST,Perlis,3,2,1,Estonia
2166,2/1/2020,EST,Pulau Pinang,6,3,3,Estonia
2167,2/1/2020,EST,Sabah,5,2,3,Estonia
2168,2/1/2020,EST,Sarawak,10,4,6,Estonia
2169,2/1/2020,EST,Selangor,515,250,265,Estonia
2170,2/1/2020,EST,W.P. Labuan,0,0,0,Estonia
2171,2/1/2020,ETH,Johor,2,2,0,Ethiopia
2172,2/1/2020,ETH,Kedah,0,0,0,Ethiopia
2173,2/1/2020,ETH,Pulau Pinang,0,0,0,Ethiopia
2174,2/1/2020,ETH,Sarawak,0,0,0,Ethiopia
2175,2/1/2020,ETH,Selangor,37,24,13,Ethiopia
2176,2/1/2020,FIN,Johor,241,136,105,Finland
2177,2/1/2020,FIN,Kedah,459,207,252,Finland
2178,2/1/2020,FIN,Kelantan,4,2,2,Finland
2179,2/1/2020,FIN,Melaka,0,0,0,Finland
2180,2/1/2020,FIN,Negeri Sembilan,0,0,0,Finland
2181,2/1/2020,FIN,Pahang,0,0,0,Finland
2182,2/1/2020,FIN,Perak,1,1,0,Finland
2183,2/1/2020,FIN,Perlis,13,9,4,Finland
2184,2/1/2020,FIN,Pulau Pinang,134,71,63,Finland
2185,2/1/2020,FIN,Sabah,41,21,20,Finland
2186,2/1/2020,FIN,Sarawak,20,11,9,Finland
2187,2/1/2020,FIN,Selangor,1584,849,735,Finland
2188,2/1/2020,FIN,W.P. Labuan,1,1,0,Finland
2189,2/1/2020,FJI,Johor,27,15,12,Fiji
2190,2/1/2020,FJI,Kedah,3,2,1,Fiji
2191,2/1/2020,FJI,Kelantan,0,0,0,Fiji
2192,2/1/2020,FJI,Perak,0,0,0,Fiji
2193,2/1/2020,FJI,Perlis,0,0,0,Fiji
2194,2/1/2020,FJI,Pulau Pinang,3,3,0,Fiji
2195,2/1/2020,FJI,Sabah,1,0,1,Fiji
2196,2/1/2020,FJI,Sarawak,1,1,0,Fiji
2197,2/1/2020,FJI,Selangor,77,48,29,Fiji
2198,2/1/2020,FRA,Johor,2063,1231,832,France
2199,2/1/2020,FRA,Kedah,1396,726,670,France
2200,2/1/2020,FRA,Kelantan,83,58,25,France
2201,2/1/2020,FRA,Melaka,5,4,1,France
2202,2/1/2020,FRA,Negeri Sembilan,0,0,0,France
2203,2/1/2020,FRA,Pahang,41,21,20,France
2204,2/1/2020,FRA,Perak,23,16,7,France
2205,2/1/2020,FRA,Perlis,122,79,43,France
2206,2/1/2020,FRA,Pulau Pinang,548,322,226,France
2207,2/1/2020,FRA,Sabah,173,105,68,France
2208,2/1/2020,FRA,Sarawak,143,91,52,France
2209,2/1/2020,FRA,Selangor,9806,5882,3924,France
2210,2/1/2020,FRA,Terengganu,0,0,0,France
2211,2/1/2020,FRA,W.P. Labuan,11,9,2,France
2212,2/1/2020,FSM,Johor,0,0,0,"Micronesia, Federated States of"
2213,2/1/2020,FSM,Pulau Pinang,0,0,0,"Micronesia, Federated States of"
2214,2/1/2020,FSM,Selangor,0,0,0,"Micronesia, Federated States of"
2215,2/1/2020,GAB,Johor,0,0,0,Gabon
2216,2/1/2020,GAB,Pulau Pinang,0,0,0,Gabon
2217,2/1/2020,GAB,Sarawak,0,0,0,Gabon
2218,2/1/2020,GAB,Selangor,6,4,2,Gabon
2219,2/1/2020,GBR,Johor,4194,2809,1385,United Kingdom
2220,2/1/2020,GBR,Kedah,1699,906,793,United Kingdom
2221,2/1/2020,GBR,Kelantan,72,55,17,United Kingdom
2222,2/1/2020,GBR,Melaka,2,2,0,United Kingdom
2223,2/1/2020,GBR,Negeri Sembilan,0,0,0,United Kingdom
2224,2/1/2020,GBR,Pahang,19,14,5,United Kingdom
2225,2/1/2020,GBR,Perak,89,55,34,United Kingdom
2226,2/1/2020,GBR,Perlis,367,228,139,United Kingdom
2227,2/1/2020,GBR,Pulau Pinang,1616,946,670,United Kingdom
2228,2/1/2020,GBR,Sabah,639,340,299,United Kingdom
2229,2/1/2020,GBR,Sarawak,1159,757,402,United Kingdom
2230,2/1/2020,GBR,Selangor,18590,11608,6982,United Kingdom
2231,2/1/2020,GBR,Terengganu,0,0,0,United Kingdom
2232,2/1/2020,GBR,W.P. Labuan,74,48,26,United Kingdom
2233,2/1/2020,GEO,Johor,10,7,3,Georgia
2234,2/1/2020,GEO,Kedah,13,10,3,Georgia
2235,2/1/2020,GEO,Melaka,0,0,0,Georgia
2236,2/1/2020,GEO,Perak,0,0,0,Georgia
2237,2/1/2020,GEO,Perlis,0,0,0,Georgia
2238,2/1/2020,GEO,Pulau Pinang,3,1,2,Georgia
2239,2/1/2020,GEO,Sabah,0,0,0,Georgia
2240,2/1/2020,GEO,Sarawak,0,0,0,Georgia
2241,2/1/2020,GEO,Selangor,31,22,9,Georgia
2242,2/1/2020,GHA,Johor,2,2,0,Ghana
2243,2/1/2020,GHA,Kedah,0,0,0,Ghana
2244,2/1/2020,GHA,Kelantan,0,0,0,Ghana
2245,2/1/2020,GHA,Pulau Pinang,0,0,0,Ghana
2246,2/1/2020,GHA,Sabah,0,0,0,Ghana
2247,2/1/2020,GHA,Sarawak,0,0,0,Ghana
2248,2/1/2020,GHA,Selangor,52,41,11,Ghana
2249,2/1/2020,GIB,Johor,0,0,0,Gibraltar
2250,2/1/2020,GIB,Sarawak,0,0,0,Gibraltar
2251,2/1/2020,GIN,Johor,8,8,0,Guinea
2252,2/1/2020,GIN,Kedah,0,0,0,Guinea
2253,2/1/2020,GIN,Kelantan,0,0,0,Guinea
2254,2/1/2020,GIN,Perlis,0,0,0,Guinea
2255,2/1/2020,GIN,Pulau Pinang,0,0,0,Guinea
2256,2/1/2020,GIN,Sabah,1,1,0,Guinea
2257,2/1/2020,GIN,Sarawak,0,0,0,Guinea
2258,2/1/2020,GIN,Selangor,56,45,11,Guinea
2259,2/1/2020,GLP,Selangor,0,0,0,Guadeloupe
2260,2/1/2020,GMB,Johor,0,0,0,Gambia
2261,2/1/2020,GMB,Kedah,1,0,1,Gambia
2262,2/1/2020,GMB,Kelantan,0,0,0,Gambia
2263,2/1/2020,GMB,Pulau Pinang,3,2,1,Gambia
2264,2/1/2020,GMB,Sabah,0,0,0,Gambia
2265,2/1/2020,GMB,Sarawak,1,1,0,Gambia
2266,2/1/2020,GMB,Selangor,53,44,9,Gambia
2267,2/1/2020,GNB,Johor,2,2,0,Guinea-Bissau
2268,2/1/2020,GNB,Selangor,0,0,0,Guinea-Bissau
2269,2/1/2020,GNQ,Johor,0,0,0,Equatorial Guinea
2270,2/1/2020,GNQ,Selangor,1,0,1,Equatorial Guinea
2271,2/1/2020,GRC,Johor,39,30,9,Greece
2272,2/1/2020,GRC,Kedah,23,16,7,Greece
2273,2/1/2020,GRC,Kelantan,0,0,0,Greece
2274,2/1/2020,GRC,Melaka,0,0,0,Greece
2275,2/1/2020,GRC,Negeri Sembilan,0,0,0,Greece
2276,2/1/2020,GRC,Pahang,3,3,0,Greece
2277,2/1/2020,GRC,Perak,0,0,0,Greece
2278,2/1/2020,GRC,Perlis,5,5,0,Greece
2279,2/1/2020,GRC,Pulau Pinang,7,7,0,Greece
2280,2/1/2020,GRC,Sabah,2,1,1,Greece
2281,2/1/2020,GRC,Sarawak,15,11,4,Greece
2282,2/1/2020,GRC,Selangor,267,191,76,Greece
2283,2/1/2020,GRD,Johor,7,5,2,Grenada
2284,2/1/2020,GRD,Kedah,0,0,0,Grenada
2285,2/1/2020,GRD,Pulau Pinang,1,1,0,Grenada
2286,2/1/2020,GRD,Sabah,0,0,0,Grenada
2287,2/1/2020,GRD,Sarawak,0,0,0,Grenada
2288,2/1/2020,GRD,Selangor,7,4,3,Grenada
2289,2/1/2020,GRL,Johor,0,0,0,Greenland
2290,2/1/2020,GRL,Selangor,0,0,0,Greenland
2291,2/1/2020,GTM,Johor,2,1,1,Guatemala
2292,2/1/2020,GTM,Kedah,1,1,0,Guatemala
2293,2/1/2020,GTM,Pahang,0,0,0,Guatemala
2294,2/1/2020,GTM,Perak,0,0,0,Guatemala
2295,2/1/2020,GTM,Pulau Pinang,0,0,0,Guatemala
2296,2/1/2020,GTM,Sabah,1,0,1,Guatemala
2297,2/1/2020,GTM,Sarawak,0,0,0,Guatemala
2298,2/1/2020,GTM,Selangor,13,9,4,Guatemala
2299,2/1/2020,GTM,W.P. Labuan,0,0,0,Guatemala
2300,2/1/2020,GUY,Johor,0,0,0,Guyana
2301,2/1/2020,GUY,Kedah,1,0,1,Guyana
2302,2/1/2020,GUY,Pulau Pinang,0,0,0,Guyana
2303,2/1/2020,GUY,Sarawak,0,0,0,Guyana
2304,2/1/2020,GUY,Selangor,4,2,2,Guyana
2305,2/1/2020,HKG,Johor,3,0,3,Hong Kong
2306,2/1/2020,HKG,Kedah,0,0,0,Hong Kong
2307,2/1/2020,HKG,Kelantan,0,0,0,Hong Kong
2308,2/1/2020,HKG,Pahang,0,0,0,Hong Kong
2309,2/1/2020,HKG,Perak,20,12,8,Hong Kong
2310,2/1/2020,HKG,Perlis,0,0,0,Hong Kong
2311,2/1/2020,HKG,Pulau Pinang,0,0,0,Hong Kong
2312,2/1/2020,HKG,Sabah,0,0,0,Hong Kong
2313,2/1/2020,HKG,Sarawak,7,4,3,Hong Kong
2314,2/1/2020,HKG,Selangor,0,0,0,Hong Kong
2315,2/1/2020,HKG,Terengganu,0,0,0,Hong Kong
2316,2/1/2020,HMD,Johor,0,0,0,Heard Island and McDonald Islands
2317,2/1/2020,HND,Johor,8,3,5,Honduras
2318,2/1/2020,HND,Kedah,0,0,0,Honduras
2319,2/1/2020,HND,Perak,0,0,0,Honduras
2320,2/1/2020,HND,Pulau Pinang,1,1,0,Honduras
2321,2/1/2020,HND,Sabah,0,0,0,Honduras
2322,2/1/2020,HND,Sarawak,1,1,0,Honduras
2323,2/1/2020,HND,Selangor,13,11,2,Honduras
2324,2/1/2020,HRV,Johor,30,29,1,Croatia
2325,2/1/2020,HRV,Kedah,18,10,8,Croatia
2326,2/1/2020,HRV,Kelantan,0,0,0,Croatia
2327,2/1/2020,HRV,Melaka,0,0,0,Croatia
2328,2/1/2020,HRV,Pahang,10,9,1,Croatia
2329,2/1/2020,HRV,Perak,0,0,0,Croatia
2330,2/1/2020,HRV,Perlis,3,2,1,Croatia
2331,2/1/2020,HRV,Pulau Pinang,3,2,1,Croatia
2332,2/1/2020,HRV,Sabah,5,2,3,Croatia
2333,2/1/2020,HRV,Sarawak,3,3,0,Croatia
2334,2/1/2020,HRV,Selangor,248,165,83,Croatia
2335,2/1/2020,HTI,Johor,0,0,0,Haiti
2336,2/1/2020,HTI,Kedah,0,0,0,Haiti
2337,2/1/2020,HTI,Kelantan,0,0,0,Haiti
2338,2/1/2020,HTI,Perak,0,0,0,Haiti
2339,2/1/2020,HTI,Pulau Pinang,0,0,0,Haiti
2340,2/1/2020,HTI,Sabah,0,0,0,Haiti
2341,2/1/2020,HTI,Selangor,10,8,2,Haiti
2342,2/1/2020,HUN,Johor,59,39,20,Hungary
2343,2/1/2020,HUN,Kedah,388,190,198,Hungary
2344,2/1/2020,HUN,Kelantan,4,3,1,Hungary
2345,2/1/2020,HUN,Pahang,0,0,0,Hungary
2346,2/1/2020,HUN,Perak,0,0,0,Hungary
2347,2/1/2020,HUN,Perlis,5,2,3,Hungary
2348,2/1/2020,HUN,Pulau Pinang,44,20,24,Hungary
2349,2/1/2020,HUN,Sabah,9,5,4,Hungary
2350,2/1/2020,HUN,Sarawak,10,9,1,Hungary
2351,2/1/2020,HUN,Selangor,1119,568,551,Hungary
2352,2/1/2020,HUN,W.P. Labuan,2,1,1,Hungary
2353,2/1/2020,IDN,Johor,105615,60705,44910,Indonesia
2354,2/1/2020,IDN,Kedah,2058,885,1173,Indonesia
2355,2/1/2020,IDN,Kelantan,231,164,67,Indonesia
2356,2/1/2020,IDN,Melaka,3134,1430,1704,Indonesia
2357,2/1/2020,IDN,Negeri Sembilan,3252,2145,1107,Indonesia
2358,2/1/2020,IDN,Pahang,14,12,2,Indonesia
2359,2/1/2020,IDN,Perak,134,57,77,Indonesia
2360,2/1/2020,IDN,Perlis,351,179,172,Indonesia
2361,2/1/2020,IDN,Pulau Pinang,21871,8620,13251,Indonesia
2362,2/1/2020,IDN,Sabah,4181,2264,1917,Indonesia
2363,2/1/2020,IDN,Sarawak,28788,17818,10970,Indonesia
2364,2/1/2020,IDN,Selangor,108102,52727,55375,Indonesia
2365,2/1/2020,IDN,Terengganu,1,1,0,Indonesia
2366,2/1/2020,IDN,W.P. Labuan,95,68,27,Indonesia
2367,2/1/2020,IND,Johor,13646,10636,3010,India
2368,2/1/2020,IND,Kedah,510,315,195,India
2369,2/1/2020,IND,Kelantan,15,10,5,India
2370,2/1/2020,IND,Melaka,20,19,1,India
2371,2/1/2020,IND,Negeri Sembilan,0,0,0,India
2372,2/1/2020,IND,Pahang,22,14,8,India
2373,2/1/2020,IND,Perak,276,176,100,India
2374,2/1/2020,IND,Perlis,30,18,12,India
2375,2/1/2020,IND,Pulau Pinang,467,335,132,India
2376,2/1/2020,IND,Sabah,96,81,15,India
2377,2/1/2020,IND,Sarawak,1505,1340,165,India
2378,2/1/2020,IND,Selangor,55552,42134,13418,India
2379,2/1/2020,IND,Terengganu,0,0,0,India
2380,2/1/2020,IND,W.P. Labuan,57,48,9,India
2381,2/1/2020,IOT,Pulau Pinang,0,0,0,British Indian Ocean Territory
2382,2/1/2020,IOT,Selangor,0,0,0,British Indian Ocean Territory
2383,2/1/2020,IRL,Johor,238,152,86,Ireland
2384,2/1/2020,IRL,Kedah,97,50,47,Ireland
2385,2/1/2020,IRL,Kelantan,1,1,0,Ireland
2386,2/1/2020,IRL,Negeri Sembilan,0,0,0,Ireland
2387,2/1/2020,IRL,Pahang,1,0,1,Ireland
2388,2/1/2020,IRL,Perak,6,4,2,Ireland
2389,2/1/2020,IRL,Perlis,22,15,7,Ireland
2390,2/1/2020,IRL,Pulau Pinang,87,53,34,Ireland
2391,2/1/2020,IRL,Sabah,37,17,20,Ireland
2392,2/1/2020,IRL,Sarawak,31,18,13,Ireland
2393,2/1/2020,IRL,Selangor,1126,705,421,Ireland
2394,2/1/2020,IRL,Terengganu,0,0,0,Ireland
2395,2/1/2020,IRL,W.P. Labuan,1,1,0,Ireland
2396,2/1/2020,IRN,Johor,483,246,237,Iran
2397,2/1/2020,IRN,Kedah,11,8,3,Iran
2398,2/1/2020,IRN,Kelantan,0,0,0,Iran
2399,2/1/2020,IRN,Perak,0,0,0,Iran
2400,2/1/2020,IRN,Perlis,3,2,1,Iran
2401,2/1/2020,IRN,Pulau Pinang,3,2,1,Iran
2402,2/1/2020,IRN,Sabah,6,3,3,Iran
2403,2/1/2020,IRN,Sarawak,5,3,2,Iran
2404,2/1/2020,IRN,Selangor,3439,1887,1552,Iran
2405,2/1/2020,IRN,W.P. Labuan,0,0,0,Iran
2406,2/1/2020,IRQ,Johor,14,10,4,Iraq
2407,2/1/2020,IRQ,Kedah,0,0,0,Iraq
2408,2/1/2020,IRQ,Kelantan,0,0,0,Iraq
2409,2/1/2020,IRQ,Melaka,0,0,0,Iraq
2410,2/1/2020,IRQ,Pahang,0,0,0,Iraq
2411,2/1/2020,IRQ,Perak,0,0,0,Iraq
2412,2/1/2020,IRQ,Perlis,0,0,0,Iraq
2413,2/1/2020,IRQ,Pulau Pinang,9,4,5,Iraq
2414,2/1/2020,IRQ,Sabah,1,1,0,Iraq
2415,2/1/2020,IRQ,Sarawak,0,0,0,Iraq
2416,2/1/2020,IRQ,Selangor,1563,1052,511,Iraq
2417,2/1/2020,ISL,Johor,2,2,0,Iceland
2418,2/1/2020,ISL,Kedah,2,2,0,Iceland
2419,2/1/2020,ISL,Kelantan,0,0,0,Iceland
2420,2/1/2020,ISL,Perak,0,0,0,Iceland
2421,2/1/2020,ISL,Perlis,0,0,0,Iceland
2422,2/1/2020,ISL,Pulau Pinang,1,0,1,Iceland
2423,2/1/2020,ISL,Sabah,10,5,5,Iceland
2424,2/1/2020,ISL,Sarawak,3,2,1,Iceland
2425,2/1/2020,ISL,Selangor,75,40,35,Iceland
2426,2/1/2020,ISL,W.P. Labuan,5,3,2,Iceland
2427,2/1/2020,ISR,Pulau Pinang,0,0,0,Israel
2428,2/1/2020,ITA,Johor,465,347,118,Italy
2429,2/1/2020,ITA,Kedah,625,362,263,Italy
2430,2/1/2020,ITA,Kelantan,19,16,3,Italy
2431,2/1/2020,ITA,Melaka,2,2,0,Italy
2432,2/1/2020,ITA,Negeri Sembilan,0,0,0,Italy
2433,2/1/2020,ITA,Pahang,1,0,1,Italy
2434,2/1/2020,ITA,Perak,11,7,4,Italy
2435,2/1/2020,ITA,Perlis,57,41,16,Italy
2436,2/1/2020,ITA,Pulau Pinang,89,62,27,Italy
2437,2/1/2020,ITA,Sabah,70,44,26,Italy
2438,2/1/2020,ITA,Sarawak,68,47,21,Italy
2439,2/1/2020,ITA,Selangor,2963,2055,908,Italy
2440,2/1/2020,ITA,W.P. Labuan,2,1,1,Italy
2441,2/1/2020,JAM,Johor,4,2,2,Jamaica
2442,2/1/2020,JAM,Kedah,0,0,0,Jamaica
2443,2/1/2020,JAM,Perak,0,0,0,Jamaica
2444,2/1/2020,JAM,Pulau Pinang,1,1,0,Jamaica
2445,2/1/2020,JAM,Sabah,1,1,0,Jamaica
2446,2/1/2020,JAM,Sarawak,0,0,0,Jamaica
2447,2/1/2020,JAM,Selangor,22,9,13,Jamaica
2448,2/1/2020,JAM,W.P. Labuan,0,0,0,Jamaica
2449,2/1/2020,JOR,Johor,28,8,20,Jordan
2450,2/1/2020,JOR,Kedah,39,24,15,Jordan
2451,2/1/2020,JOR,Kelantan,0,0,0,Jordan
2452,2/1/2020,JOR,Melaka,0,0,0,Jordan
2453,2/1/2020,JOR,Perlis,2,2,0,Jordan
2454,2/1/2020,JOR,Pulau Pinang,22,13,9,Jordan
2455,2/1/2020,JOR,Sabah,1,0,1,Jordan
2456,2/1/2020,JOR,Sarawak,1,1,0,Jordan
2457,2/1/2020,JOR,Selangor,829,584,245,Jordan
2458,2/1/2020,JOR,W.P. Labuan,0,0,0,Jordan
2459,2/1/2020,JPN,Johor,7273,4928,2345,Japan
2460,2/1/2020,JPN,Kedah,280,140,140,Japan
2461,2/1/2020,JPN,Kelantan,10,9,1,Japan
2462,2/1/2020,JPN,Melaka,5,4,1,Japan
2463,2/1/2020,JPN,Negeri Sembilan,0,0,0,Japan
2464,2/1/2020,JPN,Pahang,6,5,1,Japan
2465,2/1/2020,JPN,Perak,55,35,20,Japan
2466,2/1/2020,JPN,Perlis,118,99,19,Japan
2467,2/1/2020,JPN,Pulau Pinang,1378,996,382,Japan
2468,2/1/2020,JPN,Sabah,1123,555,568,Japan
2469,2/1/2020,JPN,Sarawak,237,172,65,Japan
2470,2/1/2020,JPN,Selangor,30796,18629,12167,Japan
2471,2/1/2020,JPN,W.P. Labuan,31,16,15,Japan
2472,2/1/2020,KAZ,Johor,38,15,23,Kazakhstan
2473,2/1/2020,KAZ,Kedah,80,35,45,Kazakhstan
2474,2/1/2020,KAZ,Kelantan,7,3,4,Kazakhstan
2475,2/1/2020,KAZ,Melaka,1,1,0,Kazakhstan
2476,2/1/2020,KAZ,Perak,1,0,1,Kazakhstan
2477,2/1/2020,KAZ,Perlis,3,3,0,Kazakhstan
2478,2/1/2020,KAZ,Pulau Pinang,3,2,1,Kazakhstan
2479,2/1/2020,KAZ,Sabah,11,6,5,Kazakhstan
2480,2/1/2020,KAZ,Sarawak,3,0,3,Kazakhstan
2481,2/1/2020,KAZ,Selangor,2340,994,1346,Kazakhstan
2482,2/1/2020,KAZ,W.P. Labuan,1,1,0,Kazakhstan
2483,2/1/2020,KEN,Johor,30,16,14,Kenya
2484,2/1/2020,KEN,Kedah,2,0,2,Kenya
2485,2/1/2020,KEN,Kelantan,0,0,0,Kenya
2486,2/1/2020,KEN,Perak,0,0,0,Kenya
2487,2/1/2020,KEN,Perlis,1,0,1,Kenya
2488,2/1/2020,KEN,Pulau Pinang,3,2,1,Kenya
2489,2/1/2020,KEN,Sabah,1,1,0,Kenya
2490,2/1/2020,KEN,Sarawak,3,2,1,Kenya
2491,2/1/2020,KEN,Selangor,313,169,144,Kenya
2492,2/1/2020,KGZ,Johor,15,13,2,Kyrgyzstan
2493,2/1/2020,KGZ,Kedah,9,7,2,Kyrgyzstan
2494,2/1/2020,KGZ,Kelantan,0,0,0,Kyrgyzstan
2495,2/1/2020,KGZ,Perak,0,0,0,Kyrgyzstan
2496,2/1/2020,KGZ,Perlis,0,0,0,Kyrgyzstan
2497,2/1/2020,KGZ,Pulau Pinang,5,2,3,Kyrgyzstan
2498,2/1/2020,KGZ,Sabah,2,2,0,Kyrgyzstan
2499,2/1/2020,KGZ,Sarawak,0,0,0,Kyrgyzstan
2500,2/1/2020,KGZ,Selangor,329,146,183,Kyrgyzstan
2501,2/1/2020,KHM,Johor,1507,603,904,Cambodia
2502,2/1/2020,KHM,Kedah,167,82,85,Cambodia
2503,2/1/2020,KHM,Kelantan,1617,1336,281,Cambodia
2504,2/1/2020,KHM,Melaka,0,0,0,Cambodia
2505,2/1/2020,KHM,Negeri Sembilan,2,2,0,Cambodia
2506,2/1/2020,KHM,Pahang,0,0,0,Cambodia
2507,2/1/2020,KHM,Perak,27,23,4,Cambodia
2508,2/1/2020,KHM,Perlis,600,439,161,Cambodia
2509,2/1/2020,KHM,Pulau Pinang,9,3,6,Cambodia
2510,2/1/2020,KHM,Sabah,0,0,0,Cambodia
2511,2/1/2020,KHM,Sarawak,22,5,17,Cambodia
2512,2/1/2020,KHM,Selangor,4005,2113,1892,Cambodia
2513,2/1/2020,KHM,W.P. Labuan,0,0,0,Cambodia
2514,2/1/2020,KIR,Johor,1,1,0,Kiribati
2515,2/1/2020,KIR,Sabah,0,0,0,Kiribati
2516,2/1/2020,KIR,Selangor,2,1,1,Kiribati
2517,2/1/2020,KNA,Johor,6,5,1,Saint Kitts and Nevis
2518,2/1/2020,KNA,Kedah,0,0,0,Saint Kitts and Nevis
2519,2/1/2020,KNA,Perlis,0,0,0,Saint Kitts and Nevis
2520,2/1/2020,KNA,Pulau Pinang,4,1,3,Saint Kitts and Nevis
2521,2/1/2020,KNA,Sabah,0,0,0,Saint Kitts and Nevis
2522,2/1/2020,KNA,Selangor,36,30,6,Saint Kitts and Nevis
2523,2/1/2020,KNA,W.P. Labuan,0,0,0,Saint Kitts and Nevis
2524,2/1/2020,KOR,Johor,7227,3977,3250,"Korea, Republic of (South Korea)"
2525,2/1/2020,KOR,Kedah,271,138,133,"Korea, Republic of (South Korea)"
2526,2/1/2020,KOR,Kelantan,6,5,1,"Korea, Republic of (South Korea)"
2527,2/1/2020,KOR,Melaka,1,0,1,"Korea, Republic of (South Korea)"
2528,2/1/2020,KOR,Negeri Sembilan,0,0,0,"Korea, Republic of (South Korea)"
2529,2/1/2020,KOR,Pahang,4,1,3,"Korea, Republic of (South Korea)"
2530,2/1/2020,KOR,Perak,11,4,7,"Korea, Republic of (South Korea)"
2531,2/1/2020,KOR,Perlis,87,61,26,"Korea, Republic of (South Korea)"
2532,2/1/2020,KOR,Pulau Pinang,262,142,120,"Korea, Republic of (South Korea)"
2533,2/1/2020,KOR,Sabah,14366,6032,8334,"Korea, Republic of (South Korea)"
2534,2/1/2020,KOR,Sarawak,306,183,123,"Korea, Republic of (South Korea)"
2535,2/1/2020,KOR,Selangor,13031,7279,5752,"Korea, Republic of (South Korea)"
2536,2/1/2020,KOR,Terengganu,1,1,0,"Korea, Republic of (South Korea)"
2537,2/1/2020,KOR,W.P. Labuan,23,17,6,"Korea, Republic of (South Korea)"
2538,2/1/2020,KWT,Johor,5,4,1,Kuwait
2539,2/1/2020,KWT,Kedah,2,2,0,Kuwait
2540,2/1/2020,KWT,Kelantan,0,0,0,Kuwait
2541,2/1/2020,KWT,Perak,0,0,0,Kuwait
2542,2/1/2020,KWT,Perlis,0,0,0,Kuwait
2543,2/1/2020,KWT,Pulau Pinang,3,2,1,Kuwait
2544,2/1/2020,KWT,Sabah,0,0,0,Kuwait
2545,2/1/2020,KWT,Sarawak,0,0,0,Kuwait
2546,2/1/2020,KWT,Selangor,185,126,59,Kuwait
2547,2/1/2020,KWT,W.P. Labuan,0,0,0,Kuwait
2548,2/1/2020,LAO,Johor,128,38,90,Lao People's Democratic Republic
2549,2/1/2020,LAO,Kedah,1129,86,1043,Lao People's Democratic Republic
2550,2/1/2020,LAO,Kelantan,759,654,105,Lao People's Democratic Republic
2551,2/1/2020,LAO,Melaka,0,0,0,Lao People's Democratic Republic
2552,2/1/2020,LAO,Perak,11,0,11,Lao People's Democratic Republic
2553,2/1/2020,LAO,Perlis,423,136,287,Lao People's Democratic Republic
2554,2/1/2020,LAO,Pulau Pinang,13,3,10,Lao People's Democratic Republic
2555,2/1/2020,LAO,Sabah,1,0,1,Lao People's Democratic Republic
2556,2/1/2020,LAO,Sarawak,4,0,4,Lao People's Democratic Republic
2557,2/1/2020,LAO,Selangor,395,136,259,Lao People's Democratic Republic
2558,2/1/2020,LAO,W.P. Labuan,0,0,0,Lao People's Democratic Republic
2559,2/1/2020,LBN,Johor,8,5,3,Lebanon
2560,2/1/2020,LBN,Kedah,3,2,1,Lebanon
2561,2/1/2020,LBN,Kelantan,1,1,0,Lebanon
2562,2/1/2020,LBN,Pahang,0,0,0,Lebanon
2563,2/1/2020,LBN,Perak,0,0,0,Lebanon
2564,2/1/2020,LBN,Perlis,0,0,0,Lebanon
2565,2/1/2020,LBN,Pulau Pinang,6,3,3,Lebanon
2566,2/1/2020,LBN,Sabah,2,2,0,Lebanon
2567,2/1/2020,LBN,Sarawak,1,1,0,Lebanon
2568,2/1/2020,LBN,Selangor,225,167,58,Lebanon
2569,2/1/2020,LBN,W.P. Labuan,0,0,0,Lebanon
2570,2/1/2020,LBR,Johor,0,0,0,Liberia
2571,2/1/2020,LBR,Kedah,0,0,0,Liberia
2572,2/1/2020,LBR,Sabah,0,0,0,Liberia
2573,2/1/2020,LBR,Sarawak,0,0,0,Liberia
2574,2/1/2020,LBR,Selangor,4,3,1,Liberia
2575,2/1/2020,LBY,Johor,5,3,2,Libyan Arab Jamahiriya
2576,2/1/2020,LBY,Kedah,3,2,1,Libyan Arab Jamahiriya
2577,2/1/2020,LBY,Perlis,0,0,0,Libyan Arab Jamahiriya
2578,2/1/2020,LBY,Pulau Pinang,4,4,0,Libyan Arab Jamahiriya
2579,2/1/2020,LBY,Sabah,3,3,0,Libyan Arab Jamahiriya
2580,2/1/2020,LBY,Sarawak,2,0,2,Libyan Arab Jamahiriya
2581,2/1/2020,LBY,Selangor,673,496,177,Libyan Arab Jamahiriya
2582,2/1/2020,LCA,Johor,2,2,0,Saint Lucia
2583,2/1/2020,LCA,Kedah,0,0,0,Saint Lucia
2584,2/1/2020,LCA,Pulau Pinang,0,0,0,Saint Lucia
2585,2/1/2020,LCA,Sarawak,0,0,0,Saint Lucia
2586,2/1/2020,LCA,Selangor,8,7,1,Saint Lucia
2587,2/1/2020,LIE,Johor,2,1,1,Liechtenstein
2588,2/1/2020,LIE,Kedah,0,0,0,Liechtenstein
2589,2/1/2020,LIE,Perlis,0,0,0,Liechtenstein
2590,2/1/2020,LIE,Pulau Pinang,0,0,0,Liechtenstein
2591,2/1/2020,LIE,Sabah,0,0,0,Liechtenstein
2592,2/1/2020,LIE,Sarawak,1,1,0,Liechtenstein
2593,2/1/2020,LIE,Selangor,4,4,0,Liechtenstein
2594,2/1/2020,LKA,Johor,661,487,174,Sri Lanka
2595,2/1/2020,LKA,Kedah,9,5,4,Sri Lanka
2596,2/1/2020,LKA,Kelantan,0,0,0,Sri Lanka
2597,2/1/2020,LKA,Melaka,0,0,0,Sri Lanka
2598,2/1/2020,LKA,Pahang,1,1,0,Sri Lanka
2599,2/1/2020,LKA,Perak,2,1,1,Sri Lanka
2600,2/1/2020,LKA,Perlis,0,0,0,Sri Lanka
2601,2/1/2020,LKA,Pulau Pinang,24,18,6,Sri Lanka
2602,2/1/2020,LKA,Sabah,3,3,0,Sri Lanka
2603,2/1/2020,LKA,Sarawak,16,13,3,Sri Lanka
2604,2/1/2020,LKA,Selangor,2922,1964,958,Sri Lanka
2605,2/1/2020,LKA,W.P. Labuan,0,0,0,Sri Lanka
2606,2/1/2020,LSO,Johor,0,0,0,Lesotho
2607,2/1/2020,LSO,Kedah,0,0,0,Lesotho
2608,2/1/2020,LSO,Pulau Pinang,0,0,0,Lesotho
2609,2/1/2020,LSO,Sarawak,0,0,0,Lesotho
2610,2/1/2020,LSO,Selangor,5,2,3,Lesotho
2611,2/1/2020,LTU,Johor,132,62,70,Lithuania
2612,2/1/2020,LTU,Kedah,45,23,22,Lithuania
2613,2/1/2020,LTU,Kelantan,0,0,0,Lithuania
2614,2/1/2020,LTU,Pahang,0,0,0,Lithuania
2615,2/1/2020,LTU,Perak,10,1,9,Lithuania
2616,2/1/2020,LTU,Perlis,3,3,0,Lithuania
2617,2/1/2020,LTU,Pulau Pinang,8,5,3,Lithuania
2618,2/1/2020,LTU,Sabah,13,7,6,Lithuania
2619,2/1/2020,LTU,Sarawak,8,3,5,Lithuania
2620,2/1/2020,LTU,Selangor,399,210,189,Lithuania
2621,2/1/2020,LTU,W.P. Labuan,2,2,0,Lithuania
2622,2/1/2020,LUX,Johor,9,4,5,Luxembourg
2623,2/1/2020,LUX,Kedah,4,0,4,Luxembourg
2624,2/1/2020,LUX,Kelantan,0,0,0,Luxembourg
2625,2/1/2020,LUX,Perak,1,1,0,Luxembourg
2626,2/1/2020,LUX,Perlis,0,0,0,Luxembourg
2627,2/1/2020,LUX,Pulau Pinang,1,1,0,Luxembourg
2628,2/1/2020,LUX,Sabah,1,1,0,Luxembourg
2629,2/1/2020,LUX,Sarawak,0,0,0,Luxembourg
2630,2/1/2020,LUX,Selangor,41,26,15,Luxembourg
2631,2/1/2020,LVA,Johor,105,41,64,Latvia
2632,2/1/2020,LVA,Kedah,21,6,15,Latvia
2633,2/1/2020,LVA,Kelantan,0,0,0,Latvia
2634,2/1/2020,LVA,Pahang,0,0,0,Latvia
2635,2/1/2020,LVA,Perak,0,0,0,Latvia
2636,2/1/2020,LVA,Perlis,6,5,1,Latvia
2637,2/1/2020,LVA,Pulau Pinang,11,7,4,Latvia
2638,2/1/2020,LVA,Sabah,1,0,1,Latvia
2639,2/1/2020,LVA,Sarawak,3,1,2,Latvia
2640,2/1/2020,LVA,Selangor,191,89,102,Latvia
2641,2/1/2020,LVA,W.P. Labuan,0,0,0,Latvia
2642,2/1/2020,MAC,Johor,0,0,0,Macao
2643,2/1/2020,MAC,Pahang,0,0,0,Macao
2644,2/1/2020,MAC,Perak,0,0,0,Macao
2645,2/1/2020,MAC,Selangor,0,0,0,Macao
2646,2/1/2020,MAC,W.P. Labuan,0,0,0,Macao
2647,2/1/2020,MAR,Johor,54,36,18,Morocco
2648,2/1/2020,MAR,Kedah,23,9,14,Morocco
2649,2/1/2020,MAR,Kelantan,5,4,1,Morocco
2650,2/1/2020,MAR,Melaka,0,0,0,Morocco
2651,2/1/2020,MAR,Pahang,0,0,0,Morocco
2652,2/1/2020,MAR,Perak,1,0,1,Morocco
2653,2/1/2020,MAR,Perlis,2,2,0,Morocco
2654,2/1/2020,MAR,Pulau Pinang,7,2,5,Morocco
2655,2/1/2020,MAR,Sabah,6,4,2,Morocco
2656,2/1/2020,MAR,Sarawak,3,1,2,Morocco
2657,2/1/2020,MAR,Selangor,870,474,396,Morocco
2658,2/1/2020,MAR,W.P. Labuan,0,0,0,Morocco
2659,2/1/2020,MCO,Johor,0,0,0,Monaco
2660,2/1/2020,MCO,Kedah,1,1,0,Monaco
2661,2/1/2020,MCO,Sabah,0,0,0,Monaco
2662,2/1/2020,MCO,Selangor,5,1,4,Monaco
2663,2/1/2020,MDA,Johor,5,2,3,"Moldova, Republic of"
2664,2/1/2020,MDA,Kedah,7,4,3,"Moldova, Republic of"
2665,2/1/2020,MDA,Kelantan,1,0,1,"Moldova, Republic of"
2666,2/1/2020,MDA,Negeri Sembilan,0,0,0,"Moldova, Republic of"
2667,2/1/2020,MDA,Perlis,0,0,0,"Moldova, Republic of"
2668,2/1/2020,MDA,Pulau Pinang,1,0,1,"Moldova, Republic of"
2669,2/1/2020,MDA,Sabah,0,0,0,"Moldova, Republic of"
2670,2/1/2020,MDA,Sarawak,0,0,0,"Moldova, Republic of"
2671,2/1/2020,MDA,Selangor,33,17,16,"Moldova, Republic of"
2672,2/1/2020,MDG,Johor,5,1,4,Madagascar
2673,2/1/2020,MDG,Kedah,0,0,0,Madagascar
2674,2/1/2020,MDG,Perak,0,0,0,Madagascar
2675,2/1/2020,MDG,Perlis,0,0,0,Madagascar
2676,2/1/2020,MDG,Pulau Pinang,2,1,1,Madagascar
2677,2/1/2020,MDG,Sabah,2,1,1,Madagascar
2678,2/1/2020,MDG,Sarawak,0,0,0,Madagascar
2679,2/1/2020,MDG,Selangor,29,16,13,Madagascar
2680,2/1/2020,MDV,Johor,46,35,11,Maldives
2681,2/1/2020,MDV,Kedah,1,1,0,Maldives
2682,2/1/2020,MDV,Kelantan,0,0,0,Maldives
2683,2/1/2020,MDV,Perak,0,0,0,Maldives
2684,2/1/2020,MDV,Perlis,0,0,0,Maldives
2685,2/1/2020,MDV,Pulau Pinang,4,2,2,Maldives
2686,2/1/2020,MDV,Sabah,1,1,0,Maldives
2687,2/1/2020,MDV,Sarawak,0,0,0,Maldives
2688,2/1/2020,MDV,Selangor,1320,755,565,Maldives
2689,2/1/2020,MEX,Johor,75,41,34,Mexico
2690,2/1/2020,MEX,Kedah,8,4,4,Mexico
2691,2/1/2020,MEX,Kelantan,1,1,0,Mexico
2692,2/1/2020,MEX,Pahang,0,0,0,Mexico
2693,2/1/2020,MEX,Perak,0,0,0,Mexico
2694,2/1/2020,MEX,Perlis,4,3,1,Mexico
2695,2/1/2020,MEX,Pulau Pinang,8,5,3,Mexico
2696,2/1/2020,MEX,Sabah,6,2,4,Mexico
2697,2/1/2020,MEX,Sarawak,4,1,3,Mexico
2698,2/1/2020,MEX,Selangor,396,203,193,Mexico
2699,2/1/2020,MEX,W.P. Labuan,1,1,0,Mexico
2700,2/1/2020,MHL,Johor,0,0,0,Marshall Islands
2701,2/1/2020,MHL,Kedah,0,0,0,Marshall Islands
2702,2/1/2020,MHL,Perak,0,0,0,Marshall Islands
2703,2/1/2020,MHL,Pulau Pinang,0,0,0,Marshall Islands
2704,2/1/2020,MHL,Sabah,0,0,0,Marshall Islands
2705,2/1/2020,MHL,Selangor,4,2,2,Marshall Islands
2706,2/1/2020,MKD,Johor,20,12,8,"Macedonia, the former Yugoslav Republic of"
2707,2/1/2020,MKD,Kedah,2,2,0,"Macedonia, the former Yugoslav Republic of"
2708,2/1/2020,MKD,Perak,0,0,0,"Macedonia, the former Yugoslav Republic of"
2709,2/1/2020,MKD,Pulau Pinang,0,0,0,"Macedonia, the former Yugoslav Republic of"
2710,2/1/2020,MKD,Sabah,0,0,0,"Macedonia, the former Yugoslav Republic of"
2711,2/1/2020,MKD,Sarawak,0,0,0,"Macedonia, the former Yugoslav Republic of"
2712,2/1/2020,MKD,Selangor,48,30,18,"Macedonia, the former Yugoslav Republic of"
2713,2/1/2020,MLI,Johor,1,1,0,Mali
2714,2/1/2020,MLI,Sabah,0,0,0,Mali
2715,2/1/2020,MLI,Selangor,5,5,0,Mali
2716,2/1/2020,MLT,Johor,4,3,1,Malta
2717,2/1/2020,MLT,Kedah,10,7,3,Malta
2718,2/1/2020,MLT,Kelantan,0,0,0,Malta
2719,2/1/2020,MLT,Perak,0,0,0,Malta
2720,2/1/2020,MLT,Perlis,0,0,0,Malta
2721,2/1/2020,MLT,Pulau Pinang,2,2,0,Malta
2722,2/1/2020,MLT,Sabah,2,1,1,Malta
2723,2/1/2020,MLT,Sarawak,0,0,0,Malta
2724,2/1/2020,MLT,Selangor,36,25,11,Malta
2725,2/1/2020,MLT,W.P. Labuan,0,0,0,Malta
2726,2/1/2020,MMR,Johor,2196,755,1441,Myanmar
2727,2/1/2020,MMR,Kedah,38,32,6,Myanmar
2728,2/1/2020,MMR,Kelantan,2,0,2,Myanmar
2729,2/1/2020,MMR,Negeri Sembilan,0,0,0,Myanmar
2730,2/1/2020,MMR,Pahang,5,4,1,Myanmar
2731,2/1/2020,MMR,Perak,7,1,6,Myanmar
2732,2/1/2020,MMR,Perlis,4,0,4,Myanmar
2733,2/1/2020,MMR,Pulau Pinang,349,270,79,Myanmar
2734,2/1/2020,MMR,Sabah,6,4,2,Myanmar
2735,2/1/2020,MMR,Sarawak,45,32,13,Myanmar
2736,2/1/2020,MMR,Selangor,10268,7840,2428,Myanmar
2737,2/1/2020,MMR,Terengganu,0,0,0,Myanmar
2738,2/1/2020,MMR,W.P. Labuan,5,3,2,Myanmar
2739,2/1/2020,MNE,Johor,5,5,0,Montenegro
2740,2/1/2020,MNE,Kedah,0,0,0,Montenegro
2741,2/1/2020,MNE,Pulau Pinang,0,0,0,Montenegro
2742,2/1/2020,MNE,Sabah,3,2,1,Montenegro
2743,2/1/2020,MNE,Sarawak,0,0,0,Montenegro
2744,2/1/2020,MNE,Selangor,20,10,10,Montenegro
2745,2/1/2020,MNG,Johor,56,19,37,Mongolia
2746,2/1/2020,MNG,Kedah,20,2,18,Mongolia
2747,2/1/2020,MNG,Kelantan,0,0,0,Mongolia
2748,2/1/2020,MNG,Perak,0,0,0,Mongolia
2749,2/1/2020,MNG,Perlis,3,0,3,Mongolia
2750,2/1/2020,MNG,Pulau Pinang,2,0,2,Mongolia
2751,2/1/2020,MNG,Sabah,2,0,2,Mongolia
2752,2/1/2020,MNG,Sarawak,2,1,1,Mongolia
2753,2/1/2020,MNG,Selangor,215,93,122,Mongolia
2754,2/1/2020,MNP,Selangor,0,0,0,Northern Mariana Islands
2755,2/1/2020,MOZ,Johor,0,0,0,Mozambique
2756,2/1/2020,MOZ,Kedah,0,0,0,Mozambique
2757,2/1/2020,MOZ,Perak,0,0,0,Mozambique
2758,2/1/2020,MOZ,Pulau Pinang,0,0,0,Mozambique
2759,2/1/2020,MOZ,Sabah,0,0,0,Mozambique
2760,2/1/2020,MOZ,Sarawak,0,0,0,Mozambique
2761,2/1/2020,MOZ,Selangor,18,13,5,Mozambique
2762,2/1/2020,MRT,Johor,0,0,0,Mauritania
2763,2/1/2020,MRT,Kedah,0,0,0,Mauritania
2764,2/1/2020,MRT,Pulau Pinang,0,0,0,Mauritania
2765,2/1/2020,MRT,Sabah,0,0,0,Mauritania
2766,2/1/2020,MRT,Sarawak,0,0,0,Mauritania
2767,2/1/2020,MRT,Selangor,26,25,1,Mauritania
2768,2/1/2020,MUS,Johor,57,38,19,Mauritius
2769,2/1/2020,MUS,Kedah,1,0,1,Mauritius
2770,2/1/2020,MUS,Kelantan,0,0,0,Mauritius
2771,2/1/2020,MUS,Pahang,0,0,0,Mauritius
2772,2/1/2020,MUS,Perak,0,0,0,Mauritius
2773,2/1/2020,MUS,Perlis,0,0,0,Mauritius
2774,2/1/2020,MUS,Pulau Pinang,6,3,3,Mauritius
2775,2/1/2020,MUS,Sabah,1,1,0,Mauritius
2776,2/1/2020,MUS,Sarawak,1,1,0,Mauritius
2777,2/1/2020,MUS,Selangor,543,271,272,Mauritius
2778,2/1/2020,MWI,Johor,1,1,0,Malawi
2779,2/1/2020,MWI,Pulau Pinang,1,1,0,Malawi
2780,2/1/2020,MWI,Sabah,0,0,0,Malawi
2781,2/1/2020,MWI,Sarawak,0,0,0,Malawi
2782,2/1/2020,MWI,Selangor,20,14,6,Malawi
2783,2/1/2020,MYT,Selangor,0,0,0,Mayotte
2784,2/1/2020,NAM,Johor,2,1,1,Namibia
2785,2/1/2020,NAM,Kedah,0,0,0,Namibia
2786,2/1/2020,NAM,Perak,0,0,0,Namibia
2787,2/1/2020,NAM,Perlis,0,0,0,Namibia
2788,2/1/2020,NAM,Pulau Pinang,0,0,0,Namibia
2789,2/1/2020,NAM,Sabah,0,0,0,Namibia
2790,2/1/2020,NAM,Sarawak,0,0,0,Namibia
2791,2/1/2020,NAM,Selangor,19,9,10,Namibia
2792,2/1/2020,NCL,Selangor,0,0,0,New Caledonia
2793,2/1/2020,NER,Johor,0,0,0,Niger
2794,2/1/2020,NER,Sabah,0,0,0,Niger
2795,2/1/2020,NER,Selangor,5,3,2,Niger
2796,2/1/2020,NGA,Johor,19,19,0,Nigeria
2797,2/1/2020,NGA,Kedah,0,0,0,Nigeria
2798,2/1/2020,NGA,Perlis,0,0,0,Nigeria
2799,2/1/2020,NGA,Pulau Pinang,13,10,3,Nigeria
2800,2/1/2020,NGA,Sabah,0,0,0,Nigeria
2801,2/1/2020,NGA,Sarawak,9,8,1,Nigeria
2802,2/1/2020,NGA,Selangor,763,658,105,Nigeria
2803,2/1/2020,NIC,Johor,0,0,0,Nicaragua
2804,2/1/2020,NIC,Kedah,0,0,0,Nicaragua
2805,2/1/2020,NIC,Pulau Pinang,0,0,0,Nicaragua
2806,2/1/2020,NIC,Sabah,1,0,1,Nicaragua
2807,2/1/2020,NIC,Selangor,9,7,2,Nicaragua
2808,2/1/2020,NLD,Johor,844,551,293,Netherlands
2809,2/1/2020,NLD,Kedah,405,188,217,Netherlands
2810,2/1/2020,NLD,Kelantan,7,3,4,Netherlands
2811,2/1/2020,NLD,Melaka,9,5,4,Netherlands
2812,2/1/2020,NLD,Negeri Sembilan,0,0,0,Netherlands
2813,2/1/2020,NLD,Pahang,1,1,0,Netherlands
2814,2/1/2020,NLD,Perak,15,10,5,Netherlands
2815,2/1/2020,NLD,Perlis,57,35,22,Netherlands
2816,2/1/2020,NLD,Pulau Pinang,217,141,76,Netherlands
2817,2/1/2020,NLD,Sabah,98,53,45,Netherlands
2818,2/1/2020,NLD,Sarawak,246,141,105,Netherlands
2819,2/1/2020,NLD,Selangor,4428,2686,1742,Netherlands
2820,2/1/2020,NLD,Terengganu,0,0,0,Netherlands
2821,2/1/2020,NLD,W.P. Labuan,16,9,7,Netherlands
2822,2/1/2020,NOR,Johor,224,117,107,Norway
2823,2/1/2020,NOR,Kedah,198,98,100,Norway
2824,2/1/2020,NOR,Kelantan,2,1,1,Norway
2825,2/1/2020,NOR,Melaka,0,0,0,Norway
2826,2/1/2020,NOR,Pahang,1,1,0,Norway
2827,2/1/2020,NOR,Perak,5,3,2,Norway
2828,2/1/2020,NOR,Perlis,21,11,10,Norway
2829,2/1/2020,NOR,Pulau Pinang,79,47,32,Norway
2830,2/1/2020,NOR,Sabah,18,13,5,Norway
2831,2/1/2020,NOR,Sarawak,42,30,12,Norway
2832,2/1/2020,NOR,Selangor,1157,678,479,Norway
2833,2/1/2020,NOR,W.P. Labuan,1,1,0,Norway
2834,2/1/2020,NPL,Johor,353,279,74,Nepal
2835,2/1/2020,NPL,Kedah,1,1,0,Nepal
2836,2/1/2020,NPL,Pahang,0,0,0,Nepal
2837,2/1/2020,NPL,Perak,0,0,0,Nepal
2838,2/1/2020,NPL,Perlis,1,1,0,Nepal
2839,2/1/2020,NPL,Pulau Pinang,85,80,5,Nepal
2840,2/1/2020,NPL,Sabah,15,15,0,Nepal
2841,2/1/2020,NPL,Sarawak,138,100,38,Nepal
2842,2/1/2020,NPL,Selangor,11932,11466,466,Nepal
2843,2/1/2020,NPL,W.P. Labuan,100,84,16,Nepal
2844,2/1/2020,NRU,Johor,0,0,0,Nauru
2845,2/1/2020,NRU,Pulau Pinang,1,1,0,Nauru
2846,2/1/2020,NRU,Selangor,1,1,0,Nauru
2847,2/1/2020,NZL,Johor,561,384,177,New Zealand
2848,2/1/2020,NZL,Kedah,90,59,31,New Zealand
2849,2/1/2020,NZL,Kelantan,2,1,1,New Zealand
2850,2/1/2020,NZL,Melaka,0,0,0,New Zealand
2851,2/1/2020,NZL,Negeri Sembilan,0,0,0,New Zealand
2852,2/1/2020,NZL,Pahang,3,3,0,New Zealand
2853,2/1/2020,NZL,Perak,9,5,4,New Zealand
2854,2/1/2020,NZL,Perlis,16,11,5,New Zealand
2855,2/1/2020,NZL,Pulau Pinang,155,93,62,New Zealand
2856,2/1/2020,NZL,Sabah,50,27,23,New Zealand
2857,2/1/2020,NZL,Sarawak,103,70,33,New Zealand
2858,2/1/2020,NZL,Selangor,2047,1259,788,New Zealand
2859,2/1/2020,NZL,Terengganu,0,0,0,New Zealand
2860,2/1/2020,NZL,W.P. Labuan,7,6,1,New Zealand
2861,2/1/2020,OMN,Johor,4,2,2,Oman
2862,2/1/2020,OMN,Kedah,3,2,1,Oman
2863,2/1/2020,OMN,Kelantan,0,0,0,Oman
2864,2/1/2020,OMN,Melaka,0,0,0,Oman
2865,2/1/2020,OMN,Perak,0,0,0,Oman
2866,2/1/2020,OMN,Perlis,0,0,0,Oman
2867,2/1/2020,OMN,Pulau Pinang,7,4,3,Oman
2868,2/1/2020,OMN,Sabah,1,1,0,Oman
2869,2/1/2020,OMN,Sarawak,38,21,17,Oman
2870,2/1/2020,OMN,Selangor,737,481,256,Oman
2871,2/1/2020,PAK,Johor,748,595,153,Pakistan
2872,2/1/2020,PAK,Kedah,65,44,21,Pakistan
2873,2/1/2020,PAK,Kelantan,9,9,0,Pakistan
2874,2/1/2020,PAK,Melaka,0,0,0,Pakistan
2875,2/1/2020,PAK,Negeri Sembilan,0,0,0,Pakistan
2876,2/1/2020,PAK,Pahang,1,1,0,Pakistan
2877,2/1/2020,PAK,Perak,2,2,0,Pakistan
2878,2/1/2020,PAK,Perlis,22,16,6,Pakistan
2879,2/1/2020,PAK,Pulau Pinang,45,41,4,Pakistan
2880,2/1/2020,PAK,Sabah,22,20,2,Pakistan
2881,2/1/2020,PAK,Sarawak,371,352,19,Pakistan
2882,2/1/2020,PAK,Selangor,13424,11655,1769,Pakistan
2883,2/1/2020,PAK,W.P. Labuan,23,23,0,Pakistan
2884,2/1/2020,PAN,Johor,4,3,1,Panama
2885,2/1/2020,PAN,Kedah,1,1,0,Panama
2886,2/1/2020,PAN,Perak,0,0,0,Panama
2887,2/1/2020,PAN,Perlis,0,0,0,Panama
2888,2/1/2020,PAN,Pulau Pinang,0,0,0,Panama
2889,2/1/2020,PAN,Sabah,1,0,1,Panama
2890,2/1/2020,PAN,Sarawak,0,0,0,Panama
2891,2/1/2020,PAN,Selangor,33,13,20,Panama
2892,2/1/2020,PER,Johor,28,14,14,Peru
2893,2/1/2020,PER,Kedah,6,2,4,Peru
2894,2/1/2020,PER,Kelantan,1,0,1,Peru
2895,2/1/2020,PER,Pahang,0,0,0,Peru
2896,2/1/2020,PER,Perak,0,0,0,Peru
2897,2/1/2020,PER,Perlis,0,0,0,Peru
2898,2/1/2020,PER,Pulau Pinang,7,3,4,Peru
2899,2/1/2020,PER,Sabah,5,2,3,Peru
2900,2/1/2020,PER,Sarawak,1,1,0,Peru
2901,2/1/2020,PER,Selangor,147,77,70,Peru
2902,2/1/2020,PER,W.P. Labuan,1,0,1,Peru
2903,2/1/2020,PHL,Johor,12116,3987,8129,Philippines
2904,2/1/2020,PHL,Kedah,1096,374,722,Philippines
2905,2/1/2020,PHL,Kelantan,59,25,34,Philippines
2906,2/1/2020,PHL,Melaka,0,0,0,Philippines
2907,2/1/2020,PHL,Negeri Sembilan,0,0,0,Philippines
2908,2/1/2020,PHL,Pahang,18,16,2,Philippines
2909,2/1/2020,PHL,Perak,38,10,28,Philippines
2910,2/1/2020,PHL,Perlis,199,66,133,Philippines
2911,2/1/2020,PHL,Pulau Pinang,348,134,214,Philippines
2912,2/1/2020,PHL,Sabah,2134,1072,1062,Philippines
2913,2/1/2020,PHL,Sarawak,2850,1232,1618,Philippines
2914,2/1/2020,PHL,Selangor,13027,5783,7244,Philippines
2915,2/1/2020,PHL,Terengganu,0,0,0,Philippines
2916,2/1/2020,PHL,W.P. Labuan,193,84,109,Philippines
2917,2/1/2020,PLW,Johor,0,0,0,Palau
2918,2/1/2020,PLW,Pulau Pinang,0,0,0,Palau
2919,2/1/2020,PLW,Selangor,0,0,0,Palau
2920,2/1/2020,PNG,Johor,8,5,3,Papua New Guinea
2921,2/1/2020,PNG,Kedah,0,0,0,Papua New Guinea
2922,2/1/2020,PNG,Kelantan,0,0,0,Papua New Guinea
2923,2/1/2020,PNG,Perak,0,0,0,Papua New Guinea
2924,2/1/2020,PNG,Pulau Pinang,1,0,1,Papua New Guinea
2925,2/1/2020,PNG,Sabah,4,2,2,Papua New Guinea
2926,2/1/2020,PNG,Sarawak,3,1,2,Papua New Guinea
2927,2/1/2020,PNG,Selangor,51,31,20,Papua New Guinea
2928,2/1/2020,POL,Johor,643,348,295,Poland
2929,2/1/2020,POL,Kedah,431,216,215,Poland
2930,2/1/2020,POL,Kelantan,10,3,7,Poland
2931,2/1/2020,POL,Melaka,0,0,0,Poland
2932,2/1/2020,POL,Negeri Sembilan,0,0,0,Poland
2933,2/1/2020,POL,Pahang,0,0,0,Poland
2934,2/1/2020,POL,Perak,5,2,3,Poland
2935,2/1/2020,POL,Perlis,52,29,23,Poland
2936,2/1/2020,POL,Pulau Pinang,133,60,73,Poland
2937,2/1/2020,POL,Sabah,105,55,50,Poland
2938,2/1/2020,POL,Sarawak,106,59,47,Poland
2939,2/1/2020,POL,Selangor,1844,997,847,Poland
2940,2/1/2020,POL,Terengganu,0,0,0,Poland
2941,2/1/2020,POL,W.P. Labuan,5,3,2,Poland
2942,2/1/2020,PRK,Selangor,5,4,1,"Korea, Democratic People's Republic of"
2943,2/1/2020,PRT,Johor,163,78,85,Portugal
2944,2/1/2020,PRT,Kedah,69,39,30,Portugal
2945,2/1/2020,PRT,Kelantan,4,2,2,Portugal
2946,2/1/2020,PRT,Melaka,0,0,0,Portugal
2947,2/1/2020,PRT,Pahang,0,0,0,Portugal
2948,2/1/2020,PRT,Perak,1,0,1,Portugal
2949,2/1/2020,PRT,Perlis,6,5,1,Portugal
2950,2/1/2020,PRT,Pulau Pinang,12,4,8,Portugal
2951,2/1/2020,PRT,Sabah,13,9,4,Portugal
2952,2/1/2020,PRT,Sarawak,10,7,3,Portugal
2953,2/1/2020,PRT,Selangor,479,284,195,Portugal
2954,2/1/2020,PRT,W.P. Labuan,1,0,1,Portugal
2955,2/1/2020,PRY,Johor,2,1,1,Paraguay
2956,2/1/2020,PRY,Kedah,2,2,0,Paraguay
2957,2/1/2020,PRY,Perak,0,0,0,Paraguay
2958,2/1/2020,PRY,Perlis,1,1,0,Paraguay
2959,2/1/2020,PRY,Pulau Pinang,0,0,0,Paraguay
2960,2/1/2020,PRY,Sabah,0,0,0,Paraguay
2961,2/1/2020,PRY,Sarawak,0,0,0,Paraguay
2962,2/1/2020,PRY,Selangor,9,3,6,Paraguay
2963,2/1/2020,PSE,Johor,14,8,6,"Palestinian Territory, Occupied"
2964,2/1/2020,PSE,Kedah,1,0,1,"Palestinian Territory, Occupied"
2965,2/1/2020,PSE,Kelantan,0,0,0,"Palestinian Territory, Occupied"
2966,2/1/2020,PSE,Melaka,0,0,0,"Palestinian Territory, Occupied"
2967,2/1/2020,PSE,Perak,0,0,0,"Palestinian Territory, Occupied"
2968,2/1/2020,PSE,Perlis,0,0,0,"Palestinian Territory, Occupied"
2969,2/1/2020,PSE,Pulau Pinang,5,3,2,"Palestinian Territory, Occupied"
2970,2/1/2020,PSE,Sabah,1,1,0,"Palestinian Territory, Occupied"
2971,2/1/2020,PSE,Sarawak,3,3,0,"Palestinian Territory, Occupied"
2972,2/1/2020,PSE,Selangor,408,332,76,"Palestinian Territory, Occupied"
2973,2/1/2020,QAT,Johor,3,1,2,Qatar
2974,2/1/2020,QAT,Kedah,5,4,1,Qatar
2975,2/1/2020,QAT,Perlis,0,0,0,Qatar
2976,2/1/2020,QAT,Pulau Pinang,1,1,0,Qatar
2977,2/1/2020,QAT,Sabah,0,0,0,Qatar
2978,2/1/2020,QAT,Sarawak,0,0,0,Qatar
2979,2/1/2020,QAT,Selangor,70,51,19,Qatar
2980,2/1/2020,REU,Johor,0,0,0,Reunion
2981,2/1/2020,REU,Sarawak,0,0,0,Reunion
2982,2/1/2020,ROU,Johor,98,57,41,Romania
2983,2/1/2020,ROU,Kedah,131,68,63,Romania
2984,2/1/2020,ROU,Kelantan,3,1,2,Romania
2985,2/1/2020,ROU,Negeri Sembilan,0,0,0,Romania
2986,2/1/2020,ROU,Pahang,0,0,0,Romania
2987,2/1/2020,ROU,Perak,2,0,2,Romania
2988,2/1/2020,ROU,Perlis,3,2,1,Romania
2989,2/1/2020,ROU,Pulau Pinang,16,8,8,Romania
2990,2/1/2020,ROU,Sabah,6,4,2,Romania
2991,2/1/2020,ROU,Sarawak,6,4,2,Romania
2992,2/1/2020,ROU,Selangor,638,352,286,Romania
2993,2/1/2020,ROU,W.P. Labuan,0,0,0,Romania
2994,2/1/2020,RUS,Johor,439,281,158,Russia
2995,2/1/2020,RUS,Kedah,1215,537,678,Russia
2996,2/1/2020,RUS,Kelantan,143,61,82,Russia
2997,2/1/2020,RUS,Melaka,2,2,0,Russia
2998,2/1/2020,RUS,Negeri Sembilan,0,0,0,Russia
2999,2/1/2020,RUS,Pahang,4,4,0,Russia
3000,2/1/2020,RUS,Perak,7,3,4,Russia
3001,2/1/2020,RUS,Perlis,354,168,186,Russia
3002,2/1/2020,RUS,Pulau Pinang,135,62,73,Russia
3003,2/1/2020,RUS,Sabah,102,42,60,Russia
3004,2/1/2020,RUS,Sarawak,73,37,36,Russia
3005,2/1/2020,RUS,Selangor,10284,4766,5518,Russia
3006,2/1/2020,RUS,W.P. Labuan,22,6,16,Russia
3007,2/1/2020,RWA,Johor,0,0,0,Rwanda
3008,2/1/2020,RWA,Kedah,0,0,0,Rwanda
3009,2/1/2020,RWA,Pulau Pinang,0,0,0,Rwanda
3010,2/1/2020,RWA,Selangor,4,3,1,Rwanda
3011,2/1/2020,SAU,Johor,53,40,13,Saudi Arabia
3012,2/1/2020,SAU,Kedah,8,7,1,Saudi Arabia
3013,2/1/2020,SAU,Kelantan,3,1,2,Saudi Arabia
3014,2/1/2020,SAU,Melaka,0,0,0,Saudi Arabia
3015,2/1/2020,SAU,Perak,0,0,0,Saudi Arabia
3016,2/1/2020,SAU,Perlis,0,0,0,Saudi Arabia
3017,2/1/2020,SAU,Pulau Pinang,15,10,5,Saudi Arabia
3018,2/1/2020,SAU,Sabah,2,1,1,Saudi Arabia
3019,2/1/2020,SAU,Sarawak,2,2,0,Saudi Arabia
3020,2/1/2020,SAU,Selangor,3685,2229,1456,Saudi Arabia
3021,2/1/2020,SAU,W.P. Labuan,1,1,0,Saudi Arabia
3022,2/1/2020,SDN,Johor,12,11,1,Sudan
3023,2/1/2020,SDN,Kedah,1,1,0,Sudan
3024,2/1/2020,SDN,Kelantan,0,0,0,Sudan
3025,2/1/2020,SDN,Perlis,0,0,0,Sudan
3026,2/1/2020,SDN,Pulau Pinang,0,0,0,Sudan
3027,2/1/2020,SDN,Sabah,2,2,0,Sudan
3028,2/1/2020,SDN,Sarawak,1,1,0,Sudan
3029,2/1/2020,SDN,Selangor,1083,714,369,Sudan
3030,2/1/2020,SDN,W.P. Labuan,0,0,0,Sudan
3031,2/1/2020,SEN,Johor,1,1,0,Senegal
3032,2/1/2020,SEN,Kedah,0,0,0,Senegal
3033,2/1/2020,SEN,Kelantan,0,0,0,Senegal
3034,2/1/2020,SEN,Perak,0,0,0,Senegal
3035,2/1/2020,SEN,Perlis,0,0,0,Senegal
3036,2/1/2020,SEN,Pulau Pinang,1,1,0,Senegal
3037,2/1/2020,SEN,Sabah,0,0,0,Senegal
3038,2/1/2020,SEN,Sarawak,1,0,1,Senegal
3039,2/1/2020,SEN,Selangor,61,46,15,Senegal
3040,2/1/2020,SGP,Johor,887821,557719,330102,Singapore
3041,2/1/2020,SGP,Kedah,1332,834,498,Singapore
3042,2/1/2020,SGP,Kelantan,147,87,60,Singapore
3043,2/1/2020,SGP,Melaka,13,11,2,Singapore
3044,2/1/2020,SGP,Negeri Sembilan,1,1,0,Singapore
3045,2/1/2020,SGP,Pahang,236,135,101,Singapore
3046,2/1/2020,SGP,Perak,2223,1107,1116,Singapore
3047,2/1/2020,SGP,Perlis,56,40,16,Singapore
3048,2/1/2020,SGP,Pulau Pinang,5711,3166,2545,Singapore
3049,2/1/2020,SGP,Sabah,943,547,396,Singapore
3050,2/1/2020,SGP,Sarawak,1686,1036,650,Singapore
3051,2/1/2020,SGP,Selangor,20083,12332,7751,Singapore
3052,2/1/2020,SGP,Terengganu,0,0,0,Singapore
3053,2/1/2020,SGP,W.P. Labuan,25,21,4,Singapore
3054,2/1/2020,SGS,Johor,0,0,0,South Georgia and the South Sandwich Islands
3055,2/1/2020,SGS,Sabah,0,0,0,South Georgia and the South Sandwich Islands
3056,2/1/2020,SGS,Selangor,0,0,0,South Georgia and the South Sandwich Islands
3057,2/1/2020,SHN,Sarawak,0,0,0,"Saint Helena, Ascension and Tristan da Cunha"
3058,2/1/2020,SLB,Johor,1,1,0,Solomon Islands
3059,2/1/2020,SLB,Perlis,0,0,0,Solomon Islands
3060,2/1/2020,SLB,Pulau Pinang,0,0,0,Solomon Islands
3061,2/1/2020,SLB,Sabah,2,0,2,Solomon Islands
3062,2/1/2020,SLB,Sarawak,4,2,2,Solomon Islands
3063,2/1/2020,SLB,Selangor,1,1,0,Solomon Islands
3064,2/1/2020,SLB,W.P. Labuan,0,0,0,Solomon Islands
3065,2/1/2020,SLE,Johor,1,1,0,Sierra Leone
3066,2/1/2020,SLE,Kedah,0,0,0,Sierra Leone
3067,2/1/2020,SLE,Perak,0,0,0,Sierra Leone
3068,2/1/2020,SLE,Pulau Pinang,3,2,1,Sierra Leone
3069,2/1/2020,SLE,Sabah,0,0,0,Sierra Leone
3070,2/1/2020,SLE,Selangor,39,27,12,Sierra Leone
3071,2/1/2020,SLV,Johor,1,1,0,El Salvador
3072,2/1/2020,SLV,Kedah,0,0,0,El Salvador
3073,2/1/2020,SLV,Perak,0,0,0,El Salvador
3074,2/1/2020,SLV,Perlis,0,0,0,El Salvador
3075,2/1/2020,SLV,Pulau Pinang,2,0,2,El Salvador
3076,2/1/2020,SLV,Sabah,1,0,1,El Salvador
3077,2/1/2020,SLV,Selangor,17,8,9,El Salvador
3078,2/1/2020,SLV,W.P. Labuan,1,0,1,El Salvador
3079,2/1/2020,SMR,Johor,0,0,0,San Marino
3080,2/1/2020,SMR,Selangor,4,3,1,San Marino
3081,2/1/2020,SOM,Johor,2,0,2,Somalia
3082,2/1/2020,SOM,Kedah,0,0,0,Somalia
3083,2/1/2020,SOM,Kelantan,0,0,0,Somalia
3084,2/1/2020,SOM,Perlis,0,0,0,Somalia
3085,2/1/2020,SOM,Sabah,1,0,1,Somalia
3086,2/1/2020,SOM,Sarawak,0,0,0,Somalia
3087,2/1/2020,SOM,Selangor,354,245,109,Somalia
3088,2/1/2020,SRB,Johor,9,8,1,Serbia
3089,2/1/2020,SRB,Kedah,7,7,0,Serbia
3090,2/1/2020,SRB,Kelantan,0,0,0,Serbia
3091,2/1/2020,SRB,Pahang,0,0,0,Serbia
3092,2/1/2020,SRB,Perak,0,0,0,Serbia
3093,2/1/2020,SRB,Perlis,0,0,0,Serbia
3094,2/1/2020,SRB,Pulau Pinang,3,2,1,Serbia
3095,2/1/2020,SRB,Sabah,0,0,0,Serbia
3096,2/1/2020,SRB,Sarawak,0,0,0,Serbia
3097,2/1/2020,SRB,Selangor,96,51,45,Serbia
3098,2/1/2020,STP,Selangor,2,2,0,Sao Tome and Principe
3099,2/1/2020,SUR,Johor,4,2,2,Suriname
3100,2/1/2020,SUR,Kedah,0,0,0,Suriname
3101,2/1/2020,SUR,Kelantan,0,0,0,Suriname
3102,2/1/2020,SUR,Perak,0,0,0,Suriname
3103,2/1/2020,SUR,Perlis,0,0,0,Suriname
3104,2/1/2020,SUR,Pulau Pinang,0,0,0,Suriname
3105,2/1/2020,SUR,Sabah,0,0,0,Suriname
3106,2/1/2020,SUR,Sarawak,0,0,0,Suriname
3107,2/1/2020,SUR,Selangor,4,3,1,Suriname
3108,2/1/2020,SVK,Johor,42,27,15,Slovakia
3109,2/1/2020,SVK,Kedah,273,132,141,Slovakia
3110,2/1/2020,SVK,Kelantan,3,3,0,Slovakia
3111,2/1/2020,SVK,Negeri Sembilan,0,0,0,Slovakia
3112,2/1/2020,SVK,Pahang,0,0,0,Slovakia
3113,2/1/2020,SVK,Perak,1,1,0,Slovakia
3114,2/1/2020,SVK,Perlis,4,3,1,Slovakia
3115,2/1/2020,SVK,Pulau Pinang,69,29,40,Slovakia
3116,2/1/2020,SVK,Sabah,13,7,6,Slovakia
3117,2/1/2020,SVK,Sarawak,3,3,0,Slovakia
3118,2/1/2020,SVK,Selangor,542,279,263,Slovakia
3119,2/1/2020,SVK,W.P. Labuan,3,2,1,Slovakia
3120,2/1/2020,SVN,Johor,19,12,7,Slovenia
3121,2/1/2020,SVN,Kedah,65,32,33,Slovenia
3122,2/1/2020,SVN,Kelantan,0,0,0,Slovenia
3123,2/1/2020,SVN,Perak,0,0,0,Slovenia
3124,2/1/2020,SVN,Perlis,2,2,0,Slovenia
3125,2/1/2020,SVN,Pulau Pinang,6,4,2,Slovenia
3126,2/1/2020,SVN,Sabah,11,4,7,Slovenia
3127,2/1/2020,SVN,Sarawak,1,0,1,Slovenia
3128,2/1/2020,SVN,Selangor,281,158,123,Slovenia
3129,2/1/2020,SVN,W.P. Labuan,0,0,0,Slovenia
3130,2/1/2020,SWE,Johor,329,196,133,Sweden
3131,2/1/2020,SWE,Kedah,876,395,481,Sweden
3132,2/1/2020,SWE,Kelantan,14,12,2,Sweden
3133,2/1/2020,SWE,Melaka,0,0,0,Sweden
3134,2/1/2020,SWE,Negeri Sembilan,0,0,0,Sweden
3135,2/1/2020,SWE,Pahang,4,2,2,Sweden
3136,2/1/2020,SWE,Perak,10,7,3,Sweden
3137,2/1/2020,SWE,Perlis,37,29,8,Sweden
3138,2/1/2020,SWE,Pulau Pinang,103,64,39,Sweden
3139,2/1/2020,SWE,Sabah,60,28,32,Sweden
3140,2/1/2020,SWE,Sarawak,45,28,17,Sweden
3141,2/1/2020,SWE,Selangor,2478,1387,1091,Sweden
3142,2/1/2020,SWE,W.P. Labuan,4,0,4,Sweden
3143,2/1/2020,SWZ,Johor,0,0,0,Swaziland
3144,2/1/2020,SWZ,Kedah,0,0,0,Swaziland
3145,2/1/2020,SWZ,Pulau Pinang,0,0,0,Swaziland
3146,2/1/2020,SWZ,Sabah,0,0,0,Swaziland
3147,2/1/2020,SWZ,Selangor,6,5,1,Swaziland
3148,2/1/2020,SYC,Johor,5,3,2,Seychelles
3149,2/1/2020,SYC,Kedah,1,1,0,Seychelles
3150,2/1/2020,SYC,Pulau Pinang,0,0,0,Seychelles
3151,2/1/2020,SYC,Sabah,0,0,0,Seychelles
3152,2/1/2020,SYC,Sarawak,0,0,0,Seychelles
3153,2/1/2020,SYC,Selangor,70,36,34,Seychelles
3154,2/1/2020,SYR,Johor,12,10,2,Syrian Arab Republic
3155,2/1/2020,SYR,Kedah,2,2,0,Syrian Arab Republic
3156,2/1/2020,SYR,Kelantan,0,0,0,Syrian Arab Republic
3157,2/1/2020,SYR,Pahang,0,0,0,Syrian Arab Republic
3158,2/1/2020,SYR,Perlis,1,1,0,Syrian Arab Republic
3159,2/1/2020,SYR,Pulau Pinang,6,3,3,Syrian Arab Republic
3160,2/1/2020,SYR,Sabah,1,1,0,Syrian Arab Republic
3161,2/1/2020,SYR,Sarawak,3,1,2,Syrian Arab Republic
3162,2/1/2020,SYR,Selangor,760,527,233,Syrian Arab Republic
3163,2/1/2020,SYR,W.P. Labuan,0,0,0,Syrian Arab Republic
3164,2/1/2020,TCA,Perlis,0,0,0,Turks and Caicos
3165,2/1/2020,TCD,Johor,0,0,0,Chad
3166,2/1/2020,TCD,Kedah,0,0,0,Chad
3167,2/1/2020,TCD,Perlis,0,0,0,Chad
3168,2/1/2020,TCD,Selangor,26,23,3,Chad
3169,2/1/2020,TGO,Johor,1,1,0,Togo
3170,2/1/2020,TGO,Perak,0,0,0,Togo
3171,2/1/2020,TGO,Pulau Pinang,0,0,0,Togo
3172,2/1/2020,TGO,Selangor,8,8,0,Togo
3173,2/1/2020,THA,Johor,4620,1253,3367,Thailand
3174,2/1/2020,THA,Kedah,41527,14919,26608,Thailand
3175,2/1/2020,THA,Kelantan,36173,19239,16934,Thailand
3176,2/1/2020,THA,Melaka,1,1,0,Thailand
3177,2/1/2020,THA,Negeri Sembilan,2,1,1,Thailand
3178,2/1/2020,THA,Pahang,0,0,0,Thailand
3179,2/1/2020,THA,Perak,11999,5604,6395,Thailand
3180,2/1/2020,THA,Perlis,41747,24293,17454,Thailand
3181,2/1/2020,THA,Pulau Pinang,1171,442,729,Thailand
3182,2/1/2020,THA,Sabah,138,51,87,Thailand
3183,2/1/2020,THA,Sarawak,505,206,299,Thailand
3184,2/1/2020,THA,Selangor,10529,4415,6114,Thailand
3185,2/1/2020,THA,Terengganu,0,0,0,Thailand
3186,2/1/2020,THA,W.P. Labuan,18,5,13,Thailand
3187,2/1/2020,TJK,Johor,0,0,0,Tajikistan
3188,2/1/2020,TJK,Kedah,5,4,1,Tajikistan
3189,2/1/2020,TJK,Perlis,0,0,0,Tajikistan
3190,2/1/2020,TJK,Pulau Pinang,1,0,1,Tajikistan
3191,2/1/2020,TJK,Sabah,0,0,0,Tajikistan
3192,2/1/2020,TJK,Selangor,106,84,22,Tajikistan
3193,2/1/2020,TKL,Selangor,0,0,0,Tokelau
3194,2/1/2020,TKM,Johor,0,0,0,Turkmenistan
3195,2/1/2020,TKM,Kedah,3,2,1,Turkmenistan
3196,2/1/2020,TKM,Kelantan,0,0,0,Turkmenistan
3197,2/1/2020,TKM,Perlis,0,0,0,Turkmenistan
3198,2/1/2020,TKM,Pulau Pinang,0,0,0,Turkmenistan
3199,2/1/2020,TKM,Sabah,0,0,0,Turkmenistan
3200,2/1/2020,TKM,Sarawak,0,0,0,Turkmenistan
3201,2/1/2020,TKM,Selangor,91,61,30,Turkmenistan
3202,2/1/2020,TLS,Johor,3,1,2,Timor-Leste
3203,2/1/2020,TLS,Kedah,0,0,0,Timor-Leste
3204,2/1/2020,TLS,Perlis,0,0,0,Timor-Leste
3205,2/1/2020,TLS,Pulau Pinang,1,1,0,Timor-Leste
3206,2/1/2020,TLS,Sabah,0,0,0,Timor-Leste
3207,2/1/2020,TLS,Sarawak,1,1,0,Timor-Leste
3208,2/1/2020,TLS,Selangor,86,57,29,Timor-Leste
3209,2/1/2020,TON,Johor,0,0,0,Tonga
3210,2/1/2020,TON,Pulau Pinang,1,1,0,Tonga
3211,2/1/2020,TON,Sarawak,0,0,0,Tonga
3212,2/1/2020,TON,Selangor,7,5,2,Tonga
3213,2/1/2020,TTO,Johor,15,14,1,Trinidad and Tobago
3214,2/1/2020,TTO,Kedah,0,0,0,Trinidad and Tobago
3215,2/1/2020,TTO,Pahang,0,0,0,Trinidad and Tobago
3216,2/1/2020,TTO,Pulau Pinang,2,1,1,Trinidad and Tobago
3217,2/1/2020,TTO,Sabah,0,0,0,Trinidad and Tobago
3218,2/1/2020,TTO,Sarawak,0,0,0,Trinidad and Tobago
3219,2/1/2020,TTO,Selangor,25,16,9,Trinidad and Tobago
3220,2/1/2020,TUN,Johor,7,5,2,Tunisia
3221,2/1/2020,TUN,Kedah,14,12,2,Tunisia
3222,2/1/2020,TUN,Kelantan,0,0,0,Tunisia
3223,2/1/2020,TUN,Melaka,0,0,0,Tunisia
3224,2/1/2020,TUN,Perak,0,0,0,Tunisia
3225,2/1/2020,TUN,Perlis,0,0,0,Tunisia
3226,2/1/2020,TUN,Pulau Pinang,9,5,4,Tunisia
3227,2/1/2020,TUN,Sabah,1,0,1,Tunisia
3228,2/1/2020,TUN,Sarawak,0,0,0,Tunisia
3229,2/1/2020,TUN,Selangor,289,164,125,Tunisia
3230,2/1/2020,TUN,W.P. Labuan,0,0,0,Tunisia
3231,2/1/2020,TUR,Johor,259,179,80,Turkey
3232,2/1/2020,TUR,Kedah,50,37,13,Turkey
3233,2/1/2020,TUR,Kelantan,4,4,0,Turkey
3234,2/1/2020,TUR,Melaka,0,0,0,Turkey
3235,2/1/2020,TUR,Negeri Sembilan,0,0,0,Turkey
3236,2/1/2020,TUR,Pahang,0,0,0,Turkey
3237,2/1/2020,TUR,Perak,1,1,0,Turkey
3238,2/1/2020,TUR,Perlis,17,15,2,Turkey
3239,2/1/2020,TUR,Pulau Pinang,13,9,4,Turkey
3240,2/1/2020,TUR,Sabah,13,10,3,Turkey
3241,2/1/2020,TUR,Sarawak,21,19,2,Turkey
3242,2/1/2020,TUR,Selangor,926,663,263,Turkey
3243,2/1/2020,TUR,W.P. Labuan,2,2,0,Turkey
3244,2/1/2020,TUV,Selangor,0,0,0,Tuvalu
3245,2/1/2020,TWN,Johor,5036,2173,2863,Taiwan
3246,2/1/2020,TWN,Kedah,171,95,76,Taiwan
3247,2/1/2020,TWN,Kelantan,3,2,1,Taiwan
3248,2/1/2020,TWN,Melaka,11,3,8,Taiwan
3249,2/1/2020,TWN,Negeri Sembilan,0,0,0,Taiwan
3250,2/1/2020,TWN,Pahang,1,0,1,Taiwan
3251,2/1/2020,TWN,Perak,24,9,15,Taiwan
3252,2/1/2020,TWN,Perlis,9,3,6,Taiwan
3253,2/1/2020,TWN,Pulau Pinang,2937,1523,1414,Taiwan
3254,2/1/2020,TWN,Sabah,2608,1233,1375,Taiwan
3255,2/1/2020,TWN,Sarawak,311,111,200,Taiwan
3256,2/1/2020,TWN,Selangor,11217,5789,5428,Taiwan
3257,2/1/2020,TWN,W.P. Labuan,14,8,6,Taiwan
3258,2/1/2020,TZA,Johor,9,2,7,"Tanzania, United Republic of"
3259,2/1/2020,TZA,Kedah,0,0,0,"Tanzania, United Republic of"
3260,2/1/2020,TZA,Perak,0,0,0,"Tanzania, United Republic of"
3261,2/1/2020,TZA,Perlis,0,0,0,"Tanzania, United Republic of"
3262,2/1/2020,TZA,Pulau Pinang,0,0,0,"Tanzania, United Republic of"
3263,2/1/2020,TZA,Sabah,0,0,0,"Tanzania, United Republic of"
3264,2/1/2020,TZA,Sarawak,1,1,0,"Tanzania, United Republic of"
3265,2/1/2020,TZA,Selangor,183,102,81,"Tanzania, United Republic of"
3266,2/1/2020,UGA,Johor,29,14,15,Uganda
3267,2/1/2020,UGA,Kedah,0,0,0,Uganda
3268,2/1/2020,UGA,Perak,0,0,0,Uganda
3269,2/1/2020,UGA,Perlis,0,0,0,Uganda
3270,2/1/2020,UGA,Pulau Pinang,2,0,2,Uganda
3271,2/1/2020,UGA,Sabah,0,0,0,Uganda
3272,2/1/2020,UGA,Sarawak,0,0,0,Uganda
3273,2/1/2020,UGA,Selangor,63,33,30,Uganda
3274,2/1/2020,UKR,Johor,97,59,38,Ukraine
3275,2/1/2020,UKR,Kedah,386,183,203,Ukraine
3276,2/1/2020,UKR,Kelantan,22,11,11,Ukraine
3277,2/1/2020,UKR,Melaka,0,0,0,Ukraine
3278,2/1/2020,UKR,Negeri Sembilan,0,0,0,Ukraine
3279,2/1/2020,UKR,Pahang,3,3,0,Ukraine
3280,2/1/2020,UKR,Perak,2,1,1,Ukraine
3281,2/1/2020,UKR,Perlis,27,13,14,Ukraine
3282,2/1/2020,UKR,Pulau Pinang,41,19,22,Ukraine
3283,2/1/2020,UKR,Sabah,15,6,9,Ukraine
3284,2/1/2020,UKR,Sarawak,28,15,13,Ukraine
3285,2/1/2020,UKR,Selangor,2150,1079,1071,Ukraine
3286,2/1/2020,UKR,W.P. Labuan,0,0,0,Ukraine
3287,2/1/2020,URY,Johor,8,3,5,Uruguay
3288,2/1/2020,URY,Kedah,1,0,1,Uruguay
3289,2/1/2020,URY,Kelantan,1,0,1,Uruguay
3290,2/1/2020,URY,Perak,0,0,0,Uruguay
3291,2/1/2020,URY,Perlis,1,0,1,Uruguay
3292,2/1/2020,URY,Pulau Pinang,2,0,2,Uruguay
3293,2/1/2020,URY,Sabah,1,1,0,Uruguay
3294,2/1/2020,URY,Sarawak,0,0,0,Uruguay
3295,2/1/2020,URY,Selangor,64,30,34,Uruguay
3296,2/1/2020,URY,W.P. Labuan,0,0,0,Uruguay
3297,2/1/2020,USA,Johor,2947,1771,1176,United States Of America
3298,2/1/2020,USA,Kedah,566,330,236,United States Of America
3299,2/1/2020,USA,Kelantan,30,22,8,United States Of America
3300,2/1/2020,USA,Melaka,5,2,3,United States Of America
3301,2/1/2020,USA,Negeri Sembilan,0,0,0,United States Of America
3302,2/1/2020,USA,Pahang,4,1,3,United States Of America
3303,2/1/2020,USA,Perak,68,36,32,United States Of America
3304,2/1/2020,USA,Perlis,114,74,40,United States Of America
3305,2/1/2020,USA,Pulau Pinang,1199,703,496,United States Of America
3306,2/1/2020,USA,Sabah,414,226,188,United States Of America
3307,2/1/2020,USA,Sarawak,290,165,125,United States Of America
3308,2/1/2020,USA,Selangor,11838,7168,4670,United States Of America
3309,2/1/2020,USA,Terengganu,0,0,0,United States Of America
3310,2/1/2020,USA,W.P. Labuan,7,5,2,United States Of America
3311,2/1/2020,UZB,Johor,65,37,28,Uzbekistan
3312,2/1/2020,UZB,Kedah,102,25,77,Uzbekistan
3313,2/1/2020,UZB,Kelantan,1,0,1,Uzbekistan
3314,2/1/2020,UZB,Perak,0,0,0,Uzbekistan
3315,2/1/2020,UZB,Perlis,0,0,0,Uzbekistan
3316,2/1/2020,UZB,Pulau Pinang,4,0,4,Uzbekistan
3317,2/1/2020,UZB,Sabah,3,3,0,Uzbekistan
3318,2/1/2020,UZB,Sarawak,5,4,1,Uzbekistan
3319,2/1/2020,UZB,Selangor,1107,715,392,Uzbekistan
3320,2/1/2020,VAT,Johor,0,0,0,Holy See (Vatican City State)
3321,2/1/2020,VAT,Sarawak,0,0,0,Holy See (Vatican City State)
3322,2/1/2020,VAT,Selangor,2,2,0,Holy See (Vatican City State)
3323,2/1/2020,VCT,Johor,0,0,0,Saint Vincent and the Grenadines
3324,2/1/2020,VCT,Kedah,1,0,1,Saint Vincent and the Grenadines
3325,2/1/2020,VCT,Pulau Pinang,0,0,0,Saint Vincent and the Grenadines
3326,2/1/2020,VCT,Sarawak,0,0,0,Saint Vincent and the Grenadines
3327,2/1/2020,VCT,Selangor,3,3,0,Saint Vincent and the Grenadines
3328,2/1/2020,VEN,Johor,24,16,8,Venezuela
3329,2/1/2020,VEN,Kedah,1,0,1,Venezuela
3330,2/1/2020,VEN,Kelantan,1,1,0,Venezuela
3331,2/1/2020,VEN,Melaka,0,0,0,Venezuela
3332,2/1/2020,VEN,Perak,0,0,0,Venezuela
3333,2/1/2020,VEN,Perlis,0,0,0,Venezuela
3334,2/1/2020,VEN,Pulau Pinang,0,0,0,Venezuela
3335,2/1/2020,VEN,Sabah,1,1,0,Venezuela
3336,2/1/2020,VEN,Sarawak,7,4,3,Venezuela
3337,2/1/2020,VEN,Selangor,88,50,38,Venezuela
3338,2/1/2020,VEN,W.P. Labuan,0,0,0,Venezuela
3339,2/1/2020,VNM,Johor,8786,2492,6294,Vietnam
3340,2/1/2020,VNM,Kedah,485,34,451,Vietnam
3341,2/1/2020,VNM,Kelantan,28,17,11,Vietnam
3342,2/1/2020,VNM,Melaka,0,0,0,Vietnam
3343,2/1/2020,VNM,Negeri Sembilan,0,0,0,Vietnam
3344,2/1/2020,VNM,Pahang,2,2,0,Vietnam
3345,2/1/2020,VNM,Perak,51,4,47,Vietnam
3346,2/1/2020,VNM,Perlis,93,19,74,Vietnam
3347,2/1/2020,VNM,Pulau Pinang,899,198,701,Vietnam
3348,2/1/2020,VNM,Sabah,34,8,26,Vietnam
3349,2/1/2020,VNM,Sarawak,571,151,420,Vietnam
3350,2/1/2020,VNM,Selangor,17058,5766,11292,Vietnam
3351,2/1/2020,VNM,Terengganu,0,0,0,Vietnam
3352,2/1/2020,VNM,W.P. Labuan,4,3,1,Vietnam
3353,2/1/2020,VUT,Johor,12,10,2,Vanuatu
3354,2/1/2020,VUT,Kedah,1,1,0,Vanuatu
3355,2/1/2020,VUT,Pulau Pinang,1,1,0,Vanuatu
3356,2/1/2020,VUT,Sabah,3,3,0,Vanuatu
3357,2/1/2020,VUT,Sarawak,0,0,0,Vanuatu
3358,2/1/2020,VUT,Selangor,51,46,5,Vanuatu
3359,2/1/2020,WSM,Johor,0,0,0,Samoa
3360,2/1/2020,WSM,Sarawak,0,0,0,Samoa
3361,2/1/2020,WSM,Selangor,3,1,2,Samoa
3362,2/1/2020,YEM,Johor,44,27,17,Yemen
3363,2/1/2020,YEM,Kedah,6,4,2,Yemen
3364,2/1/2020,YEM,Kelantan,1,1,0,Yemen
3365,2/1/2020,YEM,Melaka,5,3,2,Yemen
3366,2/1/2020,YEM,Pahang,0,0,0,Yemen
3367,2/1/2020,YEM,Perak,0,0,0,Yemen
3368,2/1/2020,YEM,Perlis,2,2,0,Yemen
3369,2/1/2020,YEM,Pulau Pinang,12,10,2,Yemen
3370,2/1/2020,YEM,Sabah,1,1,0,Yemen
3371,2/1/2020,YEM,Sarawak,2,2,0,Yemen
3372,2/1/2020,YEM,Selangor,2987,2308,679,Yemen
3373,2/1/2020,YEM,W.P. Labuan,0,0,0,Yemen
3374,2/1/2020,ZAF,Johor,199,132,67,South Africa
3375,2/1/2020,ZAF,Kedah,67,34,33,South Africa
3376,2/1/2020,ZAF,Kelantan,18,9,9,South Africa
3377,2/1/2020,ZAF,Melaka,0,0,0,South Africa
3378,2/1/2020,ZAF,Pahang,0,0,0,South Africa
3379,2/1/2020,ZAF,Perak,1,1,0,South Africa
3380,2/1/2020,ZAF,Perlis,7,5,2,South Africa
3381,2/1/2020,ZAF,Pulau Pinang,46,30,16,South Africa
3382,2/1/2020,ZAF,Sabah,11,6,5,South Africa
3383,2/1/2020,ZAF,Sarawak,71,46,25,South Africa
3384,2/1/2020,ZAF,Selangor,938,519,419,South Africa
3385,2/1/2020,ZAF,Terengganu,0,0,0,South Africa
3386,2/1/2020,ZAF,W.P. Labuan,0,0,0,South Africa
3387,2/1/2020,ZMB,Johor,2,1,1,Zambia
3388,2/1/2020,ZMB,Kedah,0,0,0,Zambia
3389,2/1/2020,ZMB,Perak,0,0,0,Zambia
3390,2/1/2020,ZMB,Perlis,0,0,0,Zambia
3391,2/1/2020,ZMB,Pulau Pinang,2,1,1,Zambia
3392,2/1/2020,ZMB,Sabah,0,0,0,Zambia
3393,2/1/2020,ZMB,Sarawak,1,1,0,Zambia
3394,2/1/2020,ZMB,Selangor,76,41,35,Zambia
3395,2/1/2020,ZWE,Johor,33,20,13,Zimbabwe
3396,2/1/2020,ZWE,Kedah,0,0,0,Zimbabwe
3397,2/1/2020,ZWE,Kelantan,1,1,0,Zimbabwe
3398,2/1/2020,ZWE,Perak,0,0,0,Zimbabwe
3399,2/1/2020,ZWE,Perlis,0,0,0,Zimbabwe
3400,2/1/2020,ZWE,Pulau Pinang,1,1,0,Zimbabwe
3401,2/1/2020,ZWE,Sabah,0,0,0,Zimbabwe
3402,2/1/2020,ZWE,Sarawak,0,0,0,Zimbabwe
3403,2/1/2020,ZWE,Selangor,134,82,52,Zimbabwe
3404,3/1/2020,ABW,Kedah,0,0,0,Aruba
3405,3/1/2020,ABW,Pulau Pinang,0,0,0,Aruba
3406,3/1/2020,AFG,Johor,3,3,0,Afghanistan
3407,3/1/2020,AFG,Kedah,0,0,0,Afghanistan
3408,3/1/2020,AFG,Perlis,0,0,0,Afghanistan
3409,3/1/2020,AFG,Pulau Pinang,0,0,0,Afghanistan
3410,3/1/2020,AFG,Sarawak,0,0,0,Afghanistan
3411,3/1/2020,AFG,Selangor,84,68,16,Afghanistan
3412,3/1/2020,AGO,Johor,0,0,0,Angola
3413,3/1/2020,AGO,Kedah,0,0,0,Angola
3414,3/1/2020,AGO,Sabah,0,0,0,Angola
3415,3/1/2020,AGO,Selangor,1,0,1,Angola
3416,3/1/2020,AIA,Selangor,0,0,0,Anguilla
3417,3/1/2020,ALB,Johor,7,6,1,Albania
3418,3/1/2020,ALB,Kedah,0,0,0,Albania
3419,3/1/2020,ALB,Perak,0,0,0,Albania
3420,3/1/2020,ALB,Perlis,0,0,0,Albania
3421,3/1/2020,ALB,Pulau Pinang,1,1,0,Albania
3422,3/1/2020,ALB,Sabah,0,0,0,Albania
3423,3/1/2020,ALB,Sarawak,0,0,0,Albania
3424,3/1/2020,ALB,Selangor,19,10,9,Albania
3425,3/1/2020,AND,Johor,0,0,0,Andorra
3426,3/1/2020,AND,Kedah,0,0,0,Andorra
3427,3/1/2020,AND,Perlis,0,0,0,Andorra
3428,3/1/2020,AND,Pulau Pinang,0,0,0,Andorra
3429,3/1/2020,AND,Selangor,1,1,0,Andorra
3430,3/1/2020,ANT,Selangor,0,0,0,Netherlands Antilles
3431,3/1/2020,ARE,Johor,4,4,0,United Arab Emirates
3432,3/1/2020,ARE,Kedah,0,0,0,United Arab Emirates
3433,3/1/2020,ARE,Kelantan,0,0,0,United Arab Emirates
3434,3/1/2020,ARE,Perak,0,0,0,United Arab Emirates
3435,3/1/2020,ARE,Perlis,0,0,0,United Arab Emirates
3436,3/1/2020,ARE,Pulau Pinang,0,0,0,United Arab Emirates
3437,3/1/2020,ARE,Sabah,0,0,0,United Arab Emirates
3438,3/1/2020,ARE,Sarawak,0,0,0,United Arab Emirates
3439,3/1/2020,ARE,Selangor,60,49,11,United Arab Emirates
3440,3/1/2020,ARG,Johor,56,25,31,Argentina
3441,3/1/2020,ARG,Kedah,99,51,48,Argentina
3442,3/1/2020,ARG,Kelantan,0,0,0,Argentina
3443,3/1/2020,ARG,Melaka,0,0,0,Argentina
3444,3/1/2020,ARG,Perak,0,0,0,Argentina
3445,3/1/2020,ARG,Perlis,14,4,10,Argentina
3446,3/1/2020,ARG,Pulau Pinang,6,2,4,Argentina
3447,3/1/2020,ARG,Sabah,3,3,0,Argentina
3448,3/1/2020,ARG,Sarawak,3,3,0,Argentina
3449,3/1/2020,ARG,Selangor,329,181,148,Argentina
3450,3/1/2020,ARG,W.P. Labuan,1,1,0,Argentina
3451,3/1/2020,ARM,Johor,5,2,3,Armenia
3452,3/1/2020,ARM,Kedah,0,0,0,Armenia
3453,3/1/2020,ARM,Kelantan,0,0,0,Armenia
3454,3/1/2020,ARM,Perak,0,0,0,Armenia
3455,3/1/2020,ARM,Perlis,0,0,0,Armenia
3456,3/1/2020,ARM,Pulau Pinang,1,1,0,Armenia
3457,3/1/2020,ARM,Sabah,0,0,0,Armenia
3458,3/1/2020,ARM,Sarawak,0,0,0,Armenia
3459,3/1/2020,ARM,Selangor,18,9,9,Armenia
3460,3/1/2020,ATA,Selangor,0,0,0,Antarctica
3461,3/1/2020,ATG,Johor,1,1,0,Antigua and Barbuda
3462,3/1/2020,ATG,Kedah,0,0,0,Antigua and Barbuda
3463,3/1/2020,ATG,Pulau Pinang,0,0,0,Antigua and Barbuda
3464,3/1/2020,ATG,Sarawak,0,0,0,Antigua and Barbuda
3465,3/1/2020,ATG,Selangor,6,5,1,Antigua and Barbuda
3466,3/1/2020,AUS,Johor,1347,887,460,Australia
3467,3/1/2020,AUS,Kedah,253,148,105,Australia
3468,3/1/2020,AUS,Kelantan,8,4,4,Australia
3469,3/1/2020,AUS,Melaka,1,1,0,Australia
3470,3/1/2020,AUS,Negeri Sembilan,1,1,0,Australia
3471,3/1/2020,AUS,Pahang,2,1,1,Australia
3472,3/1/2020,AUS,Perak,42,22,20,Australia
3473,3/1/2020,AUS,Perlis,30,22,8,Australia
3474,3/1/2020,AUS,Pulau Pinang,583,306,277,Australia
3475,3/1/2020,AUS,Sabah,170,71,99,Australia
3476,3/1/2020,AUS,Sarawak,160,102,58,Australia
3477,3/1/2020,AUS,Selangor,6804,4239,2565,Australia
3478,3/1/2020,AUS,Terengganu,2,2,0,Australia
3479,3/1/2020,AUS,W.P. Labuan,6,4,2,Australia
3480,3/1/2020,AUT,Johor,88,64,24,Austria
3481,3/1/2020,AUT,Kedah,51,30,21,Austria
3482,3/1/2020,AUT,Kelantan,7,6,1,Austria
3483,3/1/2020,AUT,Melaka,0,0,0,Austria
3484,3/1/2020,AUT,Negeri Sembilan,0,0,0,Austria
3485,3/1/2020,AUT,Pahang,0,0,0,Austria
3486,3/1/2020,AUT,Perak,0,0,0,Austria
3487,3/1/2020,AUT,Perlis,6,4,2,Austria
3488,3/1/2020,AUT,Pulau Pinang,42,26,16,Austria
3489,3/1/2020,AUT,Sabah,9,5,4,Austria
3490,3/1/2020,AUT,Sarawak,3,3,0,Austria
3491,3/1/2020,AUT,Selangor,403,241,162,Austria
3492,3/1/2020,AUT,Terengganu,0,0,0,Austria
3493,3/1/2020,AUT,W.P. Labuan,0,0,0,Austria
3494,3/1/2020,AZE,Johor,1,1,0,Azerbaijan
3495,3/1/2020,AZE,Kedah,0,0,0,Azerbaijan
3496,3/1/2020,AZE,Kelantan,0,0,0,Azerbaijan
3497,3/1/2020,AZE,Melaka,0,0,0,Azerbaijan
3498,3/1/2020,AZE,Perlis,0,0,0,Azerbaijan
3499,3/1/2020,AZE,Pulau Pinang,0,0,0,Azerbaijan
3500,3/1/2020,AZE,Sabah,0,0,0,Azerbaijan
3501,3/1/2020,AZE,Sarawak,0,0,0,Azerbaijan
3502,3/1/2020,AZE,Selangor,27,19,8,Azerbaijan
3503,3/1/2020,AZE,W.P. Labuan,0,0,0,Azerbaijan
3504,3/1/2020,BDI,Pulau Pinang,0,0,0,Burundi
3505,3/1/2020,BDI,Sarawak,0,0,0,Burundi
3506,3/1/2020,BDI,Selangor,1,1,0,Burundi
3507,3/1/2020,BEL,Johor,121,86,35,Belgium
3508,3/1/2020,BEL,Kedah,70,37,33,Belgium
3509,3/1/2020,BEL,Kelantan,6,4,2,Belgium
3510,3/1/2020,BEL,Melaka,0,0,0,Belgium
3511,3/1/2020,BEL,Negeri Sembilan,0,0,0,Belgium
3512,3/1/2020,BEL,Pahang,4,2,2,Belgium
3513,3/1/2020,BEL,Perak,0,0,0,Belgium
3514,3/1/2020,BEL,Perlis,9,5,4,Belgium
3515,3/1/2020,BEL,Pulau Pinang,30,22,8,Belgium
3516,3/1/2020,BEL,Sabah,16,12,4,Belgium
3517,3/1/2020,BEL,Sarawak,16,6,10,Belgium
3518,3/1/2020,BEL,Selangor,580,378,202,Belgium
3519,3/1/2020,BEL,W.P. Labuan,2,1,1,Belgium
3520,3/1/2020,BEN,Johor,0,0,0,Benin
3521,3/1/2020,BEN,Kedah,0,0,0,Benin
3522,3/1/2020,BEN,Perak,0,0,0,Benin
3523,3/1/2020,BEN,Pulau Pinang,0,0,0,Benin
3524,3/1/2020,BEN,Sabah,0,0,0,Benin
3525,3/1/2020,BEN,Sarawak,0,0,0,Benin
3526,3/1/2020,BEN,Selangor,1,1,0,Benin
3527,3/1/2020,BFA,Perak,0,0,0,Burkina Faso
3528,3/1/2020,BFA,Pulau Pinang,0,0,0,Burkina Faso
3529,3/1/2020,BFA,Selangor,1,1,0,Burkina Faso
3530,3/1/2020,BGD,Johor,794,699,95,Bangladesh
3531,3/1/2020,BGD,Kedah,0,0,0,Bangladesh
3532,3/1/2020,BGD,Kelantan,0,0,0,Bangladesh
3533,3/1/2020,BGD,Melaka,0,0,0,Bangladesh
3534,3/1/2020,BGD,Negeri Sembilan,0,0,0,Bangladesh
3535,3/1/2020,BGD,Pahang,0,0,0,Bangladesh
3536,3/1/2020,BGD,Perak,0,0,0,Bangladesh
3537,3/1/2020,BGD,Perlis,0,0,0,Bangladesh
3538,3/1/2020,BGD,Pulau Pinang,51,51,0,Bangladesh
3539,3/1/2020,BGD,Sabah,1,1,0,Bangladesh
3540,3/1/2020,BGD,Sarawak,48,48,0,Bangladesh
3541,3/1/2020,BGD,Selangor,9470,8768,702,Bangladesh
3542,3/1/2020,BGD,W.P. Labuan,5,5,0,Bangladesh
3543,3/1/2020,BGR,Johor,24,18,6,Bulgaria
3544,3/1/2020,BGR,Kedah,12,6,6,Bulgaria
3545,3/1/2020,BGR,Kelantan,0,0,0,Bulgaria
3546,3/1/2020,BGR,Pahang,0,0,0,Bulgaria
3547,3/1/2020,BGR,Perak,0,0,0,Bulgaria
3548,3/1/2020,BGR,Perlis,1,1,0,Bulgaria
3549,3/1/2020,BGR,Pulau Pinang,3,2,1,Bulgaria
3550,3/1/2020,BGR,Sabah,0,0,0,Bulgaria
3551,3/1/2020,BGR,Sarawak,0,0,0,Bulgaria
3552,3/1/2020,BGR,Selangor,146,90,56,Bulgaria
3553,3/1/2020,BGR,W.P. Labuan,0,0,0,Bulgaria
3554,3/1/2020,BHR,Johor,0,0,0,Bahrain
3555,3/1/2020,BHR,Kedah,1,1,0,Bahrain
3556,3/1/2020,BHR,Kelantan,0,0,0,Bahrain
3557,3/1/2020,BHR,Perlis,0,0,0,Bahrain
3558,3/1/2020,BHR,Pulau Pinang,0,0,0,Bahrain
3559,3/1/2020,BHR,Sabah,0,0,0,Bahrain
3560,3/1/2020,BHR,Sarawak,1,1,0,Bahrain
3561,3/1/2020,BHR,Selangor,18,14,4,Bahrain
3562,3/1/2020,BHS,Johor,0,0,0,Bahamas
3563,3/1/2020,BHS,Kedah,0,0,0,Bahamas
3564,3/1/2020,BHS,Perak,0,0,0,Bahamas
3565,3/1/2020,BHS,Sabah,0,0,0,Bahamas
3566,3/1/2020,BHS,Sarawak,0,0,0,Bahamas
3567,3/1/2020,BHS,Selangor,2,1,1,Bahamas
3568,3/1/2020,BIH,Johor,1,1,0,Bosnia and Herzegovina
3569,3/1/2020,BIH,Kedah,0,0,0,Bosnia and Herzegovina
3570,3/1/2020,BIH,Perlis,0,0,0,Bosnia and Herzegovina
3571,3/1/2020,BIH,Pulau Pinang,4,3,1,Bosnia and Herzegovina
3572,3/1/2020,BIH,Sabah,0,0,0,Bosnia and Herzegovina
3573,3/1/2020,BIH,Sarawak,0,0,0,Bosnia and Herzegovina
3574,3/1/2020,BIH,Selangor,24,17,7,Bosnia and Herzegovina
3575,3/1/2020,BLR,Johor,7,2,5,Belarus
3576,3/1/2020,BLR,Kedah,16,7,9,Belarus
3577,3/1/2020,BLR,Kelantan,0,0,0,Belarus
3578,3/1/2020,BLR,Pahang,0,0,0,Belarus
3579,3/1/2020,BLR,Perak,0,0,0,Belarus
3580,3/1/2020,BLR,Perlis,1,1,0,Belarus
3581,3/1/2020,BLR,Pulau Pinang,0,0,0,Belarus
3582,3/1/2020,BLR,Sabah,0,0,0,Belarus
3583,3/1/2020,BLR,Sarawak,2,0,2,Belarus
3584,3/1/2020,BLR,Selangor,208,97,111,Belarus
3585,3/1/2020,BLR,W.P. Labuan,1,0,1,Belarus
3586,3/1/2020,BLZ,Johor,0,0,0,Belize
3587,3/1/2020,BLZ,Pulau Pinang,0,0,0,Belize
3588,3/1/2020,BLZ,Sarawak,0,0,0,Belize
3589,3/1/2020,BLZ,Selangor,2,2,0,Belize
3590,3/1/2020,BMU,Selangor,0,0,0,Bermuda
3591,3/1/2020,BOL,Johor,1,1,0,Bolivia
3592,3/1/2020,BOL,Kedah,1,0,1,Bolivia
3593,3/1/2020,BOL,Melaka,0,0,0,Bolivia
3594,3/1/2020,BOL,Perak,0,0,0,Bolivia
3595,3/1/2020,BOL,Perlis,0,0,0,Bolivia
3596,3/1/2020,BOL,Pulau Pinang,0,0,0,Bolivia
3597,3/1/2020,BOL,Sabah,0,0,0,Bolivia
3598,3/1/2020,BOL,Sarawak,0,0,0,Bolivia
3599,3/1/2020,BOL,Selangor,10,6,4,Bolivia
3600,3/1/2020,BRA,Johor,71,39,32,Brazil
3601,3/1/2020,BRA,Kedah,53,29,24,Brazil
3602,3/1/2020,BRA,Kelantan,0,0,0,Brazil
3603,3/1/2020,BRA,Melaka,0,0,0,Brazil
3604,3/1/2020,BRA,Pahang,0,0,0,Brazil
3605,3/1/2020,BRA,Perak,0,0,0,Brazil
3606,3/1/2020,BRA,Perlis,2,0,2,Brazil
3607,3/1/2020,BRA,Pulau Pinang,14,7,7,Brazil
3608,3/1/2020,BRA,Sabah,5,2,3,Brazil
3609,3/1/2020,BRA,Sarawak,2,0,2,Brazil
3610,3/1/2020,BRA,Selangor,517,288,229,Brazil
3611,3/1/2020,BRA,W.P. Labuan,0,0,0,Brazil
3612,3/1/2020,BRB,Johor,1,0,1,Barbados
3613,3/1/2020,BRB,Kedah,0,0,0,Barbados
3614,3/1/2020,BRB,Perlis,0,0,0,Barbados
3615,3/1/2020,BRB,Pulau Pinang,0,0,0,Barbados
3616,3/1/2020,BRB,Selangor,0,0,0,Barbados
3617,3/1/2020,BRN,Johor,59,33,26,Brunei Darussalam
3618,3/1/2020,BRN,Kedah,6,4,2,Brunei Darussalam
3619,3/1/2020,BRN,Kelantan,4,2,2,Brunei Darussalam
3620,3/1/2020,BRN,Melaka,0,0,0,Brunei Darussalam
3621,3/1/2020,BRN,Pahang,0,0,0,Brunei Darussalam
3622,3/1/2020,BRN,Perak,0,0,0,Brunei Darussalam
3623,3/1/2020,BRN,Perlis,0,0,0,Brunei Darussalam
3624,3/1/2020,BRN,Pulau Pinang,1,0,1,Brunei Darussalam
3625,3/1/2020,BRN,Sabah,217,137,80,Brunei Darussalam
3626,3/1/2020,BRN,Sarawak,29596,17860,11736,Brunei Darussalam
3627,3/1/2020,BRN,Selangor,1243,669,574,Brunei Darussalam
3628,3/1/2020,BRN,W.P. Labuan,470,341,129,Brunei Darussalam
3629,3/1/2020,BTN,Johor,2,0,2,Bhutan
3630,3/1/2020,BTN,Kedah,1,1,0,Bhutan
3631,3/1/2020,BTN,Perak,0,0,0,Bhutan
3632,3/1/2020,BTN,Perlis,0,0,0,Bhutan
3633,3/1/2020,BTN,Pulau Pinang,0,0,0,Bhutan
3634,3/1/2020,BTN,Sabah,0,0,0,Bhutan
3635,3/1/2020,BTN,Sarawak,0,0,0,Bhutan
3636,3/1/2020,BTN,Selangor,10,8,2,Bhutan
3637,3/1/2020,BWA,Johor,0,0,0,Botswana
3638,3/1/2020,BWA,Kedah,0,0,0,Botswana
3639,3/1/2020,BWA,Perlis,0,0,0,Botswana
3640,3/1/2020,BWA,Pulau Pinang,0,0,0,Botswana
3641,3/1/2020,BWA,Sabah,0,0,0,Botswana
3642,3/1/2020,BWA,Sarawak,0,0,0,Botswana
3643,3/1/2020,BWA,Selangor,6,2,4,Botswana
3644,3/1/2020,CAF,Kedah,0,0,0,Central African Republic
3645,3/1/2020,CAF,Selangor,0,0,0,Central African Republic
3646,3/1/2020,CAN,Johor,450,272,178,Canada
3647,3/1/2020,CAN,Kedah,130,76,54,Canada
3648,3/1/2020,CAN,Kelantan,12,9,3,Canada
3649,3/1/2020,CAN,Melaka,0,0,0,Canada
3650,3/1/2020,CAN,Negeri Sembilan,0,0,0,Canada
3651,3/1/2020,CAN,Pahang,2,1,1,Canada
3652,3/1/2020,CAN,Perak,6,6,0,Canada
3653,3/1/2020,CAN,Perlis,35,23,12,Canada
3654,3/1/2020,CAN,Pulau Pinang,211,127,84,Canada
3655,3/1/2020,CAN,Sabah,64,34,30,Canada
3656,3/1/2020,CAN,Sarawak,131,83,48,Canada
3657,3/1/2020,CAN,Selangor,1730,1023,707,Canada
3658,3/1/2020,CAN,Terengganu,0,0,0,Canada
3659,3/1/2020,CAN,W.P. Labuan,6,3,3,Canada
3660,3/1/2020,CCK,Selangor,0,0,0,Cocos (Keeling) Islands
3661,3/1/2020,CHE,Johor,174,104,70,Switzerland
3662,3/1/2020,CHE,Kedah,134,70,64,Switzerland
3663,3/1/2020,CHE,Kelantan,3,1,2,Switzerland
3664,3/1/2020,CHE,Melaka,0,0,0,Switzerland
3665,3/1/2020,CHE,Negeri Sembilan,0,0,0,Switzerland
3666,3/1/2020,CHE,Pahang,0,0,0,Switzerland
3667,3/1/2020,CHE,Perak,5,2,3,Switzerland
3668,3/1/2020,CHE,Perlis,26,15,11,Switzerland
3669,3/1/2020,CHE,Pulau Pinang,63,42,21,Switzerland
3670,3/1/2020,CHE,Sabah,32,13,19,Switzerland
3671,3/1/2020,CHE,Sarawak,21,8,13,Switzerland
3672,3/1/2020,CHE,Selangor,624,368,256,Switzerland
3673,3/1/2020,CHE,W.P. Labuan,0,0,0,Switzerland
3674,3/1/2020,CHL,Johor,15,7,8,Chile
3675,3/1/2020,CHL,Kedah,26,12,14,Chile
3676,3/1/2020,CHL,Kelantan,2,0,2,Chile
3677,3/1/2020,CHL,Melaka,0,0,0,Chile
3678,3/1/2020,CHL,Pahang,0,0,0,Chile
3679,3/1/2020,CHL,Perak,0,0,0,Chile
3680,3/1/2020,CHL,Perlis,1,0,1,Chile
3681,3/1/2020,CHL,Pulau Pinang,3,2,1,Chile
3682,3/1/2020,CHL,Sabah,2,1,1,Chile
3683,3/1/2020,CHL,Sarawak,0,0,0,Chile
3684,3/1/2020,CHL,Selangor,163,81,82,Chile
3685,3/1/2020,CHN,Johor,4791,1978,2813,China
3686,3/1/2020,CHN,Kedah,232,92,140,China
3687,3/1/2020,CHN,Kelantan,10,7,3,China
3688,3/1/2020,CHN,Melaka,0,0,0,China
3689,3/1/2020,CHN,Pahang,2,0,2,China
3690,3/1/2020,CHN,Perak,197,73,124,China
3691,3/1/2020,CHN,Perlis,30,17,13,China
3692,3/1/2020,CHN,Pulau Pinang,954,530,424,China
3693,3/1/2020,CHN,Sabah,105,51,54,China
3694,3/1/2020,CHN,Sarawak,173,58,115,China
3695,3/1/2020,CHN,Selangor,25271,15716,9555,China
3696,3/1/2020,CHN,Terengganu,0,0,0,China
3697,3/1/2020,CHN,W.P. Labuan,0,0,0,China
3698,3/1/2020,CIV,Johor,0,0,0,C��te d'Iv
3699,3/1/2020,CIV,Kedah,0,0,0,C��te d'Iv
3700,3/1/2020,CIV,Pulau Pinang,0,0,0,C��te d'Iv
3701,3/1/2020,CIV,Sabah,0,0,0,C��te d'Iv
3702,3/1/2020,CIV,Sarawak,0,0,0,C��te d'Iv
3703,3/1/2020,CIV,Selangor,6,6,0,C��te d'Iv
3704,3/1/2020,CMR,Johor,4,4,0,Cameroon
3705,3/1/2020,CMR,Kedah,0,0,0,Cameroon
3706,3/1/2020,CMR,Pulau Pinang,0,0,0,Cameroon
3707,3/1/2020,CMR,Sabah,0,0,0,Cameroon
3708,3/1/2020,CMR,Sarawak,0,0,0,Cameroon
3709,3/1/2020,CMR,Selangor,10,5,5,Cameroon
3710,3/1/2020,COD,Johor,0,0,0,"Congo, the Democratic Republic of the"
3711,3/1/2020,COD,Pulau Pinang,0,0,0,"Congo, the Democratic Republic of the"
3712,3/1/2020,COD,Sarawak,0,0,0,"Congo, the Democratic Republic of the"
3713,3/1/2020,COD,Selangor,11,6,5,"Congo, the Democratic Republic of the"
3714,3/1/2020,COG,Johor,0,0,0,Congo
3715,3/1/2020,COG,Kedah,1,0,1,Congo
3716,3/1/2020,COG,Selangor,0,0,0,Congo
3717,3/1/2020,COK,Selangor,0,0,0,Cook Islands
3718,3/1/2020,COL,Johor,3,1,2,Colombia
3719,3/1/2020,COL,Kedah,0,0,0,Colombia
3720,3/1/2020,COL,Perak,0,0,0,Colombia
3721,3/1/2020,COL,Pulau Pinang,1,1,0,Colombia
3722,3/1/2020,COL,Sabah,0,0,0,Colombia
3723,3/1/2020,COL,Sarawak,1,0,1,Colombia
3724,3/1/2020,COL,Selangor,54,28,26,Colombia
3725,3/1/2020,COL,W.P. Labuan,0,0,0,Colombia
3726,3/1/2020,COM,Johor,0,0,0,Comoros
3727,3/1/2020,COM,Kedah,0,0,0,Comoros
3728,3/1/2020,COM,Selangor,7,7,0,Comoros
3729,3/1/2020,CPV,Johor,0,0,0,Cape Verde
3730,3/1/2020,CPV,Kedah,0,0,0,Cape Verde
3731,3/1/2020,CPV,Pulau Pinang,0,0,0,Cape Verde
3732,3/1/2020,CPV,Sabah,0,0,0,Cape Verde
3733,3/1/2020,CPV,Selangor,2,2,0,Cape Verde
3734,3/1/2020,CRI,Johor,5,4,1,Costa Rica
3735,3/1/2020,CRI,Kedah,1,1,0,Costa Rica
3736,3/1/2020,CRI,Perak,0,0,0,Costa Rica
3737,3/1/2020,CRI,Perlis,0,0,0,Costa Rica
3738,3/1/2020,CRI,Pulau Pinang,1,0,1,Costa Rica
3739,3/1/2020,CRI,Sabah,0,0,0,Costa Rica
3740,3/1/2020,CRI,Sarawak,0,0,0,Costa Rica
3741,3/1/2020,CRI,Selangor,16,7,9,Costa Rica
3742,3/1/2020,CUB,Johor,2,2,0,Cuba
3743,3/1/2020,CUB,Kedah,1,1,0,Cuba
3744,3/1/2020,CUB,Perlis,0,0,0,Cuba
3745,3/1/2020,CUB,Pulau Pinang,0,0,0,Cuba
3746,3/1/2020,CUB,Sabah,0,0,0,Cuba
3747,3/1/2020,CUB,Sarawak,0,0,0,Cuba
3748,3/1/2020,CUB,Selangor,9,4,5,Cuba
3749,3/1/2020,CYP,Johor,4,3,1,Cyprus
3750,3/1/2020,CYP,Kedah,0,0,0,Cyprus
3751,3/1/2020,CYP,Perak,0,0,0,Cyprus
3752,3/1/2020,CYP,Perlis,0,0,0,Cyprus
3753,3/1/2020,CYP,Pulau Pinang,0,0,0,Cyprus
3754,3/1/2020,CYP,Sabah,0,0,0,Cyprus
3755,3/1/2020,CYP,Sarawak,0,0,0,Cyprus
3756,3/1/2020,CYP,Selangor,17,12,5,Cyprus
3757,3/1/2020,CZE,Johor,125,73,52,Czech Republic
3758,3/1/2020,CZE,Kedah,172,78,94,Czech Republic
3759,3/1/2020,CZE,Kelantan,1,1,0,Czech Republic
3760,3/1/2020,CZE,Melaka,0,0,0,Czech Republic
3761,3/1/2020,CZE,Negeri Sembilan,0,0,0,Czech Republic
3762,3/1/2020,CZE,Perak,0,0,0,Czech Republic
3763,3/1/2020,CZE,Perlis,8,6,2,Czech Republic
3764,3/1/2020,CZE,Pulau Pinang,10,7,3,Czech Republic
3765,3/1/2020,CZE,Sabah,22,11,11,Czech Republic
3766,3/1/2020,CZE,Sarawak,27,18,9,Czech Republic
3767,3/1/2020,CZE,Selangor,418,242,176,Czech Republic
3768,3/1/2020,CZE,W.P. Labuan,0,0,0,Czech Republic
3769,3/1/2020,DEU,Johor,1069,695,374,Germany
3770,3/1/2020,DEU,Kedah,873,463,410,Germany
3771,3/1/2020,DEU,Kelantan,31,21,10,Germany
3772,3/1/2020,DEU,Melaka,0,0,0,Germany
3773,3/1/2020,DEU,Negeri Sembilan,0,0,0,Germany
3774,3/1/2020,DEU,Pahang,1,1,0,Germany
3775,3/1/2020,DEU,Perak,11,6,5,Germany
3776,3/1/2020,DEU,Perlis,90,58,32,Germany
3777,3/1/2020,DEU,Pulau Pinang,318,204,114,Germany
3778,3/1/2020,DEU,Sabah,105,65,40,Germany
3779,3/1/2020,DEU,Sarawak,148,89,59,Germany
3780,3/1/2020,DEU,Selangor,3930,2284,1646,Germany
3781,3/1/2020,DEU,Terengganu,0,0,0,Germany
3782,3/1/2020,DEU,W.P. Labuan,14,11,3,Germany
3783,3/1/2020,DJI,Johor,0,0,0,Djibouti
3784,3/1/2020,DJI,Selangor,4,0,4,Djibouti
3785,3/1/2020,DMA,Johor,2,2,0,Dominica
3786,3/1/2020,DMA,Kedah,0,0,0,Dominica
3787,3/1/2020,DMA,Pulau Pinang,0,0,0,Dominica
3788,3/1/2020,DMA,Sabah,0,0,0,Dominica
3789,3/1/2020,DMA,Sarawak,0,0,0,Dominica
3790,3/1/2020,DMA,Selangor,12,10,2,Dominica
3791,3/1/2020,DMA,W.P. Labuan,0,0,0,Dominica
3792,3/1/2020,DNK,Johor,111,74,37,Denmark
3793,3/1/2020,DNK,Kedah,136,58,78,Denmark
3794,3/1/2020,DNK,Kelantan,0,0,0,Denmark
3795,3/1/2020,DNK,Melaka,0,0,0,Denmark
3796,3/1/2020,DNK,Negeri Sembilan,0,0,0,Denmark
3797,3/1/2020,DNK,Pahang,0,0,0,Denmark
3798,3/1/2020,DNK,Perak,2,1,1,Denmark
3799,3/1/2020,DNK,Perlis,3,1,2,Denmark
3800,3/1/2020,DNK,Pulau Pinang,44,28,16,Denmark
3801,3/1/2020,DNK,Sabah,47,22,25,Denmark
3802,3/1/2020,DNK,Sarawak,20,12,8,Denmark
3803,3/1/2020,DNK,Selangor,527,310,217,Denmark
3804,3/1/2020,DNK,W.P. Labuan,0,0,0,Denmark
3805,3/1/2020,DOM,Johor,0,0,0,Dominican Republic
3806,3/1/2020,DOM,Kedah,0,0,0,Dominican Republic
3807,3/1/2020,DOM,Perak,0,0,0,Dominican Republic
3808,3/1/2020,DOM,Perlis,0,0,0,Dominican Republic
3809,3/1/2020,DOM,Pulau Pinang,0,0,0,Dominican Republic
3810,3/1/2020,DOM,Sabah,0,0,0,Dominican Republic
3811,3/1/2020,DOM,Sarawak,0,0,0,Dominican Republic
3812,3/1/2020,DOM,Selangor,6,4,2,Dominican Republic
3813,3/1/2020,DZA,Johor,21,21,0,Algeria
3814,3/1/2020,DZA,Kedah,6,3,3,Algeria
3815,3/1/2020,DZA,Kelantan,0,0,0,Algeria
3816,3/1/2020,DZA,Melaka,0,0,0,Algeria
3817,3/1/2020,DZA,Perak,0,0,0,Algeria
3818,3/1/2020,DZA,Perlis,2,1,1,Algeria
3819,3/1/2020,DZA,Pulau Pinang,5,4,1,Algeria
3820,3/1/2020,DZA,Sabah,0,0,0,Algeria
3821,3/1/2020,DZA,Sarawak,0,0,0,Algeria
3822,3/1/2020,DZA,Selangor,333,239,94,Algeria
3823,3/1/2020,DZA,W.P. Labuan,0,0,0,Algeria
3824,3/1/2020,ECU,Johor,0,0,0,Ecuador
3825,3/1/2020,ECU,Kedah,0,0,0,Ecuador
3826,3/1/2020,ECU,Perak,0,0,0,Ecuador
3827,3/1/2020,ECU,Perlis,0,0,0,Ecuador
3828,3/1/2020,ECU,Pulau Pinang,0,0,0,Ecuador
3829,3/1/2020,ECU,Sabah,0,0,0,Ecuador
3830,3/1/2020,ECU,Sarawak,0,0,0,Ecuador
3831,3/1/2020,ECU,Selangor,15,7,8,Ecuador
3832,3/1/2020,EGY,Johor,91,80,11,Egypt
3833,3/1/2020,EGY,Kedah,4,2,2,Egypt
3834,3/1/2020,EGY,Kelantan,5,5,0,Egypt
3835,3/1/2020,EGY,Melaka,0,0,0,Egypt
3836,3/1/2020,EGY,Pahang,0,0,0,Egypt
3837,3/1/2020,EGY,Perak,0,0,0,Egypt
3838,3/1/2020,EGY,Perlis,0,0,0,Egypt
3839,3/1/2020,EGY,Pulau Pinang,7,4,3,Egypt
3840,3/1/2020,EGY,Sabah,1,1,0,Egypt
3841,3/1/2020,EGY,Sarawak,8,8,0,Egypt
3842,3/1/2020,EGY,Selangor,645,478,167,Egypt
3843,3/1/2020,EGY,Terengganu,0,0,0,Egypt
3844,3/1/2020,EGY,W.P. Labuan,2,2,0,Egypt
3845,3/1/2020,ERI,Johor,0,0,0,Eritrea
3846,3/1/2020,ERI,Pulau Pinang,0,0,0,Eritrea
3847,3/1/2020,ERI,Sabah,0,0,0,Eritrea
3848,3/1/2020,ERI,Selangor,3,3,0,Eritrea
3849,3/1/2020,ESP,Johor,160,101,59,Spain
3850,3/1/2020,ESP,Kedah,114,53,61,Spain
3851,3/1/2020,ESP,Kelantan,7,5,2,Spain
3852,3/1/2020,ESP,Melaka,1,1,0,Spain
3853,3/1/2020,ESP,Negeri Sembilan,0,0,0,Spain
3854,3/1/2020,ESP,Pahang,1,1,0,Spain
3855,3/1/2020,ESP,Perak,0,0,0,Spain
3856,3/1/2020,ESP,Perlis,19,11,8,Spain
3857,3/1/2020,ESP,Pulau Pinang,36,20,16,Spain
3858,3/1/2020,ESP,Sabah,19,10,9,Spain
3859,3/1/2020,ESP,Sarawak,16,7,9,Spain
3860,3/1/2020,ESP,Selangor,1054,615,439,Spain
3861,3/1/2020,ESP,W.P. Labuan,1,1,0,Spain
3862,3/1/2020,EST,Johor,24,8,16,Estonia
3863,3/1/2020,EST,Kedah,65,27,38,Estonia
3864,3/1/2020,EST,Kelantan,1,0,1,Estonia
3865,3/1/2020,EST,Pahang,0,0,0,Estonia
3866,3/1/2020,EST,Perak,0,0,0,Estonia
3867,3/1/2020,EST,Perlis,0,0,0,Estonia
3868,3/1/2020,EST,Pulau Pinang,3,1,2,Estonia
3869,3/1/2020,EST,Sabah,2,0,2,Estonia
3870,3/1/2020,EST,Sarawak,2,0,2,Estonia
3871,3/1/2020,EST,Selangor,110,61,49,Estonia
3872,3/1/2020,EST,W.P. Labuan,2,1,1,Estonia
3873,3/1/2020,ETH,Johor,0,0,0,Ethiopia
3874,3/1/2020,ETH,Kedah,0,0,0,Ethiopia
3875,3/1/2020,ETH,Pulau Pinang,0,0,0,Ethiopia
3876,3/1/2020,ETH,Sarawak,0,0,0,Ethiopia
3877,3/1/2020,ETH,Selangor,13,6,7,Ethiopia
3878,3/1/2020,FIN,Johor,104,76,28,Finland
3879,3/1/2020,FIN,Kedah,180,84,96,Finland
3880,3/1/2020,FIN,Kelantan,3,2,1,Finland
3881,3/1/2020,FIN,Melaka,2,1,1,Finland
3882,3/1/2020,FIN,Negeri Sembilan,0,0,0,Finland
3883,3/1/2020,FIN,Pahang,0,0,0,Finland
3884,3/1/2020,FIN,Perak,2,1,1,Finland
3885,3/1/2020,FIN,Perlis,6,5,1,Finland
3886,3/1/2020,FIN,Pulau Pinang,43,26,17,Finland
3887,3/1/2020,FIN,Sabah,12,6,6,Finland
3888,3/1/2020,FIN,Sarawak,5,2,3,Finland
3889,3/1/2020,FIN,Selangor,425,238,187,Finland
3890,3/1/2020,FIN,W.P. Labuan,4,2,2,Finland
3891,3/1/2020,FJI,Johor,0,0,0,Fiji
3892,3/1/2020,FJI,Kedah,0,0,0,Fiji
3893,3/1/2020,FJI,Kelantan,0,0,0,Fiji
3894,3/1/2020,FJI,Perak,0,0,0,Fiji
3895,3/1/2020,FJI,Perlis,0,0,0,Fiji
3896,3/1/2020,FJI,Pulau Pinang,0,0,0,Fiji
3897,3/1/2020,FJI,Sabah,0,0,0,Fiji
3898,3/1/2020,FJI,Sarawak,1,1,0,Fiji
3899,3/1/2020,FJI,Selangor,28,14,14,Fiji
3900,3/1/2020,FRA,Johor,792,518,274,France
3901,3/1/2020,FRA,Kedah,693,391,302,France
3902,3/1/2020,FRA,Kelantan,61,36,25,France
3903,3/1/2020,FRA,Melaka,0,0,0,France
3904,3/1/2020,FRA,Negeri Sembilan,1,1,0,France
3905,3/1/2020,FRA,Pahang,12,7,5,France
3906,3/1/2020,FRA,Perak,8,6,2,France
3907,3/1/2020,FRA,Perlis,68,38,30,France
3908,3/1/2020,FRA,Pulau Pinang,231,146,85,France
3909,3/1/2020,FRA,Sabah,60,43,17,France
3910,3/1/2020,FRA,Sarawak,43,32,11,France
3911,3/1/2020,FRA,Selangor,4310,2537,1773,France
3912,3/1/2020,FRA,Terengganu,0,0,0,France
3913,3/1/2020,FRA,W.P. Labuan,1,1,0,France
3914,3/1/2020,FSM,Johor,0,0,0,"Micronesia, Federated States of"
3915,3/1/2020,FSM,Pulau Pinang,0,0,0,"Micronesia, Federated States of"
3916,3/1/2020,FSM,Selangor,0,0,0,"Micronesia, Federated States of"
3917,3/1/2020,GAB,Johor,0,0,0,Gabon
3918,3/1/2020,GAB,Pulau Pinang,0,0,0,Gabon
3919,3/1/2020,GAB,Sarawak,0,0,0,Gabon
3920,3/1/2020,GAB,Selangor,5,3,2,Gabon
3921,3/1/2020,GBR,Johor,2111,1405,706,United Kingdom
3922,3/1/2020,GBR,Kedah,794,443,351,United Kingdom
3923,3/1/2020,GBR,Kelantan,27,15,12,United Kingdom
3924,3/1/2020,GBR,Melaka,1,1,0,United Kingdom
3925,3/1/2020,GBR,Negeri Sembilan,1,1,0,United Kingdom
3926,3/1/2020,GBR,Pahang,2,1,1,United Kingdom
3927,3/1/2020,GBR,Perak,36,21,15,United Kingdom
3928,3/1/2020,GBR,Perlis,152,93,59,United Kingdom
3929,3/1/2020,GBR,Pulau Pinang,832,499,333,United Kingdom
3930,3/1/2020,GBR,Sabah,291,146,145,United Kingdom
3931,3/1/2020,GBR,Sarawak,449,312,137,United Kingdom
3932,3/1/2020,GBR,Selangor,8560,5286,3274,United Kingdom
3933,3/1/2020,GBR,Terengganu,2,2,0,United Kingdom
3934,3/1/2020,GBR,W.P. Labuan,48,38,10,United Kingdom
3935,3/1/2020,GEO,Johor,3,3,0,Georgia
3936,3/1/2020,GEO,Kedah,1,1,0,Georgia
3937,3/1/2020,GEO,Melaka,0,0,0,Georgia
3938,3/1/2020,GEO,Perak,0,0,0,Georgia
3939,3/1/2020,GEO,Perlis,0,0,0,Georgia
3940,3/1/2020,GEO,Pulau Pinang,1,1,0,Georgia
3941,3/1/2020,GEO,Sabah,0,0,0,Georgia
3942,3/1/2020,GEO,Sarawak,0,0,0,Georgia
3943,3/1/2020,GEO,Selangor,14,12,2,Georgia
3944,3/1/2020,GHA,Johor,2,1,1,Ghana
3945,3/1/2020,GHA,Kedah,0,0,0,Ghana
3946,3/1/2020,GHA,Kelantan,0,0,0,Ghana
3947,3/1/2020,GHA,Pulau Pinang,0,0,0,Ghana
3948,3/1/2020,GHA,Sabah,0,0,0,Ghana
3949,3/1/2020,GHA,Sarawak,0,0,0,Ghana
3950,3/1/2020,GHA,Selangor,19,14,5,Ghana
3951,3/1/2020,GIB,Johor,0,0,0,Gibraltar
3952,3/1/2020,GIB,Sarawak,0,0,0,Gibraltar
3953,3/1/2020,GIN,Johor,0,0,0,Guinea
3954,3/1/2020,GIN,Kedah,0,0,0,Guinea
3955,3/1/2020,GIN,Kelantan,1,1,0,Guinea
3956,3/1/2020,GIN,Perlis,0,0,0,Guinea
3957,3/1/2020,GIN,Pulau Pinang,0,0,0,Guinea
3958,3/1/2020,GIN,Sabah,0,0,0,Guinea
3959,3/1/2020,GIN,Sarawak,0,0,0,Guinea
3960,3/1/2020,GIN,Selangor,25,18,7,Guinea
3961,3/1/2020,GLP,Selangor,1,1,0,Guadeloupe
3962,3/1/2020,GMB,Johor,0,0,0,Gambia
3963,3/1/2020,GMB,Kedah,0,0,0,Gambia
3964,3/1/2020,GMB,Kelantan,0,0,0,Gambia
3965,3/1/2020,GMB,Pulau Pinang,0,0,0,Gambia
3966,3/1/2020,GMB,Sabah,0,0,0,Gambia
3967,3/1/2020,GMB,Sarawak,0,0,0,Gambia
3968,3/1/2020,GMB,Selangor,33,26,7,Gambia
3969,3/1/2020,GNB,Johor,1,1,0,Guinea-Bissau
3970,3/1/2020,GNB,Selangor,0,0,0,Guinea-Bissau
3971,3/1/2020,GNQ,Johor,0,0,0,Equatorial Guinea
3972,3/1/2020,GNQ,Selangor,0,0,0,Equatorial Guinea
3973,3/1/2020,GRC,Johor,18,15,3,Greece
3974,3/1/2020,GRC,Kedah,6,4,2,Greece
3975,3/1/2020,GRC,Kelantan,1,1,0,Greece
3976,3/1/2020,GRC,Melaka,0,0,0,Greece
3977,3/1/2020,GRC,Negeri Sembilan,0,0,0,Greece
3978,3/1/2020,GRC,Pahang,0,0,0,Greece
3979,3/1/2020,GRC,Perak,0,0,0,Greece
3980,3/1/2020,GRC,Perlis,0,0,0,Greece
3981,3/1/2020,GRC,Pulau Pinang,4,3,1,Greece
3982,3/1/2020,GRC,Sabah,2,2,0,Greece
3983,3/1/2020,GRC,Sarawak,0,0,0,Greece
3984,3/1/2020,GRC,Selangor,104,72,32,Greece
3985,3/1/2020,GRD,Johor,6,6,0,Grenada
3986,3/1/2020,GRD,Kedah,0,0,0,Grenada
3987,3/1/2020,GRD,Pulau Pinang,0,0,0,Grenada
3988,3/1/2020,GRD,Sabah,0,0,0,Grenada
3989,3/1/2020,GRD,Sarawak,0,0,0,Grenada
3990,3/1/2020,GRD,Selangor,1,1,0,Grenada
3991,3/1/2020,GRL,Johor,0,0,0,Greenland
3992,3/1/2020,GRL,Selangor,0,0,0,Greenland
3993,3/1/2020,GTM,Johor,0,0,0,Guatemala
3994,3/1/2020,GTM,Kedah,0,0,0,Guatemala
3995,3/1/2020,GTM,Pahang,0,0,0,Guatemala
3996,3/1/2020,GTM,Perak,0,0,0,Guatemala
3997,3/1/2020,GTM,Pulau Pinang,0,0,0,Guatemala
3998,3/1/2020,GTM,Sabah,0,0,0,Guatemala
3999,3/1/2020,GTM,Sarawak,0,0,0,Guatemala
4000,3/1/2020,GTM,Selangor,2,2,0,Guatemala
4001,3/1/2020,GTM,W.P. Labuan,0,0,0,Guatemala
4002,3/1/2020,GUY,Johor,0,0,0,Guyana
4003,3/1/2020,GUY,Kedah,0,0,0,Guyana
4004,3/1/2020,GUY,Pulau Pinang,0,0,0,Guyana
4005,3/1/2020,GUY,Sarawak,0,0,0,Guyana
4006,3/1/2020,GUY,Selangor,3,3,0,Guyana
4007,3/1/2020,HKG,Johor,0,0,0,Hong Kong
4008,3/1/2020,HKG,Kedah,0,0,0,Hong Kong
4009,3/1/2020,HKG,Kelantan,0,0,0,Hong Kong
4010,3/1/2020,HKG,Pahang,0,0,0,Hong Kong
4011,3/1/2020,HKG,Perak,7,4,3,Hong Kong
4012,3/1/2020,HKG,Perlis,1,1,0,Hong Kong
4013,3/1/2020,HKG,Pulau Pinang,0,0,0,Hong Kong
4014,3/1/2020,HKG,Sabah,0,0,0,Hong Kong
4015,3/1/2020,HKG,Sarawak,1,0,1,Hong Kong
4016,3/1/2020,HKG,Selangor,0,0,0,Hong Kong
4017,3/1/2020,HKG,Terengganu,0,0,0,Hong Kong
4018,3/1/2020,HMD,Johor,0,0,0,Heard Island and McDonald Islands
4019,3/1/2020,HND,Johor,2,2,0,Honduras
4020,3/1/2020,HND,Kedah,2,0,2,Honduras
4021,3/1/2020,HND,Perak,0,0,0,Honduras
4022,3/1/2020,HND,Pulau Pinang,0,0,0,Honduras
4023,3/1/2020,HND,Sabah,0,0,0,Honduras
4024,3/1/2020,HND,Sarawak,0,0,0,Honduras
4025,3/1/2020,HND,Selangor,6,3,3,Honduras
4026,3/1/2020,HRV,Johor,20,17,3,Croatia
4027,3/1/2020,HRV,Kedah,6,4,2,Croatia
4028,3/1/2020,HRV,Kelantan,0,0,0,Croatia
4029,3/1/2020,HRV,Melaka,0,0,0,Croatia
4030,3/1/2020,HRV,Pahang,0,0,0,Croatia
4031,3/1/2020,HRV,Perak,0,0,0,Croatia
4032,3/1/2020,HRV,Perlis,0,0,0,Croatia
4033,3/1/2020,HRV,Pulau Pinang,4,2,2,Croatia
4034,3/1/2020,HRV,Sabah,1,1,0,Croatia
4035,3/1/2020,HRV,Sarawak,2,2,0,Croatia
4036,3/1/2020,HRV,Selangor,56,43,13,Croatia
4037,3/1/2020,HTI,Johor,0,0,0,Haiti
4038,3/1/2020,HTI,Kedah,0,0,0,Haiti
4039,3/1/2020,HTI,Kelantan,0,0,0,Haiti
4040,3/1/2020,HTI,Perak,0,0,0,Haiti
4041,3/1/2020,HTI,Pulau Pinang,0,0,0,Haiti
4042,3/1/2020,HTI,Sabah,0,0,0,Haiti
4043,3/1/2020,HTI,Selangor,0,0,0,Haiti
4044,3/1/2020,HUN,Johor,30,20,10,Hungary
4045,3/1/2020,HUN,Kedah,70,37,33,Hungary
4046,3/1/2020,HUN,Kelantan,1,1,0,Hungary
4047,3/1/2020,HUN,Pahang,0,0,0,Hungary
4048,3/1/2020,HUN,Perak,2,1,1,Hungary
4049,3/1/2020,HUN,Perlis,1,1,0,Hungary
4050,3/1/2020,HUN,Pulau Pinang,17,10,7,Hungary
4051,3/1/2020,HUN,Sabah,7,4,3,Hungary
4052,3/1/2020,HUN,Sarawak,3,2,1,Hungary
4053,3/1/2020,HUN,Selangor,396,204,192,Hungary
4054,3/1/2020,HUN,W.P. Labuan,0,0,0,Hungary
4055,3/1/2020,IDN,Johor,59621,34831,24790,Indonesia
4056,3/1/2020,IDN,Kedah,813,312,501,Indonesia
4057,3/1/2020,IDN,Kelantan,103,77,26,Indonesia
4058,3/1/2020,IDN,Melaka,1014,482,532,Indonesia
4059,3/1/2020,IDN,Negeri Sembilan,1686,1134,552,Indonesia
4060,3/1/2020,IDN,Pahang,2,2,0,Indonesia
4061,3/1/2020,IDN,Perak,93,35,58,Indonesia
4062,3/1/2020,IDN,Perlis,203,109,94,Indonesia
4063,3/1/2020,IDN,Pulau Pinang,11656,4678,6978,Indonesia
4064,3/1/2020,IDN,Sabah,2945,1545,1400,Indonesia
4065,3/1/2020,IDN,Sarawak,14387,8918,5469,Indonesia
4066,3/1/2020,IDN,Selangor,39093,19629,19464,Indonesia
4067,3/1/2020,IDN,Terengganu,7,7,0,Indonesia
4068,3/1/2020,IDN,W.P. Labuan,60,40,20,Indonesia
4069,3/1/2020,IND,Johor,6925,5476,1449,India
4070,3/1/2020,IND,Kedah,130,87,43,India
4071,3/1/2020,IND,Kelantan,4,4,0,India
4072,3/1/2020,IND,Melaka,1,1,0,India
4073,3/1/2020,IND,Negeri Sembilan,1,1,0,India
4074,3/1/2020,IND,Pahang,3,2,1,India
4075,3/1/2020,IND,Perak,104,72,32,India
4076,3/1/2020,IND,Perlis,15,11,4,India
4077,3/1/2020,IND,Pulau Pinang,172,127,45,India
4078,3/1/2020,IND,Sabah,39,28,11,India
4079,3/1/2020,IND,Sarawak,544,485,59,India
4080,3/1/2020,IND,Selangor,19251,15243,4008,India
4081,3/1/2020,IND,Terengganu,3,3,0,India
4082,3/1/2020,IND,W.P. Labuan,18,16,2,India
4083,3/1/2020,IOT,Pulau Pinang,0,0,0,British Indian Ocean Territory
4084,3/1/2020,IOT,Selangor,0,0,0,British Indian Ocean Territory
4085,3/1/2020,IRL,Johor,121,86,35,Ireland
4086,3/1/2020,IRL,Kedah,56,25,31,Ireland
4087,3/1/2020,IRL,Kelantan,2,1,1,Ireland
4088,3/1/2020,IRL,Negeri Sembilan,0,0,0,Ireland
4089,3/1/2020,IRL,Pahang,0,0,0,Ireland
4090,3/1/2020,IRL,Perak,5,2,3,Ireland
4091,3/1/2020,IRL,Perlis,9,5,4,Ireland
4092,3/1/2020,IRL,Pulau Pinang,36,24,12,Ireland
4093,3/1/2020,IRL,Sabah,2,1,1,Ireland
4094,3/1/2020,IRL,Sarawak,9,7,2,Ireland
4095,3/1/2020,IRL,Selangor,514,318,196,Ireland
4096,3/1/2020,IRL,Terengganu,0,0,0,Ireland
4097,3/1/2020,IRL,W.P. Labuan,1,0,1,Ireland
4098,3/1/2020,IRN,Johor,52,32,20,Iran
4099,3/1/2020,IRN,Kedah,0,0,0,Iran
4100,3/1/2020,IRN,Kelantan,0,0,0,Iran
4101,3/1/2020,IRN,Perak,0,0,0,Iran
4102,3/1/2020,IRN,Perlis,0,0,0,Iran
4103,3/1/2020,IRN,Pulau Pinang,2,2,0,Iran
4104,3/1/2020,IRN,Sabah,1,1,0,Iran
4105,3/1/2020,IRN,Sarawak,0,0,0,Iran
4106,3/1/2020,IRN,Selangor,651,381,270,Iran
4107,3/1/2020,IRN,W.P. Labuan,0,0,0,Iran
4108,3/1/2020,IRQ,Johor,9,7,2,Iraq
4109,3/1/2020,IRQ,Kedah,0,0,0,Iraq
4110,3/1/2020,IRQ,Kelantan,0,0,0,Iraq
4111,3/1/2020,IRQ,Melaka,0,0,0,Iraq
4112,3/1/2020,IRQ,Pahang,0,0,0,Iraq
4113,3/1/2020,IRQ,Perak,0,0,0,Iraq
4114,3/1/2020,IRQ,Perlis,0,0,0,Iraq
4115,3/1/2020,IRQ,Pulau Pinang,5,4,1,Iraq
4116,3/1/2020,IRQ,Sabah,0,0,0,Iraq
4117,3/1/2020,IRQ,Sarawak,0,0,0,Iraq
4118,3/1/2020,IRQ,Selangor,597,405,192,Iraq
4119,3/1/2020,ISL,Johor,4,4,0,Iceland
4120,3/1/2020,ISL,Kedah,4,2,2,Iceland
4121,3/1/2020,ISL,Kelantan,0,0,0,Iceland
4122,3/1/2020,ISL,Perak,0,0,0,Iceland
4123,3/1/2020,ISL,Perlis,1,1,0,Iceland
4124,3/1/2020,ISL,Pulau Pinang,0,0,0,Iceland
4125,3/1/2020,ISL,Sabah,0,0,0,Iceland
4126,3/1/2020,ISL,Sarawak,0,0,0,Iceland
4127,3/1/2020,ISL,Selangor,33,18,15,Iceland
4128,3/1/2020,ISL,W.P. Labuan,0,0,0,Iceland
4129,3/1/2020,ISR,Pulau Pinang,0,0,0,Israel
4130,3/1/2020,ITA,Johor,196,157,39,Italy
4131,3/1/2020,ITA,Kedah,165,91,74,Italy
4132,3/1/2020,ITA,Kelantan,16,12,4,Italy
4133,3/1/2020,ITA,Melaka,0,0,0,Italy
4134,3/1/2020,ITA,Negeri Sembilan,0,0,0,Italy
4135,3/1/2020,ITA,Pahang,0,0,0,Italy
4136,3/1/2020,ITA,Perak,7,4,3,Italy
4137,3/1/2020,ITA,Perlis,19,15,4,Italy
4138,3/1/2020,ITA,Pulau Pinang,32,23,9,Italy
4139,3/1/2020,ITA,Sabah,8,5,3,Italy
4140,3/1/2020,ITA,Sarawak,29,14,15,Italy
4141,3/1/2020,ITA,Selangor,685,485,200,Italy
4142,3/1/2020,ITA,W.P. Labuan,4,4,0,Italy
4143,3/1/2020,JAM,Johor,0,0,0,Jamaica
4144,3/1/2020,JAM,Kedah,0,0,0,Jamaica
4145,3/1/2020,JAM,Perak,0,0,0,Jamaica
4146,3/1/2020,JAM,Pulau Pinang,2,1,1,Jamaica
4147,3/1/2020,JAM,Sabah,0,0,0,Jamaica
4148,3/1/2020,JAM,Sarawak,1,1,0,Jamaica
4149,3/1/2020,JAM,Selangor,4,2,2,Jamaica
4150,3/1/2020,JAM,W.P. Labuan,0,0,0,Jamaica
4151,3/1/2020,JOR,Johor,8,4,4,Jordan
4152,3/1/2020,JOR,Kedah,11,7,4,Jordan
4153,3/1/2020,JOR,Kelantan,0,0,0,Jordan
4154,3/1/2020,JOR,Melaka,0,0,0,Jordan
4155,3/1/2020,JOR,Perlis,0,0,0,Jordan
4156,3/1/2020,JOR,Pulau Pinang,13,11,2,Jordan
4157,3/1/2020,JOR,Sabah,0,0,0,Jordan
4158,3/1/2020,JOR,Sarawak,1,1,0,Jordan
4159,3/1/2020,JOR,Selangor,263,196,67,Jordan
4160,3/1/2020,JOR,W.P. Labuan,0,0,0,Jordan
4161,3/1/2020,JPN,Johor,2284,1682,602,Japan
4162,3/1/2020,JPN,Kedah,127,64,63,Japan
4163,3/1/2020,JPN,Kelantan,8,8,0,Japan
4164,3/1/2020,JPN,Melaka,1,1,0,Japan
4165,3/1/2020,JPN,Negeri Sembilan,0,0,0,Japan
4166,3/1/2020,JPN,Pahang,0,0,0,Japan
4167,3/1/2020,JPN,Perak,11,6,5,Japan
4168,3/1/2020,JPN,Perlis,45,38,7,Japan
4169,3/1/2020,JPN,Pulau Pinang,306,211,95,Japan
4170,3/1/2020,JPN,Sabah,303,149,154,Japan
4171,3/1/2020,JPN,Sarawak,97,74,23,Japan
4172,3/1/2020,JPN,Selangor,7593,4799,2794,Japan
4173,3/1/2020,JPN,W.P. Labuan,27,15,12,Japan
4174,3/1/2020,KAZ,Johor,10,2,8,Kazakhstan
4175,3/1/2020,KAZ,Kedah,25,13,12,Kazakhstan
4176,3/1/2020,KAZ,Kelantan,0,0,0,Kazakhstan
4177,3/1/2020,KAZ,Melaka,0,0,0,Kazakhstan
4178,3/1/2020,KAZ,Perak,0,0,0,Kazakhstan
4179,3/1/2020,KAZ,Perlis,4,2,2,Kazakhstan
4180,3/1/2020,KAZ,Pulau Pinang,3,2,1,Kazakhstan
4181,3/1/2020,KAZ,Sabah,0,0,0,Kazakhstan
4182,3/1/2020,KAZ,Sarawak,4,1,3,Kazakhstan
4183,3/1/2020,KAZ,Selangor,1163,452,711,Kazakhstan
4184,3/1/2020,KAZ,W.P. Labuan,0,0,0,Kazakhstan
4185,3/1/2020,KEN,Johor,6,1,5,Kenya
4186,3/1/2020,KEN,Kedah,1,1,0,Kenya
4187,3/1/2020,KEN,Kelantan,1,0,1,Kenya
4188,3/1/2020,KEN,Perak,0,0,0,Kenya
4189,3/1/2020,KEN,Perlis,0,0,0,Kenya
4190,3/1/2020,KEN,Pulau Pinang,1,1,0,Kenya
4191,3/1/2020,KEN,Sabah,0,0,0,Kenya
4192,3/1/2020,KEN,Sarawak,0,0,0,Kenya
4193,3/1/2020,KEN,Selangor,103,65,38,Kenya
4194,3/1/2020,KGZ,Johor,8,7,1,Kyrgyzstan
4195,3/1/2020,KGZ,Kedah,9,7,2,Kyrgyzstan
4196,3/1/2020,KGZ,Kelantan,0,0,0,Kyrgyzstan
4197,3/1/2020,KGZ,Perak,0,0,0,Kyrgyzstan
4198,3/1/2020,KGZ,Perlis,1,0,1,Kyrgyzstan
4199,3/1/2020,KGZ,Pulau Pinang,1,0,1,Kyrgyzstan
4200,3/1/2020,KGZ,Sabah,0,0,0,Kyrgyzstan
4201,3/1/2020,KGZ,Sarawak,0,0,0,Kyrgyzstan
4202,3/1/2020,KGZ,Selangor,130,58,72,Kyrgyzstan
4203,3/1/2020,KHM,Johor,370,133,237,Cambodia
4204,3/1/2020,KHM,Kedah,149,95,54,Cambodia
4205,3/1/2020,KHM,Kelantan,337,211,126,Cambodia
4206,3/1/2020,KHM,Melaka,0,0,0,Cambodia
4207,3/1/2020,KHM,Negeri Sembilan,0,0,0,Cambodia
4208,3/1/2020,KHM,Pahang,0,0,0,Cambodia
4209,3/1/2020,KHM,Perak,20,17,3,Cambodia
4210,3/1/2020,KHM,Perlis,481,365,116,Cambodia
4211,3/1/2020,KHM,Pulau Pinang,6,1,5,Cambodia
4212,3/1/2020,KHM,Sabah,5,4,1,Cambodia
4213,3/1/2020,KHM,Sarawak,5,0,5,Cambodia
4214,3/1/2020,KHM,Selangor,1386,600,786,Cambodia
4215,3/1/2020,KHM,W.P. Labuan,0,0,0,Cambodia
4216,3/1/2020,KIR,Johor,2,2,0,Kiribati
4217,3/1/2020,KIR,Sabah,0,0,0,Kiribati
4218,3/1/2020,KIR,Selangor,0,0,0,Kiribati
4219,3/1/2020,KNA,Johor,3,3,0,Saint Kitts and Nevis
4220,3/1/2020,KNA,Kedah,0,0,0,Saint Kitts and Nevis
4221,3/1/2020,KNA,Perlis,0,0,0,Saint Kitts and Nevis
4222,3/1/2020,KNA,Pulau Pinang,2,1,1,Saint Kitts and Nevis
4223,3/1/2020,KNA,Sabah,0,0,0,Saint Kitts and Nevis
4224,3/1/2020,KNA,Selangor,18,14,4,Saint Kitts and Nevis
4225,3/1/2020,KNA,W.P. Labuan,0,0,0,Saint Kitts and Nevis
4226,3/1/2020,KOR,Johor,1761,1062,699,"Korea, Republic of (South Korea)"
4227,3/1/2020,KOR,Kedah,54,30,24,"Korea, Republic of (South Korea)"
4228,3/1/2020,KOR,Kelantan,3,1,2,"Korea, Republic of (South Korea)"
4229,3/1/2020,KOR,Melaka,0,0,0,"Korea, Republic of (South Korea)"
4230,3/1/2020,KOR,Negeri Sembilan,0,0,0,"Korea, Republic of (South Korea)"
4231,3/1/2020,KOR,Pahang,5,4,1,"Korea, Republic of (South Korea)"
4232,3/1/2020,KOR,Perak,11,8,3,"Korea, Republic of (South Korea)"
4233,3/1/2020,KOR,Perlis,160,93,67,"Korea, Republic of (South Korea)"
4234,3/1/2020,KOR,Pulau Pinang,92,51,41,"Korea, Republic of (South Korea)"
4235,3/1/2020,KOR,Sabah,24,19,5,"Korea, Republic of (South Korea)"
4236,3/1/2020,KOR,Sarawak,70,36,34,"Korea, Republic of (South Korea)"
4237,3/1/2020,KOR,Selangor,2376,1423,953,"Korea, Republic of (South Korea)"
4238,3/1/2020,KOR,Terengganu,0,0,0,"Korea, Republic of (South Korea)"
4239,3/1/2020,KOR,W.P. Labuan,3,3,0,"Korea, Republic of (South Korea)"
4240,3/1/2020,KWT,Johor,1,0,1,Kuwait
4241,3/1/2020,KWT,Kedah,5,2,3,Kuwait
4242,3/1/2020,KWT,Kelantan,1,0,1,Kuwait
4243,3/1/2020,KWT,Perak,0,0,0,Kuwait
4244,3/1/2020,KWT,Perlis,0,0,0,Kuwait
4245,3/1/2020,KWT,Pulau Pinang,1,1,0,Kuwait
4246,3/1/2020,KWT,Sabah,0,0,0,Kuwait
4247,3/1/2020,KWT,Sarawak,0,0,0,Kuwait
4248,3/1/2020,KWT,Selangor,48,39,9,Kuwait
4249,3/1/2020,KWT,W.P. Labuan,0,0,0,Kuwait
4250,3/1/2020,LAO,Johor,29,5,24,Lao People's Democratic Republic
4251,3/1/2020,LAO,Kedah,670,54,616,Lao People's Democratic Republic
4252,3/1/2020,LAO,Kelantan,102,20,82,Lao People's Democratic Republic
4253,3/1/2020,LAO,Melaka,0,0,0,Lao People's Democratic Republic
4254,3/1/2020,LAO,Perak,7,2,5,Lao People's Democratic Republic
4255,3/1/2020,LAO,Perlis,223,66,157,Lao People's Democratic Republic
4256,3/1/2020,LAO,Pulau Pinang,0,0,0,Lao People's Democratic Republic
4257,3/1/2020,LAO,Sabah,0,0,0,Lao People's Democratic Republic
4258,3/1/2020,LAO,Sarawak,3,2,1,Lao People's Democratic Republic
4259,3/1/2020,LAO,Selangor,99,31,68,Lao People's Democratic Republic
4260,3/1/2020,LAO,W.P. Labuan,0,0,0,Lao People's Democratic Republic
4261,3/1/2020,LBN,Johor,6,4,2,Lebanon
4262,3/1/2020,LBN,Kedah,0,0,0,Lebanon
4263,3/1/2020,LBN,Kelantan,0,0,0,Lebanon
4264,3/1/2020,LBN,Pahang,0,0,0,Lebanon
4265,3/1/2020,LBN,Perak,0,0,0,Lebanon
4266,3/1/2020,LBN,Perlis,0,0,0,Lebanon
4267,3/1/2020,LBN,Pulau Pinang,0,0,0,Lebanon
4268,3/1/2020,LBN,Sabah,0,0,0,Lebanon
4269,3/1/2020,LBN,Sarawak,0,0,0,Lebanon
4270,3/1/2020,LBN,Selangor,82,66,16,Lebanon
4271,3/1/2020,LBN,W.P. Labuan,0,0,0,Lebanon
4272,3/1/2020,LBR,Johor,0,0,0,Liberia
4273,3/1/2020,LBR,Kedah,0,0,0,Liberia
4274,3/1/2020,LBR,Sabah,0,0,0,Liberia
4275,3/1/2020,LBR,Sarawak,0,0,0,Liberia
4276,3/1/2020,LBR,Selangor,3,3,0,Liberia
4277,3/1/2020,LBY,Johor,1,1,0,Libyan Arab Jamahiriya
4278,3/1/2020,LBY,Kedah,1,1,0,Libyan Arab Jamahiriya
4279,3/1/2020,LBY,Perlis,0,0,0,Libyan Arab Jamahiriya
4280,3/1/2020,LBY,Pulau Pinang,0,0,0,Libyan Arab Jamahiriya
4281,3/1/2020,LBY,Sabah,0,0,0,Libyan Arab Jamahiriya
4282,3/1/2020,LBY,Sarawak,2,0,2,Libyan Arab Jamahiriya
4283,3/1/2020,LBY,Selangor,256,184,72,Libyan Arab Jamahiriya
4284,3/1/2020,LCA,Johor,2,2,0,Saint Lucia
4285,3/1/2020,LCA,Kedah,0,0,0,Saint Lucia
4286,3/1/2020,LCA,Pulau Pinang,0,0,0,Saint Lucia
4287,3/1/2020,LCA,Sarawak,0,0,0,Saint Lucia
4288,3/1/2020,LCA,Selangor,3,3,0,Saint Lucia
4289,3/1/2020,LIE,Johor,0,0,0,Liechtenstein
4290,3/1/2020,LIE,Kedah,0,0,0,Liechtenstein
4291,3/1/2020,LIE,Perlis,0,0,0,Liechtenstein
4292,3/1/2020,LIE,Pulau Pinang,0,0,0,Liechtenstein
4293,3/1/2020,LIE,Sabah,0,0,0,Liechtenstein
4294,3/1/2020,LIE,Sarawak,0,0,0,Liechtenstein
4295,3/1/2020,LIE,Selangor,4,1,3,Liechtenstein
4296,3/1/2020,LKA,Johor,340,265,75,Sri Lanka
4297,3/1/2020,LKA,Kedah,4,3,1,Sri Lanka
4298,3/1/2020,LKA,Kelantan,2,1,1,Sri Lanka
4299,3/1/2020,LKA,Melaka,0,0,0,Sri Lanka
4300,3/1/2020,LKA,Pahang,0,0,0,Sri Lanka
4301,3/1/2020,LKA,Perak,1,1,0,Sri Lanka
4302,3/1/2020,LKA,Perlis,0,0,0,Sri Lanka
4303,3/1/2020,LKA,Pulau Pinang,7,7,0,Sri Lanka
4304,3/1/2020,LKA,Sabah,1,1,0,Sri Lanka
4305,3/1/2020,LKA,Sarawak,6,5,1,Sri Lanka
4306,3/1/2020,LKA,Selangor,1437,907,530,Sri Lanka
4307,3/1/2020,LKA,W.P. Labuan,0,0,0,Sri Lanka
4308,3/1/2020,LSO,Johor,0,0,0,Lesotho
4309,3/1/2020,LSO,Kedah,0,0,0,Lesotho
4310,3/1/2020,LSO,Pulau Pinang,0,0,0,Lesotho
4311,3/1/2020,LSO,Sarawak,0,0,0,Lesotho
4312,3/1/2020,LSO,Selangor,2,2,0,Lesotho
4313,3/1/2020,LTU,Johor,20,10,10,Lithuania
4314,3/1/2020,LTU,Kedah,23,13,10,Lithuania
4315,3/1/2020,LTU,Kelantan,1,1,0,Lithuania
4316,3/1/2020,LTU,Pahang,0,0,0,Lithuania
4317,3/1/2020,LTU,Perak,0,0,0,Lithuania
4318,3/1/2020,LTU,Perlis,4,2,2,Lithuania
4319,3/1/2020,LTU,Pulau Pinang,6,4,2,Lithuania
4320,3/1/2020,LTU,Sabah,1,1,0,Lithuania
4321,3/1/2020,LTU,Sarawak,2,1,1,Lithuania
4322,3/1/2020,LTU,Selangor,131,71,60,Lithuania
4323,3/1/2020,LTU,W.P. Labuan,3,2,1,Lithuania
4324,3/1/2020,LUX,Johor,1,0,1,Luxembourg
4325,3/1/2020,LUX,Kedah,2,2,0,Luxembourg
4326,3/1/2020,LUX,Kelantan,2,0,2,Luxembourg
4327,3/1/2020,LUX,Perak,0,0,0,Luxembourg
4328,3/1/2020,LUX,Perlis,0,0,0,Luxembourg
4329,3/1/2020,LUX,Pulau Pinang,3,1,2,Luxembourg
4330,3/1/2020,LUX,Sabah,2,1,1,Luxembourg
4331,3/1/2020,LUX,Sarawak,0,0,0,Luxembourg
4332,3/1/2020,LUX,Selangor,23,13,10,Luxembourg
4333,3/1/2020,LVA,Johor,26,19,7,Latvia
4334,3/1/2020,LVA,Kedah,8,4,4,Latvia
4335,3/1/2020,LVA,Kelantan,0,0,0,Latvia
4336,3/1/2020,LVA,Pahang,0,0,0,Latvia
4337,3/1/2020,LVA,Perak,0,0,0,Latvia
4338,3/1/2020,LVA,Perlis,1,0,1,Latvia
4339,3/1/2020,LVA,Pulau Pinang,3,2,1,Latvia
4340,3/1/2020,LVA,Sabah,3,1,2,Latvia
4341,3/1/2020,LVA,Sarawak,0,0,0,Latvia
4342,3/1/2020,LVA,Selangor,97,43,54,Latvia
4343,3/1/2020,LVA,W.P. Labuan,0,0,0,Latvia
4344,3/1/2020,MAC,Johor,0,0,0,Macao
4345,3/1/2020,MAC,Pahang,0,0,0,Macao
4346,3/1/2020,MAC,Perak,0,0,0,Macao
4347,3/1/2020,MAC,Selangor,0,0,0,Macao
4348,3/1/2020,MAC,W.P. Labuan,0,0,0,Macao
4349,3/1/2020,MAR,Johor,44,33,11,Morocco
4350,3/1/2020,MAR,Kedah,2,1,1,Morocco
4351,3/1/2020,MAR,Kelantan,0,0,0,Morocco
4352,3/1/2020,MAR,Melaka,0,0,0,Morocco
4353,3/1/2020,MAR,Pahang,0,0,0,Morocco
4354,3/1/2020,MAR,Perak,0,0,0,Morocco
4355,3/1/2020,MAR,Perlis,0,0,0,Morocco
4356,3/1/2020,MAR,Pulau Pinang,2,2,0,Morocco
4357,3/1/2020,MAR,Sabah,2,1,1,Morocco
4358,3/1/2020,MAR,Sarawak,1,1,0,Morocco
4359,3/1/2020,MAR,Selangor,324,176,148,Morocco
4360,3/1/2020,MAR,W.P. Labuan,1,1,0,Morocco
4361,3/1/2020,MCO,Johor,0,0,0,Monaco
4362,3/1/2020,MCO,Kedah,0,0,0,Monaco
4363,3/1/2020,MCO,Sabah,0,0,0,Monaco
4364,3/1/2020,MCO,Selangor,2,1,1,Monaco
4365,3/1/2020,MDA,Johor,5,2,3,"Moldova, Republic of"
4366,3/1/2020,MDA,Kedah,3,1,2,"Moldova, Republic of"
4367,3/1/2020,MDA,Kelantan,0,0,0,"Moldova, Republic of"
4368,3/1/2020,MDA,Negeri Sembilan,0,0,0,"Moldova, Republic of"
4369,3/1/2020,MDA,Perlis,0,0,0,"Moldova, Republic of"
4370,3/1/2020,MDA,Pulau Pinang,2,1,1,"Moldova, Republic of"
4371,3/1/2020,MDA,Sabah,0,0,0,"Moldova, Republic of"
4372,3/1/2020,MDA,Sarawak,0,0,0,"Moldova, Republic of"
4373,3/1/2020,MDA,Selangor,21,10,11,"Moldova, Republic of"
4374,3/1/2020,MDG,Johor,2,2,0,Madagascar
4375,3/1/2020,MDG,Kedah,1,0,1,Madagascar
4376,3/1/2020,MDG,Perak,0,0,0,Madagascar
4377,3/1/2020,MDG,Perlis,0,0,0,Madagascar
4378,3/1/2020,MDG,Pulau Pinang,0,0,0,Madagascar
4379,3/1/2020,MDG,Sabah,0,0,0,Madagascar
4380,3/1/2020,MDG,Sarawak,0,0,0,Madagascar
4381,3/1/2020,MDG,Selangor,25,12,13,Madagascar
4382,3/1/2020,MDV,Johor,23,15,8,Maldives
4383,3/1/2020,MDV,Kedah,0,0,0,Maldives
4384,3/1/2020,MDV,Kelantan,0,0,0,Maldives
4385,3/1/2020,MDV,Perak,0,0,0,Maldives
4386,3/1/2020,MDV,Perlis,1,1,0,Maldives
4387,3/1/2020,MDV,Pulau Pinang,3,2,1,Maldives
4388,3/1/2020,MDV,Sabah,2,2,0,Maldives
4389,3/1/2020,MDV,Sarawak,0,0,0,Maldives
4390,3/1/2020,MDV,Selangor,951,546,405,Maldives
4391,3/1/2020,MEX,Johor,50,29,21,Mexico
4392,3/1/2020,MEX,Kedah,5,3,2,Mexico
4393,3/1/2020,MEX,Kelantan,1,1,0,Mexico
4394,3/1/2020,MEX,Pahang,0,0,0,Mexico
4395,3/1/2020,MEX,Perak,0,0,0,Mexico
4396,3/1/2020,MEX,Perlis,2,2,0,Mexico
4397,3/1/2020,MEX,Pulau Pinang,8,4,4,Mexico
4398,3/1/2020,MEX,Sabah,1,1,0,Mexico
4399,3/1/2020,MEX,Sarawak,5,3,2,Mexico
4400,3/1/2020,MEX,Selangor,201,101,100,Mexico
4401,3/1/2020,MEX,W.P. Labuan,0,0,0,Mexico
4402,3/1/2020,MHL,Johor,2,1,1,Marshall Islands
4403,3/1/2020,MHL,Kedah,0,0,0,Marshall Islands
4404,3/1/2020,MHL,Perak,0,0,0,Marshall Islands
4405,3/1/2020,MHL,Pulau Pinang,0,0,0,Marshall Islands
4406,3/1/2020,MHL,Sabah,0,0,0,Marshall Islands
4407,3/1/2020,MHL,Selangor,3,2,1,Marshall Islands
4408,3/1/2020,MKD,Johor,1,0,1,"Macedonia, the former Yugoslav Republic of"
4409,3/1/2020,MKD,Kedah,1,0,1,"Macedonia, the former Yugoslav Republic of"
4410,3/1/2020,MKD,Perak,0,0,0,"Macedonia, the former Yugoslav Republic of"
4411,3/1/2020,MKD,Pulau Pinang,0,0,0,"Macedonia, the former Yugoslav Republic of"
4412,3/1/2020,MKD,Sabah,0,0,0,"Macedonia, the former Yugoslav Republic of"
4413,3/1/2020,MKD,Sarawak,3,3,0,"Macedonia, the former Yugoslav Republic of"
4414,3/1/2020,MKD,Selangor,12,8,4,"Macedonia, the former Yugoslav Republic of"
4415,3/1/2020,MLI,Johor,3,3,0,Mali
4416,3/1/2020,MLI,Sabah,0,0,0,Mali
4417,3/1/2020,MLI,Selangor,9,7,2,Mali
4418,3/1/2020,MLT,Johor,4,3,1,Malta
4419,3/1/2020,MLT,Kedah,0,0,0,Malta
4420,3/1/2020,MLT,Kelantan,0,0,0,Malta
4421,3/1/2020,MLT,Perak,0,0,0,Malta
4422,3/1/2020,MLT,Perlis,0,0,0,Malta
4423,3/1/2020,MLT,Pulau Pinang,1,1,0,Malta
4424,3/1/2020,MLT,Sabah,0,0,0,Malta
4425,3/1/2020,MLT,Sarawak,0,0,0,Malta
4426,3/1/2020,MLT,Selangor,8,7,1,Malta
4427,3/1/2020,MLT,W.P. Labuan,0,0,0,Malta
4428,3/1/2020,MMR,Johor,1309,453,856,Myanmar
4429,3/1/2020,MMR,Kedah,8,2,6,Myanmar
4430,3/1/2020,MMR,Kelantan,4,1,3,Myanmar
4431,3/1/2020,MMR,Negeri Sembilan,0,0,0,Myanmar
4432,3/1/2020,MMR,Pahang,6,6,0,Myanmar
4433,3/1/2020,MMR,Perak,6,1,5,Myanmar
4434,3/1/2020,MMR,Perlis,1,1,0,Myanmar
4435,3/1/2020,MMR,Pulau Pinang,163,115,48,Myanmar
4436,3/1/2020,MMR,Sabah,5,2,3,Myanmar
4437,3/1/2020,MMR,Sarawak,13,10,3,Myanmar
4438,3/1/2020,MMR,Selangor,4948,3764,1184,Myanmar
4439,3/1/2020,MMR,Terengganu,0,0,0,Myanmar
4440,3/1/2020,MMR,W.P. Labuan,0,0,0,Myanmar
4441,3/1/2020,MNE,Johor,0,0,0,Montenegro
4442,3/1/2020,MNE,Kedah,0,0,0,Montenegro
4443,3/1/2020,MNE,Pulau Pinang,0,0,0,Montenegro
4444,3/1/2020,MNE,Sabah,0,0,0,Montenegro
4445,3/1/2020,MNE,Sarawak,0,0,0,Montenegro
4446,3/1/2020,MNE,Selangor,7,5,2,Montenegro
4447,3/1/2020,MNG,Johor,34,17,17,Mongolia
4448,3/1/2020,MNG,Kedah,18,3,15,Mongolia
4449,3/1/2020,MNG,Kelantan,0,0,0,Mongolia
4450,3/1/2020,MNG,Perak,0,0,0,Mongolia
4451,3/1/2020,MNG,Perlis,1,1,0,Mongolia
4452,3/1/2020,MNG,Pulau Pinang,5,2,3,Mongolia
4453,3/1/2020,MNG,Sabah,0,0,0,Mongolia
4454,3/1/2020,MNG,Sarawak,0,0,0,Mongolia
4455,3/1/2020,MNG,Selangor,93,37,56,Mongolia
4456,3/1/2020,MNP,Selangor,0,0,0,Northern Mariana Islands
4457,3/1/2020,MOZ,Johor,0,0,0,Mozambique
4458,3/1/2020,MOZ,Kedah,0,0,0,Mozambique
4459,3/1/2020,MOZ,Perak,0,0,0,Mozambique
4460,3/1/2020,MOZ,Pulau Pinang,0,0,0,Mozambique
4461,3/1/2020,MOZ,Sabah,0,0,0,Mozambique
4462,3/1/2020,MOZ,Sarawak,0,0,0,Mozambique
4463,3/1/2020,MOZ,Selangor,7,4,3,Mozambique
4464,3/1/2020,MRT,Johor,0,0,0,Mauritania
4465,3/1/2020,MRT,Kedah,0,0,0,Mauritania
4466,3/1/2020,MRT,Pulau Pinang,0,0,0,Mauritania
4467,3/1/2020,MRT,Sabah,0,0,0,Mauritania
4468,3/1/2020,MRT,Sarawak,0,0,0,Mauritania
4469,3/1/2020,MRT,Selangor,8,7,1,Mauritania
4470,3/1/2020,MUS,Johor,35,22,13,Mauritius
4471,3/1/2020,MUS,Kedah,1,1,0,Mauritius
4472,3/1/2020,MUS,Kelantan,0,0,0,Mauritius
4473,3/1/2020,MUS,Pahang,1,1,0,Mauritius
4474,3/1/2020,MUS,Perak,0,0,0,Mauritius
4475,3/1/2020,MUS,Perlis,0,0,0,Mauritius
4476,3/1/2020,MUS,Pulau Pinang,0,0,0,Mauritius
4477,3/1/2020,MUS,Sabah,2,1,1,Mauritius
4478,3/1/2020,MUS,Sarawak,0,0,0,Mauritius
4479,3/1/2020,MUS,Selangor,188,128,60,Mauritius
4480,3/1/2020,MWI,Johor,2,2,0,Malawi
4481,3/1/2020,MWI,Pulau Pinang,0,0,0,Malawi
4482,3/1/2020,MWI,Sabah,0,0,0,Malawi
4483,3/1/2020,MWI,Sarawak,0,0,0,Malawi
4484,3/1/2020,MWI,Selangor,4,3,1,Malawi
4485,3/1/2020,MYT,Selangor,0,0,0,Mayotte
4486,3/1/2020,NAM,Johor,0,0,0,Namibia
4487,3/1/2020,NAM,Kedah,0,0,0,Namibia
4488,3/1/2020,NAM,Perak,0,0,0,Namibia
4489,3/1/2020,NAM,Perlis,1,0,1,Namibia
4490,3/1/2020,NAM,Pulau Pinang,2,0,2,Namibia
4491,3/1/2020,NAM,Sabah,0,0,0,Namibia
4492,3/1/2020,NAM,Sarawak,0,0,0,Namibia
4493,3/1/2020,NAM,Selangor,7,4,3,Namibia
4494,3/1/2020,NCL,Selangor,0,0,0,New Caledonia
4495,3/1/2020,NER,Johor,0,0,0,Niger
4496,3/1/2020,NER,Sabah,0,0,0,Niger
4497,3/1/2020,NER,Selangor,0,0,0,Niger
4498,3/1/2020,NGA,Johor,6,6,0,Nigeria
4499,3/1/2020,NGA,Kedah,0,0,0,Nigeria
4500,3/1/2020,NGA,Perlis,0,0,0,Nigeria
4501,3/1/2020,NGA,Pulau Pinang,3,2,1,Nigeria
4502,3/1/2020,NGA,Sabah,0,0,0,Nigeria
4503,3/1/2020,NGA,Sarawak,1,1,0,Nigeria
4504,3/1/2020,NGA,Selangor,284,238,46,Nigeria
4505,3/1/2020,NIC,Johor,0,0,0,Nicaragua
4506,3/1/2020,NIC,Kedah,1,1,0,Nicaragua
4507,3/1/2020,NIC,Pulau Pinang,0,0,0,Nicaragua
4508,3/1/2020,NIC,Sabah,0,0,0,Nicaragua
4509,3/1/2020,NIC,Selangor,2,1,1,Nicaragua
4510,3/1/2020,NLD,Johor,511,344,167,Netherlands
4511,3/1/2020,NLD,Kedah,217,130,87,Netherlands
4512,3/1/2020,NLD,Kelantan,14,10,4,Netherlands
4513,3/1/2020,NLD,Melaka,2,0,2,Netherlands
4514,3/1/2020,NLD,Negeri Sembilan,0,0,0,Netherlands
4515,3/1/2020,NLD,Pahang,2,1,1,Netherlands
4516,3/1/2020,NLD,Perak,2,2,0,Netherlands
4517,3/1/2020,NLD,Perlis,27,16,11,Netherlands
4518,3/1/2020,NLD,Pulau Pinang,108,71,37,Netherlands
4519,3/1/2020,NLD,Sabah,40,23,17,Netherlands
4520,3/1/2020,NLD,Sarawak,84,64,20,Netherlands
4521,3/1/2020,NLD,Selangor,2187,1297,890,Netherlands
4522,3/1/2020,NLD,Terengganu,0,0,0,Netherlands
4523,3/1/2020,NLD,W.P. Labuan,1,0,1,Netherlands
4524,3/1/2020,NOR,Johor,70,50,20,Norway
4525,3/1/2020,NOR,Kedah,73,32,41,Norway
4526,3/1/2020,NOR,Kelantan,0,0,0,Norway
4527,3/1/2020,NOR,Melaka,0,0,0,Norway
4528,3/1/2020,NOR,Pahang,0,0,0,Norway
4529,3/1/2020,NOR,Perak,1,1,0,Norway
4530,3/1/2020,NOR,Perlis,8,4,4,Norway
4531,3/1/2020,NOR,Pulau Pinang,20,13,7,Norway
4532,3/1/2020,NOR,Sabah,3,3,0,Norway
4533,3/1/2020,NOR,Sarawak,16,11,5,Norway
4534,3/1/2020,NOR,Selangor,400,212,188,Norway
4535,3/1/2020,NOR,W.P. Labuan,0,0,0,Norway
4536,3/1/2020,NPL,Johor,123,110,13,Nepal
4537,3/1/2020,NPL,Kedah,2,1,1,Nepal
4538,3/1/2020,NPL,Pahang,0,0,0,Nepal
4539,3/1/2020,NPL,Perak,0,0,0,Nepal
4540,3/1/2020,NPL,Perlis,0,0,0,Nepal
4541,3/1/2020,NPL,Pulau Pinang,65,58,7,Nepal
4542,3/1/2020,NPL,Sabah,46,46,0,Nepal
4543,3/1/2020,NPL,Sarawak,48,36,12,Nepal
4544,3/1/2020,NPL,Selangor,5976,5665,311,Nepal
4545,3/1/2020,NPL,W.P. Labuan,14,13,1,Nepal
4546,3/1/2020,NRU,Johor,0,0,0,Nauru
4547,3/1/2020,NRU,Pulau Pinang,0,0,0,Nauru
4548,3/1/2020,NRU,Selangor,0,0,0,Nauru
4549,3/1/2020,NZL,Johor,221,148,73,New Zealand
4550,3/1/2020,NZL,Kedah,39,23,16,New Zealand
4551,3/1/2020,NZL,Kelantan,2,2,0,New Zealand
4552,3/1/2020,NZL,Melaka,0,0,0,New Zealand
4553,3/1/2020,NZL,Negeri Sembilan,0,0,0,New Zealand
4554,3/1/2020,NZL,Pahang,0,0,0,New Zealand
4555,3/1/2020,NZL,Perak,10,6,4,New Zealand
4556,3/1/2020,NZL,Perlis,7,6,1,New Zealand
4557,3/1/2020,NZL,Pulau Pinang,71,38,33,New Zealand
4558,3/1/2020,NZL,Sabah,18,5,13,New Zealand
4559,3/1/2020,NZL,Sarawak,54,36,18,New Zealand
4560,3/1/2020,NZL,Selangor,889,555,334,New Zealand
4561,3/1/2020,NZL,Terengganu,0,0,0,New Zealand
4562,3/1/2020,NZL,W.P. Labuan,0,0,0,New Zealand
4563,3/1/2020,OMN,Johor,0,0,0,Oman
4564,3/1/2020,OMN,Kedah,4,3,1,Oman
4565,3/1/2020,OMN,Kelantan,0,0,0,Oman
4566,3/1/2020,OMN,Melaka,0,0,0,Oman
4567,3/1/2020,OMN,Perak,0,0,0,Oman
4568,3/1/2020,OMN,Perlis,0,0,0,Oman
4569,3/1/2020,OMN,Pulau Pinang,5,3,2,Oman
4570,3/1/2020,OMN,Sabah,0,0,0,Oman
4571,3/1/2020,OMN,Sarawak,3,3,0,Oman
4572,3/1/2020,OMN,Selangor,175,124,51,Oman
4573,3/1/2020,PAK,Johor,396,308,88,Pakistan
4574,3/1/2020,PAK,Kedah,31,21,10,Pakistan
4575,3/1/2020,PAK,Kelantan,5,5,0,Pakistan
4576,3/1/2020,PAK,Melaka,0,0,0,Pakistan
4577,3/1/2020,PAK,Negeri Sembilan,0,0,0,Pakistan
4578,3/1/2020,PAK,Pahang,0,0,0,Pakistan
4579,3/1/2020,PAK,Perak,2,2,0,Pakistan
4580,3/1/2020,PAK,Perlis,9,8,1,Pakistan
4581,3/1/2020,PAK,Pulau Pinang,16,15,1,Pakistan
4582,3/1/2020,PAK,Sabah,3,3,0,Pakistan
4583,3/1/2020,PAK,Sarawak,162,157,5,Pakistan
4584,3/1/2020,PAK,Selangor,5966,5345,621,Pakistan
4585,3/1/2020,PAK,W.P. Labuan,4,4,0,Pakistan
4586,3/1/2020,PAN,Johor,1,1,0,Panama
4587,3/1/2020,PAN,Kedah,0,0,0,Panama
4588,3/1/2020,PAN,Perak,0,0,0,Panama
4589,3/1/2020,PAN,Perlis,0,0,0,Panama
4590,3/1/2020,PAN,Pulau Pinang,0,0,0,Panama
4591,3/1/2020,PAN,Sabah,0,0,0,Panama
4592,3/1/2020,PAN,Sarawak,0,0,0,Panama
4593,3/1/2020,PAN,Selangor,8,3,5,Panama
4594,3/1/2020,PER,Johor,8,5,3,Peru
4595,3/1/2020,PER,Kedah,2,0,2,Peru
4596,3/1/2020,PER,Kelantan,0,0,0,Peru
4597,3/1/2020,PER,Pahang,0,0,0,Peru
4598,3/1/2020,PER,Perak,0,0,0,Peru
4599,3/1/2020,PER,Perlis,2,2,0,Peru
4600,3/1/2020,PER,Pulau Pinang,1,1,0,Peru
4601,3/1/2020,PER,Sabah,1,1,0,Peru
4602,3/1/2020,PER,Sarawak,2,1,1,Peru
4603,3/1/2020,PER,Selangor,48,24,24,Peru
4604,3/1/2020,PER,W.P. Labuan,0,0,0,Peru
4605,3/1/2020,PHL,Johor,6568,2051,4517,Philippines
4606,3/1/2020,PHL,Kedah,746,257,489,Philippines
4607,3/1/2020,PHL,Kelantan,36,23,13,Philippines
4608,3/1/2020,PHL,Melaka,0,0,0,Philippines
4609,3/1/2020,PHL,Negeri Sembilan,0,0,0,Philippines
4610,3/1/2020,PHL,Pahang,15,12,3,Philippines
4611,3/1/2020,PHL,Perak,25,8,17,Philippines
4612,3/1/2020,PHL,Perlis,138,45,93,Philippines
4613,3/1/2020,PHL,Pulau Pinang,205,54,151,Philippines
4614,3/1/2020,PHL,Sabah,1062,594,468,Philippines
4615,3/1/2020,PHL,Sarawak,1281,582,699,Philippines
4616,3/1/2020,PHL,Selangor,5551,2651,2900,Philippines
4617,3/1/2020,PHL,Terengganu,0,0,0,Philippines
4618,3/1/2020,PHL,W.P. Labuan,133,62,71,Philippines
4619,3/1/2020,PLW,Johor,0,0,0,Palau
4620,3/1/2020,PLW,Pulau Pinang,0,0,0,Palau
4621,3/1/2020,PLW,Selangor,0,0,0,Palau
4622,3/1/2020,PNG,Johor,5,5,0,Papua New Guinea
4623,3/1/2020,PNG,Kedah,0,0,0,Papua New Guinea
4624,3/1/2020,PNG,Kelantan,0,0,0,Papua New Guinea
4625,3/1/2020,PNG,Perak,0,0,0,Papua New Guinea
4626,3/1/2020,PNG,Pulau Pinang,0,0,0,Papua New Guinea
4627,3/1/2020,PNG,Sabah,3,2,1,Papua New Guinea
4628,3/1/2020,PNG,Sarawak,2,1,1,Papua New Guinea
4629,3/1/2020,PNG,Selangor,13,8,5,Papua New Guinea
4630,3/1/2020,POL,Johor,166,100,66,Poland
4631,3/1/2020,POL,Kedah,104,54,50,Poland
4632,3/1/2020,POL,Kelantan,1,0,1,Poland
4633,3/1/2020,POL,Melaka,0,0,0,Poland
4634,3/1/2020,POL,Negeri Sembilan,0,0,0,Poland
4635,3/1/2020,POL,Pahang,0,0,0,Poland
4636,3/1/2020,POL,Perak,0,0,0,Poland
4637,3/1/2020,POL,Perlis,19,9,10,Poland
4638,3/1/2020,POL,Pulau Pinang,33,16,17,Poland
4639,3/1/2020,POL,Sabah,31,17,14,Poland
4640,3/1/2020,POL,Sarawak,33,22,11,Poland
4641,3/1/2020,POL,Selangor,749,394,355,Poland
4642,3/1/2020,POL,Terengganu,0,0,0,Poland
4643,3/1/2020,POL,W.P. Labuan,14,10,4,Poland
4644,3/1/2020,PRK,Selangor,0,0,0,"Korea, Democratic People's Republic of"
4645,3/1/2020,PRT,Johor,56,35,21,Portugal
4646,3/1/2020,PRT,Kedah,28,18,10,Portugal
4647,3/1/2020,PRT,Kelantan,0,0,0,Portugal
4648,3/1/2020,PRT,Melaka,0,0,0,Portugal
4649,3/1/2020,PRT,Pahang,0,0,0,Portugal
4650,3/1/2020,PRT,Perak,0,0,0,Portugal
4651,3/1/2020,PRT,Perlis,2,2,0,Portugal
4652,3/1/2020,PRT,Pulau Pinang,10,6,4,Portugal
4653,3/1/2020,PRT,Sabah,13,6,7,Portugal
4654,3/1/2020,PRT,Sarawak,4,2,2,Portugal
4655,3/1/2020,PRT,Selangor,234,138,96,Portugal
4656,3/1/2020,PRT,W.P. Labuan,0,0,0,Portugal
4657,3/1/2020,PRY,Johor,0,0,0,Paraguay
4658,3/1/2020,PRY,Kedah,0,0,0,Paraguay
4659,3/1/2020,PRY,Perak,0,0,0,Paraguay
4660,3/1/2020,PRY,Perlis,0,0,0,Paraguay
4661,3/1/2020,PRY,Pulau Pinang,0,0,0,Paraguay
4662,3/1/2020,PRY,Sabah,0,0,0,Paraguay
4663,3/1/2020,PRY,Sarawak,0,0,0,Paraguay
4664,3/1/2020,PRY,Selangor,11,3,8,Paraguay
4665,3/1/2020,PSE,Johor,3,3,0,"Palestinian Territory, Occupied"
4666,3/1/2020,PSE,Kedah,0,0,0,"Palestinian Territory, Occupied"
4667,3/1/2020,PSE,Kelantan,0,0,0,"Palestinian Territory, Occupied"
4668,3/1/2020,PSE,Melaka,0,0,0,"Palestinian Territory, Occupied"
4669,3/1/2020,PSE,Perak,0,0,0,"Palestinian Territory, Occupied"
4670,3/1/2020,PSE,Perlis,0,0,0,"Palestinian Territory, Occupied"
4671,3/1/2020,PSE,Pulau Pinang,1,1,0,"Palestinian Territory, Occupied"
4672,3/1/2020,PSE,Sabah,0,0,0,"Palestinian Territory, Occupied"
4673,3/1/2020,PSE,Sarawak,1,1,0,"Palestinian Territory, Occupied"
4674,3/1/2020,PSE,Selangor,196,163,33,"Palestinian Territory, Occupied"
4675,3/1/2020,QAT,Johor,0,0,0,Qatar
4676,3/1/2020,QAT,Kedah,1,1,0,Qatar
4677,3/1/2020,QAT,Perlis,0,0,0,Qatar
4678,3/1/2020,QAT,Pulau Pinang,0,0,0,Qatar
4679,3/1/2020,QAT,Sabah,0,0,0,Qatar
4680,3/1/2020,QAT,Sarawak,0,0,0,Qatar
4681,3/1/2020,QAT,Selangor,6,6,0,Qatar
4682,3/1/2020,REU,Johor,0,0,0,Reunion
4683,3/1/2020,REU,Sarawak,0,0,0,Reunion
4684,3/1/2020,ROU,Johor,54,35,19,Romania
4685,3/1/2020,ROU,Kedah,36,18,18,Romania
4686,3/1/2020,ROU,Kelantan,1,1,0,Romania
4687,3/1/2020,ROU,Negeri Sembilan,0,0,0,Romania
4688,3/1/2020,ROU,Pahang,0,0,0,Romania
4689,3/1/2020,ROU,Perak,0,0,0,Romania
4690,3/1/2020,ROU,Perlis,1,1,0,Romania
4691,3/1/2020,ROU,Pulau Pinang,8,4,4,Romania
4692,3/1/2020,ROU,Sabah,4,2,2,Romania
4693,3/1/2020,ROU,Sarawak,7,5,2,Romania
4694,3/1/2020,ROU,Selangor,385,191,194,Romania
4695,3/1/2020,ROU,W.P. Labuan,3,2,1,Romania
4696,3/1/2020,RUS,Johor,218,130,88,Russia
4697,3/1/2020,RUS,Kedah,561,250,311,Russia
4698,3/1/2020,RUS,Kelantan,69,34,35,Russia
4699,3/1/2020,RUS,Melaka,0,0,0,Russia
4700,3/1/2020,RUS,Negeri Sembilan,0,0,0,Russia
4701,3/1/2020,RUS,Pahang,3,3,0,Russia
4702,3/1/2020,RUS,Perak,3,1,2,Russia
4703,3/1/2020,RUS,Perlis,167,81,86,Russia
4704,3/1/2020,RUS,Pulau Pinang,83,39,44,Russia
4705,3/1/2020,RUS,Sabah,46,24,22,Russia
4706,3/1/2020,RUS,Sarawak,42,21,21,Russia
4707,3/1/2020,RUS,Selangor,4991,2199,2792,Russia
4708,3/1/2020,RUS,W.P. Labuan,9,6,3,Russia
4709,3/1/2020,RWA,Johor,1,1,0,Rwanda
4710,3/1/2020,RWA,Kedah,0,0,0,Rwanda
4711,3/1/2020,RWA,Pulau Pinang,0,0,0,Rwanda
4712,3/1/2020,RWA,Selangor,1,0,1,Rwanda
4713,3/1/2020,SAU,Johor,13,11,2,Saudi Arabia
4714,3/1/2020,SAU,Kedah,1,1,0,Saudi Arabia
4715,3/1/2020,SAU,Kelantan,1,1,0,Saudi Arabia
4716,3/1/2020,SAU,Melaka,0,0,0,Saudi Arabia
4717,3/1/2020,SAU,Perak,0,0,0,Saudi Arabia
4718,3/1/2020,SAU,Perlis,0,0,0,Saudi Arabia
4719,3/1/2020,SAU,Pulau Pinang,11,6,5,Saudi Arabia
4720,3/1/2020,SAU,Sabah,0,0,0,Saudi Arabia
4721,3/1/2020,SAU,Sarawak,0,0,0,Saudi Arabia
4722,3/1/2020,SAU,Selangor,984,600,384,Saudi Arabia
4723,3/1/2020,SAU,W.P. Labuan,0,0,0,Saudi Arabia
4724,3/1/2020,SDN,Johor,2,2,0,Sudan
4725,3/1/2020,SDN,Kedah,0,0,0,Sudan
4726,3/1/2020,SDN,Kelantan,0,0,0,Sudan
4727,3/1/2020,SDN,Perlis,0,0,0,Sudan
4728,3/1/2020,SDN,Pulau Pinang,0,0,0,Sudan
4729,3/1/2020,SDN,Sabah,0,0,0,Sudan
4730,3/1/2020,SDN,Sarawak,0,0,0,Sudan
4731,3/1/2020,SDN,Selangor,373,233,140,Sudan
4732,3/1/2020,SDN,W.P. Labuan,0,0,0,Sudan
4733,3/1/2020,SEN,Johor,6,6,0,Senegal
4734,3/1/2020,SEN,Kedah,0,0,0,Senegal
4735,3/1/2020,SEN,Kelantan,0,0,0,Senegal
4736,3/1/2020,SEN,Perak,0,0,0,Senegal
4737,3/1/2020,SEN,Perlis,0,0,0,Senegal
4738,3/1/2020,SEN,Pulau Pinang,0,0,0,Senegal
4739,3/1/2020,SEN,Sabah,0,0,0,Senegal
4740,3/1/2020,SEN,Sarawak,0,0,0,Senegal
4741,3/1/2020,SEN,Selangor,19,17,2,Senegal
4742,3/1/2020,SGP,Johor,567130,351191,215939,Singapore
4743,3/1/2020,SGP,Kedah,1328,723,605,Singapore
4744,3/1/2020,SGP,Kelantan,201,107,94,Singapore
4745,3/1/2020,SGP,Melaka,6,6,0,Singapore
4746,3/1/2020,SGP,Negeri Sembilan,2,1,1,Singapore
4747,3/1/2020,SGP,Pahang,196,92,104,Singapore
4748,3/1/2020,SGP,Perak,1516,769,747,Singapore
4749,3/1/2020,SGP,Perlis,58,35,23,Singapore
4750,3/1/2020,SGP,Pulau Pinang,4627,2411,2216,Singapore
4751,3/1/2020,SGP,Sabah,814,454,360,Singapore
4752,3/1/2020,SGP,Sarawak,837,515,322,Singapore
4753,3/1/2020,SGP,Selangor,11654,6915,4739,Singapore
4754,3/1/2020,SGP,Terengganu,9,8,1,Singapore
4755,3/1/2020,SGP,W.P. Labuan,13,9,4,Singapore
4756,3/1/2020,SGS,Johor,0,0,0,South Georgia and the South Sandwich Islands
4757,3/1/2020,SGS,Sabah,0,0,0,South Georgia and the South Sandwich Islands
4758,3/1/2020,SGS,Selangor,0,0,0,South Georgia and the South Sandwich Islands
4759,3/1/2020,SHN,Sarawak,0,0,0,"Saint Helena, Ascension and Tristan da Cunha"
4760,3/1/2020,SLB,Johor,1,1,0,Solomon Islands
4761,3/1/2020,SLB,Perlis,0,0,0,Solomon Islands
4762,3/1/2020,SLB,Pulau Pinang,0,0,0,Solomon Islands
4763,3/1/2020,SLB,Sabah,0,0,0,Solomon Islands
4764,3/1/2020,SLB,Sarawak,0,0,0,Solomon Islands
4765,3/1/2020,SLB,Selangor,1,1,0,Solomon Islands
4766,3/1/2020,SLB,W.P. Labuan,0,0,0,Solomon Islands
4767,3/1/2020,SLE,Johor,0,0,0,Sierra Leone
4768,3/1/2020,SLE,Kedah,0,0,0,Sierra Leone
4769,3/1/2020,SLE,Perak,0,0,0,Sierra Leone
4770,3/1/2020,SLE,Pulau Pinang,0,0,0,Sierra Leone
4771,3/1/2020,SLE,Sabah,0,0,0,Sierra Leone
4772,3/1/2020,SLE,Selangor,25,15,10,Sierra Leone
4773,3/1/2020,SLV,Johor,0,0,0,El Salvador
4774,3/1/2020,SLV,Kedah,0,0,0,El Salvador
4775,3/1/2020,SLV,Perak,0,0,0,El Salvador
4776,3/1/2020,SLV,Perlis,0,0,0,El Salvador
4777,3/1/2020,SLV,Pulau Pinang,0,0,0,El Salvador
4778,3/1/2020,SLV,Sabah,0,0,0,El Salvador
4779,3/1/2020,SLV,Selangor,7,5,2,El Salvador
4780,3/1/2020,SLV,W.P. Labuan,0,0,0,El Salvador
4781,3/1/2020,SMR,Johor,0,0,0,San Marino
4782,3/1/2020,SMR,Selangor,1,1,0,San Marino
4783,3/1/2020,SOM,Johor,0,0,0,Somalia
4784,3/1/2020,SOM,Kedah,0,0,0,Somalia
4785,3/1/2020,SOM,Kelantan,0,0,0,Somalia
4786,3/1/2020,SOM,Perlis,0,0,0,Somalia
4787,3/1/2020,SOM,Sabah,0,0,0,Somalia
4788,3/1/2020,SOM,Sarawak,0,0,0,Somalia
4789,3/1/2020,SOM,Selangor,153,98,55,Somalia
4790,3/1/2020,SRB,Johor,3,1,2,Serbia
4791,3/1/2020,SRB,Kedah,3,1,2,Serbia
4792,3/1/2020,SRB,Kelantan,0,0,0,Serbia
4793,3/1/2020,SRB,Pahang,0,0,0,Serbia
4794,3/1/2020,SRB,Perak,0,0,0,Serbia
4795,3/1/2020,SRB,Perlis,0,0,0,Serbia
4796,3/1/2020,SRB,Pulau Pinang,2,2,0,Serbia
4797,3/1/2020,SRB,Sabah,1,1,0,Serbia
4798,3/1/2020,SRB,Sarawak,0,0,0,Serbia
4799,3/1/2020,SRB,Selangor,28,18,10,Serbia
4800,3/1/2020,STP,Selangor,0,0,0,Sao Tome and Principe
4801,3/1/2020,SUR,Johor,0,0,0,Suriname
4802,3/1/2020,SUR,Kedah,0,0,0,Suriname
4803,3/1/2020,SUR,Kelantan,0,0,0,Suriname
4804,3/1/2020,SUR,Perak,0,0,0,Suriname
4805,3/1/2020,SUR,Perlis,0,0,0,Suriname
4806,3/1/2020,SUR,Pulau Pinang,0,0,0,Suriname
4807,3/1/2020,SUR,Sabah,0,0,0,Suriname
4808,3/1/2020,SUR,Sarawak,0,0,0,Suriname
4809,3/1/2020,SUR,Selangor,9,5,4,Suriname
4810,3/1/2020,SVK,Johor,14,12,2,Slovakia
4811,3/1/2020,SVK,Kedah,141,67,74,Slovakia
4812,3/1/2020,SVK,Kelantan,2,2,0,Slovakia
4813,3/1/2020,SVK,Negeri Sembilan,0,0,0,Slovakia
4814,3/1/2020,SVK,Pahang,0,0,0,Slovakia
4815,3/1/2020,SVK,Perak,0,0,0,Slovakia
4816,3/1/2020,SVK,Perlis,0,0,0,Slovakia
4817,3/1/2020,SVK,Pulau Pinang,2,1,1,Slovakia
4818,3/1/2020,SVK,Sabah,11,4,7,Slovakia
4819,3/1/2020,SVK,Sarawak,4,2,2,Slovakia
4820,3/1/2020,SVK,Selangor,218,103,115,Slovakia
4821,3/1/2020,SVK,W.P. Labuan,1,1,0,Slovakia
4822,3/1/2020,SVN,Johor,5,3,2,Slovenia
4823,3/1/2020,SVN,Kedah,15,7,8,Slovenia
4824,3/1/2020,SVN,Kelantan,0,0,0,Slovenia
4825,3/1/2020,SVN,Perak,0,0,0,Slovenia
4826,3/1/2020,SVN,Perlis,0,0,0,Slovenia
4827,3/1/2020,SVN,Pulau Pinang,0,0,0,Slovenia
4828,3/1/2020,SVN,Sabah,1,1,0,Slovenia
4829,3/1/2020,SVN,Sarawak,0,0,0,Slovenia
4830,3/1/2020,SVN,Selangor,43,23,20,Slovenia
4831,3/1/2020,SVN,W.P. Labuan,0,0,0,Slovenia
4832,3/1/2020,SWE,Johor,142,83,59,Sweden
4833,3/1/2020,SWE,Kedah,286,128,158,Sweden
4834,3/1/2020,SWE,Kelantan,5,4,1,Sweden
4835,3/1/2020,SWE,Melaka,1,0,1,Sweden
4836,3/1/2020,SWE,Negeri Sembilan,0,0,0,Sweden
4837,3/1/2020,SWE,Pahang,0,0,0,Sweden
4838,3/1/2020,SWE,Perak,0,0,0,Sweden
4839,3/1/2020,SWE,Perlis,16,14,2,Sweden
4840,3/1/2020,SWE,Pulau Pinang,58,38,20,Sweden
4841,3/1/2020,SWE,Sabah,17,10,7,Sweden
4842,3/1/2020,SWE,Sarawak,12,7,5,Sweden
4843,3/1/2020,SWE,Selangor,839,469,370,Sweden
4844,3/1/2020,SWE,W.P. Labuan,4,3,1,Sweden
4845,3/1/2020,SWZ,Johor,0,0,0,Swaziland
4846,3/1/2020,SWZ,Kedah,0,0,0,Swaziland
4847,3/1/2020,SWZ,Pulau Pinang,0,0,0,Swaziland
4848,3/1/2020,SWZ,Sabah,0,0,0,Swaziland
4849,3/1/2020,SWZ,Selangor,6,2,4,Swaziland
4850,3/1/2020,SYC,Johor,0,0,0,Seychelles
4851,3/1/2020,SYC,Kedah,0,0,0,Seychelles
4852,3/1/2020,SYC,Pulau Pinang,0,0,0,Seychelles
4853,3/1/2020,SYC,Sabah,0,0,0,Seychelles
4854,3/1/2020,SYC,Sarawak,0,0,0,Seychelles
4855,3/1/2020,SYC,Selangor,25,8,17,Seychelles
4856,3/1/2020,SYR,Johor,3,2,1,Syrian Arab Republic
4857,3/1/2020,SYR,Kedah,2,2,0,Syrian Arab Republic
4858,3/1/2020,SYR,Kelantan,0,0,0,Syrian Arab Republic
4859,3/1/2020,SYR,Pahang,0,0,0,Syrian Arab Republic
4860,3/1/2020,SYR,Perlis,0,0,0,Syrian Arab Republic
4861,3/1/2020,SYR,Pulau Pinang,0,0,0,Syrian Arab Republic
4862,3/1/2020,SYR,Sabah,0,0,0,Syrian Arab Republic
4863,3/1/2020,SYR,Sarawak,0,0,0,Syrian Arab Republic
4864,3/1/2020,SYR,Selangor,336,264,72,Syrian Arab Republic
4865,3/1/2020,SYR,W.P. Labuan,0,0,0,Syrian Arab Republic
4866,3/1/2020,TCA,Perlis,0,0,0,Turks and Caicos
4867,3/1/2020,TCD,Johor,0,0,0,Chad
4868,3/1/2020,TCD,Kedah,0,0,0,Chad
4869,3/1/2020,TCD,Perlis,0,0,0,Chad
4870,3/1/2020,TCD,Selangor,5,5,0,Chad
4871,3/1/2020,TGO,Johor,0,0,0,Togo
4872,3/1/2020,TGO,Perak,0,0,0,Togo
4873,3/1/2020,TGO,Pulau Pinang,0,0,0,Togo
4874,3/1/2020,TGO,Selangor,4,4,0,Togo
4875,3/1/2020,THA,Johor,1928,438,1490,Thailand
4876,3/1/2020,THA,Kedah,26140,11342,14798,Thailand
4877,3/1/2020,THA,Kelantan,19386,10005,9381,Thailand
4878,3/1/2020,THA,Melaka,1,1,0,Thailand
4879,3/1/2020,THA,Negeri Sembilan,2,2,0,Thailand
4880,3/1/2020,THA,Pahang,0,0,0,Thailand
4881,3/1/2020,THA,Perak,7402,3404,3998,Thailand
4882,3/1/2020,THA,Perlis,27314,15943,11371,Thailand
4883,3/1/2020,THA,Pulau Pinang,425,172,253,Thailand
4884,3/1/2020,THA,Sabah,75,15,60,Thailand
4885,3/1/2020,THA,Sarawak,275,97,178,Thailand
4886,3/1/2020,THA,Selangor,3221,1307,1914,Thailand
4887,3/1/2020,THA,Terengganu,3,3,0,Thailand
4888,3/1/2020,THA,W.P. Labuan,5,2,3,Thailand
4889,3/1/2020,TJK,Johor,3,3,0,Tajikistan
4890,3/1/2020,TJK,Kedah,0,0,0,Tajikistan
4891,3/1/2020,TJK,Perlis,0,0,0,Tajikistan
4892,3/1/2020,TJK,Pulau Pinang,0,0,0,Tajikistan
4893,3/1/2020,TJK,Sabah,0,0,0,Tajikistan
4894,3/1/2020,TJK,Selangor,54,41,13,Tajikistan
4895,3/1/2020,TKL,Selangor,0,0,0,Tokelau
4896,3/1/2020,TKM,Johor,1,0,1,Turkmenistan
4897,3/1/2020,TKM,Kedah,0,0,0,Turkmenistan
4898,3/1/2020,TKM,Kelantan,0,0,0,Turkmenistan
4899,3/1/2020,TKM,Perlis,1,1,0,Turkmenistan
4900,3/1/2020,TKM,Pulau Pinang,0,0,0,Turkmenistan
4901,3/1/2020,TKM,Sabah,0,0,0,Turkmenistan
4902,3/1/2020,TKM,Sarawak,0,0,0,Turkmenistan
4903,3/1/2020,TKM,Selangor,29,18,11,Turkmenistan
4904,3/1/2020,TLS,Johor,0,0,0,Timor-Leste
4905,3/1/2020,TLS,Kedah,0,0,0,Timor-Leste
4906,3/1/2020,TLS,Perlis,0,0,0,Timor-Leste
4907,3/1/2020,TLS,Pulau Pinang,1,0,1,Timor-Leste
4908,3/1/2020,TLS,Sabah,0,0,0,Timor-Leste
4909,3/1/2020,TLS,Sarawak,1,1,0,Timor-Leste
4910,3/1/2020,TLS,Selangor,26,14,12,Timor-Leste
4911,3/1/2020,TON,Johor,0,0,0,Tonga
4912,3/1/2020,TON,Pulau Pinang,0,0,0,Tonga
4913,3/1/2020,TON,Sarawak,0,0,0,Tonga
4914,3/1/2020,TON,Selangor,2,1,1,Tonga
4915,3/1/2020,TTO,Johor,7,7,0,Trinidad and Tobago
4916,3/1/2020,TTO,Kedah,0,0,0,Trinidad and Tobago
4917,3/1/2020,TTO,Pahang,0,0,0,Trinidad and Tobago
4918,3/1/2020,TTO,Pulau Pinang,0,0,0,Trinidad and Tobago
4919,3/1/2020,TTO,Sabah,0,0,0,Trinidad and Tobago
4920,3/1/2020,TTO,Sarawak,0,0,0,Trinidad and Tobago
4921,3/1/2020,TTO,Selangor,13,8,5,Trinidad and Tobago
4922,3/1/2020,TUN,Johor,6,2,4,Tunisia
4923,3/1/2020,TUN,Kedah,3,2,1,Tunisia
4924,3/1/2020,TUN,Kelantan,0,0,0,Tunisia
4925,3/1/2020,TUN,Melaka,0,0,0,Tunisia
4926,3/1/2020,TUN,Perak,0,0,0,Tunisia
4927,3/1/2020,TUN,Perlis,0,0,0,Tunisia
4928,3/1/2020,TUN,Pulau Pinang,0,0,0,Tunisia
4929,3/1/2020,TUN,Sabah,0,0,0,Tunisia
4930,3/1/2020,TUN,Sarawak,0,0,0,Tunisia
4931,3/1/2020,TUN,Selangor,128,70,58,Tunisia
4932,3/1/2020,TUN,W.P. Labuan,0,0,0,Tunisia
4933,3/1/2020,TUR,Johor,70,63,7,Turkey
4934,3/1/2020,TUR,Kedah,26,19,7,Turkey
4935,3/1/2020,TUR,Kelantan,1,1,0,Turkey
4936,3/1/2020,TUR,Melaka,0,0,0,Turkey
4937,3/1/2020,TUR,Negeri Sembilan,0,0,0,Turkey
4938,3/1/2020,TUR,Pahang,0,0,0,Turkey
4939,3/1/2020,TUR,Perak,0,0,0,Turkey
4940,3/1/2020,TUR,Perlis,6,5,1,Turkey
4941,3/1/2020,TUR,Pulau Pinang,13,8,5,Turkey
4942,3/1/2020,TUR,Sabah,3,3,0,Turkey
4943,3/1/2020,TUR,Sarawak,7,6,1,Turkey
4944,3/1/2020,TUR,Selangor,364,284,80,Turkey
4945,3/1/2020,TUR,W.P. Labuan,1,1,0,Turkey
4946,3/1/2020,TUV,Selangor,0,0,0,Tuvalu
4947,3/1/2020,TWN,Johor,1199,463,736,Taiwan
4948,3/1/2020,TWN,Kedah,31,23,8,Taiwan
4949,3/1/2020,TWN,Kelantan,4,2,2,Taiwan
4950,3/1/2020,TWN,Melaka,2,0,2,Taiwan
4951,3/1/2020,TWN,Negeri Sembilan,0,0,0,Taiwan
4952,3/1/2020,TWN,Pahang,0,0,0,Taiwan
4953,3/1/2020,TWN,Perak,12,4,8,Taiwan
4954,3/1/2020,TWN,Perlis,4,4,0,Taiwan
4955,3/1/2020,TWN,Pulau Pinang,322,203,119,Taiwan
4956,3/1/2020,TWN,Sabah,368,188,180,Taiwan
4957,3/1/2020,TWN,Sarawak,55,22,33,Taiwan
4958,3/1/2020,TWN,Selangor,2288,1430,858,Taiwan
4959,3/1/2020,TWN,W.P. Labuan,6,5,1,Taiwan
4960,3/1/2020,TZA,Johor,7,5,2,"Tanzania, United Republic of"
4961,3/1/2020,TZA,Kedah,0,0,0,"Tanzania, United Republic of"
4962,3/1/2020,TZA,Perak,0,0,0,"Tanzania, United Republic of"
4963,3/1/2020,TZA,Perlis,0,0,0,"Tanzania, United Republic of"
4964,3/1/2020,TZA,Pulau Pinang,0,0,0,"Tanzania, United Republic of"
4965,3/1/2020,TZA,Sabah,4,1,3,"Tanzania, United Republic of"
4966,3/1/2020,TZA,Sarawak,0,0,0,"Tanzania, United Republic of"
4967,3/1/2020,TZA,Selangor,72,34,38,"Tanzania, United Republic of"
4968,3/1/2020,UGA,Johor,5,1,4,Uganda
4969,3/1/2020,UGA,Kedah,0,0,0,Uganda
4970,3/1/2020,UGA,Perak,0,0,0,Uganda
4971,3/1/2020,UGA,Perlis,0,0,0,Uganda
4972,3/1/2020,UGA,Pulau Pinang,0,0,0,Uganda
4973,3/1/2020,UGA,Sabah,0,0,0,Uganda
4974,3/1/2020,UGA,Sarawak,1,1,0,Uganda
4975,3/1/2020,UGA,Selangor,50,29,21,Uganda
4976,3/1/2020,UKR,Johor,74,39,35,Ukraine
4977,3/1/2020,UKR,Kedah,122,59,63,Ukraine
4978,3/1/2020,UKR,Kelantan,8,3,5,Ukraine
4979,3/1/2020,UKR,Melaka,0,0,0,Ukraine
4980,3/1/2020,UKR,Negeri Sembilan,0,0,0,Ukraine
4981,3/1/2020,UKR,Pahang,6,6,0,Ukraine
4982,3/1/2020,UKR,Perak,1,1,0,Ukraine
4983,3/1/2020,UKR,Perlis,15,8,7,Ukraine
4984,3/1/2020,UKR,Pulau Pinang,40,18,22,Ukraine
4985,3/1/2020,UKR,Sabah,7,3,4,Ukraine
4986,3/1/2020,UKR,Sarawak,7,6,1,Ukraine
4987,3/1/2020,UKR,Selangor,978,513,465,Ukraine
4988,3/1/2020,UKR,W.P. Labuan,11,7,4,Ukraine
4989,3/1/2020,URY,Johor,186,87,99,Uruguay
4990,3/1/2020,URY,Kedah,1,1,0,Uruguay
4991,3/1/2020,URY,Kelantan,27,10,17,Uruguay
4992,3/1/2020,URY,Perak,0,0,0,Uruguay
4993,3/1/2020,URY,Perlis,1,0,1,Uruguay
4994,3/1/2020,URY,Pulau Pinang,5,2,3,Uruguay
4995,3/1/2020,URY,Sabah,0,0,0,Uruguay
4996,3/1/2020,URY,Sarawak,0,0,0,Uruguay
4997,3/1/2020,URY,Selangor,86,33,53,Uruguay
4998,3/1/2020,URY,W.P. Labuan,0,0,0,Uruguay
4999,3/1/2020,USA,Johor,1236,807,429,United States Of America
5000,3/1/2020,USA,Kedah,232,143,89,United States Of America
5001,3/1/2020,USA,Kelantan,27,17,10,United States Of America
5002,3/1/2020,USA,Melaka,2,2,0,United States Of America
5003,3/1/2020,USA,Negeri Sembilan,0,0,0,United States Of America
5004,3/1/2020,USA,Pahang,4,3,1,United States Of America
5005,3/1/2020,USA,Perak,23,14,9,United States Of America
5006,3/1/2020,USA,Perlis,53,34,19,United States Of America
5007,3/1/2020,USA,Pulau Pinang,449,277,172,United States Of America
5008,3/1/2020,USA,Sabah,141,84,57,United States Of America
5009,3/1/2020,USA,Sarawak,86,40,46,United States Of America
5010,3/1/2020,USA,Selangor,4577,2883,1694,United States Of America
5011,3/1/2020,USA,Terengganu,0,0,0,United States Of America
5012,3/1/2020,USA,W.P. Labuan,11,8,3,United States Of America
5013,3/1/2020,UZB,Johor,20,11,9,Uzbekistan
5014,3/1/2020,UZB,Kedah,26,3,23,Uzbekistan
5015,3/1/2020,UZB,Kelantan,0,0,0,Uzbekistan
5016,3/1/2020,UZB,Perak,1,1,0,Uzbekistan
5017,3/1/2020,UZB,Perlis,1,0,1,Uzbekistan
5018,3/1/2020,UZB,Pulau Pinang,3,2,1,Uzbekistan
5019,3/1/2020,UZB,Sabah,0,0,0,Uzbekistan
5020,3/1/2020,UZB,Sarawak,1,1,0,Uzbekistan
5021,3/1/2020,UZB,Selangor,454,286,168,Uzbekistan
5022,3/1/2020,VAT,Johor,0,0,0,Holy See (Vatican City State)
5023,3/1/2020,VAT,Sarawak,0,0,0,Holy See (Vatican City State)
5024,3/1/2020,VAT,Selangor,0,0,0,Holy See (Vatican City State)
5025,3/1/2020,VCT,Johor,0,0,0,Saint Vincent and the Grenadines
5026,3/1/2020,VCT,Kedah,0,0,0,Saint Vincent and the Grenadines
5027,3/1/2020,VCT,Pulau Pinang,0,0,0,Saint Vincent and the Grenadines
5028,3/1/2020,VCT,Sarawak,0,0,0,Saint Vincent and the Grenadines
5029,3/1/2020,VCT,Selangor,0,0,0,Saint Vincent and the Grenadines
5030,3/1/2020,VEN,Johor,9,3,6,Venezuela
5031,3/1/2020,VEN,Kedah,1,1,0,Venezuela
5032,3/1/2020,VEN,Kelantan,0,0,0,Venezuela
5033,3/1/2020,VEN,Melaka,0,0,0,Venezuela
5034,3/1/2020,VEN,Perak,0,0,0,Venezuela
5035,3/1/2020,VEN,Perlis,0,0,0,Venezuela
5036,3/1/2020,VEN,Pulau Pinang,0,0,0,Venezuela
5037,3/1/2020,VEN,Sabah,0,0,0,Venezuela
5038,3/1/2020,VEN,Sarawak,1,0,1,Venezuela
5039,3/1/2020,VEN,Selangor,40,23,17,Venezuela
5040,3/1/2020,VEN,W.P. Labuan,0,0,0,Venezuela
5041,3/1/2020,VNM,Johor,3089,576,2513,Vietnam
5042,3/1/2020,VNM,Kedah,412,34,378,Vietnam
5043,3/1/2020,VNM,Kelantan,28,12,16,Vietnam
5044,3/1/2020,VNM,Melaka,0,0,0,Vietnam
5045,3/1/2020,VNM,Negeri Sembilan,0,0,0,Vietnam
5046,3/1/2020,VNM,Pahang,2,1,1,Vietnam
5047,3/1/2020,VNM,Perak,33,2,31,Vietnam
5048,3/1/2020,VNM,Perlis,100,23,77,Vietnam
5049,3/1/2020,VNM,Pulau Pinang,388,74,314,Vietnam
5050,3/1/2020,VNM,Sabah,17,5,12,Vietnam
5051,3/1/2020,VNM,Sarawak,352,98,254,Vietnam
5052,3/1/2020,VNM,Selangor,5528,1776,3752,Vietnam
5053,3/1/2020,VNM,Terengganu,0,0,0,Vietnam
5054,3/1/2020,VNM,W.P. Labuan,2,2,0,Vietnam
5055,3/1/2020,VUT,Johor,7,7,0,Vanuatu
5056,3/1/2020,VUT,Kedah,0,0,0,Vanuatu
5057,3/1/2020,VUT,Pulau Pinang,1,1,0,Vanuatu
5058,3/1/2020,VUT,Sabah,1,1,0,Vanuatu
5059,3/1/2020,VUT,Sarawak,0,0,0,Vanuatu
5060,3/1/2020,VUT,Selangor,33,32,1,Vanuatu
5061,3/1/2020,WSM,Johor,0,0,0,Samoa
5062,3/1/2020,WSM,Sarawak,0,0,0,Samoa
5063,3/1/2020,WSM,Selangor,1,0,1,Samoa
5064,3/1/2020,YEM,Johor,9,6,3,Yemen
5065,3/1/2020,YEM,Kedah,4,3,1,Yemen
5066,3/1/2020,YEM,Kelantan,0,0,0,Yemen
5067,3/1/2020,YEM,Melaka,5,3,2,Yemen
5068,3/1/2020,YEM,Pahang,0,0,0,Yemen
5069,3/1/2020,YEM,Perak,0,0,0,Yemen
5070,3/1/2020,YEM,Perlis,0,0,0,Yemen
5071,3/1/2020,YEM,Pulau Pinang,3,3,0,Yemen
5072,3/1/2020,YEM,Sabah,0,0,0,Yemen
5073,3/1/2020,YEM,Sarawak,0,0,0,Yemen
5074,3/1/2020,YEM,Selangor,820,605,215,Yemen
5075,3/1/2020,YEM,W.P. Labuan,0,0,0,Yemen
5076,3/1/2020,ZAF,Johor,85,54,31,South Africa
5077,3/1/2020,ZAF,Kedah,38,26,12,South Africa
5078,3/1/2020,ZAF,Kelantan,9,6,3,South Africa
5079,3/1/2020,ZAF,Melaka,0,0,0,South Africa
5080,3/1/2020,ZAF,Pahang,0,0,0,South Africa
5081,3/1/2020,ZAF,Perak,0,0,0,South Africa
5082,3/1/2020,ZAF,Perlis,3,1,2,South Africa
5083,3/1/2020,ZAF,Pulau Pinang,21,9,12,South Africa
5084,3/1/2020,ZAF,Sabah,6,4,2,South Africa
5085,3/1/2020,ZAF,Sarawak,28,17,11,South Africa
5086,3/1/2020,ZAF,Selangor,511,338,173,South Africa
5087,3/1/2020,ZAF,Terengganu,0,0,0,South Africa
5088,3/1/2020,ZAF,W.P. Labuan,0,0,0,South Africa
5089,3/1/2020,ZMB,Johor,0,0,0,Zambia
5090,3/1/2020,ZMB,Kedah,1,1,0,Zambia
5091,3/1/2020,ZMB,Perak,0,0,0,Zambia
5092,3/1/2020,ZMB,Perlis,0,0,0,Zambia
5093,3/1/2020,ZMB,Pulau Pinang,0,0,0,Zambia
5094,3/1/2020,ZMB,Sabah,0,0,0,Zambia
5095,3/1/2020,ZMB,Sarawak,0,0,0,Zambia
5096,3/1/2020,ZMB,Selangor,24,16,8,Zambia
5097,3/1/2020,ZWE,Johor,10,7,3,Zimbabwe
5098,3/1/2020,ZWE,Kedah,0,0,0,Zimbabwe
5099,3/1/2020,ZWE,Kelantan,0,0,0,Zimbabwe
5100,3/1/2020,ZWE,Perak,0,0,0,Zimbabwe
5101,3/1/2020,ZWE,Perlis,0,0,0,Zimbabwe
5102,3/1/2020,ZWE,Pulau Pinang,0,0,0,Zimbabwe
5103,3/1/2020,ZWE,Sabah,0,0,0,Zimbabwe
5104,3/1/2020,ZWE,Sarawak,0,0,0,Zimbabwe
5105,3/1/2020,ZWE,Selangor,60,30,30,Zimbabwe
5106,4/1/2020,ABW,Kedah,0,0,0,Aruba
5107,4/1/2020,ABW,Pulau Pinang,0,0,0,Aruba
5108,4/1/2020,AFG,Johor,0,0,0,Afghanistan
5109,4/1/2020,AFG,Kedah,0,0,0,Afghanistan
5110,4/1/2020,AFG,Perlis,0,0,0,Afghanistan
5111,4/1/2020,AFG,Pulau Pinang,0,0,0,Afghanistan
5112,4/1/2020,AFG,Sarawak,0,0,0,Afghanistan
5113,4/1/2020,AFG,Selangor,0,0,0,Afghanistan
5114,4/1/2020,AGO,Johor,0,0,0,Angola
5115,4/1/2020,AGO,Kedah,0,0,0,Angola
5116,4/1/2020,AGO,Sabah,0,0,0,Angola
5117,4/1/2020,AGO,Selangor,0,0,0,Angola
5118,4/1/2020,AIA,Selangor,0,0,0,Anguilla
5119,4/1/2020,ALB,Johor,0,0,0,Albania
5120,4/1/2020,ALB,Kedah,0,0,0,Albania
5121,4/1/2020,ALB,Perak,0,0,0,Albania
5122,4/1/2020,ALB,Perlis,0,0,0,Albania
5123,4/1/2020,ALB,Pulau Pinang,0,0,0,Albania
5124,4/1/2020,ALB,Sabah,0,0,0,Albania
5125,4/1/2020,ALB,Sarawak,0,0,0,Albania
5126,4/1/2020,ALB,Selangor,0,0,0,Albania
5127,4/1/2020,AND,Johor,0,0,0,Andorra
5128,4/1/2020,AND,Kedah,0,0,0,Andorra
5129,4/1/2020,AND,Perlis,0,0,0,Andorra
5130,4/1/2020,AND,Pulau Pinang,0,0,0,Andorra
5131,4/1/2020,AND,Selangor,0,0,0,Andorra
5132,4/1/2020,ANT,Selangor,0,0,0,Netherlands Antilles
5133,4/1/2020,ARE,Johor,0,0,0,United Arab Emirates
5134,4/1/2020,ARE,Kedah,0,0,0,United Arab Emirates
5135,4/1/2020,ARE,Kelantan,0,0,0,United Arab Emirates
5136,4/1/2020,ARE,Perak,0,0,0,United Arab Emirates
5137,4/1/2020,ARE,Perlis,0,0,0,United Arab Emirates
5138,4/1/2020,ARE,Pulau Pinang,0,0,0,United Arab Emirates
5139,4/1/2020,ARE,Sabah,0,0,0,United Arab Emirates
5140,4/1/2020,ARE,Sarawak,0,0,0,United Arab Emirates
5141,4/1/2020,ARE,Selangor,2,2,0,United Arab Emirates
5142,4/1/2020,ARG,Johor,0,0,0,Argentina
5143,4/1/2020,ARG,Kedah,0,0,0,Argentina
5144,4/1/2020,ARG,Kelantan,0,0,0,Argentina
5145,4/1/2020,ARG,Melaka,0,0,0,Argentina
5146,4/1/2020,ARG,Perak,0,0,0,Argentina
5147,4/1/2020,ARG,Perlis,0,0,0,Argentina
5148,4/1/2020,ARG,Pulau Pinang,0,0,0,Argentina
5149,4/1/2020,ARG,Sabah,0,0,0,Argentina
5150,4/1/2020,ARG,Sarawak,0,0,0,Argentina
5151,4/1/2020,ARG,Selangor,0,0,0,Argentina
5152,4/1/2020,ARG,W.P. Labuan,0,0,0,Argentina
5153,4/1/2020,ARM,Johor,0,0,0,Armenia
5154,4/1/2020,ARM,Kedah,0,0,0,Armenia
5155,4/1/2020,ARM,Kelantan,0,0,0,Armenia
5156,4/1/2020,ARM,Perak,0,0,0,Armenia
5157,4/1/2020,ARM,Perlis,0,0,0,Armenia
5158,4/1/2020,ARM,Pulau Pinang,0,0,0,Armenia
5159,4/1/2020,ARM,Sabah,0,0,0,Armenia
5160,4/1/2020,ARM,Sarawak,0,0,0,Armenia
5161,4/1/2020,ARM,Selangor,0,0,0,Armenia
5162,4/1/2020,ATA,Selangor,0,0,0,Antarctica
5163,4/1/2020,ATG,Johor,0,0,0,Antigua and Barbuda
5164,4/1/2020,ATG,Kedah,0,0,0,Antigua and Barbuda
5165,4/1/2020,ATG,Pulau Pinang,0,0,0,Antigua and Barbuda
5166,4/1/2020,ATG,Sarawak,0,0,0,Antigua and Barbuda
5167,4/1/2020,ATG,Selangor,0,0,0,Antigua and Barbuda
5168,4/1/2020,AUS,Johor,0,0,0,Australia
5169,4/1/2020,AUS,Kedah,0,0,0,Australia
5170,4/1/2020,AUS,Kelantan,0,0,0,Australia
5171,4/1/2020,AUS,Melaka,0,0,0,Australia
5172,4/1/2020,AUS,Negeri Sembilan,0,0,0,Australia
5173,4/1/2020,AUS,Pahang,0,0,0,Australia
5174,4/1/2020,AUS,Perak,0,0,0,Australia
5175,4/1/2020,AUS,Perlis,0,0,0,Australia
5176,4/1/2020,AUS,Pulau Pinang,0,0,0,Australia
5177,4/1/2020,AUS,Sabah,0,0,0,Australia
5178,4/1/2020,AUS,Sarawak,0,0,0,Australia
5179,4/1/2020,AUS,Selangor,9,8,1,Australia
5180,4/1/2020,AUS,Terengganu,0,0,0,Australia
5181,4/1/2020,AUS,W.P. Labuan,0,0,0,Australia
5182,4/1/2020,AUT,Johor,0,0,0,Austria
5183,4/1/2020,AUT,Kedah,1,1,0,Austria
5184,4/1/2020,AUT,Kelantan,0,0,0,Austria
5185,4/1/2020,AUT,Melaka,0,0,0,Austria
5186,4/1/2020,AUT,Negeri Sembilan,0,0,0,Austria
5187,4/1/2020,AUT,Pahang,0,0,0,Austria
5188,4/1/2020,AUT,Perak,0,0,0,Austria
5189,4/1/2020,AUT,Perlis,0,0,0,Austria
5190,4/1/2020,AUT,Pulau Pinang,0,0,0,Austria
5191,4/1/2020,AUT,Sabah,0,0,0,Austria
5192,4/1/2020,AUT,Sarawak,0,0,0,Austria
5193,4/1/2020,AUT,Selangor,0,0,0,Austria
5194,4/1/2020,AUT,Terengganu,0,0,0,Austria
5195,4/1/2020,AUT,W.P. Labuan,0,0,0,Austria
5196,4/1/2020,AZE,Johor,0,0,0,Azerbaijan
5197,4/1/2020,AZE,Kedah,0,0,0,Azerbaijan
5198,4/1/2020,AZE,Kelantan,0,0,0,Azerbaijan
5199,4/1/2020,AZE,Melaka,0,0,0,Azerbaijan
5200,4/1/2020,AZE,Perlis,0,0,0,Azerbaijan
5201,4/1/2020,AZE,Pulau Pinang,0,0,0,Azerbaijan
5202,4/1/2020,AZE,Sabah,0,0,0,Azerbaijan
5203,4/1/2020,AZE,Sarawak,0,0,0,Azerbaijan
5204,4/1/2020,AZE,Selangor,0,0,0,Azerbaijan
5205,4/1/2020,AZE,W.P. Labuan,0,0,0,Azerbaijan
5206,4/1/2020,BDI,Pulau Pinang,0,0,0,Burundi
5207,4/1/2020,BDI,Sarawak,0,0,0,Burundi
5208,4/1/2020,BDI,Selangor,0,0,0,Burundi
5209,4/1/2020,BEL,Johor,1,0,1,Belgium
5210,4/1/2020,BEL,Kedah,0,0,0,Belgium
5211,4/1/2020,BEL,Kelantan,0,0,0,Belgium
5212,4/1/2020,BEL,Melaka,0,0,0,Belgium
5213,4/1/2020,BEL,Negeri Sembilan,0,0,0,Belgium
5214,4/1/2020,BEL,Pahang,0,0,0,Belgium
5215,4/1/2020,BEL,Perak,0,0,0,Belgium
5216,4/1/2020,BEL,Perlis,0,0,0,Belgium
5217,4/1/2020,BEL,Pulau Pinang,0,0,0,Belgium
5218,4/1/2020,BEL,Sabah,0,0,0,Belgium
5219,4/1/2020,BEL,Sarawak,0,0,0,Belgium
5220,4/1/2020,BEL,Selangor,6,6,0,Belgium
5221,4/1/2020,BEL,W.P. Labuan,0,0,0,Belgium
5222,4/1/2020,BEN,Johor,0,0,0,Benin
5223,4/1/2020,BEN,Kedah,0,0,0,Benin
5224,4/1/2020,BEN,Perak,0,0,0,Benin
5225,4/1/2020,BEN,Pulau Pinang,0,0,0,Benin
5226,4/1/2020,BEN,Sabah,0,0,0,Benin
5227,4/1/2020,BEN,Sarawak,0,0,0,Benin
5228,4/1/2020,BEN,Selangor,0,0,0,Benin
5229,4/1/2020,BFA,Perak,0,0,0,Burkina Faso
5230,4/1/2020,BFA,Pulau Pinang,0,0,0,Burkina Faso
5231,4/1/2020,BFA,Selangor,0,0,0,Burkina Faso
5232,4/1/2020,BGD,Johor,0,0,0,Bangladesh
5233,4/1/2020,BGD,Kedah,0,0,0,Bangladesh
5234,4/1/2020,BGD,Kelantan,0,0,0,Bangladesh
5235,4/1/2020,BGD,Melaka,0,0,0,Bangladesh
5236,4/1/2020,BGD,Negeri Sembilan,0,0,0,Bangladesh
5237,4/1/2020,BGD,Pahang,0,0,0,Bangladesh
5238,4/1/2020,BGD,Perak,0,0,0,Bangladesh
5239,4/1/2020,BGD,Perlis,0,0,0,Bangladesh
5240,4/1/2020,BGD,Pulau Pinang,0,0,0,Bangladesh
5241,4/1/2020,BGD,Sabah,0,0,0,Bangladesh
5242,4/1/2020,BGD,Sarawak,0,0,0,Bangladesh
5243,4/1/2020,BGD,Selangor,2,2,0,Bangladesh
5244,4/1/2020,BGD,W.P. Labuan,0,0,0,Bangladesh
5245,4/1/2020,BGR,Johor,0,0,0,Bulgaria
5246,4/1/2020,BGR,Kedah,0,0,0,Bulgaria
5247,4/1/2020,BGR,Kelantan,0,0,0,Bulgaria
5248,4/1/2020,BGR,Pahang,0,0,0,Bulgaria
5249,4/1/2020,BGR,Perak,0,0,0,Bulgaria
5250,4/1/2020,BGR,Perlis,0,0,0,Bulgaria
5251,4/1/2020,BGR,Pulau Pinang,0,0,0,Bulgaria
5252,4/1/2020,BGR,Sabah,0,0,0,Bulgaria
5253,4/1/2020,BGR,Sarawak,0,0,0,Bulgaria
5254,4/1/2020,BGR,Selangor,0,0,0,Bulgaria
5255,4/1/2020,BGR,W.P. Labuan,0,0,0,Bulgaria
5256,4/1/2020,BHR,Johor,0,0,0,Bahrain
5257,4/1/2020,BHR,Kedah,0,0,0,Bahrain
5258,4/1/2020,BHR,Kelantan,0,0,0,Bahrain
5259,4/1/2020,BHR,Perlis,0,0,0,Bahrain
5260,4/1/2020,BHR,Pulau Pinang,0,0,0,Bahrain
5261,4/1/2020,BHR,Sabah,0,0,0,Bahrain
5262,4/1/2020,BHR,Sarawak,0,0,0,Bahrain
5263,4/1/2020,BHR,Selangor,0,0,0,Bahrain
5264,4/1/2020,BHS,Johor,0,0,0,Bahamas
5265,4/1/2020,BHS,Kedah,0,0,0,Bahamas
5266,4/1/2020,BHS,Perak,0,0,0,Bahamas
5267,4/1/2020,BHS,Sabah,0,0,0,Bahamas
5268,4/1/2020,BHS,Sarawak,0,0,0,Bahamas
5269,4/1/2020,BHS,Selangor,0,0,0,Bahamas
5270,4/1/2020,BIH,Johor,0,0,0,Bosnia and Herzegovina
5271,4/1/2020,BIH,Kedah,0,0,0,Bosnia and Herzegovina
5272,4/1/2020,BIH,Perlis,0,0,0,Bosnia and Herzegovina
5273,4/1/2020,BIH,Pulau Pinang,0,0,0,Bosnia and Herzegovina
5274,4/1/2020,BIH,Sabah,0,0,0,Bosnia and Herzegovina
5275,4/1/2020,BIH,Sarawak,0,0,0,Bosnia and Herzegovina
5276,4/1/2020,BIH,Selangor,1,1,0,Bosnia and Herzegovina
5277,4/1/2020,BLR,Johor,0,0,0,Belarus
5278,4/1/2020,BLR,Kedah,0,0,0,Belarus
5279,4/1/2020,BLR,Kelantan,0,0,0,Belarus
5280,4/1/2020,BLR,Pahang,0,0,0,Belarus
5281,4/1/2020,BLR,Perak,0,0,0,Belarus
5282,4/1/2020,BLR,Perlis,0,0,0,Belarus
5283,4/1/2020,BLR,Pulau Pinang,0,0,0,Belarus
5284,4/1/2020,BLR,Sabah,0,0,0,Belarus
5285,4/1/2020,BLR,Sarawak,0,0,0,Belarus
5286,4/1/2020,BLR,Selangor,0,0,0,Belarus
5287,4/1/2020,BLR,W.P. Labuan,0,0,0,Belarus
5288,4/1/2020,BLZ,Johor,0,0,0,Belize
5289,4/1/2020,BLZ,Pulau Pinang,0,0,0,Belize
5290,4/1/2020,BLZ,Sarawak,0,0,0,Belize
5291,4/1/2020,BLZ,Selangor,0,0,0,Belize
5292,4/1/2020,BMU,Selangor,0,0,0,Bermuda
5293,4/1/2020,BOL,Johor,0,0,0,Bolivia
5294,4/1/2020,BOL,Kedah,0,0,0,Bolivia
5295,4/1/2020,BOL,Melaka,0,0,0,Bolivia
5296,4/1/2020,BOL,Perak,0,0,0,Bolivia
5297,4/1/2020,BOL,Perlis,0,0,0,Bolivia
5298,4/1/2020,BOL,Pulau Pinang,0,0,0,Bolivia
5299,4/1/2020,BOL,Sabah,0,0,0,Bolivia
5300,4/1/2020,BOL,Sarawak,0,0,0,Bolivia
5301,4/1/2020,BOL,Selangor,0,0,0,Bolivia
5302,4/1/2020,BRA,Johor,0,0,0,Brazil
5303,4/1/2020,BRA,Kedah,0,0,0,Brazil
5304,4/1/2020,BRA,Kelantan,0,0,0,Brazil
5305,4/1/2020,BRA,Melaka,0,0,0,Brazil
5306,4/1/2020,BRA,Pahang,0,0,0,Brazil
5307,4/1/2020,BRA,Perak,0,0,0,Brazil
5308,4/1/2020,BRA,Perlis,0,0,0,Brazil
5309,4/1/2020,BRA,Pulau Pinang,0,0,0,Brazil
5310,4/1/2020,BRA,Sabah,0,0,0,Brazil
5311,4/1/2020,BRA,Sarawak,0,0,0,Brazil
5312,4/1/2020,BRA,Selangor,0,0,0,Brazil
5313,4/1/2020,BRA,W.P. Labuan,0,0,0,Brazil
5314,4/1/2020,BRB,Johor,0,0,0,Barbados
5315,4/1/2020,BRB,Kedah,0,0,0,Barbados
5316,4/1/2020,BRB,Perlis,0,0,0,Barbados
5317,4/1/2020,BRB,Pulau Pinang,0,0,0,Barbados
5318,4/1/2020,BRB,Selangor,0,0,0,Barbados
5319,4/1/2020,BRN,Johor,0,0,0,Brunei Darussalam
5320,4/1/2020,BRN,Kedah,0,0,0,Brunei Darussalam
5321,4/1/2020,BRN,Kelantan,0,0,0,Brunei Darussalam
5322,4/1/2020,BRN,Melaka,0,0,0,Brunei Darussalam
5323,4/1/2020,BRN,Pahang,0,0,0,Brunei Darussalam
5324,4/1/2020,BRN,Perak,0,0,0,Brunei Darussalam
5325,4/1/2020,BRN,Perlis,0,0,0,Brunei Darussalam
5326,4/1/2020,BRN,Pulau Pinang,0,0,0,Brunei Darussalam
5327,4/1/2020,BRN,Sabah,0,0,0,Brunei Darussalam
5328,4/1/2020,BRN,Sarawak,251,233,18,Brunei Darussalam
5329,4/1/2020,BRN,Selangor,1,1,0,Brunei Darussalam
5330,4/1/2020,BRN,W.P. Labuan,2,2,0,Brunei Darussalam
5331,4/1/2020,BTN,Johor,0,0,0,Bhutan
5332,4/1/2020,BTN,Kedah,0,0,0,Bhutan
5333,4/1/2020,BTN,Perak,0,0,0,Bhutan
5334,4/1/2020,BTN,Perlis,0,0,0,Bhutan
5335,4/1/2020,BTN,Pulau Pinang,0,0,0,Bhutan
5336,4/1/2020,BTN,Sabah,0,0,0,Bhutan
5337,4/1/2020,BTN,Sarawak,0,0,0,Bhutan
5338,4/1/2020,BTN,Selangor,0,0,0,Bhutan
5339,4/1/2020,BWA,Johor,0,0,0,Botswana
5340,4/1/2020,BWA,Kedah,0,0,0,Botswana
5341,4/1/2020,BWA,Perlis,0,0,0,Botswana
5342,4/1/2020,BWA,Pulau Pinang,0,0,0,Botswana
5343,4/1/2020,BWA,Sabah,0,0,0,Botswana
5344,4/1/2020,BWA,Sarawak,0,0,0,Botswana
5345,4/1/2020,BWA,Selangor,0,0,0,Botswana
5346,4/1/2020,CAF,Kedah,0,0,0,Central African Republic
5347,4/1/2020,CAF,Selangor,0,0,0,Central African Republic
5348,4/1/2020,CAN,Johor,0,0,0,Canada
5349,4/1/2020,CAN,Kedah,0,0,0,Canada
5350,4/1/2020,CAN,Kelantan,0,0,0,Canada
5351,4/1/2020,CAN,Melaka,0,0,0,Canada
5352,4/1/2020,CAN,Negeri Sembilan,0,0,0,Canada
5353,4/1/2020,CAN,Pahang,0,0,0,Canada
5354,4/1/2020,CAN,Perak,0,0,0,Canada
5355,4/1/2020,CAN,Perlis,0,0,0,Canada
5356,4/1/2020,CAN,Pulau Pinang,0,0,0,Canada
5357,4/1/2020,CAN,Sabah,0,0,0,Canada
5358,4/1/2020,CAN,Sarawak,0,0,0,Canada
5359,4/1/2020,CAN,Selangor,2,2,0,Canada
5360,4/1/2020,CAN,Terengganu,0,0,0,Canada
5361,4/1/2020,CAN,W.P. Labuan,0,0,0,Canada
5362,4/1/2020,CCK,Selangor,0,0,0,Cocos (Keeling) Islands
5363,4/1/2020,CHE,Johor,0,0,0,Switzerland
5364,4/1/2020,CHE,Kedah,0,0,0,Switzerland
5365,4/1/2020,CHE,Kelantan,0,0,0,Switzerland
5366,4/1/2020,CHE,Melaka,0,0,0,Switzerland
5367,4/1/2020,CHE,Negeri Sembilan,0,0,0,Switzerland
5368,4/1/2020,CHE,Pahang,0,0,0,Switzerland
5369,4/1/2020,CHE,Perak,0,0,0,Switzerland
5370,4/1/2020,CHE,Perlis,0,0,0,Switzerland
5371,4/1/2020,CHE,Pulau Pinang,0,0,0,Switzerland
5372,4/1/2020,CHE,Sabah,0,0,0,Switzerland
5373,4/1/2020,CHE,Sarawak,0,0,0,Switzerland
5374,4/1/2020,CHE,Selangor,1,1,0,Switzerland
5375,4/1/2020,CHE,W.P. Labuan,0,0,0,Switzerland
5376,4/1/2020,CHL,Johor,0,0,0,Chile
5377,4/1/2020,CHL,Kedah,0,0,0,Chile
5378,4/1/2020,CHL,Kelantan,0,0,0,Chile
5379,4/1/2020,CHL,Melaka,0,0,0,Chile
5380,4/1/2020,CHL,Pahang,0,0,0,Chile
5381,4/1/2020,CHL,Perak,0,0,0,Chile
5382,4/1/2020,CHL,Perlis,0,0,0,Chile
5383,4/1/2020,CHL,Pulau Pinang,0,0,0,Chile
5384,4/1/2020,CHL,Sabah,0,0,0,Chile
5385,4/1/2020,CHL,Sarawak,0,0,0,Chile
5386,4/1/2020,CHL,Selangor,0,0,0,Chile
5387,4/1/2020,CHN,Johor,2,0,2,China
5388,4/1/2020,CHN,Kedah,0,0,0,China
5389,4/1/2020,CHN,Kelantan,0,0,0,China
5390,4/1/2020,CHN,Melaka,0,0,0,China
5391,4/1/2020,CHN,Pahang,0,0,0,China
5392,4/1/2020,CHN,Perak,0,0,0,China
5393,4/1/2020,CHN,Perlis,0,0,0,China
5394,4/1/2020,CHN,Pulau Pinang,0,0,0,China
5395,4/1/2020,CHN,Sabah,0,0,0,China
5396,4/1/2020,CHN,Sarawak,1,0,1,China
5397,4/1/2020,CHN,Selangor,57,28,29,China
5398,4/1/2020,CHN,Terengganu,0,0,0,China
5399,4/1/2020,CHN,W.P. Labuan,0,0,0,China
5400,4/1/2020,CIV,Johor,0,0,0,C��te d'Iv
5401,4/1/2020,CIV,Kedah,0,0,0,C��te d'Iv
5402,4/1/2020,CIV,Pulau Pinang,0,0,0,C��te d'Iv
5403,4/1/2020,CIV,Sabah,0,0,0,C��te d'Iv
5404,4/1/2020,CIV,Sarawak,0,0,0,C��te d'Iv
5405,4/1/2020,CIV,Selangor,0,0,0,C��te d'Iv
5406,4/1/2020,CMR,Johor,0,0,0,Cameroon
5407,4/1/2020,CMR,Kedah,0,0,0,Cameroon
5408,4/1/2020,CMR,Pulau Pinang,0,0,0,Cameroon
5409,4/1/2020,CMR,Sabah,0,0,0,Cameroon
5410,4/1/2020,CMR,Sarawak,0,0,0,Cameroon
5411,4/1/2020,CMR,Selangor,0,0,0,Cameroon
5412,4/1/2020,COD,Johor,0,0,0,"Congo, the Democratic Republic of the"
5413,4/1/2020,COD,Pulau Pinang,0,0,0,"Congo, the Democratic Republic of the"
5414,4/1/2020,COD,Sarawak,0,0,0,"Congo, the Democratic Republic of the"
5415,4/1/2020,COD,Selangor,0,0,0,"Congo, the Democratic Republic of the"
5416,4/1/2020,COG,Johor,0,0,0,Congo
5417,4/1/2020,COG,Kedah,0,0,0,Congo
5418,4/1/2020,COG,Selangor,0,0,0,Congo
5419,4/1/2020,COK,Selangor,0,0,0,Cook Islands
5420,4/1/2020,COL,Johor,0,0,0,Colombia
5421,4/1/2020,COL,Kedah,0,0,0,Colombia
5422,4/1/2020,COL,Perak,0,0,0,Colombia
5423,4/1/2020,COL,Pulau Pinang,0,0,0,Colombia
5424,4/1/2020,COL,Sabah,0,0,0,Colombia
5425,4/1/2020,COL,Sarawak,0,0,0,Colombia
5426,4/1/2020,COL,Selangor,0,0,0,Colombia
5427,4/1/2020,COL,W.P. Labuan,0,0,0,Colombia
5428,4/1/2020,COM,Johor,0,0,0,Comoros
5429,4/1/2020,COM,Kedah,0,0,0,Comoros
5430,4/1/2020,COM,Selangor,0,0,0,Comoros
5431,4/1/2020,CPV,Johor,0,0,0,Cape Verde
5432,4/1/2020,CPV,Kedah,0,0,0,Cape Verde
5433,4/1/2020,CPV,Pulau Pinang,0,0,0,Cape Verde
5434,4/1/2020,CPV,Sabah,0,0,0,Cape Verde
5435,4/1/2020,CPV,Selangor,0,0,0,Cape Verde
5436,4/1/2020,CRI,Johor,0,0,0,Costa Rica
5437,4/1/2020,CRI,Kedah,0,0,0,Costa Rica
5438,4/1/2020,CRI,Perak,0,0,0,Costa Rica
5439,4/1/2020,CRI,Perlis,0,0,0,Costa Rica
5440,4/1/2020,CRI,Pulau Pinang,0,0,0,Costa Rica
5441,4/1/2020,CRI,Sabah,0,0,0,Costa Rica
5442,4/1/2020,CRI,Sarawak,0,0,0,Costa Rica
5443,4/1/2020,CRI,Selangor,0,0,0,Costa Rica
5444,4/1/2020,CUB,Johor,0,0,0,Cuba
5445,4/1/2020,CUB,Kedah,0,0,0,Cuba
5446,4/1/2020,CUB,Perlis,0,0,0,Cuba
5447,4/1/2020,CUB,Pulau Pinang,0,0,0,Cuba
5448,4/1/2020,CUB,Sabah,0,0,0,Cuba
5449,4/1/2020,CUB,Sarawak,0,0,0,Cuba
5450,4/1/2020,CUB,Selangor,0,0,0,Cuba
5451,4/1/2020,CYP,Johor,0,0,0,Cyprus
5452,4/1/2020,CYP,Kedah,0,0,0,Cyprus
5453,4/1/2020,CYP,Perak,0,0,0,Cyprus
5454,4/1/2020,CYP,Perlis,0,0,0,Cyprus
5455,4/1/2020,CYP,Pulau Pinang,0,0,0,Cyprus
5456,4/1/2020,CYP,Sabah,0,0,0,Cyprus
5457,4/1/2020,CYP,Sarawak,0,0,0,Cyprus
5458,4/1/2020,CYP,Selangor,0,0,0,Cyprus
5459,4/1/2020,CZE,Johor,0,0,0,Czech Republic
5460,4/1/2020,CZE,Kedah,0,0,0,Czech Republic
5461,4/1/2020,CZE,Kelantan,0,0,0,Czech Republic
5462,4/1/2020,CZE,Melaka,0,0,0,Czech Republic
5463,4/1/2020,CZE,Negeri Sembilan,0,0,0,Czech Republic
5464,4/1/2020,CZE,Perak,0,0,0,Czech Republic
5465,4/1/2020,CZE,Perlis,0,0,0,Czech Republic
5466,4/1/2020,CZE,Pulau Pinang,0,0,0,Czech Republic
5467,4/1/2020,CZE,Sabah,0,0,0,Czech Republic
5468,4/1/2020,CZE,Sarawak,0,0,0,Czech Republic
5469,4/1/2020,CZE,Selangor,0,0,0,Czech Republic
5470,4/1/2020,CZE,W.P. Labuan,0,0,0,Czech Republic
5471,4/1/2020,DEU,Johor,4,2,2,Germany
5472,4/1/2020,DEU,Kedah,0,0,0,Germany
5473,4/1/2020,DEU,Kelantan,0,0,0,Germany
5474,4/1/2020,DEU,Melaka,0,0,0,Germany
5475,4/1/2020,DEU,Negeri Sembilan,0,0,0,Germany
5476,4/1/2020,DEU,Pahang,0,0,0,Germany
5477,4/1/2020,DEU,Perak,0,0,0,Germany
5478,4/1/2020,DEU,Perlis,0,0,0,Germany
5479,4/1/2020,DEU,Pulau Pinang,0,0,0,Germany
5480,4/1/2020,DEU,Sabah,0,0,0,Germany
5481,4/1/2020,DEU,Sarawak,0,0,0,Germany
5482,4/1/2020,DEU,Selangor,2,2,0,Germany
5483,4/1/2020,DEU,Terengganu,0,0,0,Germany
5484,4/1/2020,DEU,W.P. Labuan,0,0,0,Germany
5485,4/1/2020,DJI,Johor,0,0,0,Djibouti
5486,4/1/2020,DJI,Selangor,0,0,0,Djibouti
5487,4/1/2020,DMA,Johor,0,0,0,Dominica
5488,4/1/2020,DMA,Kedah,0,0,0,Dominica
5489,4/1/2020,DMA,Pulau Pinang,0,0,0,Dominica
5490,4/1/2020,DMA,Sabah,0,0,0,Dominica
5491,4/1/2020,DMA,Sarawak,0,0,0,Dominica
5492,4/1/2020,DMA,Selangor,0,0,0,Dominica
5493,4/1/2020,DMA,W.P. Labuan,0,0,0,Dominica
5494,4/1/2020,DNK,Johor,0,0,0,Denmark
5495,4/1/2020,DNK,Kedah,0,0,0,Denmark
5496,4/1/2020,DNK,Kelantan,0,0,0,Denmark
5497,4/1/2020,DNK,Melaka,0,0,0,Denmark
5498,4/1/2020,DNK,Negeri Sembilan,0,0,0,Denmark
5499,4/1/2020,DNK,Pahang,0,0,0,Denmark
5500,4/1/2020,DNK,Perak,0,0,0,Denmark
5501,4/1/2020,DNK,Perlis,0,0,0,Denmark
5502,4/1/2020,DNK,Pulau Pinang,0,0,0,Denmark
5503,4/1/2020,DNK,Sabah,0,0,0,Denmark
5504,4/1/2020,DNK,Sarawak,0,0,0,Denmark
5505,4/1/2020,DNK,Selangor,0,0,0,Denmark
5506,4/1/2020,DNK,W.P. Labuan,0,0,0,Denmark
5507,4/1/2020,DOM,Johor,0,0,0,Dominican Republic
5508,4/1/2020,DOM,Kedah,0,0,0,Dominican Republic
5509,4/1/2020,DOM,Perak,0,0,0,Dominican Republic
5510,4/1/2020,DOM,Perlis,0,0,0,Dominican Republic
5511,4/1/2020,DOM,Pulau Pinang,0,0,0,Dominican Republic
5512,4/1/2020,DOM,Sabah,0,0,0,Dominican Republic
5513,4/1/2020,DOM,Sarawak,0,0,0,Dominican Republic
5514,4/1/2020,DOM,Selangor,0,0,0,Dominican Republic
5515,4/1/2020,DZA,Johor,0,0,0,Algeria
5516,4/1/2020,DZA,Kedah,0,0,0,Algeria
5517,4/1/2020,DZA,Kelantan,0,0,0,Algeria
5518,4/1/2020,DZA,Melaka,0,0,0,Algeria
5519,4/1/2020,DZA,Perak,0,0,0,Algeria
5520,4/1/2020,DZA,Perlis,0,0,0,Algeria
5521,4/1/2020,DZA,Pulau Pinang,0,0,0,Algeria
5522,4/1/2020,DZA,Sabah,0,0,0,Algeria
5523,4/1/2020,DZA,Sarawak,0,0,0,Algeria
5524,4/1/2020,DZA,Selangor,0,0,0,Algeria
5525,4/1/2020,DZA,W.P. Labuan,0,0,0,Algeria
5526,4/1/2020,ECU,Johor,0,0,0,Ecuador
5527,4/1/2020,ECU,Kedah,0,0,0,Ecuador
5528,4/1/2020,ECU,Perak,0,0,0,Ecuador
5529,4/1/2020,ECU,Perlis,0,0,0,Ecuador
5530,4/1/2020,ECU,Pulau Pinang,0,0,0,Ecuador
5531,4/1/2020,ECU,Sabah,0,0,0,Ecuador
5532,4/1/2020,ECU,Sarawak,0,0,0,Ecuador
5533,4/1/2020,ECU,Selangor,0,0,0,Ecuador
5534,4/1/2020,EGY,Johor,6,6,0,Egypt
5535,4/1/2020,EGY,Kedah,0,0,0,Egypt
5536,4/1/2020,EGY,Kelantan,0,0,0,Egypt
5537,4/1/2020,EGY,Melaka,0,0,0,Egypt
5538,4/1/2020,EGY,Pahang,0,0,0,Egypt
5539,4/1/2020,EGY,Perak,0,0,0,Egypt
5540,4/1/2020,EGY,Perlis,0,0,0,Egypt
5541,4/1/2020,EGY,Pulau Pinang,0,0,0,Egypt
5542,4/1/2020,EGY,Sabah,0,0,0,Egypt
5543,4/1/2020,EGY,Sarawak,0,0,0,Egypt
5544,4/1/2020,EGY,Selangor,2,1,1,Egypt
5545,4/1/2020,EGY,Terengganu,0,0,0,Egypt
5546,4/1/2020,EGY,W.P. Labuan,0,0,0,Egypt
5547,4/1/2020,ERI,Johor,0,0,0,Eritrea
5548,4/1/2020,ERI,Pulau Pinang,0,0,0,Eritrea
5549,4/1/2020,ERI,Sabah,0,0,0,Eritrea
5550,4/1/2020,ERI,Selangor,0,0,0,Eritrea
5551,4/1/2020,ESP,Johor,0,0,0,Spain
5552,4/1/2020,ESP,Kedah,0,0,0,Spain
5553,4/1/2020,ESP,Kelantan,0,0,0,Spain
5554,4/1/2020,ESP,Melaka,0,0,0,Spain
5555,4/1/2020,ESP,Negeri Sembilan,0,0,0,Spain
5556,4/1/2020,ESP,Pahang,0,0,0,Spain
5557,4/1/2020,ESP,Perak,0,0,0,Spain
5558,4/1/2020,ESP,Perlis,0,0,0,Spain
5559,4/1/2020,ESP,Pulau Pinang,0,0,0,Spain
5560,4/1/2020,ESP,Sabah,0,0,0,Spain
5561,4/1/2020,ESP,Sarawak,0,0,0,Spain
5562,4/1/2020,ESP,Selangor,0,0,0,Spain
5563,4/1/2020,ESP,W.P. Labuan,0,0,0,Spain
5564,4/1/2020,EST,Johor,0,0,0,Estonia
5565,4/1/2020,EST,Kedah,0,0,0,Estonia
5566,4/1/2020,EST,Kelantan,0,0,0,Estonia
5567,4/1/2020,EST,Pahang,0,0,0,Estonia
5568,4/1/2020,EST,Perak,0,0,0,Estonia
5569,4/1/2020,EST,Perlis,0,0,0,Estonia
5570,4/1/2020,EST,Pulau Pinang,0,0,0,Estonia
5571,4/1/2020,EST,Sabah,0,0,0,Estonia
5572,4/1/2020,EST,Sarawak,0,0,0,Estonia
5573,4/1/2020,EST,Selangor,0,0,0,Estonia
5574,4/1/2020,EST,W.P. Labuan,0,0,0,Estonia
5575,4/1/2020,ETH,Johor,0,0,0,Ethiopia
5576,4/1/2020,ETH,Kedah,0,0,0,Ethiopia
5577,4/1/2020,ETH,Pulau Pinang,0,0,0,Ethiopia
5578,4/1/2020,ETH,Sarawak,0,0,0,Ethiopia
5579,4/1/2020,ETH,Selangor,0,0,0,Ethiopia
5580,4/1/2020,FIN,Johor,1,1,0,Finland
5581,4/1/2020,FIN,Kedah,0,0,0,Finland
5582,4/1/2020,FIN,Kelantan,0,0,0,Finland
5583,4/1/2020,FIN,Melaka,0,0,0,Finland
5584,4/1/2020,FIN,Negeri Sembilan,0,0,0,Finland
5585,4/1/2020,FIN,Pahang,0,0,0,Finland
5586,4/1/2020,FIN,Perak,0,0,0,Finland
5587,4/1/2020,FIN,Perlis,0,0,0,Finland
5588,4/1/2020,FIN,Pulau Pinang,1,1,0,Finland
5589,4/1/2020,FIN,Sabah,0,0,0,Finland
5590,4/1/2020,FIN,Sarawak,0,0,0,Finland
5591,4/1/2020,FIN,Selangor,0,0,0,Finland
5592,4/1/2020,FIN,W.P. Labuan,0,0,0,Finland
5593,4/1/2020,FJI,Johor,0,0,0,Fiji
5594,4/1/2020,FJI,Kedah,0,0,0,Fiji
5595,4/1/2020,FJI,Kelantan,0,0,0,Fiji
5596,4/1/2020,FJI,Perak,0,0,0,Fiji
5597,4/1/2020,FJI,Perlis,0,0,0,Fiji
5598,4/1/2020,FJI,Pulau Pinang,0,0,0,Fiji
5599,4/1/2020,FJI,Sabah,0,0,0,Fiji
5600,4/1/2020,FJI,Sarawak,0,0,0,Fiji
5601,4/1/2020,FJI,Selangor,0,0,0,Fiji
5602,4/1/2020,FRA,Johor,1,1,0,France
5603,4/1/2020,FRA,Kedah,0,0,0,France
5604,4/1/2020,FRA,Kelantan,0,0,0,France
5605,4/1/2020,FRA,Melaka,0,0,0,France
5606,4/1/2020,FRA,Negeri Sembilan,0,0,0,France
5607,4/1/2020,FRA,Pahang,0,0,0,France
5608,4/1/2020,FRA,Perak,0,0,0,France
5609,4/1/2020,FRA,Perlis,0,0,0,France
5610,4/1/2020,FRA,Pulau Pinang,0,0,0,France
5611,4/1/2020,FRA,Sabah,0,0,0,France
5612,4/1/2020,FRA,Sarawak,0,0,0,France
5613,4/1/2020,FRA,Selangor,2,1,1,France
5614,4/1/2020,FRA,Terengganu,0,0,0,France
5615,4/1/2020,FRA,W.P. Labuan,0,0,0,France
5616,4/1/2020,FSM,Johor,0,0,0,"Micronesia, Federated States of"
5617,4/1/2020,FSM,Pulau Pinang,0,0,0,"Micronesia, Federated States of"
5618,4/1/2020,FSM,Selangor,0,0,0,"Micronesia, Federated States of"
5619,4/1/2020,GAB,Johor,0,0,0,Gabon
5620,4/1/2020,GAB,Pulau Pinang,0,0,0,Gabon
5621,4/1/2020,GAB,Sarawak,0,0,0,Gabon
5622,4/1/2020,GAB,Selangor,0,0,0,Gabon
5623,4/1/2020,GBR,Johor,1,1,0,United Kingdom
5624,4/1/2020,GBR,Kedah,0,0,0,United Kingdom
5625,4/1/2020,GBR,Kelantan,0,0,0,United Kingdom
5626,4/1/2020,GBR,Melaka,0,0,0,United Kingdom
5627,4/1/2020,GBR,Negeri Sembilan,0,0,0,United Kingdom
5628,4/1/2020,GBR,Pahang,0,0,0,United Kingdom
5629,4/1/2020,GBR,Perak,0,0,0,United Kingdom
5630,4/1/2020,GBR,Perlis,0,0,0,United Kingdom
5631,4/1/2020,GBR,Pulau Pinang,0,0,0,United Kingdom
5632,4/1/2020,GBR,Sabah,0,0,0,United Kingdom
5633,4/1/2020,GBR,Sarawak,0,0,0,United Kingdom
5634,4/1/2020,GBR,Selangor,17,14,3,United Kingdom
5635,4/1/2020,GBR,Terengganu,0,0,0,United Kingdom
5636,4/1/2020,GBR,W.P. Labuan,0,0,0,United Kingdom
5637,4/1/2020,GEO,Johor,0,0,0,Georgia
5638,4/1/2020,GEO,Kedah,0,0,0,Georgia
5639,4/1/2020,GEO,Melaka,0,0,0,Georgia
5640,4/1/2020,GEO,Perak,0,0,0,Georgia
5641,4/1/2020,GEO,Perlis,0,0,0,Georgia
5642,4/1/2020,GEO,Pulau Pinang,0,0,0,Georgia
5643,4/1/2020,GEO,Sabah,0,0,0,Georgia
5644,4/1/2020,GEO,Sarawak,0,0,0,Georgia
5645,4/1/2020,GEO,Selangor,0,0,0,Georgia
5646,4/1/2020,GHA,Johor,0,0,0,Ghana
5647,4/1/2020,GHA,Kedah,0,0,0,Ghana
5648,4/1/2020,GHA,Kelantan,0,0,0,Ghana
5649,4/1/2020,GHA,Pulau Pinang,0,0,0,Ghana
5650,4/1/2020,GHA,Sabah,0,0,0,Ghana
5651,4/1/2020,GHA,Sarawak,0,0,0,Ghana
5652,4/1/2020,GHA,Selangor,0,0,0,Ghana
5653,4/1/2020,GIB,Johor,0,0,0,Gibraltar
5654,4/1/2020,GIB,Sarawak,0,0,0,Gibraltar
5655,4/1/2020,GIN,Johor,0,0,0,Guinea
5656,4/1/2020,GIN,Kedah,0,0,0,Guinea
5657,4/1/2020,GIN,Kelantan,0,0,0,Guinea
5658,4/1/2020,GIN,Perlis,0,0,0,Guinea
5659,4/1/2020,GIN,Pulau Pinang,0,0,0,Guinea
5660,4/1/2020,GIN,Sabah,0,0,0,Guinea
5661,4/1/2020,GIN,Sarawak,0,0,0,Guinea
5662,4/1/2020,GIN,Selangor,0,0,0,Guinea
5663,4/1/2020,GLP,Selangor,0,0,0,Guadeloupe
5664,4/1/2020,GMB,Johor,0,0,0,Gambia
5665,4/1/2020,GMB,Kedah,0,0,0,Gambia
5666,4/1/2020,GMB,Kelantan,0,0,0,Gambia
5667,4/1/2020,GMB,Pulau Pinang,0,0,0,Gambia
5668,4/1/2020,GMB,Sabah,0,0,0,Gambia
5669,4/1/2020,GMB,Sarawak,0,0,0,Gambia
5670,4/1/2020,GMB,Selangor,0,0,0,Gambia
5671,4/1/2020,GNB,Johor,0,0,0,Guinea-Bissau
5672,4/1/2020,GNB,Selangor,0,0,0,Guinea-Bissau
5673,4/1/2020,GNQ,Johor,0,0,0,Equatorial Guinea
5674,4/1/2020,GNQ,Selangor,0,0,0,Equatorial Guinea
5675,4/1/2020,GRC,Johor,0,0,0,Greece
5676,4/1/2020,GRC,Kedah,0,0,0,Greece
5677,4/1/2020,GRC,Kelantan,0,0,0,Greece
5678,4/1/2020,GRC,Melaka,0,0,0,Greece
5679,4/1/2020,GRC,Negeri Sembilan,0,0,0,Greece
5680,4/1/2020,GRC,Pahang,0,0,0,Greece
5681,4/1/2020,GRC,Perak,0,0,0,Greece
5682,4/1/2020,GRC,Perlis,0,0,0,Greece
5683,4/1/2020,GRC,Pulau Pinang,0,0,0,Greece
5684,4/1/2020,GRC,Sabah,0,0,0,Greece
5685,4/1/2020,GRC,Sarawak,0,0,0,Greece
5686,4/1/2020,GRC,Selangor,0,0,0,Greece
5687,4/1/2020,GRD,Johor,0,0,0,Grenada
5688,4/1/2020,GRD,Kedah,0,0,0,Grenada
5689,4/1/2020,GRD,Pulau Pinang,0,0,0,Grenada
5690,4/1/2020,GRD,Sabah,0,0,0,Grenada
5691,4/1/2020,GRD,Sarawak,0,0,0,Grenada
5692,4/1/2020,GRD,Selangor,0,0,0,Grenada
5693,4/1/2020,GRL,Johor,0,0,0,Greenland
5694,4/1/2020,GRL,Selangor,0,0,0,Greenland
5695,4/1/2020,GTM,Johor,0,0,0,Guatemala
5696,4/1/2020,GTM,Kedah,0,0,0,Guatemala
5697,4/1/2020,GTM,Pahang,0,0,0,Guatemala
5698,4/1/2020,GTM,Perak,0,0,0,Guatemala
5699,4/1/2020,GTM,Pulau Pinang,0,0,0,Guatemala
5700,4/1/2020,GTM,Sabah,0,0,0,Guatemala
5701,4/1/2020,GTM,Sarawak,0,0,0,Guatemala
5702,4/1/2020,GTM,Selangor,0,0,0,Guatemala
5703,4/1/2020,GTM,W.P. Labuan,0,0,0,Guatemala
5704,4/1/2020,GUY,Johor,0,0,0,Guyana
5705,4/1/2020,GUY,Kedah,0,0,0,Guyana
5706,4/1/2020,GUY,Pulau Pinang,0,0,0,Guyana
5707,4/1/2020,GUY,Sarawak,0,0,0,Guyana
5708,4/1/2020,GUY,Selangor,0,0,0,Guyana
5709,4/1/2020,HKG,Johor,0,0,0,Hong Kong
5710,4/1/2020,HKG,Kedah,0,0,0,Hong Kong
5711,4/1/2020,HKG,Kelantan,0,0,0,Hong Kong
5712,4/1/2020,HKG,Pahang,0,0,0,Hong Kong
5713,4/1/2020,HKG,Perak,0,0,0,Hong Kong
5714,4/1/2020,HKG,Perlis,0,0,0,Hong Kong
5715,4/1/2020,HKG,Pulau Pinang,0,0,0,Hong Kong
5716,4/1/2020,HKG,Sabah,0,0,0,Hong Kong
5717,4/1/2020,HKG,Sarawak,0,0,0,Hong Kong
5718,4/1/2020,HKG,Selangor,0,0,0,Hong Kong
5719,4/1/2020,HKG,Terengganu,0,0,0,Hong Kong
5720,4/1/2020,HMD,Johor,0,0,0,Heard Island and McDonald Islands
5721,4/1/2020,HND,Johor,0,0,0,Honduras
5722,4/1/2020,HND,Kedah,0,0,0,Honduras
5723,4/1/2020,HND,Perak,0,0,0,Honduras
5724,4/1/2020,HND,Pulau Pinang,0,0,0,Honduras
5725,4/1/2020,HND,Sabah,0,0,0,Honduras
5726,4/1/2020,HND,Sarawak,0,0,0,Honduras
5727,4/1/2020,HND,Selangor,0,0,0,Honduras
5728,4/1/2020,HRV,Johor,2,2,0,Croatia
5729,4/1/2020,HRV,Kedah,0,0,0,Croatia
5730,4/1/2020,HRV,Kelantan,0,0,0,Croatia
5731,4/1/2020,HRV,Melaka,0,0,0,Croatia
5732,4/1/2020,HRV,Pahang,0,0,0,Croatia
5733,4/1/2020,HRV,Perak,0,0,0,Croatia
5734,4/1/2020,HRV,Perlis,0,0,0,Croatia
5735,4/1/2020,HRV,Pulau Pinang,0,0,0,Croatia
5736,4/1/2020,HRV,Sabah,0,0,0,Croatia
5737,4/1/2020,HRV,Sarawak,0,0,0,Croatia
5738,4/1/2020,HRV,Selangor,0,0,0,Croatia
5739,4/1/2020,HTI,Johor,0,0,0,Haiti
5740,4/1/2020,HTI,Kedah,0,0,0,Haiti
5741,4/1/2020,HTI,Kelantan,0,0,0,Haiti
5742,4/1/2020,HTI,Perak,0,0,0,Haiti
5743,4/1/2020,HTI,Pulau Pinang,0,0,0,Haiti
5744,4/1/2020,HTI,Sabah,0,0,0,Haiti
5745,4/1/2020,HTI,Selangor,0,0,0,Haiti
5746,4/1/2020,HUN,Johor,0,0,0,Hungary
5747,4/1/2020,HUN,Kedah,0,0,0,Hungary
5748,4/1/2020,HUN,Kelantan,0,0,0,Hungary
5749,4/1/2020,HUN,Pahang,0,0,0,Hungary
5750,4/1/2020,HUN,Perak,0,0,0,Hungary
5751,4/1/2020,HUN,Perlis,0,0,0,Hungary
5752,4/1/2020,HUN,Pulau Pinang,2,2,0,Hungary
5753,4/1/2020,HUN,Sabah,0,0,0,Hungary
5754,4/1/2020,HUN,Sarawak,0,0,0,Hungary
5755,4/1/2020,HUN,Selangor,0,0,0,Hungary
5756,4/1/2020,HUN,W.P. Labuan,0,0,0,Hungary
5757,4/1/2020,IDN,Johor,89,52,37,Indonesia
5758,4/1/2020,IDN,Kedah,16,16,0,Indonesia
5759,4/1/2020,IDN,Kelantan,1,0,1,Indonesia
5760,4/1/2020,IDN,Melaka,0,0,0,Indonesia
5761,4/1/2020,IDN,Negeri Sembilan,1,1,0,Indonesia
5762,4/1/2020,IDN,Pahang,0,0,0,Indonesia
5763,4/1/2020,IDN,Perak,0,0,0,Indonesia
5764,4/1/2020,IDN,Perlis,0,0,0,Indonesia
5765,4/1/2020,IDN,Pulau Pinang,0,0,0,Indonesia
5766,4/1/2020,IDN,Sabah,18,2,16,Indonesia
5767,4/1/2020,IDN,Sarawak,201,188,13,Indonesia
5768,4/1/2020,IDN,Selangor,104,46,58,Indonesia
5769,4/1/2020,IDN,Terengganu,0,0,0,Indonesia
5770,4/1/2020,IDN,W.P. Labuan,0,0,0,Indonesia
5771,4/1/2020,IND,Johor,5,5,0,India
5772,4/1/2020,IND,Kedah,0,0,0,India
5773,4/1/2020,IND,Kelantan,0,0,0,India
5774,4/1/2020,IND,Melaka,0,0,0,India
5775,4/1/2020,IND,Negeri Sembilan,0,0,0,India
5776,4/1/2020,IND,Pahang,0,0,0,India
5777,4/1/2020,IND,Perak,0,0,0,India
5778,4/1/2020,IND,Perlis,0,0,0,India
5779,4/1/2020,IND,Pulau Pinang,0,0,0,India
5780,4/1/2020,IND,Sabah,0,0,0,India
5781,4/1/2020,IND,Sarawak,0,0,0,India
5782,4/1/2020,IND,Selangor,42,21,21,India
5783,4/1/2020,IND,Terengganu,0,0,0,India
5784,4/1/2020,IND,W.P. Labuan,0,0,0,India
5785,4/1/2020,IOT,Pulau Pinang,0,0,0,British Indian Ocean Territory
5786,4/1/2020,IOT,Selangor,0,0,0,British Indian Ocean Territory
5787,4/1/2020,IRL,Johor,0,0,0,Ireland
5788,4/1/2020,IRL,Kedah,0,0,0,Ireland
5789,4/1/2020,IRL,Kelantan,0,0,0,Ireland
5790,4/1/2020,IRL,Negeri Sembilan,0,0,0,Ireland
5791,4/1/2020,IRL,Pahang,0,0,0,Ireland
5792,4/1/2020,IRL,Perak,0,0,0,Ireland
5793,4/1/2020,IRL,Perlis,0,0,0,Ireland
5794,4/1/2020,IRL,Pulau Pinang,0,0,0,Ireland
5795,4/1/2020,IRL,Sabah,0,0,0,Ireland
5796,4/1/2020,IRL,Sarawak,0,0,0,Ireland
5797,4/1/2020,IRL,Selangor,2,2,0,Ireland
5798,4/1/2020,IRL,Terengganu,0,0,0,Ireland
5799,4/1/2020,IRL,W.P. Labuan,0,0,0,Ireland
5800,4/1/2020,IRN,Johor,0,0,0,Iran
5801,4/1/2020,IRN,Kedah,0,0,0,Iran
5802,4/1/2020,IRN,Kelantan,0,0,0,Iran
5803,4/1/2020,IRN,Perak,0,0,0,Iran
5804,4/1/2020,IRN,Perlis,0,0,0,Iran
5805,4/1/2020,IRN,Pulau Pinang,0,0,0,Iran
5806,4/1/2020,IRN,Sabah,0,0,0,Iran
5807,4/1/2020,IRN,Sarawak,0,0,0,Iran
5808,4/1/2020,IRN,Selangor,0,0,0,Iran
5809,4/1/2020,IRN,W.P. Labuan,0,0,0,Iran
5810,4/1/2020,IRQ,Johor,0,0,0,Iraq
5811,4/1/2020,IRQ,Kedah,0,0,0,Iraq
5812,4/1/2020,IRQ,Kelantan,0,0,0,Iraq
5813,4/1/2020,IRQ,Melaka,0,0,0,Iraq
5814,4/1/2020,IRQ,Pahang,0,0,0,Iraq
5815,4/1/2020,IRQ,Perak,0,0,0,Iraq
5816,4/1/2020,IRQ,Perlis,0,0,0,Iraq
5817,4/1/2020,IRQ,Pulau Pinang,0,0,0,Iraq
5818,4/1/2020,IRQ,Sabah,0,0,0,Iraq
5819,4/1/2020,IRQ,Sarawak,0,0,0,Iraq
5820,4/1/2020,IRQ,Selangor,0,0,0,Iraq
5821,4/1/2020,ISL,Johor,0,0,0,Iceland
5822,4/1/2020,ISL,Kedah,0,0,0,Iceland
5823,4/1/2020,ISL,Kelantan,0,0,0,Iceland
5824,4/1/2020,ISL,Perak,0,0,0,Iceland
5825,4/1/2020,ISL,Perlis,0,0,0,Iceland
5826,4/1/2020,ISL,Pulau Pinang,0,0,0,Iceland
5827,4/1/2020,ISL,Sabah,0,0,0,Iceland
5828,4/1/2020,ISL,Sarawak,0,0,0,Iceland
5829,4/1/2020,ISL,Selangor,0,0,0,Iceland
5830,4/1/2020,ISL,W.P. Labuan,0,0,0,Iceland
5831,4/1/2020,ISR,Pulau Pinang,0,0,0,Israel
5832,4/1/2020,ITA,Johor,0,0,0,Italy
5833,4/1/2020,ITA,Kedah,0,0,0,Italy
5834,4/1/2020,ITA,Kelantan,0,0,0,Italy
5835,4/1/2020,ITA,Melaka,0,0,0,Italy
5836,4/1/2020,ITA,Negeri Sembilan,0,0,0,Italy
5837,4/1/2020,ITA,Pahang,0,0,0,Italy
5838,4/1/2020,ITA,Perak,0,0,0,Italy
5839,4/1/2020,ITA,Perlis,0,0,0,Italy
5840,4/1/2020,ITA,Pulau Pinang,0,0,0,Italy
5841,4/1/2020,ITA,Sabah,0,0,0,Italy
5842,4/1/2020,ITA,Sarawak,0,0,0,Italy
5843,4/1/2020,ITA,Selangor,2,2,0,Italy
5844,4/1/2020,ITA,W.P. Labuan,0,0,0,Italy
5845,4/1/2020,JAM,Johor,0,0,0,Jamaica
5846,4/1/2020,JAM,Kedah,0,0,0,Jamaica
5847,4/1/2020,JAM,Perak,0,0,0,Jamaica
5848,4/1/2020,JAM,Pulau Pinang,0,0,0,Jamaica
5849,4/1/2020,JAM,Sabah,0,0,0,Jamaica
5850,4/1/2020,JAM,Sarawak,0,0,0,Jamaica
5851,4/1/2020,JAM,Selangor,0,0,0,Jamaica
5852,4/1/2020,JAM,W.P. Labuan,0,0,0,Jamaica
5853,4/1/2020,JOR,Johor,0,0,0,Jordan
5854,4/1/2020,JOR,Kedah,0,0,0,Jordan
5855,4/1/2020,JOR,Kelantan,0,0,0,Jordan
5856,4/1/2020,JOR,Melaka,0,0,0,Jordan
5857,4/1/2020,JOR,Perlis,0,0,0,Jordan
5858,4/1/2020,JOR,Pulau Pinang,0,0,0,Jordan
5859,4/1/2020,JOR,Sabah,0,0,0,Jordan
5860,4/1/2020,JOR,Sarawak,0,0,0,Jordan
5861,4/1/2020,JOR,Selangor,0,0,0,Jordan
5862,4/1/2020,JOR,W.P. Labuan,0,0,0,Jordan
5863,4/1/2020,JPN,Johor,0,0,0,Japan
5864,4/1/2020,JPN,Kedah,0,0,0,Japan
5865,4/1/2020,JPN,Kelantan,0,0,0,Japan
5866,4/1/2020,JPN,Melaka,0,0,0,Japan
5867,4/1/2020,JPN,Negeri Sembilan,0,0,0,Japan
5868,4/1/2020,JPN,Pahang,0,0,0,Japan
5869,4/1/2020,JPN,Perak,0,0,0,Japan
5870,4/1/2020,JPN,Perlis,0,0,0,Japan
5871,4/1/2020,JPN,Pulau Pinang,0,0,0,Japan
5872,4/1/2020,JPN,Sabah,0,0,0,Japan
5873,4/1/2020,JPN,Sarawak,0,0,0,Japan
5874,4/1/2020,JPN,Selangor,7,6,1,Japan
5875,4/1/2020,JPN,W.P. Labuan,0,0,0,Japan
5876,4/1/2020,KAZ,Johor,0,0,0,Kazakhstan
5877,4/1/2020,KAZ,Kedah,0,0,0,Kazakhstan
5878,4/1/2020,KAZ,Kelantan,0,0,0,Kazakhstan
5879,4/1/2020,KAZ,Melaka,0,0,0,Kazakhstan
5880,4/1/2020,KAZ,Perak,0,0,0,Kazakhstan
5881,4/1/2020,KAZ,Perlis,0,0,0,Kazakhstan
5882,4/1/2020,KAZ,Pulau Pinang,0,0,0,Kazakhstan
5883,4/1/2020,KAZ,Sabah,0,0,0,Kazakhstan
5884,4/1/2020,KAZ,Sarawak,0,0,0,Kazakhstan
5885,4/1/2020,KAZ,Selangor,0,0,0,Kazakhstan
5886,4/1/2020,KAZ,W.P. Labuan,0,0,0,Kazakhstan
5887,4/1/2020,KEN,Johor,0,0,0,Kenya
5888,4/1/2020,KEN,Kedah,0,0,0,Kenya
5889,4/1/2020,KEN,Kelantan,0,0,0,Kenya
5890,4/1/2020,KEN,Perak,0,0,0,Kenya
5891,4/1/2020,KEN,Perlis,0,0,0,Kenya
5892,4/1/2020,KEN,Pulau Pinang,0,0,0,Kenya
5893,4/1/2020,KEN,Sabah,0,0,0,Kenya
5894,4/1/2020,KEN,Sarawak,0,0,0,Kenya
5895,4/1/2020,KEN,Selangor,0,0,0,Kenya
5896,4/1/2020,KGZ,Johor,0,0,0,Kyrgyzstan
5897,4/1/2020,KGZ,Kedah,0,0,0,Kyrgyzstan
5898,4/1/2020,KGZ,Kelantan,0,0,0,Kyrgyzstan
5899,4/1/2020,KGZ,Perak,0,0,0,Kyrgyzstan
5900,4/1/2020,KGZ,Perlis,0,0,0,Kyrgyzstan
5901,4/1/2020,KGZ,Pulau Pinang,0,0,0,Kyrgyzstan
5902,4/1/2020,KGZ,Sabah,0,0,0,Kyrgyzstan
5903,4/1/2020,KGZ,Sarawak,0,0,0,Kyrgyzstan
5904,4/1/2020,KGZ,Selangor,0,0,0,Kyrgyzstan
5905,4/1/2020,KHM,Johor,0,0,0,Cambodia
5906,4/1/2020,KHM,Kedah,1,0,1,Cambodia
5907,4/1/2020,KHM,Kelantan,1,1,0,Cambodia
5908,4/1/2020,KHM,Melaka,0,0,0,Cambodia
5909,4/1/2020,KHM,Negeri Sembilan,0,0,0,Cambodia
5910,4/1/2020,KHM,Pahang,0,0,0,Cambodia
5911,4/1/2020,KHM,Perak,0,0,0,Cambodia
5912,4/1/2020,KHM,Perlis,0,0,0,Cambodia
5913,4/1/2020,KHM,Pulau Pinang,0,0,0,Cambodia
5914,4/1/2020,KHM,Sabah,0,0,0,Cambodia
5915,4/1/2020,KHM,Sarawak,0,0,0,Cambodia
5916,4/1/2020,KHM,Selangor,5,1,4,Cambodia
5917,4/1/2020,KHM,W.P. Labuan,0,0,0,Cambodia
5918,4/1/2020,KIR,Johor,0,0,0,Kiribati
5919,4/1/2020,KIR,Sabah,0,0,0,Kiribati
5920,4/1/2020,KIR,Selangor,0,0,0,Kiribati
5921,4/1/2020,KNA,Johor,0,0,0,Saint Kitts and Nevis
5922,4/1/2020,KNA,Kedah,0,0,0,Saint Kitts and Nevis
5923,4/1/2020,KNA,Perlis,0,0,0,Saint Kitts and Nevis
5924,4/1/2020,KNA,Pulau Pinang,0,0,0,Saint Kitts and Nevis
5925,4/1/2020,KNA,Sabah,0,0,0,Saint Kitts and Nevis
5926,4/1/2020,KNA,Selangor,0,0,0,Saint Kitts and Nevis
5927,4/1/2020,KNA,W.P. Labuan,0,0,0,Saint Kitts and Nevis
5928,4/1/2020,KOR,Johor,1,1,0,"Korea, Republic of (South Korea)"
5929,4/1/2020,KOR,Kedah,0,0,0,"Korea, Republic of (South Korea)"
5930,4/1/2020,KOR,Kelantan,0,0,0,"Korea, Republic of (South Korea)"
5931,4/1/2020,KOR,Melaka,0,0,0,"Korea, Republic of (South Korea)"
5932,4/1/2020,KOR,Negeri Sembilan,0,0,0,"Korea, Republic of (South Korea)"
5933,4/1/2020,KOR,Pahang,0,0,0,"Korea, Republic of (South Korea)"
5934,4/1/2020,KOR,Perak,0,0,0,"Korea, Republic of (South Korea)"
5935,4/1/2020,KOR,Perlis,0,0,0,"Korea, Republic of (South Korea)"
5936,4/1/2020,KOR,Pulau Pinang,0,0,0,"Korea, Republic of (South Korea)"
5937,4/1/2020,KOR,Sabah,0,0,0,"Korea, Republic of (South Korea)"
5938,4/1/2020,KOR,Sarawak,0,0,0,"Korea, Republic of (South Korea)"
5939,4/1/2020,KOR,Selangor,1,1,0,"Korea, Republic of (South Korea)"
5940,4/1/2020,KOR,Terengganu,0,0,0,"Korea, Republic of (South Korea)"
5941,4/1/2020,KOR,W.P. Labuan,0,0,0,"Korea, Republic of (South Korea)"
5942,4/1/2020,KWT,Johor,0,0,0,Kuwait
5943,4/1/2020,KWT,Kedah,0,0,0,Kuwait
5944,4/1/2020,KWT,Kelantan,0,0,0,Kuwait
5945,4/1/2020,KWT,Perak,0,0,0,Kuwait
5946,4/1/2020,KWT,Perlis,0,0,0,Kuwait
5947,4/1/2020,KWT,Pulau Pinang,0,0,0,Kuwait
5948,4/1/2020,KWT,Sabah,0,0,0,Kuwait
5949,4/1/2020,KWT,Sarawak,0,0,0,Kuwait
5950,4/1/2020,KWT,Selangor,0,0,0,Kuwait
5951,4/1/2020,KWT,W.P. Labuan,0,0,0,Kuwait
5952,4/1/2020,LAO,Johor,0,0,0,Lao People's Democratic Republic
5953,4/1/2020,LAO,Kedah,1,0,1,Lao People's Democratic Republic
5954,4/1/2020,LAO,Kelantan,0,0,0,Lao People's Democratic Republic
5955,4/1/2020,LAO,Melaka,0,0,0,Lao People's Democratic Republic
5956,4/1/2020,LAO,Perak,0,0,0,Lao People's Democratic Republic
5957,4/1/2020,LAO,Perlis,0,0,0,Lao People's Democratic Republic
5958,4/1/2020,LAO,Pulau Pinang,0,0,0,Lao People's Democratic Republic
5959,4/1/2020,LAO,Sabah,0,0,0,Lao People's Democratic Republic
5960,4/1/2020,LAO,Sarawak,0,0,0,Lao People's Democratic Republic
5961,4/1/2020,LAO,Selangor,1,0,1,Lao People's Democratic Republic
5962,4/1/2020,LAO,W.P. Labuan,0,0,0,Lao People's Democratic Republic
5963,4/1/2020,LBN,Johor,0,0,0,Lebanon
5964,4/1/2020,LBN,Kedah,0,0,0,Lebanon
5965,4/1/2020,LBN,Kelantan,0,0,0,Lebanon
5966,4/1/2020,LBN,Pahang,0,0,0,Lebanon
5967,4/1/2020,LBN,Perak,0,0,0,Lebanon
5968,4/1/2020,LBN,Perlis,0,0,0,Lebanon
5969,4/1/2020,LBN,Pulau Pinang,0,0,0,Lebanon
5970,4/1/2020,LBN,Sabah,0,0,0,Lebanon
5971,4/1/2020,LBN,Sarawak,0,0,0,Lebanon
5972,4/1/2020,LBN,Selangor,0,0,0,Lebanon
5973,4/1/2020,LBN,W.P. Labuan,0,0,0,Lebanon
5974,4/1/2020,LBR,Johor,0,0,0,Liberia
5975,4/1/2020,LBR,Kedah,0,0,0,Liberia
5976,4/1/2020,LBR,Sabah,0,0,0,Liberia
5977,4/1/2020,LBR,Sarawak,0,0,0,Liberia
5978,4/1/2020,LBR,Selangor,0,0,0,Liberia
5979,4/1/2020,LBY,Johor,0,0,0,Libyan Arab Jamahiriya
5980,4/1/2020,LBY,Kedah,0,0,0,Libyan Arab Jamahiriya
5981,4/1/2020,LBY,Perlis,0,0,0,Libyan Arab Jamahiriya
5982,4/1/2020,LBY,Pulau Pinang,0,0,0,Libyan Arab Jamahiriya
5983,4/1/2020,LBY,Sabah,0,0,0,Libyan Arab Jamahiriya
5984,4/1/2020,LBY,Sarawak,0,0,0,Libyan Arab Jamahiriya
5985,4/1/2020,LBY,Selangor,0,0,0,Libyan Arab Jamahiriya
5986,4/1/2020,LCA,Johor,0,0,0,Saint Lucia
5987,4/1/2020,LCA,Kedah,0,0,0,Saint Lucia
5988,4/1/2020,LCA,Pulau Pinang,0,0,0,Saint Lucia
5989,4/1/2020,LCA,Sarawak,0,0,0,Saint Lucia
5990,4/1/2020,LCA,Selangor,0,0,0,Saint Lucia
5991,4/1/2020,LIE,Johor,0,0,0,Liechtenstein
5992,4/1/2020,LIE,Kedah,0,0,0,Liechtenstein
5993,4/1/2020,LIE,Perlis,0,0,0,Liechtenstein
5994,4/1/2020,LIE,Pulau Pinang,0,0,0,Liechtenstein
5995,4/1/2020,LIE,Sabah,0,0,0,Liechtenstein
5996,4/1/2020,LIE,Sarawak,0,0,0,Liechtenstein
5997,4/1/2020,LIE,Selangor,0,0,0,Liechtenstein
5998,4/1/2020,LKA,Johor,1,1,0,Sri Lanka
5999,4/1/2020,LKA,Kedah,0,0,0,Sri Lanka
6000,4/1/2020,LKA,Kelantan,0,0,0,Sri Lanka
6001,4/1/2020,LKA,Melaka,0,0,0,Sri Lanka
6002,4/1/2020,LKA,Pahang,0,0,0,Sri Lanka
6003,4/1/2020,LKA,Perak,0,0,0,Sri Lanka
6004,4/1/2020,LKA,Perlis,0,0,0,Sri Lanka
6005,4/1/2020,LKA,Pulau Pinang,0,0,0,Sri Lanka
6006,4/1/2020,LKA,Sabah,0,0,0,Sri Lanka
6007,4/1/2020,LKA,Sarawak,0,0,0,Sri Lanka
6008,4/1/2020,LKA,Selangor,4,3,1,Sri Lanka
6009,4/1/2020,LKA,W.P. Labuan,0,0,0,Sri Lanka
6010,4/1/2020,LSO,Johor,0,0,0,Lesotho
6011,4/1/2020,LSO,Kedah,0,0,0,Lesotho
6012,4/1/2020,LSO,Pulau Pinang,0,0,0,Lesotho
6013,4/1/2020,LSO,Sarawak,0,0,0,Lesotho
6014,4/1/2020,LSO,Selangor,0,0,0,Lesotho
6015,4/1/2020,LTU,Johor,0,0,0,Lithuania
6016,4/1/2020,LTU,Kedah,0,0,0,Lithuania
6017,4/1/2020,LTU,Kelantan,0,0,0,Lithuania
6018,4/1/2020,LTU,Pahang,0,0,0,Lithuania
6019,4/1/2020,LTU,Perak,0,0,0,Lithuania
6020,4/1/2020,LTU,Perlis,0,0,0,Lithuania
6021,4/1/2020,LTU,Pulau Pinang,0,0,0,Lithuania
6022,4/1/2020,LTU,Sabah,0,0,0,Lithuania
6023,4/1/2020,LTU,Sarawak,0,0,0,Lithuania
6024,4/1/2020,LTU,Selangor,0,0,0,Lithuania
6025,4/1/2020,LTU,W.P. Labuan,0,0,0,Lithuania
6026,4/1/2020,LUX,Johor,0,0,0,Luxembourg
6027,4/1/2020,LUX,Kedah,0,0,0,Luxembourg
6028,4/1/2020,LUX,Kelantan,0,0,0,Luxembourg
6029,4/1/2020,LUX,Perak,0,0,0,Luxembourg
6030,4/1/2020,LUX,Perlis,0,0,0,Luxembourg
6031,4/1/2020,LUX,Pulau Pinang,0,0,0,Luxembourg
6032,4/1/2020,LUX,Sabah,0,0,0,Luxembourg
6033,4/1/2020,LUX,Sarawak,0,0,0,Luxembourg
6034,4/1/2020,LUX,Selangor,0,0,0,Luxembourg
6035,4/1/2020,LVA,Johor,0,0,0,Latvia
6036,4/1/2020,LVA,Kedah,0,0,0,Latvia
6037,4/1/2020,LVA,Kelantan,0,0,0,Latvia
6038,4/1/2020,LVA,Pahang,0,0,0,Latvia
6039,4/1/2020,LVA,Perak,0,0,0,Latvia
6040,4/1/2020,LVA,Perlis,0,0,0,Latvia
6041,4/1/2020,LVA,Pulau Pinang,0,0,0,Latvia
6042,4/1/2020,LVA,Sabah,0,0,0,Latvia
6043,4/1/2020,LVA,Sarawak,0,0,0,Latvia
6044,4/1/2020,LVA,Selangor,0,0,0,Latvia
6045,4/1/2020,LVA,W.P. Labuan,0,0,0,Latvia
6046,4/1/2020,MAC,Johor,0,0,0,Macao
6047,4/1/2020,MAC,Pahang,0,0,0,Macao
6048,4/1/2020,MAC,Perak,0,0,0,Macao
6049,4/1/2020,MAC,Selangor,0,0,0,Macao
6050,4/1/2020,MAC,W.P. Labuan,0,0,0,Macao
6051,4/1/2020,MAR,Johor,0,0,0,Morocco
6052,4/1/2020,MAR,Kedah,0,0,0,Morocco
6053,4/1/2020,MAR,Kelantan,0,0,0,Morocco
6054,4/1/2020,MAR,Melaka,0,0,0,Morocco
6055,4/1/2020,MAR,Pahang,0,0,0,Morocco
6056,4/1/2020,MAR,Perak,0,0,0,Morocco
6057,4/1/2020,MAR,Perlis,0,0,0,Morocco
6058,4/1/2020,MAR,Pulau Pinang,0,0,0,Morocco
6059,4/1/2020,MAR,Sabah,0,0,0,Morocco
6060,4/1/2020,MAR,Sarawak,0,0,0,Morocco
6061,4/1/2020,MAR,Selangor,1,0,1,Morocco
6062,4/1/2020,MAR,W.P. Labuan,0,0,0,Morocco
6063,4/1/2020,MCO,Johor,0,0,0,Monaco
6064,4/1/2020,MCO,Kedah,0,0,0,Monaco
6065,4/1/2020,MCO,Sabah,0,0,0,Monaco
6066,4/1/2020,MCO,Selangor,0,0,0,Monaco
6067,4/1/2020,MDA,Johor,0,0,0,"Moldova, Republic of"
6068,4/1/2020,MDA,Kedah,0,0,0,"Moldova, Republic of"
6069,4/1/2020,MDA,Kelantan,0,0,0,"Moldova, Republic of"
6070,4/1/2020,MDA,Negeri Sembilan,0,0,0,"Moldova, Republic of"
6071,4/1/2020,MDA,Perlis,0,0,0,"Moldova, Republic of"
6072,4/1/2020,MDA,Pulau Pinang,0,0,0,"Moldova, Republic of"
6073,4/1/2020,MDA,Sabah,0,0,0,"Moldova, Republic of"
6074,4/1/2020,MDA,Sarawak,0,0,0,"Moldova, Republic of"
6075,4/1/2020,MDA,Selangor,0,0,0,"Moldova, Republic of"
6076,4/1/2020,MDG,Johor,0,0,0,Madagascar
6077,4/1/2020,MDG,Kedah,0,0,0,Madagascar
6078,4/1/2020,MDG,Perak,0,0,0,Madagascar
6079,4/1/2020,MDG,Perlis,0,0,0,Madagascar
6080,4/1/2020,MDG,Pulau Pinang,0,0,0,Madagascar
6081,4/1/2020,MDG,Sabah,0,0,0,Madagascar
6082,4/1/2020,MDG,Sarawak,0,0,0,Madagascar
6083,4/1/2020,MDG,Selangor,0,0,0,Madagascar
6084,4/1/2020,MDV,Johor,0,0,0,Maldives
6085,4/1/2020,MDV,Kedah,0,0,0,Maldives
6086,4/1/2020,MDV,Kelantan,0,0,0,Maldives
6087,4/1/2020,MDV,Perak,0,0,0,Maldives
6088,4/1/2020,MDV,Perlis,0,0,0,Maldives
6089,4/1/2020,MDV,Pulau Pinang,0,0,0,Maldives
6090,4/1/2020,MDV,Sabah,0,0,0,Maldives
6091,4/1/2020,MDV,Sarawak,0,0,0,Maldives
6092,4/1/2020,MDV,Selangor,0,0,0,Maldives
6093,4/1/2020,MEX,Johor,0,0,0,Mexico
6094,4/1/2020,MEX,Kedah,0,0,0,Mexico
6095,4/1/2020,MEX,Kelantan,0,0,0,Mexico
6096,4/1/2020,MEX,Pahang,0,0,0,Mexico
6097,4/1/2020,MEX,Perak,0,0,0,Mexico
6098,4/1/2020,MEX,Perlis,0,0,0,Mexico
6099,4/1/2020,MEX,Pulau Pinang,0,0,0,Mexico
6100,4/1/2020,MEX,Sabah,0,0,0,Mexico
6101,4/1/2020,MEX,Sarawak,0,0,0,Mexico
6102,4/1/2020,MEX,Selangor,0,0,0,Mexico
6103,4/1/2020,MEX,W.P. Labuan,0,0,0,Mexico
6104,4/1/2020,MHL,Johor,0,0,0,Marshall Islands
6105,4/1/2020,MHL,Kedah,0,0,0,Marshall Islands
6106,4/1/2020,MHL,Perak,0,0,0,Marshall Islands
6107,4/1/2020,MHL,Pulau Pinang,0,0,0,Marshall Islands
6108,4/1/2020,MHL,Sabah,0,0,0,Marshall Islands
6109,4/1/2020,MHL,Selangor,0,0,0,Marshall Islands
6110,4/1/2020,MKD,Johor,0,0,0,"Macedonia, the former Yugoslav Republic of"
6111,4/1/2020,MKD,Kedah,0,0,0,"Macedonia, the former Yugoslav Republic of"
6112,4/1/2020,MKD,Perak,0,0,0,"Macedonia, the former Yugoslav Republic of"
6113,4/1/2020,MKD,Pulau Pinang,0,0,0,"Macedonia, the former Yugoslav Republic of"
6114,4/1/2020,MKD,Sabah,0,0,0,"Macedonia, the former Yugoslav Republic of"
6115,4/1/2020,MKD,Sarawak,0,0,0,"Macedonia, the former Yugoslav Republic of"
6116,4/1/2020,MKD,Selangor,0,0,0,"Macedonia, the former Yugoslav Republic of"
6117,4/1/2020,MLI,Johor,0,0,0,Mali
6118,4/1/2020,MLI,Sabah,0,0,0,Mali
6119,4/1/2020,MLI,Selangor,0,0,0,Mali
6120,4/1/2020,MLT,Johor,0,0,0,Malta
6121,4/1/2020,MLT,Kedah,0,0,0,Malta
6122,4/1/2020,MLT,Kelantan,0,0,0,Malta
6123,4/1/2020,MLT,Perak,0,0,0,Malta
6124,4/1/2020,MLT,Perlis,0,0,0,Malta
6125,4/1/2020,MLT,Pulau Pinang,0,0,0,Malta
6126,4/1/2020,MLT,Sabah,0,0,0,Malta
6127,4/1/2020,MLT,Sarawak,0,0,0,Malta
6128,4/1/2020,MLT,Selangor,0,0,0,Malta
6129,4/1/2020,MLT,W.P. Labuan,0,0,0,Malta
6130,4/1/2020,MMR,Johor,10,10,0,Myanmar
6131,4/1/2020,MMR,Kedah,0,0,0,Myanmar
6132,4/1/2020,MMR,Kelantan,0,0,0,Myanmar
6133,4/1/2020,MMR,Negeri Sembilan,0,0,0,Myanmar
6134,4/1/2020,MMR,Pahang,0,0,0,Myanmar
6135,4/1/2020,MMR,Perak,0,0,0,Myanmar
6136,4/1/2020,MMR,Perlis,0,0,0,Myanmar
6137,4/1/2020,MMR,Pulau Pinang,0,0,0,Myanmar
6138,4/1/2020,MMR,Sabah,0,0,0,Myanmar
6139,4/1/2020,MMR,Sarawak,0,0,0,Myanmar
6140,4/1/2020,MMR,Selangor,6,1,5,Myanmar
6141,4/1/2020,MMR,Terengganu,0,0,0,Myanmar
6142,4/1/2020,MMR,W.P. Labuan,0,0,0,Myanmar
6143,4/1/2020,MNE,Johor,0,0,0,Montenegro
6144,4/1/2020,MNE,Kedah,0,0,0,Montenegro
6145,4/1/2020,MNE,Pulau Pinang,0,0,0,Montenegro
6146,4/1/2020,MNE,Sabah,0,0,0,Montenegro
6147,4/1/2020,MNE,Sarawak,0,0,0,Montenegro
6148,4/1/2020,MNE,Selangor,0,0,0,Montenegro
6149,4/1/2020,MNG,Johor,0,0,0,Mongolia
6150,4/1/2020,MNG,Kedah,0,0,0,Mongolia
6151,4/1/2020,MNG,Kelantan,0,0,0,Mongolia
6152,4/1/2020,MNG,Perak,0,0,0,Mongolia
6153,4/1/2020,MNG,Perlis,0,0,0,Mongolia
6154,4/1/2020,MNG,Pulau Pinang,0,0,0,Mongolia
6155,4/1/2020,MNG,Sabah,0,0,0,Mongolia
6156,4/1/2020,MNG,Sarawak,0,0,0,Mongolia
6157,4/1/2020,MNG,Selangor,0,0,0,Mongolia
6158,4/1/2020,MNP,Selangor,0,0,0,Northern Mariana Islands
6159,4/1/2020,MOZ,Johor,0,0,0,Mozambique
6160,4/1/2020,MOZ,Kedah,0,0,0,Mozambique
6161,4/1/2020,MOZ,Perak,0,0,0,Mozambique
6162,4/1/2020,MOZ,Pulau Pinang,0,0,0,Mozambique
6163,4/1/2020,MOZ,Sabah,0,0,0,Mozambique
6164,4/1/2020,MOZ,Sarawak,0,0,0,Mozambique
6165,4/1/2020,MOZ,Selangor,0,0,0,Mozambique
6166,4/1/2020,MRT,Johor,0,0,0,Mauritania
6167,4/1/2020,MRT,Kedah,0,0,0,Mauritania
6168,4/1/2020,MRT,Pulau Pinang,0,0,0,Mauritania
6169,4/1/2020,MRT,Sabah,0,0,0,Mauritania
6170,4/1/2020,MRT,Sarawak,0,0,0,Mauritania
6171,4/1/2020,MRT,Selangor,1,1,0,Mauritania
6172,4/1/2020,MUS,Johor,0,0,0,Mauritius
6173,4/1/2020,MUS,Kedah,0,0,0,Mauritius
6174,4/1/2020,MUS,Kelantan,0,0,0,Mauritius
6175,4/1/2020,MUS,Pahang,0,0,0,Mauritius
6176,4/1/2020,MUS,Perak,0,0,0,Mauritius
6177,4/1/2020,MUS,Perlis,0,0,0,Mauritius
6178,4/1/2020,MUS,Pulau Pinang,0,0,0,Mauritius
6179,4/1/2020,MUS,Sabah,0,0,0,Mauritius
6180,4/1/2020,MUS,Sarawak,0,0,0,Mauritius
6181,4/1/2020,MUS,Selangor,0,0,0,Mauritius
6182,4/1/2020,MWI,Johor,0,0,0,Malawi
6183,4/1/2020,MWI,Pulau Pinang,0,0,0,Malawi
6184,4/1/2020,MWI,Sabah,0,0,0,Malawi
6185,4/1/2020,MWI,Sarawak,0,0,0,Malawi
6186,4/1/2020,MWI,Selangor,0,0,0,Malawi
6187,4/1/2020,MYT,Selangor,0,0,0,Mayotte
6188,4/1/2020,NAM,Johor,0,0,0,Namibia
6189,4/1/2020,NAM,Kedah,0,0,0,Namibia
6190,4/1/2020,NAM,Perak,0,0,0,Namibia
6191,4/1/2020,NAM,Perlis,0,0,0,Namibia
6192,4/1/2020,NAM,Pulau Pinang,0,0,0,Namibia
6193,4/1/2020,NAM,Sabah,0,0,0,Namibia
6194,4/1/2020,NAM,Sarawak,0,0,0,Namibia
6195,4/1/2020,NAM,Selangor,0,0,0,Namibia
6196,4/1/2020,NCL,Selangor,0,0,0,New Caledonia
6197,4/1/2020,NER,Johor,0,0,0,Niger
6198,4/1/2020,NER,Sabah,0,0,0,Niger
6199,4/1/2020,NER,Selangor,0,0,0,Niger
6200,4/1/2020,NGA,Johor,0,0,0,Nigeria
6201,4/1/2020,NGA,Kedah,0,0,0,Nigeria
6202,4/1/2020,NGA,Perlis,0,0,0,Nigeria
6203,4/1/2020,NGA,Pulau Pinang,0,0,0,Nigeria
6204,4/1/2020,NGA,Sabah,0,0,0,Nigeria
6205,4/1/2020,NGA,Sarawak,0,0,0,Nigeria
6206,4/1/2020,NGA,Selangor,2,2,0,Nigeria
6207,4/1/2020,NIC,Johor,0,0,0,Nicaragua
6208,4/1/2020,NIC,Kedah,0,0,0,Nicaragua
6209,4/1/2020,NIC,Pulau Pinang,0,0,0,Nicaragua
6210,4/1/2020,NIC,Sabah,0,0,0,Nicaragua
6211,4/1/2020,NIC,Selangor,0,0,0,Nicaragua
6212,4/1/2020,NLD,Johor,0,0,0,Netherlands
6213,4/1/2020,NLD,Kedah,0,0,0,Netherlands
6214,4/1/2020,NLD,Kelantan,0,0,0,Netherlands
6215,4/1/2020,NLD,Melaka,0,0,0,Netherlands
6216,4/1/2020,NLD,Negeri Sembilan,0,0,0,Netherlands
6217,4/1/2020,NLD,Pahang,0,0,0,Netherlands
6218,4/1/2020,NLD,Perak,0,0,0,Netherlands
6219,4/1/2020,NLD,Perlis,0,0,0,Netherlands
6220,4/1/2020,NLD,Pulau Pinang,1,1,0,Netherlands
6221,4/1/2020,NLD,Sabah,0,0,0,Netherlands
6222,4/1/2020,NLD,Sarawak,0,0,0,Netherlands
6223,4/1/2020,NLD,Selangor,31,14,17,Netherlands
6224,4/1/2020,NLD,Terengganu,0,0,0,Netherlands
6225,4/1/2020,NLD,W.P. Labuan,0,0,0,Netherlands
6226,4/1/2020,NOR,Johor,0,0,0,Norway
6227,4/1/2020,NOR,Kedah,0,0,0,Norway
6228,4/1/2020,NOR,Kelantan,0,0,0,Norway
6229,4/1/2020,NOR,Melaka,0,0,0,Norway
6230,4/1/2020,NOR,Pahang,0,0,0,Norway
6231,4/1/2020,NOR,Perak,0,0,0,Norway
6232,4/1/2020,NOR,Perlis,0,0,0,Norway
6233,4/1/2020,NOR,Pulau Pinang,0,0,0,Norway
6234,4/1/2020,NOR,Sabah,0,0,0,Norway
6235,4/1/2020,NOR,Sarawak,0,0,0,Norway
6236,4/1/2020,NOR,Selangor,0,0,0,Norway
6237,4/1/2020,NOR,W.P. Labuan,0,0,0,Norway
6238,4/1/2020,NPL,Johor,0,0,0,Nepal
6239,4/1/2020,NPL,Kedah,0,0,0,Nepal
6240,4/1/2020,NPL,Pahang,0,0,0,Nepal
6241,4/1/2020,NPL,Perak,0,0,0,Nepal
6242,4/1/2020,NPL,Perlis,0,0,0,Nepal
6243,4/1/2020,NPL,Pulau Pinang,0,0,0,Nepal
6244,4/1/2020,NPL,Sabah,0,0,0,Nepal
6245,4/1/2020,NPL,Sarawak,0,0,0,Nepal
6246,4/1/2020,NPL,Selangor,0,0,0,Nepal
6247,4/1/2020,NPL,W.P. Labuan,0,0,0,Nepal
6248,4/1/2020,NRU,Johor,0,0,0,Nauru
6249,4/1/2020,NRU,Pulau Pinang,0,0,0,Nauru
6250,4/1/2020,NRU,Selangor,0,0,0,Nauru
6251,4/1/2020,NZL,Johor,0,0,0,New Zealand
6252,4/1/2020,NZL,Kedah,0,0,0,New Zealand
6253,4/1/2020,NZL,Kelantan,0,0,0,New Zealand
6254,4/1/2020,NZL,Melaka,0,0,0,New Zealand
6255,4/1/2020,NZL,Negeri Sembilan,0,0,0,New Zealand
6256,4/1/2020,NZL,Pahang,0,0,0,New Zealand
6257,4/1/2020,NZL,Perak,0,0,0,New Zealand
6258,4/1/2020,NZL,Perlis,0,0,0,New Zealand
6259,4/1/2020,NZL,Pulau Pinang,0,0,0,New Zealand
6260,4/1/2020,NZL,Sabah,0,0,0,New Zealand
6261,4/1/2020,NZL,Sarawak,0,0,0,New Zealand
6262,4/1/2020,NZL,Selangor,2,1,1,New Zealand
6263,4/1/2020,NZL,Terengganu,0,0,0,New Zealand
6264,4/1/2020,NZL,W.P. Labuan,0,0,0,New Zealand
6265,4/1/2020,OMN,Johor,0,0,0,Oman
6266,4/1/2020,OMN,Kedah,0,0,0,Oman
6267,4/1/2020,OMN,Kelantan,0,0,0,Oman
6268,4/1/2020,OMN,Melaka,0,0,0,Oman
6269,4/1/2020,OMN,Perak,0,0,0,Oman
6270,4/1/2020,OMN,Perlis,0,0,0,Oman
6271,4/1/2020,OMN,Pulau Pinang,0,0,0,Oman
6272,4/1/2020,OMN,Sabah,0,0,0,Oman
6273,4/1/2020,OMN,Sarawak,0,0,0,Oman
6274,4/1/2020,OMN,Selangor,0,0,0,Oman
6275,4/1/2020,PAK,Johor,0,0,0,Pakistan
6276,4/1/2020,PAK,Kedah,0,0,0,Pakistan
6277,4/1/2020,PAK,Kelantan,0,0,0,Pakistan
6278,4/1/2020,PAK,Melaka,0,0,0,Pakistan
6279,4/1/2020,PAK,Negeri Sembilan,0,0,0,Pakistan
6280,4/1/2020,PAK,Pahang,0,0,0,Pakistan
6281,4/1/2020,PAK,Perak,0,0,0,Pakistan
6282,4/1/2020,PAK,Perlis,0,0,0,Pakistan
6283,4/1/2020,PAK,Pulau Pinang,0,0,0,Pakistan
6284,4/1/2020,PAK,Sabah,0,0,0,Pakistan
6285,4/1/2020,PAK,Sarawak,0,0,0,Pakistan
6286,4/1/2020,PAK,Selangor,31,29,2,Pakistan
6287,4/1/2020,PAK,W.P. Labuan,0,0,0,Pakistan
6288,4/1/2020,PAN,Johor,0,0,0,Panama
6289,4/1/2020,PAN,Kedah,0,0,0,Panama
6290,4/1/2020,PAN,Perak,0,0,0,Panama
6291,4/1/2020,PAN,Perlis,0,0,0,Panama
6292,4/1/2020,PAN,Pulau Pinang,0,0,0,Panama
6293,4/1/2020,PAN,Sabah,0,0,0,Panama
6294,4/1/2020,PAN,Sarawak,0,0,0,Panama
6295,4/1/2020,PAN,Selangor,0,0,0,Panama
6296,4/1/2020,PER,Johor,0,0,0,Peru
6297,4/1/2020,PER,Kedah,0,0,0,Peru
6298,4/1/2020,PER,Kelantan,0,0,0,Peru
6299,4/1/2020,PER,Pahang,0,0,0,Peru
6300,4/1/2020,PER,Perak,0,0,0,Peru
6301,4/1/2020,PER,Perlis,0,0,0,Peru
6302,4/1/2020,PER,Pulau Pinang,0,0,0,Peru
6303,4/1/2020,PER,Sabah,0,0,0,Peru
6304,4/1/2020,PER,Sarawak,0,0,0,Peru
6305,4/1/2020,PER,Selangor,0,0,0,Peru
6306,4/1/2020,PER,W.P. Labuan,0,0,0,Peru
6307,4/1/2020,PHL,Johor,3,2,1,Philippines
6308,4/1/2020,PHL,Kedah,0,0,0,Philippines
6309,4/1/2020,PHL,Kelantan,0,0,0,Philippines
6310,4/1/2020,PHL,Melaka,0,0,0,Philippines
6311,4/1/2020,PHL,Negeri Sembilan,0,0,0,Philippines
6312,4/1/2020,PHL,Pahang,0,0,0,Philippines
6313,4/1/2020,PHL,Perak,0,0,0,Philippines
6314,4/1/2020,PHL,Perlis,0,0,0,Philippines
6315,4/1/2020,PHL,Pulau Pinang,0,0,0,Philippines
6316,4/1/2020,PHL,Sabah,0,0,0,Philippines
6317,4/1/2020,PHL,Sarawak,9,9,0,Philippines
6318,4/1/2020,PHL,Selangor,4,1,3,Philippines
6319,4/1/2020,PHL,Terengganu,0,0,0,Philippines
6320,4/1/2020,PHL,W.P. Labuan,0,0,0,Philippines
6321,4/1/2020,PLW,Johor,0,0,0,Palau
6322,4/1/2020,PLW,Pulau Pinang,0,0,0,Palau
6323,4/1/2020,PLW,Selangor,0,0,0,Palau
6324,4/1/2020,PNG,Johor,0,0,0,Papua New Guinea
6325,4/1/2020,PNG,Kedah,0,0,0,Papua New Guinea
6326,4/1/2020,PNG,Kelantan,0,0,0,Papua New Guinea
6327,4/1/2020,PNG,Perak,0,0,0,Papua New Guinea
6328,4/1/2020,PNG,Pulau Pinang,0,0,0,Papua New Guinea
6329,4/1/2020,PNG,Sabah,0,0,0,Papua New Guinea
6330,4/1/2020,PNG,Sarawak,0,0,0,Papua New Guinea
6331,4/1/2020,PNG,Selangor,0,0,0,Papua New Guinea
6332,4/1/2020,POL,Johor,0,0,0,Poland
6333,4/1/2020,POL,Kedah,0,0,0,Poland
6334,4/1/2020,POL,Kelantan,0,0,0,Poland
6335,4/1/2020,POL,Melaka,0,0,0,Poland
6336,4/1/2020,POL,Negeri Sembilan,0,0,0,Poland
6337,4/1/2020,POL,Pahang,0,0,0,Poland
6338,4/1/2020,POL,Perak,0,0,0,Poland
6339,4/1/2020,POL,Perlis,0,0,0,Poland
6340,4/1/2020,POL,Pulau Pinang,0,0,0,Poland
6341,4/1/2020,POL,Sabah,0,0,0,Poland
6342,4/1/2020,POL,Sarawak,0,0,0,Poland
6343,4/1/2020,POL,Selangor,0,0,0,Poland
6344,4/1/2020,POL,Terengganu,0,0,0,Poland
6345,4/1/2020,POL,W.P. Labuan,0,0,0,Poland
6346,4/1/2020,PRK,Selangor,0,0,0,"Korea, Democratic People's Republic of"
6347,4/1/2020,PRT,Johor,0,0,0,Portugal
6348,4/1/2020,PRT,Kedah,0,0,0,Portugal
6349,4/1/2020,PRT,Kelantan,0,0,0,Portugal
6350,4/1/2020,PRT,Melaka,0,0,0,Portugal
6351,4/1/2020,PRT,Pahang,0,0,0,Portugal
6352,4/1/2020,PRT,Perak,0,0,0,Portugal
6353,4/1/2020,PRT,Perlis,0,0,0,Portugal
6354,4/1/2020,PRT,Pulau Pinang,0,0,0,Portugal
6355,4/1/2020,PRT,Sabah,0,0,0,Portugal
6356,4/1/2020,PRT,Sarawak,0,0,0,Portugal
6357,4/1/2020,PRT,Selangor,0,0,0,Portugal
6358,4/1/2020,PRT,W.P. Labuan,0,0,0,Portugal
6359,4/1/2020,PRY,Johor,0,0,0,Paraguay
6360,4/1/2020,PRY,Kedah,0,0,0,Paraguay
6361,4/1/2020,PRY,Perak,0,0,0,Paraguay
6362,4/1/2020,PRY,Perlis,0,0,0,Paraguay
6363,4/1/2020,PRY,Pulau Pinang,0,0,0,Paraguay
6364,4/1/2020,PRY,Sabah,0,0,0,Paraguay
6365,4/1/2020,PRY,Sarawak,0,0,0,Paraguay
6366,4/1/2020,PRY,Selangor,0,0,0,Paraguay
6367,4/1/2020,PSE,Johor,0,0,0,"Palestinian Territory, Occupied"
6368,4/1/2020,PSE,Kedah,0,0,0,"Palestinian Territory, Occupied"
6369,4/1/2020,PSE,Kelantan,0,0,0,"Palestinian Territory, Occupied"
6370,4/1/2020,PSE,Melaka,0,0,0,"Palestinian Territory, Occupied"
6371,4/1/2020,PSE,Perak,0,0,0,"Palestinian Territory, Occupied"
6372,4/1/2020,PSE,Perlis,0,0,0,"Palestinian Territory, Occupied"
6373,4/1/2020,PSE,Pulau Pinang,0,0,0,"Palestinian Territory, Occupied"
6374,4/1/2020,PSE,Sabah,0,0,0,"Palestinian Territory, Occupied"
6375,4/1/2020,PSE,Sarawak,0,0,0,"Palestinian Territory, Occupied"
6376,4/1/2020,PSE,Selangor,0,0,0,"Palestinian Territory, Occupied"
6377,4/1/2020,QAT,Johor,0,0,0,Qatar
6378,4/1/2020,QAT,Kedah,0,0,0,Qatar
6379,4/1/2020,QAT,Perlis,0,0,0,Qatar
6380,4/1/2020,QAT,Pulau Pinang,0,0,0,Qatar
6381,4/1/2020,QAT,Sabah,0,0,0,Qatar
6382,4/1/2020,QAT,Sarawak,0,0,0,Qatar
6383,4/1/2020,QAT,Selangor,0,0,0,Qatar
6384,4/1/2020,REU,Johor,0,0,0,Reunion
6385,4/1/2020,REU,Sarawak,0,0,0,Reunion
6386,4/1/2020,ROU,Johor,0,0,0,Romania
6387,4/1/2020,ROU,Kedah,0,0,0,Romania
6388,4/1/2020,ROU,Kelantan,0,0,0,Romania
6389,4/1/2020,ROU,Negeri Sembilan,0,0,0,Romania
6390,4/1/2020,ROU,Pahang,0,0,0,Romania
6391,4/1/2020,ROU,Perak,0,0,0,Romania
6392,4/1/2020,ROU,Perlis,0,0,0,Romania
6393,4/1/2020,ROU,Pulau Pinang,0,0,0,Romania
6394,4/1/2020,ROU,Sabah,0,0,0,Romania
6395,4/1/2020,ROU,Sarawak,0,0,0,Romania
6396,4/1/2020,ROU,Selangor,3,1,2,Romania
6397,4/1/2020,ROU,W.P. Labuan,0,0,0,Romania
6398,4/1/2020,RUS,Johor,1,1,0,Russia
6399,4/1/2020,RUS,Kedah,0,0,0,Russia
6400,4/1/2020,RUS,Kelantan,0,0,0,Russia
6401,4/1/2020,RUS,Melaka,0,0,0,Russia
6402,4/1/2020,RUS,Negeri Sembilan,0,0,0,Russia
6403,4/1/2020,RUS,Pahang,0,0,0,Russia
6404,4/1/2020,RUS,Perak,0,0,0,Russia
6405,4/1/2020,RUS,Perlis,0,0,0,Russia
6406,4/1/2020,RUS,Pulau Pinang,0,0,0,Russia
6407,4/1/2020,RUS,Sabah,0,0,0,Russia
6408,4/1/2020,RUS,Sarawak,0,0,0,Russia
6409,4/1/2020,RUS,Selangor,1,0,1,Russia
6410,4/1/2020,RUS,W.P. Labuan,0,0,0,Russia
6411,4/1/2020,RWA,Johor,0,0,0,Rwanda
6412,4/1/2020,RWA,Kedah,0,0,0,Rwanda
6413,4/1/2020,RWA,Pulau Pinang,0,0,0,Rwanda
6414,4/1/2020,RWA,Selangor,0,0,0,Rwanda
6415,4/1/2020,SAU,Johor,0,0,0,Saudi Arabia
6416,4/1/2020,SAU,Kedah,0,0,0,Saudi Arabia
6417,4/1/2020,SAU,Kelantan,0,0,0,Saudi Arabia
6418,4/1/2020,SAU,Melaka,0,0,0,Saudi Arabia
6419,4/1/2020,SAU,Perak,0,0,0,Saudi Arabia
6420,4/1/2020,SAU,Perlis,0,0,0,Saudi Arabia
6421,4/1/2020,SAU,Pulau Pinang,0,0,0,Saudi Arabia
6422,4/1/2020,SAU,Sabah,0,0,0,Saudi Arabia
6423,4/1/2020,SAU,Sarawak,0,0,0,Saudi Arabia
6424,4/1/2020,SAU,Selangor,0,0,0,Saudi Arabia
6425,4/1/2020,SAU,W.P. Labuan,0,0,0,Saudi Arabia
6426,4/1/2020,SDN,Johor,0,0,0,Sudan
6427,4/1/2020,SDN,Kedah,0,0,0,Sudan
6428,4/1/2020,SDN,Kelantan,0,0,0,Sudan
6429,4/1/2020,SDN,Perlis,0,0,0,Sudan
6430,4/1/2020,SDN,Pulau Pinang,0,0,0,Sudan
6431,4/1/2020,SDN,Sabah,0,0,0,Sudan
6432,4/1/2020,SDN,Sarawak,0,0,0,Sudan
6433,4/1/2020,SDN,Selangor,0,0,0,Sudan
6434,4/1/2020,SDN,W.P. Labuan,0,0,0,Sudan
6435,4/1/2020,SEN,Johor,0,0,0,Senegal
6436,4/1/2020,SEN,Kedah,0,0,0,Senegal
6437,4/1/2020,SEN,Kelantan,0,0,0,Senegal
6438,4/1/2020,SEN,Perak,0,0,0,Senegal
6439,4/1/2020,SEN,Perlis,0,0,0,Senegal
6440,4/1/2020,SEN,Pulau Pinang,0,0,0,Senegal
6441,4/1/2020,SEN,Sabah,0,0,0,Senegal
6442,4/1/2020,SEN,Sarawak,0,0,0,Senegal
6443,4/1/2020,SEN,Selangor,0,0,0,Senegal
6444,4/1/2020,SGP,Johor,81,67,14,Singapore
6445,4/1/2020,SGP,Kedah,1,1,0,Singapore
6446,4/1/2020,SGP,Kelantan,0,0,0,Singapore
6447,4/1/2020,SGP,Melaka,0,0,0,Singapore
6448,4/1/2020,SGP,Negeri Sembilan,0,0,0,Singapore
6449,4/1/2020,SGP,Pahang,0,0,0,Singapore
6450,4/1/2020,SGP,Perak,0,0,0,Singapore
6451,4/1/2020,SGP,Perlis,0,0,0,Singapore
6452,4/1/2020,SGP,Pulau Pinang,0,0,0,Singapore
6453,4/1/2020,SGP,Sabah,0,0,0,Singapore
6454,4/1/2020,SGP,Sarawak,0,0,0,Singapore
6455,4/1/2020,SGP,Selangor,15,7,8,Singapore
6456,4/1/2020,SGP,Terengganu,0,0,0,Singapore
6457,4/1/2020,SGP,W.P. Labuan,0,0,0,Singapore
6458,4/1/2020,SGS,Johor,0,0,0,South Georgia and the South Sandwich Islands
6459,4/1/2020,SGS,Sabah,0,0,0,South Georgia and the South Sandwich Islands
6460,4/1/2020,SGS,Selangor,0,0,0,South Georgia and the South Sandwich Islands
6461,4/1/2020,SHN,Sarawak,0,0,0,"Saint Helena, Ascension and Tristan da Cunha"
6462,4/1/2020,SLB,Johor,0,0,0,Solomon Islands
6463,4/1/2020,SLB,Perlis,0,0,0,Solomon Islands
6464,4/1/2020,SLB,Pulau Pinang,0,0,0,Solomon Islands
6465,4/1/2020,SLB,Sabah,0,0,0,Solomon Islands
6466,4/1/2020,SLB,Sarawak,0,0,0,Solomon Islands
6467,4/1/2020,SLB,Selangor,0,0,0,Solomon Islands
6468,4/1/2020,SLB,W.P. Labuan,0,0,0,Solomon Islands
6469,4/1/2020,SLE,Johor,0,0,0,Sierra Leone
6470,4/1/2020,SLE,Kedah,0,0,0,Sierra Leone
6471,4/1/2020,SLE,Perak,0,0,0,Sierra Leone
6472,4/1/2020,SLE,Pulau Pinang,0,0,0,Sierra Leone
6473,4/1/2020,SLE,Sabah,0,0,0,Sierra Leone
6474,4/1/2020,SLE,Selangor,0,0,0,Sierra Leone
6475,4/1/2020,SLV,Johor,0,0,0,El Salvador
6476,4/1/2020,SLV,Kedah,0,0,0,El Salvador
6477,4/1/2020,SLV,Perak,0,0,0,El Salvador
6478,4/1/2020,SLV,Perlis,0,0,0,El Salvador
6479,4/1/2020,SLV,Pulau Pinang,0,0,0,El Salvador
6480,4/1/2020,SLV,Sabah,0,0,0,El Salvador
6481,4/1/2020,SLV,Selangor,0,0,0,El Salvador
6482,4/1/2020,SLV,W.P. Labuan,0,0,0,El Salvador
6483,4/1/2020,SMR,Johor,0,0,0,San Marino
6484,4/1/2020,SMR,Selangor,0,0,0,San Marino
6485,4/1/2020,SOM,Johor,0,0,0,Somalia
6486,4/1/2020,SOM,Kedah,0,0,0,Somalia
6487,4/1/2020,SOM,Kelantan,0,0,0,Somalia
6488,4/1/2020,SOM,Perlis,0,0,0,Somalia
6489,4/1/2020,SOM,Sabah,0,0,0,Somalia
6490,4/1/2020,SOM,Sarawak,0,0,0,Somalia
6491,4/1/2020,SOM,Selangor,0,0,0,Somalia
6492,4/1/2020,SRB,Johor,0,0,0,Serbia
6493,4/1/2020,SRB,Kedah,0,0,0,Serbia
6494,4/1/2020,SRB,Kelantan,0,0,0,Serbia
6495,4/1/2020,SRB,Pahang,0,0,0,Serbia
6496,4/1/2020,SRB,Perak,0,0,0,Serbia
6497,4/1/2020,SRB,Perlis,0,0,0,Serbia
6498,4/1/2020,SRB,Pulau Pinang,0,0,0,Serbia
6499,4/1/2020,SRB,Sabah,0,0,0,Serbia
6500,4/1/2020,SRB,Sarawak,0,0,0,Serbia
6501,4/1/2020,SRB,Selangor,0,0,0,Serbia
6502,4/1/2020,STP,Selangor,0,0,0,Sao Tome and Principe
6503,4/1/2020,SUR,Johor,0,0,0,Suriname
6504,4/1/2020,SUR,Kedah,0,0,0,Suriname
6505,4/1/2020,SUR,Kelantan,0,0,0,Suriname
6506,4/1/2020,SUR,Perak,0,0,0,Suriname
6507,4/1/2020,SUR,Perlis,0,0,0,Suriname
6508,4/1/2020,SUR,Pulau Pinang,0,0,0,Suriname
6509,4/1/2020,SUR,Sabah,0,0,0,Suriname
6510,4/1/2020,SUR,Sarawak,0,0,0,Suriname
6511,4/1/2020,SUR,Selangor,0,0,0,Suriname
6512,4/1/2020,SVK,Johor,0,0,0,Slovakia
6513,4/1/2020,SVK,Kedah,0,0,0,Slovakia
6514,4/1/2020,SVK,Kelantan,0,0,0,Slovakia
6515,4/1/2020,SVK,Negeri Sembilan,0,0,0,Slovakia
6516,4/1/2020,SVK,Pahang,0,0,0,Slovakia
6517,4/1/2020,SVK,Perak,0,0,0,Slovakia
6518,4/1/2020,SVK,Perlis,0,0,0,Slovakia
6519,4/1/2020,SVK,Pulau Pinang,0,0,0,Slovakia
6520,4/1/2020,SVK,Sabah,0,0,0,Slovakia
6521,4/1/2020,SVK,Sarawak,0,0,0,Slovakia
6522,4/1/2020,SVK,Selangor,0,0,0,Slovakia
6523,4/1/2020,SVK,W.P. Labuan,0,0,0,Slovakia
6524,4/1/2020,SVN,Johor,0,0,0,Slovenia
6525,4/1/2020,SVN,Kedah,0,0,0,Slovenia
6526,4/1/2020,SVN,Kelantan,0,0,0,Slovenia
6527,4/1/2020,SVN,Perak,0,0,0,Slovenia
6528,4/1/2020,SVN,Perlis,0,0,0,Slovenia
6529,4/1/2020,SVN,Pulau Pinang,0,0,0,Slovenia
6530,4/1/2020,SVN,Sabah,0,0,0,Slovenia
6531,4/1/2020,SVN,Sarawak,0,0,0,Slovenia
6532,4/1/2020,SVN,Selangor,0,0,0,Slovenia
6533,4/1/2020,SVN,W.P. Labuan,0,0,0,Slovenia
6534,4/1/2020,SWE,Johor,0,0,0,Sweden
6535,4/1/2020,SWE,Kedah,0,0,0,Sweden
6536,4/1/2020,SWE,Kelantan,0,0,0,Sweden
6537,4/1/2020,SWE,Melaka,0,0,0,Sweden
6538,4/1/2020,SWE,Negeri Sembilan,0,0,0,Sweden
6539,4/1/2020,SWE,Pahang,0,0,0,Sweden
6540,4/1/2020,SWE,Perak,0,0,0,Sweden
6541,4/1/2020,SWE,Perlis,0,0,0,Sweden
6542,4/1/2020,SWE,Pulau Pinang,2,2,0,Sweden
6543,4/1/2020,SWE,Sabah,0,0,0,Sweden
6544,4/1/2020,SWE,Sarawak,0,0,0,Sweden
6545,4/1/2020,SWE,Selangor,1,1,0,Sweden
6546,4/1/2020,SWE,W.P. Labuan,0,0,0,Sweden
6547,4/1/2020,SWZ,Johor,0,0,0,Swaziland
6548,4/1/2020,SWZ,Kedah,0,0,0,Swaziland
6549,4/1/2020,SWZ,Pulau Pinang,0,0,0,Swaziland
6550,4/1/2020,SWZ,Sabah,0,0,0,Swaziland
6551,4/1/2020,SWZ,Selangor,0,0,0,Swaziland
6552,4/1/2020,SYC,Johor,0,0,0,Seychelles
6553,4/1/2020,SYC,Kedah,0,0,0,Seychelles
6554,4/1/2020,SYC,Pulau Pinang,0,0,0,Seychelles
6555,4/1/2020,SYC,Sabah,0,0,0,Seychelles
6556,4/1/2020,SYC,Sarawak,0,0,0,Seychelles
6557,4/1/2020,SYC,Selangor,0,0,0,Seychelles
6558,4/1/2020,SYR,Johor,0,0,0,Syrian Arab Republic
6559,4/1/2020,SYR,Kedah,0,0,0,Syrian Arab Republic
6560,4/1/2020,SYR,Kelantan,0,0,0,Syrian Arab Republic
6561,4/1/2020,SYR,Pahang,0,0,0,Syrian Arab Republic
6562,4/1/2020,SYR,Perlis,0,0,0,Syrian Arab Republic
6563,4/1/2020,SYR,Pulau Pinang,0,0,0,Syrian Arab Republic
6564,4/1/2020,SYR,Sabah,0,0,0,Syrian Arab Republic
6565,4/1/2020,SYR,Sarawak,0,0,0,Syrian Arab Republic
6566,4/1/2020,SYR,Selangor,0,0,0,Syrian Arab Republic
6567,4/1/2020,SYR,W.P. Labuan,0,0,0,Syrian Arab Republic
6568,4/1/2020,TCA,Perlis,0,0,0,Turks and Caicos
6569,4/1/2020,TCD,Johor,0,0,0,Chad
6570,4/1/2020,TCD,Kedah,0,0,0,Chad
6571,4/1/2020,TCD,Perlis,0,0,0,Chad
6572,4/1/2020,TCD,Selangor,1,1,0,Chad
6573,4/1/2020,TGO,Johor,0,0,0,Togo
6574,4/1/2020,TGO,Perak,0,0,0,Togo
6575,4/1/2020,TGO,Pulau Pinang,0,0,0,Togo
6576,4/1/2020,TGO,Selangor,0,0,0,Togo
6577,4/1/2020,THA,Johor,85,84,1,Thailand
6578,4/1/2020,THA,Kedah,13817,13143,674,Thailand
6579,4/1/2020,THA,Kelantan,20,4,16,Thailand
6580,4/1/2020,THA,Melaka,0,0,0,Thailand
6581,4/1/2020,THA,Negeri Sembilan,0,0,0,Thailand
6582,4/1/2020,THA,Pahang,0,0,0,Thailand
6583,4/1/2020,THA,Perak,2,0,2,Thailand
6584,4/1/2020,THA,Perlis,2,0,2,Thailand
6585,4/1/2020,THA,Pulau Pinang,0,0,0,Thailand
6586,4/1/2020,THA,Sabah,0,0,0,Thailand
6587,4/1/2020,THA,Sarawak,8,8,0,Thailand
6588,4/1/2020,THA,Selangor,16,4,12,Thailand
6589,4/1/2020,THA,Terengganu,0,0,0,Thailand
6590,4/1/2020,THA,W.P. Labuan,0,0,0,Thailand
6591,4/1/2020,TJK,Johor,0,0,0,Tajikistan
6592,4/1/2020,TJK,Kedah,0,0,0,Tajikistan
6593,4/1/2020,TJK,Perlis,0,0,0,Tajikistan
6594,4/1/2020,TJK,Pulau Pinang,0,0,0,Tajikistan
6595,4/1/2020,TJK,Sabah,0,0,0,Tajikistan
6596,4/1/2020,TJK,Selangor,0,0,0,Tajikistan
6597,4/1/2020,TKL,Selangor,0,0,0,Tokelau
6598,4/1/2020,TKM,Johor,0,0,0,Turkmenistan
6599,4/1/2020,TKM,Kedah,0,0,0,Turkmenistan
6600,4/1/2020,TKM,Kelantan,0,0,0,Turkmenistan
6601,4/1/2020,TKM,Perlis,0,0,0,Turkmenistan
6602,4/1/2020,TKM,Pulau Pinang,0,0,0,Turkmenistan
6603,4/1/2020,TKM,Sabah,0,0,0,Turkmenistan
6604,4/1/2020,TKM,Sarawak,0,0,0,Turkmenistan
6605,4/1/2020,TKM,Selangor,0,0,0,Turkmenistan
6606,4/1/2020,TLS,Johor,0,0,0,Timor-Leste
6607,4/1/2020,TLS,Kedah,0,0,0,Timor-Leste
6608,4/1/2020,TLS,Perlis,0,0,0,Timor-Leste
6609,4/1/2020,TLS,Pulau Pinang,0,0,0,Timor-Leste
6610,4/1/2020,TLS,Sabah,0,0,0,Timor-Leste
6611,4/1/2020,TLS,Sarawak,0,0,0,Timor-Leste
6612,4/1/2020,TLS,Selangor,0,0,0,Timor-Leste
6613,4/1/2020,TON,Johor,0,0,0,Tonga
6614,4/1/2020,TON,Pulau Pinang,0,0,0,Tonga
6615,4/1/2020,TON,Sarawak,0,0,0,Tonga
6616,4/1/2020,TON,Selangor,0,0,0,Tonga
6617,4/1/2020,TTO,Johor,0,0,0,Trinidad and Tobago
6618,4/1/2020,TTO,Kedah,0,0,0,Trinidad and Tobago
6619,4/1/2020,TTO,Pahang,0,0,0,Trinidad and Tobago
6620,4/1/2020,TTO,Pulau Pinang,0,0,0,Trinidad and Tobago
6621,4/1/2020,TTO,Sabah,0,0,0,Trinidad and Tobago
6622,4/1/2020,TTO,Sarawak,0,0,0,Trinidad and Tobago
6623,4/1/2020,TTO,Selangor,0,0,0,Trinidad and Tobago
6624,4/1/2020,TUN,Johor,0,0,0,Tunisia
6625,4/1/2020,TUN,Kedah,0,0,0,Tunisia
6626,4/1/2020,TUN,Kelantan,0,0,0,Tunisia
6627,4/1/2020,TUN,Melaka,0,0,0,Tunisia
6628,4/1/2020,TUN,Perak,0,0,0,Tunisia
6629,4/1/2020,TUN,Perlis,0,0,0,Tunisia
6630,4/1/2020,TUN,Pulau Pinang,0,0,0,Tunisia
6631,4/1/2020,TUN,Sabah,0,0,0,Tunisia
6632,4/1/2020,TUN,Sarawak,0,0,0,Tunisia
6633,4/1/2020,TUN,Selangor,0,0,0,Tunisia
6634,4/1/2020,TUN,W.P. Labuan,0,0,0,Tunisia
6635,4/1/2020,TUR,Johor,0,0,0,Turkey
6636,4/1/2020,TUR,Kedah,0,0,0,Turkey
6637,4/1/2020,TUR,Kelantan,0,0,0,Turkey
6638,4/1/2020,TUR,Melaka,0,0,0,Turkey
6639,4/1/2020,TUR,Negeri Sembilan,0,0,0,Turkey
6640,4/1/2020,TUR,Pahang,0,0,0,Turkey
6641,4/1/2020,TUR,Perak,0,0,0,Turkey
6642,4/1/2020,TUR,Perlis,0,0,0,Turkey
6643,4/1/2020,TUR,Pulau Pinang,0,0,0,Turkey
6644,4/1/2020,TUR,Sabah,0,0,0,Turkey
6645,4/1/2020,TUR,Sarawak,0,0,0,Turkey
6646,4/1/2020,TUR,Selangor,1,1,0,Turkey
6647,4/1/2020,TUR,W.P. Labuan,0,0,0,Turkey
6648,4/1/2020,TUV,Selangor,0,0,0,Tuvalu
6649,4/1/2020,TWN,Johor,0,0,0,Taiwan
6650,4/1/2020,TWN,Kedah,0,0,0,Taiwan
6651,4/1/2020,TWN,Kelantan,0,0,0,Taiwan
6652,4/1/2020,TWN,Melaka,0,0,0,Taiwan
6653,4/1/2020,TWN,Negeri Sembilan,0,0,0,Taiwan
6654,4/1/2020,TWN,Pahang,0,0,0,Taiwan
6655,4/1/2020,TWN,Perak,0,0,0,Taiwan
6656,4/1/2020,TWN,Perlis,0,0,0,Taiwan
6657,4/1/2020,TWN,Pulau Pinang,0,0,0,Taiwan
6658,4/1/2020,TWN,Sabah,0,0,0,Taiwan
6659,4/1/2020,TWN,Sarawak,0,0,0,Taiwan
6660,4/1/2020,TWN,Selangor,3,3,0,Taiwan
6661,4/1/2020,TWN,W.P. Labuan,0,0,0,Taiwan
6662,4/1/2020,TZA,Johor,0,0,0,"Tanzania, United Republic of"
6663,4/1/2020,TZA,Kedah,0,0,0,"Tanzania, United Republic of"
6664,4/1/2020,TZA,Perak,0,0,0,"Tanzania, United Republic of"
6665,4/1/2020,TZA,Perlis,0,0,0,"Tanzania, United Republic of"
6666,4/1/2020,TZA,Pulau Pinang,0,0,0,"Tanzania, United Republic of"
6667,4/1/2020,TZA,Sabah,0,0,0,"Tanzania, United Republic of"
6668,4/1/2020,TZA,Sarawak,0,0,0,"Tanzania, United Republic of"
6669,4/1/2020,TZA,Selangor,0,0,0,"Tanzania, United Republic of"
6670,4/1/2020,UGA,Johor,0,0,0,Uganda
6671,4/1/2020,UGA,Kedah,0,0,0,Uganda
6672,4/1/2020,UGA,Perak,0,0,0,Uganda
6673,4/1/2020,UGA,Perlis,0,0,0,Uganda
6674,4/1/2020,UGA,Pulau Pinang,0,0,0,Uganda
6675,4/1/2020,UGA,Sabah,0,0,0,Uganda
6676,4/1/2020,UGA,Sarawak,0,0,0,Uganda
6677,4/1/2020,UGA,Selangor,0,0,0,Uganda
6678,4/1/2020,UKR,Johor,0,0,0,Ukraine
6679,4/1/2020,UKR,Kedah,0,0,0,Ukraine
6680,4/1/2020,UKR,Kelantan,0,0,0,Ukraine
6681,4/1/2020,UKR,Melaka,0,0,0,Ukraine
6682,4/1/2020,UKR,Negeri Sembilan,0,0,0,Ukraine
6683,4/1/2020,UKR,Pahang,0,0,0,Ukraine
6684,4/1/2020,UKR,Perak,0,0,0,Ukraine
6685,4/1/2020,UKR,Perlis,0,0,0,Ukraine
6686,4/1/2020,UKR,Pulau Pinang,0,0,0,Ukraine
6687,4/1/2020,UKR,Sabah,0,0,0,Ukraine
6688,4/1/2020,UKR,Sarawak,0,0,0,Ukraine
6689,4/1/2020,UKR,Selangor,0,0,0,Ukraine
6690,4/1/2020,UKR,W.P. Labuan,0,0,0,Ukraine
6691,4/1/2020,URY,Johor,0,0,0,Uruguay
6692,4/1/2020,URY,Kedah,0,0,0,Uruguay
6693,4/1/2020,URY,Kelantan,0,0,0,Uruguay
6694,4/1/2020,URY,Perak,0,0,0,Uruguay
6695,4/1/2020,URY,Perlis,0,0,0,Uruguay
6696,4/1/2020,URY,Pulau Pinang,0,0,0,Uruguay
6697,4/1/2020,URY,Sabah,0,0,0,Uruguay
6698,4/1/2020,URY,Sarawak,0,0,0,Uruguay
6699,4/1/2020,URY,Selangor,0,0,0,Uruguay
6700,4/1/2020,URY,W.P. Labuan,0,0,0,Uruguay
6701,4/1/2020,USA,Johor,0,0,0,United States Of America
6702,4/1/2020,USA,Kedah,0,0,0,United States Of America
6703,4/1/2020,USA,Kelantan,0,0,0,United States Of America
6704,4/1/2020,USA,Melaka,0,0,0,United States Of America
6705,4/1/2020,USA,Negeri Sembilan,0,0,0,United States Of America
6706,4/1/2020,USA,Pahang,0,0,0,United States Of America
6707,4/1/2020,USA,Perak,0,0,0,United States Of America
6708,4/1/2020,USA,Perlis,0,0,0,United States Of America
6709,4/1/2020,USA,Pulau Pinang,5,4,1,United States Of America
6710,4/1/2020,USA,Sabah,0,0,0,United States Of America
6711,4/1/2020,USA,Sarawak,0,0,0,United States Of America
6712,4/1/2020,USA,Selangor,11,9,2,United States Of America
6713,4/1/2020,USA,Terengganu,0,0,0,United States Of America
6714,4/1/2020,USA,W.P. Labuan,0,0,0,United States Of America
6715,4/1/2020,UZB,Johor,0,0,0,Uzbekistan
6716,4/1/2020,UZB,Kedah,0,0,0,Uzbekistan
6717,4/1/2020,UZB,Kelantan,0,0,0,Uzbekistan
6718,4/1/2020,UZB,Perak,0,0,0,Uzbekistan
6719,4/1/2020,UZB,Perlis,0,0,0,Uzbekistan
6720,4/1/2020,UZB,Pulau Pinang,0,0,0,Uzbekistan
6721,4/1/2020,UZB,Sabah,0,0,0,Uzbekistan
6722,4/1/2020,UZB,Sarawak,0,0,0,Uzbekistan
6723,4/1/2020,UZB,Selangor,0,0,0,Uzbekistan
6724,4/1/2020,VAT,Johor,0,0,0,Holy See (Vatican City State)
6725,4/1/2020,VAT,Sarawak,0,0,0,Holy See (Vatican City State)
6726,4/1/2020,VAT,Selangor,0,0,0,Holy See (Vatican City State)
6727,4/1/2020,VCT,Johor,0,0,0,Saint Vincent and the Grenadines
6728,4/1/2020,VCT,Kedah,0,0,0,Saint Vincent and the Grenadines
6729,4/1/2020,VCT,Pulau Pinang,0,0,0,Saint Vincent and the Grenadines
6730,4/1/2020,VCT,Sarawak,0,0,0,Saint Vincent and the Grenadines
6731,4/1/2020,VCT,Selangor,0,0,0,Saint Vincent and the Grenadines
6732,4/1/2020,VEN,Johor,0,0,0,Venezuela
6733,4/1/2020,VEN,Kedah,0,0,0,Venezuela
6734,4/1/2020,VEN,Kelantan,0,0,0,Venezuela
6735,4/1/2020,VEN,Melaka,0,0,0,Venezuela
6736,4/1/2020,VEN,Perak,0,0,0,Venezuela
6737,4/1/2020,VEN,Perlis,0,0,0,Venezuela
6738,4/1/2020,VEN,Pulau Pinang,0,0,0,Venezuela
6739,4/1/2020,VEN,Sabah,0,0,0,Venezuela
6740,4/1/2020,VEN,Sarawak,0,0,0,Venezuela
6741,4/1/2020,VEN,Selangor,0,0,0,Venezuela
6742,4/1/2020,VEN,W.P. Labuan,0,0,0,Venezuela
6743,4/1/2020,VNM,Johor,2,0,2,Vietnam
6744,4/1/2020,VNM,Kedah,0,0,0,Vietnam
6745,4/1/2020,VNM,Kelantan,0,0,0,Vietnam
6746,4/1/2020,VNM,Melaka,0,0,0,Vietnam
6747,4/1/2020,VNM,Negeri Sembilan,0,0,0,Vietnam
6748,4/1/2020,VNM,Pahang,0,0,0,Vietnam
6749,4/1/2020,VNM,Perak,0,0,0,Vietnam
6750,4/1/2020,VNM,Perlis,0,0,0,Vietnam
6751,4/1/2020,VNM,Pulau Pinang,0,0,0,Vietnam
6752,4/1/2020,VNM,Sabah,0,0,0,Vietnam
6753,4/1/2020,VNM,Sarawak,0,0,0,Vietnam
6754,4/1/2020,VNM,Selangor,14,4,10,Vietnam
6755,4/1/2020,VNM,Terengganu,0,0,0,Vietnam
6756,4/1/2020,VNM,W.P. Labuan,0,0,0,Vietnam
6757,4/1/2020,VUT,Johor,0,0,0,Vanuatu
6758,4/1/2020,VUT,Kedah,0,0,0,Vanuatu
6759,4/1/2020,VUT,Pulau Pinang,0,0,0,Vanuatu
6760,4/1/2020,VUT,Sabah,0,0,0,Vanuatu
6761,4/1/2020,VUT,Sarawak,0,0,0,Vanuatu
6762,4/1/2020,VUT,Selangor,0,0,0,Vanuatu
6763,4/1/2020,WSM,Johor,0,0,0,Samoa
6764,4/1/2020,WSM,Sarawak,0,0,0,Samoa
6765,4/1/2020,WSM,Selangor,0,0,0,Samoa
6766,4/1/2020,YEM,Johor,0,0,0,Yemen
6767,4/1/2020,YEM,Kedah,0,0,0,Yemen
6768,4/1/2020,YEM,Kelantan,0,0,0,Yemen
6769,4/1/2020,YEM,Melaka,0,0,0,Yemen
6770,4/1/2020,YEM,Pahang,0,0,0,Yemen
6771,4/1/2020,YEM,Perak,0,0,0,Yemen
6772,4/1/2020,YEM,Perlis,0,0,0,Yemen
6773,4/1/2020,YEM,Pulau Pinang,0,0,0,Yemen
6774,4/1/2020,YEM,Sabah,0,0,0,Yemen
6775,4/1/2020,YEM,Sarawak,0,0,0,Yemen
6776,4/1/2020,YEM,Selangor,0,0,0,Yemen
6777,4/1/2020,YEM,W.P. Labuan,0,0,0,Yemen
6778,4/1/2020,ZAF,Johor,0,0,0,South Africa
6779,4/1/2020,ZAF,Kedah,0,0,0,South Africa
6780,4/1/2020,ZAF,Kelantan,0,0,0,South Africa
6781,4/1/2020,ZAF,Melaka,0,0,0,South Africa
6782,4/1/2020,ZAF,Pahang,0,0,0,South Africa
6783,4/1/2020,ZAF,Perak,0,0,0,South Africa
6784,4/1/2020,ZAF,Perlis,0,0,0,South Africa
6785,4/1/2020,ZAF,Pulau Pinang,0,0,0,South Africa
6786,4/1/2020,ZAF,Sabah,0,0,0,South Africa
6787,4/1/2020,ZAF,Sarawak,0,0,0,South Africa
6788,4/1/2020,ZAF,Selangor,0,0,0,South Africa
6789,4/1/2020,ZAF,Terengganu,0,0,0,South Africa
6790,4/1/2020,ZAF,W.P. Labuan,0,0,0,South Africa
6791,4/1/2020,ZMB,Johor,0,0,0,Zambia
6792,4/1/2020,ZMB,Kedah,0,0,0,Zambia
6793,4/1/2020,ZMB,Perak,0,0,0,Zambia
6794,4/1/2020,ZMB,Perlis,0,0,0,Zambia
6795,4/1/2020,ZMB,Pulau Pinang,0,0,0,Zambia
6796,4/1/2020,ZMB,Sabah,0,0,0,Zambia
6797,4/1/2020,ZMB,Sarawak,0,0,0,Zambia
6798,4/1/2020,ZMB,Selangor,0,0,0,Zambia
6799,4/1/2020,ZWE,Johor,0,0,0,Zimbabwe
6800,4/1/2020,ZWE,Kedah,0,0,0,Zimbabwe
6801,4/1/2020,ZWE,Kelantan,0,0,0,Zimbabwe
6802,4/1/2020,ZWE,Perak,0,0,0,Zimbabwe
6803,4/1/2020,ZWE,Perlis,0,0,0,Zimbabwe
6804,4/1/2020,ZWE,Pulau Pinang,0,0,0,Zimbabwe
6805,4/1/2020,ZWE,Sabah,0,0,0,Zimbabwe
6806,4/1/2020,ZWE,Sarawak,0,0,0,Zimbabwe
6807,4/1/2020,ZWE,Selangor,0,0,0,Zimbabwe
6808,5/1/2020,ABW,Kedah,0,0,0,Aruba
6809,5/1/2020,ABW,Pulau Pinang,0,0,0,Aruba
6810,5/1/2020,AFG,Johor,0,0,0,Afghanistan
6811,5/1/2020,AFG,Kedah,0,0,0,Afghanistan
6812,5/1/2020,AFG,Perlis,0,0,0,Afghanistan
6813,5/1/2020,AFG,Pulau Pinang,0,0,0,Afghanistan
6814,5/1/2020,AFG,Sarawak,0,0,0,Afghanistan
6815,5/1/2020,AFG,Selangor,1,1,0,Afghanistan
6816,5/1/2020,AGO,Johor,0,0,0,Angola
6817,5/1/2020,AGO,Kedah,0,0,0,Angola
6818,5/1/2020,AGO,Sabah,0,0,0,Angola
6819,5/1/2020,AGO,Selangor,0,0,0,Angola
6820,5/1/2020,AIA,Selangor,0,0,0,Anguilla
6821,5/1/2020,ALB,Johor,0,0,0,Albania
6822,5/1/2020,ALB,Kedah,0,0,0,Albania
6823,5/1/2020,ALB,Perak,0,0,0,Albania
6824,5/1/2020,ALB,Perlis,0,0,0,Albania
6825,5/1/2020,ALB,Pulau Pinang,0,0,0,Albania
6826,5/1/2020,ALB,Sabah,0,0,0,Albania
6827,5/1/2020,ALB,Sarawak,0,0,0,Albania
6828,5/1/2020,ALB,Selangor,0,0,0,Albania
6829,5/1/2020,AND,Johor,0,0,0,Andorra
6830,5/1/2020,AND,Kedah,0,0,0,Andorra
6831,5/1/2020,AND,Perlis,0,0,0,Andorra
6832,5/1/2020,AND,Pulau Pinang,0,0,0,Andorra
6833,5/1/2020,AND,Selangor,0,0,0,Andorra
6834,5/1/2020,ANT,Selangor,0,0,0,Netherlands Antilles
6835,5/1/2020,ARE,Johor,0,0,0,United Arab Emirates
6836,5/1/2020,ARE,Kedah,0,0,0,United Arab Emirates
6837,5/1/2020,ARE,Kelantan,0,0,0,United Arab Emirates
6838,5/1/2020,ARE,Perak,0,0,0,United Arab Emirates
6839,5/1/2020,ARE,Perlis,0,0,0,United Arab Emirates
6840,5/1/2020,ARE,Pulau Pinang,0,0,0,United Arab Emirates
6841,5/1/2020,ARE,Sabah,0,0,0,United Arab Emirates
6842,5/1/2020,ARE,Sarawak,0,0,0,United Arab Emirates
6843,5/1/2020,ARE,Selangor,0,0,0,United Arab Emirates
6844,5/1/2020,ARG,Johor,0,0,0,Argentina
6845,5/1/2020,ARG,Kedah,0,0,0,Argentina
6846,5/1/2020,ARG,Kelantan,0,0,0,Argentina
6847,5/1/2020,ARG,Melaka,0,0,0,Argentina
6848,5/1/2020,ARG,Perak,0,0,0,Argentina
6849,5/1/2020,ARG,Perlis,0,0,0,Argentina
6850,5/1/2020,ARG,Pulau Pinang,0,0,0,Argentina
6851,5/1/2020,ARG,Sabah,0,0,0,Argentina
6852,5/1/2020,ARG,Sarawak,0,0,0,Argentina
6853,5/1/2020,ARG,Selangor,0,0,0,Argentina
6854,5/1/2020,ARG,W.P. Labuan,0,0,0,Argentina
6855,5/1/2020,ARM,Johor,0,0,0,Armenia
6856,5/1/2020,ARM,Kedah,0,0,0,Armenia
6857,5/1/2020,ARM,Kelantan,0,0,0,Armenia
6858,5/1/2020,ARM,Perak,0,0,0,Armenia
6859,5/1/2020,ARM,Perlis,0,0,0,Armenia
6860,5/1/2020,ARM,Pulau Pinang,0,0,0,Armenia
6861,5/1/2020,ARM,Sabah,0,0,0,Armenia
6862,5/1/2020,ARM,Sarawak,0,0,0,Armenia
6863,5/1/2020,ARM,Selangor,0,0,0,Armenia
6864,5/1/2020,ATA,Selangor,0,0,0,Antarctica
6865,5/1/2020,ATG,Johor,0,0,0,Antigua and Barbuda
6866,5/1/2020,ATG,Kedah,0,0,0,Antigua and Barbuda
6867,5/1/2020,ATG,Pulau Pinang,0,0,0,Antigua and Barbuda
6868,5/1/2020,ATG,Sarawak,0,0,0,Antigua and Barbuda
6869,5/1/2020,ATG,Selangor,0,0,0,Antigua and Barbuda
6870,5/1/2020,AUS,Johor,0,0,0,Australia
6871,5/1/2020,AUS,Kedah,0,0,0,Australia
6872,5/1/2020,AUS,Kelantan,0,0,0,Australia
6873,5/1/2020,AUS,Melaka,0,0,0,Australia
6874,5/1/2020,AUS,Negeri Sembilan,0,0,0,Australia
6875,5/1/2020,AUS,Pahang,0,0,0,Australia
6876,5/1/2020,AUS,Perak,0,0,0,Australia
6877,5/1/2020,AUS,Perlis,0,0,0,Australia
6878,5/1/2020,AUS,Pulau Pinang,0,0,0,Australia
6879,5/1/2020,AUS,Sabah,0,0,0,Australia
6880,5/1/2020,AUS,Sarawak,0,0,0,Australia
6881,5/1/2020,AUS,Selangor,42,35,7,Australia
6882,5/1/2020,AUS,Terengganu,0,0,0,Australia
6883,5/1/2020,AUS,W.P. Labuan,0,0,0,Australia
6884,5/1/2020,AUT,Johor,0,0,0,Austria
6885,5/1/2020,AUT,Kedah,0,0,0,Austria
6886,5/1/2020,AUT,Kelantan,0,0,0,Austria
6887,5/1/2020,AUT,Melaka,0,0,0,Austria
6888,5/1/2020,AUT,Negeri Sembilan,0,0,0,Austria
6889,5/1/2020,AUT,Pahang,0,0,0,Austria
6890,5/1/2020,AUT,Perak,0,0,0,Austria
6891,5/1/2020,AUT,Perlis,0,0,0,Austria
6892,5/1/2020,AUT,Pulau Pinang,0,0,0,Austria
6893,5/1/2020,AUT,Sabah,0,0,0,Austria
6894,5/1/2020,AUT,Sarawak,0,0,0,Austria
6895,5/1/2020,AUT,Selangor,0,0,0,Austria
6896,5/1/2020,AUT,Terengganu,0,0,0,Austria
6897,5/1/2020,AUT,W.P. Labuan,0,0,0,Austria
6898,5/1/2020,AZE,Johor,0,0,0,Azerbaijan
6899,5/1/2020,AZE,Kedah,0,0,0,Azerbaijan
6900,5/1/2020,AZE,Kelantan,0,0,0,Azerbaijan
6901,5/1/2020,AZE,Melaka,0,0,0,Azerbaijan
6902,5/1/2020,AZE,Perlis,0,0,0,Azerbaijan
6903,5/1/2020,AZE,Pulau Pinang,0,0,0,Azerbaijan
6904,5/1/2020,AZE,Sabah,0,0,0,Azerbaijan
6905,5/1/2020,AZE,Sarawak,0,0,0,Azerbaijan
6906,5/1/2020,AZE,Selangor,1,1,0,Azerbaijan
6907,5/1/2020,AZE,W.P. Labuan,0,0,0,Azerbaijan
6908,5/1/2020,BDI,Pulau Pinang,0,0,0,Burundi
6909,5/1/2020,BDI,Sarawak,0,0,0,Burundi
6910,5/1/2020,BDI,Selangor,0,0,0,Burundi
6911,5/1/2020,BEL,Johor,0,0,0,Belgium
6912,5/1/2020,BEL,Kedah,0,0,0,Belgium
6913,5/1/2020,BEL,Kelantan,0,0,0,Belgium
6914,5/1/2020,BEL,Melaka,0,0,0,Belgium
6915,5/1/2020,BEL,Negeri Sembilan,0,0,0,Belgium
6916,5/1/2020,BEL,Pahang,0,0,0,Belgium
6917,5/1/2020,BEL,Perak,0,0,0,Belgium
6918,5/1/2020,BEL,Perlis,0,0,0,Belgium
6919,5/1/2020,BEL,Pulau Pinang,0,0,0,Belgium
6920,5/1/2020,BEL,Sabah,0,0,0,Belgium
6921,5/1/2020,BEL,Sarawak,0,0,0,Belgium
6922,5/1/2020,BEL,Selangor,1,0,1,Belgium
6923,5/1/2020,BEL,W.P. Labuan,0,0,0,Belgium
6924,5/1/2020,BEN,Johor,0,0,0,Benin
6925,5/1/2020,BEN,Kedah,0,0,0,Benin
6926,5/1/2020,BEN,Perak,0,0,0,Benin
6927,5/1/2020,BEN,Pulau Pinang,0,0,0,Benin
6928,5/1/2020,BEN,Sabah,0,0,0,Benin
6929,5/1/2020,BEN,Sarawak,0,0,0,Benin
6930,5/1/2020,BEN,Selangor,0,0,0,Benin
6931,5/1/2020,BFA,Perak,0,0,0,Burkina Faso
6932,5/1/2020,BFA,Pulau Pinang,0,0,0,Burkina Faso
6933,5/1/2020,BFA,Selangor,0,0,0,Burkina Faso
6934,5/1/2020,BGD,Johor,0,0,0,Bangladesh
6935,5/1/2020,BGD,Kedah,0,0,0,Bangladesh
6936,5/1/2020,BGD,Kelantan,0,0,0,Bangladesh
6937,5/1/2020,BGD,Melaka,0,0,0,Bangladesh
6938,5/1/2020,BGD,Negeri Sembilan,0,0,0,Bangladesh
6939,5/1/2020,BGD,Pahang,0,0,0,Bangladesh
6940,5/1/2020,BGD,Perak,0,0,0,Bangladesh
6941,5/1/2020,BGD,Perlis,0,0,0,Bangladesh
6942,5/1/2020,BGD,Pulau Pinang,0,0,0,Bangladesh
6943,5/1/2020,BGD,Sabah,0,0,0,Bangladesh
6944,5/1/2020,BGD,Sarawak,0,0,0,Bangladesh
6945,5/1/2020,BGD,Selangor,10,9,1,Bangladesh
6946,5/1/2020,BGD,W.P. Labuan,0,0,0,Bangladesh
6947,5/1/2020,BGR,Johor,0,0,0,Bulgaria
6948,5/1/2020,BGR,Kedah,0,0,0,Bulgaria
6949,5/1/2020,BGR,Kelantan,0,0,0,Bulgaria
6950,5/1/2020,BGR,Pahang,0,0,0,Bulgaria
6951,5/1/2020,BGR,Perak,0,0,0,Bulgaria
6952,5/1/2020,BGR,Perlis,0,0,0,Bulgaria
6953,5/1/2020,BGR,Pulau Pinang,0,0,0,Bulgaria
6954,5/1/2020,BGR,Sabah,0,0,0,Bulgaria
6955,5/1/2020,BGR,Sarawak,0,0,0,Bulgaria
6956,5/1/2020,BGR,Selangor,0,0,0,Bulgaria
6957,5/1/2020,BGR,W.P. Labuan,0,0,0,Bulgaria
6958,5/1/2020,BHR,Johor,0,0,0,Bahrain
6959,5/1/2020,BHR,Kedah,0,0,0,Bahrain
6960,5/1/2020,BHR,Kelantan,0,0,0,Bahrain
6961,5/1/2020,BHR,Perlis,0,0,0,Bahrain
6962,5/1/2020,BHR,Pulau Pinang,0,0,0,Bahrain
6963,5/1/2020,BHR,Sabah,0,0,0,Bahrain
6964,5/1/2020,BHR,Sarawak,0,0,0,Bahrain
6965,5/1/2020,BHR,Selangor,0,0,0,Bahrain
6966,5/1/2020,BHS,Johor,0,0,0,Bahamas
6967,5/1/2020,BHS,Kedah,0,0,0,Bahamas
6968,5/1/2020,BHS,Perak,0,0,0,Bahamas
6969,5/1/2020,BHS,Sabah,0,0,0,Bahamas
6970,5/1/2020,BHS,Sarawak,0,0,0,Bahamas
6971,5/1/2020,BHS,Selangor,0,0,0,Bahamas
6972,5/1/2020,BIH,Johor,0,0,0,Bosnia and Herzegovina
6973,5/1/2020,BIH,Kedah,0,0,0,Bosnia and Herzegovina
6974,5/1/2020,BIH,Perlis,0,0,0,Bosnia and Herzegovina
6975,5/1/2020,BIH,Pulau Pinang,0,0,0,Bosnia and Herzegovina
6976,5/1/2020,BIH,Sabah,0,0,0,Bosnia and Herzegovina
6977,5/1/2020,BIH,Sarawak,0,0,0,Bosnia and Herzegovina
6978,5/1/2020,BIH,Selangor,0,0,0,Bosnia and Herzegovina
6979,5/1/2020,BLR,Johor,0,0,0,Belarus
6980,5/1/2020,BLR,Kedah,0,0,0,Belarus
6981,5/1/2020,BLR,Kelantan,0,0,0,Belarus
6982,5/1/2020,BLR,Pahang,0,0,0,Belarus
6983,5/1/2020,BLR,Perak,0,0,0,Belarus
6984,5/1/2020,BLR,Perlis,0,0,0,Belarus
6985,5/1/2020,BLR,Pulau Pinang,0,0,0,Belarus
6986,5/1/2020,BLR,Sabah,0,0,0,Belarus
6987,5/1/2020,BLR,Sarawak,0,0,0,Belarus
6988,5/1/2020,BLR,Selangor,0,0,0,Belarus
6989,5/1/2020,BLR,W.P. Labuan,0,0,0,Belarus
6990,5/1/2020,BLZ,Johor,0,0,0,Belize
6991,5/1/2020,BLZ,Pulau Pinang,0,0,0,Belize
6992,5/1/2020,BLZ,Sarawak,0,0,0,Belize
6993,5/1/2020,BLZ,Selangor,0,0,0,Belize
6994,5/1/2020,BMU,Selangor,0,0,0,Bermuda
6995,5/1/2020,BOL,Johor,0,0,0,Bolivia
6996,5/1/2020,BOL,Kedah,0,0,0,Bolivia
6997,5/1/2020,BOL,Melaka,0,0,0,Bolivia
6998,5/1/2020,BOL,Perak,0,0,0,Bolivia
6999,5/1/2020,BOL,Perlis,0,0,0,Bolivia
7000,5/1/2020,BOL,Pulau Pinang,0,0,0,Bolivia
7001,5/1/2020,BOL,Sabah,0,0,0,Bolivia
7002,5/1/2020,BOL,Sarawak,0,0,0,Bolivia
7003,5/1/2020,BOL,Selangor,0,0,0,Bolivia
7004,5/1/2020,BRA,Johor,0,0,0,Brazil
7005,5/1/2020,BRA,Kedah,0,0,0,Brazil
7006,5/1/2020,BRA,Kelantan,0,0,0,Brazil
7007,5/1/2020,BRA,Melaka,0,0,0,Brazil
7008,5/1/2020,BRA,Pahang,0,0,0,Brazil
7009,5/1/2020,BRA,Perak,0,0,0,Brazil
7010,5/1/2020,BRA,Perlis,0,0,0,Brazil
7011,5/1/2020,BRA,Pulau Pinang,0,0,0,Brazil
7012,5/1/2020,BRA,Sabah,0,0,0,Brazil
7013,5/1/2020,BRA,Sarawak,0,0,0,Brazil
7014,5/1/2020,BRA,Selangor,12,12,0,Brazil
7015,5/1/2020,BRA,W.P. Labuan,0,0,0,Brazil
7016,5/1/2020,BRB,Johor,0,0,0,Barbados
7017,5/1/2020,BRB,Kedah,0,0,0,Barbados
7018,5/1/2020,BRB,Perlis,0,0,0,Barbados
7019,5/1/2020,BRB,Pulau Pinang,0,0,0,Barbados
7020,5/1/2020,BRB,Selangor,0,0,0,Barbados
7021,5/1/2020,BRN,Johor,0,0,0,Brunei Darussalam
7022,5/1/2020,BRN,Kedah,0,0,0,Brunei Darussalam
7023,5/1/2020,BRN,Kelantan,0,0,0,Brunei Darussalam
7024,5/1/2020,BRN,Melaka,0,0,0,Brunei Darussalam
7025,5/1/2020,BRN,Pahang,0,0,0,Brunei Darussalam
7026,5/1/2020,BRN,Perak,0,0,0,Brunei Darussalam
7027,5/1/2020,BRN,Perlis,0,0,0,Brunei Darussalam
7028,5/1/2020,BRN,Pulau Pinang,0,0,0,Brunei Darussalam
7029,5/1/2020,BRN,Sabah,0,0,0,Brunei Darussalam
7030,5/1/2020,BRN,Sarawak,328,320,8,Brunei Darussalam
7031,5/1/2020,BRN,Selangor,1,1,0,Brunei Darussalam
7032,5/1/2020,BRN,W.P. Labuan,1,1,0,Brunei Darussalam
7033,5/1/2020,BTN,Johor,0,0,0,Bhutan
7034,5/1/2020,BTN,Kedah,0,0,0,Bhutan
7035,5/1/2020,BTN,Perak,0,0,0,Bhutan
7036,5/1/2020,BTN,Perlis,0,0,0,Bhutan
7037,5/1/2020,BTN,Pulau Pinang,0,0,0,Bhutan
7038,5/1/2020,BTN,Sabah,0,0,0,Bhutan
7039,5/1/2020,BTN,Sarawak,0,0,0,Bhutan
7040,5/1/2020,BTN,Selangor,0,0,0,Bhutan
7041,5/1/2020,BWA,Johor,0,0,0,Botswana
7042,5/1/2020,BWA,Kedah,0,0,0,Botswana
7043,5/1/2020,BWA,Perlis,0,0,0,Botswana
7044,5/1/2020,BWA,Pulau Pinang,0,0,0,Botswana
7045,5/1/2020,BWA,Sabah,0,0,0,Botswana
7046,5/1/2020,BWA,Sarawak,0,0,0,Botswana
7047,5/1/2020,BWA,Selangor,0,0,0,Botswana
7048,5/1/2020,CAF,Kedah,0,0,0,Central African Republic
7049,5/1/2020,CAF,Selangor,0,0,0,Central African Republic
7050,5/1/2020,CAN,Johor,1,1,0,Canada
7051,5/1/2020,CAN,Kedah,0,0,0,Canada
7052,5/1/2020,CAN,Kelantan,0,0,0,Canada
7053,5/1/2020,CAN,Melaka,0,0,0,Canada
7054,5/1/2020,CAN,Negeri Sembilan,0,0,0,Canada
7055,5/1/2020,CAN,Pahang,0,0,0,Canada
7056,5/1/2020,CAN,Perak,0,0,0,Canada
7057,5/1/2020,CAN,Perlis,0,0,0,Canada
7058,5/1/2020,CAN,Pulau Pinang,0,0,0,Canada
7059,5/1/2020,CAN,Sabah,0,0,0,Canada
7060,5/1/2020,CAN,Sarawak,0,0,0,Canada
7061,5/1/2020,CAN,Selangor,19,17,2,Canada
7062,5/1/2020,CAN,Terengganu,0,0,0,Canada
7063,5/1/2020,CAN,W.P. Labuan,0,0,0,Canada
7064,5/1/2020,CCK,Selangor,0,0,0,Cocos (Keeling) Islands
7065,5/1/2020,CHE,Johor,0,0,0,Switzerland
7066,5/1/2020,CHE,Kedah,0,0,0,Switzerland
7067,5/1/2020,CHE,Kelantan,0,0,0,Switzerland
7068,5/1/2020,CHE,Melaka,0,0,0,Switzerland
7069,5/1/2020,CHE,Negeri Sembilan,0,0,0,Switzerland
7070,5/1/2020,CHE,Pahang,0,0,0,Switzerland
7071,5/1/2020,CHE,Perak,0,0,0,Switzerland
7072,5/1/2020,CHE,Perlis,0,0,0,Switzerland
7073,5/1/2020,CHE,Pulau Pinang,0,0,0,Switzerland
7074,5/1/2020,CHE,Sabah,0,0,0,Switzerland
7075,5/1/2020,CHE,Sarawak,0,0,0,Switzerland
7076,5/1/2020,CHE,Selangor,1,1,0,Switzerland
7077,5/1/2020,CHE,W.P. Labuan,0,0,0,Switzerland
7078,5/1/2020,CHL,Johor,0,0,0,Chile
7079,5/1/2020,CHL,Kedah,0,0,0,Chile
7080,5/1/2020,CHL,Kelantan,0,0,0,Chile
7081,5/1/2020,CHL,Melaka,0,0,0,Chile
7082,5/1/2020,CHL,Pahang,0,0,0,Chile
7083,5/1/2020,CHL,Perak,0,0,0,Chile
7084,5/1/2020,CHL,Perlis,0,0,0,Chile
7085,5/1/2020,CHL,Pulau Pinang,0,0,0,Chile
7086,5/1/2020,CHL,Sabah,0,0,0,Chile
7087,5/1/2020,CHL,Sarawak,0,0,0,Chile
7088,5/1/2020,CHL,Selangor,0,0,0,Chile
7089,5/1/2020,CHN,Johor,2,0,2,China
7090,5/1/2020,CHN,Kedah,0,0,0,China
7091,5/1/2020,CHN,Kelantan,0,0,0,China
7092,5/1/2020,CHN,Melaka,0,0,0,China
7093,5/1/2020,CHN,Pahang,0,0,0,China
7094,5/1/2020,CHN,Perak,0,0,0,China
7095,5/1/2020,CHN,Perlis,0,0,0,China
7096,5/1/2020,CHN,Pulau Pinang,0,0,0,China
7097,5/1/2020,CHN,Sabah,0,0,0,China
7098,5/1/2020,CHN,Sarawak,0,0,0,China
7099,5/1/2020,CHN,Selangor,21,11,10,China
7100,5/1/2020,CHN,Terengganu,0,0,0,China
7101,5/1/2020,CHN,W.P. Labuan,0,0,0,China
7102,5/1/2020,CIV,Johor,0,0,0,C��te d'Iv
7103,5/1/2020,CIV,Kedah,0,0,0,C��te d'Iv
7104,5/1/2020,CIV,Pulau Pinang,0,0,0,C��te d'Iv
7105,5/1/2020,CIV,Sabah,0,0,0,C��te d'Iv
7106,5/1/2020,CIV,Sarawak,0,0,0,C��te d'Iv
7107,5/1/2020,CIV,Selangor,0,0,0,C��te d'Iv
7108,5/1/2020,CMR,Johor,0,0,0,Cameroon
7109,5/1/2020,CMR,Kedah,0,0,0,Cameroon
7110,5/1/2020,CMR,Pulau Pinang,0,0,0,Cameroon
7111,5/1/2020,CMR,Sabah,0,0,0,Cameroon
7112,5/1/2020,CMR,Sarawak,0,0,0,Cameroon
7113,5/1/2020,CMR,Selangor,0,0,0,Cameroon
7114,5/1/2020,COD,Johor,0,0,0,"Congo, the Democratic Republic of the"
7115,5/1/2020,COD,Pulau Pinang,0,0,0,"Congo, the Democratic Republic of the"
7116,5/1/2020,COD,Sarawak,0,0,0,"Congo, the Democratic Republic of the"
7117,5/1/2020,COD,Selangor,0,0,0,"Congo, the Democratic Republic of the"
7118,5/1/2020,COG,Johor,0,0,0,Congo
7119,5/1/2020,COG,Kedah,0,0,0,Congo
7120,5/1/2020,COG,Selangor,0,0,0,Congo
7121,5/1/2020,COK,Selangor,0,0,0,Cook Islands
7122,5/1/2020,COL,Johor,0,0,0,Colombia
7123,5/1/2020,COL,Kedah,0,0,0,Colombia
7124,5/1/2020,COL,Perak,0,0,0,Colombia
7125,5/1/2020,COL,Pulau Pinang,0,0,0,Colombia
7126,5/1/2020,COL,Sabah,0,0,0,Colombia
7127,5/1/2020,COL,Sarawak,0,0,0,Colombia
7128,5/1/2020,COL,Selangor,0,0,0,Colombia
7129,5/1/2020,COL,W.P. Labuan,0,0,0,Colombia
7130,5/1/2020,COM,Johor,0,0,0,Comoros
7131,5/1/2020,COM,Kedah,0,0,0,Comoros
7132,5/1/2020,COM,Selangor,0,0,0,Comoros
7133,5/1/2020,CPV,Johor,0,0,0,Cape Verde
7134,5/1/2020,CPV,Kedah,0,0,0,Cape Verde
7135,5/1/2020,CPV,Pulau Pinang,0,0,0,Cape Verde
7136,5/1/2020,CPV,Sabah,0,0,0,Cape Verde
7137,5/1/2020,CPV,Selangor,0,0,0,Cape Verde
7138,5/1/2020,CRI,Johor,0,0,0,Costa Rica
7139,5/1/2020,CRI,Kedah,0,0,0,Costa Rica
7140,5/1/2020,CRI,Perak,0,0,0,Costa Rica
7141,5/1/2020,CRI,Perlis,0,0,0,Costa Rica
7142,5/1/2020,CRI,Pulau Pinang,0,0,0,Costa Rica
7143,5/1/2020,CRI,Sabah,0,0,0,Costa Rica
7144,5/1/2020,CRI,Sarawak,0,0,0,Costa Rica
7145,5/1/2020,CRI,Selangor,0,0,0,Costa Rica
7146,5/1/2020,CUB,Johor,0,0,0,Cuba
7147,5/1/2020,CUB,Kedah,0,0,0,Cuba
7148,5/1/2020,CUB,Perlis,0,0,0,Cuba
7149,5/1/2020,CUB,Pulau Pinang,0,0,0,Cuba
7150,5/1/2020,CUB,Sabah,0,0,0,Cuba
7151,5/1/2020,CUB,Sarawak,0,0,0,Cuba
7152,5/1/2020,CUB,Selangor,0,0,0,Cuba
7153,5/1/2020,CYP,Johor,0,0,0,Cyprus
7154,5/1/2020,CYP,Kedah,0,0,0,Cyprus
7155,5/1/2020,CYP,Perak,0,0,0,Cyprus
7156,5/1/2020,CYP,Perlis,0,0,0,Cyprus
7157,5/1/2020,CYP,Pulau Pinang,0,0,0,Cyprus
7158,5/1/2020,CYP,Sabah,0,0,0,Cyprus
7159,5/1/2020,CYP,Sarawak,0,0,0,Cyprus
7160,5/1/2020,CYP,Selangor,0,0,0,Cyprus
7161,5/1/2020,CZE,Johor,0,0,0,Czech Republic
7162,5/1/2020,CZE,Kedah,0,0,0,Czech Republic
7163,5/1/2020,CZE,Kelantan,0,0,0,Czech Republic
7164,5/1/2020,CZE,Melaka,0,0,0,Czech Republic
7165,5/1/2020,CZE,Negeri Sembilan,0,0,0,Czech Republic
7166,5/1/2020,CZE,Perak,0,0,0,Czech Republic
7167,5/1/2020,CZE,Perlis,0,0,0,Czech Republic
7168,5/1/2020,CZE,Pulau Pinang,0,0,0,Czech Republic
7169,5/1/2020,CZE,Sabah,0,0,0,Czech Republic
7170,5/1/2020,CZE,Sarawak,0,0,0,Czech Republic
7171,5/1/2020,CZE,Selangor,1,1,0,Czech Republic
7172,5/1/2020,CZE,W.P. Labuan,0,0,0,Czech Republic
7173,5/1/2020,DEU,Johor,0,0,0,Germany
7174,5/1/2020,DEU,Kedah,0,0,0,Germany
7175,5/1/2020,DEU,Kelantan,0,0,0,Germany
7176,5/1/2020,DEU,Melaka,0,0,0,Germany
7177,5/1/2020,DEU,Negeri Sembilan,0,0,0,Germany
7178,5/1/2020,DEU,Pahang,0,0,0,Germany
7179,5/1/2020,DEU,Perak,0,0,0,Germany
7180,5/1/2020,DEU,Perlis,0,0,0,Germany
7181,5/1/2020,DEU,Pulau Pinang,0,0,0,Germany
7182,5/1/2020,DEU,Sabah,0,0,0,Germany
7183,5/1/2020,DEU,Sarawak,0,0,0,Germany
7184,5/1/2020,DEU,Selangor,4,2,2,Germany
7185,5/1/2020,DEU,Terengganu,0,0,0,Germany
7186,5/1/2020,DEU,W.P. Labuan,0,0,0,Germany
7187,5/1/2020,DJI,Johor,0,0,0,Djibouti
7188,5/1/2020,DJI,Selangor,0,0,0,Djibouti
7189,5/1/2020,DMA,Johor,0,0,0,Dominica
7190,5/1/2020,DMA,Kedah,0,0,0,Dominica
7191,5/1/2020,DMA,Pulau Pinang,0,0,0,Dominica
7192,5/1/2020,DMA,Sabah,0,0,0,Dominica
7193,5/1/2020,DMA,Sarawak,0,0,0,Dominica
7194,5/1/2020,DMA,Selangor,0,0,0,Dominica
7195,5/1/2020,DMA,W.P. Labuan,0,0,0,Dominica
7196,5/1/2020,DNK,Johor,0,0,0,Denmark
7197,5/1/2020,DNK,Kedah,0,0,0,Denmark
7198,5/1/2020,DNK,Kelantan,0,0,0,Denmark
7199,5/1/2020,DNK,Melaka,0,0,0,Denmark
7200,5/1/2020,DNK,Negeri Sembilan,0,0,0,Denmark
7201,5/1/2020,DNK,Pahang,0,0,0,Denmark
7202,5/1/2020,DNK,Perak,0,0,0,Denmark
7203,5/1/2020,DNK,Perlis,0,0,0,Denmark
7204,5/1/2020,DNK,Pulau Pinang,0,0,0,Denmark
7205,5/1/2020,DNK,Sabah,0,0,0,Denmark
7206,5/1/2020,DNK,Sarawak,0,0,0,Denmark
7207,5/1/2020,DNK,Selangor,0,0,0,Denmark
7208,5/1/2020,DNK,W.P. Labuan,0,0,0,Denmark
7209,5/1/2020,DOM,Johor,0,0,0,Dominican Republic
7210,5/1/2020,DOM,Kedah,0,0,0,Dominican Republic
7211,5/1/2020,DOM,Perak,0,0,0,Dominican Republic
7212,5/1/2020,DOM,Perlis,0,0,0,Dominican Republic
7213,5/1/2020,DOM,Pulau Pinang,0,0,0,Dominican Republic
7214,5/1/2020,DOM,Sabah,0,0,0,Dominican Republic
7215,5/1/2020,DOM,Sarawak,0,0,0,Dominican Republic
7216,5/1/2020,DOM,Selangor,0,0,0,Dominican Republic
7217,5/1/2020,DZA,Johor,0,0,0,Algeria
7218,5/1/2020,DZA,Kedah,0,0,0,Algeria
7219,5/1/2020,DZA,Kelantan,0,0,0,Algeria
7220,5/1/2020,DZA,Melaka,0,0,0,Algeria
7221,5/1/2020,DZA,Perak,0,0,0,Algeria
7222,5/1/2020,DZA,Perlis,0,0,0,Algeria
7223,5/1/2020,DZA,Pulau Pinang,0,0,0,Algeria
7224,5/1/2020,DZA,Sabah,0,0,0,Algeria
7225,5/1/2020,DZA,Sarawak,0,0,0,Algeria
7226,5/1/2020,DZA,Selangor,0,0,0,Algeria
7227,5/1/2020,DZA,W.P. Labuan,0,0,0,Algeria
7228,5/1/2020,ECU,Johor,0,0,0,Ecuador
7229,5/1/2020,ECU,Kedah,0,0,0,Ecuador
7230,5/1/2020,ECU,Perak,0,0,0,Ecuador
7231,5/1/2020,ECU,Perlis,0,0,0,Ecuador
7232,5/1/2020,ECU,Pulau Pinang,0,0,0,Ecuador
7233,5/1/2020,ECU,Sabah,0,0,0,Ecuador
7234,5/1/2020,ECU,Sarawak,0,0,0,Ecuador
7235,5/1/2020,ECU,Selangor,0,0,0,Ecuador
7236,5/1/2020,EGY,Johor,0,0,0,Egypt
7237,5/1/2020,EGY,Kedah,0,0,0,Egypt
7238,5/1/2020,EGY,Kelantan,0,0,0,Egypt
7239,5/1/2020,EGY,Melaka,0,0,0,Egypt
7240,5/1/2020,EGY,Pahang,0,0,0,Egypt
7241,5/1/2020,EGY,Perak,0,0,0,Egypt
7242,5/1/2020,EGY,Perlis,0,0,0,Egypt
7243,5/1/2020,EGY,Pulau Pinang,0,0,0,Egypt
7244,5/1/2020,EGY,Sabah,0,0,0,Egypt
7245,5/1/2020,EGY,Sarawak,0,0,0,Egypt
7246,5/1/2020,EGY,Selangor,13,11,2,Egypt
7247,5/1/2020,EGY,Terengganu,0,0,0,Egypt
7248,5/1/2020,EGY,W.P. Labuan,0,0,0,Egypt
7249,5/1/2020,ERI,Johor,0,0,0,Eritrea
7250,5/1/2020,ERI,Pulau Pinang,0,0,0,Eritrea
7251,5/1/2020,ERI,Sabah,0,0,0,Eritrea
7252,5/1/2020,ERI,Selangor,0,0,0,Eritrea
7253,5/1/2020,ESP,Johor,0,0,0,Spain
7254,5/1/2020,ESP,Kedah,0,0,0,Spain
7255,5/1/2020,ESP,Kelantan,0,0,0,Spain
7256,5/1/2020,ESP,Melaka,0,0,0,Spain
7257,5/1/2020,ESP,Negeri Sembilan,0,0,0,Spain
7258,5/1/2020,ESP,Pahang,0,0,0,Spain
7259,5/1/2020,ESP,Perak,0,0,0,Spain
7260,5/1/2020,ESP,Perlis,0,0,0,Spain
7261,5/1/2020,ESP,Pulau Pinang,0,0,0,Spain
7262,5/1/2020,ESP,Sabah,0,0,0,Spain
7263,5/1/2020,ESP,Sarawak,0,0,0,Spain
7264,5/1/2020,ESP,Selangor,0,0,0,Spain
7265,5/1/2020,ESP,W.P. Labuan,0,0,0,Spain
7266,5/1/2020,EST,Johor,0,0,0,Estonia
7267,5/1/2020,EST,Kedah,0,0,0,Estonia
7268,5/1/2020,EST,Kelantan,0,0,0,Estonia
7269,5/1/2020,EST,Pahang,0,0,0,Estonia
7270,5/1/2020,EST,Perak,0,0,0,Estonia
7271,5/1/2020,EST,Perlis,0,0,0,Estonia
7272,5/1/2020,EST,Pulau Pinang,0,0,0,Estonia
7273,5/1/2020,EST,Sabah,0,0,0,Estonia
7274,5/1/2020,EST,Sarawak,0,0,0,Estonia
7275,5/1/2020,EST,Selangor,0,0,0,Estonia
7276,5/1/2020,EST,W.P. Labuan,0,0,0,Estonia
7277,5/1/2020,ETH,Johor,0,0,0,Ethiopia
7278,5/1/2020,ETH,Kedah,0,0,0,Ethiopia
7279,5/1/2020,ETH,Pulau Pinang,0,0,0,Ethiopia
7280,5/1/2020,ETH,Sarawak,0,0,0,Ethiopia
7281,5/1/2020,ETH,Selangor,0,0,0,Ethiopia
7282,5/1/2020,FIN,Johor,0,0,0,Finland
7283,5/1/2020,FIN,Kedah,0,0,0,Finland
7284,5/1/2020,FIN,Kelantan,0,0,0,Finland
7285,5/1/2020,FIN,Melaka,0,0,0,Finland
7286,5/1/2020,FIN,Negeri Sembilan,0,0,0,Finland
7287,5/1/2020,FIN,Pahang,0,0,0,Finland
7288,5/1/2020,FIN,Perak,0,0,0,Finland
7289,5/1/2020,FIN,Perlis,0,0,0,Finland
7290,5/1/2020,FIN,Pulau Pinang,0,0,0,Finland
7291,5/1/2020,FIN,Sabah,0,0,0,Finland
7292,5/1/2020,FIN,Sarawak,0,0,0,Finland
7293,5/1/2020,FIN,Selangor,2,1,1,Finland
7294,5/1/2020,FIN,W.P. Labuan,0,0,0,Finland
7295,5/1/2020,FJI,Johor,0,0,0,Fiji
7296,5/1/2020,FJI,Kedah,0,0,0,Fiji
7297,5/1/2020,FJI,Kelantan,0,0,0,Fiji
7298,5/1/2020,FJI,Perak,0,0,0,Fiji
7299,5/1/2020,FJI,Perlis,0,0,0,Fiji
7300,5/1/2020,FJI,Pulau Pinang,0,0,0,Fiji
7301,5/1/2020,FJI,Sabah,0,0,0,Fiji
7302,5/1/2020,FJI,Sarawak,0,0,0,Fiji
7303,5/1/2020,FJI,Selangor,0,0,0,Fiji
7304,5/1/2020,FRA,Johor,0,0,0,France
7305,5/1/2020,FRA,Kedah,0,0,0,France
7306,5/1/2020,FRA,Kelantan,0,0,0,France
7307,5/1/2020,FRA,Melaka,0,0,0,France
7308,5/1/2020,FRA,Negeri Sembilan,0,0,0,France
7309,5/1/2020,FRA,Pahang,0,0,0,France
7310,5/1/2020,FRA,Perak,0,0,0,France
7311,5/1/2020,FRA,Perlis,0,0,0,France
7312,5/1/2020,FRA,Pulau Pinang,0,0,0,France
7313,5/1/2020,FRA,Sabah,0,0,0,France
7314,5/1/2020,FRA,Sarawak,0,0,0,France
7315,5/1/2020,FRA,Selangor,7,7,0,France
7316,5/1/2020,FRA,Terengganu,0,0,0,France
7317,5/1/2020,FRA,W.P. Labuan,0,0,0,France
7318,5/1/2020,FSM,Johor,0,0,0,"Micronesia, Federated States of"
7319,5/1/2020,FSM,Pulau Pinang,0,0,0,"Micronesia, Federated States of"
7320,5/1/2020,FSM,Selangor,0,0,0,"Micronesia, Federated States of"
7321,5/1/2020,GAB,Johor,0,0,0,Gabon
7322,5/1/2020,GAB,Pulau Pinang,0,0,0,Gabon
7323,5/1/2020,GAB,Sarawak,0,0,0,Gabon
7324,5/1/2020,GAB,Selangor,0,0,0,Gabon
7325,5/1/2020,GBR,Johor,3,3,0,United Kingdom
7326,5/1/2020,GBR,Kedah,2,1,1,United Kingdom
7327,5/1/2020,GBR,Kelantan,0,0,0,United Kingdom
7328,5/1/2020,GBR,Melaka,0,0,0,United Kingdom
7329,5/1/2020,GBR,Negeri Sembilan,0,0,0,United Kingdom
7330,5/1/2020,GBR,Pahang,0,0,0,United Kingdom
7331,5/1/2020,GBR,Perak,0,0,0,United Kingdom
7332,5/1/2020,GBR,Perlis,0,0,0,United Kingdom
7333,5/1/2020,GBR,Pulau Pinang,0,0,0,United Kingdom
7334,5/1/2020,GBR,Sabah,0,0,0,United Kingdom
7335,5/1/2020,GBR,Sarawak,0,0,0,United Kingdom
7336,5/1/2020,GBR,Selangor,54,52,2,United Kingdom
7337,5/1/2020,GBR,Terengganu,0,0,0,United Kingdom
7338,5/1/2020,GBR,W.P. Labuan,0,0,0,United Kingdom
7339,5/1/2020,GEO,Johor,0,0,0,Georgia
7340,5/1/2020,GEO,Kedah,0,0,0,Georgia
7341,5/1/2020,GEO,Melaka,0,0,0,Georgia
7342,5/1/2020,GEO,Perak,0,0,0,Georgia
7343,5/1/2020,GEO,Perlis,0,0,0,Georgia
7344,5/1/2020,GEO,Pulau Pinang,0,0,0,Georgia
7345,5/1/2020,GEO,Sabah,0,0,0,Georgia
7346,5/1/2020,GEO,Sarawak,0,0,0,Georgia
7347,5/1/2020,GEO,Selangor,0,0,0,Georgia
7348,5/1/2020,GHA,Johor,0,0,0,Ghana
7349,5/1/2020,GHA,Kedah,0,0,0,Ghana
7350,5/1/2020,GHA,Kelantan,0,0,0,Ghana
7351,5/1/2020,GHA,Pulau Pinang,0,0,0,Ghana
7352,5/1/2020,GHA,Sabah,0,0,0,Ghana
7353,5/1/2020,GHA,Sarawak,0,0,0,Ghana
7354,5/1/2020,GHA,Selangor,0,0,0,Ghana
7355,5/1/2020,GIB,Johor,0,0,0,Gibraltar
7356,5/1/2020,GIB,Sarawak,0,0,0,Gibraltar
7357,5/1/2020,GIN,Johor,0,0,0,Guinea
7358,5/1/2020,GIN,Kedah,0,0,0,Guinea
7359,5/1/2020,GIN,Kelantan,0,0,0,Guinea
7360,5/1/2020,GIN,Perlis,0,0,0,Guinea
7361,5/1/2020,GIN,Pulau Pinang,0,0,0,Guinea
7362,5/1/2020,GIN,Sabah,0,0,0,Guinea
7363,5/1/2020,GIN,Sarawak,0,0,0,Guinea
7364,5/1/2020,GIN,Selangor,0,0,0,Guinea
7365,5/1/2020,GLP,Selangor,0,0,0,Guadeloupe
7366,5/1/2020,GMB,Johor,0,0,0,Gambia
7367,5/1/2020,GMB,Kedah,0,0,0,Gambia
7368,5/1/2020,GMB,Kelantan,0,0,0,Gambia
7369,5/1/2020,GMB,Pulau Pinang,0,0,0,Gambia
7370,5/1/2020,GMB,Sabah,0,0,0,Gambia
7371,5/1/2020,GMB,Sarawak,0,0,0,Gambia
7372,5/1/2020,GMB,Selangor,0,0,0,Gambia
7373,5/1/2020,GNB,Johor,0,0,0,Guinea-Bissau
7374,5/1/2020,GNB,Selangor,0,0,0,Guinea-Bissau
7375,5/1/2020,GNQ,Johor,0,0,0,Equatorial Guinea
7376,5/1/2020,GNQ,Selangor,0,0,0,Equatorial Guinea
7377,5/1/2020,GRC,Johor,0,0,0,Greece
7378,5/1/2020,GRC,Kedah,0,0,0,Greece
7379,5/1/2020,GRC,Kelantan,0,0,0,Greece
7380,5/1/2020,GRC,Melaka,0,0,0,Greece
7381,5/1/2020,GRC,Negeri Sembilan,0,0,0,Greece
7382,5/1/2020,GRC,Pahang,0,0,0,Greece
7383,5/1/2020,GRC,Perak,0,0,0,Greece
7384,5/1/2020,GRC,Perlis,0,0,0,Greece
7385,5/1/2020,GRC,Pulau Pinang,0,0,0,Greece
7386,5/1/2020,GRC,Sabah,0,0,0,Greece
7387,5/1/2020,GRC,Sarawak,0,0,0,Greece
7388,5/1/2020,GRC,Selangor,0,0,0,Greece
7389,5/1/2020,GRD,Johor,0,0,0,Grenada
7390,5/1/2020,GRD,Kedah,0,0,0,Grenada
7391,5/1/2020,GRD,Pulau Pinang,0,0,0,Grenada
7392,5/1/2020,GRD,Sabah,0,0,0,Grenada
7393,5/1/2020,GRD,Sarawak,0,0,0,Grenada
7394,5/1/2020,GRD,Selangor,0,0,0,Grenada
7395,5/1/2020,GRL,Johor,0,0,0,Greenland
7396,5/1/2020,GRL,Selangor,0,0,0,Greenland
7397,5/1/2020,GTM,Johor,0,0,0,Guatemala
7398,5/1/2020,GTM,Kedah,0,0,0,Guatemala
7399,5/1/2020,GTM,Pahang,0,0,0,Guatemala
7400,5/1/2020,GTM,Perak,0,0,0,Guatemala
7401,5/1/2020,GTM,Pulau Pinang,0,0,0,Guatemala
7402,5/1/2020,GTM,Sabah,0,0,0,Guatemala
7403,5/1/2020,GTM,Sarawak,0,0,0,Guatemala
7404,5/1/2020,GTM,Selangor,0,0,0,Guatemala
7405,5/1/2020,GTM,W.P. Labuan,0,0,0,Guatemala
7406,5/1/2020,GUY,Johor,0,0,0,Guyana
7407,5/1/2020,GUY,Kedah,0,0,0,Guyana
7408,5/1/2020,GUY,Pulau Pinang,0,0,0,Guyana
7409,5/1/2020,GUY,Sarawak,0,0,0,Guyana
7410,5/1/2020,GUY,Selangor,0,0,0,Guyana
7411,5/1/2020,HKG,Johor,0,0,0,Hong Kong
7412,5/1/2020,HKG,Kedah,0,0,0,Hong Kong
7413,5/1/2020,HKG,Kelantan,0,0,0,Hong Kong
7414,5/1/2020,HKG,Pahang,0,0,0,Hong Kong
7415,5/1/2020,HKG,Perak,0,0,0,Hong Kong
7416,5/1/2020,HKG,Perlis,0,0,0,Hong Kong
7417,5/1/2020,HKG,Pulau Pinang,0,0,0,Hong Kong
7418,5/1/2020,HKG,Sabah,0,0,0,Hong Kong
7419,5/1/2020,HKG,Sarawak,0,0,0,Hong Kong
7420,5/1/2020,HKG,Selangor,0,0,0,Hong Kong
7421,5/1/2020,HKG,Terengganu,0,0,0,Hong Kong
7422,5/1/2020,HMD,Johor,0,0,0,Heard Island and McDonald Islands
7423,5/1/2020,HND,Johor,0,0,0,Honduras
7424,5/1/2020,HND,Kedah,0,0,0,Honduras
7425,5/1/2020,HND,Perak,0,0,0,Honduras
7426,5/1/2020,HND,Pulau Pinang,0,0,0,Honduras
7427,5/1/2020,HND,Sabah,0,0,0,Honduras
7428,5/1/2020,HND,Sarawak,0,0,0,Honduras
7429,5/1/2020,HND,Selangor,0,0,0,Honduras
7430,5/1/2020,HRV,Johor,0,0,0,Croatia
7431,5/1/2020,HRV,Kedah,0,0,0,Croatia
7432,5/1/2020,HRV,Kelantan,0,0,0,Croatia
7433,5/1/2020,HRV,Melaka,0,0,0,Croatia
7434,5/1/2020,HRV,Pahang,0,0,0,Croatia
7435,5/1/2020,HRV,Perak,0,0,0,Croatia
7436,5/1/2020,HRV,Perlis,0,0,0,Croatia
7437,5/1/2020,HRV,Pulau Pinang,0,0,0,Croatia
7438,5/1/2020,HRV,Sabah,0,0,0,Croatia
7439,5/1/2020,HRV,Sarawak,0,0,0,Croatia
7440,5/1/2020,HRV,Selangor,8,8,0,Croatia
7441,5/1/2020,HTI,Johor,0,0,0,Haiti
7442,5/1/2020,HTI,Kedah,0,0,0,Haiti
7443,5/1/2020,HTI,Kelantan,0,0,0,Haiti
7444,5/1/2020,HTI,Perak,0,0,0,Haiti
7445,5/1/2020,HTI,Pulau Pinang,0,0,0,Haiti
7446,5/1/2020,HTI,Sabah,0,0,0,Haiti
7447,5/1/2020,HTI,Selangor,0,0,0,Haiti
7448,5/1/2020,HUN,Johor,0,0,0,Hungary
7449,5/1/2020,HUN,Kedah,0,0,0,Hungary
7450,5/1/2020,HUN,Kelantan,0,0,0,Hungary
7451,5/1/2020,HUN,Pahang,0,0,0,Hungary
7452,5/1/2020,HUN,Perak,0,0,0,Hungary
7453,5/1/2020,HUN,Perlis,0,0,0,Hungary
7454,5/1/2020,HUN,Pulau Pinang,0,0,0,Hungary
7455,5/1/2020,HUN,Sabah,0,0,0,Hungary
7456,5/1/2020,HUN,Sarawak,0,0,0,Hungary
7457,5/1/2020,HUN,Selangor,0,0,0,Hungary
7458,5/1/2020,HUN,W.P. Labuan,0,0,0,Hungary
7459,5/1/2020,IDN,Johor,40,37,3,Indonesia
7460,5/1/2020,IDN,Kedah,8,8,0,Indonesia
7461,5/1/2020,IDN,Kelantan,0,0,0,Indonesia
7462,5/1/2020,IDN,Melaka,0,0,0,Indonesia
7463,5/1/2020,IDN,Negeri Sembilan,0,0,0,Indonesia
7464,5/1/2020,IDN,Pahang,2,2,0,Indonesia
7465,5/1/2020,IDN,Perak,0,0,0,Indonesia
7466,5/1/2020,IDN,Perlis,0,0,0,Indonesia
7467,5/1/2020,IDN,Pulau Pinang,0,0,0,Indonesia
7468,5/1/2020,IDN,Sabah,8,1,7,Indonesia
7469,5/1/2020,IDN,Sarawak,100,90,10,Indonesia
7470,5/1/2020,IDN,Selangor,75,34,41,Indonesia
7471,5/1/2020,IDN,Terengganu,0,0,0,Indonesia
7472,5/1/2020,IDN,W.P. Labuan,1,1,0,Indonesia
7473,5/1/2020,IND,Johor,3,1,2,India
7474,5/1/2020,IND,Kedah,0,0,0,India
7475,5/1/2020,IND,Kelantan,0,0,0,India
7476,5/1/2020,IND,Melaka,0,0,0,India
7477,5/1/2020,IND,Negeri Sembilan,0,0,0,India
7478,5/1/2020,IND,Pahang,0,0,0,India
7479,5/1/2020,IND,Perak,0,0,0,India
7480,5/1/2020,IND,Perlis,0,0,0,India
7481,5/1/2020,IND,Pulau Pinang,0,0,0,India
7482,5/1/2020,IND,Sabah,0,0,0,India
7483,5/1/2020,IND,Sarawak,0,0,0,India
7484,5/1/2020,IND,Selangor,35,20,15,India
7485,5/1/2020,IND,Terengganu,0,0,0,India
7486,5/1/2020,IND,W.P. Labuan,0,0,0,India
7487,5/1/2020,IOT,Pulau Pinang,0,0,0,British Indian Ocean Territory
7488,5/1/2020,IOT,Selangor,0,0,0,British Indian Ocean Territory
7489,5/1/2020,IRL,Johor,0,0,0,Ireland
7490,5/1/2020,IRL,Kedah,0,0,0,Ireland
7491,5/1/2020,IRL,Kelantan,0,0,0,Ireland
7492,5/1/2020,IRL,Negeri Sembilan,0,0,0,Ireland
7493,5/1/2020,IRL,Pahang,0,0,0,Ireland
7494,5/1/2020,IRL,Perak,0,0,0,Ireland
7495,5/1/2020,IRL,Perlis,0,0,0,Ireland
7496,5/1/2020,IRL,Pulau Pinang,0,0,0,Ireland
7497,5/1/2020,IRL,Sabah,0,0,0,Ireland
7498,5/1/2020,IRL,Sarawak,0,0,0,Ireland
7499,5/1/2020,IRL,Selangor,6,4,2,Ireland
7500,5/1/2020,IRL,Terengganu,0,0,0,Ireland
7501,5/1/2020,IRL,W.P. Labuan,0,0,0,Ireland
7502,5/1/2020,IRN,Johor,0,0,0,Iran
7503,5/1/2020,IRN,Kedah,0,0,0,Iran
7504,5/1/2020,IRN,Kelantan,0,0,0,Iran
7505,5/1/2020,IRN,Perak,0,0,0,Iran
7506,5/1/2020,IRN,Perlis,0,0,0,Iran
7507,5/1/2020,IRN,Pulau Pinang,0,0,0,Iran
7508,5/1/2020,IRN,Sabah,0,0,0,Iran
7509,5/1/2020,IRN,Sarawak,0,0,0,Iran
7510,5/1/2020,IRN,Selangor,1,1,0,Iran
7511,5/1/2020,IRN,W.P. Labuan,0,0,0,Iran
7512,5/1/2020,IRQ,Johor,0,0,0,Iraq
7513,5/1/2020,IRQ,Kedah,0,0,0,Iraq
7514,5/1/2020,IRQ,Kelantan,0,0,0,Iraq
7515,5/1/2020,IRQ,Melaka,0,0,0,Iraq
7516,5/1/2020,IRQ,Pahang,0,0,0,Iraq
7517,5/1/2020,IRQ,Perak,0,0,0,Iraq
7518,5/1/2020,IRQ,Perlis,0,0,0,Iraq
7519,5/1/2020,IRQ,Pulau Pinang,0,0,0,Iraq
7520,5/1/2020,IRQ,Sabah,0,0,0,Iraq
7521,5/1/2020,IRQ,Sarawak,0,0,0,Iraq
7522,5/1/2020,IRQ,Selangor,0,0,0,Iraq
7523,5/1/2020,ISL,Johor,0,0,0,Iceland
7524,5/1/2020,ISL,Kedah,0,0,0,Iceland
7525,5/1/2020,ISL,Kelantan,0,0,0,Iceland
7526,5/1/2020,ISL,Perak,0,0,0,Iceland
7527,5/1/2020,ISL,Perlis,0,0,0,Iceland
7528,5/1/2020,ISL,Pulau Pinang,0,0,0,Iceland
7529,5/1/2020,ISL,Sabah,0,0,0,Iceland
7530,5/1/2020,ISL,Sarawak,0,0,0,Iceland
7531,5/1/2020,ISL,Selangor,0,0,0,Iceland
7532,5/1/2020,ISL,W.P. Labuan,0,0,0,Iceland
7533,5/1/2020,ISR,Pulau Pinang,0,0,0,Israel
7534,5/1/2020,ITA,Johor,0,0,0,Italy
7535,5/1/2020,ITA,Kedah,0,0,0,Italy
7536,5/1/2020,ITA,Kelantan,0,0,0,Italy
7537,5/1/2020,ITA,Melaka,0,0,0,Italy
7538,5/1/2020,ITA,Negeri Sembilan,0,0,0,Italy
7539,5/1/2020,ITA,Pahang,0,0,0,Italy
7540,5/1/2020,ITA,Perak,0,0,0,Italy
7541,5/1/2020,ITA,Perlis,0,0,0,Italy
7542,5/1/2020,ITA,Pulau Pinang,0,0,0,Italy
7543,5/1/2020,ITA,Sabah,0,0,0,Italy
7544,5/1/2020,ITA,Sarawak,0,0,0,Italy
7545,5/1/2020,ITA,Selangor,0,0,0,Italy
7546,5/1/2020,ITA,W.P. Labuan,0,0,0,Italy
7547,5/1/2020,JAM,Johor,0,0,0,Jamaica
7548,5/1/2020,JAM,Kedah,0,0,0,Jamaica
7549,5/1/2020,JAM,Perak,0,0,0,Jamaica
7550,5/1/2020,JAM,Pulau Pinang,0,0,0,Jamaica
7551,5/1/2020,JAM,Sabah,0,0,0,Jamaica
7552,5/1/2020,JAM,Sarawak,0,0,0,Jamaica
7553,5/1/2020,JAM,Selangor,0,0,0,Jamaica
7554,5/1/2020,JAM,W.P. Labuan,0,0,0,Jamaica
7555,5/1/2020,JOR,Johor,0,0,0,Jordan
7556,5/1/2020,JOR,Kedah,0,0,0,Jordan
7557,5/1/2020,JOR,Kelantan,0,0,0,Jordan
7558,5/1/2020,JOR,Melaka,0,0,0,Jordan
7559,5/1/2020,JOR,Perlis,0,0,0,Jordan
7560,5/1/2020,JOR,Pulau Pinang,0,0,0,Jordan
7561,5/1/2020,JOR,Sabah,0,0,0,Jordan
7562,5/1/2020,JOR,Sarawak,0,0,0,Jordan
7563,5/1/2020,JOR,Selangor,0,0,0,Jordan
7564,5/1/2020,JOR,W.P. Labuan,0,0,0,Jordan
7565,5/1/2020,JPN,Johor,0,0,0,Japan
7566,5/1/2020,JPN,Kedah,0,0,0,Japan
7567,5/1/2020,JPN,Kelantan,0,0,0,Japan
7568,5/1/2020,JPN,Melaka,0,0,0,Japan
7569,5/1/2020,JPN,Negeri Sembilan,0,0,0,Japan
7570,5/1/2020,JPN,Pahang,0,0,0,Japan
7571,5/1/2020,JPN,Perak,0,0,0,Japan
7572,5/1/2020,JPN,Perlis,0,0,0,Japan
7573,5/1/2020,JPN,Pulau Pinang,0,0,0,Japan
7574,5/1/2020,JPN,Sabah,0,0,0,Japan
7575,5/1/2020,JPN,Sarawak,0,0,0,Japan
7576,5/1/2020,JPN,Selangor,8,6,2,Japan
7577,5/1/2020,JPN,W.P. Labuan,0,0,0,Japan
7578,5/1/2020,KAZ,Johor,0,0,0,Kazakhstan
7579,5/1/2020,KAZ,Kedah,0,0,0,Kazakhstan
7580,5/1/2020,KAZ,Kelantan,0,0,0,Kazakhstan
7581,5/1/2020,KAZ,Melaka,0,0,0,Kazakhstan
7582,5/1/2020,KAZ,Perak,0,0,0,Kazakhstan
7583,5/1/2020,KAZ,Perlis,0,0,0,Kazakhstan
7584,5/1/2020,KAZ,Pulau Pinang,0,0,0,Kazakhstan
7585,5/1/2020,KAZ,Sabah,0,0,0,Kazakhstan
7586,5/1/2020,KAZ,Sarawak,0,0,0,Kazakhstan
7587,5/1/2020,KAZ,Selangor,0,0,0,Kazakhstan
7588,5/1/2020,KAZ,W.P. Labuan,0,0,0,Kazakhstan
7589,5/1/2020,KEN,Johor,0,0,0,Kenya
7590,5/1/2020,KEN,Kedah,0,0,0,Kenya
7591,5/1/2020,KEN,Kelantan,0,0,0,Kenya
7592,5/1/2020,KEN,Perak,0,0,0,Kenya
7593,5/1/2020,KEN,Perlis,0,0,0,Kenya
7594,5/1/2020,KEN,Pulau Pinang,0,0,0,Kenya
7595,5/1/2020,KEN,Sabah,0,0,0,Kenya
7596,5/1/2020,KEN,Sarawak,0,0,0,Kenya
7597,5/1/2020,KEN,Selangor,0,0,0,Kenya
7598,5/1/2020,KGZ,Johor,0,0,0,Kyrgyzstan
7599,5/1/2020,KGZ,Kedah,0,0,0,Kyrgyzstan
7600,5/1/2020,KGZ,Kelantan,0,0,0,Kyrgyzstan
7601,5/1/2020,KGZ,Perak,0,0,0,Kyrgyzstan
7602,5/1/2020,KGZ,Perlis,0,0,0,Kyrgyzstan
7603,5/1/2020,KGZ,Pulau Pinang,0,0,0,Kyrgyzstan
7604,5/1/2020,KGZ,Sabah,0,0,0,Kyrgyzstan
7605,5/1/2020,KGZ,Sarawak,0,0,0,Kyrgyzstan
7606,5/1/2020,KGZ,Selangor,0,0,0,Kyrgyzstan
7607,5/1/2020,KHM,Johor,0,0,0,Cambodia
7608,5/1/2020,KHM,Kedah,0,0,0,Cambodia
7609,5/1/2020,KHM,Kelantan,0,0,0,Cambodia
7610,5/1/2020,KHM,Melaka,0,0,0,Cambodia
7611,5/1/2020,KHM,Negeri Sembilan,0,0,0,Cambodia
7612,5/1/2020,KHM,Pahang,0,0,0,Cambodia
7613,5/1/2020,KHM,Perak,0,0,0,Cambodia
7614,5/1/2020,KHM,Perlis,0,0,0,Cambodia
7615,5/1/2020,KHM,Pulau Pinang,0,0,0,Cambodia
7616,5/1/2020,KHM,Sabah,0,0,0,Cambodia
7617,5/1/2020,KHM,Sarawak,0,0,0,Cambodia
7618,5/1/2020,KHM,Selangor,2,0,2,Cambodia
7619,5/1/2020,KHM,W.P. Labuan,0,0,0,Cambodia
7620,5/1/2020,KIR,Johor,0,0,0,Kiribati
7621,5/1/2020,KIR,Sabah,0,0,0,Kiribati
7622,5/1/2020,KIR,Selangor,0,0,0,Kiribati
7623,5/1/2020,KNA,Johor,0,0,0,Saint Kitts and Nevis
7624,5/1/2020,KNA,Kedah,0,0,0,Saint Kitts and Nevis
7625,5/1/2020,KNA,Perlis,0,0,0,Saint Kitts and Nevis
7626,5/1/2020,KNA,Pulau Pinang,0,0,0,Saint Kitts and Nevis
7627,5/1/2020,KNA,Sabah,0,0,0,Saint Kitts and Nevis
7628,5/1/2020,KNA,Selangor,0,0,0,Saint Kitts and Nevis
7629,5/1/2020,KNA,W.P. Labuan,0,0,0,Saint Kitts and Nevis
7630,5/1/2020,KOR,Johor,0,0,0,"Korea, Republic of (South Korea)"
7631,5/1/2020,KOR,Kedah,0,0,0,"Korea, Republic of (South Korea)"
7632,5/1/2020,KOR,Kelantan,0,0,0,"Korea, Republic of (South Korea)"
7633,5/1/2020,KOR,Melaka,0,0,0,"Korea, Republic of (South Korea)"
7634,5/1/2020,KOR,Negeri Sembilan,0,0,0,"Korea, Republic of (South Korea)"
7635,5/1/2020,KOR,Pahang,0,0,0,"Korea, Republic of (South Korea)"
7636,5/1/2020,KOR,Perak,0,0,0,"Korea, Republic of (South Korea)"
7637,5/1/2020,KOR,Perlis,0,0,0,"Korea, Republic of (South Korea)"
7638,5/1/2020,KOR,Pulau Pinang,0,0,0,"Korea, Republic of (South Korea)"
7639,5/1/2020,KOR,Sabah,0,0,0,"Korea, Republic of (South Korea)"
7640,5/1/2020,KOR,Sarawak,0,0,0,"Korea, Republic of (South Korea)"
7641,5/1/2020,KOR,Selangor,2,1,1,"Korea, Republic of (South Korea)"
7642,5/1/2020,KOR,Terengganu,0,0,0,"Korea, Republic of (South Korea)"
7643,5/1/2020,KOR,W.P. Labuan,0,0,0,"Korea, Republic of (South Korea)"
7644,5/1/2020,KWT,Johor,0,0,0,Kuwait
7645,5/1/2020,KWT,Kedah,0,0,0,Kuwait
7646,5/1/2020,KWT,Kelantan,0,0,0,Kuwait
7647,5/1/2020,KWT,Perak,0,0,0,Kuwait
7648,5/1/2020,KWT,Perlis,0,0,0,Kuwait
7649,5/1/2020,KWT,Pulau Pinang,0,0,0,Kuwait
7650,5/1/2020,KWT,Sabah,0,0,0,Kuwait
7651,5/1/2020,KWT,Sarawak,0,0,0,Kuwait
7652,5/1/2020,KWT,Selangor,0,0,0,Kuwait
7653,5/1/2020,KWT,W.P. Labuan,0,0,0,Kuwait
7654,5/1/2020,LAO,Johor,1,0,1,Lao People's Democratic Republic
7655,5/1/2020,LAO,Kedah,0,0,0,Lao People's Democratic Republic
7656,5/1/2020,LAO,Kelantan,0,0,0,Lao People's Democratic Republic
7657,5/1/2020,LAO,Melaka,0,0,0,Lao People's Democratic Republic
7658,5/1/2020,LAO,Perak,0,0,0,Lao People's Democratic Republic
7659,5/1/2020,LAO,Perlis,0,0,0,Lao People's Democratic Republic
7660,5/1/2020,LAO,Pulau Pinang,0,0,0,Lao People's Democratic Republic
7661,5/1/2020,LAO,Sabah,0,0,0,Lao People's Democratic Republic
7662,5/1/2020,LAO,Sarawak,0,0,0,Lao People's Democratic Republic
7663,5/1/2020,LAO,Selangor,3,0,3,Lao People's Democratic Republic
7664,5/1/2020,LAO,W.P. Labuan,0,0,0,Lao People's Democratic Republic
7665,5/1/2020,LBN,Johor,0,0,0,Lebanon
7666,5/1/2020,LBN,Kedah,0,0,0,Lebanon
7667,5/1/2020,LBN,Kelantan,0,0,0,Lebanon
7668,5/1/2020,LBN,Pahang,0,0,0,Lebanon
7669,5/1/2020,LBN,Perak,0,0,0,Lebanon
7670,5/1/2020,LBN,Perlis,0,0,0,Lebanon
7671,5/1/2020,LBN,Pulau Pinang,0,0,0,Lebanon
7672,5/1/2020,LBN,Sabah,0,0,0,Lebanon
7673,5/1/2020,LBN,Sarawak,0,0,0,Lebanon
7674,5/1/2020,LBN,Selangor,1,1,0,Lebanon
7675,5/1/2020,LBN,W.P. Labuan,0,0,0,Lebanon
7676,5/1/2020,LBR,Johor,0,0,0,Liberia
7677,5/1/2020,LBR,Kedah,0,0,0,Liberia
7678,5/1/2020,LBR,Sabah,0,0,0,Liberia
7679,5/1/2020,LBR,Sarawak,0,0,0,Liberia
7680,5/1/2020,LBR,Selangor,0,0,0,Liberia
7681,5/1/2020,LBY,Johor,0,0,0,Libyan Arab Jamahiriya
7682,5/1/2020,LBY,Kedah,0,0,0,Libyan Arab Jamahiriya
7683,5/1/2020,LBY,Perlis,0,0,0,Libyan Arab Jamahiriya
7684,5/1/2020,LBY,Pulau Pinang,0,0,0,Libyan Arab Jamahiriya
7685,5/1/2020,LBY,Sabah,0,0,0,Libyan Arab Jamahiriya
7686,5/1/2020,LBY,Sarawak,0,0,0,Libyan Arab Jamahiriya
7687,5/1/2020,LBY,Selangor,0,0,0,Libyan Arab Jamahiriya
7688,5/1/2020,LCA,Johor,0,0,0,Saint Lucia
7689,5/1/2020,LCA,Kedah,0,0,0,Saint Lucia
7690,5/1/2020,LCA,Pulau Pinang,0,0,0,Saint Lucia
7691,5/1/2020,LCA,Sarawak,0,0,0,Saint Lucia
7692,5/1/2020,LCA,Selangor,0,0,0,Saint Lucia
7693,5/1/2020,LIE,Johor,0,0,0,Liechtenstein
7694,5/1/2020,LIE,Kedah,0,0,0,Liechtenstein
7695,5/1/2020,LIE,Perlis,0,0,0,Liechtenstein
7696,5/1/2020,LIE,Pulau Pinang,0,0,0,Liechtenstein
7697,5/1/2020,LIE,Sabah,0,0,0,Liechtenstein
7698,5/1/2020,LIE,Sarawak,0,0,0,Liechtenstein
7699,5/1/2020,LIE,Selangor,0,0,0,Liechtenstein
7700,5/1/2020,LKA,Johor,0,0,0,Sri Lanka
7701,5/1/2020,LKA,Kedah,0,0,0,Sri Lanka
7702,5/1/2020,LKA,Kelantan,0,0,0,Sri Lanka
7703,5/1/2020,LKA,Melaka,0,0,0,Sri Lanka
7704,5/1/2020,LKA,Pahang,0,0,0,Sri Lanka
7705,5/1/2020,LKA,Perak,0,0,0,Sri Lanka
7706,5/1/2020,LKA,Perlis,0,0,0,Sri Lanka
7707,5/1/2020,LKA,Pulau Pinang,0,0,0,Sri Lanka
7708,5/1/2020,LKA,Sabah,0,0,0,Sri Lanka
7709,5/1/2020,LKA,Sarawak,0,0,0,Sri Lanka
7710,5/1/2020,LKA,Selangor,1,1,0,Sri Lanka
7711,5/1/2020,LKA,W.P. Labuan,0,0,0,Sri Lanka
7712,5/1/2020,LSO,Johor,0,0,0,Lesotho
7713,5/1/2020,LSO,Kedah,0,0,0,Lesotho
7714,5/1/2020,LSO,Pulau Pinang,0,0,0,Lesotho
7715,5/1/2020,LSO,Sarawak,0,0,0,Lesotho
7716,5/1/2020,LSO,Selangor,0,0,0,Lesotho
7717,5/1/2020,LTU,Johor,2,2,0,Lithuania
7718,5/1/2020,LTU,Kedah,0,0,0,Lithuania
7719,5/1/2020,LTU,Kelantan,0,0,0,Lithuania
7720,5/1/2020,LTU,Pahang,0,0,0,Lithuania
7721,5/1/2020,LTU,Perak,0,0,0,Lithuania
7722,5/1/2020,LTU,Perlis,0,0,0,Lithuania
7723,5/1/2020,LTU,Pulau Pinang,0,0,0,Lithuania
7724,5/1/2020,LTU,Sabah,0,0,0,Lithuania
7725,5/1/2020,LTU,Sarawak,0,0,0,Lithuania
7726,5/1/2020,LTU,Selangor,1,1,0,Lithuania
7727,5/1/2020,LTU,W.P. Labuan,0,0,0,Lithuania
7728,5/1/2020,LUX,Johor,0,0,0,Luxembourg
7729,5/1/2020,LUX,Kedah,0,0,0,Luxembourg
7730,5/1/2020,LUX,Kelantan,0,0,0,Luxembourg
7731,5/1/2020,LUX,Perak,0,0,0,Luxembourg
7732,5/1/2020,LUX,Perlis,0,0,0,Luxembourg
7733,5/1/2020,LUX,Pulau Pinang,0,0,0,Luxembourg
7734,5/1/2020,LUX,Sabah,0,0,0,Luxembourg
7735,5/1/2020,LUX,Sarawak,0,0,0,Luxembourg
7736,5/1/2020,LUX,Selangor,0,0,0,Luxembourg
7737,5/1/2020,LVA,Johor,2,2,0,Latvia
7738,5/1/2020,LVA,Kedah,0,0,0,Latvia
7739,5/1/2020,LVA,Kelantan,0,0,0,Latvia
7740,5/1/2020,LVA,Pahang,0,0,0,Latvia
7741,5/1/2020,LVA,Perak,0,0,0,Latvia
7742,5/1/2020,LVA,Perlis,0,0,0,Latvia
7743,5/1/2020,LVA,Pulau Pinang,0,0,0,Latvia
7744,5/1/2020,LVA,Sabah,0,0,0,Latvia
7745,5/1/2020,LVA,Sarawak,0,0,0,Latvia
7746,5/1/2020,LVA,Selangor,1,1,0,Latvia
7747,5/1/2020,LVA,W.P. Labuan,0,0,0,Latvia
7748,5/1/2020,MAC,Johor,0,0,0,Macao
7749,5/1/2020,MAC,Pahang,0,0,0,Macao
7750,5/1/2020,MAC,Perak,0,0,0,Macao
7751,5/1/2020,MAC,Selangor,0,0,0,Macao
7752,5/1/2020,MAC,W.P. Labuan,0,0,0,Macao
7753,5/1/2020,MAR,Johor,0,0,0,Morocco
7754,5/1/2020,MAR,Kedah,0,0,0,Morocco
7755,5/1/2020,MAR,Kelantan,0,0,0,Morocco
7756,5/1/2020,MAR,Melaka,0,0,0,Morocco
7757,5/1/2020,MAR,Pahang,0,0,0,Morocco
7758,5/1/2020,MAR,Perak,0,0,0,Morocco
7759,5/1/2020,MAR,Perlis,0,0,0,Morocco
7760,5/1/2020,MAR,Pulau Pinang,0,0,0,Morocco
7761,5/1/2020,MAR,Sabah,0,0,0,Morocco
7762,5/1/2020,MAR,Sarawak,0,0,0,Morocco
7763,5/1/2020,MAR,Selangor,0,0,0,Morocco
7764,5/1/2020,MAR,W.P. Labuan,0,0,0,Morocco
7765,5/1/2020,MCO,Johor,0,0,0,Monaco
7766,5/1/2020,MCO,Kedah,0,0,0,Monaco
7767,5/1/2020,MCO,Sabah,0,0,0,Monaco
7768,5/1/2020,MCO,Selangor,0,0,0,Monaco
7769,5/1/2020,MDA,Johor,0,0,0,"Moldova, Republic of"
7770,5/1/2020,MDA,Kedah,0,0,0,"Moldova, Republic of"
7771,5/1/2020,MDA,Kelantan,0,0,0,"Moldova, Republic of"
7772,5/1/2020,MDA,Negeri Sembilan,0,0,0,"Moldova, Republic of"
7773,5/1/2020,MDA,Perlis,0,0,0,"Moldova, Republic of"
7774,5/1/2020,MDA,Pulau Pinang,0,0,0,"Moldova, Republic of"
7775,5/1/2020,MDA,Sabah,0,0,0,"Moldova, Republic of"
7776,5/1/2020,MDA,Sarawak,0,0,0,"Moldova, Republic of"
7777,5/1/2020,MDA,Selangor,0,0,0,"Moldova, Republic of"
7778,5/1/2020,MDG,Johor,0,0,0,Madagascar
7779,5/1/2020,MDG,Kedah,0,0,0,Madagascar
7780,5/1/2020,MDG,Perak,0,0,0,Madagascar
7781,5/1/2020,MDG,Perlis,0,0,0,Madagascar
7782,5/1/2020,MDG,Pulau Pinang,0,0,0,Madagascar
7783,5/1/2020,MDG,Sabah,0,0,0,Madagascar
7784,5/1/2020,MDG,Sarawak,0,0,0,Madagascar
7785,5/1/2020,MDG,Selangor,0,0,0,Madagascar
7786,5/1/2020,MDV,Johor,0,0,0,Maldives
7787,5/1/2020,MDV,Kedah,0,0,0,Maldives
7788,5/1/2020,MDV,Kelantan,0,0,0,Maldives
7789,5/1/2020,MDV,Perak,0,0,0,Maldives
7790,5/1/2020,MDV,Perlis,0,0,0,Maldives
7791,5/1/2020,MDV,Pulau Pinang,0,0,0,Maldives
7792,5/1/2020,MDV,Sabah,0,0,0,Maldives
7793,5/1/2020,MDV,Sarawak,0,0,0,Maldives
7794,5/1/2020,MDV,Selangor,0,0,0,Maldives
7795,5/1/2020,MEX,Johor,0,0,0,Mexico
7796,5/1/2020,MEX,Kedah,0,0,0,Mexico
7797,5/1/2020,MEX,Kelantan,0,0,0,Mexico
7798,5/1/2020,MEX,Pahang,0,0,0,Mexico
7799,5/1/2020,MEX,Perak,0,0,0,Mexico
7800,5/1/2020,MEX,Perlis,0,0,0,Mexico
7801,5/1/2020,MEX,Pulau Pinang,0,0,0,Mexico
7802,5/1/2020,MEX,Sabah,0,0,0,Mexico
7803,5/1/2020,MEX,Sarawak,0,0,0,Mexico
7804,5/1/2020,MEX,Selangor,0,0,0,Mexico
7805,5/1/2020,MEX,W.P. Labuan,0,0,0,Mexico
7806,5/1/2020,MHL,Johor,0,0,0,Marshall Islands
7807,5/1/2020,MHL,Kedah,0,0,0,Marshall Islands
7808,5/1/2020,MHL,Perak,0,0,0,Marshall Islands
7809,5/1/2020,MHL,Pulau Pinang,0,0,0,Marshall Islands
7810,5/1/2020,MHL,Sabah,0,0,0,Marshall Islands
7811,5/1/2020,MHL,Selangor,0,0,0,Marshall Islands
7812,5/1/2020,MKD,Johor,0,0,0,"Macedonia, the former Yugoslav Republic of"
7813,5/1/2020,MKD,Kedah,0,0,0,"Macedonia, the former Yugoslav Republic of"
7814,5/1/2020,MKD,Perak,0,0,0,"Macedonia, the former Yugoslav Republic of"
7815,5/1/2020,MKD,Pulau Pinang,0,0,0,"Macedonia, the former Yugoslav Republic of"
7816,5/1/2020,MKD,Sabah,0,0,0,"Macedonia, the former Yugoslav Republic of"
7817,5/1/2020,MKD,Sarawak,0,0,0,"Macedonia, the former Yugoslav Republic of"
7818,5/1/2020,MKD,Selangor,0,0,0,"Macedonia, the former Yugoslav Republic of"
7819,5/1/2020,MLI,Johor,0,0,0,Mali
7820,5/1/2020,MLI,Sabah,0,0,0,Mali
7821,5/1/2020,MLI,Selangor,0,0,0,Mali
7822,5/1/2020,MLT,Johor,0,0,0,Malta
7823,5/1/2020,MLT,Kedah,0,0,0,Malta
7824,5/1/2020,MLT,Kelantan,0,0,0,Malta
7825,5/1/2020,MLT,Perak,0,0,0,Malta
7826,5/1/2020,MLT,Perlis,0,0,0,Malta
7827,5/1/2020,MLT,Pulau Pinang,0,0,0,Malta
7828,5/1/2020,MLT,Sabah,0,0,0,Malta
7829,5/1/2020,MLT,Sarawak,0,0,0,Malta
7830,5/1/2020,MLT,Selangor,0,0,0,Malta
7831,5/1/2020,MLT,W.P. Labuan,0,0,0,Malta
7832,5/1/2020,MMR,Johor,2,2,0,Myanmar
7833,5/1/2020,MMR,Kedah,0,0,0,Myanmar
7834,5/1/2020,MMR,Kelantan,0,0,0,Myanmar
7835,5/1/2020,MMR,Negeri Sembilan,0,0,0,Myanmar
7836,5/1/2020,MMR,Pahang,0,0,0,Myanmar
7837,5/1/2020,MMR,Perak,0,0,0,Myanmar
7838,5/1/2020,MMR,Perlis,0,0,0,Myanmar
7839,5/1/2020,MMR,Pulau Pinang,0,0,0,Myanmar
7840,5/1/2020,MMR,Sabah,0,0,0,Myanmar
7841,5/1/2020,MMR,Sarawak,0,0,0,Myanmar
7842,5/1/2020,MMR,Selangor,8,4,4,Myanmar
7843,5/1/2020,MMR,Terengganu,0,0,0,Myanmar
7844,5/1/2020,MMR,W.P. Labuan,0,0,0,Myanmar
7845,5/1/2020,MNE,Johor,0,0,0,Montenegro
7846,5/1/2020,MNE,Kedah,0,0,0,Montenegro
7847,5/1/2020,MNE,Pulau Pinang,0,0,0,Montenegro
7848,5/1/2020,MNE,Sabah,0,0,0,Montenegro
7849,5/1/2020,MNE,Sarawak,0,0,0,Montenegro
7850,5/1/2020,MNE,Selangor,0,0,0,Montenegro
7851,5/1/2020,MNG,Johor,0,0,0,Mongolia
7852,5/1/2020,MNG,Kedah,0,0,0,Mongolia
7853,5/1/2020,MNG,Kelantan,0,0,0,Mongolia
7854,5/1/2020,MNG,Perak,0,0,0,Mongolia
7855,5/1/2020,MNG,Perlis,0,0,0,Mongolia
7856,5/1/2020,MNG,Pulau Pinang,0,0,0,Mongolia
7857,5/1/2020,MNG,Sabah,0,0,0,Mongolia
7858,5/1/2020,MNG,Sarawak,0,0,0,Mongolia
7859,5/1/2020,MNG,Selangor,0,0,0,Mongolia
7860,5/1/2020,MNP,Selangor,0,0,0,Northern Mariana Islands
7861,5/1/2020,MOZ,Johor,0,0,0,Mozambique
7862,5/1/2020,MOZ,Kedah,0,0,0,Mozambique
7863,5/1/2020,MOZ,Perak,0,0,0,Mozambique
7864,5/1/2020,MOZ,Pulau Pinang,0,0,0,Mozambique
7865,5/1/2020,MOZ,Sabah,0,0,0,Mozambique
7866,5/1/2020,MOZ,Sarawak,0,0,0,Mozambique
7867,5/1/2020,MOZ,Selangor,0,0,0,Mozambique
7868,5/1/2020,MRT,Johor,0,0,0,Mauritania
7869,5/1/2020,MRT,Kedah,0,0,0,Mauritania
7870,5/1/2020,MRT,Pulau Pinang,0,0,0,Mauritania
7871,5/1/2020,MRT,Sabah,0,0,0,Mauritania
7872,5/1/2020,MRT,Sarawak,0,0,0,Mauritania
7873,5/1/2020,MRT,Selangor,0,0,0,Mauritania
7874,5/1/2020,MUS,Johor,0,0,0,Mauritius
7875,5/1/2020,MUS,Kedah,0,0,0,Mauritius
7876,5/1/2020,MUS,Kelantan,0,0,0,Mauritius
7877,5/1/2020,MUS,Pahang,0,0,0,Mauritius
7878,5/1/2020,MUS,Perak,0,0,0,Mauritius
7879,5/1/2020,MUS,Perlis,0,0,0,Mauritius
7880,5/1/2020,MUS,Pulau Pinang,0,0,0,Mauritius
7881,5/1/2020,MUS,Sabah,0,0,0,Mauritius
7882,5/1/2020,MUS,Sarawak,0,0,0,Mauritius
7883,5/1/2020,MUS,Selangor,0,0,0,Mauritius
7884,5/1/2020,MWI,Johor,0,0,0,Malawi
7885,5/1/2020,MWI,Pulau Pinang,0,0,0,Malawi
7886,5/1/2020,MWI,Sabah,0,0,0,Malawi
7887,5/1/2020,MWI,Sarawak,0,0,0,Malawi
7888,5/1/2020,MWI,Selangor,0,0,0,Malawi
7889,5/1/2020,MYT,Selangor,0,0,0,Mayotte
7890,5/1/2020,NAM,Johor,0,0,0,Namibia
7891,5/1/2020,NAM,Kedah,0,0,0,Namibia
7892,5/1/2020,NAM,Perak,0,0,0,Namibia
7893,5/1/2020,NAM,Perlis,0,0,0,Namibia
7894,5/1/2020,NAM,Pulau Pinang,0,0,0,Namibia
7895,5/1/2020,NAM,Sabah,0,0,0,Namibia
7896,5/1/2020,NAM,Sarawak,0,0,0,Namibia
7897,5/1/2020,NAM,Selangor,0,0,0,Namibia
7898,5/1/2020,NCL,Selangor,0,0,0,New Caledonia
7899,5/1/2020,NER,Johor,0,0,0,Niger
7900,5/1/2020,NER,Sabah,0,0,0,Niger
7901,5/1/2020,NER,Selangor,0,0,0,Niger
7902,5/1/2020,NGA,Johor,0,0,0,Nigeria
7903,5/1/2020,NGA,Kedah,0,0,0,Nigeria
7904,5/1/2020,NGA,Perlis,0,0,0,Nigeria
7905,5/1/2020,NGA,Pulau Pinang,0,0,0,Nigeria
7906,5/1/2020,NGA,Sabah,0,0,0,Nigeria
7907,5/1/2020,NGA,Sarawak,0,0,0,Nigeria
7908,5/1/2020,NGA,Selangor,1,1,0,Nigeria
7909,5/1/2020,NIC,Johor,0,0,0,Nicaragua
7910,5/1/2020,NIC,Kedah,0,0,0,Nicaragua
7911,5/1/2020,NIC,Pulau Pinang,0,0,0,Nicaragua
7912,5/1/2020,NIC,Sabah,0,0,0,Nicaragua
7913,5/1/2020,NIC,Selangor,0,0,0,Nicaragua
7914,5/1/2020,NLD,Johor,4,4,0,Netherlands
7915,5/1/2020,NLD,Kedah,0,0,0,Netherlands
7916,5/1/2020,NLD,Kelantan,0,0,0,Netherlands
7917,5/1/2020,NLD,Melaka,0,0,0,Netherlands
7918,5/1/2020,NLD,Negeri Sembilan,0,0,0,Netherlands
7919,5/1/2020,NLD,Pahang,0,0,0,Netherlands
7920,5/1/2020,NLD,Perak,0,0,0,Netherlands
7921,5/1/2020,NLD,Perlis,0,0,0,Netherlands
7922,5/1/2020,NLD,Pulau Pinang,0,0,0,Netherlands
7923,5/1/2020,NLD,Sabah,0,0,0,Netherlands
7924,5/1/2020,NLD,Sarawak,0,0,0,Netherlands
7925,5/1/2020,NLD,Selangor,12,8,4,Netherlands
7926,5/1/2020,NLD,Terengganu,0,0,0,Netherlands
7927,5/1/2020,NLD,W.P. Labuan,0,0,0,Netherlands
7928,5/1/2020,NOR,Johor,0,0,0,Norway
7929,5/1/2020,NOR,Kedah,0,0,0,Norway
7930,5/1/2020,NOR,Kelantan,0,0,0,Norway
7931,5/1/2020,NOR,Melaka,0,0,0,Norway
7932,5/1/2020,NOR,Pahang,0,0,0,Norway
7933,5/1/2020,NOR,Perak,0,0,0,Norway
7934,5/1/2020,NOR,Perlis,0,0,0,Norway
7935,5/1/2020,NOR,Pulau Pinang,0,0,0,Norway
7936,5/1/2020,NOR,Sabah,0,0,0,Norway
7937,5/1/2020,NOR,Sarawak,0,0,0,Norway
7938,5/1/2020,NOR,Selangor,2,2,0,Norway
7939,5/1/2020,NOR,W.P. Labuan,0,0,0,Norway
7940,5/1/2020,NPL,Johor,0,0,0,Nepal
7941,5/1/2020,NPL,Kedah,0,0,0,Nepal
7942,5/1/2020,NPL,Pahang,0,0,0,Nepal
7943,5/1/2020,NPL,Perak,0,0,0,Nepal
7944,5/1/2020,NPL,Perlis,0,0,0,Nepal
7945,5/1/2020,NPL,Pulau Pinang,0,0,0,Nepal
7946,5/1/2020,NPL,Sabah,0,0,0,Nepal
7947,5/1/2020,NPL,Sarawak,0,0,0,Nepal
7948,5/1/2020,NPL,Selangor,0,0,0,Nepal
7949,5/1/2020,NPL,W.P. Labuan,0,0,0,Nepal
7950,5/1/2020,NRU,Johor,0,0,0,Nauru
7951,5/1/2020,NRU,Pulau Pinang,0,0,0,Nauru
7952,5/1/2020,NRU,Selangor,0,0,0,Nauru
7953,5/1/2020,NZL,Johor,0,0,0,New Zealand
7954,5/1/2020,NZL,Kedah,2,1,1,New Zealand
7955,5/1/2020,NZL,Kelantan,0,0,0,New Zealand
7956,5/1/2020,NZL,Melaka,0,0,0,New Zealand
7957,5/1/2020,NZL,Negeri Sembilan,0,0,0,New Zealand
7958,5/1/2020,NZL,Pahang,0,0,0,New Zealand
7959,5/1/2020,NZL,Perak,0,0,0,New Zealand
7960,5/1/2020,NZL,Perlis,0,0,0,New Zealand
7961,5/1/2020,NZL,Pulau Pinang,0,0,0,New Zealand
7962,5/1/2020,NZL,Sabah,0,0,0,New Zealand
7963,5/1/2020,NZL,Sarawak,0,0,0,New Zealand
7964,5/1/2020,NZL,Selangor,5,5,0,New Zealand
7965,5/1/2020,NZL,Terengganu,0,0,0,New Zealand
7966,5/1/2020,NZL,W.P. Labuan,0,0,0,New Zealand
7967,5/1/2020,OMN,Johor,0,0,0,Oman
7968,5/1/2020,OMN,Kedah,0,0,0,Oman
7969,5/1/2020,OMN,Kelantan,0,0,0,Oman
7970,5/1/2020,OMN,Melaka,0,0,0,Oman
7971,5/1/2020,OMN,Perak,0,0,0,Oman
7972,5/1/2020,OMN,Perlis,0,0,0,Oman
7973,5/1/2020,OMN,Pulau Pinang,0,0,0,Oman
7974,5/1/2020,OMN,Sabah,0,0,0,Oman
7975,5/1/2020,OMN,Sarawak,0,0,0,Oman
7976,5/1/2020,OMN,Selangor,0,0,0,Oman
7977,5/1/2020,PAK,Johor,0,0,0,Pakistan
7978,5/1/2020,PAK,Kedah,0,0,0,Pakistan
7979,5/1/2020,PAK,Kelantan,0,0,0,Pakistan
7980,5/1/2020,PAK,Melaka,0,0,0,Pakistan
7981,5/1/2020,PAK,Negeri Sembilan,0,0,0,Pakistan
7982,5/1/2020,PAK,Pahang,0,0,0,Pakistan
7983,5/1/2020,PAK,Perak,0,0,0,Pakistan
7984,5/1/2020,PAK,Perlis,0,0,0,Pakistan
7985,5/1/2020,PAK,Pulau Pinang,0,0,0,Pakistan
7986,5/1/2020,PAK,Sabah,0,0,0,Pakistan
7987,5/1/2020,PAK,Sarawak,0,0,0,Pakistan
7988,5/1/2020,PAK,Selangor,35,31,4,Pakistan
7989,5/1/2020,PAK,W.P. Labuan,0,0,0,Pakistan
7990,5/1/2020,PAN,Johor,0,0,0,Panama
7991,5/1/2020,PAN,Kedah,0,0,0,Panama
7992,5/1/2020,PAN,Perak,0,0,0,Panama
7993,5/1/2020,PAN,Perlis,0,0,0,Panama
7994,5/1/2020,PAN,Pulau Pinang,0,0,0,Panama
7995,5/1/2020,PAN,Sabah,0,0,0,Panama
7996,5/1/2020,PAN,Sarawak,0,0,0,Panama
7997,5/1/2020,PAN,Selangor,0,0,0,Panama
7998,5/1/2020,PER,Johor,0,0,0,Peru
7999,5/1/2020,PER,Kedah,0,0,0,Peru
8000,5/1/2020,PER,Kelantan,0,0,0,Peru
8001,5/1/2020,PER,Pahang,0,0,0,Peru
8002,5/1/2020,PER,Perak,0,0,0,Peru
8003,5/1/2020,PER,Perlis,0,0,0,Peru
8004,5/1/2020,PER,Pulau Pinang,0,0,0,Peru
8005,5/1/2020,PER,Sabah,0,0,0,Peru
8006,5/1/2020,PER,Sarawak,0,0,0,Peru
8007,5/1/2020,PER,Selangor,0,0,0,Peru
8008,5/1/2020,PER,W.P. Labuan,0,0,0,Peru
8009,5/1/2020,PHL,Johor,3,0,3,Philippines
8010,5/1/2020,PHL,Kedah,0,0,0,Philippines
8011,5/1/2020,PHL,Kelantan,0,0,0,Philippines
8012,5/1/2020,PHL,Melaka,0,0,0,Philippines
8013,5/1/2020,PHL,Negeri Sembilan,0,0,0,Philippines
8014,5/1/2020,PHL,Pahang,0,0,0,Philippines
8015,5/1/2020,PHL,Perak,0,0,0,Philippines
8016,5/1/2020,PHL,Perlis,0,0,0,Philippines
8017,5/1/2020,PHL,Pulau Pinang,0,0,0,Philippines
8018,5/1/2020,PHL,Sabah,1,0,1,Philippines
8019,5/1/2020,PHL,Sarawak,14,14,0,Philippines
8020,5/1/2020,PHL,Selangor,9,4,5,Philippines
8021,5/1/2020,PHL,Terengganu,0,0,0,Philippines
8022,5/1/2020,PHL,W.P. Labuan,0,0,0,Philippines
8023,5/1/2020,PLW,Johor,0,0,0,Palau
8024,5/1/2020,PLW,Pulau Pinang,0,0,0,Palau
8025,5/1/2020,PLW,Selangor,0,0,0,Palau
8026,5/1/2020,PNG,Johor,0,0,0,Papua New Guinea
8027,5/1/2020,PNG,Kedah,0,0,0,Papua New Guinea
8028,5/1/2020,PNG,Kelantan,0,0,0,Papua New Guinea
8029,5/1/2020,PNG,Perak,0,0,0,Papua New Guinea
8030,5/1/2020,PNG,Pulau Pinang,0,0,0,Papua New Guinea
8031,5/1/2020,PNG,Sabah,0,0,0,Papua New Guinea
8032,5/1/2020,PNG,Sarawak,0,0,0,Papua New Guinea
8033,5/1/2020,PNG,Selangor,0,0,0,Papua New Guinea
8034,5/1/2020,POL,Johor,6,6,0,Poland
8035,5/1/2020,POL,Kedah,0,0,0,Poland
8036,5/1/2020,POL,Kelantan,0,0,0,Poland
8037,5/1/2020,POL,Melaka,0,0,0,Poland
8038,5/1/2020,POL,Negeri Sembilan,0,0,0,Poland
8039,5/1/2020,POL,Pahang,0,0,0,Poland
8040,5/1/2020,POL,Perak,0,0,0,Poland
8041,5/1/2020,POL,Perlis,0,0,0,Poland
8042,5/1/2020,POL,Pulau Pinang,0,0,0,Poland
8043,5/1/2020,POL,Sabah,0,0,0,Poland
8044,5/1/2020,POL,Sarawak,0,0,0,Poland
8045,5/1/2020,POL,Selangor,6,6,0,Poland
8046,5/1/2020,POL,Terengganu,0,0,0,Poland
8047,5/1/2020,POL,W.P. Labuan,0,0,0,Poland
8048,5/1/2020,PRK,Selangor,0,0,0,"Korea, Democratic People's Republic of"
8049,5/1/2020,PRT,Johor,0,0,0,Portugal
8050,5/1/2020,PRT,Kedah,0,0,0,Portugal
8051,5/1/2020,PRT,Kelantan,0,0,0,Portugal
8052,5/1/2020,PRT,Melaka,0,0,0,Portugal
8053,5/1/2020,PRT,Pahang,0,0,0,Portugal
8054,5/1/2020,PRT,Perak,0,0,0,Portugal
8055,5/1/2020,PRT,Perlis,0,0,0,Portugal
8056,5/1/2020,PRT,Pulau Pinang,0,0,0,Portugal
8057,5/1/2020,PRT,Sabah,0,0,0,Portugal
8058,5/1/2020,PRT,Sarawak,0,0,0,Portugal
8059,5/1/2020,PRT,Selangor,1,1,0,Portugal
8060,5/1/2020,PRT,W.P. Labuan,0,0,0,Portugal
8061,5/1/2020,PRY,Johor,0,0,0,Paraguay
8062,5/1/2020,PRY,Kedah,0,0,0,Paraguay
8063,5/1/2020,PRY,Perak,0,0,0,Paraguay
8064,5/1/2020,PRY,Perlis,0,0,0,Paraguay
8065,5/1/2020,PRY,Pulau Pinang,0,0,0,Paraguay
8066,5/1/2020,PRY,Sabah,0,0,0,Paraguay
8067,5/1/2020,PRY,Sarawak,0,0,0,Paraguay
8068,5/1/2020,PRY,Selangor,0,0,0,Paraguay
8069,5/1/2020,PSE,Johor,0,0,0,"Palestinian Territory, Occupied"
8070,5/1/2020,PSE,Kedah,0,0,0,"Palestinian Territory, Occupied"
8071,5/1/2020,PSE,Kelantan,0,0,0,"Palestinian Territory, Occupied"
8072,5/1/2020,PSE,Melaka,0,0,0,"Palestinian Territory, Occupied"
8073,5/1/2020,PSE,Perak,0,0,0,"Palestinian Territory, Occupied"
8074,5/1/2020,PSE,Perlis,0,0,0,"Palestinian Territory, Occupied"
8075,5/1/2020,PSE,Pulau Pinang,0,0,0,"Palestinian Territory, Occupied"
8076,5/1/2020,PSE,Sabah,0,0,0,"Palestinian Territory, Occupied"
8077,5/1/2020,PSE,Sarawak,0,0,0,"Palestinian Territory, Occupied"
8078,5/1/2020,PSE,Selangor,2,1,1,"Palestinian Territory, Occupied"
8079,5/1/2020,QAT,Johor,0,0,0,Qatar
8080,5/1/2020,QAT,Kedah,0,0,0,Qatar
8081,5/1/2020,QAT,Perlis,0,0,0,Qatar
8082,5/1/2020,QAT,Pulau Pinang,0,0,0,Qatar
8083,5/1/2020,QAT,Sabah,0,0,0,Qatar
8084,5/1/2020,QAT,Sarawak,0,0,0,Qatar
8085,5/1/2020,QAT,Selangor,0,0,0,Qatar
8086,5/1/2020,REU,Johor,0,0,0,Reunion
8087,5/1/2020,REU,Sarawak,0,0,0,Reunion
8088,5/1/2020,ROU,Johor,2,2,0,Romania
8089,5/1/2020,ROU,Kedah,0,0,0,Romania
8090,5/1/2020,ROU,Kelantan,0,0,0,Romania
8091,5/1/2020,ROU,Negeri Sembilan,0,0,0,Romania
8092,5/1/2020,ROU,Pahang,0,0,0,Romania
8093,5/1/2020,ROU,Perak,0,0,0,Romania
8094,5/1/2020,ROU,Perlis,0,0,0,Romania
8095,5/1/2020,ROU,Pulau Pinang,0,0,0,Romania
8096,5/1/2020,ROU,Sabah,0,0,0,Romania
8097,5/1/2020,ROU,Sarawak,0,0,0,Romania
8098,5/1/2020,ROU,Selangor,0,0,0,Romania
8099,5/1/2020,ROU,W.P. Labuan,0,0,0,Romania
8100,5/1/2020,RUS,Johor,0,0,0,Russia
8101,5/1/2020,RUS,Kedah,0,0,0,Russia
8102,5/1/2020,RUS,Kelantan,0,0,0,Russia
8103,5/1/2020,RUS,Melaka,0,0,0,Russia
8104,5/1/2020,RUS,Negeri Sembilan,0,0,0,Russia
8105,5/1/2020,RUS,Pahang,0,0,0,Russia
8106,5/1/2020,RUS,Perak,0,0,0,Russia
8107,5/1/2020,RUS,Perlis,0,0,0,Russia
8108,5/1/2020,RUS,Pulau Pinang,0,0,0,Russia
8109,5/1/2020,RUS,Sabah,0,0,0,Russia
8110,5/1/2020,RUS,Sarawak,0,0,0,Russia
8111,5/1/2020,RUS,Selangor,6,4,2,Russia
8112,5/1/2020,RUS,W.P. Labuan,0,0,0,Russia
8113,5/1/2020,RWA,Johor,0,0,0,Rwanda
8114,5/1/2020,RWA,Kedah,0,0,0,Rwanda
8115,5/1/2020,RWA,Pulau Pinang,0,0,0,Rwanda
8116,5/1/2020,RWA,Selangor,0,0,0,Rwanda
8117,5/1/2020,SAU,Johor,0,0,0,Saudi Arabia
8118,5/1/2020,SAU,Kedah,0,0,0,Saudi Arabia
8119,5/1/2020,SAU,Kelantan,0,0,0,Saudi Arabia
8120,5/1/2020,SAU,Melaka,0,0,0,Saudi Arabia
8121,5/1/2020,SAU,Perak,0,0,0,Saudi Arabia
8122,5/1/2020,SAU,Perlis,0,0,0,Saudi Arabia
8123,5/1/2020,SAU,Pulau Pinang,0,0,0,Saudi Arabia
8124,5/1/2020,SAU,Sabah,0,0,0,Saudi Arabia
8125,5/1/2020,SAU,Sarawak,0,0,0,Saudi Arabia
8126,5/1/2020,SAU,Selangor,0,0,0,Saudi Arabia
8127,5/1/2020,SAU,W.P. Labuan,0,0,0,Saudi Arabia
8128,5/1/2020,SDN,Johor,0,0,0,Sudan
8129,5/1/2020,SDN,Kedah,0,0,0,Sudan
8130,5/1/2020,SDN,Kelantan,0,0,0,Sudan
8131,5/1/2020,SDN,Perlis,0,0,0,Sudan
8132,5/1/2020,SDN,Pulau Pinang,0,0,0,Sudan
8133,5/1/2020,SDN,Sabah,0,0,0,Sudan
8134,5/1/2020,SDN,Sarawak,0,0,0,Sudan
8135,5/1/2020,SDN,Selangor,0,0,0,Sudan
8136,5/1/2020,SDN,W.P. Labuan,0,0,0,Sudan
8137,5/1/2020,SEN,Johor,0,0,0,Senegal
8138,5/1/2020,SEN,Kedah,0,0,0,Senegal
8139,5/1/2020,SEN,Kelantan,0,0,0,Senegal
8140,5/1/2020,SEN,Perak,0,0,0,Senegal
8141,5/1/2020,SEN,Perlis,0,0,0,Senegal
8142,5/1/2020,SEN,Pulau Pinang,0,0,0,Senegal
8143,5/1/2020,SEN,Sabah,0,0,0,Senegal
8144,5/1/2020,SEN,Sarawak,0,0,0,Senegal
8145,5/1/2020,SEN,Selangor,0,0,0,Senegal
8146,5/1/2020,SGP,Johor,56,53,3,Singapore
8147,5/1/2020,SGP,Kedah,0,0,0,Singapore
8148,5/1/2020,SGP,Kelantan,0,0,0,Singapore
8149,5/1/2020,SGP,Melaka,0,0,0,Singapore
8150,5/1/2020,SGP,Negeri Sembilan,0,0,0,Singapore
8151,5/1/2020,SGP,Pahang,0,0,0,Singapore
8152,5/1/2020,SGP,Perak,0,0,0,Singapore
8153,5/1/2020,SGP,Perlis,0,0,0,Singapore
8154,5/1/2020,SGP,Pulau Pinang,0,0,0,Singapore
8155,5/1/2020,SGP,Sabah,0,0,0,Singapore
8156,5/1/2020,SGP,Sarawak,3,0,3,Singapore
8157,5/1/2020,SGP,Selangor,21,10,11,Singapore
8158,5/1/2020,SGP,Terengganu,0,0,0,Singapore
8159,5/1/2020,SGP,W.P. Labuan,0,0,0,Singapore
8160,5/1/2020,SGS,Johor,0,0,0,South Georgia and the South Sandwich Islands
8161,5/1/2020,SGS,Sabah,0,0,0,South Georgia and the South Sandwich Islands
8162,5/1/2020,SGS,Selangor,0,0,0,South Georgia and the South Sandwich Islands
8163,5/1/2020,SHN,Sarawak,0,0,0,"Saint Helena, Ascension and Tristan da Cunha"
8164,5/1/2020,SLB,Johor,0,0,0,Solomon Islands
8165,5/1/2020,SLB,Perlis,0,0,0,Solomon Islands
8166,5/1/2020,SLB,Pulau Pinang,0,0,0,Solomon Islands
8167,5/1/2020,SLB,Sabah,0,0,0,Solomon Islands
8168,5/1/2020,SLB,Sarawak,0,0,0,Solomon Islands
8169,5/1/2020,SLB,Selangor,0,0,0,Solomon Islands
8170,5/1/2020,SLB,W.P. Labuan,0,0,0,Solomon Islands
8171,5/1/2020,SLE,Johor,0,0,0,Sierra Leone
8172,5/1/2020,SLE,Kedah,0,0,0,Sierra Leone
8173,5/1/2020,SLE,Perak,0,0,0,Sierra Leone
8174,5/1/2020,SLE,Pulau Pinang,0,0,0,Sierra Leone
8175,5/1/2020,SLE,Sabah,0,0,0,Sierra Leone
8176,5/1/2020,SLE,Selangor,0,0,0,Sierra Leone
8177,5/1/2020,SLV,Johor,0,0,0,El Salvador
8178,5/1/2020,SLV,Kedah,0,0,0,El Salvador
8179,5/1/2020,SLV,Perak,0,0,0,El Salvador
8180,5/1/2020,SLV,Perlis,0,0,0,El Salvador
8181,5/1/2020,SLV,Pulau Pinang,0,0,0,El Salvador
8182,5/1/2020,SLV,Sabah,0,0,0,El Salvador
8183,5/1/2020,SLV,Selangor,0,0,0,El Salvador
8184,5/1/2020,SLV,W.P. Labuan,0,0,0,El Salvador
8185,5/1/2020,SMR,Johor,0,0,0,San Marino
8186,5/1/2020,SMR,Selangor,0,0,0,San Marino
8187,5/1/2020,SOM,Johor,0,0,0,Somalia
8188,5/1/2020,SOM,Kedah,0,0,0,Somalia
8189,5/1/2020,SOM,Kelantan,0,0,0,Somalia
8190,5/1/2020,SOM,Perlis,0,0,0,Somalia
8191,5/1/2020,SOM,Sabah,0,0,0,Somalia
8192,5/1/2020,SOM,Sarawak,0,0,0,Somalia
8193,5/1/2020,SOM,Selangor,0,0,0,Somalia
8194,5/1/2020,SRB,Johor,0,0,0,Serbia
8195,5/1/2020,SRB,Kedah,0,0,0,Serbia
8196,5/1/2020,SRB,Kelantan,0,0,0,Serbia
8197,5/1/2020,SRB,Pahang,0,0,0,Serbia
8198,5/1/2020,SRB,Perak,0,0,0,Serbia
8199,5/1/2020,SRB,Perlis,0,0,0,Serbia
8200,5/1/2020,SRB,Pulau Pinang,0,0,0,Serbia
8201,5/1/2020,SRB,Sabah,0,0,0,Serbia
8202,5/1/2020,SRB,Sarawak,0,0,0,Serbia
8203,5/1/2020,SRB,Selangor,0,0,0,Serbia
8204,5/1/2020,STP,Selangor,0,0,0,Sao Tome and Principe
8205,5/1/2020,SUR,Johor,0,0,0,Suriname
8206,5/1/2020,SUR,Kedah,0,0,0,Suriname
8207,5/1/2020,SUR,Kelantan,0,0,0,Suriname
8208,5/1/2020,SUR,Perak,0,0,0,Suriname
8209,5/1/2020,SUR,Perlis,0,0,0,Suriname
8210,5/1/2020,SUR,Pulau Pinang,0,0,0,Suriname
8211,5/1/2020,SUR,Sabah,0,0,0,Suriname
8212,5/1/2020,SUR,Sarawak,0,0,0,Suriname
8213,5/1/2020,SUR,Selangor,0,0,0,Suriname
8214,5/1/2020,SVK,Johor,0,0,0,Slovakia
8215,5/1/2020,SVK,Kedah,0,0,0,Slovakia
8216,5/1/2020,SVK,Kelantan,0,0,0,Slovakia
8217,5/1/2020,SVK,Negeri Sembilan,0,0,0,Slovakia
8218,5/1/2020,SVK,Pahang,0,0,0,Slovakia
8219,5/1/2020,SVK,Perak,0,0,0,Slovakia
8220,5/1/2020,SVK,Perlis,0,0,0,Slovakia
8221,5/1/2020,SVK,Pulau Pinang,0,0,0,Slovakia
8222,5/1/2020,SVK,Sabah,0,0,0,Slovakia
8223,5/1/2020,SVK,Sarawak,0,0,0,Slovakia
8224,5/1/2020,SVK,Selangor,0,0,0,Slovakia
8225,5/1/2020,SVK,W.P. Labuan,0,0,0,Slovakia
8226,5/1/2020,SVN,Johor,0,0,0,Slovenia
8227,5/1/2020,SVN,Kedah,0,0,0,Slovenia
8228,5/1/2020,SVN,Kelantan,0,0,0,Slovenia
8229,5/1/2020,SVN,Perak,0,0,0,Slovenia
8230,5/1/2020,SVN,Perlis,0,0,0,Slovenia
8231,5/1/2020,SVN,Pulau Pinang,0,0,0,Slovenia
8232,5/1/2020,SVN,Sabah,0,0,0,Slovenia
8233,5/1/2020,SVN,Sarawak,0,0,0,Slovenia
8234,5/1/2020,SVN,Selangor,0,0,0,Slovenia
8235,5/1/2020,SVN,W.P. Labuan,0,0,0,Slovenia
8236,5/1/2020,SWE,Johor,0,0,0,Sweden
8237,5/1/2020,SWE,Kedah,0,0,0,Sweden
8238,5/1/2020,SWE,Kelantan,0,0,0,Sweden
8239,5/1/2020,SWE,Melaka,0,0,0,Sweden
8240,5/1/2020,SWE,Negeri Sembilan,0,0,0,Sweden
8241,5/1/2020,SWE,Pahang,0,0,0,Sweden
8242,5/1/2020,SWE,Perak,0,0,0,Sweden
8243,5/1/2020,SWE,Perlis,0,0,0,Sweden
8244,5/1/2020,SWE,Pulau Pinang,0,0,0,Sweden
8245,5/1/2020,SWE,Sabah,0,0,0,Sweden
8246,5/1/2020,SWE,Sarawak,0,0,0,Sweden
8247,5/1/2020,SWE,Selangor,1,1,0,Sweden
8248,5/1/2020,SWE,W.P. Labuan,0,0,0,Sweden
8249,5/1/2020,SWZ,Johor,0,0,0,Swaziland
8250,5/1/2020,SWZ,Kedah,0,0,0,Swaziland
8251,5/1/2020,SWZ,Pulau Pinang,0,0,0,Swaziland
8252,5/1/2020,SWZ,Sabah,0,0,0,Swaziland
8253,5/1/2020,SWZ,Selangor,0,0,0,Swaziland
8254,5/1/2020,SYC,Johor,0,0,0,Seychelles
8255,5/1/2020,SYC,Kedah,0,0,0,Seychelles
8256,5/1/2020,SYC,Pulau Pinang,0,0,0,Seychelles
8257,5/1/2020,SYC,Sabah,0,0,0,Seychelles
8258,5/1/2020,SYC,Sarawak,0,0,0,Seychelles
8259,5/1/2020,SYC,Selangor,0,0,0,Seychelles
8260,5/1/2020,SYR,Johor,0,0,0,Syrian Arab Republic
8261,5/1/2020,SYR,Kedah,0,0,0,Syrian Arab Republic
8262,5/1/2020,SYR,Kelantan,0,0,0,Syrian Arab Republic
8263,5/1/2020,SYR,Pahang,0,0,0,Syrian Arab Republic
8264,5/1/2020,SYR,Perlis,0,0,0,Syrian Arab Republic
8265,5/1/2020,SYR,Pulau Pinang,0,0,0,Syrian Arab Republic
8266,5/1/2020,SYR,Sabah,0,0,0,Syrian Arab Republic
8267,5/1/2020,SYR,Sarawak,0,0,0,Syrian Arab Republic
8268,5/1/2020,SYR,Selangor,0,0,0,Syrian Arab Republic
8269,5/1/2020,SYR,W.P. Labuan,0,0,0,Syrian Arab Republic
8270,5/1/2020,TCA,Perlis,0,0,0,Turks and Caicos
8271,5/1/2020,TCD,Johor,0,0,0,Chad
8272,5/1/2020,TCD,Kedah,0,0,0,Chad
8273,5/1/2020,TCD,Perlis,0,0,0,Chad
8274,5/1/2020,TCD,Selangor,0,0,0,Chad
8275,5/1/2020,TGO,Johor,0,0,0,Togo
8276,5/1/2020,TGO,Perak,0,0,0,Togo
8277,5/1/2020,TGO,Pulau Pinang,0,0,0,Togo
8278,5/1/2020,TGO,Selangor,0,0,0,Togo
8279,5/1/2020,THA,Johor,88,88,0,Thailand
8280,5/1/2020,THA,Kedah,12912,12099,813,Thailand
8281,5/1/2020,THA,Kelantan,18,6,12,Thailand
8282,5/1/2020,THA,Melaka,0,0,0,Thailand
8283,5/1/2020,THA,Negeri Sembilan,0,0,0,Thailand
8284,5/1/2020,THA,Pahang,0,0,0,Thailand
8285,5/1/2020,THA,Perak,0,0,0,Thailand
8286,5/1/2020,THA,Perlis,24,3,21,Thailand
8287,5/1/2020,THA,Pulau Pinang,0,0,0,Thailand
8288,5/1/2020,THA,Sabah,0,0,0,Thailand
8289,5/1/2020,THA,Sarawak,6,6,0,Thailand
8290,5/1/2020,THA,Selangor,89,75,14,Thailand
8291,5/1/2020,THA,Terengganu,0,0,0,Thailand
8292,5/1/2020,THA,W.P. Labuan,0,0,0,Thailand
8293,5/1/2020,TJK,Johor,0,0,0,Tajikistan
8294,5/1/2020,TJK,Kedah,0,0,0,Tajikistan
8295,5/1/2020,TJK,Perlis,0,0,0,Tajikistan
8296,5/1/2020,TJK,Pulau Pinang,0,0,0,Tajikistan
8297,5/1/2020,TJK,Sabah,0,0,0,Tajikistan
8298,5/1/2020,TJK,Selangor,0,0,0,Tajikistan
8299,5/1/2020,TKL,Selangor,0,0,0,Tokelau
8300,5/1/2020,TKM,Johor,0,0,0,Turkmenistan
8301,5/1/2020,TKM,Kedah,0,0,0,Turkmenistan
8302,5/1/2020,TKM,Kelantan,0,0,0,Turkmenistan
8303,5/1/2020,TKM,Perlis,0,0,0,Turkmenistan
8304,5/1/2020,TKM,Pulau Pinang,0,0,0,Turkmenistan
8305,5/1/2020,TKM,Sabah,0,0,0,Turkmenistan
8306,5/1/2020,TKM,Sarawak,0,0,0,Turkmenistan
8307,5/1/2020,TKM,Selangor,0,0,0,Turkmenistan
8308,5/1/2020,TLS,Johor,0,0,0,Timor-Leste
8309,5/1/2020,TLS,Kedah,0,0,0,Timor-Leste
8310,5/1/2020,TLS,Perlis,0,0,0,Timor-Leste
8311,5/1/2020,TLS,Pulau Pinang,0,0,0,Timor-Leste
8312,5/1/2020,TLS,Sabah,0,0,0,Timor-Leste
8313,5/1/2020,TLS,Sarawak,0,0,0,Timor-Leste
8314,5/1/2020,TLS,Selangor,1,1,0,Timor-Leste
8315,5/1/2020,TON,Johor,0,0,0,Tonga
8316,5/1/2020,TON,Pulau Pinang,0,0,0,Tonga
8317,5/1/2020,TON,Sarawak,0,0,0,Tonga
8318,5/1/2020,TON,Selangor,0,0,0,Tonga
8319,5/1/2020,TTO,Johor,0,0,0,Trinidad and Tobago
8320,5/1/2020,TTO,Kedah,0,0,0,Trinidad and Tobago
8321,5/1/2020,TTO,Pahang,0,0,0,Trinidad and Tobago
8322,5/1/2020,TTO,Pulau Pinang,0,0,0,Trinidad and Tobago
8323,5/1/2020,TTO,Sabah,0,0,0,Trinidad and Tobago
8324,5/1/2020,TTO,Sarawak,0,0,0,Trinidad and Tobago
8325,5/1/2020,TTO,Selangor,0,0,0,Trinidad and Tobago
8326,5/1/2020,TUN,Johor,0,0,0,Tunisia
8327,5/1/2020,TUN,Kedah,0,0,0,Tunisia
8328,5/1/2020,TUN,Kelantan,0,0,0,Tunisia
8329,5/1/2020,TUN,Melaka,0,0,0,Tunisia
8330,5/1/2020,TUN,Perak,0,0,0,Tunisia
8331,5/1/2020,TUN,Perlis,0,0,0,Tunisia
8332,5/1/2020,TUN,Pulau Pinang,0,0,0,Tunisia
8333,5/1/2020,TUN,Sabah,0,0,0,Tunisia
8334,5/1/2020,TUN,Sarawak,0,0,0,Tunisia
8335,5/1/2020,TUN,Selangor,0,0,0,Tunisia
8336,5/1/2020,TUN,W.P. Labuan,0,0,0,Tunisia
8337,5/1/2020,TUR,Johor,0,0,0,Turkey
8338,5/1/2020,TUR,Kedah,0,0,0,Turkey
8339,5/1/2020,TUR,Kelantan,0,0,0,Turkey
8340,5/1/2020,TUR,Melaka,0,0,0,Turkey
8341,5/1/2020,TUR,Negeri Sembilan,0,0,0,Turkey
8342,5/1/2020,TUR,Pahang,0,0,0,Turkey
8343,5/1/2020,TUR,Perak,0,0,0,Turkey
8344,5/1/2020,TUR,Perlis,0,0,0,Turkey
8345,5/1/2020,TUR,Pulau Pinang,0,0,0,Turkey
8346,5/1/2020,TUR,Sabah,0,0,0,Turkey
8347,5/1/2020,TUR,Sarawak,3,2,1,Turkey
8348,5/1/2020,TUR,Selangor,8,7,1,Turkey
8349,5/1/2020,TUR,W.P. Labuan,0,0,0,Turkey
8350,5/1/2020,TUV,Selangor,0,0,0,Tuvalu
8351,5/1/2020,TWN,Johor,0,0,0,Taiwan
8352,5/1/2020,TWN,Kedah,0,0,0,Taiwan
8353,5/1/2020,TWN,Kelantan,0,0,0,Taiwan
8354,5/1/2020,TWN,Melaka,0,0,0,Taiwan
8355,5/1/2020,TWN,Negeri Sembilan,0,0,0,Taiwan
8356,5/1/2020,TWN,Pahang,0,0,0,Taiwan
8357,5/1/2020,TWN,Perak,0,0,0,Taiwan
8358,5/1/2020,TWN,Perlis,0,0,0,Taiwan
8359,5/1/2020,TWN,Pulau Pinang,0,0,0,Taiwan
8360,5/1/2020,TWN,Sabah,0,0,0,Taiwan
8361,5/1/2020,TWN,Sarawak,0,0,0,Taiwan
8362,5/1/2020,TWN,Selangor,2,0,2,Taiwan
8363,5/1/2020,TWN,W.P. Labuan,0,0,0,Taiwan
8364,5/1/2020,TZA,Johor,0,0,0,"Tanzania, United Republic of"
8365,5/1/2020,TZA,Kedah,0,0,0,"Tanzania, United Republic of"
8366,5/1/2020,TZA,Perak,0,0,0,"Tanzania, United Republic of"
8367,5/1/2020,TZA,Perlis,0,0,0,"Tanzania, United Republic of"
8368,5/1/2020,TZA,Pulau Pinang,0,0,0,"Tanzania, United Republic of"
8369,5/1/2020,TZA,Sabah,0,0,0,"Tanzania, United Republic of"
8370,5/1/2020,TZA,Sarawak,0,0,0,"Tanzania, United Republic of"
8371,5/1/2020,TZA,Selangor,0,0,0,"Tanzania, United Republic of"
8372,5/1/2020,UGA,Johor,0,0,0,Uganda
8373,5/1/2020,UGA,Kedah,0,0,0,Uganda
8374,5/1/2020,UGA,Perak,0,0,0,Uganda
8375,5/1/2020,UGA,Perlis,0,0,0,Uganda
8376,5/1/2020,UGA,Pulau Pinang,0,0,0,Uganda
8377,5/1/2020,UGA,Sabah,0,0,0,Uganda
8378,5/1/2020,UGA,Sarawak,0,0,0,Uganda
8379,5/1/2020,UGA,Selangor,0,0,0,Uganda
8380,5/1/2020,UKR,Johor,2,2,0,Ukraine
8381,5/1/2020,UKR,Kedah,0,0,0,Ukraine
8382,5/1/2020,UKR,Kelantan,0,0,0,Ukraine
8383,5/1/2020,UKR,Melaka,0,0,0,Ukraine
8384,5/1/2020,UKR,Negeri Sembilan,0,0,0,Ukraine
8385,5/1/2020,UKR,Pahang,0,0,0,Ukraine
8386,5/1/2020,UKR,Perak,0,0,0,Ukraine
8387,5/1/2020,UKR,Perlis,0,0,0,Ukraine
8388,5/1/2020,UKR,Pulau Pinang,0,0,0,Ukraine
8389,5/1/2020,UKR,Sabah,10,10,0,Ukraine
8390,5/1/2020,UKR,Sarawak,0,0,0,Ukraine
8391,5/1/2020,UKR,Selangor,0,0,0,Ukraine
8392,5/1/2020,UKR,W.P. Labuan,0,0,0,Ukraine
8393,5/1/2020,URY,Johor,0,0,0,Uruguay
8394,5/1/2020,URY,Kedah,0,0,0,Uruguay
8395,5/1/2020,URY,Kelantan,0,0,0,Uruguay
8396,5/1/2020,URY,Perak,0,0,0,Uruguay
8397,5/1/2020,URY,Perlis,0,0,0,Uruguay
8398,5/1/2020,URY,Pulau Pinang,0,0,0,Uruguay
8399,5/1/2020,URY,Sabah,0,0,0,Uruguay
8400,5/1/2020,URY,Sarawak,0,0,0,Uruguay
8401,5/1/2020,URY,Selangor,0,0,0,Uruguay
8402,5/1/2020,URY,W.P. Labuan,0,0,0,Uruguay
8403,5/1/2020,USA,Johor,0,0,0,United States Of America
8404,5/1/2020,USA,Kedah,0,0,0,United States Of America
8405,5/1/2020,USA,Kelantan,0,0,0,United States Of America
8406,5/1/2020,USA,Melaka,0,0,0,United States Of America
8407,5/1/2020,USA,Negeri Sembilan,0,0,0,United States Of America
8408,5/1/2020,USA,Pahang,0,0,0,United States Of America
8409,5/1/2020,USA,Perak,0,0,0,United States Of America
8410,5/1/2020,USA,Perlis,0,0,0,United States Of America
8411,5/1/2020,USA,Pulau Pinang,1,1,0,United States Of America
8412,5/1/2020,USA,Sabah,0,0,0,United States Of America
8413,5/1/2020,USA,Sarawak,0,0,0,United States Of America
8414,5/1/2020,USA,Selangor,22,18,4,United States Of America
8415,5/1/2020,USA,Terengganu,0,0,0,United States Of America
8416,5/1/2020,USA,W.P. Labuan,0,0,0,United States Of America
8417,5/1/2020,UZB,Johor,0,0,0,Uzbekistan
8418,5/1/2020,UZB,Kedah,0,0,0,Uzbekistan
8419,5/1/2020,UZB,Kelantan,0,0,0,Uzbekistan
8420,5/1/2020,UZB,Perak,0,0,0,Uzbekistan
8421,5/1/2020,UZB,Perlis,0,0,0,Uzbekistan
8422,5/1/2020,UZB,Pulau Pinang,0,0,0,Uzbekistan
8423,5/1/2020,UZB,Sabah,0,0,0,Uzbekistan
8424,5/1/2020,UZB,Sarawak,0,0,0,Uzbekistan
8425,5/1/2020,UZB,Selangor,0,0,0,Uzbekistan
8426,5/1/2020,VAT,Johor,0,0,0,Holy See (Vatican City State)
8427,5/1/2020,VAT,Sarawak,0,0,0,Holy See (Vatican City State)
8428,5/1/2020,VAT,Selangor,0,0,0,Holy See (Vatican City State)
8429,5/1/2020,VCT,Johor,0,0,0,Saint Vincent and the Grenadines
8430,5/1/2020,VCT,Kedah,0,0,0,Saint Vincent and the Grenadines
8431,5/1/2020,VCT,Pulau Pinang,0,0,0,Saint Vincent and the Grenadines
8432,5/1/2020,VCT,Sarawak,0,0,0,Saint Vincent and the Grenadines
8433,5/1/2020,VCT,Selangor,0,0,0,Saint Vincent and the Grenadines
8434,5/1/2020,VEN,Johor,0,0,0,Venezuela
8435,5/1/2020,VEN,Kedah,0,0,0,Venezuela
8436,5/1/2020,VEN,Kelantan,0,0,0,Venezuela
8437,5/1/2020,VEN,Melaka,0,0,0,Venezuela
8438,5/1/2020,VEN,Perak,0,0,0,Venezuela
8439,5/1/2020,VEN,Perlis,0,0,0,Venezuela
8440,5/1/2020,VEN,Pulau Pinang,0,0,0,Venezuela
8441,5/1/2020,VEN,Sabah,0,0,0,Venezuela
8442,5/1/2020,VEN,Sarawak,0,0,0,Venezuela
8443,5/1/2020,VEN,Selangor,0,0,0,Venezuela
8444,5/1/2020,VEN,W.P. Labuan,0,0,0,Venezuela
8445,5/1/2020,VNM,Johor,4,3,1,Vietnam
8446,5/1/2020,VNM,Kedah,0,0,0,Vietnam
8447,5/1/2020,VNM,Kelantan,0,0,0,Vietnam
8448,5/1/2020,VNM,Melaka,0,0,0,Vietnam
8449,5/1/2020,VNM,Negeri Sembilan,0,0,0,Vietnam
8450,5/1/2020,VNM,Pahang,0,0,0,Vietnam
8451,5/1/2020,VNM,Perak,0,0,0,Vietnam
8452,5/1/2020,VNM,Perlis,0,0,0,Vietnam
8453,5/1/2020,VNM,Pulau Pinang,0,0,0,Vietnam
8454,5/1/2020,VNM,Sabah,0,0,0,Vietnam
8455,5/1/2020,VNM,Sarawak,0,0,0,Vietnam
8456,5/1/2020,VNM,Selangor,46,0,46,Vietnam
8457,5/1/2020,VNM,Terengganu,0,0,0,Vietnam
8458,5/1/2020,VNM,W.P. Labuan,0,0,0,Vietnam
8459,5/1/2020,VUT,Johor,0,0,0,Vanuatu
8460,5/1/2020,VUT,Kedah,0,0,0,Vanuatu
8461,5/1/2020,VUT,Pulau Pinang,0,0,0,Vanuatu
8462,5/1/2020,VUT,Sabah,0,0,0,Vanuatu
8463,5/1/2020,VUT,Sarawak,0,0,0,Vanuatu
8464,5/1/2020,VUT,Selangor,0,0,0,Vanuatu
8465,5/1/2020,WSM,Johor,0,0,0,Samoa
8466,5/1/2020,WSM,Sarawak,0,0,0,Samoa
8467,5/1/2020,WSM,Selangor,0,0,0,Samoa
8468,5/1/2020,YEM,Johor,0,0,0,Yemen
8469,5/1/2020,YEM,Kedah,0,0,0,Yemen
8470,5/1/2020,YEM,Kelantan,0,0,0,Yemen
8471,5/1/2020,YEM,Melaka,0,0,0,Yemen
8472,5/1/2020,YEM,Pahang,0,0,0,Yemen
8473,5/1/2020,YEM,Perak,0,0,0,Yemen
8474,5/1/2020,YEM,Perlis,0,0,0,Yemen
8475,5/1/2020,YEM,Pulau Pinang,0,0,0,Yemen
8476,5/1/2020,YEM,Sabah,0,0,0,Yemen
8477,5/1/2020,YEM,Sarawak,0,0,0,Yemen
8478,5/1/2020,YEM,Selangor,1,0,1,Yemen
8479,5/1/2020,YEM,W.P. Labuan,0,0,0,Yemen
8480,5/1/2020,ZAF,Johor,0,0,0,South Africa
8481,5/1/2020,ZAF,Kedah,0,0,0,South Africa
8482,5/1/2020,ZAF,Kelantan,0,0,0,South Africa
8483,5/1/2020,ZAF,Melaka,0,0,0,South Africa
8484,5/1/2020,ZAF,Pahang,0,0,0,South Africa
8485,5/1/2020,ZAF,Perak,0,0,0,South Africa
8486,5/1/2020,ZAF,Perlis,0,0,0,South Africa
8487,5/1/2020,ZAF,Pulau Pinang,0,0,0,South Africa
8488,5/1/2020,ZAF,Sabah,0,0,0,South Africa
8489,5/1/2020,ZAF,Sarawak,0,0,0,South Africa
8490,5/1/2020,ZAF,Selangor,1,1,0,South Africa
8491,5/1/2020,ZAF,Terengganu,0,0,0,South Africa
8492,5/1/2020,ZAF,W.P. Labuan,0,0,0,South Africa
8493,5/1/2020,ZMB,Johor,0,0,0,Zambia
8494,5/1/2020,ZMB,Kedah,0,0,0,Zambia
8495,5/1/2020,ZMB,Perak,0,0,0,Zambia
8496,5/1/2020,ZMB,Perlis,0,0,0,Zambia
8497,5/1/2020,ZMB,Pulau Pinang,0,0,0,Zambia
8498,5/1/2020,ZMB,Sabah,0,0,0,Zambia
8499,5/1/2020,ZMB,Sarawak,0,0,0,Zambia
8500,5/1/2020,ZMB,Selangor,0,0,0,Zambia
8501,5/1/2020,ZWE,Johor,0,0,0,Zimbabwe
8502,5/1/2020,ZWE,Kedah,0,0,0,Zimbabwe
8503,5/1/2020,ZWE,Kelantan,0,0,0,Zimbabwe
8504,5/1/2020,ZWE,Perak,0,0,0,Zimbabwe
8505,5/1/2020,ZWE,Perlis,0,0,0,Zimbabwe
8506,5/1/2020,ZWE,Pulau Pinang,0,0,0,Zimbabwe
8507,5/1/2020,ZWE,Sabah,0,0,0,Zimbabwe
8508,5/1/2020,ZWE,Sarawak,0,0,0,Zimbabwe
8509,5/1/2020,ZWE,Selangor,0,0,0,Zimbabwe
8510,6/1/2020,ABW,Kedah,0,0,0,Aruba
8511,6/1/2020,ABW,Pulau Pinang,0,0,0,Aruba
8512,6/1/2020,AFG,Johor,0,0,0,Afghanistan
8513,6/1/2020,AFG,Kedah,0,0,0,Afghanistan
8514,6/1/2020,AFG,Perlis,0,0,0,Afghanistan
8515,6/1/2020,AFG,Pulau Pinang,0,0,0,Afghanistan
8516,6/1/2020,AFG,Sarawak,0,0,0,Afghanistan
8517,6/1/2020,AFG,Selangor,1,1,0,Afghanistan
8518,6/1/2020,AGO,Johor,0,0,0,Angola
8519,6/1/2020,AGO,Kedah,0,0,0,Angola
8520,6/1/2020,AGO,Sabah,0,0,0,Angola
8521,6/1/2020,AGO,Selangor,0,0,0,Angola
8522,6/1/2020,AIA,Selangor,0,0,0,Anguilla
8523,6/1/2020,ALB,Johor,0,0,0,Albania
8524,6/1/2020,ALB,Kedah,0,0,0,Albania
8525,6/1/2020,ALB,Perak,0,0,0,Albania
8526,6/1/2020,ALB,Perlis,0,0,0,Albania
8527,6/1/2020,ALB,Pulau Pinang,0,0,0,Albania
8528,6/1/2020,ALB,Sabah,0,0,0,Albania
8529,6/1/2020,ALB,Sarawak,0,0,0,Albania
8530,6/1/2020,ALB,Selangor,0,0,0,Albania
8531,6/1/2020,AND,Johor,0,0,0,Andorra
8532,6/1/2020,AND,Kedah,0,0,0,Andorra
8533,6/1/2020,AND,Perlis,0,0,0,Andorra
8534,6/1/2020,AND,Pulau Pinang,0,0,0,Andorra
8535,6/1/2020,AND,Selangor,0,0,0,Andorra
8536,6/1/2020,ANT,Selangor,0,0,0,Netherlands Antilles
8537,6/1/2020,ARE,Johor,0,0,0,United Arab Emirates
8538,6/1/2020,ARE,Kedah,0,0,0,United Arab Emirates
8539,6/1/2020,ARE,Kelantan,0,0,0,United Arab Emirates
8540,6/1/2020,ARE,Perak,0,0,0,United Arab Emirates
8541,6/1/2020,ARE,Perlis,0,0,0,United Arab Emirates
8542,6/1/2020,ARE,Pulau Pinang,0,0,0,United Arab Emirates
8543,6/1/2020,ARE,Sabah,0,0,0,United Arab Emirates
8544,6/1/2020,ARE,Sarawak,0,0,0,United Arab Emirates
8545,6/1/2020,ARE,Selangor,2,2,0,United Arab Emirates
8546,6/1/2020,ARG,Johor,0,0,0,Argentina
8547,6/1/2020,ARG,Kedah,0,0,0,Argentina
8548,6/1/2020,ARG,Kelantan,0,0,0,Argentina
8549,6/1/2020,ARG,Melaka,0,0,0,Argentina
8550,6/1/2020,ARG,Perak,0,0,0,Argentina
8551,6/1/2020,ARG,Perlis,0,0,0,Argentina
8552,6/1/2020,ARG,Pulau Pinang,0,0,0,Argentina
8553,6/1/2020,ARG,Sabah,0,0,0,Argentina
8554,6/1/2020,ARG,Sarawak,0,0,0,Argentina
8555,6/1/2020,ARG,Selangor,0,0,0,Argentina
8556,6/1/2020,ARG,W.P. Labuan,0,0,0,Argentina
8557,6/1/2020,ARM,Johor,0,0,0,Armenia
8558,6/1/2020,ARM,Kedah,0,0,0,Armenia
8559,6/1/2020,ARM,Kelantan,0,0,0,Armenia
8560,6/1/2020,ARM,Perak,0,0,0,Armenia
8561,6/1/2020,ARM,Perlis,0,0,0,Armenia
8562,6/1/2020,ARM,Pulau Pinang,0,0,0,Armenia
8563,6/1/2020,ARM,Sabah,0,0,0,Armenia
8564,6/1/2020,ARM,Sarawak,0,0,0,Armenia
8565,6/1/2020,ARM,Selangor,0,0,0,Armenia
8566,6/1/2020,ATA,Selangor,0,0,0,Antarctica
8567,6/1/2020,ATG,Johor,0,0,0,Antigua and Barbuda
8568,6/1/2020,ATG,Kedah,0,0,0,Antigua and Barbuda
8569,6/1/2020,ATG,Pulau Pinang,0,0,0,Antigua and Barbuda
8570,6/1/2020,ATG,Sarawak,0,0,0,Antigua and Barbuda
8571,6/1/2020,ATG,Selangor,0,0,0,Antigua and Barbuda
8572,6/1/2020,AUS,Johor,4,4,0,Australia
8573,6/1/2020,AUS,Kedah,0,0,0,Australia
8574,6/1/2020,AUS,Kelantan,0,0,0,Australia
8575,6/1/2020,AUS,Melaka,0,0,0,Australia
8576,6/1/2020,AUS,Negeri Sembilan,0,0,0,Australia
8577,6/1/2020,AUS,Pahang,0,0,0,Australia
8578,6/1/2020,AUS,Perak,0,0,0,Australia
8579,6/1/2020,AUS,Perlis,0,0,0,Australia
8580,6/1/2020,AUS,Pulau Pinang,0,0,0,Australia
8581,6/1/2020,AUS,Sabah,0,0,0,Australia
8582,6/1/2020,AUS,Sarawak,1,1,0,Australia
8583,6/1/2020,AUS,Selangor,36,21,15,Australia
8584,6/1/2020,AUS,Terengganu,0,0,0,Australia
8585,6/1/2020,AUS,W.P. Labuan,0,0,0,Australia
8586,6/1/2020,AUT,Johor,0,0,0,Austria
8587,6/1/2020,AUT,Kedah,0,0,0,Austria
8588,6/1/2020,AUT,Kelantan,0,0,0,Austria
8589,6/1/2020,AUT,Melaka,0,0,0,Austria
8590,6/1/2020,AUT,Negeri Sembilan,0,0,0,Austria
8591,6/1/2020,AUT,Pahang,0,0,0,Austria
8592,6/1/2020,AUT,Perak,0,0,0,Austria
8593,6/1/2020,AUT,Perlis,0,0,0,Austria
8594,6/1/2020,AUT,Pulau Pinang,0,0,0,Austria
8595,6/1/2020,AUT,Sabah,0,0,0,Austria
8596,6/1/2020,AUT,Sarawak,0,0,0,Austria
8597,6/1/2020,AUT,Selangor,0,0,0,Austria
8598,6/1/2020,AUT,Terengganu,0,0,0,Austria
8599,6/1/2020,AUT,W.P. Labuan,0,0,0,Austria
8600,6/1/2020,AZE,Johor,0,0,0,Azerbaijan
8601,6/1/2020,AZE,Kedah,0,0,0,Azerbaijan
8602,6/1/2020,AZE,Kelantan,0,0,0,Azerbaijan
8603,6/1/2020,AZE,Melaka,0,0,0,Azerbaijan
8604,6/1/2020,AZE,Perlis,0,0,0,Azerbaijan
8605,6/1/2020,AZE,Pulau Pinang,0,0,0,Azerbaijan
8606,6/1/2020,AZE,Sabah,0,0,0,Azerbaijan
8607,6/1/2020,AZE,Sarawak,0,0,0,Azerbaijan
8608,6/1/2020,AZE,Selangor,0,0,0,Azerbaijan
8609,6/1/2020,AZE,W.P. Labuan,0,0,0,Azerbaijan
8610,6/1/2020,BDI,Pulau Pinang,0,0,0,Burundi
8611,6/1/2020,BDI,Sarawak,0,0,0,Burundi
8612,6/1/2020,BDI,Selangor,0,0,0,Burundi
8613,6/1/2020,BEL,Johor,0,0,0,Belgium
8614,6/1/2020,BEL,Kedah,0,0,0,Belgium
8615,6/1/2020,BEL,Kelantan,0,0,0,Belgium
8616,6/1/2020,BEL,Melaka,0,0,0,Belgium
8617,6/1/2020,BEL,Negeri Sembilan,0,0,0,Belgium
8618,6/1/2020,BEL,Pahang,0,0,0,Belgium
8619,6/1/2020,BEL,Perak,0,0,0,Belgium
8620,6/1/2020,BEL,Perlis,0,0,0,Belgium
8621,6/1/2020,BEL,Pulau Pinang,0,0,0,Belgium
8622,6/1/2020,BEL,Sabah,0,0,0,Belgium
8623,6/1/2020,BEL,Sarawak,0,0,0,Belgium
8624,6/1/2020,BEL,Selangor,0,0,0,Belgium
8625,6/1/2020,BEL,W.P. Labuan,0,0,0,Belgium
8626,6/1/2020,BEN,Johor,0,0,0,Benin
8627,6/1/2020,BEN,Kedah,0,0,0,Benin
8628,6/1/2020,BEN,Perak,0,0,0,Benin
8629,6/1/2020,BEN,Pulau Pinang,0,0,0,Benin
8630,6/1/2020,BEN,Sabah,0,0,0,Benin
8631,6/1/2020,BEN,Sarawak,0,0,0,Benin
8632,6/1/2020,BEN,Selangor,0,0,0,Benin
8633,6/1/2020,BFA,Perak,0,0,0,Burkina Faso
8634,6/1/2020,BFA,Pulau Pinang,0,0,0,Burkina Faso
8635,6/1/2020,BFA,Selangor,0,0,0,Burkina Faso
8636,6/1/2020,BGD,Johor,0,0,0,Bangladesh
8637,6/1/2020,BGD,Kedah,0,0,0,Bangladesh
8638,6/1/2020,BGD,Kelantan,0,0,0,Bangladesh
8639,6/1/2020,BGD,Melaka,0,0,0,Bangladesh
8640,6/1/2020,BGD,Negeri Sembilan,0,0,0,Bangladesh
8641,6/1/2020,BGD,Pahang,0,0,0,Bangladesh
8642,6/1/2020,BGD,Perak,0,0,0,Bangladesh
8643,6/1/2020,BGD,Perlis,0,0,0,Bangladesh
8644,6/1/2020,BGD,Pulau Pinang,0,0,0,Bangladesh
8645,6/1/2020,BGD,Sabah,0,0,0,Bangladesh
8646,6/1/2020,BGD,Sarawak,0,0,0,Bangladesh
8647,6/1/2020,BGD,Selangor,39,32,7,Bangladesh
8648,6/1/2020,BGD,W.P. Labuan,0,0,0,Bangladesh
8649,6/1/2020,BGR,Johor,0,0,0,Bulgaria
8650,6/1/2020,BGR,Kedah,0,0,0,Bulgaria
8651,6/1/2020,BGR,Kelantan,0,0,0,Bulgaria
8652,6/1/2020,BGR,Pahang,0,0,0,Bulgaria
8653,6/1/2020,BGR,Perak,0,0,0,Bulgaria
8654,6/1/2020,BGR,Perlis,0,0,0,Bulgaria
8655,6/1/2020,BGR,Pulau Pinang,0,0,0,Bulgaria
8656,6/1/2020,BGR,Sabah,0,0,0,Bulgaria
8657,6/1/2020,BGR,Sarawak,0,0,0,Bulgaria
8658,6/1/2020,BGR,Selangor,0,0,0,Bulgaria
8659,6/1/2020,BGR,W.P. Labuan,0,0,0,Bulgaria
8660,6/1/2020,BHR,Johor,0,0,0,Bahrain
8661,6/1/2020,BHR,Kedah,0,0,0,Bahrain
8662,6/1/2020,BHR,Kelantan,0,0,0,Bahrain
8663,6/1/2020,BHR,Perlis,0,0,0,Bahrain
8664,6/1/2020,BHR,Pulau Pinang,0,0,0,Bahrain
8665,6/1/2020,BHR,Sabah,0,0,0,Bahrain
8666,6/1/2020,BHR,Sarawak,0,0,0,Bahrain
8667,6/1/2020,BHR,Selangor,0,0,0,Bahrain
8668,6/1/2020,BHS,Johor,0,0,0,Bahamas
8669,6/1/2020,BHS,Kedah,0,0,0,Bahamas
8670,6/1/2020,BHS,Perak,0,0,0,Bahamas
8671,6/1/2020,BHS,Sabah,0,0,0,Bahamas
8672,6/1/2020,BHS,Sarawak,0,0,0,Bahamas
8673,6/1/2020,BHS,Selangor,0,0,0,Bahamas
8674,6/1/2020,BIH,Johor,0,0,0,Bosnia and Herzegovina
8675,6/1/2020,BIH,Kedah,0,0,0,Bosnia and Herzegovina
8676,6/1/2020,BIH,Perlis,0,0,0,Bosnia and Herzegovina
8677,6/1/2020,BIH,Pulau Pinang,0,0,0,Bosnia and Herzegovina
8678,6/1/2020,BIH,Sabah,0,0,0,Bosnia and Herzegovina
8679,6/1/2020,BIH,Sarawak,0,0,0,Bosnia and Herzegovina
8680,6/1/2020,BIH,Selangor,0,0,0,Bosnia and Herzegovina
8681,6/1/2020,BLR,Johor,0,0,0,Belarus
8682,6/1/2020,BLR,Kedah,0,0,0,Belarus
8683,6/1/2020,BLR,Kelantan,0,0,0,Belarus
8684,6/1/2020,BLR,Pahang,0,0,0,Belarus
8685,6/1/2020,BLR,Perak,0,0,0,Belarus
8686,6/1/2020,BLR,Perlis,0,0,0,Belarus
8687,6/1/2020,BLR,Pulau Pinang,0,0,0,Belarus
8688,6/1/2020,BLR,Sabah,0,0,0,Belarus
8689,6/1/2020,BLR,Sarawak,0,0,0,Belarus
8690,6/1/2020,BLR,Selangor,0,0,0,Belarus
8691,6/1/2020,BLR,W.P. Labuan,0,0,0,Belarus
8692,6/1/2020,BLZ,Johor,0,0,0,Belize
8693,6/1/2020,BLZ,Pulau Pinang,0,0,0,Belize
8694,6/1/2020,BLZ,Sarawak,0,0,0,Belize
8695,6/1/2020,BLZ,Selangor,0,0,0,Belize
8696,6/1/2020,BMU,Selangor,0,0,0,Bermuda
8697,6/1/2020,BOL,Johor,0,0,0,Bolivia
8698,6/1/2020,BOL,Kedah,0,0,0,Bolivia
8699,6/1/2020,BOL,Melaka,0,0,0,Bolivia
8700,6/1/2020,BOL,Perak,0,0,0,Bolivia
8701,6/1/2020,BOL,Perlis,0,0,0,Bolivia
8702,6/1/2020,BOL,Pulau Pinang,0,0,0,Bolivia
8703,6/1/2020,BOL,Sabah,0,0,0,Bolivia
8704,6/1/2020,BOL,Sarawak,0,0,0,Bolivia
8705,6/1/2020,BOL,Selangor,0,0,0,Bolivia
8706,6/1/2020,BRA,Johor,0,0,0,Brazil
8707,6/1/2020,BRA,Kedah,0,0,0,Brazil
8708,6/1/2020,BRA,Kelantan,0,0,0,Brazil
8709,6/1/2020,BRA,Melaka,0,0,0,Brazil
8710,6/1/2020,BRA,Pahang,0,0,0,Brazil
8711,6/1/2020,BRA,Perak,0,0,0,Brazil
8712,6/1/2020,BRA,Perlis,0,0,0,Brazil
8713,6/1/2020,BRA,Pulau Pinang,0,0,0,Brazil
8714,6/1/2020,BRA,Sabah,0,0,0,Brazil
8715,6/1/2020,BRA,Sarawak,0,0,0,Brazil
8716,6/1/2020,BRA,Selangor,2,2,0,Brazil
8717,6/1/2020,BRA,W.P. Labuan,0,0,0,Brazil
8718,6/1/2020,BRB,Johor,0,0,0,Barbados
8719,6/1/2020,BRB,Kedah,0,0,0,Barbados
8720,6/1/2020,BRB,Perlis,0,0,0,Barbados
8721,6/1/2020,BRB,Pulau Pinang,0,0,0,Barbados
8722,6/1/2020,BRB,Selangor,0,0,0,Barbados
8723,6/1/2020,BRN,Johor,0,0,0,Brunei Darussalam
8724,6/1/2020,BRN,Kedah,0,0,0,Brunei Darussalam
8725,6/1/2020,BRN,Kelantan,0,0,0,Brunei Darussalam
8726,6/1/2020,BRN,Melaka,0,0,0,Brunei Darussalam
8727,6/1/2020,BRN,Pahang,0,0,0,Brunei Darussalam
8728,6/1/2020,BRN,Perak,0,0,0,Brunei Darussalam
8729,6/1/2020,BRN,Perlis,0,0,0,Brunei Darussalam
8730,6/1/2020,BRN,Pulau Pinang,0,0,0,Brunei Darussalam
8731,6/1/2020,BRN,Sabah,0,0,0,Brunei Darussalam
8732,6/1/2020,BRN,Sarawak,428,411,17,Brunei Darussalam
8733,6/1/2020,BRN,Selangor,37,34,3,Brunei Darussalam
8734,6/1/2020,BRN,W.P. Labuan,0,0,0,Brunei Darussalam
8735,6/1/2020,BTN,Johor,0,0,0,Bhutan
8736,6/1/2020,BTN,Kedah,0,0,0,Bhutan
8737,6/1/2020,BTN,Perak,0,0,0,Bhutan
8738,6/1/2020,BTN,Perlis,0,0,0,Bhutan
8739,6/1/2020,BTN,Pulau Pinang,0,0,0,Bhutan
8740,6/1/2020,BTN,Sabah,0,0,0,Bhutan
8741,6/1/2020,BTN,Sarawak,0,0,0,Bhutan
8742,6/1/2020,BTN,Selangor,0,0,0,Bhutan
8743,6/1/2020,BWA,Johor,0,0,0,Botswana
8744,6/1/2020,BWA,Kedah,0,0,0,Botswana
8745,6/1/2020,BWA,Perlis,0,0,0,Botswana
8746,6/1/2020,BWA,Pulau Pinang,0,0,0,Botswana
8747,6/1/2020,BWA,Sabah,0,0,0,Botswana
8748,6/1/2020,BWA,Sarawak,0,0,0,Botswana
8749,6/1/2020,BWA,Selangor,0,0,0,Botswana
8750,6/1/2020,CAF,Kedah,0,0,0,Central African Republic
8751,6/1/2020,CAF,Selangor,0,0,0,Central African Republic
8752,6/1/2020,CAN,Johor,0,0,0,Canada
8753,6/1/2020,CAN,Kedah,0,0,0,Canada
8754,6/1/2020,CAN,Kelantan,0,0,0,Canada
8755,6/1/2020,CAN,Melaka,0,0,0,Canada
8756,6/1/2020,CAN,Negeri Sembilan,0,0,0,Canada
8757,6/1/2020,CAN,Pahang,0,0,0,Canada
8758,6/1/2020,CAN,Perak,0,0,0,Canada
8759,6/1/2020,CAN,Perlis,0,0,0,Canada
8760,6/1/2020,CAN,Pulau Pinang,0,0,0,Canada
8761,6/1/2020,CAN,Sabah,0,0,0,Canada
8762,6/1/2020,CAN,Sarawak,1,1,0,Canada
8763,6/1/2020,CAN,Selangor,14,12,2,Canada
8764,6/1/2020,CAN,Terengganu,0,0,0,Canada
8765,6/1/2020,CAN,W.P. Labuan,0,0,0,Canada
8766,6/1/2020,CCK,Selangor,0,0,0,Cocos (Keeling) Islands
8767,6/1/2020,CHE,Johor,1,1,0,Switzerland
8768,6/1/2020,CHE,Kedah,0,0,0,Switzerland
8769,6/1/2020,CHE,Kelantan,0,0,0,Switzerland
8770,6/1/2020,CHE,Melaka,0,0,0,Switzerland
8771,6/1/2020,CHE,Negeri Sembilan,0,0,0,Switzerland
8772,6/1/2020,CHE,Pahang,0,0,0,Switzerland
8773,6/1/2020,CHE,Perak,0,0,0,Switzerland
8774,6/1/2020,CHE,Perlis,0,0,0,Switzerland
8775,6/1/2020,CHE,Pulau Pinang,0,0,0,Switzerland
8776,6/1/2020,CHE,Sabah,0,0,0,Switzerland
8777,6/1/2020,CHE,Sarawak,0,0,0,Switzerland
8778,6/1/2020,CHE,Selangor,2,2,0,Switzerland
8779,6/1/2020,CHE,W.P. Labuan,0,0,0,Switzerland
8780,6/1/2020,CHL,Johor,0,0,0,Chile
8781,6/1/2020,CHL,Kedah,0,0,0,Chile
8782,6/1/2020,CHL,Kelantan,0,0,0,Chile
8783,6/1/2020,CHL,Melaka,0,0,0,Chile
8784,6/1/2020,CHL,Pahang,0,0,0,Chile
8785,6/1/2020,CHL,Perak,0,0,0,Chile
8786,6/1/2020,CHL,Perlis,0,0,0,Chile
8787,6/1/2020,CHL,Pulau Pinang,0,0,0,Chile
8788,6/1/2020,CHL,Sabah,0,0,0,Chile
8789,6/1/2020,CHL,Sarawak,0,0,0,Chile
8790,6/1/2020,CHL,Selangor,0,0,0,Chile
8791,6/1/2020,CHN,Johor,0,0,0,China
8792,6/1/2020,CHN,Kedah,0,0,0,China
8793,6/1/2020,CHN,Kelantan,0,0,0,China
8794,6/1/2020,CHN,Melaka,0,0,0,China
8795,6/1/2020,CHN,Pahang,0,0,0,China
8796,6/1/2020,CHN,Perak,0,0,0,China
8797,6/1/2020,CHN,Perlis,0,0,0,China
8798,6/1/2020,CHN,Pulau Pinang,0,0,0,China
8799,6/1/2020,CHN,Sabah,0,0,0,China
8800,6/1/2020,CHN,Sarawak,2,0,2,China
8801,6/1/2020,CHN,Selangor,194,135,59,China
8802,6/1/2020,CHN,Terengganu,0,0,0,China
8803,6/1/2020,CHN,W.P. Labuan,0,0,0,China
8804,6/1/2020,CIV,Johor,0,0,0,C��te d'Iv
8805,6/1/2020,CIV,Kedah,0,0,0,C��te d'Iv
8806,6/1/2020,CIV,Pulau Pinang,0,0,0,C��te d'Iv
8807,6/1/2020,CIV,Sabah,0,0,0,C��te d'Iv
8808,6/1/2020,CIV,Sarawak,0,0,0,C��te d'Iv
8809,6/1/2020,CIV,Selangor,0,0,0,C��te d'Iv
8810,6/1/2020,CMR,Johor,0,0,0,Cameroon
8811,6/1/2020,CMR,Kedah,0,0,0,Cameroon
8812,6/1/2020,CMR,Pulau Pinang,0,0,0,Cameroon
8813,6/1/2020,CMR,Sabah,0,0,0,Cameroon
8814,6/1/2020,CMR,Sarawak,0,0,0,Cameroon
8815,6/1/2020,CMR,Selangor,0,0,0,Cameroon
8816,6/1/2020,COD,Johor,0,0,0,"Congo, the Democratic Republic of the"
8817,6/1/2020,COD,Pulau Pinang,0,0,0,"Congo, the Democratic Republic of the"
8818,6/1/2020,COD,Sarawak,0,0,0,"Congo, the Democratic Republic of the"
8819,6/1/2020,COD,Selangor,0,0,0,"Congo, the Democratic Republic of the"
8820,6/1/2020,COG,Johor,0,0,0,Congo
8821,6/1/2020,COG,Kedah,0,0,0,Congo
8822,6/1/2020,COG,Selangor,0,0,0,Congo
8823,6/1/2020,COK,Selangor,0,0,0,Cook Islands
8824,6/1/2020,COL,Johor,0,0,0,Colombia
8825,6/1/2020,COL,Kedah,0,0,0,Colombia
8826,6/1/2020,COL,Perak,0,0,0,Colombia
8827,6/1/2020,COL,Pulau Pinang,0,0,0,Colombia
8828,6/1/2020,COL,Sabah,0,0,0,Colombia
8829,6/1/2020,COL,Sarawak,0,0,0,Colombia
8830,6/1/2020,COL,Selangor,0,0,0,Colombia
8831,6/1/2020,COL,W.P. Labuan,0,0,0,Colombia
8832,6/1/2020,COM,Johor,0,0,0,Comoros
8833,6/1/2020,COM,Kedah,0,0,0,Comoros
8834,6/1/2020,COM,Selangor,0,0,0,Comoros
8835,6/1/2020,CPV,Johor,0,0,0,Cape Verde
8836,6/1/2020,CPV,Kedah,0,0,0,Cape Verde
8837,6/1/2020,CPV,Pulau Pinang,0,0,0,Cape Verde
8838,6/1/2020,CPV,Sabah,0,0,0,Cape Verde
8839,6/1/2020,CPV,Selangor,0,0,0,Cape Verde
8840,6/1/2020,CRI,Johor,0,0,0,Costa Rica
8841,6/1/2020,CRI,Kedah,0,0,0,Costa Rica
8842,6/1/2020,CRI,Perak,0,0,0,Costa Rica
8843,6/1/2020,CRI,Perlis,0,0,0,Costa Rica
8844,6/1/2020,CRI,Pulau Pinang,0,0,0,Costa Rica
8845,6/1/2020,CRI,Sabah,0,0,0,Costa Rica
8846,6/1/2020,CRI,Sarawak,0,0,0,Costa Rica
8847,6/1/2020,CRI,Selangor,0,0,0,Costa Rica
8848,6/1/2020,CUB,Johor,0,0,0,Cuba
8849,6/1/2020,CUB,Kedah,0,0,0,Cuba
8850,6/1/2020,CUB,Perlis,0,0,0,Cuba
8851,6/1/2020,CUB,Pulau Pinang,0,0,0,Cuba
8852,6/1/2020,CUB,Sabah,0,0,0,Cuba
8853,6/1/2020,CUB,Sarawak,0,0,0,Cuba
8854,6/1/2020,CUB,Selangor,0,0,0,Cuba
8855,6/1/2020,CYP,Johor,0,0,0,Cyprus
8856,6/1/2020,CYP,Kedah,0,0,0,Cyprus
8857,6/1/2020,CYP,Perak,0,0,0,Cyprus
8858,6/1/2020,CYP,Perlis,0,0,0,Cyprus
8859,6/1/2020,CYP,Pulau Pinang,0,0,0,Cyprus
8860,6/1/2020,CYP,Sabah,0,0,0,Cyprus
8861,6/1/2020,CYP,Sarawak,0,0,0,Cyprus
8862,6/1/2020,CYP,Selangor,0,0,0,Cyprus
8863,6/1/2020,CZE,Johor,0,0,0,Czech Republic
8864,6/1/2020,CZE,Kedah,0,0,0,Czech Republic
8865,6/1/2020,CZE,Kelantan,0,0,0,Czech Republic
8866,6/1/2020,CZE,Melaka,0,0,0,Czech Republic
8867,6/1/2020,CZE,Negeri Sembilan,0,0,0,Czech Republic
8868,6/1/2020,CZE,Perak,0,0,0,Czech Republic
8869,6/1/2020,CZE,Perlis,0,0,0,Czech Republic
8870,6/1/2020,CZE,Pulau Pinang,0,0,0,Czech Republic
8871,6/1/2020,CZE,Sabah,0,0,0,Czech Republic
8872,6/1/2020,CZE,Sarawak,0,0,0,Czech Republic
8873,6/1/2020,CZE,Selangor,1,1,0,Czech Republic
8874,6/1/2020,CZE,W.P. Labuan,0,0,0,Czech Republic
8875,6/1/2020,DEU,Johor,0,0,0,Germany
8876,6/1/2020,DEU,Kedah,0,0,0,Germany
8877,6/1/2020,DEU,Kelantan,0,0,0,Germany
8878,6/1/2020,DEU,Melaka,0,0,0,Germany
8879,6/1/2020,DEU,Negeri Sembilan,0,0,0,Germany
8880,6/1/2020,DEU,Pahang,0,0,0,Germany
8881,6/1/2020,DEU,Perak,0,0,0,Germany
8882,6/1/2020,DEU,Perlis,0,0,0,Germany
8883,6/1/2020,DEU,Pulau Pinang,0,0,0,Germany
8884,6/1/2020,DEU,Sabah,0,0,0,Germany
8885,6/1/2020,DEU,Sarawak,1,1,0,Germany
8886,6/1/2020,DEU,Selangor,18,15,3,Germany
8887,6/1/2020,DEU,Terengganu,0,0,0,Germany
8888,6/1/2020,DEU,W.P. Labuan,0,0,0,Germany
8889,6/1/2020,DJI,Johor,0,0,0,Djibouti
8890,6/1/2020,DJI,Selangor,0,0,0,Djibouti
8891,6/1/2020,DMA,Johor,0,0,0,Dominica
8892,6/1/2020,DMA,Kedah,0,0,0,Dominica
8893,6/1/2020,DMA,Pulau Pinang,0,0,0,Dominica
8894,6/1/2020,DMA,Sabah,0,0,0,Dominica
8895,6/1/2020,DMA,Sarawak,0,0,0,Dominica
8896,6/1/2020,DMA,Selangor,1,1,0,Dominica
8897,6/1/2020,DMA,W.P. Labuan,0,0,0,Dominica
8898,6/1/2020,DNK,Johor,0,0,0,Denmark
8899,6/1/2020,DNK,Kedah,0,0,0,Denmark
8900,6/1/2020,DNK,Kelantan,0,0,0,Denmark
8901,6/1/2020,DNK,Melaka,0,0,0,Denmark
8902,6/1/2020,DNK,Negeri Sembilan,0,0,0,Denmark
8903,6/1/2020,DNK,Pahang,0,0,0,Denmark
8904,6/1/2020,DNK,Perak,0,0,0,Denmark
8905,6/1/2020,DNK,Perlis,0,0,0,Denmark
8906,6/1/2020,DNK,Pulau Pinang,0,0,0,Denmark
8907,6/1/2020,DNK,Sabah,0,0,0,Denmark
8908,6/1/2020,DNK,Sarawak,0,0,0,Denmark
8909,6/1/2020,DNK,Selangor,2,2,0,Denmark
8910,6/1/2020,DNK,W.P. Labuan,0,0,0,Denmark
8911,6/1/2020,DOM,Johor,0,0,0,Dominican Republic
8912,6/1/2020,DOM,Kedah,0,0,0,Dominican Republic
8913,6/1/2020,DOM,Perak,0,0,0,Dominican Republic
8914,6/1/2020,DOM,Perlis,0,0,0,Dominican Republic
8915,6/1/2020,DOM,Pulau Pinang,0,0,0,Dominican Republic
8916,6/1/2020,DOM,Sabah,0,0,0,Dominican Republic
8917,6/1/2020,DOM,Sarawak,0,0,0,Dominican Republic
8918,6/1/2020,DOM,Selangor,0,0,0,Dominican Republic
8919,6/1/2020,DZA,Johor,0,0,0,Algeria
8920,6/1/2020,DZA,Kedah,0,0,0,Algeria
8921,6/1/2020,DZA,Kelantan,0,0,0,Algeria
8922,6/1/2020,DZA,Melaka,0,0,0,Algeria
8923,6/1/2020,DZA,Perak,0,0,0,Algeria
8924,6/1/2020,DZA,Perlis,0,0,0,Algeria
8925,6/1/2020,DZA,Pulau Pinang,0,0,0,Algeria
8926,6/1/2020,DZA,Sabah,0,0,0,Algeria
8927,6/1/2020,DZA,Sarawak,0,0,0,Algeria
8928,6/1/2020,DZA,Selangor,1,1,0,Algeria
8929,6/1/2020,DZA,W.P. Labuan,0,0,0,Algeria
8930,6/1/2020,ECU,Johor,0,0,0,Ecuador
8931,6/1/2020,ECU,Kedah,0,0,0,Ecuador
8932,6/1/2020,ECU,Perak,0,0,0,Ecuador
8933,6/1/2020,ECU,Perlis,0,0,0,Ecuador
8934,6/1/2020,ECU,Pulau Pinang,0,0,0,Ecuador
8935,6/1/2020,ECU,Sabah,0,0,0,Ecuador
8936,6/1/2020,ECU,Sarawak,0,0,0,Ecuador
8937,6/1/2020,ECU,Selangor,1,0,1,Ecuador
8938,6/1/2020,EGY,Johor,0,0,0,Egypt
8939,6/1/2020,EGY,Kedah,0,0,0,Egypt
8940,6/1/2020,EGY,Kelantan,0,0,0,Egypt
8941,6/1/2020,EGY,Melaka,0,0,0,Egypt
8942,6/1/2020,EGY,Pahang,0,0,0,Egypt
8943,6/1/2020,EGY,Perak,0,0,0,Egypt
8944,6/1/2020,EGY,Perlis,0,0,0,Egypt
8945,6/1/2020,EGY,Pulau Pinang,0,0,0,Egypt
8946,6/1/2020,EGY,Sabah,0,0,0,Egypt
8947,6/1/2020,EGY,Sarawak,0,0,0,Egypt
8948,6/1/2020,EGY,Selangor,3,3,0,Egypt
8949,6/1/2020,EGY,Terengganu,0,0,0,Egypt
8950,6/1/2020,EGY,W.P. Labuan,0,0,0,Egypt
8951,6/1/2020,ERI,Johor,0,0,0,Eritrea
8952,6/1/2020,ERI,Pulau Pinang,0,0,0,Eritrea
8953,6/1/2020,ERI,Sabah,0,0,0,Eritrea
8954,6/1/2020,ERI,Selangor,0,0,0,Eritrea
8955,6/1/2020,ESP,Johor,0,0,0,Spain
8956,6/1/2020,ESP,Kedah,0,0,0,Spain
8957,6/1/2020,ESP,Kelantan,0,0,0,Spain
8958,6/1/2020,ESP,Melaka,0,0,0,Spain
8959,6/1/2020,ESP,Negeri Sembilan,0,0,0,Spain
8960,6/1/2020,ESP,Pahang,0,0,0,Spain
8961,6/1/2020,ESP,Perak,0,0,0,Spain
8962,6/1/2020,ESP,Perlis,0,0,0,Spain
8963,6/1/2020,ESP,Pulau Pinang,0,0,0,Spain
8964,6/1/2020,ESP,Sabah,0,0,0,Spain
8965,6/1/2020,ESP,Sarawak,0,0,0,Spain
8966,6/1/2020,ESP,Selangor,3,1,2,Spain
8967,6/1/2020,ESP,W.P. Labuan,0,0,0,Spain
8968,6/1/2020,EST,Johor,0,0,0,Estonia
8969,6/1/2020,EST,Kedah,0,0,0,Estonia
8970,6/1/2020,EST,Kelantan,0,0,0,Estonia
8971,6/1/2020,EST,Pahang,0,0,0,Estonia
8972,6/1/2020,EST,Perak,0,0,0,Estonia
8973,6/1/2020,EST,Perlis,0,0,0,Estonia
8974,6/1/2020,EST,Pulau Pinang,0,0,0,Estonia
8975,6/1/2020,EST,Sabah,0,0,0,Estonia
8976,6/1/2020,EST,Sarawak,0,0,0,Estonia
8977,6/1/2020,EST,Selangor,0,0,0,Estonia
8978,6/1/2020,EST,W.P. Labuan,0,0,0,Estonia
8979,6/1/2020,ETH,Johor,0,0,0,Ethiopia
8980,6/1/2020,ETH,Kedah,0,0,0,Ethiopia
8981,6/1/2020,ETH,Pulau Pinang,0,0,0,Ethiopia
8982,6/1/2020,ETH,Sarawak,0,0,0,Ethiopia
8983,6/1/2020,ETH,Selangor,0,0,0,Ethiopia
8984,6/1/2020,FIN,Johor,0,0,0,Finland
8985,6/1/2020,FIN,Kedah,0,0,0,Finland
8986,6/1/2020,FIN,Kelantan,0,0,0,Finland
8987,6/1/2020,FIN,Melaka,0,0,0,Finland
8988,6/1/2020,FIN,Negeri Sembilan,0,0,0,Finland
8989,6/1/2020,FIN,Pahang,0,0,0,Finland
8990,6/1/2020,FIN,Perak,0,0,0,Finland
8991,6/1/2020,FIN,Perlis,0,0,0,Finland
8992,6/1/2020,FIN,Pulau Pinang,0,0,0,Finland
8993,6/1/2020,FIN,Sabah,0,0,0,Finland
8994,6/1/2020,FIN,Sarawak,0,0,0,Finland
8995,6/1/2020,FIN,Selangor,0,0,0,Finland
8996,6/1/2020,FIN,W.P. Labuan,0,0,0,Finland
8997,6/1/2020,FJI,Johor,0,0,0,Fiji
8998,6/1/2020,FJI,Kedah,0,0,0,Fiji
8999,6/1/2020,FJI,Kelantan,0,0,0,Fiji
9000,6/1/2020,FJI,Perak,0,0,0,Fiji
9001,6/1/2020,FJI,Perlis,0,0,0,Fiji
9002,6/1/2020,FJI,Pulau Pinang,0,0,0,Fiji
9003,6/1/2020,FJI,Sabah,0,0,0,Fiji
9004,6/1/2020,FJI,Sarawak,0,0,0,Fiji
9005,6/1/2020,FJI,Selangor,0,0,0,Fiji
9006,6/1/2020,FRA,Johor,3,2,1,France
9007,6/1/2020,FRA,Kedah,0,0,0,France
9008,6/1/2020,FRA,Kelantan,0,0,0,France
9009,6/1/2020,FRA,Melaka,0,0,0,France
9010,6/1/2020,FRA,Negeri Sembilan,0,0,0,France
9011,6/1/2020,FRA,Pahang,0,0,0,France
9012,6/1/2020,FRA,Perak,0,0,0,France
9013,6/1/2020,FRA,Perlis,0,0,0,France
9014,6/1/2020,FRA,Pulau Pinang,1,1,0,France
9015,6/1/2020,FRA,Sabah,0,0,0,France
9016,6/1/2020,FRA,Sarawak,0,0,0,France
9017,6/1/2020,FRA,Selangor,22,18,4,France
9018,6/1/2020,FRA,Terengganu,0,0,0,France
9019,6/1/2020,FRA,W.P. Labuan,0,0,0,France
9020,6/1/2020,FSM,Johor,0,0,0,"Micronesia, Federated States of"
9021,6/1/2020,FSM,Pulau Pinang,0,0,0,"Micronesia, Federated States of"
9022,6/1/2020,FSM,Selangor,0,0,0,"Micronesia, Federated States of"
9023,6/1/2020,GAB,Johor,0,0,0,Gabon
9024,6/1/2020,GAB,Pulau Pinang,0,0,0,Gabon
9025,6/1/2020,GAB,Sarawak,0,0,0,Gabon
9026,6/1/2020,GAB,Selangor,0,0,0,Gabon
9027,6/1/2020,GBR,Johor,4,4,0,United Kingdom
9028,6/1/2020,GBR,Kedah,0,0,0,United Kingdom
9029,6/1/2020,GBR,Kelantan,0,0,0,United Kingdom
9030,6/1/2020,GBR,Melaka,0,0,0,United Kingdom
9031,6/1/2020,GBR,Negeri Sembilan,0,0,0,United Kingdom
9032,6/1/2020,GBR,Pahang,0,0,0,United Kingdom
9033,6/1/2020,GBR,Perak,0,0,0,United Kingdom
9034,6/1/2020,GBR,Perlis,0,0,0,United Kingdom
9035,6/1/2020,GBR,Pulau Pinang,0,0,0,United Kingdom
9036,6/1/2020,GBR,Sabah,0,0,0,United Kingdom
9037,6/1/2020,GBR,Sarawak,3,3,0,United Kingdom
9038,6/1/2020,GBR,Selangor,94,78,16,United Kingdom
9039,6/1/2020,GBR,Terengganu,0,0,0,United Kingdom
9040,6/1/2020,GBR,W.P. Labuan,0,0,0,United Kingdom
9041,6/1/2020,GEO,Johor,0,0,0,Georgia
9042,6/1/2020,GEO,Kedah,0,0,0,Georgia
9043,6/1/2020,GEO,Melaka,0,0,0,Georgia
9044,6/1/2020,GEO,Perak,0,0,0,Georgia
9045,6/1/2020,GEO,Perlis,0,0,0,Georgia
9046,6/1/2020,GEO,Pulau Pinang,0,0,0,Georgia
9047,6/1/2020,GEO,Sabah,0,0,0,Georgia
9048,6/1/2020,GEO,Sarawak,0,0,0,Georgia
9049,6/1/2020,GEO,Selangor,1,1,0,Georgia
9050,6/1/2020,GHA,Johor,0,0,0,Ghana
9051,6/1/2020,GHA,Kedah,0,0,0,Ghana
9052,6/1/2020,GHA,Kelantan,0,0,0,Ghana
9053,6/1/2020,GHA,Pulau Pinang,0,0,0,Ghana
9054,6/1/2020,GHA,Sabah,0,0,0,Ghana
9055,6/1/2020,GHA,Sarawak,0,0,0,Ghana
9056,6/1/2020,GHA,Selangor,0,0,0,Ghana
9057,6/1/2020,GIB,Johor,0,0,0,Gibraltar
9058,6/1/2020,GIB,Sarawak,0,0,0,Gibraltar
9059,6/1/2020,GIN,Johor,0,0,0,Guinea
9060,6/1/2020,GIN,Kedah,0,0,0,Guinea
9061,6/1/2020,GIN,Kelantan,0,0,0,Guinea
9062,6/1/2020,GIN,Perlis,0,0,0,Guinea
9063,6/1/2020,GIN,Pulau Pinang,0,0,0,Guinea
9064,6/1/2020,GIN,Sabah,0,0,0,Guinea
9065,6/1/2020,GIN,Sarawak,0,0,0,Guinea
9066,6/1/2020,GIN,Selangor,0,0,0,Guinea
9067,6/1/2020,GLP,Selangor,0,0,0,Guadeloupe
9068,6/1/2020,GMB,Johor,0,0,0,Gambia
9069,6/1/2020,GMB,Kedah,0,0,0,Gambia
9070,6/1/2020,GMB,Kelantan,0,0,0,Gambia
9071,6/1/2020,GMB,Pulau Pinang,0,0,0,Gambia
9072,6/1/2020,GMB,Sabah,0,0,0,Gambia
9073,6/1/2020,GMB,Sarawak,0,0,0,Gambia
9074,6/1/2020,GMB,Selangor,0,0,0,Gambia
9075,6/1/2020,GNB,Johor,0,0,0,Guinea-Bissau
9076,6/1/2020,GNB,Selangor,0,0,0,Guinea-Bissau
9077,6/1/2020,GNQ,Johor,0,0,0,Equatorial Guinea
9078,6/1/2020,GNQ,Selangor,0,0,0,Equatorial Guinea
9079,6/1/2020,GRC,Johor,0,0,0,Greece
9080,6/1/2020,GRC,Kedah,0,0,0,Greece
9081,6/1/2020,GRC,Kelantan,0,0,0,Greece
9082,6/1/2020,GRC,Melaka,0,0,0,Greece
9083,6/1/2020,GRC,Negeri Sembilan,0,0,0,Greece
9084,6/1/2020,GRC,Pahang,0,0,0,Greece
9085,6/1/2020,GRC,Perak,0,0,0,Greece
9086,6/1/2020,GRC,Perlis,0,0,0,Greece
9087,6/1/2020,GRC,Pulau Pinang,0,0,0,Greece
9088,6/1/2020,GRC,Sabah,0,0,0,Greece
9089,6/1/2020,GRC,Sarawak,0,0,0,Greece
9090,6/1/2020,GRC,Selangor,2,1,1,Greece
9091,6/1/2020,GRD,Johor,0,0,0,Grenada
9092,6/1/2020,GRD,Kedah,0,0,0,Grenada
9093,6/1/2020,GRD,Pulau Pinang,0,0,0,Grenada
9094,6/1/2020,GRD,Sabah,0,0,0,Grenada
9095,6/1/2020,GRD,Sarawak,0,0,0,Grenada
9096,6/1/2020,GRD,Selangor,0,0,0,Grenada
9097,6/1/2020,GRL,Johor,0,0,0,Greenland
9098,6/1/2020,GRL,Selangor,0,0,0,Greenland
9099,6/1/2020,GTM,Johor,0,0,0,Guatemala
9100,6/1/2020,GTM,Kedah,0,0,0,Guatemala
9101,6/1/2020,GTM,Pahang,0,0,0,Guatemala
9102,6/1/2020,GTM,Perak,0,0,0,Guatemala
9103,6/1/2020,GTM,Pulau Pinang,0,0,0,Guatemala
9104,6/1/2020,GTM,Sabah,0,0,0,Guatemala
9105,6/1/2020,GTM,Sarawak,0,0,0,Guatemala
9106,6/1/2020,GTM,Selangor,0,0,0,Guatemala
9107,6/1/2020,GTM,W.P. Labuan,0,0,0,Guatemala
9108,6/1/2020,GUY,Johor,0,0,0,Guyana
9109,6/1/2020,GUY,Kedah,0,0,0,Guyana
9110,6/1/2020,GUY,Pulau Pinang,0,0,0,Guyana
9111,6/1/2020,GUY,Sarawak,0,0,0,Guyana
9112,6/1/2020,GUY,Selangor,0,0,0,Guyana
9113,6/1/2020,HKG,Johor,0,0,0,Hong Kong
9114,6/1/2020,HKG,Kedah,0,0,0,Hong Kong
9115,6/1/2020,HKG,Kelantan,0,0,0,Hong Kong
9116,6/1/2020,HKG,Pahang,0,0,0,Hong Kong
9117,6/1/2020,HKG,Perak,0,0,0,Hong Kong
9118,6/1/2020,HKG,Perlis,0,0,0,Hong Kong
9119,6/1/2020,HKG,Pulau Pinang,0,0,0,Hong Kong
9120,6/1/2020,HKG,Sabah,0,0,0,Hong Kong
9121,6/1/2020,HKG,Sarawak,0,0,0,Hong Kong
9122,6/1/2020,HKG,Selangor,0,0,0,Hong Kong
9123,6/1/2020,HKG,Terengganu,0,0,0,Hong Kong
9124,6/1/2020,HMD,Johor,0,0,0,Heard Island and McDonald Islands
9125,6/1/2020,HND,Johor,0,0,0,Honduras
9126,6/1/2020,HND,Kedah,0,0,0,Honduras
9127,6/1/2020,HND,Perak,0,0,0,Honduras
9128,6/1/2020,HND,Pulau Pinang,0,0,0,Honduras
9129,6/1/2020,HND,Sabah,0,0,0,Honduras
9130,6/1/2020,HND,Sarawak,0,0,0,Honduras
9131,6/1/2020,HND,Selangor,0,0,0,Honduras
9132,6/1/2020,HRV,Johor,0,0,0,Croatia
9133,6/1/2020,HRV,Kedah,0,0,0,Croatia
9134,6/1/2020,HRV,Kelantan,0,0,0,Croatia
9135,6/1/2020,HRV,Melaka,0,0,0,Croatia
9136,6/1/2020,HRV,Pahang,0,0,0,Croatia
9137,6/1/2020,HRV,Perak,0,0,0,Croatia
9138,6/1/2020,HRV,Perlis,0,0,0,Croatia
9139,6/1/2020,HRV,Pulau Pinang,0,0,0,Croatia
9140,6/1/2020,HRV,Sabah,0,0,0,Croatia
9141,6/1/2020,HRV,Sarawak,0,0,0,Croatia
9142,6/1/2020,HRV,Selangor,1,1,0,Croatia
9143,6/1/2020,HTI,Johor,0,0,0,Haiti
9144,6/1/2020,HTI,Kedah,0,0,0,Haiti
9145,6/1/2020,HTI,Kelantan,0,0,0,Haiti
9146,6/1/2020,HTI,Perak,0,0,0,Haiti
9147,6/1/2020,HTI,Pulau Pinang,0,0,0,Haiti
9148,6/1/2020,HTI,Sabah,0,0,0,Haiti
9149,6/1/2020,HTI,Selangor,0,0,0,Haiti
9150,6/1/2020,HUN,Johor,0,0,0,Hungary
9151,6/1/2020,HUN,Kedah,0,0,0,Hungary
9152,6/1/2020,HUN,Kelantan,0,0,0,Hungary
9153,6/1/2020,HUN,Pahang,0,0,0,Hungary
9154,6/1/2020,HUN,Perak,0,0,0,Hungary
9155,6/1/2020,HUN,Perlis,0,0,0,Hungary
9156,6/1/2020,HUN,Pulau Pinang,0,0,0,Hungary
9157,6/1/2020,HUN,Sabah,0,0,0,Hungary
9158,6/1/2020,HUN,Sarawak,0,0,0,Hungary
9159,6/1/2020,HUN,Selangor,1,0,1,Hungary
9160,6/1/2020,HUN,W.P. Labuan,0,0,0,Hungary
9161,6/1/2020,IDN,Johor,84,62,22,Indonesia
9162,6/1/2020,IDN,Kedah,7,7,0,Indonesia
9163,6/1/2020,IDN,Kelantan,6,0,6,Indonesia
9164,6/1/2020,IDN,Melaka,0,0,0,Indonesia
9165,6/1/2020,IDN,Negeri Sembilan,0,0,0,Indonesia
9166,6/1/2020,IDN,Pahang,0,0,0,Indonesia
9167,6/1/2020,IDN,Perak,0,0,0,Indonesia
9168,6/1/2020,IDN,Perlis,0,0,0,Indonesia
9169,6/1/2020,IDN,Pulau Pinang,14,0,14,Indonesia
9170,6/1/2020,IDN,Sabah,28,5,23,Indonesia
9171,6/1/2020,IDN,Sarawak,444,423,21,Indonesia
9172,6/1/2020,IDN,Selangor,144,53,91,Indonesia
9173,6/1/2020,IDN,Terengganu,1,1,0,Indonesia
9174,6/1/2020,IDN,W.P. Labuan,0,0,0,Indonesia
9175,6/1/2020,IND,Johor,3,3,0,India
9176,6/1/2020,IND,Kedah,0,0,0,India
9177,6/1/2020,IND,Kelantan,0,0,0,India
9178,6/1/2020,IND,Melaka,0,0,0,India
9179,6/1/2020,IND,Negeri Sembilan,0,0,0,India
9180,6/1/2020,IND,Pahang,0,0,0,India
9181,6/1/2020,IND,Perak,0,0,0,India
9182,6/1/2020,IND,Perlis,0,0,0,India
9183,6/1/2020,IND,Pulau Pinang,0,0,0,India
9184,6/1/2020,IND,Sabah,0,0,0,India
9185,6/1/2020,IND,Sarawak,0,0,0,India
9186,6/1/2020,IND,Selangor,70,40,30,India
9187,6/1/2020,IND,Terengganu,0,0,0,India
9188,6/1/2020,IND,W.P. Labuan,0,0,0,India
9189,6/1/2020,IOT,Pulau Pinang,0,0,0,British Indian Ocean Territory
9190,6/1/2020,IOT,Selangor,0,0,0,British Indian Ocean Territory
9191,6/1/2020,IRL,Johor,1,1,0,Ireland
9192,6/1/2020,IRL,Kedah,0,0,0,Ireland
9193,6/1/2020,IRL,Kelantan,0,0,0,Ireland
9194,6/1/2020,IRL,Negeri Sembilan,0,0,0,Ireland
9195,6/1/2020,IRL,Pahang,0,0,0,Ireland
9196,6/1/2020,IRL,Perak,0,0,0,Ireland
9197,6/1/2020,IRL,Perlis,0,0,0,Ireland
9198,6/1/2020,IRL,Pulau Pinang,0,0,0,Ireland
9199,6/1/2020,IRL,Sabah,0,0,0,Ireland
9200,6/1/2020,IRL,Sarawak,0,0,0,Ireland
9201,6/1/2020,IRL,Selangor,3,2,1,Ireland
9202,6/1/2020,IRL,Terengganu,0,0,0,Ireland
9203,6/1/2020,IRL,W.P. Labuan,0,0,0,Ireland
9204,6/1/2020,IRN,Johor,0,0,0,Iran
9205,6/1/2020,IRN,Kedah,0,0,0,Iran
9206,6/1/2020,IRN,Kelantan,0,0,0,Iran
9207,6/1/2020,IRN,Perak,0,0,0,Iran
9208,6/1/2020,IRN,Perlis,0,0,0,Iran
9209,6/1/2020,IRN,Pulau Pinang,0,0,0,Iran
9210,6/1/2020,IRN,Sabah,0,0,0,Iran
9211,6/1/2020,IRN,Sarawak,0,0,0,Iran
9212,6/1/2020,IRN,Selangor,5,4,1,Iran
9213,6/1/2020,IRN,W.P. Labuan,0,0,0,Iran
9214,6/1/2020,IRQ,Johor,0,0,0,Iraq
9215,6/1/2020,IRQ,Kedah,0,0,0,Iraq
9216,6/1/2020,IRQ,Kelantan,0,0,0,Iraq
9217,6/1/2020,IRQ,Melaka,0,0,0,Iraq
9218,6/1/2020,IRQ,Pahang,0,0,0,Iraq
9219,6/1/2020,IRQ,Perak,0,0,0,Iraq
9220,6/1/2020,IRQ,Perlis,0,0,0,Iraq
9221,6/1/2020,IRQ,Pulau Pinang,0,0,0,Iraq
9222,6/1/2020,IRQ,Sabah,0,0,0,Iraq
9223,6/1/2020,IRQ,Sarawak,0,0,0,Iraq
9224,6/1/2020,IRQ,Selangor,11,6,5,Iraq
9225,6/1/2020,ISL,Johor,0,0,0,Iceland
9226,6/1/2020,ISL,Kedah,0,0,0,Iceland
9227,6/1/2020,ISL,Kelantan,0,0,0,Iceland
9228,6/1/2020,ISL,Perak,0,0,0,Iceland
9229,6/1/2020,ISL,Perlis,0,0,0,Iceland
9230,6/1/2020,ISL,Pulau Pinang,0,0,0,Iceland
9231,6/1/2020,ISL,Sabah,0,0,0,Iceland
9232,6/1/2020,ISL,Sarawak,0,0,0,Iceland
9233,6/1/2020,ISL,Selangor,0,0,0,Iceland
9234,6/1/2020,ISL,W.P. Labuan,0,0,0,Iceland
9235,6/1/2020,ISR,Pulau Pinang,0,0,0,Israel
9236,6/1/2020,ITA,Johor,0,0,0,Italy
9237,6/1/2020,ITA,Kedah,0,0,0,Italy
9238,6/1/2020,ITA,Kelantan,0,0,0,Italy
9239,6/1/2020,ITA,Melaka,0,0,0,Italy
9240,6/1/2020,ITA,Negeri Sembilan,0,0,0,Italy
9241,6/1/2020,ITA,Pahang,0,0,0,Italy
9242,6/1/2020,ITA,Perak,0,0,0,Italy
9243,6/1/2020,ITA,Perlis,0,0,0,Italy
9244,6/1/2020,ITA,Pulau Pinang,0,0,0,Italy
9245,6/1/2020,ITA,Sabah,0,0,0,Italy
9246,6/1/2020,ITA,Sarawak,0,0,0,Italy
9247,6/1/2020,ITA,Selangor,4,2,2,Italy
9248,6/1/2020,ITA,W.P. Labuan,0,0,0,Italy
9249,6/1/2020,JAM,Johor,0,0,0,Jamaica
9250,6/1/2020,JAM,Kedah,0,0,0,Jamaica
9251,6/1/2020,JAM,Perak,0,0,0,Jamaica
9252,6/1/2020,JAM,Pulau Pinang,0,0,0,Jamaica
9253,6/1/2020,JAM,Sabah,0,0,0,Jamaica
9254,6/1/2020,JAM,Sarawak,0,0,0,Jamaica
9255,6/1/2020,JAM,Selangor,0,0,0,Jamaica
9256,6/1/2020,JAM,W.P. Labuan,0,0,0,Jamaica
9257,6/1/2020,JOR,Johor,0,0,0,Jordan
9258,6/1/2020,JOR,Kedah,0,0,0,Jordan
9259,6/1/2020,JOR,Kelantan,0,0,0,Jordan
9260,6/1/2020,JOR,Melaka,0,0,0,Jordan
9261,6/1/2020,JOR,Perlis,0,0,0,Jordan
9262,6/1/2020,JOR,Pulau Pinang,0,0,0,Jordan
9263,6/1/2020,JOR,Sabah,0,0,0,Jordan
9264,6/1/2020,JOR,Sarawak,0,0,0,Jordan
9265,6/1/2020,JOR,Selangor,2,1,1,Jordan
9266,6/1/2020,JOR,W.P. Labuan,0,0,0,Jordan
9267,6/1/2020,JPN,Johor,0,0,0,Japan
9268,6/1/2020,JPN,Kedah,0,0,0,Japan
9269,6/1/2020,JPN,Kelantan,0,0,0,Japan
9270,6/1/2020,JPN,Melaka,0,0,0,Japan
9271,6/1/2020,JPN,Negeri Sembilan,0,0,0,Japan
9272,6/1/2020,JPN,Pahang,0,0,0,Japan
9273,6/1/2020,JPN,Perak,0,0,0,Japan
9274,6/1/2020,JPN,Perlis,0,0,0,Japan
9275,6/1/2020,JPN,Pulau Pinang,0,0,0,Japan
9276,6/1/2020,JPN,Sabah,0,0,0,Japan
9277,6/1/2020,JPN,Sarawak,0,0,0,Japan
9278,6/1/2020,JPN,Selangor,47,30,17,Japan
9279,6/1/2020,JPN,W.P. Labuan,0,0,0,Japan
9280,6/1/2020,KAZ,Johor,0,0,0,Kazakhstan
9281,6/1/2020,KAZ,Kedah,0,0,0,Kazakhstan
9282,6/1/2020,KAZ,Kelantan,0,0,0,Kazakhstan
9283,6/1/2020,KAZ,Melaka,0,0,0,Kazakhstan
9284,6/1/2020,KAZ,Perak,0,0,0,Kazakhstan
9285,6/1/2020,KAZ,Perlis,0,0,0,Kazakhstan
9286,6/1/2020,KAZ,Pulau Pinang,0,0,0,Kazakhstan
9287,6/1/2020,KAZ,Sabah,0,0,0,Kazakhstan
9288,6/1/2020,KAZ,Sarawak,0,0,0,Kazakhstan
9289,6/1/2020,KAZ,Selangor,1,0,1,Kazakhstan
9290,6/1/2020,KAZ,W.P. Labuan,0,0,0,Kazakhstan
9291,6/1/2020,KEN,Johor,0,0,0,Kenya
9292,6/1/2020,KEN,Kedah,0,0,0,Kenya
9293,6/1/2020,KEN,Kelantan,0,0,0,Kenya
9294,6/1/2020,KEN,Perak,0,0,0,Kenya
9295,6/1/2020,KEN,Perlis,0,0,0,Kenya
9296,6/1/2020,KEN,Pulau Pinang,0,0,0,Kenya
9297,6/1/2020,KEN,Sabah,0,0,0,Kenya
9298,6/1/2020,KEN,Sarawak,0,0,0,Kenya
9299,6/1/2020,KEN,Selangor,0,0,0,Kenya
9300,6/1/2020,KGZ,Johor,0,0,0,Kyrgyzstan
9301,6/1/2020,KGZ,Kedah,0,0,0,Kyrgyzstan
9302,6/1/2020,KGZ,Kelantan,0,0,0,Kyrgyzstan
9303,6/1/2020,KGZ,Perak,0,0,0,Kyrgyzstan
9304,6/1/2020,KGZ,Perlis,0,0,0,Kyrgyzstan
9305,6/1/2020,KGZ,Pulau Pinang,0,0,0,Kyrgyzstan
9306,6/1/2020,KGZ,Sabah,0,0,0,Kyrgyzstan
9307,6/1/2020,KGZ,Sarawak,0,0,0,Kyrgyzstan
9308,6/1/2020,KGZ,Selangor,0,0,0,Kyrgyzstan
9309,6/1/2020,KHM,Johor,0,0,0,Cambodia
9310,6/1/2020,KHM,Kedah,0,0,0,Cambodia
9311,6/1/2020,KHM,Kelantan,0,0,0,Cambodia
9312,6/1/2020,KHM,Melaka,0,0,0,Cambodia
9313,6/1/2020,KHM,Negeri Sembilan,0,0,0,Cambodia
9314,6/1/2020,KHM,Pahang,0,0,0,Cambodia
9315,6/1/2020,KHM,Perak,0,0,0,Cambodia
9316,6/1/2020,KHM,Perlis,0,0,0,Cambodia
9317,6/1/2020,KHM,Pulau Pinang,0,0,0,Cambodia
9318,6/1/2020,KHM,Sabah,0,0,0,Cambodia
9319,6/1/2020,KHM,Sarawak,0,0,0,Cambodia
9320,6/1/2020,KHM,Selangor,14,6,8,Cambodia
9321,6/1/2020,KHM,W.P. Labuan,0,0,0,Cambodia
9322,6/1/2020,KIR,Johor,0,0,0,Kiribati
9323,6/1/2020,KIR,Sabah,0,0,0,Kiribati
9324,6/1/2020,KIR,Selangor,0,0,0,Kiribati
9325,6/1/2020,KNA,Johor,0,0,0,Saint Kitts and Nevis
9326,6/1/2020,KNA,Kedah,0,0,0,Saint Kitts and Nevis
9327,6/1/2020,KNA,Perlis,0,0,0,Saint Kitts and Nevis
9328,6/1/2020,KNA,Pulau Pinang,0,0,0,Saint Kitts and Nevis
9329,6/1/2020,KNA,Sabah,0,0,0,Saint Kitts and Nevis
9330,6/1/2020,KNA,Selangor,0,0,0,Saint Kitts and Nevis
9331,6/1/2020,KNA,W.P. Labuan,0,0,0,Saint Kitts and Nevis
9332,6/1/2020,KOR,Johor,0,0,0,"Korea, Republic of (South Korea)"
9333,6/1/2020,KOR,Kedah,0,0,0,"Korea, Republic of (South Korea)"
9334,6/1/2020,KOR,Kelantan,0,0,0,"Korea, Republic of (South Korea)"
9335,6/1/2020,KOR,Melaka,0,0,0,"Korea, Republic of (South Korea)"
9336,6/1/2020,KOR,Negeri Sembilan,0,0,0,"Korea, Republic of (South Korea)"
9337,6/1/2020,KOR,Pahang,0,0,0,"Korea, Republic of (South Korea)"
9338,6/1/2020,KOR,Perak,0,0,0,"Korea, Republic of (South Korea)"
9339,6/1/2020,KOR,Perlis,0,0,0,"Korea, Republic of (South Korea)"
9340,6/1/2020,KOR,Pulau Pinang,0,0,0,"Korea, Republic of (South Korea)"
9341,6/1/2020,KOR,Sabah,0,0,0,"Korea, Republic of (South Korea)"
9342,6/1/2020,KOR,Sarawak,0,0,0,"Korea, Republic of (South Korea)"
9343,6/1/2020,KOR,Selangor,45,35,10,"Korea, Republic of (South Korea)"
9344,6/1/2020,KOR,Terengganu,0,0,0,"Korea, Republic of (South Korea)"
9345,6/1/2020,KOR,W.P. Labuan,0,0,0,"Korea, Republic of (South Korea)"
9346,6/1/2020,KWT,Johor,0,0,0,Kuwait
9347,6/1/2020,KWT,Kedah,0,0,0,Kuwait
9348,6/1/2020,KWT,Kelantan,0,0,0,Kuwait
9349,6/1/2020,KWT,Perak,0,0,0,Kuwait
9350,6/1/2020,KWT,Perlis,0,0,0,Kuwait
9351,6/1/2020,KWT,Pulau Pinang,0,0,0,Kuwait
9352,6/1/2020,KWT,Sabah,0,0,0,Kuwait
9353,6/1/2020,KWT,Sarawak,0,0,0,Kuwait
9354,6/1/2020,KWT,Selangor,0,0,0,Kuwait
9355,6/1/2020,KWT,W.P. Labuan,0,0,0,Kuwait
9356,6/1/2020,LAO,Johor,0,0,0,Lao People's Democratic Republic
9357,6/1/2020,LAO,Kedah,0,0,0,Lao People's Democratic Republic
9358,6/1/2020,LAO,Kelantan,0,0,0,Lao People's Democratic Republic
9359,6/1/2020,LAO,Melaka,0,0,0,Lao People's Democratic Republic
9360,6/1/2020,LAO,Perak,0,0,0,Lao People's Democratic Republic
9361,6/1/2020,LAO,Perlis,0,0,0,Lao People's Democratic Republic
9362,6/1/2020,LAO,Pulau Pinang,0,0,0,Lao People's Democratic Republic
9363,6/1/2020,LAO,Sabah,0,0,0,Lao People's Democratic Republic
9364,6/1/2020,LAO,Sarawak,0,0,0,Lao People's Democratic Republic
9365,6/1/2020,LAO,Selangor,0,0,0,Lao People's Democratic Republic
9366,6/1/2020,LAO,W.P. Labuan,0,0,0,Lao People's Democratic Republic
9367,6/1/2020,LBN,Johor,0,0,0,Lebanon
9368,6/1/2020,LBN,Kedah,0,0,0,Lebanon
9369,6/1/2020,LBN,Kelantan,0,0,0,Lebanon
9370,6/1/2020,LBN,Pahang,0,0,0,Lebanon
9371,6/1/2020,LBN,Perak,0,0,0,Lebanon
9372,6/1/2020,LBN,Perlis,0,0,0,Lebanon
9373,6/1/2020,LBN,Pulau Pinang,0,0,0,Lebanon
9374,6/1/2020,LBN,Sabah,0,0,0,Lebanon
9375,6/1/2020,LBN,Sarawak,0,0,0,Lebanon
9376,6/1/2020,LBN,Selangor,0,0,0,Lebanon
9377,6/1/2020,LBN,W.P. Labuan,0,0,0,Lebanon
9378,6/1/2020,LBR,Johor,0,0,0,Liberia
9379,6/1/2020,LBR,Kedah,0,0,0,Liberia
9380,6/1/2020,LBR,Sabah,0,0,0,Liberia
9381,6/1/2020,LBR,Sarawak,0,0,0,Liberia
9382,6/1/2020,LBR,Selangor,0,0,0,Liberia
9383,6/1/2020,LBY,Johor,0,0,0,Libyan Arab Jamahiriya
9384,6/1/2020,LBY,Kedah,0,0,0,Libyan Arab Jamahiriya
9385,6/1/2020,LBY,Perlis,0,0,0,Libyan Arab Jamahiriya
9386,6/1/2020,LBY,Pulau Pinang,0,0,0,Libyan Arab Jamahiriya
9387,6/1/2020,LBY,Sabah,0,0,0,Libyan Arab Jamahiriya
9388,6/1/2020,LBY,Sarawak,0,0,0,Libyan Arab Jamahiriya
9389,6/1/2020,LBY,Selangor,0,0,0,Libyan Arab Jamahiriya
9390,6/1/2020,LCA,Johor,0,0,0,Saint Lucia
9391,6/1/2020,LCA,Kedah,0,0,0,Saint Lucia
9392,6/1/2020,LCA,Pulau Pinang,0,0,0,Saint Lucia
9393,6/1/2020,LCA,Sarawak,0,0,0,Saint Lucia
9394,6/1/2020,LCA,Selangor,0,0,0,Saint Lucia
9395,6/1/2020,LIE,Johor,0,0,0,Liechtenstein
9396,6/1/2020,LIE,Kedah,0,0,0,Liechtenstein
9397,6/1/2020,LIE,Perlis,0,0,0,Liechtenstein
9398,6/1/2020,LIE,Pulau Pinang,0,0,0,Liechtenstein
9399,6/1/2020,LIE,Sabah,0,0,0,Liechtenstein
9400,6/1/2020,LIE,Sarawak,0,0,0,Liechtenstein
9401,6/1/2020,LIE,Selangor,0,0,0,Liechtenstein
9402,6/1/2020,LKA,Johor,0,0,0,Sri Lanka
9403,6/1/2020,LKA,Kedah,0,0,0,Sri Lanka
9404,6/1/2020,LKA,Kelantan,0,0,0,Sri Lanka
9405,6/1/2020,LKA,Melaka,0,0,0,Sri Lanka
9406,6/1/2020,LKA,Pahang,0,0,0,Sri Lanka
9407,6/1/2020,LKA,Perak,0,0,0,Sri Lanka
9408,6/1/2020,LKA,Perlis,0,0,0,Sri Lanka
9409,6/1/2020,LKA,Pulau Pinang,0,0,0,Sri Lanka
9410,6/1/2020,LKA,Sabah,0,0,0,Sri Lanka
9411,6/1/2020,LKA,Sarawak,0,0,0,Sri Lanka
9412,6/1/2020,LKA,Selangor,9,6,3,Sri Lanka
9413,6/1/2020,LKA,W.P. Labuan,0,0,0,Sri Lanka
9414,6/1/2020,LSO,Johor,0,0,0,Lesotho
9415,6/1/2020,LSO,Kedah,0,0,0,Lesotho
9416,6/1/2020,LSO,Pulau Pinang,0,0,0,Lesotho
9417,6/1/2020,LSO,Sarawak,0,0,0,Lesotho
9418,6/1/2020,LSO,Selangor,0,0,0,Lesotho
9419,6/1/2020,LTU,Johor,1,1,0,Lithuania
9420,6/1/2020,LTU,Kedah,0,0,0,Lithuania
9421,6/1/2020,LTU,Kelantan,0,0,0,Lithuania
9422,6/1/2020,LTU,Pahang,0,0,0,Lithuania
9423,6/1/2020,LTU,Perak,0,0,0,Lithuania
9424,6/1/2020,LTU,Perlis,0,0,0,Lithuania
9425,6/1/2020,LTU,Pulau Pinang,0,0,0,Lithuania
9426,6/1/2020,LTU,Sabah,0,0,0,Lithuania
9427,6/1/2020,LTU,Sarawak,0,0,0,Lithuania
9428,6/1/2020,LTU,Selangor,0,0,0,Lithuania
9429,6/1/2020,LTU,W.P. Labuan,0,0,0,Lithuania
9430,6/1/2020,LUX,Johor,0,0,0,Luxembourg
9431,6/1/2020,LUX,Kedah,0,0,0,Luxembourg
9432,6/1/2020,LUX,Kelantan,0,0,0,Luxembourg
9433,6/1/2020,LUX,Perak,0,0,0,Luxembourg
9434,6/1/2020,LUX,Perlis,0,0,0,Luxembourg
9435,6/1/2020,LUX,Pulau Pinang,0,0,0,Luxembourg
9436,6/1/2020,LUX,Sabah,0,0,0,Luxembourg
9437,6/1/2020,LUX,Sarawak,0,0,0,Luxembourg
9438,6/1/2020,LUX,Selangor,0,0,0,Luxembourg
9439,6/1/2020,LVA,Johor,1,1,0,Latvia
9440,6/1/2020,LVA,Kedah,0,0,0,Latvia
9441,6/1/2020,LVA,Kelantan,0,0,0,Latvia
9442,6/1/2020,LVA,Pahang,0,0,0,Latvia
9443,6/1/2020,LVA,Perak,0,0,0,Latvia
9444,6/1/2020,LVA,Perlis,0,0,0,Latvia
9445,6/1/2020,LVA,Pulau Pinang,0,0,0,Latvia
9446,6/1/2020,LVA,Sabah,0,0,0,Latvia
9447,6/1/2020,LVA,Sarawak,0,0,0,Latvia
9448,6/1/2020,LVA,Selangor,0,0,0,Latvia
9449,6/1/2020,LVA,W.P. Labuan,0,0,0,Latvia
9450,6/1/2020,MAC,Johor,0,0,0,Macao
9451,6/1/2020,MAC,Pahang,0,0,0,Macao
9452,6/1/2020,MAC,Perak,0,0,0,Macao
9453,6/1/2020,MAC,Selangor,0,0,0,Macao
9454,6/1/2020,MAC,W.P. Labuan,0,0,0,Macao
9455,6/1/2020,MAR,Johor,0,0,0,Morocco
9456,6/1/2020,MAR,Kedah,0,0,0,Morocco
9457,6/1/2020,MAR,Kelantan,0,0,0,Morocco
9458,6/1/2020,MAR,Melaka,0,0,0,Morocco
9459,6/1/2020,MAR,Pahang,0,0,0,Morocco
9460,6/1/2020,MAR,Perak,0,0,0,Morocco
9461,6/1/2020,MAR,Perlis,0,0,0,Morocco
9462,6/1/2020,MAR,Pulau Pinang,0,0,0,Morocco
9463,6/1/2020,MAR,Sabah,0,0,0,Morocco
9464,6/1/2020,MAR,Sarawak,0,0,0,Morocco
9465,6/1/2020,MAR,Selangor,5,0,5,Morocco
9466,6/1/2020,MAR,W.P. Labuan,0,0,0,Morocco
9467,6/1/2020,MCO,Johor,0,0,0,Monaco
9468,6/1/2020,MCO,Kedah,0,0,0,Monaco
9469,6/1/2020,MCO,Sabah,0,0,0,Monaco
9470,6/1/2020,MCO,Selangor,0,0,0,Monaco
9471,6/1/2020,MDA,Johor,0,0,0,"Moldova, Republic of"
9472,6/1/2020,MDA,Kedah,0,0,0,"Moldova, Republic of"
9473,6/1/2020,MDA,Kelantan,0,0,0,"Moldova, Republic of"
9474,6/1/2020,MDA,Negeri Sembilan,0,0,0,"Moldova, Republic of"
9475,6/1/2020,MDA,Perlis,0,0,0,"Moldova, Republic of"
9476,6/1/2020,MDA,Pulau Pinang,0,0,0,"Moldova, Republic of"
9477,6/1/2020,MDA,Sabah,0,0,0,"Moldova, Republic of"
9478,6/1/2020,MDA,Sarawak,0,0,0,"Moldova, Republic of"
9479,6/1/2020,MDA,Selangor,0,0,0,"Moldova, Republic of"
9480,6/1/2020,MDG,Johor,0,0,0,Madagascar
9481,6/1/2020,MDG,Kedah,0,0,0,Madagascar
9482,6/1/2020,MDG,Perak,0,0,0,Madagascar
9483,6/1/2020,MDG,Perlis,0,0,0,Madagascar
9484,6/1/2020,MDG,Pulau Pinang,0,0,0,Madagascar
9485,6/1/2020,MDG,Sabah,0,0,0,Madagascar
9486,6/1/2020,MDG,Sarawak,0,0,0,Madagascar
9487,6/1/2020,MDG,Selangor,0,0,0,Madagascar
9488,6/1/2020,MDV,Johor,0,0,0,Maldives
9489,6/1/2020,MDV,Kedah,0,0,0,Maldives
9490,6/1/2020,MDV,Kelantan,0,0,0,Maldives
9491,6/1/2020,MDV,Perak,0,0,0,Maldives
9492,6/1/2020,MDV,Perlis,0,0,0,Maldives
9493,6/1/2020,MDV,Pulau Pinang,0,0,0,Maldives
9494,6/1/2020,MDV,Sabah,0,0,0,Maldives
9495,6/1/2020,MDV,Sarawak,0,0,0,Maldives
9496,6/1/2020,MDV,Selangor,3,2,1,Maldives
9497,6/1/2020,MEX,Johor,0,0,0,Mexico
9498,6/1/2020,MEX,Kedah,0,0,0,Mexico
9499,6/1/2020,MEX,Kelantan,0,0,0,Mexico
9500,6/1/2020,MEX,Pahang,0,0,0,Mexico
9501,6/1/2020,MEX,Perak,0,0,0,Mexico
9502,6/1/2020,MEX,Perlis,0,0,0,Mexico
9503,6/1/2020,MEX,Pulau Pinang,0,0,0,Mexico
9504,6/1/2020,MEX,Sabah,0,0,0,Mexico
9505,6/1/2020,MEX,Sarawak,0,0,0,Mexico
9506,6/1/2020,MEX,Selangor,1,1,0,Mexico
9507,6/1/2020,MEX,W.P. Labuan,0,0,0,Mexico
9508,6/1/2020,MHL,Johor,0,0,0,Marshall Islands
9509,6/1/2020,MHL,Kedah,0,0,0,Marshall Islands
9510,6/1/2020,MHL,Perak,0,0,0,Marshall Islands
9511,6/1/2020,MHL,Pulau Pinang,0,0,0,Marshall Islands
9512,6/1/2020,MHL,Sabah,0,0,0,Marshall Islands
9513,6/1/2020,MHL,Selangor,0,0,0,Marshall Islands
9514,6/1/2020,MKD,Johor,0,0,0,"Macedonia, the former Yugoslav Republic of"
9515,6/1/2020,MKD,Kedah,0,0,0,"Macedonia, the former Yugoslav Republic of"
9516,6/1/2020,MKD,Perak,0,0,0,"Macedonia, the former Yugoslav Republic of"
9517,6/1/2020,MKD,Pulau Pinang,0,0,0,"Macedonia, the former Yugoslav Republic of"
9518,6/1/2020,MKD,Sabah,0,0,0,"Macedonia, the former Yugoslav Republic of"
9519,6/1/2020,MKD,Sarawak,0,0,0,"Macedonia, the former Yugoslav Republic of"
9520,6/1/2020,MKD,Selangor,1,1,0,"Macedonia, the former Yugoslav Republic of"
9521,6/1/2020,MLI,Johor,0,0,0,Mali
9522,6/1/2020,MLI,Sabah,0,0,0,Mali
9523,6/1/2020,MLI,Selangor,0,0,0,Mali
9524,6/1/2020,MLT,Johor,0,0,0,Malta
9525,6/1/2020,MLT,Kedah,0,0,0,Malta
9526,6/1/2020,MLT,Kelantan,0,0,0,Malta
9527,6/1/2020,MLT,Perak,0,0,0,Malta
9528,6/1/2020,MLT,Perlis,0,0,0,Malta
9529,6/1/2020,MLT,Pulau Pinang,0,0,0,Malta
9530,6/1/2020,MLT,Sabah,0,0,0,Malta
9531,6/1/2020,MLT,Sarawak,0,0,0,Malta
9532,6/1/2020,MLT,Selangor,0,0,0,Malta
9533,6/1/2020,MLT,W.P. Labuan,0,0,0,Malta
9534,6/1/2020,MMR,Johor,13,12,1,Myanmar
9535,6/1/2020,MMR,Kedah,0,0,0,Myanmar
9536,6/1/2020,MMR,Kelantan,0,0,0,Myanmar
9537,6/1/2020,MMR,Negeri Sembilan,0,0,0,Myanmar
9538,6/1/2020,MMR,Pahang,0,0,0,Myanmar
9539,6/1/2020,MMR,Perak,0,0,0,Myanmar
9540,6/1/2020,MMR,Perlis,0,0,0,Myanmar
9541,6/1/2020,MMR,Pulau Pinang,0,0,0,Myanmar
9542,6/1/2020,MMR,Sabah,0,0,0,Myanmar
9543,6/1/2020,MMR,Sarawak,0,0,0,Myanmar
9544,6/1/2020,MMR,Selangor,24,5,19,Myanmar
9545,6/1/2020,MMR,Terengganu,0,0,0,Myanmar
9546,6/1/2020,MMR,W.P. Labuan,0,0,0,Myanmar
9547,6/1/2020,MNE,Johor,0,0,0,Montenegro
9548,6/1/2020,MNE,Kedah,0,0,0,Montenegro
9549,6/1/2020,MNE,Pulau Pinang,0,0,0,Montenegro
9550,6/1/2020,MNE,Sabah,0,0,0,Montenegro
9551,6/1/2020,MNE,Sarawak,0,0,0,Montenegro
9552,6/1/2020,MNE,Selangor,1,0,1,Montenegro
9553,6/1/2020,MNG,Johor,0,0,0,Mongolia
9554,6/1/2020,MNG,Kedah,0,0,0,Mongolia
9555,6/1/2020,MNG,Kelantan,0,0,0,Mongolia
9556,6/1/2020,MNG,Perak,0,0,0,Mongolia
9557,6/1/2020,MNG,Perlis,0,0,0,Mongolia
9558,6/1/2020,MNG,Pulau Pinang,0,0,0,Mongolia
9559,6/1/2020,MNG,Sabah,0,0,0,Mongolia
9560,6/1/2020,MNG,Sarawak,0,0,0,Mongolia
9561,6/1/2020,MNG,Selangor,0,0,0,Mongolia
9562,6/1/2020,MNP,Selangor,0,0,0,Northern Mariana Islands
9563,6/1/2020,MOZ,Johor,0,0,0,Mozambique
9564,6/1/2020,MOZ,Kedah,0,0,0,Mozambique
9565,6/1/2020,MOZ,Perak,0,0,0,Mozambique
9566,6/1/2020,MOZ,Pulau Pinang,0,0,0,Mozambique
9567,6/1/2020,MOZ,Sabah,0,0,0,Mozambique
9568,6/1/2020,MOZ,Sarawak,0,0,0,Mozambique
9569,6/1/2020,MOZ,Selangor,0,0,0,Mozambique
9570,6/1/2020,MRT,Johor,0,0,0,Mauritania
9571,6/1/2020,MRT,Kedah,0,0,0,Mauritania
9572,6/1/2020,MRT,Pulau Pinang,0,0,0,Mauritania
9573,6/1/2020,MRT,Sabah,0,0,0,Mauritania
9574,6/1/2020,MRT,Sarawak,0,0,0,Mauritania
9575,6/1/2020,MRT,Selangor,0,0,0,Mauritania
9576,6/1/2020,MUS,Johor,0,0,0,Mauritius
9577,6/1/2020,MUS,Kedah,0,0,0,Mauritius
9578,6/1/2020,MUS,Kelantan,0,0,0,Mauritius
9579,6/1/2020,MUS,Pahang,0,0,0,Mauritius
9580,6/1/2020,MUS,Perak,0,0,0,Mauritius
9581,6/1/2020,MUS,Perlis,0,0,0,Mauritius
9582,6/1/2020,MUS,Pulau Pinang,0,0,0,Mauritius
9583,6/1/2020,MUS,Sabah,0,0,0,Mauritius
9584,6/1/2020,MUS,Sarawak,0,0,0,Mauritius
9585,6/1/2020,MUS,Selangor,0,0,0,Mauritius
9586,6/1/2020,MWI,Johor,0,0,0,Malawi
9587,6/1/2020,MWI,Pulau Pinang,0,0,0,Malawi
9588,6/1/2020,MWI,Sabah,0,0,0,Malawi
9589,6/1/2020,MWI,Sarawak,0,0,0,Malawi
9590,6/1/2020,MWI,Selangor,0,0,0,Malawi
9591,6/1/2020,MYT,Selangor,0,0,0,Mayotte
9592,6/1/2020,NAM,Johor,0,0,0,Namibia
9593,6/1/2020,NAM,Kedah,0,0,0,Namibia
9594,6/1/2020,NAM,Perak,0,0,0,Namibia
9595,6/1/2020,NAM,Perlis,0,0,0,Namibia
9596,6/1/2020,NAM,Pulau Pinang,0,0,0,Namibia
9597,6/1/2020,NAM,Sabah,0,0,0,Namibia
9598,6/1/2020,NAM,Sarawak,0,0,0,Namibia
9599,6/1/2020,NAM,Selangor,0,0,0,Namibia
9600,6/1/2020,NCL,Selangor,0,0,0,New Caledonia
9601,6/1/2020,NER,Johor,0,0,0,Niger
9602,6/1/2020,NER,Sabah,0,0,0,Niger
9603,6/1/2020,NER,Selangor,0,0,0,Niger
9604,6/1/2020,NGA,Johor,0,0,0,Nigeria
9605,6/1/2020,NGA,Kedah,0,0,0,Nigeria
9606,6/1/2020,NGA,Perlis,0,0,0,Nigeria
9607,6/1/2020,NGA,Pulau Pinang,0,0,0,Nigeria
9608,6/1/2020,NGA,Sabah,0,0,0,Nigeria
9609,6/1/2020,NGA,Sarawak,0,0,0,Nigeria
9610,6/1/2020,NGA,Selangor,4,4,0,Nigeria
9611,6/1/2020,NIC,Johor,0,0,0,Nicaragua
9612,6/1/2020,NIC,Kedah,0,0,0,Nicaragua
9613,6/1/2020,NIC,Pulau Pinang,0,0,0,Nicaragua
9614,6/1/2020,NIC,Sabah,0,0,0,Nicaragua
9615,6/1/2020,NIC,Selangor,0,0,0,Nicaragua
9616,6/1/2020,NLD,Johor,0,0,0,Netherlands
9617,6/1/2020,NLD,Kedah,0,0,0,Netherlands
9618,6/1/2020,NLD,Kelantan,0,0,0,Netherlands
9619,6/1/2020,NLD,Melaka,0,0,0,Netherlands
9620,6/1/2020,NLD,Negeri Sembilan,0,0,0,Netherlands
9621,6/1/2020,NLD,Pahang,0,0,0,Netherlands
9622,6/1/2020,NLD,Perak,0,0,0,Netherlands
9623,6/1/2020,NLD,Perlis,0,0,0,Netherlands
9624,6/1/2020,NLD,Pulau Pinang,0,0,0,Netherlands
9625,6/1/2020,NLD,Sabah,0,0,0,Netherlands
9626,6/1/2020,NLD,Sarawak,0,0,0,Netherlands
9627,6/1/2020,NLD,Selangor,15,12,3,Netherlands
9628,6/1/2020,NLD,Terengganu,0,0,0,Netherlands
9629,6/1/2020,NLD,W.P. Labuan,0,0,0,Netherlands
9630,6/1/2020,NOR,Johor,2,2,0,Norway
9631,6/1/2020,NOR,Kedah,0,0,0,Norway
9632,6/1/2020,NOR,Kelantan,0,0,0,Norway
9633,6/1/2020,NOR,Melaka,0,0,0,Norway
9634,6/1/2020,NOR,Pahang,0,0,0,Norway
9635,6/1/2020,NOR,Perak,0,0,0,Norway
9636,6/1/2020,NOR,Perlis,0,0,0,Norway
9637,6/1/2020,NOR,Pulau Pinang,0,0,0,Norway
9638,6/1/2020,NOR,Sabah,0,0,0,Norway
9639,6/1/2020,NOR,Sarawak,0,0,0,Norway
9640,6/1/2020,NOR,Selangor,3,3,0,Norway
9641,6/1/2020,NOR,W.P. Labuan,0,0,0,Norway
9642,6/1/2020,NPL,Johor,1,1,0,Nepal
9643,6/1/2020,NPL,Kedah,0,0,0,Nepal
9644,6/1/2020,NPL,Pahang,0,0,0,Nepal
9645,6/1/2020,NPL,Perak,0,0,0,Nepal
9646,6/1/2020,NPL,Perlis,0,0,0,Nepal
9647,6/1/2020,NPL,Pulau Pinang,0,0,0,Nepal
9648,6/1/2020,NPL,Sabah,0,0,0,Nepal
9649,6/1/2020,NPL,Sarawak,0,0,0,Nepal
9650,6/1/2020,NPL,Selangor,3,3,0,Nepal
9651,6/1/2020,NPL,W.P. Labuan,0,0,0,Nepal
9652,6/1/2020,NRU,Johor,0,0,0,Nauru
9653,6/1/2020,NRU,Pulau Pinang,0,0,0,Nauru
9654,6/1/2020,NRU,Selangor,0,0,0,Nauru
9655,6/1/2020,NZL,Johor,2,2,0,New Zealand
9656,6/1/2020,NZL,Kedah,2,2,0,New Zealand
9657,6/1/2020,NZL,Kelantan,0,0,0,New Zealand
9658,6/1/2020,NZL,Melaka,0,0,0,New Zealand
9659,6/1/2020,NZL,Negeri Sembilan,0,0,0,New Zealand
9660,6/1/2020,NZL,Pahang,0,0,0,New Zealand
9661,6/1/2020,NZL,Perak,0,0,0,New Zealand
9662,6/1/2020,NZL,Perlis,0,0,0,New Zealand
9663,6/1/2020,NZL,Pulau Pinang,0,0,0,New Zealand
9664,6/1/2020,NZL,Sabah,0,0,0,New Zealand
9665,6/1/2020,NZL,Sarawak,0,0,0,New Zealand
9666,6/1/2020,NZL,Selangor,8,4,4,New Zealand
9667,6/1/2020,NZL,Terengganu,0,0,0,New Zealand
9668,6/1/2020,NZL,W.P. Labuan,0,0,0,New Zealand
9669,6/1/2020,OMN,Johor,0,0,0,Oman
9670,6/1/2020,OMN,Kedah,0,0,0,Oman
9671,6/1/2020,OMN,Kelantan,0,0,0,Oman
9672,6/1/2020,OMN,Melaka,0,0,0,Oman
9673,6/1/2020,OMN,Perak,0,0,0,Oman
9674,6/1/2020,OMN,Perlis,0,0,0,Oman
9675,6/1/2020,OMN,Pulau Pinang,0,0,0,Oman
9676,6/1/2020,OMN,Sabah,0,0,0,Oman
9677,6/1/2020,OMN,Sarawak,0,0,0,Oman
9678,6/1/2020,OMN,Selangor,0,0,0,Oman
9679,6/1/2020,PAK,Johor,0,0,0,Pakistan
9680,6/1/2020,PAK,Kedah,0,0,0,Pakistan
9681,6/1/2020,PAK,Kelantan,0,0,0,Pakistan
9682,6/1/2020,PAK,Melaka,0,0,0,Pakistan
9683,6/1/2020,PAK,Negeri Sembilan,0,0,0,Pakistan
9684,6/1/2020,PAK,Pahang,0,0,0,Pakistan
9685,6/1/2020,PAK,Perak,0,0,0,Pakistan
9686,6/1/2020,PAK,Perlis,0,0,0,Pakistan
9687,6/1/2020,PAK,Pulau Pinang,0,0,0,Pakistan
9688,6/1/2020,PAK,Sabah,0,0,0,Pakistan
9689,6/1/2020,PAK,Sarawak,0,0,0,Pakistan
9690,6/1/2020,PAK,Selangor,128,111,17,Pakistan
9691,6/1/2020,PAK,W.P. Labuan,0,0,0,Pakistan
9692,6/1/2020,PAN,Johor,0,0,0,Panama
9693,6/1/2020,PAN,Kedah,0,0,0,Panama
9694,6/1/2020,PAN,Perak,0,0,0,Panama
9695,6/1/2020,PAN,Perlis,0,0,0,Panama
9696,6/1/2020,PAN,Pulau Pinang,0,0,0,Panama
9697,6/1/2020,PAN,Sabah,0,0,0,Panama
9698,6/1/2020,PAN,Sarawak,0,0,0,Panama
9699,6/1/2020,PAN,Selangor,0,0,0,Panama
9700,6/1/2020,PER,Johor,0,0,0,Peru
9701,6/1/2020,PER,Kedah,0,0,0,Peru
9702,6/1/2020,PER,Kelantan,0,0,0,Peru
9703,6/1/2020,PER,Pahang,0,0,0,Peru
9704,6/1/2020,PER,Perak,0,0,0,Peru
9705,6/1/2020,PER,Perlis,0,0,0,Peru
9706,6/1/2020,PER,Pulau Pinang,0,0,0,Peru
9707,6/1/2020,PER,Sabah,0,0,0,Peru
9708,6/1/2020,PER,Sarawak,0,0,0,Peru
9709,6/1/2020,PER,Selangor,0,0,0,Peru
9710,6/1/2020,PER,W.P. Labuan,0,0,0,Peru
9711,6/1/2020,PHL,Johor,0,0,0,Philippines
9712,6/1/2020,PHL,Kedah,1,0,1,Philippines
9713,6/1/2020,PHL,Kelantan,0,0,0,Philippines
9714,6/1/2020,PHL,Melaka,0,0,0,Philippines
9715,6/1/2020,PHL,Negeri Sembilan,0,0,0,Philippines
9716,6/1/2020,PHL,Pahang,0,0,0,Philippines
9717,6/1/2020,PHL,Perak,0,0,0,Philippines
9718,6/1/2020,PHL,Perlis,0,0,0,Philippines
9719,6/1/2020,PHL,Pulau Pinang,0,0,0,Philippines
9720,6/1/2020,PHL,Sabah,5,1,4,Philippines
9721,6/1/2020,PHL,Sarawak,51,47,4,Philippines
9722,6/1/2020,PHL,Selangor,20,3,17,Philippines
9723,6/1/2020,PHL,Terengganu,0,0,0,Philippines
9724,6/1/2020,PHL,W.P. Labuan,5,5,0,Philippines
9725,6/1/2020,PLW,Johor,0,0,0,Palau
9726,6/1/2020,PLW,Pulau Pinang,0,0,0,Palau
9727,6/1/2020,PLW,Selangor,0,0,0,Palau
9728,6/1/2020,PNG,Johor,0,0,0,Papua New Guinea
9729,6/1/2020,PNG,Kedah,0,0,0,Papua New Guinea
9730,6/1/2020,PNG,Kelantan,0,0,0,Papua New Guinea
9731,6/1/2020,PNG,Perak,0,0,0,Papua New Guinea
9732,6/1/2020,PNG,Pulau Pinang,0,0,0,Papua New Guinea
9733,6/1/2020,PNG,Sabah,0,0,0,Papua New Guinea
9734,6/1/2020,PNG,Sarawak,0,0,0,Papua New Guinea
9735,6/1/2020,PNG,Selangor,0,0,0,Papua New Guinea
9736,6/1/2020,POL,Johor,4,4,0,Poland
9737,6/1/2020,POL,Kedah,0,0,0,Poland
9738,6/1/2020,POL,Kelantan,0,0,0,Poland
9739,6/1/2020,POL,Melaka,0,0,0,Poland
9740,6/1/2020,POL,Negeri Sembilan,0,0,0,Poland
9741,6/1/2020,POL,Pahang,0,0,0,Poland
9742,6/1/2020,POL,Perak,0,0,0,Poland
9743,6/1/2020,POL,Perlis,0,0,0,Poland
9744,6/1/2020,POL,Pulau Pinang,0,0,0,Poland
9745,6/1/2020,POL,Sabah,0,0,0,Poland
9746,6/1/2020,POL,Sarawak,0,0,0,Poland
9747,6/1/2020,POL,Selangor,1,1,0,Poland
9748,6/1/2020,POL,Terengganu,0,0,0,Poland
9749,6/1/2020,POL,W.P. Labuan,0,0,0,Poland
9750,6/1/2020,PRK,Selangor,0,0,0,"Korea, Democratic People's Republic of"
9751,6/1/2020,PRT,Johor,0,0,0,Portugal
9752,6/1/2020,PRT,Kedah,0,0,0,Portugal
9753,6/1/2020,PRT,Kelantan,0,0,0,Portugal
9754,6/1/2020,PRT,Melaka,0,0,0,Portugal
9755,6/1/2020,PRT,Pahang,0,0,0,Portugal
9756,6/1/2020,PRT,Perak,0,0,0,Portugal
9757,6/1/2020,PRT,Perlis,0,0,0,Portugal
9758,6/1/2020,PRT,Pulau Pinang,0,0,0,Portugal
9759,6/1/2020,PRT,Sabah,0,0,0,Portugal
9760,6/1/2020,PRT,Sarawak,0,0,0,Portugal
9761,6/1/2020,PRT,Selangor,1,1,0,Portugal
9762,6/1/2020,PRT,W.P. Labuan,0,0,0,Portugal
9763,6/1/2020,PRY,Johor,0,0,0,Paraguay
9764,6/1/2020,PRY,Kedah,0,0,0,Paraguay
9765,6/1/2020,PRY,Perak,0,0,0,Paraguay
9766,6/1/2020,PRY,Perlis,0,0,0,Paraguay
9767,6/1/2020,PRY,Pulau Pinang,0,0,0,Paraguay
9768,6/1/2020,PRY,Sabah,0,0,0,Paraguay
9769,6/1/2020,PRY,Sarawak,0,0,0,Paraguay
9770,6/1/2020,PRY,Selangor,0,0,0,Paraguay
9771,6/1/2020,PSE,Johor,0,0,0,"Palestinian Territory, Occupied"
9772,6/1/2020,PSE,Kedah,0,0,0,"Palestinian Territory, Occupied"
9773,6/1/2020,PSE,Kelantan,0,0,0,"Palestinian Territory, Occupied"
9774,6/1/2020,PSE,Melaka,0,0,0,"Palestinian Territory, Occupied"
9775,6/1/2020,PSE,Perak,0,0,0,"Palestinian Territory, Occupied"
9776,6/1/2020,PSE,Perlis,0,0,0,"Palestinian Territory, Occupied"
9777,6/1/2020,PSE,Pulau Pinang,0,0,0,"Palestinian Territory, Occupied"
9778,6/1/2020,PSE,Sabah,0,0,0,"Palestinian Territory, Occupied"
9779,6/1/2020,PSE,Sarawak,0,0,0,"Palestinian Territory, Occupied"
9780,6/1/2020,PSE,Selangor,1,1,0,"Palestinian Territory, Occupied"
9781,6/1/2020,QAT,Johor,0,0,0,Qatar
9782,6/1/2020,QAT,Kedah,0,0,0,Qatar
9783,6/1/2020,QAT,Perlis,0,0,0,Qatar
9784,6/1/2020,QAT,Pulau Pinang,0,0,0,Qatar
9785,6/1/2020,QAT,Sabah,0,0,0,Qatar
9786,6/1/2020,QAT,Sarawak,0,0,0,Qatar
9787,6/1/2020,QAT,Selangor,0,0,0,Qatar
9788,6/1/2020,REU,Johor,0,0,0,Reunion
9789,6/1/2020,REU,Sarawak,0,0,0,Reunion
9790,6/1/2020,ROU,Johor,2,2,0,Romania
9791,6/1/2020,ROU,Kedah,0,0,0,Romania
9792,6/1/2020,ROU,Kelantan,0,0,0,Romania
9793,6/1/2020,ROU,Negeri Sembilan,0,0,0,Romania
9794,6/1/2020,ROU,Pahang,0,0,0,Romania
9795,6/1/2020,ROU,Perak,0,0,0,Romania
9796,6/1/2020,ROU,Perlis,0,0,0,Romania
9797,6/1/2020,ROU,Pulau Pinang,0,0,0,Romania
9798,6/1/2020,ROU,Sabah,0,0,0,Romania
9799,6/1/2020,ROU,Sarawak,0,0,0,Romania
9800,6/1/2020,ROU,Selangor,9,8,1,Romania
9801,6/1/2020,ROU,W.P. Labuan,0,0,0,Romania
9802,6/1/2020,RUS,Johor,0,0,0,Russia
9803,6/1/2020,RUS,Kedah,0,0,0,Russia
9804,6/1/2020,RUS,Kelantan,0,0,0,Russia
9805,6/1/2020,RUS,Melaka,0,0,0,Russia
9806,6/1/2020,RUS,Negeri Sembilan,0,0,0,Russia
9807,6/1/2020,RUS,Pahang,0,0,0,Russia
9808,6/1/2020,RUS,Perak,0,0,0,Russia
9809,6/1/2020,RUS,Perlis,0,0,0,Russia
9810,6/1/2020,RUS,Pulau Pinang,0,0,0,Russia
9811,6/1/2020,RUS,Sabah,0,0,0,Russia
9812,6/1/2020,RUS,Sarawak,0,0,0,Russia
9813,6/1/2020,RUS,Selangor,17,16,1,Russia
9814,6/1/2020,RUS,W.P. Labuan,0,0,0,Russia
9815,6/1/2020,RWA,Johor,0,0,0,Rwanda
9816,6/1/2020,RWA,Kedah,0,0,0,Rwanda
9817,6/1/2020,RWA,Pulau Pinang,0,0,0,Rwanda
9818,6/1/2020,RWA,Selangor,0,0,0,Rwanda
9819,6/1/2020,SAU,Johor,0,0,0,Saudi Arabia
9820,6/1/2020,SAU,Kedah,0,0,0,Saudi Arabia
9821,6/1/2020,SAU,Kelantan,0,0,0,Saudi Arabia
9822,6/1/2020,SAU,Melaka,0,0,0,Saudi Arabia
9823,6/1/2020,SAU,Perak,0,0,0,Saudi Arabia
9824,6/1/2020,SAU,Perlis,0,0,0,Saudi Arabia
9825,6/1/2020,SAU,Pulau Pinang,0,0,0,Saudi Arabia
9826,6/1/2020,SAU,Sabah,0,0,0,Saudi Arabia
9827,6/1/2020,SAU,Sarawak,0,0,0,Saudi Arabia
9828,6/1/2020,SAU,Selangor,6,3,3,Saudi Arabia
9829,6/1/2020,SAU,W.P. Labuan,0,0,0,Saudi Arabia
9830,6/1/2020,SDN,Johor,0,0,0,Sudan
9831,6/1/2020,SDN,Kedah,0,0,0,Sudan
9832,6/1/2020,SDN,Kelantan,0,0,0,Sudan
9833,6/1/2020,SDN,Perlis,0,0,0,Sudan
9834,6/1/2020,SDN,Pulau Pinang,0,0,0,Sudan
9835,6/1/2020,SDN,Sabah,0,0,0,Sudan
9836,6/1/2020,SDN,Sarawak,0,0,0,Sudan
9837,6/1/2020,SDN,Selangor,0,0,0,Sudan
9838,6/1/2020,SDN,W.P. Labuan,0,0,0,Sudan
9839,6/1/2020,SEN,Johor,0,0,0,Senegal
9840,6/1/2020,SEN,Kedah,0,0,0,Senegal
9841,6/1/2020,SEN,Kelantan,0,0,0,Senegal
9842,6/1/2020,SEN,Perak,0,0,0,Senegal
9843,6/1/2020,SEN,Perlis,0,0,0,Senegal
9844,6/1/2020,SEN,Pulau Pinang,0,0,0,Senegal
9845,6/1/2020,SEN,Sabah,0,0,0,Senegal
9846,6/1/2020,SEN,Sarawak,0,0,0,Senegal
9847,6/1/2020,SEN,Selangor,0,0,0,Senegal
9848,6/1/2020,SGP,Johor,109,94,15,Singapore
9849,6/1/2020,SGP,Kedah,0,0,0,Singapore
9850,6/1/2020,SGP,Kelantan,0,0,0,Singapore
9851,6/1/2020,SGP,Melaka,0,0,0,Singapore
9852,6/1/2020,SGP,Negeri Sembilan,0,0,0,Singapore
9853,6/1/2020,SGP,Pahang,0,0,0,Singapore
9854,6/1/2020,SGP,Perak,3,1,2,Singapore
9855,6/1/2020,SGP,Perlis,0,0,0,Singapore
9856,6/1/2020,SGP,Pulau Pinang,0,0,0,Singapore
9857,6/1/2020,SGP,Sabah,0,0,0,Singapore
9858,6/1/2020,SGP,Sarawak,2,2,0,Singapore
9859,6/1/2020,SGP,Selangor,36,22,14,Singapore
9860,6/1/2020,SGP,Terengganu,0,0,0,Singapore
9861,6/1/2020,SGP,W.P. Labuan,0,0,0,Singapore
9862,6/1/2020,SGS,Johor,0,0,0,South Georgia and the South Sandwich Islands
9863,6/1/2020,SGS,Sabah,0,0,0,South Georgia and the South Sandwich Islands
9864,6/1/2020,SGS,Selangor,0,0,0,South Georgia and the South Sandwich Islands
9865,6/1/2020,SHN,Sarawak,0,0,0,"Saint Helena, Ascension and Tristan da Cunha"
9866,6/1/2020,SLB,Johor,0,0,0,Solomon Islands
9867,6/1/2020,SLB,Perlis,0,0,0,Solomon Islands
9868,6/1/2020,SLB,Pulau Pinang,0,0,0,Solomon Islands
9869,6/1/2020,SLB,Sabah,0,0,0,Solomon Islands
9870,6/1/2020,SLB,Sarawak,0,0,0,Solomon Islands
9871,6/1/2020,SLB,Selangor,0,0,0,Solomon Islands
9872,6/1/2020,SLB,W.P. Labuan,0,0,0,Solomon Islands
9873,6/1/2020,SLE,Johor,0,0,0,Sierra Leone
9874,6/1/2020,SLE,Kedah,0,0,0,Sierra Leone
9875,6/1/2020,SLE,Perak,0,0,0,Sierra Leone
9876,6/1/2020,SLE,Pulau Pinang,0,0,0,Sierra Leone
9877,6/1/2020,SLE,Sabah,0,0,0,Sierra Leone
9878,6/1/2020,SLE,Selangor,0,0,0,Sierra Leone
9879,6/1/2020,SLV,Johor,0,0,0,El Salvador
9880,6/1/2020,SLV,Kedah,0,0,0,El Salvador
9881,6/1/2020,SLV,Perak,0,0,0,El Salvador
9882,6/1/2020,SLV,Perlis,0,0,0,El Salvador
9883,6/1/2020,SLV,Pulau Pinang,0,0,0,El Salvador
9884,6/1/2020,SLV,Sabah,0,0,0,El Salvador
9885,6/1/2020,SLV,Selangor,0,0,0,El Salvador
9886,6/1/2020,SLV,W.P. Labuan,0,0,0,El Salvador
9887,6/1/2020,SMR,Johor,0,0,0,San Marino
9888,6/1/2020,SMR,Selangor,0,0,0,San Marino
9889,6/1/2020,SOM,Johor,0,0,0,Somalia
9890,6/1/2020,SOM,Kedah,0,0,0,Somalia
9891,6/1/2020,SOM,Kelantan,0,0,0,Somalia
9892,6/1/2020,SOM,Perlis,0,0,0,Somalia
9893,6/1/2020,SOM,Sabah,0,0,0,Somalia
9894,6/1/2020,SOM,Sarawak,0,0,0,Somalia
9895,6/1/2020,SOM,Selangor,0,0,0,Somalia
9896,6/1/2020,SRB,Johor,0,0,0,Serbia
9897,6/1/2020,SRB,Kedah,0,0,0,Serbia
9898,6/1/2020,SRB,Kelantan,0,0,0,Serbia
9899,6/1/2020,SRB,Pahang,0,0,0,Serbia
9900,6/1/2020,SRB,Perak,0,0,0,Serbia
9901,6/1/2020,SRB,Perlis,0,0,0,Serbia
9902,6/1/2020,SRB,Pulau Pinang,0,0,0,Serbia
9903,6/1/2020,SRB,Sabah,0,0,0,Serbia
9904,6/1/2020,SRB,Sarawak,0,0,0,Serbia
9905,6/1/2020,SRB,Selangor,0,0,0,Serbia
9906,6/1/2020,STP,Selangor,0,0,0,Sao Tome and Principe
9907,6/1/2020,SUR,Johor,0,0,0,Suriname
9908,6/1/2020,SUR,Kedah,0,0,0,Suriname
9909,6/1/2020,SUR,Kelantan,0,0,0,Suriname
9910,6/1/2020,SUR,Perak,0,0,0,Suriname
9911,6/1/2020,SUR,Perlis,0,0,0,Suriname
9912,6/1/2020,SUR,Pulau Pinang,0,0,0,Suriname
9913,6/1/2020,SUR,Sabah,0,0,0,Suriname
9914,6/1/2020,SUR,Sarawak,0,0,0,Suriname
9915,6/1/2020,SUR,Selangor,0,0,0,Suriname
9916,6/1/2020,SVK,Johor,0,0,0,Slovakia
9917,6/1/2020,SVK,Kedah,0,0,0,Slovakia
9918,6/1/2020,SVK,Kelantan,0,0,0,Slovakia
9919,6/1/2020,SVK,Negeri Sembilan,0,0,0,Slovakia
9920,6/1/2020,SVK,Pahang,0,0,0,Slovakia
9921,6/1/2020,SVK,Perak,0,0,0,Slovakia
9922,6/1/2020,SVK,Perlis,0,0,0,Slovakia
9923,6/1/2020,SVK,Pulau Pinang,0,0,0,Slovakia
9924,6/1/2020,SVK,Sabah,0,0,0,Slovakia
9925,6/1/2020,SVK,Sarawak,0,0,0,Slovakia
9926,6/1/2020,SVK,Selangor,0,0,0,Slovakia
9927,6/1/2020,SVK,W.P. Labuan,0,0,0,Slovakia
9928,6/1/2020,SVN,Johor,0,0,0,Slovenia
9929,6/1/2020,SVN,Kedah,0,0,0,Slovenia
9930,6/1/2020,SVN,Kelantan,0,0,0,Slovenia
9931,6/1/2020,SVN,Perak,0,0,0,Slovenia
9932,6/1/2020,SVN,Perlis,0,0,0,Slovenia
9933,6/1/2020,SVN,Pulau Pinang,0,0,0,Slovenia
9934,6/1/2020,SVN,Sabah,0,0,0,Slovenia
9935,6/1/2020,SVN,Sarawak,0,0,0,Slovenia
9936,6/1/2020,SVN,Selangor,0,0,0,Slovenia
9937,6/1/2020,SVN,W.P. Labuan,0,0,0,Slovenia
9938,6/1/2020,SWE,Johor,0,0,0,Sweden
9939,6/1/2020,SWE,Kedah,0,0,0,Sweden
9940,6/1/2020,SWE,Kelantan,0,0,0,Sweden
9941,6/1/2020,SWE,Melaka,0,0,0,Sweden
9942,6/1/2020,SWE,Negeri Sembilan,0,0,0,Sweden
9943,6/1/2020,SWE,Pahang,0,0,0,Sweden
9944,6/1/2020,SWE,Perak,0,0,0,Sweden
9945,6/1/2020,SWE,Perlis,0,0,0,Sweden
9946,6/1/2020,SWE,Pulau Pinang,0,0,0,Sweden
9947,6/1/2020,SWE,Sabah,0,0,0,Sweden
9948,6/1/2020,SWE,Sarawak,0,0,0,Sweden
9949,6/1/2020,SWE,Selangor,0,0,0,Sweden
9950,6/1/2020,SWE,W.P. Labuan,0,0,0,Sweden
9951,6/1/2020,SWZ,Johor,0,0,0,Swaziland
9952,6/1/2020,SWZ,Kedah,0,0,0,Swaziland
9953,6/1/2020,SWZ,Pulau Pinang,0,0,0,Swaziland
9954,6/1/2020,SWZ,Sabah,0,0,0,Swaziland
9955,6/1/2020,SWZ,Selangor,0,0,0,Swaziland
9956,6/1/2020,SYC,Johor,0,0,0,Seychelles
9957,6/1/2020,SYC,Kedah,0,0,0,Seychelles
9958,6/1/2020,SYC,Pulau Pinang,0,0,0,Seychelles
9959,6/1/2020,SYC,Sabah,0,0,0,Seychelles
9960,6/1/2020,SYC,Sarawak,0,0,0,Seychelles
9961,6/1/2020,SYC,Selangor,0,0,0,Seychelles
9962,6/1/2020,SYR,Johor,0,0,0,Syrian Arab Republic
9963,6/1/2020,SYR,Kedah,0,0,0,Syrian Arab Republic
9964,6/1/2020,SYR,Kelantan,0,0,0,Syrian Arab Republic
9965,6/1/2020,SYR,Pahang,0,0,0,Syrian Arab Republic
9966,6/1/2020,SYR,Perlis,0,0,0,Syrian Arab Republic
9967,6/1/2020,SYR,Pulau Pinang,0,0,0,Syrian Arab Republic
9968,6/1/2020,SYR,Sabah,0,0,0,Syrian Arab Republic
9969,6/1/2020,SYR,Sarawak,0,0,0,Syrian Arab Republic
9970,6/1/2020,SYR,Selangor,0,0,0,Syrian Arab Republic
9971,6/1/2020,SYR,W.P. Labuan,0,0,0,Syrian Arab Republic
9972,6/1/2020,TCA,Perlis,0,0,0,Turks and Caicos
9973,6/1/2020,TCD,Johor,0,0,0,Chad
9974,6/1/2020,TCD,Kedah,0,0,0,Chad
9975,6/1/2020,TCD,Perlis,0,0,0,Chad
9976,6/1/2020,TCD,Selangor,0,0,0,Chad
9977,6/1/2020,TGO,Johor,0,0,0,Togo
9978,6/1/2020,TGO,Perak,0,0,0,Togo
9979,6/1/2020,TGO,Pulau Pinang,0,0,0,Togo
9980,6/1/2020,TGO,Selangor,0,0,0,Togo
9981,6/1/2020,THA,Johor,135,134,1,Thailand
9982,6/1/2020,THA,Kedah,11733,10992,741,Thailand
9983,6/1/2020,THA,Kelantan,15,3,12,Thailand
9984,6/1/2020,THA,Melaka,0,0,0,Thailand
9985,6/1/2020,THA,Negeri Sembilan,0,0,0,Thailand
9986,6/1/2020,THA,Pahang,0,0,0,Thailand
9987,6/1/2020,THA,Perak,2,1,1,Thailand
9988,6/1/2020,THA,Perlis,3,0,3,Thailand
9989,6/1/2020,THA,Pulau Pinang,0,0,0,Thailand
9990,6/1/2020,THA,Sabah,0,0,0,Thailand
9991,6/1/2020,THA,Sarawak,13,13,0,Thailand
9992,6/1/2020,THA,Selangor,3,0,3,Thailand
9993,6/1/2020,THA,Terengganu,0,0,0,Thailand
9994,6/1/2020,THA,W.P. Labuan,0,0,0,Thailand
9995,6/1/2020,TJK,Johor,0,0,0,Tajikistan
9996,6/1/2020,TJK,Kedah,0,0,0,Tajikistan
9997,6/1/2020,TJK,Perlis,0,0,0,Tajikistan
9998,6/1/2020,TJK,Pulau Pinang,0,0,0,Tajikistan
9999,6/1/2020,TJK,Sabah,0,0,0,Tajikistan
10000,6/1/2020,TJK,Selangor,1,1,0,Tajikistan
10001,6/1/2020,TKL,Selangor,0,0,0,Tokelau
10002,6/1/2020,TKM,Johor,0,0,0,Turkmenistan
10003,6/1/2020,TKM,Kedah,0,0,0,Turkmenistan
10004,6/1/2020,TKM,Kelantan,0,0,0,Turkmenistan
10005,6/1/2020,TKM,Perlis,0,0,0,Turkmenistan
10006,6/1/2020,TKM,Pulau Pinang,0,0,0,Turkmenistan
10007,6/1/2020,TKM,Sabah,0,0,0,Turkmenistan
10008,6/1/2020,TKM,Sarawak,0,0,0,Turkmenistan
10009,6/1/2020,TKM,Selangor,0,0,0,Turkmenistan
10010,6/1/2020,TLS,Johor,0,0,0,Timor-Leste
10011,6/1/2020,TLS,Kedah,0,0,0,Timor-Leste
10012,6/1/2020,TLS,Perlis,0,0,0,Timor-Leste
10013,6/1/2020,TLS,Pulau Pinang,0,0,0,Timor-Leste
10014,6/1/2020,TLS,Sabah,0,0,0,Timor-Leste
10015,6/1/2020,TLS,Sarawak,0,0,0,Timor-Leste
10016,6/1/2020,TLS,Selangor,0,0,0,Timor-Leste
10017,6/1/2020,TON,Johor,0,0,0,Tonga
10018,6/1/2020,TON,Pulau Pinang,0,0,0,Tonga
10019,6/1/2020,TON,Sarawak,0,0,0,Tonga
10020,6/1/2020,TON,Selangor,0,0,0,Tonga
10021,6/1/2020,TTO,Johor,0,0,0,Trinidad and Tobago
10022,6/1/2020,TTO,Kedah,0,0,0,Trinidad and Tobago
10023,6/1/2020,TTO,Pahang,0,0,0,Trinidad and Tobago
10024,6/1/2020,TTO,Pulau Pinang,0,0,0,Trinidad and Tobago
10025,6/1/2020,TTO,Sabah,0,0,0,Trinidad and Tobago
10026,6/1/2020,TTO,Sarawak,0,0,0,Trinidad and Tobago
10027,6/1/2020,TTO,Selangor,0,0,0,Trinidad and Tobago
10028,6/1/2020,TUN,Johor,0,0,0,Tunisia
10029,6/1/2020,TUN,Kedah,0,0,0,Tunisia
10030,6/1/2020,TUN,Kelantan,0,0,0,Tunisia
10031,6/1/2020,TUN,Melaka,0,0,0,Tunisia
10032,6/1/2020,TUN,Perak,0,0,0,Tunisia
10033,6/1/2020,TUN,Perlis,0,0,0,Tunisia
10034,6/1/2020,TUN,Pulau Pinang,0,0,0,Tunisia
10035,6/1/2020,TUN,Sabah,0,0,0,Tunisia
10036,6/1/2020,TUN,Sarawak,0,0,0,Tunisia
10037,6/1/2020,TUN,Selangor,0,0,0,Tunisia
10038,6/1/2020,TUN,W.P. Labuan,0,0,0,Tunisia
10039,6/1/2020,TUR,Johor,0,0,0,Turkey
10040,6/1/2020,TUR,Kedah,0,0,0,Turkey
10041,6/1/2020,TUR,Kelantan,0,0,0,Turkey
10042,6/1/2020,TUR,Melaka,0,0,0,Turkey
10043,6/1/2020,TUR,Negeri Sembilan,0,0,0,Turkey
10044,6/1/2020,TUR,Pahang,0,0,0,Turkey
10045,6/1/2020,TUR,Perak,0,0,0,Turkey
10046,6/1/2020,TUR,Perlis,0,0,0,Turkey
10047,6/1/2020,TUR,Pulau Pinang,0,0,0,Turkey
10048,6/1/2020,TUR,Sabah,0,0,0,Turkey
10049,6/1/2020,TUR,Sarawak,0,0,0,Turkey
10050,6/1/2020,TUR,Selangor,8,5,3,Turkey
10051,6/1/2020,TUR,W.P. Labuan,0,0,0,Turkey
10052,6/1/2020,TUV,Selangor,0,0,0,Tuvalu
10053,6/1/2020,TWN,Johor,1,1,0,Taiwan
10054,6/1/2020,TWN,Kedah,0,0,0,Taiwan
10055,6/1/2020,TWN,Kelantan,0,0,0,Taiwan
10056,6/1/2020,TWN,Melaka,0,0,0,Taiwan
10057,6/1/2020,TWN,Negeri Sembilan,0,0,0,Taiwan
10058,6/1/2020,TWN,Pahang,0,0,0,Taiwan
10059,6/1/2020,TWN,Perak,0,0,0,Taiwan
10060,6/1/2020,TWN,Perlis,0,0,0,Taiwan
10061,6/1/2020,TWN,Pulau Pinang,0,0,0,Taiwan
10062,6/1/2020,TWN,Sabah,0,0,0,Taiwan
10063,6/1/2020,TWN,Sarawak,0,0,0,Taiwan
10064,6/1/2020,TWN,Selangor,11,6,5,Taiwan
10065,6/1/2020,TWN,W.P. Labuan,0,0,0,Taiwan
10066,6/1/2020,TZA,Johor,0,0,0,"Tanzania, United Republic of"
10067,6/1/2020,TZA,Kedah,0,0,0,"Tanzania, United Republic of"
10068,6/1/2020,TZA,Perak,0,0,0,"Tanzania, United Republic of"
10069,6/1/2020,TZA,Perlis,0,0,0,"Tanzania, United Republic of"
10070,6/1/2020,TZA,Pulau Pinang,0,0,0,"Tanzania, United Republic of"
10071,6/1/2020,TZA,Sabah,0,0,0,"Tanzania, United Republic of"
10072,6/1/2020,TZA,Sarawak,0,0,0,"Tanzania, United Republic of"
10073,6/1/2020,TZA,Selangor,0,0,0,"Tanzania, United Republic of"
10074,6/1/2020,UGA,Johor,0,0,0,Uganda
10075,6/1/2020,UGA,Kedah,0,0,0,Uganda
10076,6/1/2020,UGA,Perak,0,0,0,Uganda
10077,6/1/2020,UGA,Perlis,0,0,0,Uganda
10078,6/1/2020,UGA,Pulau Pinang,0,0,0,Uganda
10079,6/1/2020,UGA,Sabah,0,0,0,Uganda
10080,6/1/2020,UGA,Sarawak,0,0,0,Uganda
10081,6/1/2020,UGA,Selangor,0,0,0,Uganda
10082,6/1/2020,UKR,Johor,2,2,0,Ukraine
10083,6/1/2020,UKR,Kedah,0,0,0,Ukraine
10084,6/1/2020,UKR,Kelantan,0,0,0,Ukraine
10085,6/1/2020,UKR,Melaka,0,0,0,Ukraine
10086,6/1/2020,UKR,Negeri Sembilan,0,0,0,Ukraine
10087,6/1/2020,UKR,Pahang,0,0,0,Ukraine
10088,6/1/2020,UKR,Perak,0,0,0,Ukraine
10089,6/1/2020,UKR,Perlis,0,0,0,Ukraine
10090,6/1/2020,UKR,Pulau Pinang,0,0,0,Ukraine
10091,6/1/2020,UKR,Sabah,0,0,0,Ukraine
10092,6/1/2020,UKR,Sarawak,0,0,0,Ukraine
10093,6/1/2020,UKR,Selangor,10,9,1,Ukraine
10094,6/1/2020,UKR,W.P. Labuan,0,0,0,Ukraine
10095,6/1/2020,URY,Johor,0,0,0,Uruguay
10096,6/1/2020,URY,Kedah,0,0,0,Uruguay
10097,6/1/2020,URY,Kelantan,0,0,0,Uruguay
10098,6/1/2020,URY,Perak,0,0,0,Uruguay
10099,6/1/2020,URY,Perlis,0,0,0,Uruguay
10100,6/1/2020,URY,Pulau Pinang,0,0,0,Uruguay
10101,6/1/2020,URY,Sabah,0,0,0,Uruguay
10102,6/1/2020,URY,Sarawak,0,0,0,Uruguay
10103,6/1/2020,URY,Selangor,0,0,0,Uruguay
10104,6/1/2020,URY,W.P. Labuan,0,0,0,Uruguay
10105,6/1/2020,USA,Johor,13,11,2,United States Of America
10106,6/1/2020,USA,Kedah,0,0,0,United States Of America
10107,6/1/2020,USA,Kelantan,0,0,0,United States Of America
10108,6/1/2020,USA,Melaka,0,0,0,United States Of America
10109,6/1/2020,USA,Negeri Sembilan,0,0,0,United States Of America
10110,6/1/2020,USA,Pahang,0,0,0,United States Of America
10111,6/1/2020,USA,Perak,0,0,0,United States Of America
10112,6/1/2020,USA,Perlis,0,0,0,United States Of America
10113,6/1/2020,USA,Pulau Pinang,3,3,0,United States Of America
10114,6/1/2020,USA,Sabah,0,0,0,United States Of America
10115,6/1/2020,USA,Sarawak,0,0,0,United States Of America
10116,6/1/2020,USA,Selangor,34,25,9,United States Of America
10117,6/1/2020,USA,Terengganu,0,0,0,United States Of America
10118,6/1/2020,USA,W.P. Labuan,0,0,0,United States Of America
10119,6/1/2020,UZB,Johor,0,0,0,Uzbekistan
10120,6/1/2020,UZB,Kedah,0,0,0,Uzbekistan
10121,6/1/2020,UZB,Kelantan,0,0,0,Uzbekistan
10122,6/1/2020,UZB,Perak,0,0,0,Uzbekistan
10123,6/1/2020,UZB,Perlis,0,0,0,Uzbekistan
10124,6/1/2020,UZB,Pulau Pinang,0,0,0,Uzbekistan
10125,6/1/2020,UZB,Sabah,0,0,0,Uzbekistan
10126,6/1/2020,UZB,Sarawak,0,0,0,Uzbekistan
10127,6/1/2020,UZB,Selangor,0,0,0,Uzbekistan
10128,6/1/2020,VAT,Johor,0,0,0,Holy See (Vatican City State)
10129,6/1/2020,VAT,Sarawak,0,0,0,Holy See (Vatican City State)
10130,6/1/2020,VAT,Selangor,0,0,0,Holy See (Vatican City State)
10131,6/1/2020,VCT,Johor,0,0,0,Saint Vincent and the Grenadines
10132,6/1/2020,VCT,Kedah,0,0,0,Saint Vincent and the Grenadines
10133,6/1/2020,VCT,Pulau Pinang,0,0,0,Saint Vincent and the Grenadines
10134,6/1/2020,VCT,Sarawak,0,0,0,Saint Vincent and the Grenadines
10135,6/1/2020,VCT,Selangor,0,0,0,Saint Vincent and the Grenadines
10136,6/1/2020,VEN,Johor,0,0,0,Venezuela
10137,6/1/2020,VEN,Kedah,0,0,0,Venezuela
10138,6/1/2020,VEN,Kelantan,0,0,0,Venezuela
10139,6/1/2020,VEN,Melaka,0,0,0,Venezuela
10140,6/1/2020,VEN,Perak,0,0,0,Venezuela
10141,6/1/2020,VEN,Perlis,0,0,0,Venezuela
10142,6/1/2020,VEN,Pulau Pinang,0,0,0,Venezuela
10143,6/1/2020,VEN,Sabah,0,0,0,Venezuela
10144,6/1/2020,VEN,Sarawak,0,0,0,Venezuela
10145,6/1/2020,VEN,Selangor,2,1,1,Venezuela
10146,6/1/2020,VEN,W.P. Labuan,0,0,0,Venezuela
10147,6/1/2020,VNM,Johor,1,0,1,Vietnam
10148,6/1/2020,VNM,Kedah,0,0,0,Vietnam
10149,6/1/2020,VNM,Kelantan,0,0,0,Vietnam
10150,6/1/2020,VNM,Melaka,0,0,0,Vietnam
10151,6/1/2020,VNM,Negeri Sembilan,0,0,0,Vietnam
10152,6/1/2020,VNM,Pahang,0,0,0,Vietnam
10153,6/1/2020,VNM,Perak,0,0,0,Vietnam
10154,6/1/2020,VNM,Perlis,0,0,0,Vietnam
10155,6/1/2020,VNM,Pulau Pinang,0,0,0,Vietnam
10156,6/1/2020,VNM,Sabah,0,0,0,Vietnam
10157,6/1/2020,VNM,Sarawak,0,0,0,Vietnam
10158,6/1/2020,VNM,Selangor,31,30,1,Vietnam
10159,6/1/2020,VNM,Terengganu,0,0,0,Vietnam
10160,6/1/2020,VNM,W.P. Labuan,0,0,0,Vietnam
10161,6/1/2020,VUT,Johor,0,0,0,Vanuatu
10162,6/1/2020,VUT,Kedah,0,0,0,Vanuatu
10163,6/1/2020,VUT,Pulau Pinang,0,0,0,Vanuatu
10164,6/1/2020,VUT,Sabah,0,0,0,Vanuatu
10165,6/1/2020,VUT,Sarawak,0,0,0,Vanuatu
10166,6/1/2020,VUT,Selangor,0,0,0,Vanuatu
10167,6/1/2020,WSM,Johor,0,0,0,Samoa
10168,6/1/2020,WSM,Sarawak,0,0,0,Samoa
10169,6/1/2020,WSM,Selangor,0,0,0,Samoa
10170,6/1/2020,YEM,Johor,0,0,0,Yemen
10171,6/1/2020,YEM,Kedah,0,0,0,Yemen
10172,6/1/2020,YEM,Kelantan,0,0,0,Yemen
10173,6/1/2020,YEM,Melaka,0,0,0,Yemen
10174,6/1/2020,YEM,Pahang,0,0,0,Yemen
10175,6/1/2020,YEM,Perak,0,0,0,Yemen
10176,6/1/2020,YEM,Perlis,0,0,0,Yemen
10177,6/1/2020,YEM,Pulau Pinang,0,0,0,Yemen
10178,6/1/2020,YEM,Sabah,0,0,0,Yemen
10179,6/1/2020,YEM,Sarawak,0,0,0,Yemen
10180,6/1/2020,YEM,Selangor,0,0,0,Yemen
10181,6/1/2020,YEM,W.P. Labuan,0,0,0,Yemen
10182,6/1/2020,ZAF,Johor,0,0,0,South Africa
10183,6/1/2020,ZAF,Kedah,0,0,0,South Africa
10184,6/1/2020,ZAF,Kelantan,0,0,0,South Africa
10185,6/1/2020,ZAF,Melaka,0,0,0,South Africa
10186,6/1/2020,ZAF,Pahang,0,0,0,South Africa
10187,6/1/2020,ZAF,Perak,0,0,0,South Africa
10188,6/1/2020,ZAF,Perlis,0,0,0,South Africa
10189,6/1/2020,ZAF,Pulau Pinang,0,0,0,South Africa
10190,6/1/2020,ZAF,Sabah,0,0,0,South Africa
10191,6/1/2020,ZAF,Sarawak,0,0,0,South Africa
10192,6/1/2020,ZAF,Selangor,14,6,8,South Africa
10193,6/1/2020,ZAF,Terengganu,0,0,0,South Africa
10194,6/1/2020,ZAF,W.P. Labuan,0,0,0,South Africa
10195,6/1/2020,ZMB,Johor,0,0,0,Zambia
10196,6/1/2020,ZMB,Kedah,0,0,0,Zambia
10197,6/1/2020,ZMB,Perak,0,0,0,Zambia
10198,6/1/2020,ZMB,Perlis,0,0,0,Zambia
10199,6/1/2020,ZMB,Pulau Pinang,0,0,0,Zambia
10200,6/1/2020,ZMB,Sabah,0,0,0,Zambia
10201,6/1/2020,ZMB,Sarawak,0,0,0,Zambia
10202,6/1/2020,ZMB,Selangor,0,0,0,Zambia
10203,6/1/2020,ZWE,Johor,0,0,0,Zimbabwe
10204,6/1/2020,ZWE,Kedah,0,0,0,Zimbabwe
10205,6/1/2020,ZWE,Kelantan,0,0,0,Zimbabwe
10206,6/1/2020,ZWE,Perak,0,0,0,Zimbabwe
10207,6/1/2020,ZWE,Perlis,0,0,0,Zimbabwe
10208,6/1/2020,ZWE,Pulau Pinang,0,0,0,Zimbabwe
10209,6/1/2020,ZWE,Sabah,0,0,0,Zimbabwe
10210,6/1/2020,ZWE,Sarawak,0,0,0,Zimbabwe
10211,6/1/2020,ZWE,Selangor,0,0,0,Zimbabwe
10212,7/1/2020,ABW,Kedah,0,0,0,Aruba
10213,7/1/2020,ABW,Pulau Pinang,0,0,0,Aruba
10214,7/1/2020,AFG,Johor,0,0,0,Afghanistan
10215,7/1/2020,AFG,Kedah,0,0,0,Afghanistan
10216,7/1/2020,AFG,Perlis,0,0,0,Afghanistan
10217,7/1/2020,AFG,Pulau Pinang,0,0,0,Afghanistan
10218,7/1/2020,AFG,Sarawak,0,0,0,Afghanistan
10219,7/1/2020,AFG,Selangor,6,3,3,Afghanistan
10220,7/1/2020,AGO,Johor,0,0,0,Angola
10221,7/1/2020,AGO,Kedah,0,0,0,Angola
10222,7/1/2020,AGO,Sabah,0,0,0,Angola
10223,7/1/2020,AGO,Selangor,0,0,0,Angola
10224,7/1/2020,AIA,Selangor,0,0,0,Anguilla
10225,7/1/2020,ALB,Johor,0,0,0,Albania
10226,7/1/2020,ALB,Kedah,0,0,0,Albania
10227,7/1/2020,ALB,Perak,0,0,0,Albania
10228,7/1/2020,ALB,Perlis,0,0,0,Albania
10229,7/1/2020,ALB,Pulau Pinang,0,0,0,Albania
10230,7/1/2020,ALB,Sabah,0,0,0,Albania
10231,7/1/2020,ALB,Sarawak,0,0,0,Albania
10232,7/1/2020,ALB,Selangor,0,0,0,Albania
10233,7/1/2020,AND,Johor,0,0,0,Andorra
10234,7/1/2020,AND,Kedah,0,0,0,Andorra
10235,7/1/2020,AND,Perlis,0,0,0,Andorra
10236,7/1/2020,AND,Pulau Pinang,0,0,0,Andorra
10237,7/1/2020,AND,Selangor,0,0,0,Andorra
10238,7/1/2020,ANT,Selangor,0,0,0,Netherlands Antilles
10239,7/1/2020,ARE,Johor,0,0,0,United Arab Emirates
10240,7/1/2020,ARE,Kedah,0,0,0,United Arab Emirates
10241,7/1/2020,ARE,Kelantan,0,0,0,United Arab Emirates
10242,7/1/2020,ARE,Perak,0,0,0,United Arab Emirates
10243,7/1/2020,ARE,Perlis,0,0,0,United Arab Emirates
10244,7/1/2020,ARE,Pulau Pinang,0,0,0,United Arab Emirates
10245,7/1/2020,ARE,Sabah,0,0,0,United Arab Emirates
10246,7/1/2020,ARE,Sarawak,0,0,0,United Arab Emirates
10247,7/1/2020,ARE,Selangor,5,1,4,United Arab Emirates
10248,7/1/2020,ARG,Johor,0,0,0,Argentina
10249,7/1/2020,ARG,Kedah,0,0,0,Argentina
10250,7/1/2020,ARG,Kelantan,0,0,0,Argentina
10251,7/1/2020,ARG,Melaka,0,0,0,Argentina
10252,7/1/2020,ARG,Perak,0,0,0,Argentina
10253,7/1/2020,ARG,Perlis,0,0,0,Argentina
10254,7/1/2020,ARG,Pulau Pinang,0,0,0,Argentina
10255,7/1/2020,ARG,Sabah,0,0,0,Argentina
10256,7/1/2020,ARG,Sarawak,0,0,0,Argentina
10257,7/1/2020,ARG,Selangor,4,2,2,Argentina
10258,7/1/2020,ARG,W.P. Labuan,0,0,0,Argentina
10259,7/1/2020,ARM,Johor,0,0,0,Armenia
10260,7/1/2020,ARM,Kedah,0,0,0,Armenia
10261,7/1/2020,ARM,Kelantan,0,0,0,Armenia
10262,7/1/2020,ARM,Perak,0,0,0,Armenia
10263,7/1/2020,ARM,Perlis,0,0,0,Armenia
10264,7/1/2020,ARM,Pulau Pinang,0,0,0,Armenia
10265,7/1/2020,ARM,Sabah,0,0,0,Armenia
10266,7/1/2020,ARM,Sarawak,0,0,0,Armenia
10267,7/1/2020,ARM,Selangor,0,0,0,Armenia
10268,7/1/2020,ATA,Selangor,0,0,0,Antarctica
10269,7/1/2020,ATG,Johor,0,0,0,Antigua and Barbuda
10270,7/1/2020,ATG,Kedah,0,0,0,Antigua and Barbuda
10271,7/1/2020,ATG,Pulau Pinang,0,0,0,Antigua and Barbuda
10272,7/1/2020,ATG,Sarawak,0,0,0,Antigua and Barbuda
10273,7/1/2020,ATG,Selangor,0,0,0,Antigua and Barbuda
10274,7/1/2020,AUS,Johor,5,5,0,Australia
10275,7/1/2020,AUS,Kedah,1,1,0,Australia
10276,7/1/2020,AUS,Kelantan,0,0,0,Australia
10277,7/1/2020,AUS,Melaka,0,0,0,Australia
10278,7/1/2020,AUS,Negeri Sembilan,0,0,0,Australia
10279,7/1/2020,AUS,Pahang,0,0,0,Australia
10280,7/1/2020,AUS,Perak,0,0,0,Australia
10281,7/1/2020,AUS,Perlis,0,0,0,Australia
10282,7/1/2020,AUS,Pulau Pinang,0,0,0,Australia
10283,7/1/2020,AUS,Sabah,0,0,0,Australia
10284,7/1/2020,AUS,Sarawak,3,3,0,Australia
10285,7/1/2020,AUS,Selangor,162,111,51,Australia
10286,7/1/2020,AUS,Terengganu,0,0,0,Australia
10287,7/1/2020,AUS,W.P. Labuan,1,1,0,Australia
10288,7/1/2020,AUT,Johor,0,0,0,Austria
10289,7/1/2020,AUT,Kedah,0,0,0,Austria
10290,7/1/2020,AUT,Kelantan,0,0,0,Austria
10291,7/1/2020,AUT,Melaka,0,0,0,Austria
10292,7/1/2020,AUT,Negeri Sembilan,0,0,0,Austria
10293,7/1/2020,AUT,Pahang,0,0,0,Austria
10294,7/1/2020,AUT,Perak,0,0,0,Austria
10295,7/1/2020,AUT,Perlis,0,0,0,Austria
10296,7/1/2020,AUT,Pulau Pinang,0,0,0,Austria
10297,7/1/2020,AUT,Sabah,0,0,0,Austria
10298,7/1/2020,AUT,Sarawak,0,0,0,Austria
10299,7/1/2020,AUT,Selangor,13,9,4,Austria
10300,7/1/2020,AUT,Terengganu,0,0,0,Austria
10301,7/1/2020,AUT,W.P. Labuan,0,0,0,Austria
10302,7/1/2020,AZE,Johor,0,0,0,Azerbaijan
10303,7/1/2020,AZE,Kedah,0,0,0,Azerbaijan
10304,7/1/2020,AZE,Kelantan,0,0,0,Azerbaijan
10305,7/1/2020,AZE,Melaka,0,0,0,Azerbaijan
10306,7/1/2020,AZE,Perlis,0,0,0,Azerbaijan
10307,7/1/2020,AZE,Pulau Pinang,0,0,0,Azerbaijan
10308,7/1/2020,AZE,Sabah,0,0,0,Azerbaijan
10309,7/1/2020,AZE,Sarawak,0,0,0,Azerbaijan
10310,7/1/2020,AZE,Selangor,1,1,0,Azerbaijan
10311,7/1/2020,AZE,W.P. Labuan,0,0,0,Azerbaijan
10312,7/1/2020,BDI,Pulau Pinang,0,0,0,Burundi
10313,7/1/2020,BDI,Sarawak,0,0,0,Burundi
10314,7/1/2020,BDI,Selangor,0,0,0,Burundi
10315,7/1/2020,BEL,Johor,0,0,0,Belgium
10316,7/1/2020,BEL,Kedah,0,0,0,Belgium
10317,7/1/2020,BEL,Kelantan,0,0,0,Belgium
10318,7/1/2020,BEL,Melaka,0,0,0,Belgium
10319,7/1/2020,BEL,Negeri Sembilan,0,0,0,Belgium
10320,7/1/2020,BEL,Pahang,0,0,0,Belgium
10321,7/1/2020,BEL,Perak,0,0,0,Belgium
10322,7/1/2020,BEL,Perlis,0,0,0,Belgium
10323,7/1/2020,BEL,Pulau Pinang,0,0,0,Belgium
10324,7/1/2020,BEL,Sabah,0,0,0,Belgium
10325,7/1/2020,BEL,Sarawak,0,0,0,Belgium
10326,7/1/2020,BEL,Selangor,12,10,2,Belgium
10327,7/1/2020,BEL,W.P. Labuan,0,0,0,Belgium
10328,7/1/2020,BEN,Johor,0,0,0,Benin
10329,7/1/2020,BEN,Kedah,0,0,0,Benin
10330,7/1/2020,BEN,Perak,0,0,0,Benin
10331,7/1/2020,BEN,Pulau Pinang,0,0,0,Benin
10332,7/1/2020,BEN,Sabah,0,0,0,Benin
10333,7/1/2020,BEN,Sarawak,0,0,0,Benin
10334,7/1/2020,BEN,Selangor,0,0,0,Benin
10335,7/1/2020,BFA,Perak,0,0,0,Burkina Faso
10336,7/1/2020,BFA,Pulau Pinang,0,0,0,Burkina Faso
10337,7/1/2020,BFA,Selangor,0,0,0,Burkina Faso
10338,7/1/2020,BGD,Johor,2,2,0,Bangladesh
10339,7/1/2020,BGD,Kedah,0,0,0,Bangladesh
10340,7/1/2020,BGD,Kelantan,0,0,0,Bangladesh
10341,7/1/2020,BGD,Melaka,0,0,0,Bangladesh
10342,7/1/2020,BGD,Negeri Sembilan,0,0,0,Bangladesh
10343,7/1/2020,BGD,Pahang,0,0,0,Bangladesh
10344,7/1/2020,BGD,Perak,0,0,0,Bangladesh
10345,7/1/2020,BGD,Perlis,0,0,0,Bangladesh
10346,7/1/2020,BGD,Pulau Pinang,0,0,0,Bangladesh
10347,7/1/2020,BGD,Sabah,0,0,0,Bangladesh
10348,7/1/2020,BGD,Sarawak,0,0,0,Bangladesh
10349,7/1/2020,BGD,Selangor,106,70,36,Bangladesh
10350,7/1/2020,BGD,W.P. Labuan,0,0,0,Bangladesh
10351,7/1/2020,BGR,Johor,1,1,0,Bulgaria
10352,7/1/2020,BGR,Kedah,0,0,0,Bulgaria
10353,7/1/2020,BGR,Kelantan,0,0,0,Bulgaria
10354,7/1/2020,BGR,Pahang,0,0,0,Bulgaria
10355,7/1/2020,BGR,Perak,0,0,0,Bulgaria
10356,7/1/2020,BGR,Perlis,0,0,0,Bulgaria
10357,7/1/2020,BGR,Pulau Pinang,0,0,0,Bulgaria
10358,7/1/2020,BGR,Sabah,0,0,0,Bulgaria
10359,7/1/2020,BGR,Sarawak,0,0,0,Bulgaria
10360,7/1/2020,BGR,Selangor,24,24,0,Bulgaria
10361,7/1/2020,BGR,W.P. Labuan,0,0,0,Bulgaria
10362,7/1/2020,BHR,Johor,0,0,0,Bahrain
10363,7/1/2020,BHR,Kedah,0,0,0,Bahrain
10364,7/1/2020,BHR,Kelantan,0,0,0,Bahrain
10365,7/1/2020,BHR,Perlis,0,0,0,Bahrain
10366,7/1/2020,BHR,Pulau Pinang,0,0,0,Bahrain
10367,7/1/2020,BHR,Sabah,0,0,0,Bahrain
10368,7/1/2020,BHR,Sarawak,0,0,0,Bahrain
10369,7/1/2020,BHR,Selangor,0,0,0,Bahrain
10370,7/1/2020,BHS,Johor,0,0,0,Bahamas
10371,7/1/2020,BHS,Kedah,0,0,0,Bahamas
10372,7/1/2020,BHS,Perak,0,0,0,Bahamas
10373,7/1/2020,BHS,Sabah,0,0,0,Bahamas
10374,7/1/2020,BHS,Sarawak,0,0,0,Bahamas
10375,7/1/2020,BHS,Selangor,0,0,0,Bahamas
10376,7/1/2020,BIH,Johor,0,0,0,Bosnia and Herzegovina
10377,7/1/2020,BIH,Kedah,0,0,0,Bosnia and Herzegovina
10378,7/1/2020,BIH,Perlis,0,0,0,Bosnia and Herzegovina
10379,7/1/2020,BIH,Pulau Pinang,0,0,0,Bosnia and Herzegovina
10380,7/1/2020,BIH,Sabah,0,0,0,Bosnia and Herzegovina
10381,7/1/2020,BIH,Sarawak,0,0,0,Bosnia and Herzegovina
10382,7/1/2020,BIH,Selangor,1,1,0,Bosnia and Herzegovina
10383,7/1/2020,BLR,Johor,0,0,0,Belarus
10384,7/1/2020,BLR,Kedah,0,0,0,Belarus
10385,7/1/2020,BLR,Kelantan,0,0,0,Belarus
10386,7/1/2020,BLR,Pahang,0,0,0,Belarus
10387,7/1/2020,BLR,Perak,0,0,0,Belarus
10388,7/1/2020,BLR,Perlis,0,0,0,Belarus
10389,7/1/2020,BLR,Pulau Pinang,0,0,0,Belarus
10390,7/1/2020,BLR,Sabah,0,0,0,Belarus
10391,7/1/2020,BLR,Sarawak,0,0,0,Belarus
10392,7/1/2020,BLR,Selangor,1,1,0,Belarus
10393,7/1/2020,BLR,W.P. Labuan,0,0,0,Belarus
10394,7/1/2020,BLZ,Johor,0,0,0,Belize
10395,7/1/2020,BLZ,Pulau Pinang,0,0,0,Belize
10396,7/1/2020,BLZ,Sarawak,0,0,0,Belize
10397,7/1/2020,BLZ,Selangor,0,0,0,Belize
10398,7/1/2020,BMU,Selangor,0,0,0,Bermuda
10399,7/1/2020,BOL,Johor,0,0,0,Bolivia
10400,7/1/2020,BOL,Kedah,0,0,0,Bolivia
10401,7/1/2020,BOL,Melaka,0,0,0,Bolivia
10402,7/1/2020,BOL,Perak,0,0,0,Bolivia
10403,7/1/2020,BOL,Perlis,0,0,0,Bolivia
10404,7/1/2020,BOL,Pulau Pinang,0,0,0,Bolivia
10405,7/1/2020,BOL,Sabah,0,0,0,Bolivia
10406,7/1/2020,BOL,Sarawak,0,0,0,Bolivia
10407,7/1/2020,BOL,Selangor,0,0,0,Bolivia
10408,7/1/2020,BRA,Johor,0,0,0,Brazil
10409,7/1/2020,BRA,Kedah,0,0,0,Brazil
10410,7/1/2020,BRA,Kelantan,0,0,0,Brazil
10411,7/1/2020,BRA,Melaka,0,0,0,Brazil
10412,7/1/2020,BRA,Pahang,0,0,0,Brazil
10413,7/1/2020,BRA,Perak,0,0,0,Brazil
10414,7/1/2020,BRA,Perlis,0,0,0,Brazil
10415,7/1/2020,BRA,Pulau Pinang,0,0,0,Brazil
10416,7/1/2020,BRA,Sabah,0,0,0,Brazil
10417,7/1/2020,BRA,Sarawak,0,0,0,Brazil
10418,7/1/2020,BRA,Selangor,16,13,3,Brazil
10419,7/1/2020,BRA,W.P. Labuan,0,0,0,Brazil
10420,7/1/2020,BRB,Johor,0,0,0,Barbados
10421,7/1/2020,BRB,Kedah,0,0,0,Barbados
10422,7/1/2020,BRB,Perlis,0,0,0,Barbados
10423,7/1/2020,BRB,Pulau Pinang,0,0,0,Barbados
10424,7/1/2020,BRB,Selangor,1,0,1,Barbados
10425,7/1/2020,BRN,Johor,0,0,0,Brunei Darussalam
10426,7/1/2020,BRN,Kedah,0,0,0,Brunei Darussalam
10427,7/1/2020,BRN,Kelantan,0,0,0,Brunei Darussalam
10428,7/1/2020,BRN,Melaka,0,0,0,Brunei Darussalam
10429,7/1/2020,BRN,Pahang,0,0,0,Brunei Darussalam
10430,7/1/2020,BRN,Perak,0,0,0,Brunei Darussalam
10431,7/1/2020,BRN,Perlis,0,0,0,Brunei Darussalam
10432,7/1/2020,BRN,Pulau Pinang,0,0,0,Brunei Darussalam
10433,7/1/2020,BRN,Sabah,0,0,0,Brunei Darussalam
10434,7/1/2020,BRN,Sarawak,339,315,24,Brunei Darussalam
10435,7/1/2020,BRN,Selangor,10,1,9,Brunei Darussalam
10436,7/1/2020,BRN,W.P. Labuan,1,0,1,Brunei Darussalam
10437,7/1/2020,BTN,Johor,0,0,0,Bhutan
10438,7/1/2020,BTN,Kedah,0,0,0,Bhutan
10439,7/1/2020,BTN,Perak,0,0,0,Bhutan
10440,7/1/2020,BTN,Perlis,0,0,0,Bhutan
10441,7/1/2020,BTN,Pulau Pinang,0,0,0,Bhutan
10442,7/1/2020,BTN,Sabah,0,0,0,Bhutan
10443,7/1/2020,BTN,Sarawak,0,0,0,Bhutan
10444,7/1/2020,BTN,Selangor,0,0,0,Bhutan
10445,7/1/2020,BWA,Johor,0,0,0,Botswana
10446,7/1/2020,BWA,Kedah,0,0,0,Botswana
10447,7/1/2020,BWA,Perlis,0,0,0,Botswana
10448,7/1/2020,BWA,Pulau Pinang,0,0,0,Botswana
10449,7/1/2020,BWA,Sabah,0,0,0,Botswana
10450,7/1/2020,BWA,Sarawak,0,0,0,Botswana
10451,7/1/2020,BWA,Selangor,0,0,0,Botswana
10452,7/1/2020,CAF,Kedah,0,0,0,Central African Republic
10453,7/1/2020,CAF,Selangor,0,0,0,Central African Republic
10454,7/1/2020,CAN,Johor,0,0,0,Canada
10455,7/1/2020,CAN,Kedah,0,0,0,Canada
10456,7/1/2020,CAN,Kelantan,0,0,0,Canada
10457,7/1/2020,CAN,Melaka,0,0,0,Canada
10458,7/1/2020,CAN,Negeri Sembilan,0,0,0,Canada
10459,7/1/2020,CAN,Pahang,0,0,0,Canada
10460,7/1/2020,CAN,Perak,0,0,0,Canada
10461,7/1/2020,CAN,Perlis,0,0,0,Canada
10462,7/1/2020,CAN,Pulau Pinang,0,0,0,Canada
10463,7/1/2020,CAN,Sabah,0,0,0,Canada
10464,7/1/2020,CAN,Sarawak,0,0,0,Canada
10465,7/1/2020,CAN,Selangor,37,27,10,Canada
10466,7/1/2020,CAN,Terengganu,0,0,0,Canada
10467,7/1/2020,CAN,W.P. Labuan,0,0,0,Canada
10468,7/1/2020,CCK,Selangor,0,0,0,Cocos (Keeling) Islands
10469,7/1/2020,CHE,Johor,0,0,0,Switzerland
10470,7/1/2020,CHE,Kedah,0,0,0,Switzerland
10471,7/1/2020,CHE,Kelantan,0,0,0,Switzerland
10472,7/1/2020,CHE,Melaka,0,0,0,Switzerland
10473,7/1/2020,CHE,Negeri Sembilan,0,0,0,Switzerland
10474,7/1/2020,CHE,Pahang,0,0,0,Switzerland
10475,7/1/2020,CHE,Perak,0,0,0,Switzerland
10476,7/1/2020,CHE,Perlis,0,0,0,Switzerland
10477,7/1/2020,CHE,Pulau Pinang,0,0,0,Switzerland
10478,7/1/2020,CHE,Sabah,0,0,0,Switzerland
10479,7/1/2020,CHE,Sarawak,0,0,0,Switzerland
10480,7/1/2020,CHE,Selangor,18,14,4,Switzerland
10481,7/1/2020,CHE,W.P. Labuan,0,0,0,Switzerland
10482,7/1/2020,CHL,Johor,0,0,0,Chile
10483,7/1/2020,CHL,Kedah,0,0,0,Chile
10484,7/1/2020,CHL,Kelantan,0,0,0,Chile
10485,7/1/2020,CHL,Melaka,0,0,0,Chile
10486,7/1/2020,CHL,Pahang,0,0,0,Chile
10487,7/1/2020,CHL,Perak,0,0,0,Chile
10488,7/1/2020,CHL,Perlis,0,0,0,Chile
10489,7/1/2020,CHL,Pulau Pinang,0,0,0,Chile
10490,7/1/2020,CHL,Sabah,0,0,0,Chile
10491,7/1/2020,CHL,Sarawak,0,0,0,Chile
10492,7/1/2020,CHL,Selangor,0,0,0,Chile
10493,7/1/2020,CHN,Johor,11,3,8,China
10494,7/1/2020,CHN,Kedah,0,0,0,China
10495,7/1/2020,CHN,Kelantan,0,0,0,China
10496,7/1/2020,CHN,Melaka,0,0,0,China
10497,7/1/2020,CHN,Pahang,0,0,0,China
10498,7/1/2020,CHN,Perak,0,0,0,China
10499,7/1/2020,CHN,Perlis,0,0,0,China
10500,7/1/2020,CHN,Pulau Pinang,0,0,0,China
10501,7/1/2020,CHN,Sabah,2,1,1,China
10502,7/1/2020,CHN,Sarawak,5,0,5,China
10503,7/1/2020,CHN,Selangor,485,326,159,China
10504,7/1/2020,CHN,Terengganu,0,0,0,China
10505,7/1/2020,CHN,W.P. Labuan,2,0,2,China
10506,7/1/2020,CIV,Johor,0,0,0,C��te d'Iv
10507,7/1/2020,CIV,Kedah,0,0,0,C��te d'Iv
10508,7/1/2020,CIV,Pulau Pinang,0,0,0,C��te d'Iv
10509,7/1/2020,CIV,Sabah,0,0,0,C��te d'Iv
10510,7/1/2020,CIV,Sarawak,0,0,0,C��te d'Iv
10511,7/1/2020,CIV,Selangor,0,0,0,C��te d'Iv
10512,7/1/2020,CMR,Johor,0,0,0,Cameroon
10513,7/1/2020,CMR,Kedah,0,0,0,Cameroon
10514,7/1/2020,CMR,Pulau Pinang,0,0,0,Cameroon
10515,7/1/2020,CMR,Sabah,0,0,0,Cameroon
10516,7/1/2020,CMR,Sarawak,0,0,0,Cameroon
10517,7/1/2020,CMR,Selangor,0,0,0,Cameroon
10518,7/1/2020,COD,Johor,0,0,0,"Congo, the Democratic Republic of the"
10519,7/1/2020,COD,Pulau Pinang,0,0,0,"Congo, the Democratic Republic of the"
10520,7/1/2020,COD,Sarawak,0,0,0,"Congo, the Democratic Republic of the"
10521,7/1/2020,COD,Selangor,0,0,0,"Congo, the Democratic Republic of the"
10522,7/1/2020,COG,Johor,0,0,0,Congo
10523,7/1/2020,COG,Kedah,0,0,0,Congo
10524,7/1/2020,COG,Selangor,0,0,0,Congo
10525,7/1/2020,COK,Selangor,0,0,0,Cook Islands
10526,7/1/2020,COL,Johor,0,0,0,Colombia
10527,7/1/2020,COL,Kedah,0,0,0,Colombia
10528,7/1/2020,COL,Perak,0,0,0,Colombia
10529,7/1/2020,COL,Pulau Pinang,0,0,0,Colombia
10530,7/1/2020,COL,Sabah,0,0,0,Colombia
10531,7/1/2020,COL,Sarawak,0,0,0,Colombia
10532,7/1/2020,COL,Selangor,3,1,2,Colombia
10533,7/1/2020,COL,W.P. Labuan,0,0,0,Colombia
10534,7/1/2020,COM,Johor,0,0,0,Comoros
10535,7/1/2020,COM,Kedah,0,0,0,Comoros
10536,7/1/2020,COM,Selangor,0,0,0,Comoros
10537,7/1/2020,CPV,Johor,0,0,0,Cape Verde
10538,7/1/2020,CPV,Kedah,0,0,0,Cape Verde
10539,7/1/2020,CPV,Pulau Pinang,0,0,0,Cape Verde
10540,7/1/2020,CPV,Sabah,0,0,0,Cape Verde
10541,7/1/2020,CPV,Selangor,0,0,0,Cape Verde
10542,7/1/2020,CRI,Johor,0,0,0,Costa Rica
10543,7/1/2020,CRI,Kedah,0,0,0,Costa Rica
10544,7/1/2020,CRI,Perak,0,0,0,Costa Rica
10545,7/1/2020,CRI,Perlis,0,0,0,Costa Rica
10546,7/1/2020,CRI,Pulau Pinang,0,0,0,Costa Rica
10547,7/1/2020,CRI,Sabah,0,0,0,Costa Rica
10548,7/1/2020,CRI,Sarawak,0,0,0,Costa Rica
10549,7/1/2020,CRI,Selangor,0,0,0,Costa Rica
10550,7/1/2020,CUB,Johor,0,0,0,Cuba
10551,7/1/2020,CUB,Kedah,0,0,0,Cuba
10552,7/1/2020,CUB,Perlis,0,0,0,Cuba
10553,7/1/2020,CUB,Pulau Pinang,0,0,0,Cuba
10554,7/1/2020,CUB,Sabah,0,0,0,Cuba
10555,7/1/2020,CUB,Sarawak,0,0,0,Cuba
10556,7/1/2020,CUB,Selangor,0,0,0,Cuba
10557,7/1/2020,CYP,Johor,0,0,0,Cyprus
10558,7/1/2020,CYP,Kedah,0,0,0,Cyprus
10559,7/1/2020,CYP,Perak,0,0,0,Cyprus
10560,7/1/2020,CYP,Perlis,0,0,0,Cyprus
10561,7/1/2020,CYP,Pulau Pinang,0,0,0,Cyprus
10562,7/1/2020,CYP,Sabah,0,0,0,Cyprus
10563,7/1/2020,CYP,Sarawak,0,0,0,Cyprus
10564,7/1/2020,CYP,Selangor,2,2,0,Cyprus
10565,7/1/2020,CZE,Johor,0,0,0,Czech Republic
10566,7/1/2020,CZE,Kedah,0,0,0,Czech Republic
10567,7/1/2020,CZE,Kelantan,0,0,0,Czech Republic
10568,7/1/2020,CZE,Melaka,0,0,0,Czech Republic
10569,7/1/2020,CZE,Negeri Sembilan,0,0,0,Czech Republic
10570,7/1/2020,CZE,Perak,0,0,0,Czech Republic
10571,7/1/2020,CZE,Perlis,0,0,0,Czech Republic
10572,7/1/2020,CZE,Pulau Pinang,0,0,0,Czech Republic
10573,7/1/2020,CZE,Sabah,0,0,0,Czech Republic
10574,7/1/2020,CZE,Sarawak,0,0,0,Czech Republic
10575,7/1/2020,CZE,Selangor,7,5,2,Czech Republic
10576,7/1/2020,CZE,W.P. Labuan,0,0,0,Czech Republic
10577,7/1/2020,DEU,Johor,0,0,0,Germany
10578,7/1/2020,DEU,Kedah,0,0,0,Germany
10579,7/1/2020,DEU,Kelantan,0,0,0,Germany
10580,7/1/2020,DEU,Melaka,0,0,0,Germany
10581,7/1/2020,DEU,Negeri Sembilan,0,0,0,Germany
10582,7/1/2020,DEU,Pahang,0,0,0,Germany
10583,7/1/2020,DEU,Perak,0,0,0,Germany
10584,7/1/2020,DEU,Perlis,0,0,0,Germany
10585,7/1/2020,DEU,Pulau Pinang,0,0,0,Germany
10586,7/1/2020,DEU,Sabah,2,0,2,Germany
10587,7/1/2020,DEU,Sarawak,0,0,0,Germany
10588,7/1/2020,DEU,Selangor,115,75,40,Germany
10589,7/1/2020,DEU,Terengganu,0,0,0,Germany
10590,7/1/2020,DEU,W.P. Labuan,0,0,0,Germany
10591,7/1/2020,DJI,Johor,0,0,0,Djibouti
10592,7/1/2020,DJI,Selangor,0,0,0,Djibouti
10593,7/1/2020,DMA,Johor,0,0,0,Dominica
10594,7/1/2020,DMA,Kedah,0,0,0,Dominica
10595,7/1/2020,DMA,Pulau Pinang,0,0,0,Dominica
10596,7/1/2020,DMA,Sabah,0,0,0,Dominica
10597,7/1/2020,DMA,Sarawak,0,0,0,Dominica
10598,7/1/2020,DMA,Selangor,0,0,0,Dominica
10599,7/1/2020,DMA,W.P. Labuan,0,0,0,Dominica
10600,7/1/2020,DNK,Johor,0,0,0,Denmark
10601,7/1/2020,DNK,Kedah,0,0,0,Denmark
10602,7/1/2020,DNK,Kelantan,0,0,0,Denmark
10603,7/1/2020,DNK,Melaka,0,0,0,Denmark
10604,7/1/2020,DNK,Negeri Sembilan,0,0,0,Denmark
10605,7/1/2020,DNK,Pahang,0,0,0,Denmark
10606,7/1/2020,DNK,Perak,0,0,0,Denmark
10607,7/1/2020,DNK,Perlis,0,0,0,Denmark
10608,7/1/2020,DNK,Pulau Pinang,0,0,0,Denmark
10609,7/1/2020,DNK,Sabah,0,0,0,Denmark
10610,7/1/2020,DNK,Sarawak,0,0,0,Denmark
10611,7/1/2020,DNK,Selangor,35,30,5,Denmark
10612,7/1/2020,DNK,W.P. Labuan,0,0,0,Denmark
10613,7/1/2020,DOM,Johor,0,0,0,Dominican Republic
10614,7/1/2020,DOM,Kedah,0,0,0,Dominican Republic
10615,7/1/2020,DOM,Perak,0,0,0,Dominican Republic
10616,7/1/2020,DOM,Perlis,0,0,0,Dominican Republic
10617,7/1/2020,DOM,Pulau Pinang,0,0,0,Dominican Republic
10618,7/1/2020,DOM,Sabah,0,0,0,Dominican Republic
10619,7/1/2020,DOM,Sarawak,0,0,0,Dominican Republic
10620,7/1/2020,DOM,Selangor,1,1,0,Dominican Republic
10621,7/1/2020,DZA,Johor,0,0,0,Algeria
10622,7/1/2020,DZA,Kedah,0,0,0,Algeria
10623,7/1/2020,DZA,Kelantan,0,0,0,Algeria
10624,7/1/2020,DZA,Melaka,0,0,0,Algeria
10625,7/1/2020,DZA,Perak,0,0,0,Algeria
10626,7/1/2020,DZA,Perlis,0,0,0,Algeria
10627,7/1/2020,DZA,Pulau Pinang,0,0,0,Algeria
10628,7/1/2020,DZA,Sabah,0,0,0,Algeria
10629,7/1/2020,DZA,Sarawak,0,0,0,Algeria
10630,7/1/2020,DZA,Selangor,4,2,2,Algeria
10631,7/1/2020,DZA,W.P. Labuan,0,0,0,Algeria
10632,7/1/2020,ECU,Johor,0,0,0,Ecuador
10633,7/1/2020,ECU,Kedah,0,0,0,Ecuador
10634,7/1/2020,ECU,Perak,0,0,0,Ecuador
10635,7/1/2020,ECU,Perlis,0,0,0,Ecuador
10636,7/1/2020,ECU,Pulau Pinang,0,0,0,Ecuador
10637,7/1/2020,ECU,Sabah,0,0,0,Ecuador
10638,7/1/2020,ECU,Sarawak,0,0,0,Ecuador
10639,7/1/2020,ECU,Selangor,1,0,1,Ecuador
10640,7/1/2020,EGY,Johor,0,0,0,Egypt
10641,7/1/2020,EGY,Kedah,0,0,0,Egypt
10642,7/1/2020,EGY,Kelantan,0,0,0,Egypt
10643,7/1/2020,EGY,Melaka,0,0,0,Egypt
10644,7/1/2020,EGY,Pahang,0,0,0,Egypt
10645,7/1/2020,EGY,Perak,0,0,0,Egypt
10646,7/1/2020,EGY,Perlis,0,0,0,Egypt
10647,7/1/2020,EGY,Pulau Pinang,0,0,0,Egypt
10648,7/1/2020,EGY,Sabah,0,0,0,Egypt
10649,7/1/2020,EGY,Sarawak,0,0,0,Egypt
10650,7/1/2020,EGY,Selangor,27,18,9,Egypt
10651,7/1/2020,EGY,Terengganu,0,0,0,Egypt
10652,7/1/2020,EGY,W.P. Labuan,0,0,0,Egypt
10653,7/1/2020,ERI,Johor,0,0,0,Eritrea
10654,7/1/2020,ERI,Pulau Pinang,0,0,0,Eritrea
10655,7/1/2020,ERI,Sabah,0,0,0,Eritrea
10656,7/1/2020,ERI,Selangor,0,0,0,Eritrea
10657,7/1/2020,ESP,Johor,0,0,0,Spain
10658,7/1/2020,ESP,Kedah,0,0,0,Spain
10659,7/1/2020,ESP,Kelantan,0,0,0,Spain
10660,7/1/2020,ESP,Melaka,0,0,0,Spain
10661,7/1/2020,ESP,Negeri Sembilan,0,0,0,Spain
10662,7/1/2020,ESP,Pahang,0,0,0,Spain
10663,7/1/2020,ESP,Perak,0,0,0,Spain
10664,7/1/2020,ESP,Perlis,0,0,0,Spain
10665,7/1/2020,ESP,Pulau Pinang,0,0,0,Spain
10666,7/1/2020,ESP,Sabah,0,0,0,Spain
10667,7/1/2020,ESP,Sarawak,0,0,0,Spain
10668,7/1/2020,ESP,Selangor,22,18,4,Spain
10669,7/1/2020,ESP,W.P. Labuan,0,0,0,Spain
10670,7/1/2020,EST,Johor,0,0,0,Estonia
10671,7/1/2020,EST,Kedah,0,0,0,Estonia
10672,7/1/2020,EST,Kelantan,0,0,0,Estonia
10673,7/1/2020,EST,Pahang,0,0,0,Estonia
10674,7/1/2020,EST,Perak,0,0,0,Estonia
10675,7/1/2020,EST,Perlis,0,0,0,Estonia
10676,7/1/2020,EST,Pulau Pinang,1,1,0,Estonia
10677,7/1/2020,EST,Sabah,0,0,0,Estonia
10678,7/1/2020,EST,Sarawak,0,0,0,Estonia
10679,7/1/2020,EST,Selangor,5,5,0,Estonia
10680,7/1/2020,EST,W.P. Labuan,0,0,0,Estonia
10681,7/1/2020,ETH,Johor,0,0,0,Ethiopia
10682,7/1/2020,ETH,Kedah,0,0,0,Ethiopia
10683,7/1/2020,ETH,Pulau Pinang,0,0,0,Ethiopia
10684,7/1/2020,ETH,Sarawak,0,0,0,Ethiopia
10685,7/1/2020,ETH,Selangor,3,3,0,Ethiopia
10686,7/1/2020,FIN,Johor,0,0,0,Finland
10687,7/1/2020,FIN,Kedah,0,0,0,Finland
10688,7/1/2020,FIN,Kelantan,0,0,0,Finland
10689,7/1/2020,FIN,Melaka,0,0,0,Finland
10690,7/1/2020,FIN,Negeri Sembilan,0,0,0,Finland
10691,7/1/2020,FIN,Pahang,0,0,0,Finland
10692,7/1/2020,FIN,Perak,0,0,0,Finland
10693,7/1/2020,FIN,Perlis,0,0,0,Finland
10694,7/1/2020,FIN,Pulau Pinang,0,0,0,Finland
10695,7/1/2020,FIN,Sabah,0,0,0,Finland
10696,7/1/2020,FIN,Sarawak,0,0,0,Finland
10697,7/1/2020,FIN,Selangor,8,6,2,Finland
10698,7/1/2020,FIN,W.P. Labuan,0,0,0,Finland
10699,7/1/2020,FJI,Johor,0,0,0,Fiji
10700,7/1/2020,FJI,Kedah,0,0,0,Fiji
10701,7/1/2020,FJI,Kelantan,0,0,0,Fiji
10702,7/1/2020,FJI,Perak,0,0,0,Fiji
10703,7/1/2020,FJI,Perlis,0,0,0,Fiji
10704,7/1/2020,FJI,Pulau Pinang,0,0,0,Fiji
10705,7/1/2020,FJI,Sabah,0,0,0,Fiji
10706,7/1/2020,FJI,Sarawak,0,0,0,Fiji
10707,7/1/2020,FJI,Selangor,0,0,0,Fiji
10708,7/1/2020,FRA,Johor,1,1,0,France
10709,7/1/2020,FRA,Kedah,1,1,0,France
10710,7/1/2020,FRA,Kelantan,0,0,0,France
10711,7/1/2020,FRA,Melaka,0,0,0,France
10712,7/1/2020,FRA,Negeri Sembilan,0,0,0,France
10713,7/1/2020,FRA,Pahang,0,0,0,France
10714,7/1/2020,FRA,Perak,0,0,0,France
10715,7/1/2020,FRA,Perlis,0,0,0,France
10716,7/1/2020,FRA,Pulau Pinang,0,0,0,France
10717,7/1/2020,FRA,Sabah,0,0,0,France
10718,7/1/2020,FRA,Sarawak,0,0,0,France
10719,7/1/2020,FRA,Selangor,62,40,22,France
10720,7/1/2020,FRA,Terengganu,0,0,0,France
10721,7/1/2020,FRA,W.P. Labuan,0,0,0,France
10722,7/1/2020,FSM,Johor,0,0,0,"Micronesia, Federated States of"
10723,7/1/2020,FSM,Pulau Pinang,0,0,0,"Micronesia, Federated States of"
10724,7/1/2020,FSM,Selangor,0,0,0,"Micronesia, Federated States of"
10725,7/1/2020,GAB,Johor,0,0,0,Gabon
10726,7/1/2020,GAB,Pulau Pinang,0,0,0,Gabon
10727,7/1/2020,GAB,Sarawak,0,0,0,Gabon
10728,7/1/2020,GAB,Selangor,0,0,0,Gabon
10729,7/1/2020,GBR,Johor,1,1,0,United Kingdom
10730,7/1/2020,GBR,Kedah,0,0,0,United Kingdom
10731,7/1/2020,GBR,Kelantan,0,0,0,United Kingdom
10732,7/1/2020,GBR,Melaka,0,0,0,United Kingdom
10733,7/1/2020,GBR,Negeri Sembilan,0,0,0,United Kingdom
10734,7/1/2020,GBR,Pahang,0,0,0,United Kingdom
10735,7/1/2020,GBR,Perak,0,0,0,United Kingdom
10736,7/1/2020,GBR,Perlis,0,0,0,United Kingdom
10737,7/1/2020,GBR,Pulau Pinang,1,1,0,United Kingdom
10738,7/1/2020,GBR,Sabah,2,2,0,United Kingdom
10739,7/1/2020,GBR,Sarawak,2,2,0,United Kingdom
10740,7/1/2020,GBR,Selangor,265,197,68,United Kingdom
10741,7/1/2020,GBR,Terengganu,0,0,0,United Kingdom
10742,7/1/2020,GBR,W.P. Labuan,0,0,0,United Kingdom
10743,7/1/2020,GEO,Johor,0,0,0,Georgia
10744,7/1/2020,GEO,Kedah,0,0,0,Georgia
10745,7/1/2020,GEO,Melaka,0,0,0,Georgia
10746,7/1/2020,GEO,Perak,0,0,0,Georgia
10747,7/1/2020,GEO,Perlis,0,0,0,Georgia
10748,7/1/2020,GEO,Pulau Pinang,0,0,0,Georgia
10749,7/1/2020,GEO,Sabah,0,0,0,Georgia
10750,7/1/2020,GEO,Sarawak,0,0,0,Georgia
10751,7/1/2020,GEO,Selangor,30,30,0,Georgia
10752,7/1/2020,GHA,Johor,0,0,0,Ghana
10753,7/1/2020,GHA,Kedah,0,0,0,Ghana
10754,7/1/2020,GHA,Kelantan,0,0,0,Ghana
10755,7/1/2020,GHA,Pulau Pinang,0,0,0,Ghana
10756,7/1/2020,GHA,Sabah,0,0,0,Ghana
10757,7/1/2020,GHA,Sarawak,0,0,0,Ghana
10758,7/1/2020,GHA,Selangor,0,0,0,Ghana
10759,7/1/2020,GIB,Johor,0,0,0,Gibraltar
10760,7/1/2020,GIB,Sarawak,0,0,0,Gibraltar
10761,7/1/2020,GIN,Johor,0,0,0,Guinea
10762,7/1/2020,GIN,Kedah,0,0,0,Guinea
10763,7/1/2020,GIN,Kelantan,0,0,0,Guinea
10764,7/1/2020,GIN,Perlis,0,0,0,Guinea
10765,7/1/2020,GIN,Pulau Pinang,0,0,0,Guinea
10766,7/1/2020,GIN,Sabah,0,0,0,Guinea
10767,7/1/2020,GIN,Sarawak,0,0,0,Guinea
10768,7/1/2020,GIN,Selangor,0,0,0,Guinea
10769,7/1/2020,GLP,Selangor,0,0,0,Guadeloupe
10770,7/1/2020,GMB,Johor,0,0,0,Gambia
10771,7/1/2020,GMB,Kedah,0,0,0,Gambia
10772,7/1/2020,GMB,Kelantan,0,0,0,Gambia
10773,7/1/2020,GMB,Pulau Pinang,0,0,0,Gambia
10774,7/1/2020,GMB,Sabah,0,0,0,Gambia
10775,7/1/2020,GMB,Sarawak,0,0,0,Gambia
10776,7/1/2020,GMB,Selangor,1,0,1,Gambia
10777,7/1/2020,GNB,Johor,0,0,0,Guinea-Bissau
10778,7/1/2020,GNB,Selangor,0,0,0,Guinea-Bissau
10779,7/1/2020,GNQ,Johor,0,0,0,Equatorial Guinea
10780,7/1/2020,GNQ,Selangor,0,0,0,Equatorial Guinea
10781,7/1/2020,GRC,Johor,4,4,0,Greece
10782,7/1/2020,GRC,Kedah,0,0,0,Greece
10783,7/1/2020,GRC,Kelantan,0,0,0,Greece
10784,7/1/2020,GRC,Melaka,0,0,0,Greece
10785,7/1/2020,GRC,Negeri Sembilan,0,0,0,Greece
10786,7/1/2020,GRC,Pahang,0,0,0,Greece
10787,7/1/2020,GRC,Perak,0,0,0,Greece
10788,7/1/2020,GRC,Perlis,0,0,0,Greece
10789,7/1/2020,GRC,Pulau Pinang,0,0,0,Greece
10790,7/1/2020,GRC,Sabah,0,0,0,Greece
10791,7/1/2020,GRC,Sarawak,0,0,0,Greece
10792,7/1/2020,GRC,Selangor,31,28,3,Greece
10793,7/1/2020,GRD,Johor,0,0,0,Grenada
10794,7/1/2020,GRD,Kedah,0,0,0,Grenada
10795,7/1/2020,GRD,Pulau Pinang,0,0,0,Grenada
10796,7/1/2020,GRD,Sabah,0,0,0,Grenada
10797,7/1/2020,GRD,Sarawak,0,0,0,Grenada
10798,7/1/2020,GRD,Selangor,0,0,0,Grenada
10799,7/1/2020,GRL,Johor,0,0,0,Greenland
10800,7/1/2020,GRL,Selangor,0,0,0,Greenland
10801,7/1/2020,GTM,Johor,0,0,0,Guatemala
10802,7/1/2020,GTM,Kedah,0,0,0,Guatemala
10803,7/1/2020,GTM,Pahang,0,0,0,Guatemala
10804,7/1/2020,GTM,Perak,0,0,0,Guatemala
10805,7/1/2020,GTM,Pulau Pinang,0,0,0,Guatemala
10806,7/1/2020,GTM,Sabah,0,0,0,Guatemala
10807,7/1/2020,GTM,Sarawak,0,0,0,Guatemala
10808,7/1/2020,GTM,Selangor,0,0,0,Guatemala
10809,7/1/2020,GTM,W.P. Labuan,0,0,0,Guatemala
10810,7/1/2020,GUY,Johor,0,0,0,Guyana
10811,7/1/2020,GUY,Kedah,0,0,0,Guyana
10812,7/1/2020,GUY,Pulau Pinang,0,0,0,Guyana
10813,7/1/2020,GUY,Sarawak,0,0,0,Guyana
10814,7/1/2020,GUY,Selangor,0,0,0,Guyana
10815,7/1/2020,HKG,Johor,0,0,0,Hong Kong
10816,7/1/2020,HKG,Kedah,0,0,0,Hong Kong
10817,7/1/2020,HKG,Kelantan,0,0,0,Hong Kong
10818,7/1/2020,HKG,Pahang,0,0,0,Hong Kong
10819,7/1/2020,HKG,Perak,0,0,0,Hong Kong
10820,7/1/2020,HKG,Perlis,0,0,0,Hong Kong
10821,7/1/2020,HKG,Pulau Pinang,0,0,0,Hong Kong
10822,7/1/2020,HKG,Sabah,0,0,0,Hong Kong
10823,7/1/2020,HKG,Sarawak,7,6,1,Hong Kong
10824,7/1/2020,HKG,Selangor,0,0,0,Hong Kong
10825,7/1/2020,HKG,Terengganu,0,0,0,Hong Kong
10826,7/1/2020,HMD,Johor,0,0,0,Heard Island and McDonald Islands
10827,7/1/2020,HND,Johor,0,0,0,Honduras
10828,7/1/2020,HND,Kedah,0,0,0,Honduras
10829,7/1/2020,HND,Perak,0,0,0,Honduras
10830,7/1/2020,HND,Pulau Pinang,0,0,0,Honduras
10831,7/1/2020,HND,Sabah,0,0,0,Honduras
10832,7/1/2020,HND,Sarawak,0,0,0,Honduras
10833,7/1/2020,HND,Selangor,2,2,0,Honduras
10834,7/1/2020,HRV,Johor,7,7,0,Croatia
10835,7/1/2020,HRV,Kedah,0,0,0,Croatia
10836,7/1/2020,HRV,Kelantan,0,0,0,Croatia
10837,7/1/2020,HRV,Melaka,0,0,0,Croatia
10838,7/1/2020,HRV,Pahang,0,0,0,Croatia
10839,7/1/2020,HRV,Perak,0,0,0,Croatia
10840,7/1/2020,HRV,Perlis,0,0,0,Croatia
10841,7/1/2020,HRV,Pulau Pinang,0,0,0,Croatia
10842,7/1/2020,HRV,Sabah,0,0,0,Croatia
10843,7/1/2020,HRV,Sarawak,0,0,0,Croatia
10844,7/1/2020,HRV,Selangor,37,37,0,Croatia
10845,7/1/2020,HTI,Johor,0,0,0,Haiti
10846,7/1/2020,HTI,Kedah,0,0,0,Haiti
10847,7/1/2020,HTI,Kelantan,0,0,0,Haiti
10848,7/1/2020,HTI,Perak,0,0,0,Haiti
10849,7/1/2020,HTI,Pulau Pinang,0,0,0,Haiti
10850,7/1/2020,HTI,Sabah,0,0,0,Haiti
10851,7/1/2020,HTI,Selangor,0,0,0,Haiti
10852,7/1/2020,HUN,Johor,1,1,0,Hungary
10853,7/1/2020,HUN,Kedah,0,0,0,Hungary
10854,7/1/2020,HUN,Kelantan,0,0,0,Hungary
10855,7/1/2020,HUN,Pahang,0,0,0,Hungary
10856,7/1/2020,HUN,Perak,0,0,0,Hungary
10857,7/1/2020,HUN,Perlis,0,0,0,Hungary
10858,7/1/2020,HUN,Pulau Pinang,0,0,0,Hungary
10859,7/1/2020,HUN,Sabah,0,0,0,Hungary
10860,7/1/2020,HUN,Sarawak,0,0,0,Hungary
10861,7/1/2020,HUN,Selangor,6,2,4,Hungary
10862,7/1/2020,HUN,W.P. Labuan,0,0,0,Hungary
10863,7/1/2020,IDN,Johor,214,163,51,Indonesia
10864,7/1/2020,IDN,Kedah,8,7,1,Indonesia
10865,7/1/2020,IDN,Kelantan,0,0,0,Indonesia
10866,7/1/2020,IDN,Melaka,0,0,0,Indonesia
10867,7/1/2020,IDN,Negeri Sembilan,0,0,0,Indonesia
10868,7/1/2020,IDN,Pahang,0,0,0,Indonesia
10869,7/1/2020,IDN,Perak,0,0,0,Indonesia
10870,7/1/2020,IDN,Perlis,1,1,0,Indonesia
10871,7/1/2020,IDN,Pulau Pinang,14,2,12,Indonesia
10872,7/1/2020,IDN,Sabah,56,20,36,Indonesia
10873,7/1/2020,IDN,Sarawak,733,687,46,Indonesia
10874,7/1/2020,IDN,Selangor,716,478,238,Indonesia
10875,7/1/2020,IDN,Terengganu,0,0,0,Indonesia
10876,7/1/2020,IDN,W.P. Labuan,0,0,0,Indonesia
10877,7/1/2020,IND,Johor,71,71,0,India
10878,7/1/2020,IND,Kedah,0,0,0,India
10879,7/1/2020,IND,Kelantan,0,0,0,India
10880,7/1/2020,IND,Melaka,0,0,0,India
10881,7/1/2020,IND,Negeri Sembilan,0,0,0,India
10882,7/1/2020,IND,Pahang,0,0,0,India
10883,7/1/2020,IND,Perak,0,0,0,India
10884,7/1/2020,IND,Perlis,0,0,0,India
10885,7/1/2020,IND,Pulau Pinang,0,0,0,India
10886,7/1/2020,IND,Sabah,0,0,0,India
10887,7/1/2020,IND,Sarawak,1,0,1,India
10888,7/1/2020,IND,Selangor,699,485,214,India
10889,7/1/2020,IND,Terengganu,0,0,0,India
10890,7/1/2020,IND,W.P. Labuan,0,0,0,India
10891,7/1/2020,IOT,Pulau Pinang,0,0,0,British Indian Ocean Territory
10892,7/1/2020,IOT,Selangor,0,0,0,British Indian Ocean Territory
10893,7/1/2020,IRL,Johor,2,2,0,Ireland
10894,7/1/2020,IRL,Kedah,0,0,0,Ireland
10895,7/1/2020,IRL,Kelantan,0,0,0,Ireland
10896,7/1/2020,IRL,Negeri Sembilan,0,0,0,Ireland
10897,7/1/2020,IRL,Pahang,0,0,0,Ireland
10898,7/1/2020,IRL,Perak,0,0,0,Ireland
10899,7/1/2020,IRL,Perlis,0,0,0,Ireland
10900,7/1/2020,IRL,Pulau Pinang,0,0,0,Ireland
10901,7/1/2020,IRL,Sabah,0,0,0,Ireland
10902,7/1/2020,IRL,Sarawak,0,0,0,Ireland
10903,7/1/2020,IRL,Selangor,14,9,5,Ireland
10904,7/1/2020,IRL,Terengganu,0,0,0,Ireland
10905,7/1/2020,IRL,W.P. Labuan,0,0,0,Ireland
10906,7/1/2020,IRN,Johor,0,0,0,Iran
10907,7/1/2020,IRN,Kedah,0,0,0,Iran
10908,7/1/2020,IRN,Kelantan,0,0,0,Iran
10909,7/1/2020,IRN,Perak,0,0,0,Iran
10910,7/1/2020,IRN,Perlis,0,0,0,Iran
10911,7/1/2020,IRN,Pulau Pinang,0,0,0,Iran
10912,7/1/2020,IRN,Sabah,0,0,0,Iran
10913,7/1/2020,IRN,Sarawak,0,0,0,Iran
10914,7/1/2020,IRN,Selangor,28,14,14,Iran
10915,7/1/2020,IRN,W.P. Labuan,0,0,0,Iran
10916,7/1/2020,IRQ,Johor,0,0,0,Iraq
10917,7/1/2020,IRQ,Kedah,0,0,0,Iraq
10918,7/1/2020,IRQ,Kelantan,0,0,0,Iraq
10919,7/1/2020,IRQ,Melaka,0,0,0,Iraq
10920,7/1/2020,IRQ,Pahang,0,0,0,Iraq
10921,7/1/2020,IRQ,Perak,0,0,0,Iraq
10922,7/1/2020,IRQ,Perlis,0,0,0,Iraq
10923,7/1/2020,IRQ,Pulau Pinang,0,0,0,Iraq
10924,7/1/2020,IRQ,Sabah,0,0,0,Iraq
10925,7/1/2020,IRQ,Sarawak,0,0,0,Iraq
10926,7/1/2020,IRQ,Selangor,7,6,1,Iraq
10927,7/1/2020,ISL,Johor,0,0,0,Iceland
10928,7/1/2020,ISL,Kedah,0,0,0,Iceland
10929,7/1/2020,ISL,Kelantan,0,0,0,Iceland
10930,7/1/2020,ISL,Perak,0,0,0,Iceland
10931,7/1/2020,ISL,Perlis,0,0,0,Iceland
10932,7/1/2020,ISL,Pulau Pinang,0,0,0,Iceland
10933,7/1/2020,ISL,Sabah,0,0,0,Iceland
10934,7/1/2020,ISL,Sarawak,0,0,0,Iceland
10935,7/1/2020,ISL,Selangor,5,5,0,Iceland
10936,7/1/2020,ISL,W.P. Labuan,0,0,0,Iceland
10937,7/1/2020,ISR,Pulau Pinang,0,0,0,Israel
10938,7/1/2020,ITA,Johor,3,3,0,Italy
10939,7/1/2020,ITA,Kedah,0,0,0,Italy
10940,7/1/2020,ITA,Kelantan,0,0,0,Italy
10941,7/1/2020,ITA,Melaka,0,0,0,Italy
10942,7/1/2020,ITA,Negeri Sembilan,0,0,0,Italy
10943,7/1/2020,ITA,Pahang,0,0,0,Italy
10944,7/1/2020,ITA,Perak,0,0,0,Italy
10945,7/1/2020,ITA,Perlis,0,0,0,Italy
10946,7/1/2020,ITA,Pulau Pinang,0,0,0,Italy
10947,7/1/2020,ITA,Sabah,0,0,0,Italy
10948,7/1/2020,ITA,Sarawak,0,0,0,Italy
10949,7/1/2020,ITA,Selangor,29,22,7,Italy
10950,7/1/2020,ITA,W.P. Labuan,0,0,0,Italy
10951,7/1/2020,JAM,Johor,0,0,0,Jamaica
10952,7/1/2020,JAM,Kedah,0,0,0,Jamaica
10953,7/1/2020,JAM,Perak,0,0,0,Jamaica
10954,7/1/2020,JAM,Pulau Pinang,0,0,0,Jamaica
10955,7/1/2020,JAM,Sabah,0,0,0,Jamaica
10956,7/1/2020,JAM,Sarawak,0,0,0,Jamaica
10957,7/1/2020,JAM,Selangor,0,0,0,Jamaica
10958,7/1/2020,JAM,W.P. Labuan,0,0,0,Jamaica
10959,7/1/2020,JOR,Johor,0,0,0,Jordan
10960,7/1/2020,JOR,Kedah,0,0,0,Jordan
10961,7/1/2020,JOR,Kelantan,0,0,0,Jordan
10962,7/1/2020,JOR,Melaka,0,0,0,Jordan
10963,7/1/2020,JOR,Perlis,0,0,0,Jordan
10964,7/1/2020,JOR,Pulau Pinang,0,0,0,Jordan
10965,7/1/2020,JOR,Sabah,0,0,0,Jordan
10966,7/1/2020,JOR,Sarawak,0,0,0,Jordan
10967,7/1/2020,JOR,Selangor,0,0,0,Jordan
10968,7/1/2020,JOR,W.P. Labuan,0,0,0,Jordan
10969,7/1/2020,JPN,Johor,0,0,0,Japan
10970,7/1/2020,JPN,Kedah,0,0,0,Japan
10971,7/1/2020,JPN,Kelantan,0,0,0,Japan
10972,7/1/2020,JPN,Melaka,0,0,0,Japan
10973,7/1/2020,JPN,Negeri Sembilan,0,0,0,Japan
10974,7/1/2020,JPN,Pahang,0,0,0,Japan
10975,7/1/2020,JPN,Perak,0,0,0,Japan
10976,7/1/2020,JPN,Perlis,0,0,0,Japan
10977,7/1/2020,JPN,Pulau Pinang,1,1,0,Japan
10978,7/1/2020,JPN,Sabah,1,0,1,Japan
10979,7/1/2020,JPN,Sarawak,1,1,0,Japan
10980,7/1/2020,JPN,Selangor,439,307,132,Japan
10981,7/1/2020,JPN,W.P. Labuan,0,0,0,Japan
10982,7/1/2020,KAZ,Johor,0,0,0,Kazakhstan
10983,7/1/2020,KAZ,Kedah,0,0,0,Kazakhstan
10984,7/1/2020,KAZ,Kelantan,0,0,0,Kazakhstan
10985,7/1/2020,KAZ,Melaka,0,0,0,Kazakhstan
10986,7/1/2020,KAZ,Perak,0,0,0,Kazakhstan
10987,7/1/2020,KAZ,Perlis,0,0,0,Kazakhstan
10988,7/1/2020,KAZ,Pulau Pinang,0,0,0,Kazakhstan
10989,7/1/2020,KAZ,Sabah,0,0,0,Kazakhstan
10990,7/1/2020,KAZ,Sarawak,0,0,0,Kazakhstan
10991,7/1/2020,KAZ,Selangor,17,10,7,Kazakhstan
10992,7/1/2020,KAZ,W.P. Labuan,0,0,0,Kazakhstan
10993,7/1/2020,KEN,Johor,0,0,0,Kenya
10994,7/1/2020,KEN,Kedah,0,0,0,Kenya
10995,7/1/2020,KEN,Kelantan,0,0,0,Kenya
10996,7/1/2020,KEN,Perak,0,0,0,Kenya
10997,7/1/2020,KEN,Perlis,0,0,0,Kenya
10998,7/1/2020,KEN,Pulau Pinang,0,0,0,Kenya
10999,7/1/2020,KEN,Sabah,0,0,0,Kenya
11000,7/1/2020,KEN,Sarawak,0,0,0,Kenya
11001,7/1/2020,KEN,Selangor,1,0,1,Kenya
11002,7/1/2020,KGZ,Johor,0,0,0,Kyrgyzstan
11003,7/1/2020,KGZ,Kedah,0,0,0,Kyrgyzstan
11004,7/1/2020,KGZ,Kelantan,0,0,0,Kyrgyzstan
11005,7/1/2020,KGZ,Perak,0,0,0,Kyrgyzstan
11006,7/1/2020,KGZ,Perlis,0,0,0,Kyrgyzstan
11007,7/1/2020,KGZ,Pulau Pinang,0,0,0,Kyrgyzstan
11008,7/1/2020,KGZ,Sabah,0,0,0,Kyrgyzstan
11009,7/1/2020,KGZ,Sarawak,0,0,0,Kyrgyzstan
11010,7/1/2020,KGZ,Selangor,4,4,0,Kyrgyzstan
11011,7/1/2020,KHM,Johor,0,0,0,Cambodia
11012,7/1/2020,KHM,Kedah,0,0,0,Cambodia
11013,7/1/2020,KHM,Kelantan,0,0,0,Cambodia
11014,7/1/2020,KHM,Melaka,0,0,0,Cambodia
11015,7/1/2020,KHM,Negeri Sembilan,0,0,0,Cambodia
11016,7/1/2020,KHM,Pahang,0,0,0,Cambodia
11017,7/1/2020,KHM,Perak,0,0,0,Cambodia
11018,7/1/2020,KHM,Perlis,0,0,0,Cambodia
11019,7/1/2020,KHM,Pulau Pinang,0,0,0,Cambodia
11020,7/1/2020,KHM,Sabah,0,0,0,Cambodia
11021,7/1/2020,KHM,Sarawak,0,0,0,Cambodia
11022,7/1/2020,KHM,Selangor,15,2,13,Cambodia
11023,7/1/2020,KHM,W.P. Labuan,0,0,0,Cambodia
11024,7/1/2020,KIR,Johor,0,0,0,Kiribati
11025,7/1/2020,KIR,Sabah,0,0,0,Kiribati
11026,7/1/2020,KIR,Selangor,0,0,0,Kiribati
11027,7/1/2020,KNA,Johor,0,0,0,Saint Kitts and Nevis
11028,7/1/2020,KNA,Kedah,0,0,0,Saint Kitts and Nevis
11029,7/1/2020,KNA,Perlis,0,0,0,Saint Kitts and Nevis
11030,7/1/2020,KNA,Pulau Pinang,0,0,0,Saint Kitts and Nevis
11031,7/1/2020,KNA,Sabah,0,0,0,Saint Kitts and Nevis
11032,7/1/2020,KNA,Selangor,0,0,0,Saint Kitts and Nevis
11033,7/1/2020,KNA,W.P. Labuan,0,0,0,Saint Kitts and Nevis
11034,7/1/2020,KOR,Johor,1,0,1,"Korea, Republic of (South Korea)"
11035,7/1/2020,KOR,Kedah,0,0,0,"Korea, Republic of (South Korea)"
11036,7/1/2020,KOR,Kelantan,0,0,0,"Korea, Republic of (South Korea)"
11037,7/1/2020,KOR,Melaka,0,0,0,"Korea, Republic of (South Korea)"
11038,7/1/2020,KOR,Negeri Sembilan,0,0,0,"Korea, Republic of (South Korea)"
11039,7/1/2020,KOR,Pahang,0,0,0,"Korea, Republic of (South Korea)"
11040,7/1/2020,KOR,Perak,0,0,0,"Korea, Republic of (South Korea)"
11041,7/1/2020,KOR,Perlis,0,0,0,"Korea, Republic of (South Korea)"
11042,7/1/2020,KOR,Pulau Pinang,2,2,0,"Korea, Republic of (South Korea)"
11043,7/1/2020,KOR,Sabah,1,0,1,"Korea, Republic of (South Korea)"
11044,7/1/2020,KOR,Sarawak,3,0,3,"Korea, Republic of (South Korea)"
11045,7/1/2020,KOR,Selangor,228,153,75,"Korea, Republic of (South Korea)"
11046,7/1/2020,KOR,Terengganu,0,0,0,"Korea, Republic of (South Korea)"
11047,7/1/2020,KOR,W.P. Labuan,0,0,0,"Korea, Republic of (South Korea)"
11048,7/1/2020,KWT,Johor,0,0,0,Kuwait
11049,7/1/2020,KWT,Kedah,0,0,0,Kuwait
11050,7/1/2020,KWT,Kelantan,0,0,0,Kuwait
11051,7/1/2020,KWT,Perak,0,0,0,Kuwait
11052,7/1/2020,KWT,Perlis,0,0,0,Kuwait
11053,7/1/2020,KWT,Pulau Pinang,0,0,0,Kuwait
11054,7/1/2020,KWT,Sabah,0,0,0,Kuwait
11055,7/1/2020,KWT,Sarawak,0,0,0,Kuwait
11056,7/1/2020,KWT,Selangor,0,0,0,Kuwait
11057,7/1/2020,KWT,W.P. Labuan,0,0,0,Kuwait
11058,7/1/2020,LAO,Johor,0,0,0,Lao People's Democratic Republic
11059,7/1/2020,LAO,Kedah,1,0,1,Lao People's Democratic Republic
11060,7/1/2020,LAO,Kelantan,0,0,0,Lao People's Democratic Republic
11061,7/1/2020,LAO,Melaka,0,0,0,Lao People's Democratic Republic
11062,7/1/2020,LAO,Perak,0,0,0,Lao People's Democratic Republic
11063,7/1/2020,LAO,Perlis,0,0,0,Lao People's Democratic Republic
11064,7/1/2020,LAO,Pulau Pinang,0,0,0,Lao People's Democratic Republic
11065,7/1/2020,LAO,Sabah,0,0,0,Lao People's Democratic Republic
11066,7/1/2020,LAO,Sarawak,0,0,0,Lao People's Democratic Republic
11067,7/1/2020,LAO,Selangor,8,0,8,Lao People's Democratic Republic
11068,7/1/2020,LAO,W.P. Labuan,0,0,0,Lao People's Democratic Republic
11069,7/1/2020,LBN,Johor,2,2,0,Lebanon
11070,7/1/2020,LBN,Kedah,0,0,0,Lebanon
11071,7/1/2020,LBN,Kelantan,0,0,0,Lebanon
11072,7/1/2020,LBN,Pahang,0,0,0,Lebanon
11073,7/1/2020,LBN,Perak,0,0,0,Lebanon
11074,7/1/2020,LBN,Perlis,0,0,0,Lebanon
11075,7/1/2020,LBN,Pulau Pinang,0,0,0,Lebanon
11076,7/1/2020,LBN,Sabah,0,0,0,Lebanon
11077,7/1/2020,LBN,Sarawak,0,0,0,Lebanon
11078,7/1/2020,LBN,Selangor,1,1,0,Lebanon
11079,7/1/2020,LBN,W.P. Labuan,0,0,0,Lebanon
11080,7/1/2020,LBR,Johor,0,0,0,Liberia
11081,7/1/2020,LBR,Kedah,0,0,0,Liberia
11082,7/1/2020,LBR,Sabah,0,0,0,Liberia
11083,7/1/2020,LBR,Sarawak,0,0,0,Liberia
11084,7/1/2020,LBR,Selangor,1,1,0,Liberia
11085,7/1/2020,LBY,Johor,0,0,0,Libyan Arab Jamahiriya
11086,7/1/2020,LBY,Kedah,0,0,0,Libyan Arab Jamahiriya
11087,7/1/2020,LBY,Perlis,0,0,0,Libyan Arab Jamahiriya
11088,7/1/2020,LBY,Pulau Pinang,0,0,0,Libyan Arab Jamahiriya
11089,7/1/2020,LBY,Sabah,0,0,0,Libyan Arab Jamahiriya
11090,7/1/2020,LBY,Sarawak,0,0,0,Libyan Arab Jamahiriya
11091,7/1/2020,LBY,Selangor,1,1,0,Libyan Arab Jamahiriya
11092,7/1/2020,LCA,Johor,0,0,0,Saint Lucia
11093,7/1/2020,LCA,Kedah,0,0,0,Saint Lucia
11094,7/1/2020,LCA,Pulau Pinang,0,0,0,Saint Lucia
11095,7/1/2020,LCA,Sarawak,0,0,0,Saint Lucia
11096,7/1/2020,LCA,Selangor,0,0,0,Saint Lucia
11097,7/1/2020,LIE,Johor,0,0,0,Liechtenstein
11098,7/1/2020,LIE,Kedah,0,0,0,Liechtenstein
11099,7/1/2020,LIE,Perlis,0,0,0,Liechtenstein
11100,7/1/2020,LIE,Pulau Pinang,0,0,0,Liechtenstein
11101,7/1/2020,LIE,Sabah,0,0,0,Liechtenstein
11102,7/1/2020,LIE,Sarawak,0,0,0,Liechtenstein
11103,7/1/2020,LIE,Selangor,0,0,0,Liechtenstein
11104,7/1/2020,LKA,Johor,3,3,0,Sri Lanka
11105,7/1/2020,LKA,Kedah,0,0,0,Sri Lanka
11106,7/1/2020,LKA,Kelantan,0,0,0,Sri Lanka
11107,7/1/2020,LKA,Melaka,0,0,0,Sri Lanka
11108,7/1/2020,LKA,Pahang,0,0,0,Sri Lanka
11109,7/1/2020,LKA,Perak,0,0,0,Sri Lanka
11110,7/1/2020,LKA,Perlis,0,0,0,Sri Lanka
11111,7/1/2020,LKA,Pulau Pinang,0,0,0,Sri Lanka
11112,7/1/2020,LKA,Sabah,1,0,1,Sri Lanka
11113,7/1/2020,LKA,Sarawak,0,0,0,Sri Lanka
11114,7/1/2020,LKA,Selangor,7,5,2,Sri Lanka
11115,7/1/2020,LKA,W.P. Labuan,0,0,0,Sri Lanka
11116,7/1/2020,LSO,Johor,0,0,0,Lesotho
11117,7/1/2020,LSO,Kedah,0,0,0,Lesotho
11118,7/1/2020,LSO,Pulau Pinang,0,0,0,Lesotho
11119,7/1/2020,LSO,Sarawak,0,0,0,Lesotho
11120,7/1/2020,LSO,Selangor,0,0,0,Lesotho
11121,7/1/2020,LTU,Johor,0,0,0,Lithuania
11122,7/1/2020,LTU,Kedah,0,0,0,Lithuania
11123,7/1/2020,LTU,Kelantan,0,0,0,Lithuania
11124,7/1/2020,LTU,Pahang,0,0,0,Lithuania
11125,7/1/2020,LTU,Perak,0,0,0,Lithuania
11126,7/1/2020,LTU,Perlis,0,0,0,Lithuania
11127,7/1/2020,LTU,Pulau Pinang,0,0,0,Lithuania
11128,7/1/2020,LTU,Sabah,0,0,0,Lithuania
11129,7/1/2020,LTU,Sarawak,0,0,0,Lithuania
11130,7/1/2020,LTU,Selangor,4,4,0,Lithuania
11131,7/1/2020,LTU,W.P. Labuan,0,0,0,Lithuania
11132,7/1/2020,LUX,Johor,0,0,0,Luxembourg
11133,7/1/2020,LUX,Kedah,0,0,0,Luxembourg
11134,7/1/2020,LUX,Kelantan,0,0,0,Luxembourg
11135,7/1/2020,LUX,Perak,0,0,0,Luxembourg
11136,7/1/2020,LUX,Perlis,0,0,0,Luxembourg
11137,7/1/2020,LUX,Pulau Pinang,0,0,0,Luxembourg
11138,7/1/2020,LUX,Sabah,0,0,0,Luxembourg
11139,7/1/2020,LUX,Sarawak,0,0,0,Luxembourg
11140,7/1/2020,LUX,Selangor,0,0,0,Luxembourg
11141,7/1/2020,LVA,Johor,0,0,0,Latvia
11142,7/1/2020,LVA,Kedah,0,0,0,Latvia
11143,7/1/2020,LVA,Kelantan,0,0,0,Latvia
11144,7/1/2020,LVA,Pahang,0,0,0,Latvia
11145,7/1/2020,LVA,Perak,0,0,0,Latvia
11146,7/1/2020,LVA,Perlis,0,0,0,Latvia
11147,7/1/2020,LVA,Pulau Pinang,0,0,0,Latvia
11148,7/1/2020,LVA,Sabah,0,0,0,Latvia
11149,7/1/2020,LVA,Sarawak,0,0,0,Latvia
11150,7/1/2020,LVA,Selangor,7,7,0,Latvia
11151,7/1/2020,LVA,W.P. Labuan,0,0,0,Latvia
11152,7/1/2020,MAC,Johor,0,0,0,Macao
11153,7/1/2020,MAC,Pahang,0,0,0,Macao
11154,7/1/2020,MAC,Perak,0,0,0,Macao
11155,7/1/2020,MAC,Selangor,0,0,0,Macao
11156,7/1/2020,MAC,W.P. Labuan,0,0,0,Macao
11157,7/1/2020,MAR,Johor,0,0,0,Morocco
11158,7/1/2020,MAR,Kedah,0,0,0,Morocco
11159,7/1/2020,MAR,Kelantan,0,0,0,Morocco
11160,7/1/2020,MAR,Melaka,0,0,0,Morocco
11161,7/1/2020,MAR,Pahang,0,0,0,Morocco
11162,7/1/2020,MAR,Perak,0,0,0,Morocco
11163,7/1/2020,MAR,Perlis,0,0,0,Morocco
11164,7/1/2020,MAR,Pulau Pinang,0,0,0,Morocco
11165,7/1/2020,MAR,Sabah,0,0,0,Morocco
11166,7/1/2020,MAR,Sarawak,1,1,0,Morocco
11167,7/1/2020,MAR,Selangor,4,2,2,Morocco
11168,7/1/2020,MAR,W.P. Labuan,0,0,0,Morocco
11169,7/1/2020,MCO,Johor,0,0,0,Monaco
11170,7/1/2020,MCO,Kedah,0,0,0,Monaco
11171,7/1/2020,MCO,Sabah,0,0,0,Monaco
11172,7/1/2020,MCO,Selangor,0,0,0,Monaco
11173,7/1/2020,MDA,Johor,0,0,0,"Moldova, Republic of"
11174,7/1/2020,MDA,Kedah,0,0,0,"Moldova, Republic of"
11175,7/1/2020,MDA,Kelantan,0,0,0,"Moldova, Republic of"
11176,7/1/2020,MDA,Negeri Sembilan,0,0,0,"Moldova, Republic of"
11177,7/1/2020,MDA,Perlis,0,0,0,"Moldova, Republic of"
11178,7/1/2020,MDA,Pulau Pinang,0,0,0,"Moldova, Republic of"
11179,7/1/2020,MDA,Sabah,0,0,0,"Moldova, Republic of"
11180,7/1/2020,MDA,Sarawak,0,0,0,"Moldova, Republic of"
11181,7/1/2020,MDA,Selangor,2,2,0,"Moldova, Republic of"
11182,7/1/2020,MDG,Johor,0,0,0,Madagascar
11183,7/1/2020,MDG,Kedah,0,0,0,Madagascar
11184,7/1/2020,MDG,Perak,0,0,0,Madagascar
11185,7/1/2020,MDG,Perlis,0,0,0,Madagascar
11186,7/1/2020,MDG,Pulau Pinang,0,0,0,Madagascar
11187,7/1/2020,MDG,Sabah,0,0,0,Madagascar
11188,7/1/2020,MDG,Sarawak,0,0,0,Madagascar
11189,7/1/2020,MDG,Selangor,3,1,2,Madagascar
11190,7/1/2020,MDV,Johor,0,0,0,Maldives
11191,7/1/2020,MDV,Kedah,0,0,0,Maldives
11192,7/1/2020,MDV,Kelantan,0,0,0,Maldives
11193,7/1/2020,MDV,Perak,0,0,0,Maldives
11194,7/1/2020,MDV,Perlis,0,0,0,Maldives
11195,7/1/2020,MDV,Pulau Pinang,0,0,0,Maldives
11196,7/1/2020,MDV,Sabah,0,0,0,Maldives
11197,7/1/2020,MDV,Sarawak,0,0,0,Maldives
11198,7/1/2020,MDV,Selangor,1,0,1,Maldives
11199,7/1/2020,MEX,Johor,0,0,0,Mexico
11200,7/1/2020,MEX,Kedah,0,0,0,Mexico
11201,7/1/2020,MEX,Kelantan,0,0,0,Mexico
11202,7/1/2020,MEX,Pahang,0,0,0,Mexico
11203,7/1/2020,MEX,Perak,0,0,0,Mexico
11204,7/1/2020,MEX,Perlis,0,0,0,Mexico
11205,7/1/2020,MEX,Pulau Pinang,0,0,0,Mexico
11206,7/1/2020,MEX,Sabah,0,0,0,Mexico
11207,7/1/2020,MEX,Sarawak,0,0,0,Mexico
11208,7/1/2020,MEX,Selangor,10,9,1,Mexico
11209,7/1/2020,MEX,W.P. Labuan,0,0,0,Mexico
11210,7/1/2020,MHL,Johor,0,0,0,Marshall Islands
11211,7/1/2020,MHL,Kedah,0,0,0,Marshall Islands
11212,7/1/2020,MHL,Perak,0,0,0,Marshall Islands
11213,7/1/2020,MHL,Pulau Pinang,0,0,0,Marshall Islands
11214,7/1/2020,MHL,Sabah,0,0,0,Marshall Islands
11215,7/1/2020,MHL,Selangor,0,0,0,Marshall Islands
11216,7/1/2020,MKD,Johor,0,0,0,"Macedonia, the former Yugoslav Republic of"
11217,7/1/2020,MKD,Kedah,0,0,0,"Macedonia, the former Yugoslav Republic of"
11218,7/1/2020,MKD,Perak,0,0,0,"Macedonia, the former Yugoslav Republic of"
11219,7/1/2020,MKD,Pulau Pinang,0,0,0,"Macedonia, the former Yugoslav Republic of"
11220,7/1/2020,MKD,Sabah,0,0,0,"Macedonia, the former Yugoslav Republic of"
11221,7/1/2020,MKD,Sarawak,0,0,0,"Macedonia, the former Yugoslav Republic of"
11222,7/1/2020,MKD,Selangor,0,0,0,"Macedonia, the former Yugoslav Republic of"
11223,7/1/2020,MLI,Johor,0,0,0,Mali
11224,7/1/2020,MLI,Sabah,0,0,0,Mali
11225,7/1/2020,MLI,Selangor,0,0,0,Mali
11226,7/1/2020,MLT,Johor,0,0,0,Malta
11227,7/1/2020,MLT,Kedah,0,0,0,Malta
11228,7/1/2020,MLT,Kelantan,0,0,0,Malta
11229,7/1/2020,MLT,Perak,0,0,0,Malta
11230,7/1/2020,MLT,Perlis,0,0,0,Malta
11231,7/1/2020,MLT,Pulau Pinang,0,0,0,Malta
11232,7/1/2020,MLT,Sabah,0,0,0,Malta
11233,7/1/2020,MLT,Sarawak,0,0,0,Malta
11234,7/1/2020,MLT,Selangor,0,0,0,Malta
11235,7/1/2020,MLT,W.P. Labuan,0,0,0,Malta
11236,7/1/2020,MMR,Johor,0,0,0,Myanmar
11237,7/1/2020,MMR,Kedah,0,0,0,Myanmar
11238,7/1/2020,MMR,Kelantan,0,0,0,Myanmar
11239,7/1/2020,MMR,Negeri Sembilan,0,0,0,Myanmar
11240,7/1/2020,MMR,Pahang,0,0,0,Myanmar
11241,7/1/2020,MMR,Perak,0,0,0,Myanmar
11242,7/1/2020,MMR,Perlis,0,0,0,Myanmar
11243,7/1/2020,MMR,Pulau Pinang,0,0,0,Myanmar
11244,7/1/2020,MMR,Sabah,0,0,0,Myanmar
11245,7/1/2020,MMR,Sarawak,0,0,0,Myanmar
11246,7/1/2020,MMR,Selangor,13,4,9,Myanmar
11247,7/1/2020,MMR,Terengganu,0,0,0,Myanmar
11248,7/1/2020,MMR,W.P. Labuan,0,0,0,Myanmar
11249,7/1/2020,MNE,Johor,4,4,0,Montenegro
11250,7/1/2020,MNE,Kedah,0,0,0,Montenegro
11251,7/1/2020,MNE,Pulau Pinang,0,0,0,Montenegro
11252,7/1/2020,MNE,Sabah,0,0,0,Montenegro
11253,7/1/2020,MNE,Sarawak,0,0,0,Montenegro
11254,7/1/2020,MNE,Selangor,6,6,0,Montenegro
11255,7/1/2020,MNG,Johor,0,0,0,Mongolia
11256,7/1/2020,MNG,Kedah,0,0,0,Mongolia
11257,7/1/2020,MNG,Kelantan,0,0,0,Mongolia
11258,7/1/2020,MNG,Perak,0,0,0,Mongolia
11259,7/1/2020,MNG,Perlis,0,0,0,Mongolia
11260,7/1/2020,MNG,Pulau Pinang,0,0,0,Mongolia
11261,7/1/2020,MNG,Sabah,0,0,0,Mongolia
11262,7/1/2020,MNG,Sarawak,0,0,0,Mongolia
11263,7/1/2020,MNG,Selangor,0,0,0,Mongolia
11264,7/1/2020,MNP,Selangor,0,0,0,Northern Mariana Islands
11265,7/1/2020,MOZ,Johor,0,0,0,Mozambique
11266,7/1/2020,MOZ,Kedah,0,0,0,Mozambique
11267,7/1/2020,MOZ,Perak,0,0,0,Mozambique
11268,7/1/2020,MOZ,Pulau Pinang,0,0,0,Mozambique
11269,7/1/2020,MOZ,Sabah,0,0,0,Mozambique
11270,7/1/2020,MOZ,Sarawak,0,0,0,Mozambique
11271,7/1/2020,MOZ,Selangor,0,0,0,Mozambique
11272,7/1/2020,MRT,Johor,0,0,0,Mauritania
11273,7/1/2020,MRT,Kedah,0,0,0,Mauritania
11274,7/1/2020,MRT,Pulau Pinang,0,0,0,Mauritania
11275,7/1/2020,MRT,Sabah,0,0,0,Mauritania
11276,7/1/2020,MRT,Sarawak,0,0,0,Mauritania
11277,7/1/2020,MRT,Selangor,0,0,0,Mauritania
11278,7/1/2020,MUS,Johor,0,0,0,Mauritius
11279,7/1/2020,MUS,Kedah,0,0,0,Mauritius
11280,7/1/2020,MUS,Kelantan,0,0,0,Mauritius
11281,7/1/2020,MUS,Pahang,0,0,0,Mauritius
11282,7/1/2020,MUS,Perak,0,0,0,Mauritius
11283,7/1/2020,MUS,Perlis,0,0,0,Mauritius
11284,7/1/2020,MUS,Pulau Pinang,0,0,0,Mauritius
11285,7/1/2020,MUS,Sabah,0,0,0,Mauritius
11286,7/1/2020,MUS,Sarawak,0,0,0,Mauritius
11287,7/1/2020,MUS,Selangor,1,1,0,Mauritius
11288,7/1/2020,MWI,Johor,0,0,0,Malawi
11289,7/1/2020,MWI,Pulau Pinang,0,0,0,Malawi
11290,7/1/2020,MWI,Sabah,0,0,0,Malawi
11291,7/1/2020,MWI,Sarawak,0,0,0,Malawi
11292,7/1/2020,MWI,Selangor,0,0,0,Malawi
11293,7/1/2020,MYT,Selangor,0,0,0,Mayotte
11294,7/1/2020,NAM,Johor,0,0,0,Namibia
11295,7/1/2020,NAM,Kedah,0,0,0,Namibia
11296,7/1/2020,NAM,Perak,0,0,0,Namibia
11297,7/1/2020,NAM,Perlis,0,0,0,Namibia
11298,7/1/2020,NAM,Pulau Pinang,0,0,0,Namibia
11299,7/1/2020,NAM,Sabah,0,0,0,Namibia
11300,7/1/2020,NAM,Sarawak,0,0,0,Namibia
11301,7/1/2020,NAM,Selangor,0,0,0,Namibia
11302,7/1/2020,NCL,Selangor,0,0,0,New Caledonia
11303,7/1/2020,NER,Johor,0,0,0,Niger
11304,7/1/2020,NER,Sabah,0,0,0,Niger
11305,7/1/2020,NER,Selangor,0,0,0,Niger
11306,7/1/2020,NGA,Johor,0,0,0,Nigeria
11307,7/1/2020,NGA,Kedah,0,0,0,Nigeria
11308,7/1/2020,NGA,Perlis,0,0,0,Nigeria
11309,7/1/2020,NGA,Pulau Pinang,0,0,0,Nigeria
11310,7/1/2020,NGA,Sabah,0,0,0,Nigeria
11311,7/1/2020,NGA,Sarawak,1,1,0,Nigeria
11312,7/1/2020,NGA,Selangor,18,14,4,Nigeria
11313,7/1/2020,NIC,Johor,0,0,0,Nicaragua
11314,7/1/2020,NIC,Kedah,0,0,0,Nicaragua
11315,7/1/2020,NIC,Pulau Pinang,0,0,0,Nicaragua
11316,7/1/2020,NIC,Sabah,0,0,0,Nicaragua
11317,7/1/2020,NIC,Selangor,0,0,0,Nicaragua
11318,7/1/2020,NLD,Johor,0,0,0,Netherlands
11319,7/1/2020,NLD,Kedah,0,0,0,Netherlands
11320,7/1/2020,NLD,Kelantan,0,0,0,Netherlands
11321,7/1/2020,NLD,Melaka,0,0,0,Netherlands
11322,7/1/2020,NLD,Negeri Sembilan,0,0,0,Netherlands
11323,7/1/2020,NLD,Pahang,0,0,0,Netherlands
11324,7/1/2020,NLD,Perak,0,0,0,Netherlands
11325,7/1/2020,NLD,Perlis,0,0,0,Netherlands
11326,7/1/2020,NLD,Pulau Pinang,0,0,0,Netherlands
11327,7/1/2020,NLD,Sabah,0,0,0,Netherlands
11328,7/1/2020,NLD,Sarawak,0,0,0,Netherlands
11329,7/1/2020,NLD,Selangor,63,49,14,Netherlands
11330,7/1/2020,NLD,Terengganu,0,0,0,Netherlands
11331,7/1/2020,NLD,W.P. Labuan,0,0,0,Netherlands
11332,7/1/2020,NOR,Johor,0,0,0,Norway
11333,7/1/2020,NOR,Kedah,0,0,0,Norway
11334,7/1/2020,NOR,Kelantan,0,0,0,Norway
11335,7/1/2020,NOR,Melaka,0,0,0,Norway
11336,7/1/2020,NOR,Pahang,0,0,0,Norway
11337,7/1/2020,NOR,Perak,0,0,0,Norway
11338,7/1/2020,NOR,Perlis,0,0,0,Norway
11339,7/1/2020,NOR,Pulau Pinang,0,0,0,Norway
11340,7/1/2020,NOR,Sabah,0,0,0,Norway
11341,7/1/2020,NOR,Sarawak,0,0,0,Norway
11342,7/1/2020,NOR,Selangor,15,12,3,Norway
11343,7/1/2020,NOR,W.P. Labuan,0,0,0,Norway
11344,7/1/2020,NPL,Johor,0,0,0,Nepal
11345,7/1/2020,NPL,Kedah,0,0,0,Nepal
11346,7/1/2020,NPL,Pahang,0,0,0,Nepal
11347,7/1/2020,NPL,Perak,0,0,0,Nepal
11348,7/1/2020,NPL,Perlis,0,0,0,Nepal
11349,7/1/2020,NPL,Pulau Pinang,0,0,0,Nepal
11350,7/1/2020,NPL,Sabah,0,0,0,Nepal
11351,7/1/2020,NPL,Sarawak,0,0,0,Nepal
11352,7/1/2020,NPL,Selangor,8,8,0,Nepal
11353,7/1/2020,NPL,W.P. Labuan,0,0,0,Nepal
11354,7/1/2020,NRU,Johor,0,0,0,Nauru
11355,7/1/2020,NRU,Pulau Pinang,0,0,0,Nauru
11356,7/1/2020,NRU,Selangor,0,0,0,Nauru
11357,7/1/2020,NZL,Johor,0,0,0,New Zealand
11358,7/1/2020,NZL,Kedah,3,2,1,New Zealand
11359,7/1/2020,NZL,Kelantan,0,0,0,New Zealand
11360,7/1/2020,NZL,Melaka,0,0,0,New Zealand
11361,7/1/2020,NZL,Negeri Sembilan,0,0,0,New Zealand
11362,7/1/2020,NZL,Pahang,0,0,0,New Zealand
11363,7/1/2020,NZL,Perak,0,0,0,New Zealand
11364,7/1/2020,NZL,Perlis,0,0,0,New Zealand
11365,7/1/2020,NZL,Pulau Pinang,0,0,0,New Zealand
11366,7/1/2020,NZL,Sabah,0,0,0,New Zealand
11367,7/1/2020,NZL,Sarawak,0,0,0,New Zealand
11368,7/1/2020,NZL,Selangor,30,18,12,New Zealand
11369,7/1/2020,NZL,Terengganu,0,0,0,New Zealand
11370,7/1/2020,NZL,W.P. Labuan,0,0,0,New Zealand
11371,7/1/2020,OMN,Johor,0,0,0,Oman
11372,7/1/2020,OMN,Kedah,0,0,0,Oman
11373,7/1/2020,OMN,Kelantan,0,0,0,Oman
11374,7/1/2020,OMN,Melaka,0,0,0,Oman
11375,7/1/2020,OMN,Perak,0,0,0,Oman
11376,7/1/2020,OMN,Perlis,0,0,0,Oman
11377,7/1/2020,OMN,Pulau Pinang,0,0,0,Oman
11378,7/1/2020,OMN,Sabah,0,0,0,Oman
11379,7/1/2020,OMN,Sarawak,0,0,0,Oman
11380,7/1/2020,OMN,Selangor,1,1,0,Oman
11381,7/1/2020,PAK,Johor,3,3,0,Pakistan
11382,7/1/2020,PAK,Kedah,0,0,0,Pakistan
11383,7/1/2020,PAK,Kelantan,0,0,0,Pakistan
11384,7/1/2020,PAK,Melaka,0,0,0,Pakistan
11385,7/1/2020,PAK,Negeri Sembilan,0,0,0,Pakistan
11386,7/1/2020,PAK,Pahang,0,0,0,Pakistan
11387,7/1/2020,PAK,Perak,0,0,0,Pakistan
11388,7/1/2020,PAK,Perlis,1,1,0,Pakistan
11389,7/1/2020,PAK,Pulau Pinang,0,0,0,Pakistan
11390,7/1/2020,PAK,Sabah,1,1,0,Pakistan
11391,7/1/2020,PAK,Sarawak,1,1,0,Pakistan
11392,7/1/2020,PAK,Selangor,282,228,54,Pakistan
11393,7/1/2020,PAK,W.P. Labuan,0,0,0,Pakistan
11394,7/1/2020,PAN,Johor,0,0,0,Panama
11395,7/1/2020,PAN,Kedah,0,0,0,Panama
11396,7/1/2020,PAN,Perak,0,0,0,Panama
11397,7/1/2020,PAN,Perlis,0,0,0,Panama
11398,7/1/2020,PAN,Pulau Pinang,0,0,0,Panama
11399,7/1/2020,PAN,Sabah,0,0,0,Panama
11400,7/1/2020,PAN,Sarawak,0,0,0,Panama
11401,7/1/2020,PAN,Selangor,1,1,0,Panama
11402,7/1/2020,PER,Johor,0,0,0,Peru
11403,7/1/2020,PER,Kedah,0,0,0,Peru
11404,7/1/2020,PER,Kelantan,0,0,0,Peru
11405,7/1/2020,PER,Pahang,0,0,0,Peru
11406,7/1/2020,PER,Perak,0,0,0,Peru
11407,7/1/2020,PER,Perlis,0,0,0,Peru
11408,7/1/2020,PER,Pulau Pinang,0,0,0,Peru
11409,7/1/2020,PER,Sabah,0,0,0,Peru
11410,7/1/2020,PER,Sarawak,0,0,0,Peru
11411,7/1/2020,PER,Selangor,3,3,0,Peru
11412,7/1/2020,PER,W.P. Labuan,0,0,0,Peru
11413,7/1/2020,PHL,Johor,69,69,0,Philippines
11414,7/1/2020,PHL,Kedah,1,0,1,Philippines
11415,7/1/2020,PHL,Kelantan,0,0,0,Philippines
11416,7/1/2020,PHL,Melaka,0,0,0,Philippines
11417,7/1/2020,PHL,Negeri Sembilan,0,0,0,Philippines
11418,7/1/2020,PHL,Pahang,0,0,0,Philippines
11419,7/1/2020,PHL,Perak,0,0,0,Philippines
11420,7/1/2020,PHL,Perlis,0,0,0,Philippines
11421,7/1/2020,PHL,Pulau Pinang,0,0,0,Philippines
11422,7/1/2020,PHL,Sabah,24,3,21,Philippines
11423,7/1/2020,PHL,Sarawak,73,70,3,Philippines
11424,7/1/2020,PHL,Selangor,255,212,43,Philippines
11425,7/1/2020,PHL,Terengganu,0,0,0,Philippines
11426,7/1/2020,PHL,W.P. Labuan,7,7,0,Philippines
11427,7/1/2020,PLW,Johor,0,0,0,Palau
11428,7/1/2020,PLW,Pulau Pinang,0,0,0,Palau
11429,7/1/2020,PLW,Selangor,0,0,0,Palau
11430,7/1/2020,PNG,Johor,0,0,0,Papua New Guinea
11431,7/1/2020,PNG,Kedah,0,0,0,Papua New Guinea
11432,7/1/2020,PNG,Kelantan,0,0,0,Papua New Guinea
11433,7/1/2020,PNG,Perak,0,0,0,Papua New Guinea
11434,7/1/2020,PNG,Pulau Pinang,0,0,0,Papua New Guinea
11435,7/1/2020,PNG,Sabah,0,0,0,Papua New Guinea
11436,7/1/2020,PNG,Sarawak,0,0,0,Papua New Guinea
11437,7/1/2020,PNG,Selangor,0,0,0,Papua New Guinea
11438,7/1/2020,POL,Johor,1,1,0,Poland
11439,7/1/2020,POL,Kedah,0,0,0,Poland
11440,7/1/2020,POL,Kelantan,0,0,0,Poland
11441,7/1/2020,POL,Melaka,0,0,0,Poland
11442,7/1/2020,POL,Negeri Sembilan,0,0,0,Poland
11443,7/1/2020,POL,Pahang,0,0,0,Poland
11444,7/1/2020,POL,Perak,0,0,0,Poland
11445,7/1/2020,POL,Perlis,0,0,0,Poland
11446,7/1/2020,POL,Pulau Pinang,0,0,0,Poland
11447,7/1/2020,POL,Sabah,0,0,0,Poland
11448,7/1/2020,POL,Sarawak,0,0,0,Poland
11449,7/1/2020,POL,Selangor,18,15,3,Poland
11450,7/1/2020,POL,Terengganu,0,0,0,Poland
11451,7/1/2020,POL,W.P. Labuan,0,0,0,Poland
11452,7/1/2020,PRK,Selangor,0,0,0,"Korea, Democratic People's Republic of"
11453,7/1/2020,PRT,Johor,0,0,0,Portugal
11454,7/1/2020,PRT,Kedah,0,0,0,Portugal
11455,7/1/2020,PRT,Kelantan,0,0,0,Portugal
11456,7/1/2020,PRT,Melaka,0,0,0,Portugal
11457,7/1/2020,PRT,Pahang,0,0,0,Portugal
11458,7/1/2020,PRT,Perak,0,0,0,Portugal
11459,7/1/2020,PRT,Perlis,0,0,0,Portugal
11460,7/1/2020,PRT,Pulau Pinang,0,0,0,Portugal
11461,7/1/2020,PRT,Sabah,0,0,0,Portugal
11462,7/1/2020,PRT,Sarawak,0,0,0,Portugal
11463,7/1/2020,PRT,Selangor,2,2,0,Portugal
11464,7/1/2020,PRT,W.P. Labuan,0,0,0,Portugal
11465,7/1/2020,PRY,Johor,0,0,0,Paraguay
11466,7/1/2020,PRY,Kedah,0,0,0,Paraguay
11467,7/1/2020,PRY,Perak,0,0,0,Paraguay
11468,7/1/2020,PRY,Perlis,0,0,0,Paraguay
11469,7/1/2020,PRY,Pulau Pinang,0,0,0,Paraguay
11470,7/1/2020,PRY,Sabah,0,0,0,Paraguay
11471,7/1/2020,PRY,Sarawak,0,0,0,Paraguay
11472,7/1/2020,PRY,Selangor,0,0,0,Paraguay
11473,7/1/2020,PSE,Johor,0,0,0,"Palestinian Territory, Occupied"
11474,7/1/2020,PSE,Kedah,0,0,0,"Palestinian Territory, Occupied"
11475,7/1/2020,PSE,Kelantan,0,0,0,"Palestinian Territory, Occupied"
11476,7/1/2020,PSE,Melaka,0,0,0,"Palestinian Territory, Occupied"
11477,7/1/2020,PSE,Perak,0,0,0,"Palestinian Territory, Occupied"
11478,7/1/2020,PSE,Perlis,0,0,0,"Palestinian Territory, Occupied"
11479,7/1/2020,PSE,Pulau Pinang,0,0,0,"Palestinian Territory, Occupied"
11480,7/1/2020,PSE,Sabah,0,0,0,"Palestinian Territory, Occupied"
11481,7/1/2020,PSE,Sarawak,0,0,0,"Palestinian Territory, Occupied"
11482,7/1/2020,PSE,Selangor,0,0,0,"Palestinian Territory, Occupied"
11483,7/1/2020,QAT,Johor,0,0,0,Qatar
11484,7/1/2020,QAT,Kedah,0,0,0,Qatar
11485,7/1/2020,QAT,Perlis,0,0,0,Qatar
11486,7/1/2020,QAT,Pulau Pinang,0,0,0,Qatar
11487,7/1/2020,QAT,Sabah,0,0,0,Qatar
11488,7/1/2020,QAT,Sarawak,0,0,0,Qatar
11489,7/1/2020,QAT,Selangor,0,0,0,Qatar
11490,7/1/2020,REU,Johor,0,0,0,Reunion
11491,7/1/2020,REU,Sarawak,0,0,0,Reunion
11492,7/1/2020,ROU,Johor,5,5,0,Romania
11493,7/1/2020,ROU,Kedah,0,0,0,Romania
11494,7/1/2020,ROU,Kelantan,0,0,0,Romania
11495,7/1/2020,ROU,Negeri Sembilan,0,0,0,Romania
11496,7/1/2020,ROU,Pahang,0,0,0,Romania
11497,7/1/2020,ROU,Perak,0,0,0,Romania
11498,7/1/2020,ROU,Perlis,0,0,0,Romania
11499,7/1/2020,ROU,Pulau Pinang,0,0,0,Romania
11500,7/1/2020,ROU,Sabah,0,0,0,Romania
11501,7/1/2020,ROU,Sarawak,0,0,0,Romania
11502,7/1/2020,ROU,Selangor,25,21,4,Romania
11503,7/1/2020,ROU,W.P. Labuan,0,0,0,Romania
11504,7/1/2020,RUS,Johor,50,49,1,Russia
11505,7/1/2020,RUS,Kedah,0,0,0,Russia
11506,7/1/2020,RUS,Kelantan,0,0,0,Russia
11507,7/1/2020,RUS,Melaka,0,0,0,Russia
11508,7/1/2020,RUS,Negeri Sembilan,0,0,0,Russia
11509,7/1/2020,RUS,Pahang,0,0,0,Russia
11510,7/1/2020,RUS,Perak,0,0,0,Russia
11511,7/1/2020,RUS,Perlis,0,0,0,Russia
11512,7/1/2020,RUS,Pulau Pinang,0,0,0,Russia
11513,7/1/2020,RUS,Sabah,0,0,0,Russia
11514,7/1/2020,RUS,Sarawak,2,0,2,Russia
11515,7/1/2020,RUS,Selangor,135,130,5,Russia
11516,7/1/2020,RUS,W.P. Labuan,0,0,0,Russia
11517,7/1/2020,RWA,Johor,0,0,0,Rwanda
11518,7/1/2020,RWA,Kedah,0,0,0,Rwanda
11519,7/1/2020,RWA,Pulau Pinang,0,0,0,Rwanda
11520,7/1/2020,RWA,Selangor,0,0,0,Rwanda
11521,7/1/2020,SAU,Johor,0,0,0,Saudi Arabia
11522,7/1/2020,SAU,Kedah,0,0,0,Saudi Arabia
11523,7/1/2020,SAU,Kelantan,0,0,0,Saudi Arabia
11524,7/1/2020,SAU,Melaka,0,0,0,Saudi Arabia
11525,7/1/2020,SAU,Perak,0,0,0,Saudi Arabia
11526,7/1/2020,SAU,Perlis,0,0,0,Saudi Arabia
11527,7/1/2020,SAU,Pulau Pinang,0,0,0,Saudi Arabia
11528,7/1/2020,SAU,Sabah,0,0,0,Saudi Arabia
11529,7/1/2020,SAU,Sarawak,0,0,0,Saudi Arabia
11530,7/1/2020,SAU,Selangor,12,6,6,Saudi Arabia
11531,7/1/2020,SAU,W.P. Labuan,0,0,0,Saudi Arabia
11532,7/1/2020,SDN,Johor,0,0,0,Sudan
11533,7/1/2020,SDN,Kedah,0,0,0,Sudan
11534,7/1/2020,SDN,Kelantan,0,0,0,Sudan
11535,7/1/2020,SDN,Perlis,0,0,0,Sudan
11536,7/1/2020,SDN,Pulau Pinang,0,0,0,Sudan
11537,7/1/2020,SDN,Sabah,0,0,0,Sudan
11538,7/1/2020,SDN,Sarawak,0,0,0,Sudan
11539,7/1/2020,SDN,Selangor,2,2,0,Sudan
11540,7/1/2020,SDN,W.P. Labuan,0,0,0,Sudan
11541,7/1/2020,SEN,Johor,0,0,0,Senegal
11542,7/1/2020,SEN,Kedah,0,0,0,Senegal
11543,7/1/2020,SEN,Kelantan,0,0,0,Senegal
11544,7/1/2020,SEN,Perak,0,0,0,Senegal
11545,7/1/2020,SEN,Perlis,0,0,0,Senegal
11546,7/1/2020,SEN,Pulau Pinang,0,0,0,Senegal
11547,7/1/2020,SEN,Sabah,0,0,0,Senegal
11548,7/1/2020,SEN,Sarawak,0,0,0,Senegal
11549,7/1/2020,SEN,Selangor,2,1,1,Senegal
11550,7/1/2020,SGP,Johor,226,164,62,Singapore
11551,7/1/2020,SGP,Kedah,1,1,0,Singapore
11552,7/1/2020,SGP,Kelantan,0,0,0,Singapore
11553,7/1/2020,SGP,Melaka,0,0,0,Singapore
11554,7/1/2020,SGP,Negeri Sembilan,0,0,0,Singapore
11555,7/1/2020,SGP,Pahang,0,0,0,Singapore
11556,7/1/2020,SGP,Perak,3,1,2,Singapore
11557,7/1/2020,SGP,Perlis,0,0,0,Singapore
11558,7/1/2020,SGP,Pulau Pinang,5,3,2,Singapore
11559,7/1/2020,SGP,Sabah,2,1,1,Singapore
11560,7/1/2020,SGP,Sarawak,6,3,3,Singapore
11561,7/1/2020,SGP,Selangor,107,67,40,Singapore
11562,7/1/2020,SGP,Terengganu,0,0,0,Singapore
11563,7/1/2020,SGP,W.P. Labuan,0,0,0,Singapore
11564,7/1/2020,SGS,Johor,0,0,0,South Georgia and the South Sandwich Islands
11565,7/1/2020,SGS,Sabah,0,0,0,South Georgia and the South Sandwich Islands
11566,7/1/2020,SGS,Selangor,0,0,0,South Georgia and the South Sandwich Islands
11567,7/1/2020,SHN,Sarawak,0,0,0,"Saint Helena, Ascension and Tristan da Cunha"
11568,7/1/2020,SLB,Johor,0,0,0,Solomon Islands
11569,7/1/2020,SLB,Perlis,0,0,0,Solomon Islands
11570,7/1/2020,SLB,Pulau Pinang,0,0,0,Solomon Islands
11571,7/1/2020,SLB,Sabah,0,0,0,Solomon Islands
11572,7/1/2020,SLB,Sarawak,0,0,0,Solomon Islands
11573,7/1/2020,SLB,Selangor,0,0,0,Solomon Islands
11574,7/1/2020,SLB,W.P. Labuan,0,0,0,Solomon Islands
11575,7/1/2020,SLE,Johor,0,0,0,Sierra Leone
11576,7/1/2020,SLE,Kedah,0,0,0,Sierra Leone
11577,7/1/2020,SLE,Perak,0,0,0,Sierra Leone
11578,7/1/2020,SLE,Pulau Pinang,0,0,0,Sierra Leone
11579,7/1/2020,SLE,Sabah,0,0,0,Sierra Leone
11580,7/1/2020,SLE,Selangor,0,0,0,Sierra Leone
11581,7/1/2020,SLV,Johor,0,0,0,El Salvador
11582,7/1/2020,SLV,Kedah,0,0,0,El Salvador
11583,7/1/2020,SLV,Perak,0,0,0,El Salvador
11584,7/1/2020,SLV,Perlis,0,0,0,El Salvador
11585,7/1/2020,SLV,Pulau Pinang,0,0,0,El Salvador
11586,7/1/2020,SLV,Sabah,0,0,0,El Salvador
11587,7/1/2020,SLV,Selangor,0,0,0,El Salvador
11588,7/1/2020,SLV,W.P. Labuan,0,0,0,El Salvador
11589,7/1/2020,SMR,Johor,0,0,0,San Marino
11590,7/1/2020,SMR,Selangor,0,0,0,San Marino
11591,7/1/2020,SOM,Johor,0,0,0,Somalia
11592,7/1/2020,SOM,Kedah,0,0,0,Somalia
11593,7/1/2020,SOM,Kelantan,0,0,0,Somalia
11594,7/1/2020,SOM,Perlis,0,0,0,Somalia
11595,7/1/2020,SOM,Sabah,0,0,0,Somalia
11596,7/1/2020,SOM,Sarawak,0,0,0,Somalia
11597,7/1/2020,SOM,Selangor,0,0,0,Somalia
11598,7/1/2020,SRB,Johor,0,0,0,Serbia
11599,7/1/2020,SRB,Kedah,0,0,0,Serbia
11600,7/1/2020,SRB,Kelantan,0,0,0,Serbia
11601,7/1/2020,SRB,Pahang,0,0,0,Serbia
11602,7/1/2020,SRB,Perak,0,0,0,Serbia
11603,7/1/2020,SRB,Perlis,0,0,0,Serbia
11604,7/1/2020,SRB,Pulau Pinang,0,0,0,Serbia
11605,7/1/2020,SRB,Sabah,0,0,0,Serbia
11606,7/1/2020,SRB,Sarawak,0,0,0,Serbia
11607,7/1/2020,SRB,Selangor,1,0,1,Serbia
11608,7/1/2020,STP,Selangor,0,0,0,Sao Tome and Principe
11609,7/1/2020,SUR,Johor,0,0,0,Suriname
11610,7/1/2020,SUR,Kedah,0,0,0,Suriname
11611,7/1/2020,SUR,Kelantan,0,0,0,Suriname
11612,7/1/2020,SUR,Perak,0,0,0,Suriname
11613,7/1/2020,SUR,Perlis,0,0,0,Suriname
11614,7/1/2020,SUR,Pulau Pinang,0,0,0,Suriname
11615,7/1/2020,SUR,Sabah,0,0,0,Suriname
11616,7/1/2020,SUR,Sarawak,0,0,0,Suriname
11617,7/1/2020,SUR,Selangor,0,0,0,Suriname
11618,7/1/2020,SVK,Johor,0,0,0,Slovakia
11619,7/1/2020,SVK,Kedah,0,0,0,Slovakia
11620,7/1/2020,SVK,Kelantan,0,0,0,Slovakia
11621,7/1/2020,SVK,Negeri Sembilan,0,0,0,Slovakia
11622,7/1/2020,SVK,Pahang,0,0,0,Slovakia
11623,7/1/2020,SVK,Perak,0,0,0,Slovakia
11624,7/1/2020,SVK,Perlis,0,0,0,Slovakia
11625,7/1/2020,SVK,Pulau Pinang,0,0,0,Slovakia
11626,7/1/2020,SVK,Sabah,0,0,0,Slovakia
11627,7/1/2020,SVK,Sarawak,0,0,0,Slovakia
11628,7/1/2020,SVK,Selangor,7,7,0,Slovakia
11629,7/1/2020,SVK,W.P. Labuan,0,0,0,Slovakia
11630,7/1/2020,SVN,Johor,0,0,0,Slovenia
11631,7/1/2020,SVN,Kedah,0,0,0,Slovenia
11632,7/1/2020,SVN,Kelantan,0,0,0,Slovenia
11633,7/1/2020,SVN,Perak,0,0,0,Slovenia
11634,7/1/2020,SVN,Perlis,0,0,0,Slovenia
11635,7/1/2020,SVN,Pulau Pinang,0,0,0,Slovenia
11636,7/1/2020,SVN,Sabah,0,0,0,Slovenia
11637,7/1/2020,SVN,Sarawak,0,0,0,Slovenia
11638,7/1/2020,SVN,Selangor,2,0,2,Slovenia
11639,7/1/2020,SVN,W.P. Labuan,0,0,0,Slovenia
11640,7/1/2020,SWE,Johor,0,0,0,Sweden
11641,7/1/2020,SWE,Kedah,0,0,0,Sweden
11642,7/1/2020,SWE,Kelantan,0,0,0,Sweden
11643,7/1/2020,SWE,Melaka,0,0,0,Sweden
11644,7/1/2020,SWE,Negeri Sembilan,0,0,0,Sweden
11645,7/1/2020,SWE,Pahang,0,0,0,Sweden
11646,7/1/2020,SWE,Perak,0,0,0,Sweden
11647,7/1/2020,SWE,Perlis,0,0,0,Sweden
11648,7/1/2020,SWE,Pulau Pinang,0,0,0,Sweden
11649,7/1/2020,SWE,Sabah,0,0,0,Sweden
11650,7/1/2020,SWE,Sarawak,0,0,0,Sweden
11651,7/1/2020,SWE,Selangor,39,30,9,Sweden
11652,7/1/2020,SWE,W.P. Labuan,0,0,0,Sweden
11653,7/1/2020,SWZ,Johor,0,0,0,Swaziland
11654,7/1/2020,SWZ,Kedah,0,0,0,Swaziland
11655,7/1/2020,SWZ,Pulau Pinang,0,0,0,Swaziland
11656,7/1/2020,SWZ,Sabah,0,0,0,Swaziland
11657,7/1/2020,SWZ,Selangor,0,0,0,Swaziland
11658,7/1/2020,SYC,Johor,0,0,0,Seychelles
11659,7/1/2020,SYC,Kedah,0,0,0,Seychelles
11660,7/1/2020,SYC,Pulau Pinang,0,0,0,Seychelles
11661,7/1/2020,SYC,Sabah,0,0,0,Seychelles
11662,7/1/2020,SYC,Sarawak,0,0,0,Seychelles
11663,7/1/2020,SYC,Selangor,0,0,0,Seychelles
11664,7/1/2020,SYR,Johor,0,0,0,Syrian Arab Republic
11665,7/1/2020,SYR,Kedah,0,0,0,Syrian Arab Republic
11666,7/1/2020,SYR,Kelantan,0,0,0,Syrian Arab Republic
11667,7/1/2020,SYR,Pahang,0,0,0,Syrian Arab Republic
11668,7/1/2020,SYR,Perlis,0,0,0,Syrian Arab Republic
11669,7/1/2020,SYR,Pulau Pinang,0,0,0,Syrian Arab Republic
11670,7/1/2020,SYR,Sabah,0,0,0,Syrian Arab Republic
11671,7/1/2020,SYR,Sarawak,0,0,0,Syrian Arab Republic
11672,7/1/2020,SYR,Selangor,1,1,0,Syrian Arab Republic
11673,7/1/2020,SYR,W.P. Labuan,0,0,0,Syrian Arab Republic
11674,7/1/2020,TCA,Perlis,0,0,0,Turks and Caicos
11675,7/1/2020,TCD,Johor,0,0,0,Chad
11676,7/1/2020,TCD,Kedah,0,0,0,Chad
11677,7/1/2020,TCD,Perlis,0,0,0,Chad
11678,7/1/2020,TCD,Selangor,0,0,0,Chad
11679,7/1/2020,TGO,Johor,0,0,0,Togo
11680,7/1/2020,TGO,Perak,0,0,0,Togo
11681,7/1/2020,TGO,Pulau Pinang,0,0,0,Togo
11682,7/1/2020,TGO,Selangor,0,0,0,Togo
11683,7/1/2020,THA,Johor,79,79,0,Thailand
11684,7/1/2020,THA,Kedah,10004,9337,667,Thailand
11685,7/1/2020,THA,Kelantan,9,1,8,Thailand
11686,7/1/2020,THA,Melaka,0,0,0,Thailand
11687,7/1/2020,THA,Negeri Sembilan,0,0,0,Thailand
11688,7/1/2020,THA,Pahang,0,0,0,Thailand
11689,7/1/2020,THA,Perak,7,0,7,Thailand
11690,7/1/2020,THA,Perlis,2562,2509,53,Thailand
11691,7/1/2020,THA,Pulau Pinang,0,0,0,Thailand
11692,7/1/2020,THA,Sabah,0,0,0,Thailand
11693,7/1/2020,THA,Sarawak,15,15,0,Thailand
11694,7/1/2020,THA,Selangor,46,9,37,Thailand
11695,7/1/2020,THA,Terengganu,0,0,0,Thailand
11696,7/1/2020,THA,W.P. Labuan,0,0,0,Thailand
11697,7/1/2020,TJK,Johor,0,0,0,Tajikistan
11698,7/1/2020,TJK,Kedah,0,0,0,Tajikistan
11699,7/1/2020,TJK,Perlis,0,0,0,Tajikistan
11700,7/1/2020,TJK,Pulau Pinang,0,0,0,Tajikistan
11701,7/1/2020,TJK,Sabah,0,0,0,Tajikistan
11702,7/1/2020,TJK,Selangor,0,0,0,Tajikistan
11703,7/1/2020,TKL,Selangor,0,0,0,Tokelau
11704,7/1/2020,TKM,Johor,0,0,0,Turkmenistan
11705,7/1/2020,TKM,Kedah,0,0,0,Turkmenistan
11706,7/1/2020,TKM,Kelantan,0,0,0,Turkmenistan
11707,7/1/2020,TKM,Perlis,0,0,0,Turkmenistan
11708,7/1/2020,TKM,Pulau Pinang,0,0,0,Turkmenistan
11709,7/1/2020,TKM,Sabah,0,0,0,Turkmenistan
11710,7/1/2020,TKM,Sarawak,0,0,0,Turkmenistan
11711,7/1/2020,TKM,Selangor,0,0,0,Turkmenistan
11712,7/1/2020,TLS,Johor,0,0,0,Timor-Leste
11713,7/1/2020,TLS,Kedah,0,0,0,Timor-Leste
11714,7/1/2020,TLS,Perlis,0,0,0,Timor-Leste
11715,7/1/2020,TLS,Pulau Pinang,0,0,0,Timor-Leste
11716,7/1/2020,TLS,Sabah,0,0,0,Timor-Leste
11717,7/1/2020,TLS,Sarawak,0,0,0,Timor-Leste
11718,7/1/2020,TLS,Selangor,5,1,4,Timor-Leste
11719,7/1/2020,TON,Johor,0,0,0,Tonga
11720,7/1/2020,TON,Pulau Pinang,0,0,0,Tonga
11721,7/1/2020,TON,Sarawak,0,0,0,Tonga
11722,7/1/2020,TON,Selangor,0,0,0,Tonga
11723,7/1/2020,TTO,Johor,0,0,0,Trinidad and Tobago
11724,7/1/2020,TTO,Kedah,0,0,0,Trinidad and Tobago
11725,7/1/2020,TTO,Pahang,0,0,0,Trinidad and Tobago
11726,7/1/2020,TTO,Pulau Pinang,0,0,0,Trinidad and Tobago
11727,7/1/2020,TTO,Sabah,0,0,0,Trinidad and Tobago
11728,7/1/2020,TTO,Sarawak,0,0,0,Trinidad and Tobago
11729,7/1/2020,TTO,Selangor,0,0,0,Trinidad and Tobago
11730,7/1/2020,TUN,Johor,0,0,0,Tunisia
11731,7/1/2020,TUN,Kedah,0,0,0,Tunisia
11732,7/1/2020,TUN,Kelantan,0,0,0,Tunisia
11733,7/1/2020,TUN,Melaka,0,0,0,Tunisia
11734,7/1/2020,TUN,Perak,0,0,0,Tunisia
11735,7/1/2020,TUN,Perlis,0,0,0,Tunisia
11736,7/1/2020,TUN,Pulau Pinang,0,0,0,Tunisia
11737,7/1/2020,TUN,Sabah,0,0,0,Tunisia
11738,7/1/2020,TUN,Sarawak,0,0,0,Tunisia
11739,7/1/2020,TUN,Selangor,2,0,2,Tunisia
11740,7/1/2020,TUN,W.P. Labuan,0,0,0,Tunisia
11741,7/1/2020,TUR,Johor,2,2,0,Turkey
11742,7/1/2020,TUR,Kedah,0,0,0,Turkey
11743,7/1/2020,TUR,Kelantan,0,0,0,Turkey
11744,7/1/2020,TUR,Melaka,0,0,0,Turkey
11745,7/1/2020,TUR,Negeri Sembilan,0,0,0,Turkey
11746,7/1/2020,TUR,Pahang,0,0,0,Turkey
11747,7/1/2020,TUR,Perak,0,0,0,Turkey
11748,7/1/2020,TUR,Perlis,0,0,0,Turkey
11749,7/1/2020,TUR,Pulau Pinang,0,0,0,Turkey
11750,7/1/2020,TUR,Sabah,1,1,0,Turkey
11751,7/1/2020,TUR,Sarawak,0,0,0,Turkey
11752,7/1/2020,TUR,Selangor,54,32,22,Turkey
11753,7/1/2020,TUR,W.P. Labuan,0,0,0,Turkey
11754,7/1/2020,TUV,Selangor,0,0,0,Tuvalu
11755,7/1/2020,TWN,Johor,1,1,0,Taiwan
11756,7/1/2020,TWN,Kedah,0,0,0,Taiwan
11757,7/1/2020,TWN,Kelantan,0,0,0,Taiwan
11758,7/1/2020,TWN,Melaka,0,0,0,Taiwan
11759,7/1/2020,TWN,Negeri Sembilan,0,0,0,Taiwan
11760,7/1/2020,TWN,Pahang,0,0,0,Taiwan
11761,7/1/2020,TWN,Perak,0,0,0,Taiwan
11762,7/1/2020,TWN,Perlis,0,0,0,Taiwan
11763,7/1/2020,TWN,Pulau Pinang,0,0,0,Taiwan
11764,7/1/2020,TWN,Sabah,0,0,0,Taiwan
11765,7/1/2020,TWN,Sarawak,0,0,0,Taiwan
11766,7/1/2020,TWN,Selangor,70,46,24,Taiwan
11767,7/1/2020,TWN,W.P. Labuan,0,0,0,Taiwan
11768,7/1/2020,TZA,Johor,0,0,0,"Tanzania, United Republic of"
11769,7/1/2020,TZA,Kedah,0,0,0,"Tanzania, United Republic of"
11770,7/1/2020,TZA,Perak,0,0,0,"Tanzania, United Republic of"
11771,7/1/2020,TZA,Perlis,0,0,0,"Tanzania, United Republic of"
11772,7/1/2020,TZA,Pulau Pinang,0,0,0,"Tanzania, United Republic of"
11773,7/1/2020,TZA,Sabah,0,0,0,"Tanzania, United Republic of"
11774,7/1/2020,TZA,Sarawak,0,0,0,"Tanzania, United Republic of"
11775,7/1/2020,TZA,Selangor,0,0,0,"Tanzania, United Republic of"
11776,7/1/2020,UGA,Johor,0,0,0,Uganda
11777,7/1/2020,UGA,Kedah,0,0,0,Uganda
11778,7/1/2020,UGA,Perak,0,0,0,Uganda
11779,7/1/2020,UGA,Perlis,0,0,0,Uganda
11780,7/1/2020,UGA,Pulau Pinang,0,0,0,Uganda
11781,7/1/2020,UGA,Sabah,0,0,0,Uganda
11782,7/1/2020,UGA,Sarawak,0,0,0,Uganda
11783,7/1/2020,UGA,Selangor,0,0,0,Uganda
11784,7/1/2020,UKR,Johor,40,40,0,Ukraine
11785,7/1/2020,UKR,Kedah,0,0,0,Ukraine
11786,7/1/2020,UKR,Kelantan,0,0,0,Ukraine
11787,7/1/2020,UKR,Melaka,0,0,0,Ukraine
11788,7/1/2020,UKR,Negeri Sembilan,0,0,0,Ukraine
11789,7/1/2020,UKR,Pahang,0,0,0,Ukraine
11790,7/1/2020,UKR,Perak,0,0,0,Ukraine
11791,7/1/2020,UKR,Perlis,0,0,0,Ukraine
11792,7/1/2020,UKR,Pulau Pinang,0,0,0,Ukraine
11793,7/1/2020,UKR,Sabah,0,0,0,Ukraine
11794,7/1/2020,UKR,Sarawak,0,0,0,Ukraine
11795,7/1/2020,UKR,Selangor,164,164,0,Ukraine
11796,7/1/2020,UKR,W.P. Labuan,0,0,0,Ukraine
11797,7/1/2020,URY,Johor,0,0,0,Uruguay
11798,7/1/2020,URY,Kedah,0,0,0,Uruguay
11799,7/1/2020,URY,Kelantan,0,0,0,Uruguay
11800,7/1/2020,URY,Perak,0,0,0,Uruguay
11801,7/1/2020,URY,Perlis,0,0,0,Uruguay
11802,7/1/2020,URY,Pulau Pinang,0,0,0,Uruguay
11803,7/1/2020,URY,Sabah,0,0,0,Uruguay
11804,7/1/2020,URY,Sarawak,0,0,0,Uruguay
11805,7/1/2020,URY,Selangor,0,0,0,Uruguay
11806,7/1/2020,URY,W.P. Labuan,0,0,0,Uruguay
11807,7/1/2020,USA,Johor,0,0,0,United States Of America
11808,7/1/2020,USA,Kedah,0,0,0,United States Of America
11809,7/1/2020,USA,Kelantan,0,0,0,United States Of America
11810,7/1/2020,USA,Melaka,0,0,0,United States Of America
11811,7/1/2020,USA,Negeri Sembilan,0,0,0,United States Of America
11812,7/1/2020,USA,Pahang,0,0,0,United States Of America
11813,7/1/2020,USA,Perak,0,0,0,United States Of America
11814,7/1/2020,USA,Perlis,0,0,0,United States Of America
11815,7/1/2020,USA,Pulau Pinang,0,0,0,United States Of America
11816,7/1/2020,USA,Sabah,2,2,0,United States Of America
11817,7/1/2020,USA,Sarawak,0,0,0,United States Of America
11818,7/1/2020,USA,Selangor,193,134,59,United States Of America
11819,7/1/2020,USA,Terengganu,0,0,0,United States Of America
11820,7/1/2020,USA,W.P. Labuan,0,0,0,United States Of America
11821,7/1/2020,UZB,Johor,0,0,0,Uzbekistan
11822,7/1/2020,UZB,Kedah,0,0,0,Uzbekistan
11823,7/1/2020,UZB,Kelantan,0,0,0,Uzbekistan
11824,7/1/2020,UZB,Perak,0,0,0,Uzbekistan
11825,7/1/2020,UZB,Perlis,0,0,0,Uzbekistan
11826,7/1/2020,UZB,Pulau Pinang,0,0,0,Uzbekistan
11827,7/1/2020,UZB,Sabah,0,0,0,Uzbekistan
11828,7/1/2020,UZB,Sarawak,0,0,0,Uzbekistan
11829,7/1/2020,UZB,Selangor,1,0,1,Uzbekistan
11830,7/1/2020,VAT,Johor,0,0,0,Holy See (Vatican City State)
11831,7/1/2020,VAT,Sarawak,0,0,0,Holy See (Vatican City State)
11832,7/1/2020,VAT,Selangor,0,0,0,Holy See (Vatican City State)
11833,7/1/2020,VCT,Johor,0,0,0,Saint Vincent and the Grenadines
11834,7/1/2020,VCT,Kedah,0,0,0,Saint Vincent and the Grenadines
11835,7/1/2020,VCT,Pulau Pinang,0,0,0,Saint Vincent and the Grenadines
11836,7/1/2020,VCT,Sarawak,0,0,0,Saint Vincent and the Grenadines
11837,7/1/2020,VCT,Selangor,0,0,0,Saint Vincent and the Grenadines
11838,7/1/2020,VEN,Johor,0,0,0,Venezuela
11839,7/1/2020,VEN,Kedah,0,0,0,Venezuela
11840,7/1/2020,VEN,Kelantan,0,0,0,Venezuela
11841,7/1/2020,VEN,Melaka,0,0,0,Venezuela
11842,7/1/2020,VEN,Perak,0,0,0,Venezuela
11843,7/1/2020,VEN,Perlis,0,0,0,Venezuela
11844,7/1/2020,VEN,Pulau Pinang,0,0,0,Venezuela
11845,7/1/2020,VEN,Sabah,0,0,0,Venezuela
11846,7/1/2020,VEN,Sarawak,0,0,0,Venezuela
11847,7/1/2020,VEN,Selangor,1,1,0,Venezuela
11848,7/1/2020,VEN,W.P. Labuan,0,0,0,Venezuela
11849,7/1/2020,VNM,Johor,2,0,2,Vietnam
11850,7/1/2020,VNM,Kedah,0,0,0,Vietnam
11851,7/1/2020,VNM,Kelantan,0,0,0,Vietnam
11852,7/1/2020,VNM,Melaka,0,0,0,Vietnam
11853,7/1/2020,VNM,Negeri Sembilan,0,0,0,Vietnam
11854,7/1/2020,VNM,Pahang,0,0,0,Vietnam
11855,7/1/2020,VNM,Perak,0,0,0,Vietnam
11856,7/1/2020,VNM,Perlis,0,0,0,Vietnam
11857,7/1/2020,VNM,Pulau Pinang,0,0,0,Vietnam
11858,7/1/2020,VNM,Sabah,0,0,0,Vietnam
11859,7/1/2020,VNM,Sarawak,0,0,0,Vietnam
11860,7/1/2020,VNM,Selangor,165,4,161,Vietnam
11861,7/1/2020,VNM,Terengganu,0,0,0,Vietnam
11862,7/1/2020,VNM,W.P. Labuan,0,0,0,Vietnam
11863,7/1/2020,VUT,Johor,0,0,0,Vanuatu
11864,7/1/2020,VUT,Kedah,0,0,0,Vanuatu
11865,7/1/2020,VUT,Pulau Pinang,0,0,0,Vanuatu
11866,7/1/2020,VUT,Sabah,0,0,0,Vanuatu
11867,7/1/2020,VUT,Sarawak,0,0,0,Vanuatu
11868,7/1/2020,VUT,Selangor,0,0,0,Vanuatu
11869,7/1/2020,WSM,Johor,0,0,0,Samoa
11870,7/1/2020,WSM,Sarawak,0,0,0,Samoa
11871,7/1/2020,WSM,Selangor,0,0,0,Samoa
11872,7/1/2020,YEM,Johor,0,0,0,Yemen
11873,7/1/2020,YEM,Kedah,0,0,0,Yemen
11874,7/1/2020,YEM,Kelantan,0,0,0,Yemen
11875,7/1/2020,YEM,Melaka,0,0,0,Yemen
11876,7/1/2020,YEM,Pahang,0,0,0,Yemen
11877,7/1/2020,YEM,Perak,0,0,0,Yemen
11878,7/1/2020,YEM,Perlis,0,0,0,Yemen
11879,7/1/2020,YEM,Pulau Pinang,0,0,0,Yemen
11880,7/1/2020,YEM,Sabah,0,0,0,Yemen
11881,7/1/2020,YEM,Sarawak,0,0,0,Yemen
11882,7/1/2020,YEM,Selangor,8,8,0,Yemen
11883,7/1/2020,YEM,W.P. Labuan,0,0,0,Yemen
11884,7/1/2020,ZAF,Johor,0,0,0,South Africa
11885,7/1/2020,ZAF,Kedah,0,0,0,South Africa
11886,7/1/2020,ZAF,Kelantan,0,0,0,South Africa
11887,7/1/2020,ZAF,Melaka,0,0,0,South Africa
11888,7/1/2020,ZAF,Pahang,0,0,0,South Africa
11889,7/1/2020,ZAF,Perak,0,0,0,South Africa
11890,7/1/2020,ZAF,Perlis,0,0,0,South Africa
11891,7/1/2020,ZAF,Pulau Pinang,0,0,0,South Africa
11892,7/1/2020,ZAF,Sabah,0,0,0,South Africa
11893,7/1/2020,ZAF,Sarawak,0,0,0,South Africa
11894,7/1/2020,ZAF,Selangor,12,7,5,South Africa
11895,7/1/2020,ZAF,Terengganu,0,0,0,South Africa
11896,7/1/2020,ZAF,W.P. Labuan,0,0,0,South Africa
11897,7/1/2020,ZMB,Johor,0,0,0,Zambia
11898,7/1/2020,ZMB,Kedah,0,0,0,Zambia
11899,7/1/2020,ZMB,Perak,0,0,0,Zambia
11900,7/1/2020,ZMB,Perlis,0,0,0,Zambia
11901,7/1/2020,ZMB,Pulau Pinang,0,0,0,Zambia
11902,7/1/2020,ZMB,Sabah,0,0,0,Zambia
11903,7/1/2020,ZMB,Sarawak,0,0,0,Zambia
11904,7/1/2020,ZMB,Selangor,1,1,0,Zambia
11905,7/1/2020,ZWE,Johor,0,0,0,Zimbabwe
11906,7/1/2020,ZWE,Kedah,0,0,0,Zimbabwe
11907,7/1/2020,ZWE,Kelantan,0,0,0,Zimbabwe
11908,7/1/2020,ZWE,Perak,0,0,0,Zimbabwe
11909,7/1/2020,ZWE,Perlis,0,0,0,Zimbabwe
11910,7/1/2020,ZWE,Pulau Pinang,0,0,0,Zimbabwe
11911,7/1/2020,ZWE,Sabah,0,0,0,Zimbabwe
11912,7/1/2020,ZWE,Sarawak,0,0,0,Zimbabwe
11913,7/1/2020,ZWE,Selangor,1,1,0,Zimbabwe
11914,8/1/2020,ABW,Kedah,0,0,0,Aruba
11915,8/1/2020,ABW,Pulau Pinang,0,0,0,Aruba
11916,8/1/2020,AFG,Johor,0,0,0,Afghanistan
11917,8/1/2020,AFG,Kedah,0,0,0,Afghanistan
11918,8/1/2020,AFG,Perlis,0,0,0,Afghanistan
11919,8/1/2020,AFG,Pulau Pinang,0,0,0,Afghanistan
11920,8/1/2020,AFG,Sarawak,0,0,0,Afghanistan
11921,8/1/2020,AFG,Selangor,2,2,0,Afghanistan
11922,8/1/2020,AGO,Johor,0,0,0,Angola
11923,8/1/2020,AGO,Kedah,0,0,0,Angola
11924,8/1/2020,AGO,Sabah,0,0,0,Angola
11925,8/1/2020,AGO,Selangor,0,0,0,Angola
11926,8/1/2020,AIA,Selangor,0,0,0,Anguilla
11927,8/1/2020,ALB,Johor,0,0,0,Albania
11928,8/1/2020,ALB,Kedah,0,0,0,Albania
11929,8/1/2020,ALB,Perak,0,0,0,Albania
11930,8/1/2020,ALB,Perlis,0,0,0,Albania
11931,8/1/2020,ALB,Pulau Pinang,0,0,0,Albania
11932,8/1/2020,ALB,Sabah,0,0,0,Albania
11933,8/1/2020,ALB,Sarawak,0,0,0,Albania
11934,8/1/2020,ALB,Selangor,0,0,0,Albania
11935,8/1/2020,AND,Johor,0,0,0,Andorra
11936,8/1/2020,AND,Kedah,0,0,0,Andorra
11937,8/1/2020,AND,Perlis,0,0,0,Andorra
11938,8/1/2020,AND,Pulau Pinang,0,0,0,Andorra
11939,8/1/2020,AND,Selangor,0,0,0,Andorra
11940,8/1/2020,ANT,Selangor,0,0,0,Netherlands Antilles
11941,8/1/2020,ARE,Johor,0,0,0,United Arab Emirates
11942,8/1/2020,ARE,Kedah,0,0,0,United Arab Emirates
11943,8/1/2020,ARE,Kelantan,0,0,0,United Arab Emirates
11944,8/1/2020,ARE,Perak,0,0,0,United Arab Emirates
11945,8/1/2020,ARE,Perlis,0,0,0,United Arab Emirates
11946,8/1/2020,ARE,Pulau Pinang,0,0,0,United Arab Emirates
11947,8/1/2020,ARE,Sabah,0,0,0,United Arab Emirates
11948,8/1/2020,ARE,Sarawak,0,0,0,United Arab Emirates
11949,8/1/2020,ARE,Selangor,8,5,3,United Arab Emirates
11950,8/1/2020,ARG,Johor,0,0,0,Argentina
11951,8/1/2020,ARG,Kedah,0,0,0,Argentina
11952,8/1/2020,ARG,Kelantan,0,0,0,Argentina
11953,8/1/2020,ARG,Melaka,0,0,0,Argentina
11954,8/1/2020,ARG,Perak,0,0,0,Argentina
11955,8/1/2020,ARG,Perlis,0,0,0,Argentina
11956,8/1/2020,ARG,Pulau Pinang,0,0,0,Argentina
11957,8/1/2020,ARG,Sabah,0,0,0,Argentina
11958,8/1/2020,ARG,Sarawak,0,0,0,Argentina
11959,8/1/2020,ARG,Selangor,2,0,2,Argentina
11960,8/1/2020,ARG,W.P. Labuan,0,0,0,Argentina
11961,8/1/2020,ARM,Johor,0,0,0,Armenia
11962,8/1/2020,ARM,Kedah,0,0,0,Armenia
11963,8/1/2020,ARM,Kelantan,0,0,0,Armenia
11964,8/1/2020,ARM,Perak,0,0,0,Armenia
11965,8/1/2020,ARM,Perlis,0,0,0,Armenia
11966,8/1/2020,ARM,Pulau Pinang,0,0,0,Armenia
11967,8/1/2020,ARM,Sabah,0,0,0,Armenia
11968,8/1/2020,ARM,Sarawak,0,0,0,Armenia
11969,8/1/2020,ARM,Selangor,0,0,0,Armenia
11970,8/1/2020,ATA,Selangor,0,0,0,Antarctica
11971,8/1/2020,ATG,Johor,0,0,0,Antigua and Barbuda
11972,8/1/2020,ATG,Kedah,0,0,0,Antigua and Barbuda
11973,8/1/2020,ATG,Pulau Pinang,0,0,0,Antigua and Barbuda
11974,8/1/2020,ATG,Sarawak,0,0,0,Antigua and Barbuda
11975,8/1/2020,ATG,Selangor,0,0,0,Antigua and Barbuda
11976,8/1/2020,AUS,Johor,6,6,0,Australia
11977,8/1/2020,AUS,Kedah,0,0,0,Australia
11978,8/1/2020,AUS,Kelantan,0,0,0,Australia
11979,8/1/2020,AUS,Melaka,0,0,0,Australia
11980,8/1/2020,AUS,Negeri Sembilan,0,0,0,Australia
11981,8/1/2020,AUS,Pahang,0,0,0,Australia
11982,8/1/2020,AUS,Perak,0,0,0,Australia
11983,8/1/2020,AUS,Perlis,0,0,0,Australia
11984,8/1/2020,AUS,Pulau Pinang,0,0,0,Australia
11985,8/1/2020,AUS,Sabah,2,1,1,Australia
11986,8/1/2020,AUS,Sarawak,1,1,0,Australia
11987,8/1/2020,AUS,Selangor,116,75,41,Australia
11988,8/1/2020,AUS,Terengganu,0,0,0,Australia
11989,8/1/2020,AUS,W.P. Labuan,0,0,0,Australia
11990,8/1/2020,AUT,Johor,0,0,0,Austria
11991,8/1/2020,AUT,Kedah,0,0,0,Austria
11992,8/1/2020,AUT,Kelantan,0,0,0,Austria
11993,8/1/2020,AUT,Melaka,0,0,0,Austria
11994,8/1/2020,AUT,Negeri Sembilan,0,0,0,Austria
11995,8/1/2020,AUT,Pahang,0,0,0,Austria
11996,8/1/2020,AUT,Perak,0,0,0,Austria
11997,8/1/2020,AUT,Perlis,0,0,0,Austria
11998,8/1/2020,AUT,Pulau Pinang,0,0,0,Austria
11999,8/1/2020,AUT,Sabah,0,0,0,Austria
12000,8/1/2020,AUT,Sarawak,0,0,0,Austria
12001,8/1/2020,AUT,Selangor,16,10,6,Austria
12002,8/1/2020,AUT,Terengganu,0,0,0,Austria
12003,8/1/2020,AUT,W.P. Labuan,0,0,0,Austria
12004,8/1/2020,AZE,Johor,0,0,0,Azerbaijan
12005,8/1/2020,AZE,Kedah,0,0,0,Azerbaijan
12006,8/1/2020,AZE,Kelantan,0,0,0,Azerbaijan
12007,8/1/2020,AZE,Melaka,0,0,0,Azerbaijan
12008,8/1/2020,AZE,Perlis,0,0,0,Azerbaijan
12009,8/1/2020,AZE,Pulau Pinang,0,0,0,Azerbaijan
12010,8/1/2020,AZE,Sabah,0,0,0,Azerbaijan
12011,8/1/2020,AZE,Sarawak,0,0,0,Azerbaijan
12012,8/1/2020,AZE,Selangor,0,0,0,Azerbaijan
12013,8/1/2020,AZE,W.P. Labuan,0,0,0,Azerbaijan
12014,8/1/2020,BDI,Pulau Pinang,0,0,0,Burundi
12015,8/1/2020,BDI,Sarawak,0,0,0,Burundi
12016,8/1/2020,BDI,Selangor,0,0,0,Burundi
12017,8/1/2020,BEL,Johor,0,0,0,Belgium
12018,8/1/2020,BEL,Kedah,0,0,0,Belgium
12019,8/1/2020,BEL,Kelantan,0,0,0,Belgium
12020,8/1/2020,BEL,Melaka,0,0,0,Belgium
12021,8/1/2020,BEL,Negeri Sembilan,0,0,0,Belgium
12022,8/1/2020,BEL,Pahang,0,0,0,Belgium
12023,8/1/2020,BEL,Perak,0,0,0,Belgium
12024,8/1/2020,BEL,Perlis,0,0,0,Belgium
12025,8/1/2020,BEL,Pulau Pinang,0,0,0,Belgium
12026,8/1/2020,BEL,Sabah,0,0,0,Belgium
12027,8/1/2020,BEL,Sarawak,0,0,0,Belgium
12028,8/1/2020,BEL,Selangor,9,9,0,Belgium
12029,8/1/2020,BEL,W.P. Labuan,0,0,0,Belgium
12030,8/1/2020,BEN,Johor,0,0,0,Benin
12031,8/1/2020,BEN,Kedah,0,0,0,Benin
12032,8/1/2020,BEN,Perak,0,0,0,Benin
12033,8/1/2020,BEN,Pulau Pinang,0,0,0,Benin
12034,8/1/2020,BEN,Sabah,0,0,0,Benin
12035,8/1/2020,BEN,Sarawak,0,0,0,Benin
12036,8/1/2020,BEN,Selangor,0,0,0,Benin
12037,8/1/2020,BFA,Perak,0,0,0,Burkina Faso
12038,8/1/2020,BFA,Pulau Pinang,0,0,0,Burkina Faso
12039,8/1/2020,BFA,Selangor,0,0,0,Burkina Faso
12040,8/1/2020,BGD,Johor,5,5,0,Bangladesh
12041,8/1/2020,BGD,Kedah,0,0,0,Bangladesh
12042,8/1/2020,BGD,Kelantan,0,0,0,Bangladesh
12043,8/1/2020,BGD,Melaka,0,0,0,Bangladesh
12044,8/1/2020,BGD,Negeri Sembilan,0,0,0,Bangladesh
12045,8/1/2020,BGD,Pahang,0,0,0,Bangladesh
12046,8/1/2020,BGD,Perak,0,0,0,Bangladesh
12047,8/1/2020,BGD,Perlis,0,0,0,Bangladesh
12048,8/1/2020,BGD,Pulau Pinang,0,0,0,Bangladesh
12049,8/1/2020,BGD,Sabah,0,0,0,Bangladesh
12050,8/1/2020,BGD,Sarawak,1,1,0,Bangladesh
12051,8/1/2020,BGD,Selangor,170,131,39,Bangladesh
12052,8/1/2020,BGD,W.P. Labuan,0,0,0,Bangladesh
12053,8/1/2020,BGR,Johor,0,0,0,Bulgaria
12054,8/1/2020,BGR,Kedah,0,0,0,Bulgaria
12055,8/1/2020,BGR,Kelantan,0,0,0,Bulgaria
12056,8/1/2020,BGR,Pahang,0,0,0,Bulgaria
12057,8/1/2020,BGR,Perak,0,0,0,Bulgaria
12058,8/1/2020,BGR,Perlis,0,0,0,Bulgaria
12059,8/1/2020,BGR,Pulau Pinang,1,1,0,Bulgaria
12060,8/1/2020,BGR,Sabah,0,0,0,Bulgaria
12061,8/1/2020,BGR,Sarawak,0,0,0,Bulgaria
12062,8/1/2020,BGR,Selangor,2,2,0,Bulgaria
12063,8/1/2020,BGR,W.P. Labuan,0,0,0,Bulgaria
12064,8/1/2020,BHR,Johor,0,0,0,Bahrain
12065,8/1/2020,BHR,Kedah,0,0,0,Bahrain
12066,8/1/2020,BHR,Kelantan,0,0,0,Bahrain
12067,8/1/2020,BHR,Perlis,0,0,0,Bahrain
12068,8/1/2020,BHR,Pulau Pinang,0,0,0,Bahrain
12069,8/1/2020,BHR,Sabah,0,0,0,Bahrain
12070,8/1/2020,BHR,Sarawak,0,0,0,Bahrain
12071,8/1/2020,BHR,Selangor,1,1,0,Bahrain
12072,8/1/2020,BHS,Johor,0,0,0,Bahamas
12073,8/1/2020,BHS,Kedah,0,0,0,Bahamas
12074,8/1/2020,BHS,Perak,0,0,0,Bahamas
12075,8/1/2020,BHS,Sabah,0,0,0,Bahamas
12076,8/1/2020,BHS,Sarawak,0,0,0,Bahamas
12077,8/1/2020,BHS,Selangor,0,0,0,Bahamas
12078,8/1/2020,BIH,Johor,0,0,0,Bosnia and Herzegovina
12079,8/1/2020,BIH,Kedah,0,0,0,Bosnia and Herzegovina
12080,8/1/2020,BIH,Perlis,0,0,0,Bosnia and Herzegovina
12081,8/1/2020,BIH,Pulau Pinang,0,0,0,Bosnia and Herzegovina
12082,8/1/2020,BIH,Sabah,0,0,0,Bosnia and Herzegovina
12083,8/1/2020,BIH,Sarawak,0,0,0,Bosnia and Herzegovina
12084,8/1/2020,BIH,Selangor,2,1,1,Bosnia and Herzegovina
12085,8/1/2020,BLR,Johor,0,0,0,Belarus
12086,8/1/2020,BLR,Kedah,0,0,0,Belarus
12087,8/1/2020,BLR,Kelantan,0,0,0,Belarus
12088,8/1/2020,BLR,Pahang,0,0,0,Belarus
12089,8/1/2020,BLR,Perak,0,0,0,Belarus
12090,8/1/2020,BLR,Perlis,0,0,0,Belarus
12091,8/1/2020,BLR,Pulau Pinang,0,0,0,Belarus
12092,8/1/2020,BLR,Sabah,0,0,0,Belarus
12093,8/1/2020,BLR,Sarawak,0,0,0,Belarus
12094,8/1/2020,BLR,Selangor,1,1,0,Belarus
12095,8/1/2020,BLR,W.P. Labuan,0,0,0,Belarus
12096,8/1/2020,BLZ,Johor,0,0,0,Belize
12097,8/1/2020,BLZ,Pulau Pinang,0,0,0,Belize
12098,8/1/2020,BLZ,Sarawak,0,0,0,Belize
12099,8/1/2020,BLZ,Selangor,0,0,0,Belize
12100,8/1/2020,BMU,Selangor,0,0,0,Bermuda
12101,8/1/2020,BOL,Johor,0,0,0,Bolivia
12102,8/1/2020,BOL,Kedah,0,0,0,Bolivia
12103,8/1/2020,BOL,Melaka,0,0,0,Bolivia
12104,8/1/2020,BOL,Perak,0,0,0,Bolivia
12105,8/1/2020,BOL,Perlis,0,0,0,Bolivia
12106,8/1/2020,BOL,Pulau Pinang,0,0,0,Bolivia
12107,8/1/2020,BOL,Sabah,0,0,0,Bolivia
12108,8/1/2020,BOL,Sarawak,0,0,0,Bolivia
12109,8/1/2020,BOL,Selangor,0,0,0,Bolivia
12110,8/1/2020,BRA,Johor,0,0,0,Brazil
12111,8/1/2020,BRA,Kedah,0,0,0,Brazil
12112,8/1/2020,BRA,Kelantan,0,0,0,Brazil
12113,8/1/2020,BRA,Melaka,0,0,0,Brazil
12114,8/1/2020,BRA,Pahang,0,0,0,Brazil
12115,8/1/2020,BRA,Perak,0,0,0,Brazil
12116,8/1/2020,BRA,Perlis,0,0,0,Brazil
12117,8/1/2020,BRA,Pulau Pinang,0,0,0,Brazil
12118,8/1/2020,BRA,Sabah,0,0,0,Brazil
12119,8/1/2020,BRA,Sarawak,0,0,0,Brazil
12120,8/1/2020,BRA,Selangor,7,4,3,Brazil
12121,8/1/2020,BRA,W.P. Labuan,0,0,0,Brazil
12122,8/1/2020,BRB,Johor,0,0,0,Barbados
12123,8/1/2020,BRB,Kedah,0,0,0,Barbados
12124,8/1/2020,BRB,Perlis,0,0,0,Barbados
12125,8/1/2020,BRB,Pulau Pinang,0,0,0,Barbados
12126,8/1/2020,BRB,Selangor,0,0,0,Barbados
12127,8/1/2020,BRN,Johor,0,0,0,Brunei Darussalam
12128,8/1/2020,BRN,Kedah,0,0,0,Brunei Darussalam
12129,8/1/2020,BRN,Kelantan,0,0,0,Brunei Darussalam
12130,8/1/2020,BRN,Melaka,0,0,0,Brunei Darussalam
12131,8/1/2020,BRN,Pahang,0,0,0,Brunei Darussalam
12132,8/1/2020,BRN,Perak,0,0,0,Brunei Darussalam
12133,8/1/2020,BRN,Perlis,0,0,0,Brunei Darussalam
12134,8/1/2020,BRN,Pulau Pinang,0,0,0,Brunei Darussalam
12135,8/1/2020,BRN,Sabah,0,0,0,Brunei Darussalam
12136,8/1/2020,BRN,Sarawak,196,185,11,Brunei Darussalam
12137,8/1/2020,BRN,Selangor,22,8,14,Brunei Darussalam
12138,8/1/2020,BRN,W.P. Labuan,1,0,1,Brunei Darussalam
12139,8/1/2020,BTN,Johor,0,0,0,Bhutan
12140,8/1/2020,BTN,Kedah,0,0,0,Bhutan
12141,8/1/2020,BTN,Perak,0,0,0,Bhutan
12142,8/1/2020,BTN,Perlis,0,0,0,Bhutan
12143,8/1/2020,BTN,Pulau Pinang,0,0,0,Bhutan
12144,8/1/2020,BTN,Sabah,0,0,0,Bhutan
12145,8/1/2020,BTN,Sarawak,0,0,0,Bhutan
12146,8/1/2020,BTN,Selangor,0,0,0,Bhutan
12147,8/1/2020,BWA,Johor,0,0,0,Botswana
12148,8/1/2020,BWA,Kedah,0,0,0,Botswana
12149,8/1/2020,BWA,Perlis,0,0,0,Botswana
12150,8/1/2020,BWA,Pulau Pinang,0,0,0,Botswana
12151,8/1/2020,BWA,Sabah,0,0,0,Botswana
12152,8/1/2020,BWA,Sarawak,0,0,0,Botswana
12153,8/1/2020,BWA,Selangor,0,0,0,Botswana
12154,8/1/2020,CAF,Kedah,0,0,0,Central African Republic
12155,8/1/2020,CAF,Selangor,0,0,0,Central African Republic
12156,8/1/2020,CAN,Johor,0,0,0,Canada
12157,8/1/2020,CAN,Kedah,0,0,0,Canada
12158,8/1/2020,CAN,Kelantan,0,0,0,Canada
12159,8/1/2020,CAN,Melaka,0,0,0,Canada
12160,8/1/2020,CAN,Negeri Sembilan,0,0,0,Canada
12161,8/1/2020,CAN,Pahang,0,0,0,Canada
12162,8/1/2020,CAN,Perak,0,0,0,Canada
12163,8/1/2020,CAN,Perlis,0,0,0,Canada
12164,8/1/2020,CAN,Pulau Pinang,0,0,0,Canada
12165,8/1/2020,CAN,Sabah,0,0,0,Canada
12166,8/1/2020,CAN,Sarawak,1,1,0,Canada
12167,8/1/2020,CAN,Selangor,51,28,23,Canada
12168,8/1/2020,CAN,Terengganu,0,0,0,Canada
12169,8/1/2020,CAN,W.P. Labuan,0,0,0,Canada
12170,8/1/2020,CCK,Selangor,0,0,0,Cocos (Keeling) Islands
12171,8/1/2020,CHE,Johor,0,0,0,Switzerland
12172,8/1/2020,CHE,Kedah,0,0,0,Switzerland
12173,8/1/2020,CHE,Kelantan,0,0,0,Switzerland
12174,8/1/2020,CHE,Melaka,0,0,0,Switzerland
12175,8/1/2020,CHE,Negeri Sembilan,0,0,0,Switzerland
12176,8/1/2020,CHE,Pahang,0,0,0,Switzerland
12177,8/1/2020,CHE,Perak,0,0,0,Switzerland
12178,8/1/2020,CHE,Perlis,0,0,0,Switzerland
12179,8/1/2020,CHE,Pulau Pinang,1,1,0,Switzerland
12180,8/1/2020,CHE,Sabah,0,0,0,Switzerland
12181,8/1/2020,CHE,Sarawak,1,1,0,Switzerland
12182,8/1/2020,CHE,Selangor,8,6,2,Switzerland
12183,8/1/2020,CHE,W.P. Labuan,0,0,0,Switzerland
12184,8/1/2020,CHL,Johor,0,0,0,Chile
12185,8/1/2020,CHL,Kedah,0,0,0,Chile
12186,8/1/2020,CHL,Kelantan,0,0,0,Chile
12187,8/1/2020,CHL,Melaka,0,0,0,Chile
12188,8/1/2020,CHL,Pahang,0,0,0,Chile
12189,8/1/2020,CHL,Perak,0,0,0,Chile
12190,8/1/2020,CHL,Perlis,0,0,0,Chile
12191,8/1/2020,CHL,Pulau Pinang,0,0,0,Chile
12192,8/1/2020,CHL,Sabah,0,0,0,Chile
12193,8/1/2020,CHL,Sarawak,0,0,0,Chile
12194,8/1/2020,CHL,Selangor,2,1,1,Chile
12195,8/1/2020,CHN,Johor,26,25,1,China
12196,8/1/2020,CHN,Kedah,0,0,0,China
12197,8/1/2020,CHN,Kelantan,0,0,0,China
12198,8/1/2020,CHN,Melaka,0,0,0,China
12199,8/1/2020,CHN,Pahang,0,0,0,China
12200,8/1/2020,CHN,Perak,0,0,0,China
12201,8/1/2020,CHN,Perlis,0,0,0,China
12202,8/1/2020,CHN,Pulau Pinang,0,0,0,China
12203,8/1/2020,CHN,Sabah,1,1,0,China
12204,8/1/2020,CHN,Sarawak,24,21,3,China
12205,8/1/2020,CHN,Selangor,569,389,180,China
12206,8/1/2020,CHN,Terengganu,0,0,0,China
12207,8/1/2020,CHN,W.P. Labuan,1,0,1,China
12208,8/1/2020,CIV,Johor,0,0,0,C��te d'Iv
12209,8/1/2020,CIV,Kedah,0,0,0,C��te d'Iv
12210,8/1/2020,CIV,Pulau Pinang,0,0,0,C��te d'Iv
12211,8/1/2020,CIV,Sabah,0,0,0,C��te d'Iv
12212,8/1/2020,CIV,Sarawak,0,0,0,C��te d'Iv
12213,8/1/2020,CIV,Selangor,0,0,0,C��te d'Iv
12214,8/1/2020,CMR,Johor,0,0,0,Cameroon
12215,8/1/2020,CMR,Kedah,0,0,0,Cameroon
12216,8/1/2020,CMR,Pulau Pinang,0,0,0,Cameroon
12217,8/1/2020,CMR,Sabah,0,0,0,Cameroon
12218,8/1/2020,CMR,Sarawak,0,0,0,Cameroon
12219,8/1/2020,CMR,Selangor,1,0,1,Cameroon
12220,8/1/2020,COD,Johor,0,0,0,"Congo, the Democratic Republic of the"
12221,8/1/2020,COD,Pulau Pinang,0,0,0,"Congo, the Democratic Republic of the"
12222,8/1/2020,COD,Sarawak,0,0,0,"Congo, the Democratic Republic of the"
12223,8/1/2020,COD,Selangor,1,1,0,"Congo, the Democratic Republic of the"
12224,8/1/2020,COG,Johor,0,0,0,Congo
12225,8/1/2020,COG,Kedah,0,0,0,Congo
12226,8/1/2020,COG,Selangor,0,0,0,Congo
12227,8/1/2020,COK,Selangor,0,0,0,Cook Islands
12228,8/1/2020,COL,Johor,0,0,0,Colombia
12229,8/1/2020,COL,Kedah,0,0,0,Colombia
12230,8/1/2020,COL,Perak,0,0,0,Colombia
12231,8/1/2020,COL,Pulau Pinang,0,0,0,Colombia
12232,8/1/2020,COL,Sabah,0,0,0,Colombia
12233,8/1/2020,COL,Sarawak,0,0,0,Colombia
12234,8/1/2020,COL,Selangor,0,0,0,Colombia
12235,8/1/2020,COL,W.P. Labuan,0,0,0,Colombia
12236,8/1/2020,COM,Johor,0,0,0,Comoros
12237,8/1/2020,COM,Kedah,0,0,0,Comoros
12238,8/1/2020,COM,Selangor,0,0,0,Comoros
12239,8/1/2020,CPV,Johor,0,0,0,Cape Verde
12240,8/1/2020,CPV,Kedah,0,0,0,Cape Verde
12241,8/1/2020,CPV,Pulau Pinang,0,0,0,Cape Verde
12242,8/1/2020,CPV,Sabah,0,0,0,Cape Verde
12243,8/1/2020,CPV,Selangor,0,0,0,Cape Verde
12244,8/1/2020,CRI,Johor,0,0,0,Costa Rica
12245,8/1/2020,CRI,Kedah,0,0,0,Costa Rica
12246,8/1/2020,CRI,Perak,0,0,0,Costa Rica
12247,8/1/2020,CRI,Perlis,0,0,0,Costa Rica
12248,8/1/2020,CRI,Pulau Pinang,0,0,0,Costa Rica
12249,8/1/2020,CRI,Sabah,0,0,0,Costa Rica
12250,8/1/2020,CRI,Sarawak,0,0,0,Costa Rica
12251,8/1/2020,CRI,Selangor,3,2,1,Costa Rica
12252,8/1/2020,CUB,Johor,0,0,0,Cuba
12253,8/1/2020,CUB,Kedah,0,0,0,Cuba
12254,8/1/2020,CUB,Perlis,0,0,0,Cuba
12255,8/1/2020,CUB,Pulau Pinang,0,0,0,Cuba
12256,8/1/2020,CUB,Sabah,0,0,0,Cuba
12257,8/1/2020,CUB,Sarawak,0,0,0,Cuba
12258,8/1/2020,CUB,Selangor,0,0,0,Cuba
12259,8/1/2020,CYP,Johor,0,0,0,Cyprus
12260,8/1/2020,CYP,Kedah,0,0,0,Cyprus
12261,8/1/2020,CYP,Perak,0,0,0,Cyprus
12262,8/1/2020,CYP,Perlis,0,0,0,Cyprus
12263,8/1/2020,CYP,Pulau Pinang,0,0,0,Cyprus
12264,8/1/2020,CYP,Sabah,0,0,0,Cyprus
12265,8/1/2020,CYP,Sarawak,0,0,0,Cyprus
12266,8/1/2020,CYP,Selangor,0,0,0,Cyprus
12267,8/1/2020,CZE,Johor,0,0,0,Czech Republic
12268,8/1/2020,CZE,Kedah,0,0,0,Czech Republic
12269,8/1/2020,CZE,Kelantan,0,0,0,Czech Republic
12270,8/1/2020,CZE,Melaka,0,0,0,Czech Republic
12271,8/1/2020,CZE,Negeri Sembilan,0,0,0,Czech Republic
12272,8/1/2020,CZE,Perak,0,0,0,Czech Republic
12273,8/1/2020,CZE,Perlis,0,0,0,Czech Republic
12274,8/1/2020,CZE,Pulau Pinang,0,0,0,Czech Republic
12275,8/1/2020,CZE,Sabah,0,0,0,Czech Republic
12276,8/1/2020,CZE,Sarawak,0,0,0,Czech Republic
12277,8/1/2020,CZE,Selangor,7,6,1,Czech Republic
12278,8/1/2020,CZE,W.P. Labuan,0,0,0,Czech Republic
12279,8/1/2020,DEU,Johor,0,0,0,Germany
12280,8/1/2020,DEU,Kedah,0,0,0,Germany
12281,8/1/2020,DEU,Kelantan,0,0,0,Germany
12282,8/1/2020,DEU,Melaka,0,0,0,Germany
12283,8/1/2020,DEU,Negeri Sembilan,0,0,0,Germany
12284,8/1/2020,DEU,Pahang,0,0,0,Germany
12285,8/1/2020,DEU,Perak,0,0,0,Germany
12286,8/1/2020,DEU,Perlis,0,0,0,Germany
12287,8/1/2020,DEU,Pulau Pinang,0,0,0,Germany
12288,8/1/2020,DEU,Sabah,0,0,0,Germany
12289,8/1/2020,DEU,Sarawak,0,0,0,Germany
12290,8/1/2020,DEU,Selangor,67,49,18,Germany
12291,8/1/2020,DEU,Terengganu,0,0,0,Germany
12292,8/1/2020,DEU,W.P. Labuan,0,0,0,Germany
12293,8/1/2020,DJI,Johor,0,0,0,Djibouti
12294,8/1/2020,DJI,Selangor,0,0,0,Djibouti
12295,8/1/2020,DMA,Johor,0,0,0,Dominica
12296,8/1/2020,DMA,Kedah,0,0,0,Dominica
12297,8/1/2020,DMA,Pulau Pinang,0,0,0,Dominica
12298,8/1/2020,DMA,Sabah,0,0,0,Dominica
12299,8/1/2020,DMA,Sarawak,0,0,0,Dominica
12300,8/1/2020,DMA,Selangor,0,0,0,Dominica
12301,8/1/2020,DMA,W.P. Labuan,0,0,0,Dominica
12302,8/1/2020,DNK,Johor,0,0,0,Denmark
12303,8/1/2020,DNK,Kedah,0,0,0,Denmark
12304,8/1/2020,DNK,Kelantan,0,0,0,Denmark
12305,8/1/2020,DNK,Melaka,0,0,0,Denmark
12306,8/1/2020,DNK,Negeri Sembilan,0,0,0,Denmark
12307,8/1/2020,DNK,Pahang,0,0,0,Denmark
12308,8/1/2020,DNK,Perak,0,0,0,Denmark
12309,8/1/2020,DNK,Perlis,0,0,0,Denmark
12310,8/1/2020,DNK,Pulau Pinang,0,0,0,Denmark
12311,8/1/2020,DNK,Sabah,0,0,0,Denmark
12312,8/1/2020,DNK,Sarawak,0,0,0,Denmark
12313,8/1/2020,DNK,Selangor,20,10,10,Denmark
12314,8/1/2020,DNK,W.P. Labuan,0,0,0,Denmark
12315,8/1/2020,DOM,Johor,0,0,0,Dominican Republic
12316,8/1/2020,DOM,Kedah,0,0,0,Dominican Republic
12317,8/1/2020,DOM,Perak,0,0,0,Dominican Republic
12318,8/1/2020,DOM,Perlis,0,0,0,Dominican Republic
12319,8/1/2020,DOM,Pulau Pinang,0,0,0,Dominican Republic
12320,8/1/2020,DOM,Sabah,0,0,0,Dominican Republic
12321,8/1/2020,DOM,Sarawak,0,0,0,Dominican Republic
12322,8/1/2020,DOM,Selangor,0,0,0,Dominican Republic
12323,8/1/2020,DZA,Johor,0,0,0,Algeria
12324,8/1/2020,DZA,Kedah,0,0,0,Algeria
12325,8/1/2020,DZA,Kelantan,0,0,0,Algeria
12326,8/1/2020,DZA,Melaka,0,0,0,Algeria
12327,8/1/2020,DZA,Perak,0,0,0,Algeria
12328,8/1/2020,DZA,Perlis,0,0,0,Algeria
12329,8/1/2020,DZA,Pulau Pinang,0,0,0,Algeria
12330,8/1/2020,DZA,Sabah,0,0,0,Algeria
12331,8/1/2020,DZA,Sarawak,0,0,0,Algeria
12332,8/1/2020,DZA,Selangor,5,4,1,Algeria
12333,8/1/2020,DZA,W.P. Labuan,0,0,0,Algeria
12334,8/1/2020,ECU,Johor,0,0,0,Ecuador
12335,8/1/2020,ECU,Kedah,0,0,0,Ecuador
12336,8/1/2020,ECU,Perak,0,0,0,Ecuador
12337,8/1/2020,ECU,Perlis,0,0,0,Ecuador
12338,8/1/2020,ECU,Pulau Pinang,0,0,0,Ecuador
12339,8/1/2020,ECU,Sabah,0,0,0,Ecuador
12340,8/1/2020,ECU,Sarawak,0,0,0,Ecuador
12341,8/1/2020,ECU,Selangor,0,0,0,Ecuador
12342,8/1/2020,EGY,Johor,0,0,0,Egypt
12343,8/1/2020,EGY,Kedah,0,0,0,Egypt
12344,8/1/2020,EGY,Kelantan,0,0,0,Egypt
12345,8/1/2020,EGY,Melaka,0,0,0,Egypt
12346,8/1/2020,EGY,Pahang,0,0,0,Egypt
12347,8/1/2020,EGY,Perak,0,0,0,Egypt
12348,8/1/2020,EGY,Perlis,0,0,0,Egypt
12349,8/1/2020,EGY,Pulau Pinang,0,0,0,Egypt
12350,8/1/2020,EGY,Sabah,1,1,0,Egypt
12351,8/1/2020,EGY,Sarawak,0,0,0,Egypt
12352,8/1/2020,EGY,Selangor,29,21,8,Egypt
12353,8/1/2020,EGY,Terengganu,0,0,0,Egypt
12354,8/1/2020,EGY,W.P. Labuan,0,0,0,Egypt
12355,8/1/2020,ERI,Johor,0,0,0,Eritrea
12356,8/1/2020,ERI,Pulau Pinang,0,0,0,Eritrea
12357,8/1/2020,ERI,Sabah,0,0,0,Eritrea
12358,8/1/2020,ERI,Selangor,0,0,0,Eritrea
12359,8/1/2020,ESP,Johor,0,0,0,Spain
12360,8/1/2020,ESP,Kedah,0,0,0,Spain
12361,8/1/2020,ESP,Kelantan,0,0,0,Spain
12362,8/1/2020,ESP,Melaka,0,0,0,Spain
12363,8/1/2020,ESP,Negeri Sembilan,0,0,0,Spain
12364,8/1/2020,ESP,Pahang,0,0,0,Spain
12365,8/1/2020,ESP,Perak,0,0,0,Spain
12366,8/1/2020,ESP,Perlis,0,0,0,Spain
12367,8/1/2020,ESP,Pulau Pinang,0,0,0,Spain
12368,8/1/2020,ESP,Sabah,0,0,0,Spain
12369,8/1/2020,ESP,Sarawak,0,0,0,Spain
12370,8/1/2020,ESP,Selangor,19,10,9,Spain
12371,8/1/2020,ESP,W.P. Labuan,0,0,0,Spain
12372,8/1/2020,EST,Johor,0,0,0,Estonia
12373,8/1/2020,EST,Kedah,0,0,0,Estonia
12374,8/1/2020,EST,Kelantan,0,0,0,Estonia
12375,8/1/2020,EST,Pahang,0,0,0,Estonia
12376,8/1/2020,EST,Perak,0,0,0,Estonia
12377,8/1/2020,EST,Perlis,0,0,0,Estonia
12378,8/1/2020,EST,Pulau Pinang,0,0,0,Estonia
12379,8/1/2020,EST,Sabah,0,0,0,Estonia
12380,8/1/2020,EST,Sarawak,0,0,0,Estonia
12381,8/1/2020,EST,Selangor,1,1,0,Estonia
12382,8/1/2020,EST,W.P. Labuan,0,0,0,Estonia
12383,8/1/2020,ETH,Johor,0,0,0,Ethiopia
12384,8/1/2020,ETH,Kedah,0,0,0,Ethiopia
12385,8/1/2020,ETH,Pulau Pinang,0,0,0,Ethiopia
12386,8/1/2020,ETH,Sarawak,0,0,0,Ethiopia
12387,8/1/2020,ETH,Selangor,2,1,1,Ethiopia
12388,8/1/2020,FIN,Johor,0,0,0,Finland
12389,8/1/2020,FIN,Kedah,0,0,0,Finland
12390,8/1/2020,FIN,Kelantan,0,0,0,Finland
12391,8/1/2020,FIN,Melaka,0,0,0,Finland
12392,8/1/2020,FIN,Negeri Sembilan,0,0,0,Finland
12393,8/1/2020,FIN,Pahang,0,0,0,Finland
12394,8/1/2020,FIN,Perak,0,0,0,Finland
12395,8/1/2020,FIN,Perlis,0,0,0,Finland
12396,8/1/2020,FIN,Pulau Pinang,0,0,0,Finland
12397,8/1/2020,FIN,Sabah,0,0,0,Finland
12398,8/1/2020,FIN,Sarawak,0,0,0,Finland
12399,8/1/2020,FIN,Selangor,10,5,5,Finland
12400,8/1/2020,FIN,W.P. Labuan,0,0,0,Finland
12401,8/1/2020,FJI,Johor,0,0,0,Fiji
12402,8/1/2020,FJI,Kedah,0,0,0,Fiji
12403,8/1/2020,FJI,Kelantan,0,0,0,Fiji
12404,8/1/2020,FJI,Perak,0,0,0,Fiji
12405,8/1/2020,FJI,Perlis,0,0,0,Fiji
12406,8/1/2020,FJI,Pulau Pinang,0,0,0,Fiji
12407,8/1/2020,FJI,Sabah,0,0,0,Fiji
12408,8/1/2020,FJI,Sarawak,0,0,0,Fiji
12409,8/1/2020,FJI,Selangor,1,1,0,Fiji
12410,8/1/2020,FRA,Johor,0,0,0,France
12411,8/1/2020,FRA,Kedah,0,0,0,France
12412,8/1/2020,FRA,Kelantan,0,0,0,France
12413,8/1/2020,FRA,Melaka,0,0,0,France
12414,8/1/2020,FRA,Negeri Sembilan,0,0,0,France
12415,8/1/2020,FRA,Pahang,0,0,0,France
12416,8/1/2020,FRA,Perak,0,0,0,France
12417,8/1/2020,FRA,Perlis,0,0,0,France
12418,8/1/2020,FRA,Pulau Pinang,0,0,0,France
12419,8/1/2020,FRA,Sabah,1,1,0,France
12420,8/1/2020,FRA,Sarawak,0,0,0,France
12421,8/1/2020,FRA,Selangor,120,72,48,France
12422,8/1/2020,FRA,Terengganu,0,0,0,France
12423,8/1/2020,FRA,W.P. Labuan,0,0,0,France
12424,8/1/2020,FSM,Johor,0,0,0,"Micronesia, Federated States of"
12425,8/1/2020,FSM,Pulau Pinang,0,0,0,"Micronesia, Federated States of"
12426,8/1/2020,FSM,Selangor,0,0,0,"Micronesia, Federated States of"
12427,8/1/2020,GAB,Johor,0,0,0,Gabon
12428,8/1/2020,GAB,Pulau Pinang,0,0,0,Gabon
12429,8/1/2020,GAB,Sarawak,0,0,0,Gabon
12430,8/1/2020,GAB,Selangor,1,1,0,Gabon
12431,8/1/2020,GBR,Johor,6,5,1,United Kingdom
12432,8/1/2020,GBR,Kedah,0,0,0,United Kingdom
12433,8/1/2020,GBR,Kelantan,0,0,0,United Kingdom
12434,8/1/2020,GBR,Melaka,0,0,0,United Kingdom
12435,8/1/2020,GBR,Negeri Sembilan,0,0,0,United Kingdom
12436,8/1/2020,GBR,Pahang,0,0,0,United Kingdom
12437,8/1/2020,GBR,Perak,1,1,0,United Kingdom
12438,8/1/2020,GBR,Perlis,0,0,0,United Kingdom
12439,8/1/2020,GBR,Pulau Pinang,0,0,0,United Kingdom
12440,8/1/2020,GBR,Sabah,3,1,2,United Kingdom
12441,8/1/2020,GBR,Sarawak,2,0,2,United Kingdom
12442,8/1/2020,GBR,Selangor,353,217,136,United Kingdom
12443,8/1/2020,GBR,Terengganu,0,0,0,United Kingdom
12444,8/1/2020,GBR,W.P. Labuan,0,0,0,United Kingdom
12445,8/1/2020,GEO,Johor,0,0,0,Georgia
12446,8/1/2020,GEO,Kedah,0,0,0,Georgia
12447,8/1/2020,GEO,Melaka,0,0,0,Georgia
12448,8/1/2020,GEO,Perak,0,0,0,Georgia
12449,8/1/2020,GEO,Perlis,0,0,0,Georgia
12450,8/1/2020,GEO,Pulau Pinang,0,0,0,Georgia
12451,8/1/2020,GEO,Sabah,0,0,0,Georgia
12452,8/1/2020,GEO,Sarawak,0,0,0,Georgia
12453,8/1/2020,GEO,Selangor,3,3,0,Georgia
12454,8/1/2020,GHA,Johor,0,0,0,Ghana
12455,8/1/2020,GHA,Kedah,0,0,0,Ghana
12456,8/1/2020,GHA,Kelantan,0,0,0,Ghana
12457,8/1/2020,GHA,Pulau Pinang,0,0,0,Ghana
12458,8/1/2020,GHA,Sabah,0,0,0,Ghana
12459,8/1/2020,GHA,Sarawak,0,0,0,Ghana
12460,8/1/2020,GHA,Selangor,0,0,0,Ghana
12461,8/1/2020,GIB,Johor,0,0,0,Gibraltar
12462,8/1/2020,GIB,Sarawak,0,0,0,Gibraltar
12463,8/1/2020,GIN,Johor,0,0,0,Guinea
12464,8/1/2020,GIN,Kedah,0,0,0,Guinea
12465,8/1/2020,GIN,Kelantan,0,0,0,Guinea
12466,8/1/2020,GIN,Perlis,0,0,0,Guinea
12467,8/1/2020,GIN,Pulau Pinang,0,0,0,Guinea
12468,8/1/2020,GIN,Sabah,0,0,0,Guinea
12469,8/1/2020,GIN,Sarawak,0,0,0,Guinea
12470,8/1/2020,GIN,Selangor,0,0,0,Guinea
12471,8/1/2020,GLP,Selangor,0,0,0,Guadeloupe
12472,8/1/2020,GMB,Johor,0,0,0,Gambia
12473,8/1/2020,GMB,Kedah,0,0,0,Gambia
12474,8/1/2020,GMB,Kelantan,0,0,0,Gambia
12475,8/1/2020,GMB,Pulau Pinang,0,0,0,Gambia
12476,8/1/2020,GMB,Sabah,0,0,0,Gambia
12477,8/1/2020,GMB,Sarawak,0,0,0,Gambia
12478,8/1/2020,GMB,Selangor,0,0,0,Gambia
12479,8/1/2020,GNB,Johor,0,0,0,Guinea-Bissau
12480,8/1/2020,GNB,Selangor,0,0,0,Guinea-Bissau
12481,8/1/2020,GNQ,Johor,0,0,0,Equatorial Guinea
12482,8/1/2020,GNQ,Selangor,0,0,0,Equatorial Guinea
12483,8/1/2020,GRC,Johor,0,0,0,Greece
12484,8/1/2020,GRC,Kedah,0,0,0,Greece
12485,8/1/2020,GRC,Kelantan,0,0,0,Greece
12486,8/1/2020,GRC,Melaka,0,0,0,Greece
12487,8/1/2020,GRC,Negeri Sembilan,0,0,0,Greece
12488,8/1/2020,GRC,Pahang,0,0,0,Greece
12489,8/1/2020,GRC,Perak,0,0,0,Greece
12490,8/1/2020,GRC,Perlis,0,0,0,Greece
12491,8/1/2020,GRC,Pulau Pinang,0,0,0,Greece
12492,8/1/2020,GRC,Sabah,0,0,0,Greece
12493,8/1/2020,GRC,Sarawak,0,0,0,Greece
12494,8/1/2020,GRC,Selangor,15,14,1,Greece
12495,8/1/2020,GRD,Johor,0,0,0,Grenada
12496,8/1/2020,GRD,Kedah,0,0,0,Grenada
12497,8/1/2020,GRD,Pulau Pinang,0,0,0,Grenada
12498,8/1/2020,GRD,Sabah,0,0,0,Grenada
12499,8/1/2020,GRD,Sarawak,0,0,0,Grenada
12500,8/1/2020,GRD,Selangor,0,0,0,Grenada
12501,8/1/2020,GRL,Johor,0,0,0,Greenland
12502,8/1/2020,GRL,Selangor,0,0,0,Greenland
12503,8/1/2020,GTM,Johor,0,0,0,Guatemala
12504,8/1/2020,GTM,Kedah,0,0,0,Guatemala
12505,8/1/2020,GTM,Pahang,0,0,0,Guatemala
12506,8/1/2020,GTM,Perak,0,0,0,Guatemala
12507,8/1/2020,GTM,Pulau Pinang,0,0,0,Guatemala
12508,8/1/2020,GTM,Sabah,0,0,0,Guatemala
12509,8/1/2020,GTM,Sarawak,0,0,0,Guatemala
12510,8/1/2020,GTM,Selangor,0,0,0,Guatemala
12511,8/1/2020,GTM,W.P. Labuan,0,0,0,Guatemala
12512,8/1/2020,GUY,Johor,0,0,0,Guyana
12513,8/1/2020,GUY,Kedah,0,0,0,Guyana
12514,8/1/2020,GUY,Pulau Pinang,0,0,0,Guyana
12515,8/1/2020,GUY,Sarawak,0,0,0,Guyana
12516,8/1/2020,GUY,Selangor,0,0,0,Guyana
12517,8/1/2020,HKG,Johor,0,0,0,Hong Kong
12518,8/1/2020,HKG,Kedah,0,0,0,Hong Kong
12519,8/1/2020,HKG,Kelantan,0,0,0,Hong Kong
12520,8/1/2020,HKG,Pahang,0,0,0,Hong Kong
12521,8/1/2020,HKG,Perak,1,0,1,Hong Kong
12522,8/1/2020,HKG,Perlis,0,0,0,Hong Kong
12523,8/1/2020,HKG,Pulau Pinang,0,0,0,Hong Kong
12524,8/1/2020,HKG,Sabah,0,0,0,Hong Kong
12525,8/1/2020,HKG,Sarawak,1,1,0,Hong Kong
12526,8/1/2020,HKG,Selangor,0,0,0,Hong Kong
12527,8/1/2020,HKG,Terengganu,0,0,0,Hong Kong
12528,8/1/2020,HMD,Johor,0,0,0,Heard Island and McDonald Islands
12529,8/1/2020,HND,Johor,0,0,0,Honduras
12530,8/1/2020,HND,Kedah,0,0,0,Honduras
12531,8/1/2020,HND,Perak,0,0,0,Honduras
12532,8/1/2020,HND,Pulau Pinang,0,0,0,Honduras
12533,8/1/2020,HND,Sabah,0,0,0,Honduras
12534,8/1/2020,HND,Sarawak,0,0,0,Honduras
12535,8/1/2020,HND,Selangor,0,0,0,Honduras
12536,8/1/2020,HRV,Johor,4,4,0,Croatia
12537,8/1/2020,HRV,Kedah,0,0,0,Croatia
12538,8/1/2020,HRV,Kelantan,0,0,0,Croatia
12539,8/1/2020,HRV,Melaka,0,0,0,Croatia
12540,8/1/2020,HRV,Pahang,0,0,0,Croatia
12541,8/1/2020,HRV,Perak,0,0,0,Croatia
12542,8/1/2020,HRV,Perlis,0,0,0,Croatia
12543,8/1/2020,HRV,Pulau Pinang,0,0,0,Croatia
12544,8/1/2020,HRV,Sabah,0,0,0,Croatia
12545,8/1/2020,HRV,Sarawak,0,0,0,Croatia
12546,8/1/2020,HRV,Selangor,20,19,1,Croatia
12547,8/1/2020,HTI,Johor,0,0,0,Haiti
12548,8/1/2020,HTI,Kedah,0,0,0,Haiti
12549,8/1/2020,HTI,Kelantan,0,0,0,Haiti
12550,8/1/2020,HTI,Perak,0,0,0,Haiti
12551,8/1/2020,HTI,Pulau Pinang,0,0,0,Haiti
12552,8/1/2020,HTI,Sabah,0,0,0,Haiti
12553,8/1/2020,HTI,Selangor,0,0,0,Haiti
12554,8/1/2020,HUN,Johor,0,0,0,Hungary
12555,8/1/2020,HUN,Kedah,0,0,0,Hungary
12556,8/1/2020,HUN,Kelantan,0,0,0,Hungary
12557,8/1/2020,HUN,Pahang,0,0,0,Hungary
12558,8/1/2020,HUN,Perak,0,0,0,Hungary
12559,8/1/2020,HUN,Perlis,0,0,0,Hungary
12560,8/1/2020,HUN,Pulau Pinang,0,0,0,Hungary
12561,8/1/2020,HUN,Sabah,0,0,0,Hungary
12562,8/1/2020,HUN,Sarawak,0,0,0,Hungary
12563,8/1/2020,HUN,Selangor,8,5,3,Hungary
12564,8/1/2020,HUN,W.P. Labuan,0,0,0,Hungary
12565,8/1/2020,IDN,Johor,162,139,23,Indonesia
12566,8/1/2020,IDN,Kedah,3,3,0,Indonesia
12567,8/1/2020,IDN,Kelantan,0,0,0,Indonesia
12568,8/1/2020,IDN,Melaka,0,0,0,Indonesia
12569,8/1/2020,IDN,Negeri Sembilan,0,0,0,Indonesia
12570,8/1/2020,IDN,Pahang,0,0,0,Indonesia
12571,8/1/2020,IDN,Perak,0,0,0,Indonesia
12572,8/1/2020,IDN,Perlis,5,4,1,Indonesia
12573,8/1/2020,IDN,Pulau Pinang,5,2,3,Indonesia
12574,8/1/2020,IDN,Sabah,9,3,6,Indonesia
12575,8/1/2020,IDN,Sarawak,516,456,60,Indonesia
12576,8/1/2020,IDN,Selangor,589,351,238,Indonesia
12577,8/1/2020,IDN,Terengganu,0,0,0,Indonesia
12578,8/1/2020,IDN,W.P. Labuan,0,0,0,Indonesia
12579,8/1/2020,IND,Johor,75,74,1,India
12580,8/1/2020,IND,Kedah,0,0,0,India
12581,8/1/2020,IND,Kelantan,0,0,0,India
12582,8/1/2020,IND,Melaka,0,0,0,India
12583,8/1/2020,IND,Negeri Sembilan,0,0,0,India
12584,8/1/2020,IND,Pahang,0,0,0,India
12585,8/1/2020,IND,Perak,0,0,0,India
12586,8/1/2020,IND,Perlis,0,0,0,India
12587,8/1/2020,IND,Pulau Pinang,0,0,0,India
12588,8/1/2020,IND,Sabah,1,0,1,India
12589,8/1/2020,IND,Sarawak,0,0,0,India
12590,8/1/2020,IND,Selangor,689,427,262,India
12591,8/1/2020,IND,Terengganu,0,0,0,India
12592,8/1/2020,IND,W.P. Labuan,0,0,0,India
12593,8/1/2020,IOT,Pulau Pinang,0,0,0,British Indian Ocean Territory
12594,8/1/2020,IOT,Selangor,0,0,0,British Indian Ocean Territory
12595,8/1/2020,IRL,Johor,0,0,0,Ireland
12596,8/1/2020,IRL,Kedah,0,0,0,Ireland
12597,8/1/2020,IRL,Kelantan,0,0,0,Ireland
12598,8/1/2020,IRL,Negeri Sembilan,0,0,0,Ireland
12599,8/1/2020,IRL,Pahang,0,0,0,Ireland
12600,8/1/2020,IRL,Perak,0,0,0,Ireland
12601,8/1/2020,IRL,Perlis,0,0,0,Ireland
12602,8/1/2020,IRL,Pulau Pinang,0,0,0,Ireland
12603,8/1/2020,IRL,Sabah,0,0,0,Ireland
12604,8/1/2020,IRL,Sarawak,0,0,0,Ireland
12605,8/1/2020,IRL,Selangor,22,14,8,Ireland
12606,8/1/2020,IRL,Terengganu,0,0,0,Ireland
12607,8/1/2020,IRL,W.P. Labuan,0,0,0,Ireland
12608,8/1/2020,IRN,Johor,0,0,0,Iran
12609,8/1/2020,IRN,Kedah,0,0,0,Iran
12610,8/1/2020,IRN,Kelantan,0,0,0,Iran
12611,8/1/2020,IRN,Perak,0,0,0,Iran
12612,8/1/2020,IRN,Perlis,0,0,0,Iran
12613,8/1/2020,IRN,Pulau Pinang,0,0,0,Iran
12614,8/1/2020,IRN,Sabah,0,0,0,Iran
12615,8/1/2020,IRN,Sarawak,1,0,1,Iran
12616,8/1/2020,IRN,Selangor,23,10,13,Iran
12617,8/1/2020,IRN,W.P. Labuan,0,0,0,Iran
12618,8/1/2020,IRQ,Johor,0,0,0,Iraq
12619,8/1/2020,IRQ,Kedah,0,0,0,Iraq
12620,8/1/2020,IRQ,Kelantan,0,0,0,Iraq
12621,8/1/2020,IRQ,Melaka,0,0,0,Iraq
12622,8/1/2020,IRQ,Pahang,0,0,0,Iraq
12623,8/1/2020,IRQ,Perak,0,0,0,Iraq
12624,8/1/2020,IRQ,Perlis,0,0,0,Iraq
12625,8/1/2020,IRQ,Pulau Pinang,0,0,0,Iraq
12626,8/1/2020,IRQ,Sabah,0,0,0,Iraq
12627,8/1/2020,IRQ,Sarawak,0,0,0,Iraq
12628,8/1/2020,IRQ,Selangor,10,10,0,Iraq
12629,8/1/2020,ISL,Johor,0,0,0,Iceland
12630,8/1/2020,ISL,Kedah,0,0,0,Iceland
12631,8/1/2020,ISL,Kelantan,0,0,0,Iceland
12632,8/1/2020,ISL,Perak,0,0,0,Iceland
12633,8/1/2020,ISL,Perlis,0,0,0,Iceland
12634,8/1/2020,ISL,Pulau Pinang,0,0,0,Iceland
12635,8/1/2020,ISL,Sabah,0,0,0,Iceland
12636,8/1/2020,ISL,Sarawak,0,0,0,Iceland
12637,8/1/2020,ISL,Selangor,0,0,0,Iceland
12638,8/1/2020,ISL,W.P. Labuan,0,0,0,Iceland
12639,8/1/2020,ISR,Pulau Pinang,0,0,0,Israel
12640,8/1/2020,ITA,Johor,0,0,0,Italy
12641,8/1/2020,ITA,Kedah,0,0,0,Italy
12642,8/1/2020,ITA,Kelantan,0,0,0,Italy
12643,8/1/2020,ITA,Melaka,0,0,0,Italy
12644,8/1/2020,ITA,Negeri Sembilan,0,0,0,Italy
12645,8/1/2020,ITA,Pahang,0,0,0,Italy
12646,8/1/2020,ITA,Perak,1,1,0,Italy
12647,8/1/2020,ITA,Perlis,0,0,0,Italy
12648,8/1/2020,ITA,Pulau Pinang,0,0,0,Italy
12649,8/1/2020,ITA,Sabah,0,0,0,Italy
12650,8/1/2020,ITA,Sarawak,0,0,0,Italy
12651,8/1/2020,ITA,Selangor,17,15,2,Italy
12652,8/1/2020,ITA,W.P. Labuan,0,0,0,Italy
12653,8/1/2020,JAM,Johor,0,0,0,Jamaica
12654,8/1/2020,JAM,Kedah,0,0,0,Jamaica
12655,8/1/2020,JAM,Perak,0,0,0,Jamaica
12656,8/1/2020,JAM,Pulau Pinang,0,0,0,Jamaica
12657,8/1/2020,JAM,Sabah,0,0,0,Jamaica
12658,8/1/2020,JAM,Sarawak,0,0,0,Jamaica
12659,8/1/2020,JAM,Selangor,0,0,0,Jamaica
12660,8/1/2020,JAM,W.P. Labuan,0,0,0,Jamaica
12661,8/1/2020,JOR,Johor,0,0,0,Jordan
12662,8/1/2020,JOR,Kedah,0,0,0,Jordan
12663,8/1/2020,JOR,Kelantan,0,0,0,Jordan
12664,8/1/2020,JOR,Melaka,0,0,0,Jordan
12665,8/1/2020,JOR,Perlis,0,0,0,Jordan
12666,8/1/2020,JOR,Pulau Pinang,0,0,0,Jordan
12667,8/1/2020,JOR,Sabah,1,1,0,Jordan
12668,8/1/2020,JOR,Sarawak,0,0,0,Jordan
12669,8/1/2020,JOR,Selangor,6,4,2,Jordan
12670,8/1/2020,JOR,W.P. Labuan,0,0,0,Jordan
12671,8/1/2020,JPN,Johor,6,6,0,Japan
12672,8/1/2020,JPN,Kedah,1,1,0,Japan
12673,8/1/2020,JPN,Kelantan,0,0,0,Japan
12674,8/1/2020,JPN,Melaka,0,0,0,Japan
12675,8/1/2020,JPN,Negeri Sembilan,0,0,0,Japan
12676,8/1/2020,JPN,Pahang,0,0,0,Japan
12677,8/1/2020,JPN,Perak,0,0,0,Japan
12678,8/1/2020,JPN,Perlis,0,0,0,Japan
12679,8/1/2020,JPN,Pulau Pinang,0,0,0,Japan
12680,8/1/2020,JPN,Sabah,2,1,1,Japan
12681,8/1/2020,JPN,Sarawak,0,0,0,Japan
12682,8/1/2020,JPN,Selangor,408,274,134,Japan
12683,8/1/2020,JPN,W.P. Labuan,0,0,0,Japan
12684,8/1/2020,KAZ,Johor,0,0,0,Kazakhstan
12685,8/1/2020,KAZ,Kedah,0,0,0,Kazakhstan
12686,8/1/2020,KAZ,Kelantan,0,0,0,Kazakhstan
12687,8/1/2020,KAZ,Melaka,0,0,0,Kazakhstan
12688,8/1/2020,KAZ,Perak,0,0,0,Kazakhstan
12689,8/1/2020,KAZ,Perlis,0,0,0,Kazakhstan
12690,8/1/2020,KAZ,Pulau Pinang,0,0,0,Kazakhstan
12691,8/1/2020,KAZ,Sabah,1,0,1,Kazakhstan
12692,8/1/2020,KAZ,Sarawak,0,0,0,Kazakhstan
12693,8/1/2020,KAZ,Selangor,18,10,8,Kazakhstan
12694,8/1/2020,KAZ,W.P. Labuan,0,0,0,Kazakhstan
12695,8/1/2020,KEN,Johor,0,0,0,Kenya
12696,8/1/2020,KEN,Kedah,0,0,0,Kenya
12697,8/1/2020,KEN,Kelantan,0,0,0,Kenya
12698,8/1/2020,KEN,Perak,0,0,0,Kenya
12699,8/1/2020,KEN,Perlis,0,0,0,Kenya
12700,8/1/2020,KEN,Pulau Pinang,0,0,0,Kenya
12701,8/1/2020,KEN,Sabah,0,0,0,Kenya
12702,8/1/2020,KEN,Sarawak,0,0,0,Kenya
12703,8/1/2020,KEN,Selangor,9,3,6,Kenya
12704,8/1/2020,KGZ,Johor,0,0,0,Kyrgyzstan
12705,8/1/2020,KGZ,Kedah,0,0,0,Kyrgyzstan
12706,8/1/2020,KGZ,Kelantan,0,0,0,Kyrgyzstan
12707,8/1/2020,KGZ,Perak,0,0,0,Kyrgyzstan
12708,8/1/2020,KGZ,Perlis,0,0,0,Kyrgyzstan
12709,8/1/2020,KGZ,Pulau Pinang,0,0,0,Kyrgyzstan
12710,8/1/2020,KGZ,Sabah,0,0,0,Kyrgyzstan
12711,8/1/2020,KGZ,Sarawak,0,0,0,Kyrgyzstan
12712,8/1/2020,KGZ,Selangor,1,1,0,Kyrgyzstan
12713,8/1/2020,KHM,Johor,0,0,0,Cambodia
12714,8/1/2020,KHM,Kedah,0,0,0,Cambodia
12715,8/1/2020,KHM,Kelantan,0,0,0,Cambodia
12716,8/1/2020,KHM,Melaka,0,0,0,Cambodia
12717,8/1/2020,KHM,Negeri Sembilan,0,0,0,Cambodia
12718,8/1/2020,KHM,Pahang,0,0,0,Cambodia
12719,8/1/2020,KHM,Perak,0,0,0,Cambodia
12720,8/1/2020,KHM,Perlis,0,0,0,Cambodia
12721,8/1/2020,KHM,Pulau Pinang,0,0,0,Cambodia
12722,8/1/2020,KHM,Sabah,0,0,0,Cambodia
12723,8/1/2020,KHM,Sarawak,0,0,0,Cambodia
12724,8/1/2020,KHM,Selangor,1,0,1,Cambodia
12725,8/1/2020,KHM,W.P. Labuan,0,0,0,Cambodia
12726,8/1/2020,KIR,Johor,0,0,0,Kiribati
12727,8/1/2020,KIR,Sabah,0,0,0,Kiribati
12728,8/1/2020,KIR,Selangor,0,0,0,Kiribati
12729,8/1/2020,KNA,Johor,0,0,0,Saint Kitts and Nevis
12730,8/1/2020,KNA,Kedah,0,0,0,Saint Kitts and Nevis
12731,8/1/2020,KNA,Perlis,0,0,0,Saint Kitts and Nevis
12732,8/1/2020,KNA,Pulau Pinang,0,0,0,Saint Kitts and Nevis
12733,8/1/2020,KNA,Sabah,0,0,0,Saint Kitts and Nevis
12734,8/1/2020,KNA,Selangor,0,0,0,Saint Kitts and Nevis
12735,8/1/2020,KNA,W.P. Labuan,0,0,0,Saint Kitts and Nevis
12736,8/1/2020,KOR,Johor,2,2,0,"Korea, Republic of (South Korea)"
12737,8/1/2020,KOR,Kedah,0,0,0,"Korea, Republic of (South Korea)"
12738,8/1/2020,KOR,Kelantan,0,0,0,"Korea, Republic of (South Korea)"
12739,8/1/2020,KOR,Melaka,0,0,0,"Korea, Republic of (South Korea)"
12740,8/1/2020,KOR,Negeri Sembilan,0,0,0,"Korea, Republic of (South Korea)"
12741,8/1/2020,KOR,Pahang,0,0,0,"Korea, Republic of (South Korea)"
12742,8/1/2020,KOR,Perak,0,0,0,"Korea, Republic of (South Korea)"
12743,8/1/2020,KOR,Perlis,0,0,0,"Korea, Republic of (South Korea)"
12744,8/1/2020,KOR,Pulau Pinang,0,0,0,"Korea, Republic of (South Korea)"
12745,8/1/2020,KOR,Sabah,4,1,3,"Korea, Republic of (South Korea)"
12746,8/1/2020,KOR,Sarawak,2,2,0,"Korea, Republic of (South Korea)"
12747,8/1/2020,KOR,Selangor,358,172,186,"Korea, Republic of (South Korea)"
12748,8/1/2020,KOR,Terengganu,0,0,0,"Korea, Republic of (South Korea)"
12749,8/1/2020,KOR,W.P. Labuan,0,0,0,"Korea, Republic of (South Korea)"
12750,8/1/2020,KWT,Johor,0,0,0,Kuwait
12751,8/1/2020,KWT,Kedah,0,0,0,Kuwait
12752,8/1/2020,KWT,Kelantan,0,0,0,Kuwait
12753,8/1/2020,KWT,Perak,0,0,0,Kuwait
12754,8/1/2020,KWT,Perlis,0,0,0,Kuwait
12755,8/1/2020,KWT,Pulau Pinang,0,0,0,Kuwait
12756,8/1/2020,KWT,Sabah,0,0,0,Kuwait
12757,8/1/2020,KWT,Sarawak,0,0,0,Kuwait
12758,8/1/2020,KWT,Selangor,1,1,0,Kuwait
12759,8/1/2020,KWT,W.P. Labuan,0,0,0,Kuwait
12760,8/1/2020,LAO,Johor,0,0,0,Lao People's Democratic Republic
12761,8/1/2020,LAO,Kedah,0,0,0,Lao People's Democratic Republic
12762,8/1/2020,LAO,Kelantan,0,0,0,Lao People's Democratic Republic
12763,8/1/2020,LAO,Melaka,0,0,0,Lao People's Democratic Republic
12764,8/1/2020,LAO,Perak,0,0,0,Lao People's Democratic Republic
12765,8/1/2020,LAO,Perlis,0,0,0,Lao People's Democratic Republic
12766,8/1/2020,LAO,Pulau Pinang,1,1,0,Lao People's Democratic Republic
12767,8/1/2020,LAO,Sabah,0,0,0,Lao People's Democratic Republic
12768,8/1/2020,LAO,Sarawak,0,0,0,Lao People's Democratic Republic
12769,8/1/2020,LAO,Selangor,0,0,0,Lao People's Democratic Republic
12770,8/1/2020,LAO,W.P. Labuan,0,0,0,Lao People's Democratic Republic
12771,8/1/2020,LBN,Johor,0,0,0,Lebanon
12772,8/1/2020,LBN,Kedah,0,0,0,Lebanon
12773,8/1/2020,LBN,Kelantan,0,0,0,Lebanon
12774,8/1/2020,LBN,Pahang,0,0,0,Lebanon
12775,8/1/2020,LBN,Perak,0,0,0,Lebanon
12776,8/1/2020,LBN,Perlis,0,0,0,Lebanon
12777,8/1/2020,LBN,Pulau Pinang,0,0,0,Lebanon
12778,8/1/2020,LBN,Sabah,0,0,0,Lebanon
12779,8/1/2020,LBN,Sarawak,0,0,0,Lebanon
12780,8/1/2020,LBN,Selangor,0,0,0,Lebanon
12781,8/1/2020,LBN,W.P. Labuan,0,0,0,Lebanon
12782,8/1/2020,LBR,Johor,0,0,0,Liberia
12783,8/1/2020,LBR,Kedah,0,0,0,Liberia
12784,8/1/2020,LBR,Sabah,0,0,0,Liberia
12785,8/1/2020,LBR,Sarawak,0,0,0,Liberia
12786,8/1/2020,LBR,Selangor,0,0,0,Liberia
12787,8/1/2020,LBY,Johor,0,0,0,Libyan Arab Jamahiriya
12788,8/1/2020,LBY,Kedah,0,0,0,Libyan Arab Jamahiriya
12789,8/1/2020,LBY,Perlis,0,0,0,Libyan Arab Jamahiriya
12790,8/1/2020,LBY,Pulau Pinang,0,0,0,Libyan Arab Jamahiriya
12791,8/1/2020,LBY,Sabah,0,0,0,Libyan Arab Jamahiriya
12792,8/1/2020,LBY,Sarawak,0,0,0,Libyan Arab Jamahiriya
12793,8/1/2020,LBY,Selangor,1,1,0,Libyan Arab Jamahiriya
12794,8/1/2020,LCA,Johor,0,0,0,Saint Lucia
12795,8/1/2020,LCA,Kedah,0,0,0,Saint Lucia
12796,8/1/2020,LCA,Pulau Pinang,0,0,0,Saint Lucia
12797,8/1/2020,LCA,Sarawak,0,0,0,Saint Lucia
12798,8/1/2020,LCA,Selangor,0,0,0,Saint Lucia
12799,8/1/2020,LIE,Johor,0,0,0,Liechtenstein
12800,8/1/2020,LIE,Kedah,0,0,0,Liechtenstein
12801,8/1/2020,LIE,Perlis,0,0,0,Liechtenstein
12802,8/1/2020,LIE,Pulau Pinang,0,0,0,Liechtenstein
12803,8/1/2020,LIE,Sabah,0,0,0,Liechtenstein
12804,8/1/2020,LIE,Sarawak,0,0,0,Liechtenstein
12805,8/1/2020,LIE,Selangor,0,0,0,Liechtenstein
12806,8/1/2020,LKA,Johor,1,1,0,Sri Lanka
12807,8/1/2020,LKA,Kedah,0,0,0,Sri Lanka
12808,8/1/2020,LKA,Kelantan,0,0,0,Sri Lanka
12809,8/1/2020,LKA,Melaka,0,0,0,Sri Lanka
12810,8/1/2020,LKA,Pahang,0,0,0,Sri Lanka
12811,8/1/2020,LKA,Perak,0,0,0,Sri Lanka
12812,8/1/2020,LKA,Perlis,0,0,0,Sri Lanka
12813,8/1/2020,LKA,Pulau Pinang,0,0,0,Sri Lanka
12814,8/1/2020,LKA,Sabah,0,0,0,Sri Lanka
12815,8/1/2020,LKA,Sarawak,0,0,0,Sri Lanka
12816,8/1/2020,LKA,Selangor,35,27,8,Sri Lanka
12817,8/1/2020,LKA,W.P. Labuan,0,0,0,Sri Lanka
12818,8/1/2020,LSO,Johor,0,0,0,Lesotho
12819,8/1/2020,LSO,Kedah,0,0,0,Lesotho
12820,8/1/2020,LSO,Pulau Pinang,0,0,0,Lesotho
12821,8/1/2020,LSO,Sarawak,0,0,0,Lesotho
12822,8/1/2020,LSO,Selangor,0,0,0,Lesotho
12823,8/1/2020,LTU,Johor,0,0,0,Lithuania
12824,8/1/2020,LTU,Kedah,0,0,0,Lithuania
12825,8/1/2020,LTU,Kelantan,0,0,0,Lithuania
12826,8/1/2020,LTU,Pahang,0,0,0,Lithuania
12827,8/1/2020,LTU,Perak,0,0,0,Lithuania
12828,8/1/2020,LTU,Perlis,0,0,0,Lithuania
12829,8/1/2020,LTU,Pulau Pinang,0,0,0,Lithuania
12830,8/1/2020,LTU,Sabah,0,0,0,Lithuania
12831,8/1/2020,LTU,Sarawak,0,0,0,Lithuania
12832,8/1/2020,LTU,Selangor,8,8,0,Lithuania
12833,8/1/2020,LTU,W.P. Labuan,0,0,0,Lithuania
12834,8/1/2020,LUX,Johor,0,0,0,Luxembourg
12835,8/1/2020,LUX,Kedah,0,0,0,Luxembourg
12836,8/1/2020,LUX,Kelantan,0,0,0,Luxembourg
12837,8/1/2020,LUX,Perak,0,0,0,Luxembourg
12838,8/1/2020,LUX,Perlis,0,0,0,Luxembourg
12839,8/1/2020,LUX,Pulau Pinang,0,0,0,Luxembourg
12840,8/1/2020,LUX,Sabah,0,0,0,Luxembourg
12841,8/1/2020,LUX,Sarawak,0,0,0,Luxembourg
12842,8/1/2020,LUX,Selangor,0,0,0,Luxembourg
12843,8/1/2020,LVA,Johor,0,0,0,Latvia
12844,8/1/2020,LVA,Kedah,0,0,0,Latvia
12845,8/1/2020,LVA,Kelantan,0,0,0,Latvia
12846,8/1/2020,LVA,Pahang,0,0,0,Latvia
12847,8/1/2020,LVA,Perak,0,0,0,Latvia
12848,8/1/2020,LVA,Perlis,0,0,0,Latvia
12849,8/1/2020,LVA,Pulau Pinang,0,0,0,Latvia
12850,8/1/2020,LVA,Sabah,0,0,0,Latvia
12851,8/1/2020,LVA,Sarawak,0,0,0,Latvia
12852,8/1/2020,LVA,Selangor,6,6,0,Latvia
12853,8/1/2020,LVA,W.P. Labuan,0,0,0,Latvia
12854,8/1/2020,MAC,Johor,0,0,0,Macao
12855,8/1/2020,MAC,Pahang,0,0,0,Macao
12856,8/1/2020,MAC,Perak,0,0,0,Macao
12857,8/1/2020,MAC,Selangor,0,0,0,Macao
12858,8/1/2020,MAC,W.P. Labuan,0,0,0,Macao
12859,8/1/2020,MAR,Johor,0,0,0,Morocco
12860,8/1/2020,MAR,Kedah,0,0,0,Morocco
12861,8/1/2020,MAR,Kelantan,0,0,0,Morocco
12862,8/1/2020,MAR,Melaka,0,0,0,Morocco
12863,8/1/2020,MAR,Pahang,0,0,0,Morocco
12864,8/1/2020,MAR,Perak,0,0,0,Morocco
12865,8/1/2020,MAR,Perlis,0,0,0,Morocco
12866,8/1/2020,MAR,Pulau Pinang,0,0,0,Morocco
12867,8/1/2020,MAR,Sabah,0,0,0,Morocco
12868,8/1/2020,MAR,Sarawak,0,0,0,Morocco
12869,8/1/2020,MAR,Selangor,0,0,0,Morocco
12870,8/1/2020,MAR,W.P. Labuan,0,0,0,Morocco
12871,8/1/2020,MCO,Johor,0,0,0,Monaco
12872,8/1/2020,MCO,Kedah,0,0,0,Monaco
12873,8/1/2020,MCO,Sabah,0,0,0,Monaco
12874,8/1/2020,MCO,Selangor,0,0,0,Monaco
12875,8/1/2020,MDA,Johor,0,0,0,"Moldova, Republic of"
12876,8/1/2020,MDA,Kedah,0,0,0,"Moldova, Republic of"
12877,8/1/2020,MDA,Kelantan,0,0,0,"Moldova, Republic of"
12878,8/1/2020,MDA,Negeri Sembilan,0,0,0,"Moldova, Republic of"
12879,8/1/2020,MDA,Perlis,0,0,0,"Moldova, Republic of"
12880,8/1/2020,MDA,Pulau Pinang,0,0,0,"Moldova, Republic of"
12881,8/1/2020,MDA,Sabah,0,0,0,"Moldova, Republic of"
12882,8/1/2020,MDA,Sarawak,0,0,0,"Moldova, Republic of"
12883,8/1/2020,MDA,Selangor,0,0,0,"Moldova, Republic of"
12884,8/1/2020,MDG,Johor,0,0,0,Madagascar
12885,8/1/2020,MDG,Kedah,0,0,0,Madagascar
12886,8/1/2020,MDG,Perak,0,0,0,Madagascar
12887,8/1/2020,MDG,Perlis,0,0,0,Madagascar
12888,8/1/2020,MDG,Pulau Pinang,0,0,0,Madagascar
12889,8/1/2020,MDG,Sabah,0,0,0,Madagascar
12890,8/1/2020,MDG,Sarawak,0,0,0,Madagascar
12891,8/1/2020,MDG,Selangor,0,0,0,Madagascar
12892,8/1/2020,MDV,Johor,0,0,0,Maldives
12893,8/1/2020,MDV,Kedah,0,0,0,Maldives
12894,8/1/2020,MDV,Kelantan,0,0,0,Maldives
12895,8/1/2020,MDV,Perak,0,0,0,Maldives
12896,8/1/2020,MDV,Perlis,0,0,0,Maldives
12897,8/1/2020,MDV,Pulau Pinang,0,0,0,Maldives
12898,8/1/2020,MDV,Sabah,0,0,0,Maldives
12899,8/1/2020,MDV,Sarawak,0,0,0,Maldives
12900,8/1/2020,MDV,Selangor,54,22,32,Maldives
12901,8/1/2020,MEX,Johor,10,10,0,Mexico
12902,8/1/2020,MEX,Kedah,0,0,0,Mexico
12903,8/1/2020,MEX,Kelantan,0,0,0,Mexico
12904,8/1/2020,MEX,Pahang,0,0,0,Mexico
12905,8/1/2020,MEX,Perak,0,0,0,Mexico
12906,8/1/2020,MEX,Perlis,0,0,0,Mexico
12907,8/1/2020,MEX,Pulau Pinang,0,0,0,Mexico
12908,8/1/2020,MEX,Sabah,0,0,0,Mexico
12909,8/1/2020,MEX,Sarawak,0,0,0,Mexico
12910,8/1/2020,MEX,Selangor,72,6,66,Mexico
12911,8/1/2020,MEX,W.P. Labuan,0,0,0,Mexico
12912,8/1/2020,MHL,Johor,0,0,0,Marshall Islands
12913,8/1/2020,MHL,Kedah,0,0,0,Marshall Islands
12914,8/1/2020,MHL,Perak,0,0,0,Marshall Islands
12915,8/1/2020,MHL,Pulau Pinang,0,0,0,Marshall Islands
12916,8/1/2020,MHL,Sabah,0,0,0,Marshall Islands
12917,8/1/2020,MHL,Selangor,0,0,0,Marshall Islands
12918,8/1/2020,MKD,Johor,0,0,0,"Macedonia, the former Yugoslav Republic of"
12919,8/1/2020,MKD,Kedah,0,0,0,"Macedonia, the former Yugoslav Republic of"
12920,8/1/2020,MKD,Perak,0,0,0,"Macedonia, the former Yugoslav Republic of"
12921,8/1/2020,MKD,Pulau Pinang,0,0,0,"Macedonia, the former Yugoslav Republic of"
12922,8/1/2020,MKD,Sabah,0,0,0,"Macedonia, the former Yugoslav Republic of"
12923,8/1/2020,MKD,Sarawak,0,0,0,"Macedonia, the former Yugoslav Republic of"
12924,8/1/2020,MKD,Selangor,0,0,0,"Macedonia, the former Yugoslav Republic of"
12925,8/1/2020,MLI,Johor,0,0,0,Mali
12926,8/1/2020,MLI,Sabah,0,0,0,Mali
12927,8/1/2020,MLI,Selangor,0,0,0,Mali
12928,8/1/2020,MLT,Johor,0,0,0,Malta
12929,8/1/2020,MLT,Kedah,0,0,0,Malta
12930,8/1/2020,MLT,Kelantan,0,0,0,Malta
12931,8/1/2020,MLT,Perak,0,0,0,Malta
12932,8/1/2020,MLT,Perlis,0,0,0,Malta
12933,8/1/2020,MLT,Pulau Pinang,0,0,0,Malta
12934,8/1/2020,MLT,Sabah,0,0,0,Malta
12935,8/1/2020,MLT,Sarawak,0,0,0,Malta
12936,8/1/2020,MLT,Selangor,4,4,0,Malta
12937,8/1/2020,MLT,W.P. Labuan,0,0,0,Malta
12938,8/1/2020,MMR,Johor,13,13,0,Myanmar
12939,8/1/2020,MMR,Kedah,0,0,0,Myanmar
12940,8/1/2020,MMR,Kelantan,0,0,0,Myanmar
12941,8/1/2020,MMR,Negeri Sembilan,0,0,0,Myanmar
12942,8/1/2020,MMR,Pahang,0,0,0,Myanmar
12943,8/1/2020,MMR,Perak,0,0,0,Myanmar
12944,8/1/2020,MMR,Perlis,0,0,0,Myanmar
12945,8/1/2020,MMR,Pulau Pinang,0,0,0,Myanmar
12946,8/1/2020,MMR,Sabah,1,0,1,Myanmar
12947,8/1/2020,MMR,Sarawak,0,0,0,Myanmar
12948,8/1/2020,MMR,Selangor,82,73,9,Myanmar
12949,8/1/2020,MMR,Terengganu,0,0,0,Myanmar
12950,8/1/2020,MMR,W.P. Labuan,0,0,0,Myanmar
12951,8/1/2020,MNE,Johor,0,0,0,Montenegro
12952,8/1/2020,MNE,Kedah,0,0,0,Montenegro
12953,8/1/2020,MNE,Pulau Pinang,0,0,0,Montenegro
12954,8/1/2020,MNE,Sabah,0,0,0,Montenegro
12955,8/1/2020,MNE,Sarawak,0,0,0,Montenegro
12956,8/1/2020,MNE,Selangor,1,1,0,Montenegro
12957,8/1/2020,MNG,Johor,0,0,0,Mongolia
12958,8/1/2020,MNG,Kedah,0,0,0,Mongolia
12959,8/1/2020,MNG,Kelantan,0,0,0,Mongolia
12960,8/1/2020,MNG,Perak,0,0,0,Mongolia
12961,8/1/2020,MNG,Perlis,0,0,0,Mongolia
12962,8/1/2020,MNG,Pulau Pinang,0,0,0,Mongolia
12963,8/1/2020,MNG,Sabah,0,0,0,Mongolia
12964,8/1/2020,MNG,Sarawak,0,0,0,Mongolia
12965,8/1/2020,MNG,Selangor,3,0,3,Mongolia
12966,8/1/2020,MNP,Selangor,0,0,0,Northern Mariana Islands
12967,8/1/2020,MOZ,Johor,0,0,0,Mozambique
12968,8/1/2020,MOZ,Kedah,0,0,0,Mozambique
12969,8/1/2020,MOZ,Perak,0,0,0,Mozambique
12970,8/1/2020,MOZ,Pulau Pinang,0,0,0,Mozambique
12971,8/1/2020,MOZ,Sabah,0,0,0,Mozambique
12972,8/1/2020,MOZ,Sarawak,0,0,0,Mozambique
12973,8/1/2020,MOZ,Selangor,0,0,0,Mozambique
12974,8/1/2020,MRT,Johor,0,0,0,Mauritania
12975,8/1/2020,MRT,Kedah,0,0,0,Mauritania
12976,8/1/2020,MRT,Pulau Pinang,0,0,0,Mauritania
12977,8/1/2020,MRT,Sabah,0,0,0,Mauritania
12978,8/1/2020,MRT,Sarawak,0,0,0,Mauritania
12979,8/1/2020,MRT,Selangor,0,0,0,Mauritania
12980,8/1/2020,MUS,Johor,0,0,0,Mauritius
12981,8/1/2020,MUS,Kedah,0,0,0,Mauritius
12982,8/1/2020,MUS,Kelantan,0,0,0,Mauritius
12983,8/1/2020,MUS,Pahang,0,0,0,Mauritius
12984,8/1/2020,MUS,Perak,0,0,0,Mauritius
12985,8/1/2020,MUS,Perlis,0,0,0,Mauritius
12986,8/1/2020,MUS,Pulau Pinang,0,0,0,Mauritius
12987,8/1/2020,MUS,Sabah,0,0,0,Mauritius
12988,8/1/2020,MUS,Sarawak,0,0,0,Mauritius
12989,8/1/2020,MUS,Selangor,1,0,1,Mauritius
12990,8/1/2020,MWI,Johor,0,0,0,Malawi
12991,8/1/2020,MWI,Pulau Pinang,0,0,0,Malawi
12992,8/1/2020,MWI,Sabah,0,0,0,Malawi
12993,8/1/2020,MWI,Sarawak,0,0,0,Malawi
12994,8/1/2020,MWI,Selangor,0,0,0,Malawi
12995,8/1/2020,MYT,Selangor,0,0,0,Mayotte
12996,8/1/2020,NAM,Johor,0,0,0,Namibia
12997,8/1/2020,NAM,Kedah,0,0,0,Namibia
12998,8/1/2020,NAM,Perak,0,0,0,Namibia
12999,8/1/2020,NAM,Perlis,0,0,0,Namibia
13000,8/1/2020,NAM,Pulau Pinang,0,0,0,Namibia
13001,8/1/2020,NAM,Sabah,0,0,0,Namibia
13002,8/1/2020,NAM,Sarawak,0,0,0,Namibia
13003,8/1/2020,NAM,Selangor,0,0,0,Namibia
13004,8/1/2020,NCL,Selangor,0,0,0,New Caledonia
13005,8/1/2020,NER,Johor,0,0,0,Niger
13006,8/1/2020,NER,Sabah,0,0,0,Niger
13007,8/1/2020,NER,Selangor,0,0,0,Niger
13008,8/1/2020,NGA,Johor,0,0,0,Nigeria
13009,8/1/2020,NGA,Kedah,0,0,0,Nigeria
13010,8/1/2020,NGA,Perlis,0,0,0,Nigeria
13011,8/1/2020,NGA,Pulau Pinang,0,0,0,Nigeria
13012,8/1/2020,NGA,Sabah,0,0,0,Nigeria
13013,8/1/2020,NGA,Sarawak,0,0,0,Nigeria
13014,8/1/2020,NGA,Selangor,10,3,7,Nigeria
13015,8/1/2020,NIC,Johor,0,0,0,Nicaragua
13016,8/1/2020,NIC,Kedah,0,0,0,Nicaragua
13017,8/1/2020,NIC,Pulau Pinang,0,0,0,Nicaragua
13018,8/1/2020,NIC,Sabah,0,0,0,Nicaragua
13019,8/1/2020,NIC,Selangor,0,0,0,Nicaragua
13020,8/1/2020,NLD,Johor,1,1,0,Netherlands
13021,8/1/2020,NLD,Kedah,0,0,0,Netherlands
13022,8/1/2020,NLD,Kelantan,0,0,0,Netherlands
13023,8/1/2020,NLD,Melaka,0,0,0,Netherlands
13024,8/1/2020,NLD,Negeri Sembilan,0,0,0,Netherlands
13025,8/1/2020,NLD,Pahang,0,0,0,Netherlands
13026,8/1/2020,NLD,Perak,0,0,0,Netherlands
13027,8/1/2020,NLD,Perlis,0,0,0,Netherlands
13028,8/1/2020,NLD,Pulau Pinang,0,0,0,Netherlands
13029,8/1/2020,NLD,Sabah,0,0,0,Netherlands
13030,8/1/2020,NLD,Sarawak,0,0,0,Netherlands
13031,8/1/2020,NLD,Selangor,46,37,9,Netherlands
13032,8/1/2020,NLD,Terengganu,0,0,0,Netherlands
13033,8/1/2020,NLD,W.P. Labuan,0,0,0,Netherlands
13034,8/1/2020,NOR,Johor,3,3,0,Norway
13035,8/1/2020,NOR,Kedah,0,0,0,Norway
13036,8/1/2020,NOR,Kelantan,0,0,0,Norway
13037,8/1/2020,NOR,Melaka,0,0,0,Norway
13038,8/1/2020,NOR,Pahang,0,0,0,Norway
13039,8/1/2020,NOR,Perak,0,0,0,Norway
13040,8/1/2020,NOR,Perlis,0,0,0,Norway
13041,8/1/2020,NOR,Pulau Pinang,0,0,0,Norway
13042,8/1/2020,NOR,Sabah,1,0,1,Norway
13043,8/1/2020,NOR,Sarawak,0,0,0,Norway
13044,8/1/2020,NOR,Selangor,19,17,2,Norway
13045,8/1/2020,NOR,W.P. Labuan,0,0,0,Norway
13046,8/1/2020,NPL,Johor,0,0,0,Nepal
13047,8/1/2020,NPL,Kedah,0,0,0,Nepal
13048,8/1/2020,NPL,Pahang,0,0,0,Nepal
13049,8/1/2020,NPL,Perak,0,0,0,Nepal
13050,8/1/2020,NPL,Perlis,0,0,0,Nepal
13051,8/1/2020,NPL,Pulau Pinang,0,0,0,Nepal
13052,8/1/2020,NPL,Sabah,0,0,0,Nepal
13053,8/1/2020,NPL,Sarawak,0,0,0,Nepal
13054,8/1/2020,NPL,Selangor,7,5,2,Nepal
13055,8/1/2020,NPL,W.P. Labuan,0,0,0,Nepal
13056,8/1/2020,NRU,Johor,0,0,0,Nauru
13057,8/1/2020,NRU,Pulau Pinang,0,0,0,Nauru
13058,8/1/2020,NRU,Selangor,0,0,0,Nauru
13059,8/1/2020,NZL,Johor,0,0,0,New Zealand
13060,8/1/2020,NZL,Kedah,0,0,0,New Zealand
13061,8/1/2020,NZL,Kelantan,0,0,0,New Zealand
13062,8/1/2020,NZL,Melaka,0,0,0,New Zealand
13063,8/1/2020,NZL,Negeri Sembilan,0,0,0,New Zealand
13064,8/1/2020,NZL,Pahang,0,0,0,New Zealand
13065,8/1/2020,NZL,Perak,0,0,0,New Zealand
13066,8/1/2020,NZL,Perlis,0,0,0,New Zealand
13067,8/1/2020,NZL,Pulau Pinang,0,0,0,New Zealand
13068,8/1/2020,NZL,Sabah,0,0,0,New Zealand
13069,8/1/2020,NZL,Sarawak,0,0,0,New Zealand
13070,8/1/2020,NZL,Selangor,117,107,10,New Zealand
13071,8/1/2020,NZL,Terengganu,0,0,0,New Zealand
13072,8/1/2020,NZL,W.P. Labuan,0,0,0,New Zealand
13073,8/1/2020,OMN,Johor,0,0,0,Oman
13074,8/1/2020,OMN,Kedah,0,0,0,Oman
13075,8/1/2020,OMN,Kelantan,0,0,0,Oman
13076,8/1/2020,OMN,Melaka,0,0,0,Oman
13077,8/1/2020,OMN,Perak,0,0,0,Oman
13078,8/1/2020,OMN,Perlis,0,0,0,Oman
13079,8/1/2020,OMN,Pulau Pinang,0,0,0,Oman
13080,8/1/2020,OMN,Sabah,0,0,0,Oman
13081,8/1/2020,OMN,Sarawak,0,0,0,Oman
13082,8/1/2020,OMN,Selangor,9,5,4,Oman
13083,8/1/2020,PAK,Johor,0,0,0,Pakistan
13084,8/1/2020,PAK,Kedah,0,0,0,Pakistan
13085,8/1/2020,PAK,Kelantan,0,0,0,Pakistan
13086,8/1/2020,PAK,Melaka,0,0,0,Pakistan
13087,8/1/2020,PAK,Negeri Sembilan,0,0,0,Pakistan
13088,8/1/2020,PAK,Pahang,0,0,0,Pakistan
13089,8/1/2020,PAK,Perak,0,0,0,Pakistan
13090,8/1/2020,PAK,Perlis,0,0,0,Pakistan
13091,8/1/2020,PAK,Pulau Pinang,0,0,0,Pakistan
13092,8/1/2020,PAK,Sabah,1,1,0,Pakistan
13093,8/1/2020,PAK,Sarawak,0,0,0,Pakistan
13094,8/1/2020,PAK,Selangor,175,150,25,Pakistan
13095,8/1/2020,PAK,W.P. Labuan,0,0,0,Pakistan
13096,8/1/2020,PAN,Johor,0,0,0,Panama
13097,8/1/2020,PAN,Kedah,0,0,0,Panama
13098,8/1/2020,PAN,Perak,0,0,0,Panama
13099,8/1/2020,PAN,Perlis,0,0,0,Panama
13100,8/1/2020,PAN,Pulau Pinang,0,0,0,Panama
13101,8/1/2020,PAN,Sabah,0,0,0,Panama
13102,8/1/2020,PAN,Sarawak,0,0,0,Panama
13103,8/1/2020,PAN,Selangor,0,0,0,Panama
13104,8/1/2020,PER,Johor,0,0,0,Peru
13105,8/1/2020,PER,Kedah,0,0,0,Peru
13106,8/1/2020,PER,Kelantan,0,0,0,Peru
13107,8/1/2020,PER,Pahang,0,0,0,Peru
13108,8/1/2020,PER,Perak,0,0,0,Peru
13109,8/1/2020,PER,Perlis,0,0,0,Peru
13110,8/1/2020,PER,Pulau Pinang,0,0,0,Peru
13111,8/1/2020,PER,Sabah,0,0,0,Peru
13112,8/1/2020,PER,Sarawak,0,0,0,Peru
13113,8/1/2020,PER,Selangor,5,2,3,Peru
13114,8/1/2020,PER,W.P. Labuan,0,0,0,Peru
13115,8/1/2020,PHL,Johor,69,66,3,Philippines
13116,8/1/2020,PHL,Kedah,0,0,0,Philippines
13117,8/1/2020,PHL,Kelantan,0,0,0,Philippines
13118,8/1/2020,PHL,Melaka,0,0,0,Philippines
13119,8/1/2020,PHL,Negeri Sembilan,0,0,0,Philippines
13120,8/1/2020,PHL,Pahang,0,0,0,Philippines
13121,8/1/2020,PHL,Perak,0,0,0,Philippines
13122,8/1/2020,PHL,Perlis,0,0,0,Philippines
13123,8/1/2020,PHL,Pulau Pinang,1,0,1,Philippines
13124,8/1/2020,PHL,Sabah,3,2,1,Philippines
13125,8/1/2020,PHL,Sarawak,39,38,1,Philippines
13126,8/1/2020,PHL,Selangor,312,271,41,Philippines
13127,8/1/2020,PHL,Terengganu,0,0,0,Philippines
13128,8/1/2020,PHL,W.P. Labuan,4,4,0,Philippines
13129,8/1/2020,PLW,Johor,0,0,0,Palau
13130,8/1/2020,PLW,Pulau Pinang,0,0,0,Palau
13131,8/1/2020,PLW,Selangor,0,0,0,Palau
13132,8/1/2020,PNG,Johor,0,0,0,Papua New Guinea
13133,8/1/2020,PNG,Kedah,0,0,0,Papua New Guinea
13134,8/1/2020,PNG,Kelantan,0,0,0,Papua New Guinea
13135,8/1/2020,PNG,Perak,0,0,0,Papua New Guinea
13136,8/1/2020,PNG,Pulau Pinang,0,0,0,Papua New Guinea
13137,8/1/2020,PNG,Sabah,0,0,0,Papua New Guinea
13138,8/1/2020,PNG,Sarawak,0,0,0,Papua New Guinea
13139,8/1/2020,PNG,Selangor,0,0,0,Papua New Guinea
13140,8/1/2020,POL,Johor,0,0,0,Poland
13141,8/1/2020,POL,Kedah,0,0,0,Poland
13142,8/1/2020,POL,Kelantan,0,0,0,Poland
13143,8/1/2020,POL,Melaka,0,0,0,Poland
13144,8/1/2020,POL,Negeri Sembilan,0,0,0,Poland
13145,8/1/2020,POL,Pahang,0,0,0,Poland
13146,8/1/2020,POL,Perak,0,0,0,Poland
13147,8/1/2020,POL,Perlis,0,0,0,Poland
13148,8/1/2020,POL,Pulau Pinang,0,0,0,Poland
13149,8/1/2020,POL,Sabah,0,0,0,Poland
13150,8/1/2020,POL,Sarawak,0,0,0,Poland
13151,8/1/2020,POL,Selangor,23,18,5,Poland
13152,8/1/2020,POL,Terengganu,0,0,0,Poland
13153,8/1/2020,POL,W.P. Labuan,0,0,0,Poland
13154,8/1/2020,PRK,Selangor,0,0,0,"Korea, Democratic People's Republic of"
13155,8/1/2020,PRT,Johor,0,0,0,Portugal
13156,8/1/2020,PRT,Kedah,0,0,0,Portugal
13157,8/1/2020,PRT,Kelantan,0,0,0,Portugal
13158,8/1/2020,PRT,Melaka,0,0,0,Portugal
13159,8/1/2020,PRT,Pahang,0,0,0,Portugal
13160,8/1/2020,PRT,Perak,0,0,0,Portugal
13161,8/1/2020,PRT,Perlis,0,0,0,Portugal
13162,8/1/2020,PRT,Pulau Pinang,0,0,0,Portugal
13163,8/1/2020,PRT,Sabah,0,0,0,Portugal
13164,8/1/2020,PRT,Sarawak,0,0,0,Portugal
13165,8/1/2020,PRT,Selangor,6,4,2,Portugal
13166,8/1/2020,PRT,W.P. Labuan,0,0,0,Portugal
13167,8/1/2020,PRY,Johor,0,0,0,Paraguay
13168,8/1/2020,PRY,Kedah,0,0,0,Paraguay
13169,8/1/2020,PRY,Perak,0,0,0,Paraguay
13170,8/1/2020,PRY,Perlis,0,0,0,Paraguay
13171,8/1/2020,PRY,Pulau Pinang,0,0,0,Paraguay
13172,8/1/2020,PRY,Sabah,0,0,0,Paraguay
13173,8/1/2020,PRY,Sarawak,0,0,0,Paraguay
13174,8/1/2020,PRY,Selangor,0,0,0,Paraguay
13175,8/1/2020,PSE,Johor,0,0,0,"Palestinian Territory, Occupied"
13176,8/1/2020,PSE,Kedah,0,0,0,"Palestinian Territory, Occupied"
13177,8/1/2020,PSE,Kelantan,0,0,0,"Palestinian Territory, Occupied"
13178,8/1/2020,PSE,Melaka,0,0,0,"Palestinian Territory, Occupied"
13179,8/1/2020,PSE,Perak,0,0,0,"Palestinian Territory, Occupied"
13180,8/1/2020,PSE,Perlis,0,0,0,"Palestinian Territory, Occupied"
13181,8/1/2020,PSE,Pulau Pinang,0,0,0,"Palestinian Territory, Occupied"
13182,8/1/2020,PSE,Sabah,0,0,0,"Palestinian Territory, Occupied"
13183,8/1/2020,PSE,Sarawak,0,0,0,"Palestinian Territory, Occupied"
13184,8/1/2020,PSE,Selangor,6,6,0,"Palestinian Territory, Occupied"
13185,8/1/2020,QAT,Johor,0,0,0,Qatar
13186,8/1/2020,QAT,Kedah,0,0,0,Qatar
13187,8/1/2020,QAT,Perlis,0,0,0,Qatar
13188,8/1/2020,QAT,Pulau Pinang,0,0,0,Qatar
13189,8/1/2020,QAT,Sabah,0,0,0,Qatar
13190,8/1/2020,QAT,Sarawak,0,0,0,Qatar
13191,8/1/2020,QAT,Selangor,1,1,0,Qatar
13192,8/1/2020,REU,Johor,0,0,0,Reunion
13193,8/1/2020,REU,Sarawak,0,0,0,Reunion
13194,8/1/2020,ROU,Johor,0,0,0,Romania
13195,8/1/2020,ROU,Kedah,0,0,0,Romania
13196,8/1/2020,ROU,Kelantan,0,0,0,Romania
13197,8/1/2020,ROU,Negeri Sembilan,0,0,0,Romania
13198,8/1/2020,ROU,Pahang,0,0,0,Romania
13199,8/1/2020,ROU,Perak,0,0,0,Romania
13200,8/1/2020,ROU,Perlis,0,0,0,Romania
13201,8/1/2020,ROU,Pulau Pinang,1,1,0,Romania
13202,8/1/2020,ROU,Sabah,0,0,0,Romania
13203,8/1/2020,ROU,Sarawak,0,0,0,Romania
13204,8/1/2020,ROU,Selangor,16,14,2,Romania
13205,8/1/2020,ROU,W.P. Labuan,0,0,0,Romania
13206,8/1/2020,RUS,Johor,6,6,0,Russia
13207,8/1/2020,RUS,Kedah,0,0,0,Russia
13208,8/1/2020,RUS,Kelantan,0,0,0,Russia
13209,8/1/2020,RUS,Melaka,0,0,0,Russia
13210,8/1/2020,RUS,Negeri Sembilan,0,0,0,Russia
13211,8/1/2020,RUS,Pahang,0,0,0,Russia
13212,8/1/2020,RUS,Perak,0,0,0,Russia
13213,8/1/2020,RUS,Perlis,0,0,0,Russia
13214,8/1/2020,RUS,Pulau Pinang,2,2,0,Russia
13215,8/1/2020,RUS,Sabah,3,3,0,Russia
13216,8/1/2020,RUS,Sarawak,1,0,1,Russia
13217,8/1/2020,RUS,Selangor,100,83,17,Russia
13218,8/1/2020,RUS,W.P. Labuan,0,0,0,Russia
13219,8/1/2020,RWA,Johor,0,0,0,Rwanda
13220,8/1/2020,RWA,Kedah,0,0,0,Rwanda
13221,8/1/2020,RWA,Pulau Pinang,0,0,0,Rwanda
13222,8/1/2020,RWA,Selangor,0,0,0,Rwanda
13223,8/1/2020,SAU,Johor,0,0,0,Saudi Arabia
13224,8/1/2020,SAU,Kedah,0,0,0,Saudi Arabia
13225,8/1/2020,SAU,Kelantan,0,0,0,Saudi Arabia
13226,8/1/2020,SAU,Melaka,0,0,0,Saudi Arabia
13227,8/1/2020,SAU,Perak,0,0,0,Saudi Arabia
13228,8/1/2020,SAU,Perlis,0,0,0,Saudi Arabia
13229,8/1/2020,SAU,Pulau Pinang,0,0,0,Saudi Arabia
13230,8/1/2020,SAU,Sabah,0,0,0,Saudi Arabia
13231,8/1/2020,SAU,Sarawak,0,0,0,Saudi Arabia
13232,8/1/2020,SAU,Selangor,9,5,4,Saudi Arabia
13233,8/1/2020,SAU,W.P. Labuan,0,0,0,Saudi Arabia
13234,8/1/2020,SDN,Johor,0,0,0,Sudan
13235,8/1/2020,SDN,Kedah,0,0,0,Sudan
13236,8/1/2020,SDN,Kelantan,0,0,0,Sudan
13237,8/1/2020,SDN,Perlis,0,0,0,Sudan
13238,8/1/2020,SDN,Pulau Pinang,0,0,0,Sudan
13239,8/1/2020,SDN,Sabah,0,0,0,Sudan
13240,8/1/2020,SDN,Sarawak,0,0,0,Sudan
13241,8/1/2020,SDN,Selangor,13,11,2,Sudan
13242,8/1/2020,SDN,W.P. Labuan,0,0,0,Sudan
13243,8/1/2020,SEN,Johor,0,0,0,Senegal
13244,8/1/2020,SEN,Kedah,0,0,0,Senegal
13245,8/1/2020,SEN,Kelantan,0,0,0,Senegal
13246,8/1/2020,SEN,Perak,0,0,0,Senegal
13247,8/1/2020,SEN,Perlis,0,0,0,Senegal
13248,8/1/2020,SEN,Pulau Pinang,0,0,0,Senegal
13249,8/1/2020,SEN,Sabah,0,0,0,Senegal
13250,8/1/2020,SEN,Sarawak,0,0,0,Senegal
13251,8/1/2020,SEN,Selangor,5,3,2,Senegal
13252,8/1/2020,SGP,Johor,328,288,40,Singapore
13253,8/1/2020,SGP,Kedah,2,2,0,Singapore
13254,8/1/2020,SGP,Kelantan,0,0,0,Singapore
13255,8/1/2020,SGP,Melaka,0,0,0,Singapore
13256,8/1/2020,SGP,Negeri Sembilan,0,0,0,Singapore
13257,8/1/2020,SGP,Pahang,0,0,0,Singapore
13258,8/1/2020,SGP,Perak,1,1,0,Singapore
13259,8/1/2020,SGP,Perlis,0,0,0,Singapore
13260,8/1/2020,SGP,Pulau Pinang,14,8,6,Singapore
13261,8/1/2020,SGP,Sabah,0,0,0,Singapore
13262,8/1/2020,SGP,Sarawak,8,3,5,Singapore
13263,8/1/2020,SGP,Selangor,161,115,46,Singapore
13264,8/1/2020,SGP,Terengganu,0,0,0,Singapore
13265,8/1/2020,SGP,W.P. Labuan,0,0,0,Singapore
13266,8/1/2020,SGS,Johor,0,0,0,South Georgia and the South Sandwich Islands
13267,8/1/2020,SGS,Sabah,0,0,0,South Georgia and the South Sandwich Islands
13268,8/1/2020,SGS,Selangor,0,0,0,South Georgia and the South Sandwich Islands
13269,8/1/2020,SHN,Sarawak,0,0,0,"Saint Helena, Ascension and Tristan da Cunha"
13270,8/1/2020,SLB,Johor,0,0,0,Solomon Islands
13271,8/1/2020,SLB,Perlis,0,0,0,Solomon Islands
13272,8/1/2020,SLB,Pulau Pinang,0,0,0,Solomon Islands
13273,8/1/2020,SLB,Sabah,0,0,0,Solomon Islands
13274,8/1/2020,SLB,Sarawak,0,0,0,Solomon Islands
13275,8/1/2020,SLB,Selangor,0,0,0,Solomon Islands
13276,8/1/2020,SLB,W.P. Labuan,0,0,0,Solomon Islands
13277,8/1/2020,SLE,Johor,0,0,0,Sierra Leone
13278,8/1/2020,SLE,Kedah,0,0,0,Sierra Leone
13279,8/1/2020,SLE,Perak,0,0,0,Sierra Leone
13280,8/1/2020,SLE,Pulau Pinang,0,0,0,Sierra Leone
13281,8/1/2020,SLE,Sabah,0,0,0,Sierra Leone
13282,8/1/2020,SLE,Selangor,0,0,0,Sierra Leone
13283,8/1/2020,SLV,Johor,0,0,0,El Salvador
13284,8/1/2020,SLV,Kedah,0,0,0,El Salvador
13285,8/1/2020,SLV,Perak,0,0,0,El Salvador
13286,8/1/2020,SLV,Perlis,0,0,0,El Salvador
13287,8/1/2020,SLV,Pulau Pinang,0,0,0,El Salvador
13288,8/1/2020,SLV,Sabah,0,0,0,El Salvador
13289,8/1/2020,SLV,Selangor,0,0,0,El Salvador
13290,8/1/2020,SLV,W.P. Labuan,0,0,0,El Salvador
13291,8/1/2020,SMR,Johor,0,0,0,San Marino
13292,8/1/2020,SMR,Selangor,0,0,0,San Marino
13293,8/1/2020,SOM,Johor,0,0,0,Somalia
13294,8/1/2020,SOM,Kedah,0,0,0,Somalia
13295,8/1/2020,SOM,Kelantan,0,0,0,Somalia
13296,8/1/2020,SOM,Perlis,0,0,0,Somalia
13297,8/1/2020,SOM,Sabah,0,0,0,Somalia
13298,8/1/2020,SOM,Sarawak,0,0,0,Somalia
13299,8/1/2020,SOM,Selangor,2,2,0,Somalia
13300,8/1/2020,SRB,Johor,0,0,0,Serbia
13301,8/1/2020,SRB,Kedah,0,0,0,Serbia
13302,8/1/2020,SRB,Kelantan,0,0,0,Serbia
13303,8/1/2020,SRB,Pahang,0,0,0,Serbia
13304,8/1/2020,SRB,Perak,0,0,0,Serbia
13305,8/1/2020,SRB,Perlis,0,0,0,Serbia
13306,8/1/2020,SRB,Pulau Pinang,0,0,0,Serbia
13307,8/1/2020,SRB,Sabah,0,0,0,Serbia
13308,8/1/2020,SRB,Sarawak,0,0,0,Serbia
13309,8/1/2020,SRB,Selangor,3,1,2,Serbia
13310,8/1/2020,STP,Selangor,0,0,0,Sao Tome and Principe
13311,8/1/2020,SUR,Johor,0,0,0,Suriname
13312,8/1/2020,SUR,Kedah,0,0,0,Suriname
13313,8/1/2020,SUR,Kelantan,0,0,0,Suriname
13314,8/1/2020,SUR,Perak,0,0,0,Suriname
13315,8/1/2020,SUR,Perlis,0,0,0,Suriname
13316,8/1/2020,SUR,Pulau Pinang,0,0,0,Suriname
13317,8/1/2020,SUR,Sabah,0,0,0,Suriname
13318,8/1/2020,SUR,Sarawak,0,0,0,Suriname
13319,8/1/2020,SUR,Selangor,0,0,0,Suriname
13320,8/1/2020,SVK,Johor,0,0,0,Slovakia
13321,8/1/2020,SVK,Kedah,0,0,0,Slovakia
13322,8/1/2020,SVK,Kelantan,0,0,0,Slovakia
13323,8/1/2020,SVK,Negeri Sembilan,0,0,0,Slovakia
13324,8/1/2020,SVK,Pahang,0,0,0,Slovakia
13325,8/1/2020,SVK,Perak,0,0,0,Slovakia
13326,8/1/2020,SVK,Perlis,0,0,0,Slovakia
13327,8/1/2020,SVK,Pulau Pinang,0,0,0,Slovakia
13328,8/1/2020,SVK,Sabah,0,0,0,Slovakia
13329,8/1/2020,SVK,Sarawak,0,0,0,Slovakia
13330,8/1/2020,SVK,Selangor,9,6,3,Slovakia
13331,8/1/2020,SVK,W.P. Labuan,0,0,0,Slovakia
13332,8/1/2020,SVN,Johor,0,0,0,Slovenia
13333,8/1/2020,SVN,Kedah,0,0,0,Slovenia
13334,8/1/2020,SVN,Kelantan,0,0,0,Slovenia
13335,8/1/2020,SVN,Perak,0,0,0,Slovenia
13336,8/1/2020,SVN,Perlis,0,0,0,Slovenia
13337,8/1/2020,SVN,Pulau Pinang,0,0,0,Slovenia
13338,8/1/2020,SVN,Sabah,0,0,0,Slovenia
13339,8/1/2020,SVN,Sarawak,0,0,0,Slovenia
13340,8/1/2020,SVN,Selangor,1,1,0,Slovenia
13341,8/1/2020,SVN,W.P. Labuan,0,0,0,Slovenia
13342,8/1/2020,SWE,Johor,0,0,0,Sweden
13343,8/1/2020,SWE,Kedah,0,0,0,Sweden
13344,8/1/2020,SWE,Kelantan,0,0,0,Sweden
13345,8/1/2020,SWE,Melaka,0,0,0,Sweden
13346,8/1/2020,SWE,Negeri Sembilan,0,0,0,Sweden
13347,8/1/2020,SWE,Pahang,0,0,0,Sweden
13348,8/1/2020,SWE,Perak,0,0,0,Sweden
13349,8/1/2020,SWE,Perlis,0,0,0,Sweden
13350,8/1/2020,SWE,Pulau Pinang,0,0,0,Sweden
13351,8/1/2020,SWE,Sabah,0,0,0,Sweden
13352,8/1/2020,SWE,Sarawak,0,0,0,Sweden
13353,8/1/2020,SWE,Selangor,17,13,4,Sweden
13354,8/1/2020,SWE,W.P. Labuan,0,0,0,Sweden
13355,8/1/2020,SWZ,Johor,0,0,0,Swaziland
13356,8/1/2020,SWZ,Kedah,0,0,0,Swaziland
13357,8/1/2020,SWZ,Pulau Pinang,0,0,0,Swaziland
13358,8/1/2020,SWZ,Sabah,0,0,0,Swaziland
13359,8/1/2020,SWZ,Selangor,0,0,0,Swaziland
13360,8/1/2020,SYC,Johor,0,0,0,Seychelles
13361,8/1/2020,SYC,Kedah,0,0,0,Seychelles
13362,8/1/2020,SYC,Pulau Pinang,0,0,0,Seychelles
13363,8/1/2020,SYC,Sabah,0,0,0,Seychelles
13364,8/1/2020,SYC,Sarawak,0,0,0,Seychelles
13365,8/1/2020,SYC,Selangor,0,0,0,Seychelles
13366,8/1/2020,SYR,Johor,0,0,0,Syrian Arab Republic
13367,8/1/2020,SYR,Kedah,0,0,0,Syrian Arab Republic
13368,8/1/2020,SYR,Kelantan,0,0,0,Syrian Arab Republic
13369,8/1/2020,SYR,Pahang,0,0,0,Syrian Arab Republic
13370,8/1/2020,SYR,Perlis,0,0,0,Syrian Arab Republic
13371,8/1/2020,SYR,Pulau Pinang,0,0,0,Syrian Arab Republic
13372,8/1/2020,SYR,Sabah,0,0,0,Syrian Arab Republic
13373,8/1/2020,SYR,Sarawak,0,0,0,Syrian Arab Republic
13374,8/1/2020,SYR,Selangor,24,23,1,Syrian Arab Republic
13375,8/1/2020,SYR,W.P. Labuan,0,0,0,Syrian Arab Republic
13376,8/1/2020,TCA,Perlis,0,0,0,Turks and Caicos
13377,8/1/2020,TCD,Johor,0,0,0,Chad
13378,8/1/2020,TCD,Kedah,0,0,0,Chad
13379,8/1/2020,TCD,Perlis,0,0,0,Chad
13380,8/1/2020,TCD,Selangor,0,0,0,Chad
13381,8/1/2020,TGO,Johor,0,0,0,Togo
13382,8/1/2020,TGO,Perak,0,0,0,Togo
13383,8/1/2020,TGO,Pulau Pinang,0,0,0,Togo
13384,8/1/2020,TGO,Selangor,0,0,0,Togo
13385,8/1/2020,THA,Johor,87,87,0,Thailand
13386,8/1/2020,THA,Kedah,10333,9521,812,Thailand
13387,8/1/2020,THA,Kelantan,3,1,2,Thailand
13388,8/1/2020,THA,Melaka,0,0,0,Thailand
13389,8/1/2020,THA,Negeri Sembilan,0,0,0,Thailand
13390,8/1/2020,THA,Pahang,0,0,0,Thailand
13391,8/1/2020,THA,Perak,0,0,0,Thailand
13392,8/1/2020,THA,Perlis,4315,4191,124,Thailand
13393,8/1/2020,THA,Pulau Pinang,0,0,0,Thailand
13394,8/1/2020,THA,Sabah,1,0,1,Thailand
13395,8/1/2020,THA,Sarawak,13,13,0,Thailand
13396,8/1/2020,THA,Selangor,170,122,48,Thailand
13397,8/1/2020,THA,Terengganu,0,0,0,Thailand
13398,8/1/2020,THA,W.P. Labuan,0,0,0,Thailand
13399,8/1/2020,TJK,Johor,0,0,0,Tajikistan
13400,8/1/2020,TJK,Kedah,0,0,0,Tajikistan
13401,8/1/2020,TJK,Perlis,0,0,0,Tajikistan
13402,8/1/2020,TJK,Pulau Pinang,0,0,0,Tajikistan
13403,8/1/2020,TJK,Sabah,0,0,0,Tajikistan
13404,8/1/2020,TJK,Selangor,1,0,1,Tajikistan
13405,8/1/2020,TKL,Selangor,0,0,0,Tokelau
13406,8/1/2020,TKM,Johor,0,0,0,Turkmenistan
13407,8/1/2020,TKM,Kedah,0,0,0,Turkmenistan
13408,8/1/2020,TKM,Kelantan,0,0,0,Turkmenistan
13409,8/1/2020,TKM,Perlis,0,0,0,Turkmenistan
13410,8/1/2020,TKM,Pulau Pinang,0,0,0,Turkmenistan
13411,8/1/2020,TKM,Sabah,0,0,0,Turkmenistan
13412,8/1/2020,TKM,Sarawak,0,0,0,Turkmenistan
13413,8/1/2020,TKM,Selangor,0,0,0,Turkmenistan
13414,8/1/2020,TLS,Johor,0,0,0,Timor-Leste
13415,8/1/2020,TLS,Kedah,0,0,0,Timor-Leste
13416,8/1/2020,TLS,Perlis,0,0,0,Timor-Leste
13417,8/1/2020,TLS,Pulau Pinang,0,0,0,Timor-Leste
13418,8/1/2020,TLS,Sabah,0,0,0,Timor-Leste
13419,8/1/2020,TLS,Sarawak,0,0,0,Timor-Leste
13420,8/1/2020,TLS,Selangor,2,1,1,Timor-Leste
13421,8/1/2020,TON,Johor,0,0,0,Tonga
13422,8/1/2020,TON,Pulau Pinang,0,0,0,Tonga
13423,8/1/2020,TON,Sarawak,0,0,0,Tonga
13424,8/1/2020,TON,Selangor,0,0,0,Tonga
13425,8/1/2020,TTO,Johor,0,0,0,Trinidad and Tobago
13426,8/1/2020,TTO,Kedah,0,0,0,Trinidad and Tobago
13427,8/1/2020,TTO,Pahang,0,0,0,Trinidad and Tobago
13428,8/1/2020,TTO,Pulau Pinang,0,0,0,Trinidad and Tobago
13429,8/1/2020,TTO,Sabah,0,0,0,Trinidad and Tobago
13430,8/1/2020,TTO,Sarawak,0,0,0,Trinidad and Tobago
13431,8/1/2020,TTO,Selangor,0,0,0,Trinidad and Tobago
13432,8/1/2020,TUN,Johor,0,0,0,Tunisia
13433,8/1/2020,TUN,Kedah,0,0,0,Tunisia
13434,8/1/2020,TUN,Kelantan,0,0,0,Tunisia
13435,8/1/2020,TUN,Melaka,0,0,0,Tunisia
13436,8/1/2020,TUN,Perak,0,0,0,Tunisia
13437,8/1/2020,TUN,Perlis,0,0,0,Tunisia
13438,8/1/2020,TUN,Pulau Pinang,0,0,0,Tunisia
13439,8/1/2020,TUN,Sabah,0,0,0,Tunisia
13440,8/1/2020,TUN,Sarawak,0,0,0,Tunisia
13441,8/1/2020,TUN,Selangor,5,4,1,Tunisia
13442,8/1/2020,TUN,W.P. Labuan,0,0,0,Tunisia
13443,8/1/2020,TUR,Johor,0,0,0,Turkey
13444,8/1/2020,TUR,Kedah,0,0,0,Turkey
13445,8/1/2020,TUR,Kelantan,0,0,0,Turkey
13446,8/1/2020,TUR,Melaka,0,0,0,Turkey
13447,8/1/2020,TUR,Negeri Sembilan,0,0,0,Turkey
13448,8/1/2020,TUR,Pahang,0,0,0,Turkey
13449,8/1/2020,TUR,Perak,0,0,0,Turkey
13450,8/1/2020,TUR,Perlis,0,0,0,Turkey
13451,8/1/2020,TUR,Pulau Pinang,0,0,0,Turkey
13452,8/1/2020,TUR,Sabah,0,0,0,Turkey
13453,8/1/2020,TUR,Sarawak,0,0,0,Turkey
13454,8/1/2020,TUR,Selangor,27,16,11,Turkey
13455,8/1/2020,TUR,W.P. Labuan,0,0,0,Turkey
13456,8/1/2020,TUV,Selangor,0,0,0,Tuvalu
13457,8/1/2020,TWN,Johor,0,0,0,Taiwan
13458,8/1/2020,TWN,Kedah,0,0,0,Taiwan
13459,8/1/2020,TWN,Kelantan,0,0,0,Taiwan
13460,8/1/2020,TWN,Melaka,0,0,0,Taiwan
13461,8/1/2020,TWN,Negeri Sembilan,0,0,0,Taiwan
13462,8/1/2020,TWN,Pahang,0,0,0,Taiwan
13463,8/1/2020,TWN,Perak,0,0,0,Taiwan
13464,8/1/2020,TWN,Perlis,0,0,0,Taiwan
13465,8/1/2020,TWN,Pulau Pinang,8,4,4,Taiwan
13466,8/1/2020,TWN,Sabah,0,0,0,Taiwan
13467,8/1/2020,TWN,Sarawak,0,0,0,Taiwan
13468,8/1/2020,TWN,Selangor,68,42,26,Taiwan
13469,8/1/2020,TWN,W.P. Labuan,0,0,0,Taiwan
13470,8/1/2020,TZA,Johor,0,0,0,"Tanzania, United Republic of"
13471,8/1/2020,TZA,Kedah,0,0,0,"Tanzania, United Republic of"
13472,8/1/2020,TZA,Perak,0,0,0,"Tanzania, United Republic of"
13473,8/1/2020,TZA,Perlis,0,0,0,"Tanzania, United Republic of"
13474,8/1/2020,TZA,Pulau Pinang,0,0,0,"Tanzania, United Republic of"
13475,8/1/2020,TZA,Sabah,0,0,0,"Tanzania, United Republic of"
13476,8/1/2020,TZA,Sarawak,0,0,0,"Tanzania, United Republic of"
13477,8/1/2020,TZA,Selangor,1,1,0,"Tanzania, United Republic of"
13478,8/1/2020,UGA,Johor,0,0,0,Uganda
13479,8/1/2020,UGA,Kedah,0,0,0,Uganda
13480,8/1/2020,UGA,Perak,0,0,0,Uganda
13481,8/1/2020,UGA,Perlis,0,0,0,Uganda
13482,8/1/2020,UGA,Pulau Pinang,0,0,0,Uganda
13483,8/1/2020,UGA,Sabah,0,0,0,Uganda
13484,8/1/2020,UGA,Sarawak,0,0,0,Uganda
13485,8/1/2020,UGA,Selangor,0,0,0,Uganda
13486,8/1/2020,UKR,Johor,18,18,0,Ukraine
13487,8/1/2020,UKR,Kedah,0,0,0,Ukraine
13488,8/1/2020,UKR,Kelantan,0,0,0,Ukraine
13489,8/1/2020,UKR,Melaka,0,0,0,Ukraine
13490,8/1/2020,UKR,Negeri Sembilan,0,0,0,Ukraine
13491,8/1/2020,UKR,Pahang,0,0,0,Ukraine
13492,8/1/2020,UKR,Perak,0,0,0,Ukraine
13493,8/1/2020,UKR,Perlis,0,0,0,Ukraine
13494,8/1/2020,UKR,Pulau Pinang,2,2,0,Ukraine
13495,8/1/2020,UKR,Sabah,0,0,0,Ukraine
13496,8/1/2020,UKR,Sarawak,0,0,0,Ukraine
13497,8/1/2020,UKR,Selangor,82,81,1,Ukraine
13498,8/1/2020,UKR,W.P. Labuan,0,0,0,Ukraine
13499,8/1/2020,URY,Johor,0,0,0,Uruguay
13500,8/1/2020,URY,Kedah,0,0,0,Uruguay
13501,8/1/2020,URY,Kelantan,0,0,0,Uruguay
13502,8/1/2020,URY,Perak,0,0,0,Uruguay
13503,8/1/2020,URY,Perlis,0,0,0,Uruguay
13504,8/1/2020,URY,Pulau Pinang,0,0,0,Uruguay
13505,8/1/2020,URY,Sabah,0,0,0,Uruguay
13506,8/1/2020,URY,Sarawak,0,0,0,Uruguay
13507,8/1/2020,URY,Selangor,0,0,0,Uruguay
13508,8/1/2020,URY,W.P. Labuan,0,0,0,Uruguay
13509,8/1/2020,USA,Johor,0,0,0,United States Of America
13510,8/1/2020,USA,Kedah,0,0,0,United States Of America
13511,8/1/2020,USA,Kelantan,0,0,0,United States Of America
13512,8/1/2020,USA,Melaka,0,0,0,United States Of America
13513,8/1/2020,USA,Negeri Sembilan,0,0,0,United States Of America
13514,8/1/2020,USA,Pahang,0,0,0,United States Of America
13515,8/1/2020,USA,Perak,0,0,0,United States Of America
13516,8/1/2020,USA,Perlis,0,0,0,United States Of America
13517,8/1/2020,USA,Pulau Pinang,0,0,0,United States Of America
13518,8/1/2020,USA,Sabah,0,0,0,United States Of America
13519,8/1/2020,USA,Sarawak,0,0,0,United States Of America
13520,8/1/2020,USA,Selangor,139,87,52,United States Of America
13521,8/1/2020,USA,Terengganu,0,0,0,United States Of America
13522,8/1/2020,USA,W.P. Labuan,0,0,0,United States Of America
13523,8/1/2020,UZB,Johor,0,0,0,Uzbekistan
13524,8/1/2020,UZB,Kedah,0,0,0,Uzbekistan
13525,8/1/2020,UZB,Kelantan,0,0,0,Uzbekistan
13526,8/1/2020,UZB,Perak,0,0,0,Uzbekistan
13527,8/1/2020,UZB,Perlis,0,0,0,Uzbekistan
13528,8/1/2020,UZB,Pulau Pinang,0,0,0,Uzbekistan
13529,8/1/2020,UZB,Sabah,0,0,0,Uzbekistan
13530,8/1/2020,UZB,Sarawak,0,0,0,Uzbekistan
13531,8/1/2020,UZB,Selangor,3,3,0,Uzbekistan
13532,8/1/2020,VAT,Johor,0,0,0,Holy See (Vatican City State)
13533,8/1/2020,VAT,Sarawak,0,0,0,Holy See (Vatican City State)
13534,8/1/2020,VAT,Selangor,0,0,0,Holy See (Vatican City State)
13535,8/1/2020,VCT,Johor,0,0,0,Saint Vincent and the Grenadines
13536,8/1/2020,VCT,Kedah,0,0,0,Saint Vincent and the Grenadines
13537,8/1/2020,VCT,Pulau Pinang,0,0,0,Saint Vincent and the Grenadines
13538,8/1/2020,VCT,Sarawak,0,0,0,Saint Vincent and the Grenadines
13539,8/1/2020,VCT,Selangor,0,0,0,Saint Vincent and the Grenadines
13540,8/1/2020,VEN,Johor,0,0,0,Venezuela
13541,8/1/2020,VEN,Kedah,0,0,0,Venezuela
13542,8/1/2020,VEN,Kelantan,0,0,0,Venezuela
13543,8/1/2020,VEN,Melaka,0,0,0,Venezuela
13544,8/1/2020,VEN,Perak,0,0,0,Venezuela
13545,8/1/2020,VEN,Perlis,0,0,0,Venezuela
13546,8/1/2020,VEN,Pulau Pinang,0,0,0,Venezuela
13547,8/1/2020,VEN,Sabah,0,0,0,Venezuela
13548,8/1/2020,VEN,Sarawak,0,0,0,Venezuela
13549,8/1/2020,VEN,Selangor,0,0,0,Venezuela
13550,8/1/2020,VEN,W.P. Labuan,0,0,0,Venezuela
13551,8/1/2020,VNM,Johor,3,0,3,Vietnam
13552,8/1/2020,VNM,Kedah,0,0,0,Vietnam
13553,8/1/2020,VNM,Kelantan,0,0,0,Vietnam
13554,8/1/2020,VNM,Melaka,0,0,0,Vietnam
13555,8/1/2020,VNM,Negeri Sembilan,0,0,0,Vietnam
13556,8/1/2020,VNM,Pahang,0,0,0,Vietnam
13557,8/1/2020,VNM,Perak,0,0,0,Vietnam
13558,8/1/2020,VNM,Perlis,0,0,0,Vietnam
13559,8/1/2020,VNM,Pulau Pinang,0,0,0,Vietnam
13560,8/1/2020,VNM,Sabah,0,0,0,Vietnam
13561,8/1/2020,VNM,Sarawak,0,0,0,Vietnam
13562,8/1/2020,VNM,Selangor,106,47,59,Vietnam
13563,8/1/2020,VNM,Terengganu,0,0,0,Vietnam
13564,8/1/2020,VNM,W.P. Labuan,0,0,0,Vietnam
13565,8/1/2020,VUT,Johor,0,0,0,Vanuatu
13566,8/1/2020,VUT,Kedah,0,0,0,Vanuatu
13567,8/1/2020,VUT,Pulau Pinang,0,0,0,Vanuatu
13568,8/1/2020,VUT,Sabah,0,0,0,Vanuatu
13569,8/1/2020,VUT,Sarawak,0,0,0,Vanuatu
13570,8/1/2020,VUT,Selangor,0,0,0,Vanuatu
13571,8/1/2020,WSM,Johor,0,0,0,Samoa
13572,8/1/2020,WSM,Sarawak,0,0,0,Samoa
13573,8/1/2020,WSM,Selangor,0,0,0,Samoa
13574,8/1/2020,YEM,Johor,0,0,0,Yemen
13575,8/1/2020,YEM,Kedah,0,0,0,Yemen
13576,8/1/2020,YEM,Kelantan,0,0,0,Yemen
13577,8/1/2020,YEM,Melaka,0,0,0,Yemen
13578,8/1/2020,YEM,Pahang,0,0,0,Yemen
13579,8/1/2020,YEM,Perak,0,0,0,Yemen
13580,8/1/2020,YEM,Perlis,0,0,0,Yemen
13581,8/1/2020,YEM,Pulau Pinang,0,0,0,Yemen
13582,8/1/2020,YEM,Sabah,1,1,0,Yemen
13583,8/1/2020,YEM,Sarawak,0,0,0,Yemen
13584,8/1/2020,YEM,Selangor,13,11,2,Yemen
13585,8/1/2020,YEM,W.P. Labuan,0,0,0,Yemen
13586,8/1/2020,ZAF,Johor,0,0,0,South Africa
13587,8/1/2020,ZAF,Kedah,0,0,0,South Africa
13588,8/1/2020,ZAF,Kelantan,0,0,0,South Africa
13589,8/1/2020,ZAF,Melaka,0,0,0,South Africa
13590,8/1/2020,ZAF,Pahang,0,0,0,South Africa
13591,8/1/2020,ZAF,Perak,0,0,0,South Africa
13592,8/1/2020,ZAF,Perlis,0,0,0,South Africa
13593,8/1/2020,ZAF,Pulau Pinang,0,0,0,South Africa
13594,8/1/2020,ZAF,Sabah,0,0,0,South Africa
13595,8/1/2020,ZAF,Sarawak,0,0,0,South Africa
13596,8/1/2020,ZAF,Selangor,16,11,5,South Africa
13597,8/1/2020,ZAF,Terengganu,0,0,0,South Africa
13598,8/1/2020,ZAF,W.P. Labuan,0,0,0,South Africa
13599,8/1/2020,ZMB,Johor,0,0,0,Zambia
13600,8/1/2020,ZMB,Kedah,0,0,0,Zambia
13601,8/1/2020,ZMB,Perak,0,0,0,Zambia
13602,8/1/2020,ZMB,Perlis,0,0,0,Zambia
13603,8/1/2020,ZMB,Pulau Pinang,0,0,0,Zambia
13604,8/1/2020,ZMB,Sabah,0,0,0,Zambia
13605,8/1/2020,ZMB,Sarawak,1,1,0,Zambia
13606,8/1/2020,ZMB,Selangor,2,1,1,Zambia
13607,8/1/2020,ZWE,Johor,0,0,0,Zimbabwe
13608,8/1/2020,ZWE,Kedah,0,0,0,Zimbabwe
13609,8/1/2020,ZWE,Kelantan,0,0,0,Zimbabwe
13610,8/1/2020,ZWE,Perak,0,0,0,Zimbabwe
13611,8/1/2020,ZWE,Perlis,0,0,0,Zimbabwe
13612,8/1/2020,ZWE,Pulau Pinang,0,0,0,Zimbabwe
13613,8/1/2020,ZWE,Sabah,0,0,0,Zimbabwe
13614,8/1/2020,ZWE,Sarawak,0,0,0,Zimbabwe
13615,8/1/2020,ZWE,Selangor,1,0,1,Zimbabwe
13616,9/1/2020,ABW,Kedah,0,0,0,Aruba
13617,9/1/2020,ABW,Pulau Pinang,0,0,0,Aruba
13618,9/1/2020,AFG,Johor,0,0,0,Afghanistan
13619,9/1/2020,AFG,Kedah,0,0,0,Afghanistan
13620,9/1/2020,AFG,Perlis,0,0,0,Afghanistan
13621,9/1/2020,AFG,Pulau Pinang,0,0,0,Afghanistan
13622,9/1/2020,AFG,Sarawak,0,0,0,Afghanistan
13623,9/1/2020,AFG,Selangor,12,7,5,Afghanistan
13624,9/1/2020,AGO,Johor,0,0,0,Angola
13625,9/1/2020,AGO,Kedah,0,0,0,Angola
13626,9/1/2020,AGO,Sabah,0,0,0,Angola
13627,9/1/2020,AGO,Selangor,0,0,0,Angola
13628,9/1/2020,AIA,Selangor,0,0,0,Anguilla
13629,9/1/2020,ALB,Johor,0,0,0,Albania
13630,9/1/2020,ALB,Kedah,0,0,0,Albania
13631,9/1/2020,ALB,Perak,0,0,0,Albania
13632,9/1/2020,ALB,Perlis,0,0,0,Albania
13633,9/1/2020,ALB,Pulau Pinang,0,0,0,Albania
13634,9/1/2020,ALB,Sabah,0,0,0,Albania
13635,9/1/2020,ALB,Sarawak,0,0,0,Albania
13636,9/1/2020,ALB,Selangor,0,0,0,Albania
13637,9/1/2020,AND,Johor,0,0,0,Andorra
13638,9/1/2020,AND,Kedah,0,0,0,Andorra
13639,9/1/2020,AND,Perlis,0,0,0,Andorra
13640,9/1/2020,AND,Pulau Pinang,0,0,0,Andorra
13641,9/1/2020,AND,Selangor,0,0,0,Andorra
13642,9/1/2020,ANT,Selangor,0,0,0,Netherlands Antilles
13643,9/1/2020,ARE,Johor,0,0,0,United Arab Emirates
13644,9/1/2020,ARE,Kedah,0,0,0,United Arab Emirates
13645,9/1/2020,ARE,Kelantan,0,0,0,United Arab Emirates
13646,9/1/2020,ARE,Perak,0,0,0,United Arab Emirates
13647,9/1/2020,ARE,Perlis,0,0,0,United Arab Emirates
13648,9/1/2020,ARE,Pulau Pinang,0,0,0,United Arab Emirates
13649,9/1/2020,ARE,Sabah,0,0,0,United Arab Emirates
13650,9/1/2020,ARE,Sarawak,0,0,0,United Arab Emirates
13651,9/1/2020,ARE,Selangor,1,0,1,United Arab Emirates
13652,9/1/2020,ARG,Johor,1,1,0,Argentina
13653,9/1/2020,ARG,Kedah,0,0,0,Argentina
13654,9/1/2020,ARG,Kelantan,0,0,0,Argentina
13655,9/1/2020,ARG,Melaka,0,0,0,Argentina
13656,9/1/2020,ARG,Perak,0,0,0,Argentina
13657,9/1/2020,ARG,Perlis,0,0,0,Argentina
13658,9/1/2020,ARG,Pulau Pinang,0,0,0,Argentina
13659,9/1/2020,ARG,Sabah,0,0,0,Argentina
13660,9/1/2020,ARG,Sarawak,0,0,0,Argentina
13661,9/1/2020,ARG,Selangor,0,0,0,Argentina
13662,9/1/2020,ARG,W.P. Labuan,0,0,0,Argentina
13663,9/1/2020,ARM,Johor,0,0,0,Armenia
13664,9/1/2020,ARM,Kedah,0,0,0,Armenia
13665,9/1/2020,ARM,Kelantan,0,0,0,Armenia
13666,9/1/2020,ARM,Perak,0,0,0,Armenia
13667,9/1/2020,ARM,Perlis,0,0,0,Armenia
13668,9/1/2020,ARM,Pulau Pinang,0,0,0,Armenia
13669,9/1/2020,ARM,Sabah,0,0,0,Armenia
13670,9/1/2020,ARM,Sarawak,0,0,0,Armenia
13671,9/1/2020,ARM,Selangor,0,0,0,Armenia
13672,9/1/2020,ATA,Selangor,0,0,0,Antarctica
13673,9/1/2020,ATG,Johor,0,0,0,Antigua and Barbuda
13674,9/1/2020,ATG,Kedah,0,0,0,Antigua and Barbuda
13675,9/1/2020,ATG,Pulau Pinang,0,0,0,Antigua and Barbuda
13676,9/1/2020,ATG,Sarawak,0,0,0,Antigua and Barbuda
13677,9/1/2020,ATG,Selangor,0,0,0,Antigua and Barbuda
13678,9/1/2020,AUS,Johor,5,5,0,Australia
13679,9/1/2020,AUS,Kedah,0,0,0,Australia
13680,9/1/2020,AUS,Kelantan,0,0,0,Australia
13681,9/1/2020,AUS,Melaka,0,0,0,Australia
13682,9/1/2020,AUS,Negeri Sembilan,0,0,0,Australia
13683,9/1/2020,AUS,Pahang,0,0,0,Australia
13684,9/1/2020,AUS,Perak,0,0,0,Australia
13685,9/1/2020,AUS,Perlis,0,0,0,Australia
13686,9/1/2020,AUS,Pulau Pinang,1,1,0,Australia
13687,9/1/2020,AUS,Sabah,0,0,0,Australia
13688,9/1/2020,AUS,Sarawak,0,0,0,Australia
13689,9/1/2020,AUS,Selangor,129,96,33,Australia
13690,9/1/2020,AUS,Terengganu,0,0,0,Australia
13691,9/1/2020,AUS,W.P. Labuan,0,0,0,Australia
13692,9/1/2020,AUT,Johor,0,0,0,Austria
13693,9/1/2020,AUT,Kedah,0,0,0,Austria
13694,9/1/2020,AUT,Kelantan,0,0,0,Austria
13695,9/1/2020,AUT,Melaka,0,0,0,Austria
13696,9/1/2020,AUT,Negeri Sembilan,0,0,0,Austria
13697,9/1/2020,AUT,Pahang,0,0,0,Austria
13698,9/1/2020,AUT,Perak,0,0,0,Austria
13699,9/1/2020,AUT,Perlis,0,0,0,Austria
13700,9/1/2020,AUT,Pulau Pinang,0,0,0,Austria
13701,9/1/2020,AUT,Sabah,0,0,0,Austria
13702,9/1/2020,AUT,Sarawak,0,0,0,Austria
13703,9/1/2020,AUT,Selangor,11,8,3,Austria
13704,9/1/2020,AUT,Terengganu,0,0,0,Austria
13705,9/1/2020,AUT,W.P. Labuan,0,0,0,Austria
13706,9/1/2020,AZE,Johor,0,0,0,Azerbaijan
13707,9/1/2020,AZE,Kedah,0,0,0,Azerbaijan
13708,9/1/2020,AZE,Kelantan,0,0,0,Azerbaijan
13709,9/1/2020,AZE,Melaka,0,0,0,Azerbaijan
13710,9/1/2020,AZE,Perlis,0,0,0,Azerbaijan
13711,9/1/2020,AZE,Pulau Pinang,0,0,0,Azerbaijan
13712,9/1/2020,AZE,Sabah,0,0,0,Azerbaijan
13713,9/1/2020,AZE,Sarawak,0,0,0,Azerbaijan
13714,9/1/2020,AZE,Selangor,2,1,1,Azerbaijan
13715,9/1/2020,AZE,W.P. Labuan,0,0,0,Azerbaijan
13716,9/1/2020,BDI,Pulau Pinang,0,0,0,Burundi
13717,9/1/2020,BDI,Sarawak,0,0,0,Burundi
13718,9/1/2020,BDI,Selangor,0,0,0,Burundi
13719,9/1/2020,BEL,Johor,1,1,0,Belgium
13720,9/1/2020,BEL,Kedah,0,0,0,Belgium
13721,9/1/2020,BEL,Kelantan,0,0,0,Belgium
13722,9/1/2020,BEL,Melaka,0,0,0,Belgium
13723,9/1/2020,BEL,Negeri Sembilan,0,0,0,Belgium
13724,9/1/2020,BEL,Pahang,0,0,0,Belgium
13725,9/1/2020,BEL,Perak,0,0,0,Belgium
13726,9/1/2020,BEL,Perlis,0,0,0,Belgium
13727,9/1/2020,BEL,Pulau Pinang,1,1,0,Belgium
13728,9/1/2020,BEL,Sabah,0,0,0,Belgium
13729,9/1/2020,BEL,Sarawak,0,0,0,Belgium
13730,9/1/2020,BEL,Selangor,19,15,4,Belgium
13731,9/1/2020,BEL,W.P. Labuan,0,0,0,Belgium
13732,9/1/2020,BEN,Johor,0,0,0,Benin
13733,9/1/2020,BEN,Kedah,0,0,0,Benin
13734,9/1/2020,BEN,Perak,0,0,0,Benin
13735,9/1/2020,BEN,Pulau Pinang,0,0,0,Benin
13736,9/1/2020,BEN,Sabah,0,0,0,Benin
13737,9/1/2020,BEN,Sarawak,0,0,0,Benin
13738,9/1/2020,BEN,Selangor,0,0,0,Benin
13739,9/1/2020,BFA,Perak,0,0,0,Burkina Faso
13740,9/1/2020,BFA,Pulau Pinang,0,0,0,Burkina Faso
13741,9/1/2020,BFA,Selangor,0,0,0,Burkina Faso
13742,9/1/2020,BGD,Johor,6,6,0,Bangladesh
13743,9/1/2020,BGD,Kedah,0,0,0,Bangladesh
13744,9/1/2020,BGD,Kelantan,0,0,0,Bangladesh
13745,9/1/2020,BGD,Melaka,0,0,0,Bangladesh
13746,9/1/2020,BGD,Negeri Sembilan,0,0,0,Bangladesh
13747,9/1/2020,BGD,Pahang,0,0,0,Bangladesh
13748,9/1/2020,BGD,Perak,0,0,0,Bangladesh
13749,9/1/2020,BGD,Perlis,0,0,0,Bangladesh
13750,9/1/2020,BGD,Pulau Pinang,0,0,0,Bangladesh
13751,9/1/2020,BGD,Sabah,0,0,0,Bangladesh
13752,9/1/2020,BGD,Sarawak,2,2,0,Bangladesh
13753,9/1/2020,BGD,Selangor,143,100,43,Bangladesh
13754,9/1/2020,BGD,W.P. Labuan,0,0,0,Bangladesh
13755,9/1/2020,BGR,Johor,4,4,0,Bulgaria
13756,9/1/2020,BGR,Kedah,0,0,0,Bulgaria
13757,9/1/2020,BGR,Kelantan,0,0,0,Bulgaria
13758,9/1/2020,BGR,Pahang,0,0,0,Bulgaria
13759,9/1/2020,BGR,Perak,0,0,0,Bulgaria
13760,9/1/2020,BGR,Perlis,0,0,0,Bulgaria
13761,9/1/2020,BGR,Pulau Pinang,0,0,0,Bulgaria
13762,9/1/2020,BGR,Sabah,0,0,0,Bulgaria
13763,9/1/2020,BGR,Sarawak,1,1,0,Bulgaria
13764,9/1/2020,BGR,Selangor,15,14,1,Bulgaria
13765,9/1/2020,BGR,W.P. Labuan,0,0,0,Bulgaria
13766,9/1/2020,BHR,Johor,0,0,0,Bahrain
13767,9/1/2020,BHR,Kedah,0,0,0,Bahrain
13768,9/1/2020,BHR,Kelantan,0,0,0,Bahrain
13769,9/1/2020,BHR,Perlis,0,0,0,Bahrain
13770,9/1/2020,BHR,Pulau Pinang,0,0,0,Bahrain
13771,9/1/2020,BHR,Sabah,0,0,0,Bahrain
13772,9/1/2020,BHR,Sarawak,0,0,0,Bahrain
13773,9/1/2020,BHR,Selangor,3,1,2,Bahrain
13774,9/1/2020,BHS,Johor,0,0,0,Bahamas
13775,9/1/2020,BHS,Kedah,0,0,0,Bahamas
13776,9/1/2020,BHS,Perak,0,0,0,Bahamas
13777,9/1/2020,BHS,Sabah,0,0,0,Bahamas
13778,9/1/2020,BHS,Sarawak,0,0,0,Bahamas
13779,9/1/2020,BHS,Selangor,0,0,0,Bahamas
13780,9/1/2020,BIH,Johor,0,0,0,Bosnia and Herzegovina
13781,9/1/2020,BIH,Kedah,0,0,0,Bosnia and Herzegovina
13782,9/1/2020,BIH,Perlis,0,0,0,Bosnia and Herzegovina
13783,9/1/2020,BIH,Pulau Pinang,0,0,0,Bosnia and Herzegovina
13784,9/1/2020,BIH,Sabah,0,0,0,Bosnia and Herzegovina
13785,9/1/2020,BIH,Sarawak,0,0,0,Bosnia and Herzegovina
13786,9/1/2020,BIH,Selangor,1,0,1,Bosnia and Herzegovina
13787,9/1/2020,BLR,Johor,0,0,0,Belarus
13788,9/1/2020,BLR,Kedah,0,0,0,Belarus
13789,9/1/2020,BLR,Kelantan,0,0,0,Belarus
13790,9/1/2020,BLR,Pahang,0,0,0,Belarus
13791,9/1/2020,BLR,Perak,0,0,0,Belarus
13792,9/1/2020,BLR,Perlis,0,0,0,Belarus
13793,9/1/2020,BLR,Pulau Pinang,0,0,0,Belarus
13794,9/1/2020,BLR,Sabah,0,0,0,Belarus
13795,9/1/2020,BLR,Sarawak,0,0,0,Belarus
13796,9/1/2020,BLR,Selangor,0,0,0,Belarus
13797,9/1/2020,BLR,W.P. Labuan,0,0,0,Belarus
13798,9/1/2020,BLZ,Johor,0,0,0,Belize
13799,9/1/2020,BLZ,Pulau Pinang,0,0,0,Belize
13800,9/1/2020,BLZ,Sarawak,0,0,0,Belize
13801,9/1/2020,BLZ,Selangor,0,0,0,Belize
13802,9/1/2020,BMU,Selangor,0,0,0,Bermuda
13803,9/1/2020,BOL,Johor,0,0,0,Bolivia
13804,9/1/2020,BOL,Kedah,0,0,0,Bolivia
13805,9/1/2020,BOL,Melaka,0,0,0,Bolivia
13806,9/1/2020,BOL,Perak,0,0,0,Bolivia
13807,9/1/2020,BOL,Perlis,0,0,0,Bolivia
13808,9/1/2020,BOL,Pulau Pinang,0,0,0,Bolivia
13809,9/1/2020,BOL,Sabah,0,0,0,Bolivia
13810,9/1/2020,BOL,Sarawak,0,0,0,Bolivia
13811,9/1/2020,BOL,Selangor,2,1,1,Bolivia
13812,9/1/2020,BRA,Johor,0,0,0,Brazil
13813,9/1/2020,BRA,Kedah,0,0,0,Brazil
13814,9/1/2020,BRA,Kelantan,0,0,0,Brazil
13815,9/1/2020,BRA,Melaka,0,0,0,Brazil
13816,9/1/2020,BRA,Pahang,0,0,0,Brazil
13817,9/1/2020,BRA,Perak,0,0,0,Brazil
13818,9/1/2020,BRA,Perlis,0,0,0,Brazil
13819,9/1/2020,BRA,Pulau Pinang,0,0,0,Brazil
13820,9/1/2020,BRA,Sabah,0,0,0,Brazil
13821,9/1/2020,BRA,Sarawak,0,0,0,Brazil
13822,9/1/2020,BRA,Selangor,5,5,0,Brazil
13823,9/1/2020,BRA,W.P. Labuan,0,0,0,Brazil
13824,9/1/2020,BRB,Johor,0,0,0,Barbados
13825,9/1/2020,BRB,Kedah,0,0,0,Barbados
13826,9/1/2020,BRB,Perlis,0,0,0,Barbados
13827,9/1/2020,BRB,Pulau Pinang,0,0,0,Barbados
13828,9/1/2020,BRB,Selangor,0,0,0,Barbados
13829,9/1/2020,BRN,Johor,0,0,0,Brunei Darussalam
13830,9/1/2020,BRN,Kedah,0,0,0,Brunei Darussalam
13831,9/1/2020,BRN,Kelantan,0,0,0,Brunei Darussalam
13832,9/1/2020,BRN,Melaka,0,0,0,Brunei Darussalam
13833,9/1/2020,BRN,Pahang,0,0,0,Brunei Darussalam
13834,9/1/2020,BRN,Perak,0,0,0,Brunei Darussalam
13835,9/1/2020,BRN,Perlis,0,0,0,Brunei Darussalam
13836,9/1/2020,BRN,Pulau Pinang,0,0,0,Brunei Darussalam
13837,9/1/2020,BRN,Sabah,1,1,0,Brunei Darussalam
13838,9/1/2020,BRN,Sarawak,323,315,8,Brunei Darussalam
13839,9/1/2020,BRN,Selangor,71,47,24,Brunei Darussalam
13840,9/1/2020,BRN,W.P. Labuan,1,1,0,Brunei Darussalam
13841,9/1/2020,BTN,Johor,0,0,0,Bhutan
13842,9/1/2020,BTN,Kedah,0,0,0,Bhutan
13843,9/1/2020,BTN,Perak,0,0,0,Bhutan
13844,9/1/2020,BTN,Perlis,0,0,0,Bhutan
13845,9/1/2020,BTN,Pulau Pinang,0,0,0,Bhutan
13846,9/1/2020,BTN,Sabah,0,0,0,Bhutan
13847,9/1/2020,BTN,Sarawak,0,0,0,Bhutan
13848,9/1/2020,BTN,Selangor,0,0,0,Bhutan
13849,9/1/2020,BWA,Johor,0,0,0,Botswana
13850,9/1/2020,BWA,Kedah,0,0,0,Botswana
13851,9/1/2020,BWA,Perlis,0,0,0,Botswana
13852,9/1/2020,BWA,Pulau Pinang,0,0,0,Botswana
13853,9/1/2020,BWA,Sabah,0,0,0,Botswana
13854,9/1/2020,BWA,Sarawak,0,0,0,Botswana
13855,9/1/2020,BWA,Selangor,0,0,0,Botswana
13856,9/1/2020,CAF,Kedah,0,0,0,Central African Republic
13857,9/1/2020,CAF,Selangor,0,0,0,Central African Republic
13858,9/1/2020,CAN,Johor,0,0,0,Canada
13859,9/1/2020,CAN,Kedah,0,0,0,Canada
13860,9/1/2020,CAN,Kelantan,0,0,0,Canada
13861,9/1/2020,CAN,Melaka,0,0,0,Canada
13862,9/1/2020,CAN,Negeri Sembilan,0,0,0,Canada
13863,9/1/2020,CAN,Pahang,0,0,0,Canada
13864,9/1/2020,CAN,Perak,0,0,0,Canada
13865,9/1/2020,CAN,Perlis,0,0,0,Canada
13866,9/1/2020,CAN,Pulau Pinang,0,0,0,Canada
13867,9/1/2020,CAN,Sabah,0,0,0,Canada
13868,9/1/2020,CAN,Sarawak,0,0,0,Canada
13869,9/1/2020,CAN,Selangor,70,47,23,Canada
13870,9/1/2020,CAN,Terengganu,0,0,0,Canada
13871,9/1/2020,CAN,W.P. Labuan,0,0,0,Canada
13872,9/1/2020,CCK,Selangor,0,0,0,Cocos (Keeling) Islands
13873,9/1/2020,CHE,Johor,2,1,1,Switzerland
13874,9/1/2020,CHE,Kedah,0,0,0,Switzerland
13875,9/1/2020,CHE,Kelantan,0,0,0,Switzerland
13876,9/1/2020,CHE,Melaka,0,0,0,Switzerland
13877,9/1/2020,CHE,Negeri Sembilan,0,0,0,Switzerland
13878,9/1/2020,CHE,Pahang,0,0,0,Switzerland
13879,9/1/2020,CHE,Perak,0,0,0,Switzerland
13880,9/1/2020,CHE,Perlis,0,0,0,Switzerland
13881,9/1/2020,CHE,Pulau Pinang,0,0,0,Switzerland
13882,9/1/2020,CHE,Sabah,1,1,0,Switzerland
13883,9/1/2020,CHE,Sarawak,0,0,0,Switzerland
13884,9/1/2020,CHE,Selangor,14,12,2,Switzerland
13885,9/1/2020,CHE,W.P. Labuan,0,0,0,Switzerland
13886,9/1/2020,CHL,Johor,0,0,0,Chile
13887,9/1/2020,CHL,Kedah,0,0,0,Chile
13888,9/1/2020,CHL,Kelantan,0,0,0,Chile
13889,9/1/2020,CHL,Melaka,0,0,0,Chile
13890,9/1/2020,CHL,Pahang,0,0,0,Chile
13891,9/1/2020,CHL,Perak,0,0,0,Chile
13892,9/1/2020,CHL,Perlis,0,0,0,Chile
13893,9/1/2020,CHL,Pulau Pinang,0,0,0,Chile
13894,9/1/2020,CHL,Sabah,0,0,0,Chile
13895,9/1/2020,CHL,Sarawak,0,0,0,Chile
13896,9/1/2020,CHL,Selangor,1,0,1,Chile
13897,9/1/2020,CHN,Johor,37,32,5,China
13898,9/1/2020,CHN,Kedah,0,0,0,China
13899,9/1/2020,CHN,Kelantan,0,0,0,China
13900,9/1/2020,CHN,Melaka,0,0,0,China
13901,9/1/2020,CHN,Pahang,0,0,0,China
13902,9/1/2020,CHN,Perak,0,0,0,China
13903,9/1/2020,CHN,Perlis,0,0,0,China
13904,9/1/2020,CHN,Pulau Pinang,0,0,0,China
13905,9/1/2020,CHN,Sabah,0,0,0,China
13906,9/1/2020,CHN,Sarawak,33,19,14,China
13907,9/1/2020,CHN,Selangor,793,549,244,China
13908,9/1/2020,CHN,Terengganu,0,0,0,China
13909,9/1/2020,CHN,W.P. Labuan,1,0,1,China
13910,9/1/2020,CIV,Johor,0,0,0,C��te d'Iv
13911,9/1/2020,CIV,Kedah,0,0,0,C��te d'Iv
13912,9/1/2020,CIV,Pulau Pinang,0,0,0,C��te d'Iv
13913,9/1/2020,CIV,Sabah,0,0,0,C��te d'Iv
13914,9/1/2020,CIV,Sarawak,0,0,0,C��te d'Iv
13915,9/1/2020,CIV,Selangor,1,1,0,C��te d'Iv
13916,9/1/2020,CMR,Johor,0,0,0,Cameroon
13917,9/1/2020,CMR,Kedah,0,0,0,Cameroon
13918,9/1/2020,CMR,Pulau Pinang,0,0,0,Cameroon
13919,9/1/2020,CMR,Sabah,0,0,0,Cameroon
13920,9/1/2020,CMR,Sarawak,0,0,0,Cameroon
13921,9/1/2020,CMR,Selangor,0,0,0,Cameroon
13922,9/1/2020,COD,Johor,0,0,0,"Congo, the Democratic Republic of the"
13923,9/1/2020,COD,Pulau Pinang,0,0,0,"Congo, the Democratic Republic of the"
13924,9/1/2020,COD,Sarawak,0,0,0,"Congo, the Democratic Republic of the"
13925,9/1/2020,COD,Selangor,0,0,0,"Congo, the Democratic Republic of the"
13926,9/1/2020,COG,Johor,0,0,0,Congo
13927,9/1/2020,COG,Kedah,0,0,0,Congo
13928,9/1/2020,COG,Selangor,0,0,0,Congo
13929,9/1/2020,COK,Selangor,0,0,0,Cook Islands
13930,9/1/2020,COL,Johor,0,0,0,Colombia
13931,9/1/2020,COL,Kedah,0,0,0,Colombia
13932,9/1/2020,COL,Perak,0,0,0,Colombia
13933,9/1/2020,COL,Pulau Pinang,0,0,0,Colombia
13934,9/1/2020,COL,Sabah,0,0,0,Colombia
13935,9/1/2020,COL,Sarawak,0,0,0,Colombia
13936,9/1/2020,COL,Selangor,0,0,0,Colombia
13937,9/1/2020,COL,W.P. Labuan,0,0,0,Colombia
13938,9/1/2020,COM,Johor,0,0,0,Comoros
13939,9/1/2020,COM,Kedah,0,0,0,Comoros
13940,9/1/2020,COM,Selangor,0,0,0,Comoros
13941,9/1/2020,CPV,Johor,0,0,0,Cape Verde
13942,9/1/2020,CPV,Kedah,0,0,0,Cape Verde
13943,9/1/2020,CPV,Pulau Pinang,0,0,0,Cape Verde
13944,9/1/2020,CPV,Sabah,0,0,0,Cape Verde
13945,9/1/2020,CPV,Selangor,0,0,0,Cape Verde
13946,9/1/2020,CRI,Johor,0,0,0,Costa Rica
13947,9/1/2020,CRI,Kedah,0,0,0,Costa Rica
13948,9/1/2020,CRI,Perak,0,0,0,Costa Rica
13949,9/1/2020,CRI,Perlis,0,0,0,Costa Rica
13950,9/1/2020,CRI,Pulau Pinang,0,0,0,Costa Rica
13951,9/1/2020,CRI,Sabah,0,0,0,Costa Rica
13952,9/1/2020,CRI,Sarawak,0,0,0,Costa Rica
13953,9/1/2020,CRI,Selangor,0,0,0,Costa Rica
13954,9/1/2020,CUB,Johor,0,0,0,Cuba
13955,9/1/2020,CUB,Kedah,0,0,0,Cuba
13956,9/1/2020,CUB,Perlis,0,0,0,Cuba
13957,9/1/2020,CUB,Pulau Pinang,0,0,0,Cuba
13958,9/1/2020,CUB,Sabah,0,0,0,Cuba
13959,9/1/2020,CUB,Sarawak,0,0,0,Cuba
13960,9/1/2020,CUB,Selangor,0,0,0,Cuba
13961,9/1/2020,CYP,Johor,0,0,0,Cyprus
13962,9/1/2020,CYP,Kedah,0,0,0,Cyprus
13963,9/1/2020,CYP,Perak,0,0,0,Cyprus
13964,9/1/2020,CYP,Perlis,0,0,0,Cyprus
13965,9/1/2020,CYP,Pulau Pinang,0,0,0,Cyprus
13966,9/1/2020,CYP,Sabah,0,0,0,Cyprus
13967,9/1/2020,CYP,Sarawak,0,0,0,Cyprus
13968,9/1/2020,CYP,Selangor,1,1,0,Cyprus
13969,9/1/2020,CZE,Johor,0,0,0,Czech Republic
13970,9/1/2020,CZE,Kedah,0,0,0,Czech Republic
13971,9/1/2020,CZE,Kelantan,0,0,0,Czech Republic
13972,9/1/2020,CZE,Melaka,0,0,0,Czech Republic
13973,9/1/2020,CZE,Negeri Sembilan,0,0,0,Czech Republic
13974,9/1/2020,CZE,Perak,0,0,0,Czech Republic
13975,9/1/2020,CZE,Perlis,0,0,0,Czech Republic
13976,9/1/2020,CZE,Pulau Pinang,0,0,0,Czech Republic
13977,9/1/2020,CZE,Sabah,0,0,0,Czech Republic
13978,9/1/2020,CZE,Sarawak,0,0,0,Czech Republic
13979,9/1/2020,CZE,Selangor,24,19,5,Czech Republic
13980,9/1/2020,CZE,W.P. Labuan,0,0,0,Czech Republic
13981,9/1/2020,DEU,Johor,2,2,0,Germany
13982,9/1/2020,DEU,Kedah,0,0,0,Germany
13983,9/1/2020,DEU,Kelantan,0,0,0,Germany
13984,9/1/2020,DEU,Melaka,0,0,0,Germany
13985,9/1/2020,DEU,Negeri Sembilan,0,0,0,Germany
13986,9/1/2020,DEU,Pahang,0,0,0,Germany
13987,9/1/2020,DEU,Perak,0,0,0,Germany
13988,9/1/2020,DEU,Perlis,0,0,0,Germany
13989,9/1/2020,DEU,Pulau Pinang,0,0,0,Germany
13990,9/1/2020,DEU,Sabah,0,0,0,Germany
13991,9/1/2020,DEU,Sarawak,0,0,0,Germany
13992,9/1/2020,DEU,Selangor,71,57,14,Germany
13993,9/1/2020,DEU,Terengganu,0,0,0,Germany
13994,9/1/2020,DEU,W.P. Labuan,0,0,0,Germany
13995,9/1/2020,DJI,Johor,0,0,0,Djibouti
13996,9/1/2020,DJI,Selangor,0,0,0,Djibouti
13997,9/1/2020,DMA,Johor,0,0,0,Dominica
13998,9/1/2020,DMA,Kedah,0,0,0,Dominica
13999,9/1/2020,DMA,Pulau Pinang,0,0,0,Dominica
14000,9/1/2020,DMA,Sabah,0,0,0,Dominica
14001,9/1/2020,DMA,Sarawak,0,0,0,Dominica
14002,9/1/2020,DMA,Selangor,0,0,0,Dominica
14003,9/1/2020,DMA,W.P. Labuan,0,0,0,Dominica
14004,9/1/2020,DNK,Johor,2,2,0,Denmark
14005,9/1/2020,DNK,Kedah,0,0,0,Denmark
14006,9/1/2020,DNK,Kelantan,0,0,0,Denmark
14007,9/1/2020,DNK,Melaka,0,0,0,Denmark
14008,9/1/2020,DNK,Negeri Sembilan,0,0,0,Denmark
14009,9/1/2020,DNK,Pahang,0,0,0,Denmark
14010,9/1/2020,DNK,Perak,0,0,0,Denmark
14011,9/1/2020,DNK,Perlis,0,0,0,Denmark
14012,9/1/2020,DNK,Pulau Pinang,0,0,0,Denmark
14013,9/1/2020,DNK,Sabah,0,0,0,Denmark
14014,9/1/2020,DNK,Sarawak,0,0,0,Denmark
14015,9/1/2020,DNK,Selangor,17,13,4,Denmark
14016,9/1/2020,DNK,W.P. Labuan,0,0,0,Denmark
14017,9/1/2020,DOM,Johor,0,0,0,Dominican Republic
14018,9/1/2020,DOM,Kedah,0,0,0,Dominican Republic
14019,9/1/2020,DOM,Perak,0,0,0,Dominican Republic
14020,9/1/2020,DOM,Perlis,0,0,0,Dominican Republic
14021,9/1/2020,DOM,Pulau Pinang,0,0,0,Dominican Republic
14022,9/1/2020,DOM,Sabah,0,0,0,Dominican Republic
14023,9/1/2020,DOM,Sarawak,0,0,0,Dominican Republic
14024,9/1/2020,DOM,Selangor,0,0,0,Dominican Republic
14025,9/1/2020,DZA,Johor,0,0,0,Algeria
14026,9/1/2020,DZA,Kedah,0,0,0,Algeria
14027,9/1/2020,DZA,Kelantan,0,0,0,Algeria
14028,9/1/2020,DZA,Melaka,0,0,0,Algeria
14029,9/1/2020,DZA,Perak,0,0,0,Algeria
14030,9/1/2020,DZA,Perlis,0,0,0,Algeria
14031,9/1/2020,DZA,Pulau Pinang,0,0,0,Algeria
14032,9/1/2020,DZA,Sabah,0,0,0,Algeria
14033,9/1/2020,DZA,Sarawak,0,0,0,Algeria
14034,9/1/2020,DZA,Selangor,2,2,0,Algeria
14035,9/1/2020,DZA,W.P. Labuan,0,0,0,Algeria
14036,9/1/2020,ECU,Johor,0,0,0,Ecuador
14037,9/1/2020,ECU,Kedah,0,0,0,Ecuador
14038,9/1/2020,ECU,Perak,0,0,0,Ecuador
14039,9/1/2020,ECU,Perlis,0,0,0,Ecuador
14040,9/1/2020,ECU,Pulau Pinang,0,0,0,Ecuador
14041,9/1/2020,ECU,Sabah,0,0,0,Ecuador
14042,9/1/2020,ECU,Sarawak,0,0,0,Ecuador
14043,9/1/2020,ECU,Selangor,0,0,0,Ecuador
14044,9/1/2020,EGY,Johor,0,0,0,Egypt
14045,9/1/2020,EGY,Kedah,0,0,0,Egypt
14046,9/1/2020,EGY,Kelantan,0,0,0,Egypt
14047,9/1/2020,EGY,Melaka,0,0,0,Egypt
14048,9/1/2020,EGY,Pahang,0,0,0,Egypt
14049,9/1/2020,EGY,Perak,0,0,0,Egypt
14050,9/1/2020,EGY,Perlis,0,0,0,Egypt
14051,9/1/2020,EGY,Pulau Pinang,0,0,0,Egypt
14052,9/1/2020,EGY,Sabah,0,0,0,Egypt
14053,9/1/2020,EGY,Sarawak,0,0,0,Egypt
14054,9/1/2020,EGY,Selangor,35,28,7,Egypt
14055,9/1/2020,EGY,Terengganu,0,0,0,Egypt
14056,9/1/2020,EGY,W.P. Labuan,0,0,0,Egypt
14057,9/1/2020,ERI,Johor,0,0,0,Eritrea
14058,9/1/2020,ERI,Pulau Pinang,0,0,0,Eritrea
14059,9/1/2020,ERI,Sabah,0,0,0,Eritrea
14060,9/1/2020,ERI,Selangor,0,0,0,Eritrea
14061,9/1/2020,ESP,Johor,0,0,0,Spain
14062,9/1/2020,ESP,Kedah,0,0,0,Spain
14063,9/1/2020,ESP,Kelantan,0,0,0,Spain
14064,9/1/2020,ESP,Melaka,0,0,0,Spain
14065,9/1/2020,ESP,Negeri Sembilan,0,0,0,Spain
14066,9/1/2020,ESP,Pahang,0,0,0,Spain
14067,9/1/2020,ESP,Perak,0,0,0,Spain
14068,9/1/2020,ESP,Perlis,0,0,0,Spain
14069,9/1/2020,ESP,Pulau Pinang,0,0,0,Spain
14070,9/1/2020,ESP,Sabah,0,0,0,Spain
14071,9/1/2020,ESP,Sarawak,0,0,0,Spain
14072,9/1/2020,ESP,Selangor,8,5,3,Spain
14073,9/1/2020,ESP,W.P. Labuan,0,0,0,Spain
14074,9/1/2020,EST,Johor,0,0,0,Estonia
14075,9/1/2020,EST,Kedah,0,0,0,Estonia
14076,9/1/2020,EST,Kelantan,0,0,0,Estonia
14077,9/1/2020,EST,Pahang,0,0,0,Estonia
14078,9/1/2020,EST,Perak,0,0,0,Estonia
14079,9/1/2020,EST,Perlis,0,0,0,Estonia
14080,9/1/2020,EST,Pulau Pinang,0,0,0,Estonia
14081,9/1/2020,EST,Sabah,0,0,0,Estonia
14082,9/1/2020,EST,Sarawak,0,0,0,Estonia
14083,9/1/2020,EST,Selangor,0,0,0,Estonia
14084,9/1/2020,EST,W.P. Labuan,0,0,0,Estonia
14085,9/1/2020,ETH,Johor,0,0,0,Ethiopia
14086,9/1/2020,ETH,Kedah,0,0,0,Ethiopia
14087,9/1/2020,ETH,Pulau Pinang,0,0,0,Ethiopia
14088,9/1/2020,ETH,Sarawak,0,0,0,Ethiopia
14089,9/1/2020,ETH,Selangor,1,1,0,Ethiopia
14090,9/1/2020,FIN,Johor,0,0,0,Finland
14091,9/1/2020,FIN,Kedah,0,0,0,Finland
14092,9/1/2020,FIN,Kelantan,0,0,0,Finland
14093,9/1/2020,FIN,Melaka,0,0,0,Finland
14094,9/1/2020,FIN,Negeri Sembilan,0,0,0,Finland
14095,9/1/2020,FIN,Pahang,0,0,0,Finland
14096,9/1/2020,FIN,Perak,0,0,0,Finland
14097,9/1/2020,FIN,Perlis,0,0,0,Finland
14098,9/1/2020,FIN,Pulau Pinang,0,0,0,Finland
14099,9/1/2020,FIN,Sabah,0,0,0,Finland
14100,9/1/2020,FIN,Sarawak,0,0,0,Finland
14101,9/1/2020,FIN,Selangor,8,4,4,Finland
14102,9/1/2020,FIN,W.P. Labuan,0,0,0,Finland
14103,9/1/2020,FJI,Johor,0,0,0,Fiji
14104,9/1/2020,FJI,Kedah,0,0,0,Fiji
14105,9/1/2020,FJI,Kelantan,0,0,0,Fiji
14106,9/1/2020,FJI,Perak,0,0,0,Fiji
14107,9/1/2020,FJI,Perlis,0,0,0,Fiji
14108,9/1/2020,FJI,Pulau Pinang,0,0,0,Fiji
14109,9/1/2020,FJI,Sabah,0,0,0,Fiji
14110,9/1/2020,FJI,Sarawak,0,0,0,Fiji
14111,9/1/2020,FJI,Selangor,0,0,0,Fiji
14112,9/1/2020,FRA,Johor,5,5,0,France
14113,9/1/2020,FRA,Kedah,0,0,0,France
14114,9/1/2020,FRA,Kelantan,0,0,0,France
14115,9/1/2020,FRA,Melaka,0,0,0,France
14116,9/1/2020,FRA,Negeri Sembilan,0,0,0,France
14117,9/1/2020,FRA,Pahang,0,0,0,France
14118,9/1/2020,FRA,Perak,0,0,0,France
14119,9/1/2020,FRA,Perlis,0,0,0,France
14120,9/1/2020,FRA,Pulau Pinang,0,0,0,France
14121,9/1/2020,FRA,Sabah,0,0,0,France
14122,9/1/2020,FRA,Sarawak,0,0,0,France
14123,9/1/2020,FRA,Selangor,82,55,27,France
14124,9/1/2020,FRA,Terengganu,0,0,0,France
14125,9/1/2020,FRA,W.P. Labuan,0,0,0,France
14126,9/1/2020,FSM,Johor,0,0,0,"Micronesia, Federated States of"
14127,9/1/2020,FSM,Pulau Pinang,0,0,0,"Micronesia, Federated States of"
14128,9/1/2020,FSM,Selangor,0,0,0,"Micronesia, Federated States of"
14129,9/1/2020,GAB,Johor,0,0,0,Gabon
14130,9/1/2020,GAB,Pulau Pinang,0,0,0,Gabon
14131,9/1/2020,GAB,Sarawak,0,0,0,Gabon
14132,9/1/2020,GAB,Selangor,0,0,0,Gabon
14133,9/1/2020,GBR,Johor,6,6,0,United Kingdom
14134,9/1/2020,GBR,Kedah,0,0,0,United Kingdom
14135,9/1/2020,GBR,Kelantan,0,0,0,United Kingdom
14136,9/1/2020,GBR,Melaka,0,0,0,United Kingdom
14137,9/1/2020,GBR,Negeri Sembilan,0,0,0,United Kingdom
14138,9/1/2020,GBR,Pahang,0,0,0,United Kingdom
14139,9/1/2020,GBR,Perak,0,0,0,United Kingdom
14140,9/1/2020,GBR,Perlis,0,0,0,United Kingdom
14141,9/1/2020,GBR,Pulau Pinang,0,0,0,United Kingdom
14142,9/1/2020,GBR,Sabah,0,0,0,United Kingdom
14143,9/1/2020,GBR,Sarawak,2,2,0,United Kingdom
14144,9/1/2020,GBR,Selangor,238,184,54,United Kingdom
14145,9/1/2020,GBR,Terengganu,0,0,0,United Kingdom
14146,9/1/2020,GBR,W.P. Labuan,0,0,0,United Kingdom
14147,9/1/2020,GEO,Johor,0,0,0,Georgia
14148,9/1/2020,GEO,Kedah,0,0,0,Georgia
14149,9/1/2020,GEO,Melaka,0,0,0,Georgia
14150,9/1/2020,GEO,Perak,0,0,0,Georgia
14151,9/1/2020,GEO,Perlis,0,0,0,Georgia
14152,9/1/2020,GEO,Pulau Pinang,0,0,0,Georgia
14153,9/1/2020,GEO,Sabah,0,0,0,Georgia
14154,9/1/2020,GEO,Sarawak,0,0,0,Georgia
14155,9/1/2020,GEO,Selangor,7,7,0,Georgia
14156,9/1/2020,GHA,Johor,0,0,0,Ghana
14157,9/1/2020,GHA,Kedah,0,0,0,Ghana
14158,9/1/2020,GHA,Kelantan,0,0,0,Ghana
14159,9/1/2020,GHA,Pulau Pinang,0,0,0,Ghana
14160,9/1/2020,GHA,Sabah,0,0,0,Ghana
14161,9/1/2020,GHA,Sarawak,0,0,0,Ghana
14162,9/1/2020,GHA,Selangor,5,0,5,Ghana
14163,9/1/2020,GIB,Johor,0,0,0,Gibraltar
14164,9/1/2020,GIB,Sarawak,0,0,0,Gibraltar
14165,9/1/2020,GIN,Johor,0,0,0,Guinea
14166,9/1/2020,GIN,Kedah,0,0,0,Guinea
14167,9/1/2020,GIN,Kelantan,0,0,0,Guinea
14168,9/1/2020,GIN,Perlis,0,0,0,Guinea
14169,9/1/2020,GIN,Pulau Pinang,0,0,0,Guinea
14170,9/1/2020,GIN,Sabah,0,0,0,Guinea
14171,9/1/2020,GIN,Sarawak,0,0,0,Guinea
14172,9/1/2020,GIN,Selangor,1,1,0,Guinea
14173,9/1/2020,GLP,Selangor,0,0,0,Guadeloupe
14174,9/1/2020,GMB,Johor,0,0,0,Gambia
14175,9/1/2020,GMB,Kedah,0,0,0,Gambia
14176,9/1/2020,GMB,Kelantan,0,0,0,Gambia
14177,9/1/2020,GMB,Pulau Pinang,0,0,0,Gambia
14178,9/1/2020,GMB,Sabah,0,0,0,Gambia
14179,9/1/2020,GMB,Sarawak,0,0,0,Gambia
14180,9/1/2020,GMB,Selangor,0,0,0,Gambia
14181,9/1/2020,GNB,Johor,0,0,0,Guinea-Bissau
14182,9/1/2020,GNB,Selangor,0,0,0,Guinea-Bissau
14183,9/1/2020,GNQ,Johor,0,0,0,Equatorial Guinea
14184,9/1/2020,GNQ,Selangor,0,0,0,Equatorial Guinea
14185,9/1/2020,GRC,Johor,0,0,0,Greece
14186,9/1/2020,GRC,Kedah,0,0,0,Greece
14187,9/1/2020,GRC,Kelantan,0,0,0,Greece
14188,9/1/2020,GRC,Melaka,0,0,0,Greece
14189,9/1/2020,GRC,Negeri Sembilan,0,0,0,Greece
14190,9/1/2020,GRC,Pahang,0,0,0,Greece
14191,9/1/2020,GRC,Perak,0,0,0,Greece
14192,9/1/2020,GRC,Perlis,0,0,0,Greece
14193,9/1/2020,GRC,Pulau Pinang,0,0,0,Greece
14194,9/1/2020,GRC,Sabah,0,0,0,Greece
14195,9/1/2020,GRC,Sarawak,0,0,0,Greece
14196,9/1/2020,GRC,Selangor,7,6,1,Greece
14197,9/1/2020,GRD,Johor,0,0,0,Grenada
14198,9/1/2020,GRD,Kedah,0,0,0,Grenada
14199,9/1/2020,GRD,Pulau Pinang,0,0,0,Grenada
14200,9/1/2020,GRD,Sabah,0,0,0,Grenada
14201,9/1/2020,GRD,Sarawak,0,0,0,Grenada
14202,9/1/2020,GRD,Selangor,0,0,0,Grenada
14203,9/1/2020,GRL,Johor,0,0,0,Greenland
14204,9/1/2020,GRL,Selangor,0,0,0,Greenland
14205,9/1/2020,GTM,Johor,0,0,0,Guatemala
14206,9/1/2020,GTM,Kedah,0,0,0,Guatemala
14207,9/1/2020,GTM,Pahang,0,0,0,Guatemala
14208,9/1/2020,GTM,Perak,0,0,0,Guatemala
14209,9/1/2020,GTM,Pulau Pinang,0,0,0,Guatemala
14210,9/1/2020,GTM,Sabah,0,0,0,Guatemala
14211,9/1/2020,GTM,Sarawak,0,0,0,Guatemala
14212,9/1/2020,GTM,Selangor,0,0,0,Guatemala
14213,9/1/2020,GTM,W.P. Labuan,0,0,0,Guatemala
14214,9/1/2020,GUY,Johor,0,0,0,Guyana
14215,9/1/2020,GUY,Kedah,0,0,0,Guyana
14216,9/1/2020,GUY,Pulau Pinang,0,0,0,Guyana
14217,9/1/2020,GUY,Sarawak,0,0,0,Guyana
14218,9/1/2020,GUY,Selangor,0,0,0,Guyana
14219,9/1/2020,HKG,Johor,0,0,0,Hong Kong
14220,9/1/2020,HKG,Kedah,0,0,0,Hong Kong
14221,9/1/2020,HKG,Kelantan,0,0,0,Hong Kong
14222,9/1/2020,HKG,Pahang,0,0,0,Hong Kong
14223,9/1/2020,HKG,Perak,0,0,0,Hong Kong
14224,9/1/2020,HKG,Perlis,0,0,0,Hong Kong
14225,9/1/2020,HKG,Pulau Pinang,0,0,0,Hong Kong
14226,9/1/2020,HKG,Sabah,0,0,0,Hong Kong
14227,9/1/2020,HKG,Sarawak,0,0,0,Hong Kong
14228,9/1/2020,HKG,Selangor,0,0,0,Hong Kong
14229,9/1/2020,HKG,Terengganu,0,0,0,Hong Kong
14230,9/1/2020,HMD,Johor,0,0,0,Heard Island and McDonald Islands
14231,9/1/2020,HND,Johor,0,0,0,Honduras
14232,9/1/2020,HND,Kedah,0,0,0,Honduras
14233,9/1/2020,HND,Perak,0,0,0,Honduras
14234,9/1/2020,HND,Pulau Pinang,0,0,0,Honduras
14235,9/1/2020,HND,Sabah,0,0,0,Honduras
14236,9/1/2020,HND,Sarawak,0,0,0,Honduras
14237,9/1/2020,HND,Selangor,0,0,0,Honduras
14238,9/1/2020,HRV,Johor,2,2,0,Croatia
14239,9/1/2020,HRV,Kedah,0,0,0,Croatia
14240,9/1/2020,HRV,Kelantan,0,0,0,Croatia
14241,9/1/2020,HRV,Melaka,0,0,0,Croatia
14242,9/1/2020,HRV,Pahang,0,0,0,Croatia
14243,9/1/2020,HRV,Perak,0,0,0,Croatia
14244,9/1/2020,HRV,Perlis,0,0,0,Croatia
14245,9/1/2020,HRV,Pulau Pinang,0,0,0,Croatia
14246,9/1/2020,HRV,Sabah,0,0,0,Croatia
14247,9/1/2020,HRV,Sarawak,0,0,0,Croatia
14248,9/1/2020,HRV,Selangor,11,9,2,Croatia
14249,9/1/2020,HTI,Johor,0,0,0,Haiti
14250,9/1/2020,HTI,Kedah,0,0,0,Haiti
14251,9/1/2020,HTI,Kelantan,0,0,0,Haiti
14252,9/1/2020,HTI,Perak,0,0,0,Haiti
14253,9/1/2020,HTI,Pulau Pinang,0,0,0,Haiti
14254,9/1/2020,HTI,Sabah,0,0,0,Haiti
14255,9/1/2020,HTI,Selangor,0,0,0,Haiti
14256,9/1/2020,HUN,Johor,0,0,0,Hungary
14257,9/1/2020,HUN,Kedah,0,0,0,Hungary
14258,9/1/2020,HUN,Kelantan,0,0,0,Hungary
14259,9/1/2020,HUN,Pahang,0,0,0,Hungary
14260,9/1/2020,HUN,Perak,0,0,0,Hungary
14261,9/1/2020,HUN,Perlis,0,0,0,Hungary
14262,9/1/2020,HUN,Pulau Pinang,0,0,0,Hungary
14263,9/1/2020,HUN,Sabah,0,0,0,Hungary
14264,9/1/2020,HUN,Sarawak,0,0,0,Hungary
14265,9/1/2020,HUN,Selangor,5,3,2,Hungary
14266,9/1/2020,HUN,W.P. Labuan,0,0,0,Hungary
14267,9/1/2020,IDN,Johor,276,251,25,Indonesia
14268,9/1/2020,IDN,Kedah,4,4,0,Indonesia
14269,9/1/2020,IDN,Kelantan,0,0,0,Indonesia
14270,9/1/2020,IDN,Melaka,0,0,0,Indonesia
14271,9/1/2020,IDN,Negeri Sembilan,0,0,0,Indonesia
14272,9/1/2020,IDN,Pahang,0,0,0,Indonesia
14273,9/1/2020,IDN,Perak,0,0,0,Indonesia
14274,9/1/2020,IDN,Perlis,4,4,0,Indonesia
14275,9/1/2020,IDN,Pulau Pinang,3,0,3,Indonesia
14276,9/1/2020,IDN,Sabah,11,4,7,Indonesia
14277,9/1/2020,IDN,Sarawak,401,347,54,Indonesia
14278,9/1/2020,IDN,Selangor,673,496,177,Indonesia
14279,9/1/2020,IDN,Terengganu,0,0,0,Indonesia
14280,9/1/2020,IDN,W.P. Labuan,0,0,0,Indonesia
14281,9/1/2020,IND,Johor,83,82,1,India
14282,9/1/2020,IND,Kedah,0,0,0,India
14283,9/1/2020,IND,Kelantan,0,0,0,India
14284,9/1/2020,IND,Melaka,0,0,0,India
14285,9/1/2020,IND,Negeri Sembilan,0,0,0,India
14286,9/1/2020,IND,Pahang,0,0,0,India
14287,9/1/2020,IND,Perak,0,0,0,India
14288,9/1/2020,IND,Perlis,0,0,0,India
14289,9/1/2020,IND,Pulau Pinang,0,0,0,India
14290,9/1/2020,IND,Sabah,1,1,0,India
14291,9/1/2020,IND,Sarawak,0,0,0,India
14292,9/1/2020,IND,Selangor,472,341,131,India
14293,9/1/2020,IND,Terengganu,0,0,0,India
14294,9/1/2020,IND,W.P. Labuan,0,0,0,India
14295,9/1/2020,IOT,Pulau Pinang,0,0,0,British Indian Ocean Territory
14296,9/1/2020,IOT,Selangor,0,0,0,British Indian Ocean Territory
14297,9/1/2020,IRL,Johor,1,1,0,Ireland
14298,9/1/2020,IRL,Kedah,0,0,0,Ireland
14299,9/1/2020,IRL,Kelantan,0,0,0,Ireland
14300,9/1/2020,IRL,Negeri Sembilan,0,0,0,Ireland
14301,9/1/2020,IRL,Pahang,0,0,0,Ireland
14302,9/1/2020,IRL,Perak,0,0,0,Ireland
14303,9/1/2020,IRL,Perlis,0,0,0,Ireland
14304,9/1/2020,IRL,Pulau Pinang,0,0,0,Ireland
14305,9/1/2020,IRL,Sabah,0,0,0,Ireland
14306,9/1/2020,IRL,Sarawak,0,0,0,Ireland
14307,9/1/2020,IRL,Selangor,11,9,2,Ireland
14308,9/1/2020,IRL,Terengganu,0,0,0,Ireland
14309,9/1/2020,IRL,W.P. Labuan,0,0,0,Ireland
14310,9/1/2020,IRN,Johor,0,0,0,Iran
14311,9/1/2020,IRN,Kedah,0,0,0,Iran
14312,9/1/2020,IRN,Kelantan,0,0,0,Iran
14313,9/1/2020,IRN,Perak,0,0,0,Iran
14314,9/1/2020,IRN,Perlis,0,0,0,Iran
14315,9/1/2020,IRN,Pulau Pinang,0,0,0,Iran
14316,9/1/2020,IRN,Sabah,0,0,0,Iran
14317,9/1/2020,IRN,Sarawak,0,0,0,Iran
14318,9/1/2020,IRN,Selangor,19,13,6,Iran
14319,9/1/2020,IRN,W.P. Labuan,0,0,0,Iran
14320,9/1/2020,IRQ,Johor,0,0,0,Iraq
14321,9/1/2020,IRQ,Kedah,0,0,0,Iraq
14322,9/1/2020,IRQ,Kelantan,0,0,0,Iraq
14323,9/1/2020,IRQ,Melaka,0,0,0,Iraq
14324,9/1/2020,IRQ,Pahang,0,0,0,Iraq
14325,9/1/2020,IRQ,Perak,0,0,0,Iraq
14326,9/1/2020,IRQ,Perlis,0,0,0,Iraq
14327,9/1/2020,IRQ,Pulau Pinang,0,0,0,Iraq
14328,9/1/2020,IRQ,Sabah,0,0,0,Iraq
14329,9/1/2020,IRQ,Sarawak,0,0,0,Iraq
14330,9/1/2020,IRQ,Selangor,16,10,6,Iraq
14331,9/1/2020,ISL,Johor,0,0,0,Iceland
14332,9/1/2020,ISL,Kedah,0,0,0,Iceland
14333,9/1/2020,ISL,Kelantan,0,0,0,Iceland
14334,9/1/2020,ISL,Perak,0,0,0,Iceland
14335,9/1/2020,ISL,Perlis,0,0,0,Iceland
14336,9/1/2020,ISL,Pulau Pinang,0,0,0,Iceland
14337,9/1/2020,ISL,Sabah,0,0,0,Iceland
14338,9/1/2020,ISL,Sarawak,0,0,0,Iceland
14339,9/1/2020,ISL,Selangor,1,0,1,Iceland
14340,9/1/2020,ISL,W.P. Labuan,0,0,0,Iceland
14341,9/1/2020,ISR,Pulau Pinang,0,0,0,Israel
14342,9/1/2020,ITA,Johor,0,0,0,Italy
14343,9/1/2020,ITA,Kedah,0,0,0,Italy
14344,9/1/2020,ITA,Kelantan,0,0,0,Italy
14345,9/1/2020,ITA,Melaka,0,0,0,Italy
14346,9/1/2020,ITA,Negeri Sembilan,0,0,0,Italy
14347,9/1/2020,ITA,Pahang,0,0,0,Italy
14348,9/1/2020,ITA,Perak,0,0,0,Italy
14349,9/1/2020,ITA,Perlis,0,0,0,Italy
14350,9/1/2020,ITA,Pulau Pinang,0,0,0,Italy
14351,9/1/2020,ITA,Sabah,0,0,0,Italy
14352,9/1/2020,ITA,Sarawak,0,0,0,Italy
14353,9/1/2020,ITA,Selangor,18,17,1,Italy
14354,9/1/2020,ITA,W.P. Labuan,0,0,0,Italy
14355,9/1/2020,JAM,Johor,0,0,0,Jamaica
14356,9/1/2020,JAM,Kedah,0,0,0,Jamaica
14357,9/1/2020,JAM,Perak,0,0,0,Jamaica
14358,9/1/2020,JAM,Pulau Pinang,0,0,0,Jamaica
14359,9/1/2020,JAM,Sabah,0,0,0,Jamaica
14360,9/1/2020,JAM,Sarawak,0,0,0,Jamaica
14361,9/1/2020,JAM,Selangor,0,0,0,Jamaica
14362,9/1/2020,JAM,W.P. Labuan,0,0,0,Jamaica
14363,9/1/2020,JOR,Johor,0,0,0,Jordan
14364,9/1/2020,JOR,Kedah,0,0,0,Jordan
14365,9/1/2020,JOR,Kelantan,0,0,0,Jordan
14366,9/1/2020,JOR,Melaka,0,0,0,Jordan
14367,9/1/2020,JOR,Perlis,0,0,0,Jordan
14368,9/1/2020,JOR,Pulau Pinang,0,0,0,Jordan
14369,9/1/2020,JOR,Sabah,0,0,0,Jordan
14370,9/1/2020,JOR,Sarawak,1,1,0,Jordan
14371,9/1/2020,JOR,Selangor,7,5,2,Jordan
14372,9/1/2020,JOR,W.P. Labuan,0,0,0,Jordan
14373,9/1/2020,JPN,Johor,2,2,0,Japan
14374,9/1/2020,JPN,Kedah,0,0,0,Japan
14375,9/1/2020,JPN,Kelantan,0,0,0,Japan
14376,9/1/2020,JPN,Melaka,0,0,0,Japan
14377,9/1/2020,JPN,Negeri Sembilan,0,0,0,Japan
14378,9/1/2020,JPN,Pahang,0,0,0,Japan
14379,9/1/2020,JPN,Perak,0,0,0,Japan
14380,9/1/2020,JPN,Perlis,0,0,0,Japan
14381,9/1/2020,JPN,Pulau Pinang,1,1,0,Japan
14382,9/1/2020,JPN,Sabah,1,0,1,Japan
14383,9/1/2020,JPN,Sarawak,1,1,0,Japan
14384,9/1/2020,JPN,Selangor,436,290,146,Japan
14385,9/1/2020,JPN,W.P. Labuan,0,0,0,Japan
14386,9/1/2020,KAZ,Johor,0,0,0,Kazakhstan
14387,9/1/2020,KAZ,Kedah,0,0,0,Kazakhstan
14388,9/1/2020,KAZ,Kelantan,0,0,0,Kazakhstan
14389,9/1/2020,KAZ,Melaka,0,0,0,Kazakhstan
14390,9/1/2020,KAZ,Perak,0,0,0,Kazakhstan
14391,9/1/2020,KAZ,Perlis,0,0,0,Kazakhstan
14392,9/1/2020,KAZ,Pulau Pinang,0,0,0,Kazakhstan
14393,9/1/2020,KAZ,Sabah,0,0,0,Kazakhstan
14394,9/1/2020,KAZ,Sarawak,0,0,0,Kazakhstan
14395,9/1/2020,KAZ,Selangor,9,4,5,Kazakhstan
14396,9/1/2020,KAZ,W.P. Labuan,0,0,0,Kazakhstan
14397,9/1/2020,KEN,Johor,0,0,0,Kenya
14398,9/1/2020,KEN,Kedah,0,0,0,Kenya
14399,9/1/2020,KEN,Kelantan,0,0,0,Kenya
14400,9/1/2020,KEN,Perak,0,0,0,Kenya
14401,9/1/2020,KEN,Perlis,0,0,0,Kenya
14402,9/1/2020,KEN,Pulau Pinang,0,0,0,Kenya
14403,9/1/2020,KEN,Sabah,0,0,0,Kenya
14404,9/1/2020,KEN,Sarawak,0,0,0,Kenya
14405,9/1/2020,KEN,Selangor,6,2,4,Kenya
14406,9/1/2020,KGZ,Johor,0,0,0,Kyrgyzstan
14407,9/1/2020,KGZ,Kedah,0,0,0,Kyrgyzstan
14408,9/1/2020,KGZ,Kelantan,0,0,0,Kyrgyzstan
14409,9/1/2020,KGZ,Perak,0,0,0,Kyrgyzstan
14410,9/1/2020,KGZ,Perlis,0,0,0,Kyrgyzstan
14411,9/1/2020,KGZ,Pulau Pinang,0,0,0,Kyrgyzstan
14412,9/1/2020,KGZ,Sabah,0,0,0,Kyrgyzstan
14413,9/1/2020,KGZ,Sarawak,0,0,0,Kyrgyzstan
14414,9/1/2020,KGZ,Selangor,3,3,0,Kyrgyzstan
14415,9/1/2020,KHM,Johor,0,0,0,Cambodia
14416,9/1/2020,KHM,Kedah,0,0,0,Cambodia
14417,9/1/2020,KHM,Kelantan,0,0,0,Cambodia
14418,9/1/2020,KHM,Melaka,0,0,0,Cambodia
14419,9/1/2020,KHM,Negeri Sembilan,0,0,0,Cambodia
14420,9/1/2020,KHM,Pahang,0,0,0,Cambodia
14421,9/1/2020,KHM,Perak,0,0,0,Cambodia
14422,9/1/2020,KHM,Perlis,0,0,0,Cambodia
14423,9/1/2020,KHM,Pulau Pinang,0,0,0,Cambodia
14424,9/1/2020,KHM,Sabah,0,0,0,Cambodia
14425,9/1/2020,KHM,Sarawak,0,0,0,Cambodia
14426,9/1/2020,KHM,Selangor,5,1,4,Cambodia
14427,9/1/2020,KHM,W.P. Labuan,0,0,0,Cambodia
14428,9/1/2020,KIR,Johor,0,0,0,Kiribati
14429,9/1/2020,KIR,Sabah,0,0,0,Kiribati
14430,9/1/2020,KIR,Selangor,0,0,0,Kiribati
14431,9/1/2020,KNA,Johor,0,0,0,Saint Kitts and Nevis
14432,9/1/2020,KNA,Kedah,0,0,0,Saint Kitts and Nevis
14433,9/1/2020,KNA,Perlis,0,0,0,Saint Kitts and Nevis
14434,9/1/2020,KNA,Pulau Pinang,0,0,0,Saint Kitts and Nevis
14435,9/1/2020,KNA,Sabah,0,0,0,Saint Kitts and Nevis
14436,9/1/2020,KNA,Selangor,1,1,0,Saint Kitts and Nevis
14437,9/1/2020,KNA,W.P. Labuan,0,0,0,Saint Kitts and Nevis
14438,9/1/2020,KOR,Johor,17,17,0,"Korea, Republic of (South Korea)"
14439,9/1/2020,KOR,Kedah,0,0,0,"Korea, Republic of (South Korea)"
14440,9/1/2020,KOR,Kelantan,0,0,0,"Korea, Republic of (South Korea)"
14441,9/1/2020,KOR,Melaka,0,0,0,"Korea, Republic of (South Korea)"
14442,9/1/2020,KOR,Negeri Sembilan,0,0,0,"Korea, Republic of (South Korea)"
14443,9/1/2020,KOR,Pahang,0,0,0,"Korea, Republic of (South Korea)"
14444,9/1/2020,KOR,Perak,0,0,0,"Korea, Republic of (South Korea)"
14445,9/1/2020,KOR,Perlis,0,0,0,"Korea, Republic of (South Korea)"
14446,9/1/2020,KOR,Pulau Pinang,0,0,0,"Korea, Republic of (South Korea)"
14447,9/1/2020,KOR,Sabah,1,0,1,"Korea, Republic of (South Korea)"
14448,9/1/2020,KOR,Sarawak,3,2,1,"Korea, Republic of (South Korea)"
14449,9/1/2020,KOR,Selangor,359,195,164,"Korea, Republic of (South Korea)"
14450,9/1/2020,KOR,Terengganu,0,0,0,"Korea, Republic of (South Korea)"
14451,9/1/2020,KOR,W.P. Labuan,0,0,0,"Korea, Republic of (South Korea)"
14452,9/1/2020,KWT,Johor,0,0,0,Kuwait
14453,9/1/2020,KWT,Kedah,0,0,0,Kuwait
14454,9/1/2020,KWT,Kelantan,0,0,0,Kuwait
14455,9/1/2020,KWT,Perak,0,0,0,Kuwait
14456,9/1/2020,KWT,Perlis,0,0,0,Kuwait
14457,9/1/2020,KWT,Pulau Pinang,0,0,0,Kuwait
14458,9/1/2020,KWT,Sabah,0,0,0,Kuwait
14459,9/1/2020,KWT,Sarawak,0,0,0,Kuwait
14460,9/1/2020,KWT,Selangor,2,2,0,Kuwait
14461,9/1/2020,KWT,W.P. Labuan,0,0,0,Kuwait
14462,9/1/2020,LAO,Johor,0,0,0,Lao People's Democratic Republic
14463,9/1/2020,LAO,Kedah,0,0,0,Lao People's Democratic Republic
14464,9/1/2020,LAO,Kelantan,0,0,0,Lao People's Democratic Republic
14465,9/1/2020,LAO,Melaka,0,0,0,Lao People's Democratic Republic
14466,9/1/2020,LAO,Perak,0,0,0,Lao People's Democratic Republic
14467,9/1/2020,LAO,Perlis,0,0,0,Lao People's Democratic Republic
14468,9/1/2020,LAO,Pulau Pinang,0,0,0,Lao People's Democratic Republic
14469,9/1/2020,LAO,Sabah,0,0,0,Lao People's Democratic Republic
14470,9/1/2020,LAO,Sarawak,0,0,0,Lao People's Democratic Republic
14471,9/1/2020,LAO,Selangor,1,0,1,Lao People's Democratic Republic
14472,9/1/2020,LAO,W.P. Labuan,0,0,0,Lao People's Democratic Republic
14473,9/1/2020,LBN,Johor,0,0,0,Lebanon
14474,9/1/2020,LBN,Kedah,0,0,0,Lebanon
14475,9/1/2020,LBN,Kelantan,0,0,0,Lebanon
14476,9/1/2020,LBN,Pahang,0,0,0,Lebanon
14477,9/1/2020,LBN,Perak,0,0,0,Lebanon
14478,9/1/2020,LBN,Perlis,0,0,0,Lebanon
14479,9/1/2020,LBN,Pulau Pinang,0,0,0,Lebanon
14480,9/1/2020,LBN,Sabah,0,0,0,Lebanon
14481,9/1/2020,LBN,Sarawak,0,0,0,Lebanon
14482,9/1/2020,LBN,Selangor,5,4,1,Lebanon
14483,9/1/2020,LBN,W.P. Labuan,0,0,0,Lebanon
14484,9/1/2020,LBR,Johor,0,0,0,Liberia
14485,9/1/2020,LBR,Kedah,0,0,0,Liberia
14486,9/1/2020,LBR,Sabah,0,0,0,Liberia
14487,9/1/2020,LBR,Sarawak,0,0,0,Liberia
14488,9/1/2020,LBR,Selangor,0,0,0,Liberia
14489,9/1/2020,LBY,Johor,0,0,0,Libyan Arab Jamahiriya
14490,9/1/2020,LBY,Kedah,0,0,0,Libyan Arab Jamahiriya
14491,9/1/2020,LBY,Perlis,0,0,0,Libyan Arab Jamahiriya
14492,9/1/2020,LBY,Pulau Pinang,0,0,0,Libyan Arab Jamahiriya
14493,9/1/2020,LBY,Sabah,0,0,0,Libyan Arab Jamahiriya
14494,9/1/2020,LBY,Sarawak,0,0,0,Libyan Arab Jamahiriya
14495,9/1/2020,LBY,Selangor,2,1,1,Libyan Arab Jamahiriya
14496,9/1/2020,LCA,Johor,0,0,0,Saint Lucia
14497,9/1/2020,LCA,Kedah,0,0,0,Saint Lucia
14498,9/1/2020,LCA,Pulau Pinang,0,0,0,Saint Lucia
14499,9/1/2020,LCA,Sarawak,0,0,0,Saint Lucia
14500,9/1/2020,LCA,Selangor,0,0,0,Saint Lucia
14501,9/1/2020,LIE,Johor,0,0,0,Liechtenstein
14502,9/1/2020,LIE,Kedah,0,0,0,Liechtenstein
14503,9/1/2020,LIE,Perlis,0,0,0,Liechtenstein
14504,9/1/2020,LIE,Pulau Pinang,0,0,0,Liechtenstein
14505,9/1/2020,LIE,Sabah,0,0,0,Liechtenstein
14506,9/1/2020,LIE,Sarawak,0,0,0,Liechtenstein
14507,9/1/2020,LIE,Selangor,0,0,0,Liechtenstein
14508,9/1/2020,LKA,Johor,4,4,0,Sri Lanka
14509,9/1/2020,LKA,Kedah,0,0,0,Sri Lanka
14510,9/1/2020,LKA,Kelantan,0,0,0,Sri Lanka
14511,9/1/2020,LKA,Melaka,0,0,0,Sri Lanka
14512,9/1/2020,LKA,Pahang,0,0,0,Sri Lanka
14513,9/1/2020,LKA,Perak,0,0,0,Sri Lanka
14514,9/1/2020,LKA,Perlis,0,0,0,Sri Lanka
14515,9/1/2020,LKA,Pulau Pinang,0,0,0,Sri Lanka
14516,9/1/2020,LKA,Sabah,0,0,0,Sri Lanka
14517,9/1/2020,LKA,Sarawak,2,1,1,Sri Lanka
14518,9/1/2020,LKA,Selangor,35,16,19,Sri Lanka
14519,9/1/2020,LKA,W.P. Labuan,0,0,0,Sri Lanka
14520,9/1/2020,LSO,Johor,0,0,0,Lesotho
14521,9/1/2020,LSO,Kedah,0,0,0,Lesotho
14522,9/1/2020,LSO,Pulau Pinang,0,0,0,Lesotho
14523,9/1/2020,LSO,Sarawak,0,0,0,Lesotho
14524,9/1/2020,LSO,Selangor,0,0,0,Lesotho
14525,9/1/2020,LTU,Johor,2,2,0,Lithuania
14526,9/1/2020,LTU,Kedah,0,0,0,Lithuania
14527,9/1/2020,LTU,Kelantan,0,0,0,Lithuania
14528,9/1/2020,LTU,Pahang,0,0,0,Lithuania
14529,9/1/2020,LTU,Perak,0,0,0,Lithuania
14530,9/1/2020,LTU,Perlis,0,0,0,Lithuania
14531,9/1/2020,LTU,Pulau Pinang,0,0,0,Lithuania
14532,9/1/2020,LTU,Sabah,0,0,0,Lithuania
14533,9/1/2020,LTU,Sarawak,0,0,0,Lithuania
14534,9/1/2020,LTU,Selangor,3,3,0,Lithuania
14535,9/1/2020,LTU,W.P. Labuan,0,0,0,Lithuania
14536,9/1/2020,LUX,Johor,0,0,0,Luxembourg
14537,9/1/2020,LUX,Kedah,0,0,0,Luxembourg
14538,9/1/2020,LUX,Kelantan,0,0,0,Luxembourg
14539,9/1/2020,LUX,Perak,0,0,0,Luxembourg
14540,9/1/2020,LUX,Perlis,0,0,0,Luxembourg
14541,9/1/2020,LUX,Pulau Pinang,0,0,0,Luxembourg
14542,9/1/2020,LUX,Sabah,0,0,0,Luxembourg
14543,9/1/2020,LUX,Sarawak,0,0,0,Luxembourg
14544,9/1/2020,LUX,Selangor,1,1,0,Luxembourg
14545,9/1/2020,LVA,Johor,0,0,0,Latvia
14546,9/1/2020,LVA,Kedah,0,0,0,Latvia
14547,9/1/2020,LVA,Kelantan,0,0,0,Latvia
14548,9/1/2020,LVA,Pahang,0,0,0,Latvia
14549,9/1/2020,LVA,Perak,0,0,0,Latvia
14550,9/1/2020,LVA,Perlis,0,0,0,Latvia
14551,9/1/2020,LVA,Pulau Pinang,0,0,0,Latvia
14552,9/1/2020,LVA,Sabah,0,0,0,Latvia
14553,9/1/2020,LVA,Sarawak,0,0,0,Latvia
14554,9/1/2020,LVA,Selangor,5,5,0,Latvia
14555,9/1/2020,LVA,W.P. Labuan,0,0,0,Latvia
14556,9/1/2020,MAC,Johor,0,0,0,Macao
14557,9/1/2020,MAC,Pahang,0,0,0,Macao
14558,9/1/2020,MAC,Perak,0,0,0,Macao
14559,9/1/2020,MAC,Selangor,0,0,0,Macao
14560,9/1/2020,MAC,W.P. Labuan,0,0,0,Macao
14561,9/1/2020,MAR,Johor,0,0,0,Morocco
14562,9/1/2020,MAR,Kedah,0,0,0,Morocco
14563,9/1/2020,MAR,Kelantan,0,0,0,Morocco
14564,9/1/2020,MAR,Melaka,0,0,0,Morocco
14565,9/1/2020,MAR,Pahang,0,0,0,Morocco
14566,9/1/2020,MAR,Perak,0,0,0,Morocco
14567,9/1/2020,MAR,Perlis,0,0,0,Morocco
14568,9/1/2020,MAR,Pulau Pinang,0,0,0,Morocco
14569,9/1/2020,MAR,Sabah,0,0,0,Morocco
14570,9/1/2020,MAR,Sarawak,0,0,0,Morocco
14571,9/1/2020,MAR,Selangor,5,1,4,Morocco
14572,9/1/2020,MAR,W.P. Labuan,0,0,0,Morocco
14573,9/1/2020,MCO,Johor,0,0,0,Monaco
14574,9/1/2020,MCO,Kedah,0,0,0,Monaco
14575,9/1/2020,MCO,Sabah,0,0,0,Monaco
14576,9/1/2020,MCO,Selangor,0,0,0,Monaco
14577,9/1/2020,MDA,Johor,0,0,0,"Moldova, Republic of"
14578,9/1/2020,MDA,Kedah,0,0,0,"Moldova, Republic of"
14579,9/1/2020,MDA,Kelantan,0,0,0,"Moldova, Republic of"
14580,9/1/2020,MDA,Negeri Sembilan,0,0,0,"Moldova, Republic of"
14581,9/1/2020,MDA,Perlis,0,0,0,"Moldova, Republic of"
14582,9/1/2020,MDA,Pulau Pinang,0,0,0,"Moldova, Republic of"
14583,9/1/2020,MDA,Sabah,0,0,0,"Moldova, Republic of"
14584,9/1/2020,MDA,Sarawak,0,0,0,"Moldova, Republic of"
14585,9/1/2020,MDA,Selangor,1,0,1,"Moldova, Republic of"
14586,9/1/2020,MDG,Johor,0,0,0,Madagascar
14587,9/1/2020,MDG,Kedah,0,0,0,Madagascar
14588,9/1/2020,MDG,Perak,0,0,0,Madagascar
14589,9/1/2020,MDG,Perlis,0,0,0,Madagascar
14590,9/1/2020,MDG,Pulau Pinang,0,0,0,Madagascar
14591,9/1/2020,MDG,Sabah,0,0,0,Madagascar
14592,9/1/2020,MDG,Sarawak,0,0,0,Madagascar
14593,9/1/2020,MDG,Selangor,0,0,0,Madagascar
14594,9/1/2020,MDV,Johor,0,0,0,Maldives
14595,9/1/2020,MDV,Kedah,0,0,0,Maldives
14596,9/1/2020,MDV,Kelantan,0,0,0,Maldives
14597,9/1/2020,MDV,Perak,0,0,0,Maldives
14598,9/1/2020,MDV,Perlis,0,0,0,Maldives
14599,9/1/2020,MDV,Pulau Pinang,0,0,0,Maldives
14600,9/1/2020,MDV,Sabah,0,0,0,Maldives
14601,9/1/2020,MDV,Sarawak,0,0,0,Maldives
14602,9/1/2020,MDV,Selangor,50,20,30,Maldives
14603,9/1/2020,MEX,Johor,0,0,0,Mexico
14604,9/1/2020,MEX,Kedah,0,0,0,Mexico
14605,9/1/2020,MEX,Kelantan,0,0,0,Mexico
14606,9/1/2020,MEX,Pahang,0,0,0,Mexico
14607,9/1/2020,MEX,Perak,0,0,0,Mexico
14608,9/1/2020,MEX,Perlis,0,0,0,Mexico
14609,9/1/2020,MEX,Pulau Pinang,0,0,0,Mexico
14610,9/1/2020,MEX,Sabah,0,0,0,Mexico
14611,9/1/2020,MEX,Sarawak,0,0,0,Mexico
14612,9/1/2020,MEX,Selangor,4,2,2,Mexico
14613,9/1/2020,MEX,W.P. Labuan,0,0,0,Mexico
14614,9/1/2020,MHL,Johor,0,0,0,Marshall Islands
14615,9/1/2020,MHL,Kedah,0,0,0,Marshall Islands
14616,9/1/2020,MHL,Perak,0,0,0,Marshall Islands
14617,9/1/2020,MHL,Pulau Pinang,0,0,0,Marshall Islands
14618,9/1/2020,MHL,Sabah,0,0,0,Marshall Islands
14619,9/1/2020,MHL,Selangor,0,0,0,Marshall Islands
14620,9/1/2020,MKD,Johor,0,0,0,"Macedonia, the former Yugoslav Republic of"
14621,9/1/2020,MKD,Kedah,0,0,0,"Macedonia, the former Yugoslav Republic of"
14622,9/1/2020,MKD,Perak,0,0,0,"Macedonia, the former Yugoslav Republic of"
14623,9/1/2020,MKD,Pulau Pinang,0,0,0,"Macedonia, the former Yugoslav Republic of"
14624,9/1/2020,MKD,Sabah,0,0,0,"Macedonia, the former Yugoslav Republic of"
14625,9/1/2020,MKD,Sarawak,0,0,0,"Macedonia, the former Yugoslav Republic of"
14626,9/1/2020,MKD,Selangor,0,0,0,"Macedonia, the former Yugoslav Republic of"
14627,9/1/2020,MLI,Johor,0,0,0,Mali
14628,9/1/2020,MLI,Sabah,0,0,0,Mali
14629,9/1/2020,MLI,Selangor,1,1,0,Mali
14630,9/1/2020,MLT,Johor,0,0,0,Malta
14631,9/1/2020,MLT,Kedah,0,0,0,Malta
14632,9/1/2020,MLT,Kelantan,0,0,0,Malta
14633,9/1/2020,MLT,Perak,0,0,0,Malta
14634,9/1/2020,MLT,Perlis,0,0,0,Malta
14635,9/1/2020,MLT,Pulau Pinang,0,0,0,Malta
14636,9/1/2020,MLT,Sabah,0,0,0,Malta
14637,9/1/2020,MLT,Sarawak,0,0,0,Malta
14638,9/1/2020,MLT,Selangor,0,0,0,Malta
14639,9/1/2020,MLT,W.P. Labuan,0,0,0,Malta
14640,9/1/2020,MMR,Johor,12,12,0,Myanmar
14641,9/1/2020,MMR,Kedah,0,0,0,Myanmar
14642,9/1/2020,MMR,Kelantan,0,0,0,Myanmar
14643,9/1/2020,MMR,Negeri Sembilan,0,0,0,Myanmar
14644,9/1/2020,MMR,Pahang,0,0,0,Myanmar
14645,9/1/2020,MMR,Perak,0,0,0,Myanmar
14646,9/1/2020,MMR,Perlis,0,0,0,Myanmar
14647,9/1/2020,MMR,Pulau Pinang,0,0,0,Myanmar
14648,9/1/2020,MMR,Sabah,0,0,0,Myanmar
14649,9/1/2020,MMR,Sarawak,0,0,0,Myanmar
14650,9/1/2020,MMR,Selangor,113,102,11,Myanmar
14651,9/1/2020,MMR,Terengganu,0,0,0,Myanmar
14652,9/1/2020,MMR,W.P. Labuan,0,0,0,Myanmar
14653,9/1/2020,MNE,Johor,0,0,0,Montenegro
14654,9/1/2020,MNE,Kedah,0,0,0,Montenegro
14655,9/1/2020,MNE,Pulau Pinang,0,0,0,Montenegro
14656,9/1/2020,MNE,Sabah,0,0,0,Montenegro
14657,9/1/2020,MNE,Sarawak,0,0,0,Montenegro
14658,9/1/2020,MNE,Selangor,1,0,1,Montenegro
14659,9/1/2020,MNG,Johor,0,0,0,Mongolia
14660,9/1/2020,MNG,Kedah,0,0,0,Mongolia
14661,9/1/2020,MNG,Kelantan,0,0,0,Mongolia
14662,9/1/2020,MNG,Perak,0,0,0,Mongolia
14663,9/1/2020,MNG,Perlis,0,0,0,Mongolia
14664,9/1/2020,MNG,Pulau Pinang,0,0,0,Mongolia
14665,9/1/2020,MNG,Sabah,0,0,0,Mongolia
14666,9/1/2020,MNG,Sarawak,0,0,0,Mongolia
14667,9/1/2020,MNG,Selangor,0,0,0,Mongolia
14668,9/1/2020,MNP,Selangor,0,0,0,Northern Mariana Islands
14669,9/1/2020,MOZ,Johor,0,0,0,Mozambique
14670,9/1/2020,MOZ,Kedah,0,0,0,Mozambique
14671,9/1/2020,MOZ,Perak,0,0,0,Mozambique
14672,9/1/2020,MOZ,Pulau Pinang,0,0,0,Mozambique
14673,9/1/2020,MOZ,Sabah,0,0,0,Mozambique
14674,9/1/2020,MOZ,Sarawak,0,0,0,Mozambique
14675,9/1/2020,MOZ,Selangor,1,0,1,Mozambique
14676,9/1/2020,MRT,Johor,0,0,0,Mauritania
14677,9/1/2020,MRT,Kedah,0,0,0,Mauritania
14678,9/1/2020,MRT,Pulau Pinang,0,0,0,Mauritania
14679,9/1/2020,MRT,Sabah,0,0,0,Mauritania
14680,9/1/2020,MRT,Sarawak,0,0,0,Mauritania
14681,9/1/2020,MRT,Selangor,1,1,0,Mauritania
14682,9/1/2020,MUS,Johor,0,0,0,Mauritius
14683,9/1/2020,MUS,Kedah,0,0,0,Mauritius
14684,9/1/2020,MUS,Kelantan,0,0,0,Mauritius
14685,9/1/2020,MUS,Pahang,0,0,0,Mauritius
14686,9/1/2020,MUS,Perak,0,0,0,Mauritius
14687,9/1/2020,MUS,Perlis,0,0,0,Mauritius
14688,9/1/2020,MUS,Pulau Pinang,0,0,0,Mauritius
14689,9/1/2020,MUS,Sabah,0,0,0,Mauritius
14690,9/1/2020,MUS,Sarawak,0,0,0,Mauritius
14691,9/1/2020,MUS,Selangor,4,2,2,Mauritius
14692,9/1/2020,MWI,Johor,0,0,0,Malawi
14693,9/1/2020,MWI,Pulau Pinang,0,0,0,Malawi
14694,9/1/2020,MWI,Sabah,0,0,0,Malawi
14695,9/1/2020,MWI,Sarawak,0,0,0,Malawi
14696,9/1/2020,MWI,Selangor,0,0,0,Malawi
14697,9/1/2020,MYT,Selangor,0,0,0,Mayotte
14698,9/1/2020,NAM,Johor,0,0,0,Namibia
14699,9/1/2020,NAM,Kedah,0,0,0,Namibia
14700,9/1/2020,NAM,Perak,0,0,0,Namibia
14701,9/1/2020,NAM,Perlis,0,0,0,Namibia
14702,9/1/2020,NAM,Pulau Pinang,0,0,0,Namibia
14703,9/1/2020,NAM,Sabah,0,0,0,Namibia
14704,9/1/2020,NAM,Sarawak,0,0,0,Namibia
14705,9/1/2020,NAM,Selangor,0,0,0,Namibia
14706,9/1/2020,NCL,Selangor,0,0,0,New Caledonia
14707,9/1/2020,NER,Johor,0,0,0,Niger
14708,9/1/2020,NER,Sabah,0,0,0,Niger
14709,9/1/2020,NER,Selangor,0,0,0,Niger
14710,9/1/2020,NGA,Johor,0,0,0,Nigeria
14711,9/1/2020,NGA,Kedah,0,0,0,Nigeria
14712,9/1/2020,NGA,Perlis,0,0,0,Nigeria
14713,9/1/2020,NGA,Pulau Pinang,0,0,0,Nigeria
14714,9/1/2020,NGA,Sabah,0,0,0,Nigeria
14715,9/1/2020,NGA,Sarawak,0,0,0,Nigeria
14716,9/1/2020,NGA,Selangor,36,33,3,Nigeria
14717,9/1/2020,NIC,Johor,0,0,0,Nicaragua
14718,9/1/2020,NIC,Kedah,0,0,0,Nicaragua
14719,9/1/2020,NIC,Pulau Pinang,0,0,0,Nicaragua
14720,9/1/2020,NIC,Sabah,0,0,0,Nicaragua
14721,9/1/2020,NIC,Selangor,0,0,0,Nicaragua
14722,9/1/2020,NLD,Johor,3,3,0,Netherlands
14723,9/1/2020,NLD,Kedah,0,0,0,Netherlands
14724,9/1/2020,NLD,Kelantan,0,0,0,Netherlands
14725,9/1/2020,NLD,Melaka,0,0,0,Netherlands
14726,9/1/2020,NLD,Negeri Sembilan,0,0,0,Netherlands
14727,9/1/2020,NLD,Pahang,0,0,0,Netherlands
14728,9/1/2020,NLD,Perak,0,0,0,Netherlands
14729,9/1/2020,NLD,Perlis,0,0,0,Netherlands
14730,9/1/2020,NLD,Pulau Pinang,0,0,0,Netherlands
14731,9/1/2020,NLD,Sabah,0,0,0,Netherlands
14732,9/1/2020,NLD,Sarawak,0,0,0,Netherlands
14733,9/1/2020,NLD,Selangor,46,38,8,Netherlands
14734,9/1/2020,NLD,Terengganu,0,0,0,Netherlands
14735,9/1/2020,NLD,W.P. Labuan,0,0,0,Netherlands
14736,9/1/2020,NOR,Johor,0,0,0,Norway
14737,9/1/2020,NOR,Kedah,0,0,0,Norway
14738,9/1/2020,NOR,Kelantan,0,0,0,Norway
14739,9/1/2020,NOR,Melaka,0,0,0,Norway
14740,9/1/2020,NOR,Pahang,0,0,0,Norway
14741,9/1/2020,NOR,Perak,0,0,0,Norway
14742,9/1/2020,NOR,Perlis,0,0,0,Norway
14743,9/1/2020,NOR,Pulau Pinang,0,0,0,Norway
14744,9/1/2020,NOR,Sabah,0,0,0,Norway
14745,9/1/2020,NOR,Sarawak,0,0,0,Norway
14746,9/1/2020,NOR,Selangor,8,6,2,Norway
14747,9/1/2020,NOR,W.P. Labuan,0,0,0,Norway
14748,9/1/2020,NPL,Johor,0,0,0,Nepal
14749,9/1/2020,NPL,Kedah,0,0,0,Nepal
14750,9/1/2020,NPL,Pahang,0,0,0,Nepal
14751,9/1/2020,NPL,Perak,0,0,0,Nepal
14752,9/1/2020,NPL,Perlis,0,0,0,Nepal
14753,9/1/2020,NPL,Pulau Pinang,0,0,0,Nepal
14754,9/1/2020,NPL,Sabah,0,0,0,Nepal
14755,9/1/2020,NPL,Sarawak,0,0,0,Nepal
14756,9/1/2020,NPL,Selangor,22,20,2,Nepal
14757,9/1/2020,NPL,W.P. Labuan,0,0,0,Nepal
14758,9/1/2020,NRU,Johor,0,0,0,Nauru
14759,9/1/2020,NRU,Pulau Pinang,0,0,0,Nauru
14760,9/1/2020,NRU,Selangor,0,0,0,Nauru
14761,9/1/2020,NZL,Johor,0,0,0,New Zealand
14762,9/1/2020,NZL,Kedah,0,0,0,New Zealand
14763,9/1/2020,NZL,Kelantan,0,0,0,New Zealand
14764,9/1/2020,NZL,Melaka,0,0,0,New Zealand
14765,9/1/2020,NZL,Negeri Sembilan,0,0,0,New Zealand
14766,9/1/2020,NZL,Pahang,0,0,0,New Zealand
14767,9/1/2020,NZL,Perak,0,0,0,New Zealand
14768,9/1/2020,NZL,Perlis,0,0,0,New Zealand
14769,9/1/2020,NZL,Pulau Pinang,0,0,0,New Zealand
14770,9/1/2020,NZL,Sabah,0,0,0,New Zealand
14771,9/1/2020,NZL,Sarawak,0,0,0,New Zealand
14772,9/1/2020,NZL,Selangor,23,19,4,New Zealand
14773,9/1/2020,NZL,Terengganu,0,0,0,New Zealand
14774,9/1/2020,NZL,W.P. Labuan,0,0,0,New Zealand
14775,9/1/2020,OMN,Johor,0,0,0,Oman
14776,9/1/2020,OMN,Kedah,0,0,0,Oman
14777,9/1/2020,OMN,Kelantan,0,0,0,Oman
14778,9/1/2020,OMN,Melaka,0,0,0,Oman
14779,9/1/2020,OMN,Perak,0,0,0,Oman
14780,9/1/2020,OMN,Perlis,0,0,0,Oman
14781,9/1/2020,OMN,Pulau Pinang,0,0,0,Oman
14782,9/1/2020,OMN,Sabah,0,0,0,Oman
14783,9/1/2020,OMN,Sarawak,0,0,0,Oman
14784,9/1/2020,OMN,Selangor,21,15,6,Oman
14785,9/1/2020,PAK,Johor,0,0,0,Pakistan
14786,9/1/2020,PAK,Kedah,0,0,0,Pakistan
14787,9/1/2020,PAK,Kelantan,0,0,0,Pakistan
14788,9/1/2020,PAK,Melaka,0,0,0,Pakistan
14789,9/1/2020,PAK,Negeri Sembilan,0,0,0,Pakistan
14790,9/1/2020,PAK,Pahang,0,0,0,Pakistan
14791,9/1/2020,PAK,Perak,0,0,0,Pakistan
14792,9/1/2020,PAK,Perlis,0,0,0,Pakistan
14793,9/1/2020,PAK,Pulau Pinang,0,0,0,Pakistan
14794,9/1/2020,PAK,Sabah,1,1,0,Pakistan
14795,9/1/2020,PAK,Sarawak,0,0,0,Pakistan
14796,9/1/2020,PAK,Selangor,80,63,17,Pakistan
14797,9/1/2020,PAK,W.P. Labuan,0,0,0,Pakistan
14798,9/1/2020,PAN,Johor,0,0,0,Panama
14799,9/1/2020,PAN,Kedah,0,0,0,Panama
14800,9/1/2020,PAN,Perak,0,0,0,Panama
14801,9/1/2020,PAN,Perlis,0,0,0,Panama
14802,9/1/2020,PAN,Pulau Pinang,0,0,0,Panama
14803,9/1/2020,PAN,Sabah,0,0,0,Panama
14804,9/1/2020,PAN,Sarawak,0,0,0,Panama
14805,9/1/2020,PAN,Selangor,0,0,0,Panama
14806,9/1/2020,PER,Johor,0,0,0,Peru
14807,9/1/2020,PER,Kedah,0,0,0,Peru
14808,9/1/2020,PER,Kelantan,0,0,0,Peru
14809,9/1/2020,PER,Pahang,0,0,0,Peru
14810,9/1/2020,PER,Perak,0,0,0,Peru
14811,9/1/2020,PER,Perlis,0,0,0,Peru
14812,9/1/2020,PER,Pulau Pinang,0,0,0,Peru
14813,9/1/2020,PER,Sabah,0,0,0,Peru
14814,9/1/2020,PER,Sarawak,0,0,0,Peru
14815,9/1/2020,PER,Selangor,2,2,0,Peru
14816,9/1/2020,PER,W.P. Labuan,0,0,0,Peru
14817,9/1/2020,PHL,Johor,149,139,10,Philippines
14818,9/1/2020,PHL,Kedah,0,0,0,Philippines
14819,9/1/2020,PHL,Kelantan,0,0,0,Philippines
14820,9/1/2020,PHL,Melaka,0,0,0,Philippines
14821,9/1/2020,PHL,Negeri Sembilan,0,0,0,Philippines
14822,9/1/2020,PHL,Pahang,0,0,0,Philippines
14823,9/1/2020,PHL,Perak,0,0,0,Philippines
14824,9/1/2020,PHL,Perlis,0,0,0,Philippines
14825,9/1/2020,PHL,Pulau Pinang,0,0,0,Philippines
14826,9/1/2020,PHL,Sabah,2,0,2,Philippines
14827,9/1/2020,PHL,Sarawak,50,42,8,Philippines
14828,9/1/2020,PHL,Selangor,296,260,36,Philippines
14829,9/1/2020,PHL,Terengganu,0,0,0,Philippines
14830,9/1/2020,PHL,W.P. Labuan,8,7,1,Philippines
14831,9/1/2020,PLW,Johor,0,0,0,Palau
14832,9/1/2020,PLW,Pulau Pinang,0,0,0,Palau
14833,9/1/2020,PLW,Selangor,0,0,0,Palau
14834,9/1/2020,PNG,Johor,0,0,0,Papua New Guinea
14835,9/1/2020,PNG,Kedah,0,0,0,Papua New Guinea
14836,9/1/2020,PNG,Kelantan,0,0,0,Papua New Guinea
14837,9/1/2020,PNG,Perak,0,0,0,Papua New Guinea
14838,9/1/2020,PNG,Pulau Pinang,0,0,0,Papua New Guinea
14839,9/1/2020,PNG,Sabah,0,0,0,Papua New Guinea
14840,9/1/2020,PNG,Sarawak,0,0,0,Papua New Guinea
14841,9/1/2020,PNG,Selangor,0,0,0,Papua New Guinea
14842,9/1/2020,POL,Johor,4,4,0,Poland
14843,9/1/2020,POL,Kedah,0,0,0,Poland
14844,9/1/2020,POL,Kelantan,0,0,0,Poland
14845,9/1/2020,POL,Melaka,0,0,0,Poland
14846,9/1/2020,POL,Negeri Sembilan,0,0,0,Poland
14847,9/1/2020,POL,Pahang,0,0,0,Poland
14848,9/1/2020,POL,Perak,0,0,0,Poland
14849,9/1/2020,POL,Perlis,0,0,0,Poland
14850,9/1/2020,POL,Pulau Pinang,0,0,0,Poland
14851,9/1/2020,POL,Sabah,0,0,0,Poland
14852,9/1/2020,POL,Sarawak,0,0,0,Poland
14853,9/1/2020,POL,Selangor,19,16,3,Poland
14854,9/1/2020,POL,Terengganu,0,0,0,Poland
14855,9/1/2020,POL,W.P. Labuan,0,0,0,Poland
14856,9/1/2020,PRK,Selangor,0,0,0,"Korea, Democratic People's Republic of"
14857,9/1/2020,PRT,Johor,1,1,0,Portugal
14858,9/1/2020,PRT,Kedah,0,0,0,Portugal
14859,9/1/2020,PRT,Kelantan,0,0,0,Portugal
14860,9/1/2020,PRT,Melaka,0,0,0,Portugal
14861,9/1/2020,PRT,Pahang,0,0,0,Portugal
14862,9/1/2020,PRT,Perak,0,0,0,Portugal
14863,9/1/2020,PRT,Perlis,0,0,0,Portugal
14864,9/1/2020,PRT,Pulau Pinang,0,0,0,Portugal
14865,9/1/2020,PRT,Sabah,0,0,0,Portugal
14866,9/1/2020,PRT,Sarawak,0,0,0,Portugal
14867,9/1/2020,PRT,Selangor,9,5,4,Portugal
14868,9/1/2020,PRT,W.P. Labuan,0,0,0,Portugal
14869,9/1/2020,PRY,Johor,0,0,0,Paraguay
14870,9/1/2020,PRY,Kedah,0,0,0,Paraguay
14871,9/1/2020,PRY,Perak,0,0,0,Paraguay
14872,9/1/2020,PRY,Perlis,0,0,0,Paraguay
14873,9/1/2020,PRY,Pulau Pinang,0,0,0,Paraguay
14874,9/1/2020,PRY,Sabah,0,0,0,Paraguay
14875,9/1/2020,PRY,Sarawak,0,0,0,Paraguay
14876,9/1/2020,PRY,Selangor,0,0,0,Paraguay
14877,9/1/2020,PSE,Johor,0,0,0,"Palestinian Territory, Occupied"
14878,9/1/2020,PSE,Kedah,0,0,0,"Palestinian Territory, Occupied"
14879,9/1/2020,PSE,Kelantan,0,0,0,"Palestinian Territory, Occupied"
14880,9/1/2020,PSE,Melaka,0,0,0,"Palestinian Territory, Occupied"
14881,9/1/2020,PSE,Perak,0,0,0,"Palestinian Territory, Occupied"
14882,9/1/2020,PSE,Perlis,0,0,0,"Palestinian Territory, Occupied"
14883,9/1/2020,PSE,Pulau Pinang,0,0,0,"Palestinian Territory, Occupied"
14884,9/1/2020,PSE,Sabah,0,0,0,"Palestinian Territory, Occupied"
14885,9/1/2020,PSE,Sarawak,0,0,0,"Palestinian Territory, Occupied"
14886,9/1/2020,PSE,Selangor,9,8,1,"Palestinian Territory, Occupied"
14887,9/1/2020,QAT,Johor,0,0,0,Qatar
14888,9/1/2020,QAT,Kedah,0,0,0,Qatar
14889,9/1/2020,QAT,Perlis,0,0,0,Qatar
14890,9/1/2020,QAT,Pulau Pinang,0,0,0,Qatar
14891,9/1/2020,QAT,Sabah,0,0,0,Qatar
14892,9/1/2020,QAT,Sarawak,0,0,0,Qatar
14893,9/1/2020,QAT,Selangor,0,0,0,Qatar
14894,9/1/2020,REU,Johor,0,0,0,Reunion
14895,9/1/2020,REU,Sarawak,0,0,0,Reunion
14896,9/1/2020,ROU,Johor,0,0,0,Romania
14897,9/1/2020,ROU,Kedah,0,0,0,Romania
14898,9/1/2020,ROU,Kelantan,0,0,0,Romania
14899,9/1/2020,ROU,Negeri Sembilan,0,0,0,Romania
14900,9/1/2020,ROU,Pahang,0,0,0,Romania
14901,9/1/2020,ROU,Perak,0,0,0,Romania
14902,9/1/2020,ROU,Perlis,0,0,0,Romania
14903,9/1/2020,ROU,Pulau Pinang,0,0,0,Romania
14904,9/1/2020,ROU,Sabah,0,0,0,Romania
14905,9/1/2020,ROU,Sarawak,1,1,0,Romania
14906,9/1/2020,ROU,Selangor,14,13,1,Romania
14907,9/1/2020,ROU,W.P. Labuan,0,0,0,Romania
14908,9/1/2020,RUS,Johor,3,3,0,Russia
14909,9/1/2020,RUS,Kedah,0,0,0,Russia
14910,9/1/2020,RUS,Kelantan,0,0,0,Russia
14911,9/1/2020,RUS,Melaka,0,0,0,Russia
14912,9/1/2020,RUS,Negeri Sembilan,0,0,0,Russia
14913,9/1/2020,RUS,Pahang,0,0,0,Russia
14914,9/1/2020,RUS,Perak,0,0,0,Russia
14915,9/1/2020,RUS,Perlis,0,0,0,Russia
14916,9/1/2020,RUS,Pulau Pinang,0,0,0,Russia
14917,9/1/2020,RUS,Sabah,0,0,0,Russia
14918,9/1/2020,RUS,Sarawak,0,0,0,Russia
14919,9/1/2020,RUS,Selangor,51,41,10,Russia
14920,9/1/2020,RUS,W.P. Labuan,0,0,0,Russia
14921,9/1/2020,RWA,Johor,0,0,0,Rwanda
14922,9/1/2020,RWA,Kedah,0,0,0,Rwanda
14923,9/1/2020,RWA,Pulau Pinang,0,0,0,Rwanda
14924,9/1/2020,RWA,Selangor,0,0,0,Rwanda
14925,9/1/2020,SAU,Johor,0,0,0,Saudi Arabia
14926,9/1/2020,SAU,Kedah,0,0,0,Saudi Arabia
14927,9/1/2020,SAU,Kelantan,0,0,0,Saudi Arabia
14928,9/1/2020,SAU,Melaka,0,0,0,Saudi Arabia
14929,9/1/2020,SAU,Perak,0,0,0,Saudi Arabia
14930,9/1/2020,SAU,Perlis,0,0,0,Saudi Arabia
14931,9/1/2020,SAU,Pulau Pinang,0,0,0,Saudi Arabia
14932,9/1/2020,SAU,Sabah,0,0,0,Saudi Arabia
14933,9/1/2020,SAU,Sarawak,0,0,0,Saudi Arabia
14934,9/1/2020,SAU,Selangor,40,26,14,Saudi Arabia
14935,9/1/2020,SAU,W.P. Labuan,0,0,0,Saudi Arabia
14936,9/1/2020,SDN,Johor,0,0,0,Sudan
14937,9/1/2020,SDN,Kedah,0,0,0,Sudan
14938,9/1/2020,SDN,Kelantan,0,0,0,Sudan
14939,9/1/2020,SDN,Perlis,0,0,0,Sudan
14940,9/1/2020,SDN,Pulau Pinang,0,0,0,Sudan
14941,9/1/2020,SDN,Sabah,0,0,0,Sudan
14942,9/1/2020,SDN,Sarawak,0,0,0,Sudan
14943,9/1/2020,SDN,Selangor,26,20,6,Sudan
14944,9/1/2020,SDN,W.P. Labuan,0,0,0,Sudan
14945,9/1/2020,SEN,Johor,0,0,0,Senegal
14946,9/1/2020,SEN,Kedah,0,0,0,Senegal
14947,9/1/2020,SEN,Kelantan,0,0,0,Senegal
14948,9/1/2020,SEN,Perak,0,0,0,Senegal
14949,9/1/2020,SEN,Perlis,0,0,0,Senegal
14950,9/1/2020,SEN,Pulau Pinang,0,0,0,Senegal
14951,9/1/2020,SEN,Sabah,0,0,0,Senegal
14952,9/1/2020,SEN,Sarawak,0,0,0,Senegal
14953,9/1/2020,SEN,Selangor,5,3,2,Senegal
14954,9/1/2020,SGP,Johor,550,479,71,Singapore
14955,9/1/2020,SGP,Kedah,0,0,0,Singapore
14956,9/1/2020,SGP,Kelantan,0,0,0,Singapore
14957,9/1/2020,SGP,Melaka,0,0,0,Singapore
14958,9/1/2020,SGP,Negeri Sembilan,0,0,0,Singapore
14959,9/1/2020,SGP,Pahang,1,1,0,Singapore
14960,9/1/2020,SGP,Perak,1,1,0,Singapore
14961,9/1/2020,SGP,Perlis,1,1,0,Singapore
14962,9/1/2020,SGP,Pulau Pinang,14,14,0,Singapore
14963,9/1/2020,SGP,Sabah,0,0,0,Singapore
14964,9/1/2020,SGP,Sarawak,7,4,3,Singapore
14965,9/1/2020,SGP,Selangor,307,235,72,Singapore
14966,9/1/2020,SGP,Terengganu,0,0,0,Singapore
14967,9/1/2020,SGP,W.P. Labuan,0,0,0,Singapore
14968,9/1/2020,SGS,Johor,0,0,0,South Georgia and the South Sandwich Islands
14969,9/1/2020,SGS,Sabah,0,0,0,South Georgia and the South Sandwich Islands
14970,9/1/2020,SGS,Selangor,0,0,0,South Georgia and the South Sandwich Islands
14971,9/1/2020,SHN,Sarawak,0,0,0,"Saint Helena, Ascension and Tristan da Cunha"
14972,9/1/2020,SLB,Johor,0,0,0,Solomon Islands
14973,9/1/2020,SLB,Perlis,0,0,0,Solomon Islands
14974,9/1/2020,SLB,Pulau Pinang,0,0,0,Solomon Islands
14975,9/1/2020,SLB,Sabah,0,0,0,Solomon Islands
14976,9/1/2020,SLB,Sarawak,0,0,0,Solomon Islands
14977,9/1/2020,SLB,Selangor,0,0,0,Solomon Islands
14978,9/1/2020,SLB,W.P. Labuan,0,0,0,Solomon Islands
14979,9/1/2020,SLE,Johor,0,0,0,Sierra Leone
14980,9/1/2020,SLE,Kedah,0,0,0,Sierra Leone
14981,9/1/2020,SLE,Perak,0,0,0,Sierra Leone
14982,9/1/2020,SLE,Pulau Pinang,0,0,0,Sierra Leone
14983,9/1/2020,SLE,Sabah,0,0,0,Sierra Leone
14984,9/1/2020,SLE,Selangor,0,0,0,Sierra Leone
14985,9/1/2020,SLV,Johor,0,0,0,El Salvador
14986,9/1/2020,SLV,Kedah,0,0,0,El Salvador
14987,9/1/2020,SLV,Perak,0,0,0,El Salvador
14988,9/1/2020,SLV,Perlis,0,0,0,El Salvador
14989,9/1/2020,SLV,Pulau Pinang,0,0,0,El Salvador
14990,9/1/2020,SLV,Sabah,0,0,0,El Salvador
14991,9/1/2020,SLV,Selangor,1,0,1,El Salvador
14992,9/1/2020,SLV,W.P. Labuan,0,0,0,El Salvador
14993,9/1/2020,SMR,Johor,0,0,0,San Marino
14994,9/1/2020,SMR,Selangor,0,0,0,San Marino
14995,9/1/2020,SOM,Johor,0,0,0,Somalia
14996,9/1/2020,SOM,Kedah,0,0,0,Somalia
14997,9/1/2020,SOM,Kelantan,0,0,0,Somalia
14998,9/1/2020,SOM,Perlis,0,0,0,Somalia
14999,9/1/2020,SOM,Sabah,0,0,0,Somalia
15000,9/1/2020,SOM,Sarawak,0,0,0,Somalia
15001,9/1/2020,SOM,Selangor,6,4,2,Somalia
15002,9/1/2020,SRB,Johor,0,0,0,Serbia
15003,9/1/2020,SRB,Kedah,0,0,0,Serbia
15004,9/1/2020,SRB,Kelantan,0,0,0,Serbia
15005,9/1/2020,SRB,Pahang,0,0,0,Serbia
15006,9/1/2020,SRB,Perak,0,0,0,Serbia
15007,9/1/2020,SRB,Perlis,0,0,0,Serbia
15008,9/1/2020,SRB,Pulau Pinang,0,0,0,Serbia
15009,9/1/2020,SRB,Sabah,0,0,0,Serbia
15010,9/1/2020,SRB,Sarawak,0,0,0,Serbia
15011,9/1/2020,SRB,Selangor,0,0,0,Serbia
15012,9/1/2020,STP,Selangor,0,0,0,Sao Tome and Principe
15013,9/1/2020,SUR,Johor,0,0,0,Suriname
15014,9/1/2020,SUR,Kedah,0,0,0,Suriname
15015,9/1/2020,SUR,Kelantan,0,0,0,Suriname
15016,9/1/2020,SUR,Perak,0,0,0,Suriname
15017,9/1/2020,SUR,Perlis,0,0,0,Suriname
15018,9/1/2020,SUR,Pulau Pinang,0,0,0,Suriname
15019,9/1/2020,SUR,Sabah,0,0,0,Suriname
15020,9/1/2020,SUR,Sarawak,0,0,0,Suriname
15021,9/1/2020,SUR,Selangor,0,0,0,Suriname
15022,9/1/2020,SVK,Johor,0,0,0,Slovakia
15023,9/1/2020,SVK,Kedah,0,0,0,Slovakia
15024,9/1/2020,SVK,Kelantan,0,0,0,Slovakia
15025,9/1/2020,SVK,Negeri Sembilan,0,0,0,Slovakia
15026,9/1/2020,SVK,Pahang,0,0,0,Slovakia
15027,9/1/2020,SVK,Perak,0,0,0,Slovakia
15028,9/1/2020,SVK,Perlis,0,0,0,Slovakia
15029,9/1/2020,SVK,Pulau Pinang,0,0,0,Slovakia
15030,9/1/2020,SVK,Sabah,0,0,0,Slovakia
15031,9/1/2020,SVK,Sarawak,0,0,0,Slovakia
15032,9/1/2020,SVK,Selangor,32,29,3,Slovakia
15033,9/1/2020,SVK,W.P. Labuan,0,0,0,Slovakia
15034,9/1/2020,SVN,Johor,0,0,0,Slovenia
15035,9/1/2020,SVN,Kedah,0,0,0,Slovenia
15036,9/1/2020,SVN,Kelantan,0,0,0,Slovenia
15037,9/1/2020,SVN,Perak,0,0,0,Slovenia
15038,9/1/2020,SVN,Perlis,0,0,0,Slovenia
15039,9/1/2020,SVN,Pulau Pinang,0,0,0,Slovenia
15040,9/1/2020,SVN,Sabah,0,0,0,Slovenia
15041,9/1/2020,SVN,Sarawak,0,0,0,Slovenia
15042,9/1/2020,SVN,Selangor,1,1,0,Slovenia
15043,9/1/2020,SVN,W.P. Labuan,0,0,0,Slovenia
15044,9/1/2020,SWE,Johor,0,0,0,Sweden
15045,9/1/2020,SWE,Kedah,0,0,0,Sweden
15046,9/1/2020,SWE,Kelantan,0,0,0,Sweden
15047,9/1/2020,SWE,Melaka,0,0,0,Sweden
15048,9/1/2020,SWE,Negeri Sembilan,0,0,0,Sweden
15049,9/1/2020,SWE,Pahang,0,0,0,Sweden
15050,9/1/2020,SWE,Perak,0,0,0,Sweden
15051,9/1/2020,SWE,Perlis,0,0,0,Sweden
15052,9/1/2020,SWE,Pulau Pinang,0,0,0,Sweden
15053,9/1/2020,SWE,Sabah,0,0,0,Sweden
15054,9/1/2020,SWE,Sarawak,1,1,0,Sweden
15055,9/1/2020,SWE,Selangor,9,6,3,Sweden
15056,9/1/2020,SWE,W.P. Labuan,0,0,0,Sweden
15057,9/1/2020,SWZ,Johor,0,0,0,Swaziland
15058,9/1/2020,SWZ,Kedah,0,0,0,Swaziland
15059,9/1/2020,SWZ,Pulau Pinang,0,0,0,Swaziland
15060,9/1/2020,SWZ,Sabah,0,0,0,Swaziland
15061,9/1/2020,SWZ,Selangor,0,0,0,Swaziland
15062,9/1/2020,SYC,Johor,0,0,0,Seychelles
15063,9/1/2020,SYC,Kedah,0,0,0,Seychelles
15064,9/1/2020,SYC,Pulau Pinang,0,0,0,Seychelles
15065,9/1/2020,SYC,Sabah,0,0,0,Seychelles
15066,9/1/2020,SYC,Sarawak,0,0,0,Seychelles
15067,9/1/2020,SYC,Selangor,5,1,4,Seychelles
15068,9/1/2020,SYR,Johor,1,1,0,Syrian Arab Republic
15069,9/1/2020,SYR,Kedah,0,0,0,Syrian Arab Republic
15070,9/1/2020,SYR,Kelantan,0,0,0,Syrian Arab Republic
15071,9/1/2020,SYR,Pahang,0,0,0,Syrian Arab Republic
15072,9/1/2020,SYR,Perlis,0,0,0,Syrian Arab Republic
15073,9/1/2020,SYR,Pulau Pinang,0,0,0,Syrian Arab Republic
15074,9/1/2020,SYR,Sabah,0,0,0,Syrian Arab Republic
15075,9/1/2020,SYR,Sarawak,0,0,0,Syrian Arab Republic
15076,9/1/2020,SYR,Selangor,42,40,2,Syrian Arab Republic
15077,9/1/2020,SYR,W.P. Labuan,0,0,0,Syrian Arab Republic
15078,9/1/2020,TCA,Perlis,0,0,0,Turks and Caicos
15079,9/1/2020,TCD,Johor,0,0,0,Chad
15080,9/1/2020,TCD,Kedah,0,0,0,Chad
15081,9/1/2020,TCD,Perlis,0,0,0,Chad
15082,9/1/2020,TCD,Selangor,0,0,0,Chad
15083,9/1/2020,TGO,Johor,0,0,0,Togo
15084,9/1/2020,TGO,Perak,0,0,0,Togo
15085,9/1/2020,TGO,Pulau Pinang,0,0,0,Togo
15086,9/1/2020,TGO,Selangor,0,0,0,Togo
15087,9/1/2020,THA,Johor,98,97,1,Thailand
15088,9/1/2020,THA,Kedah,9291,8590,701,Thailand
15089,9/1/2020,THA,Kelantan,7,1,6,Thailand
15090,9/1/2020,THA,Melaka,0,0,0,Thailand
15091,9/1/2020,THA,Negeri Sembilan,0,0,0,Thailand
15092,9/1/2020,THA,Pahang,0,0,0,Thailand
15093,9/1/2020,THA,Perak,2,0,2,Thailand
15094,9/1/2020,THA,Perlis,5197,5037,160,Thailand
15095,9/1/2020,THA,Pulau Pinang,0,0,0,Thailand
15096,9/1/2020,THA,Sabah,1,0,1,Thailand
15097,9/1/2020,THA,Sarawak,17,14,3,Thailand
15098,9/1/2020,THA,Selangor,125,66,59,Thailand
15099,9/1/2020,THA,Terengganu,0,0,0,Thailand
15100,9/1/2020,THA,W.P. Labuan,0,0,0,Thailand
15101,9/1/2020,TJK,Johor,0,0,0,Tajikistan
15102,9/1/2020,TJK,Kedah,0,0,0,Tajikistan
15103,9/1/2020,TJK,Perlis,0,0,0,Tajikistan
15104,9/1/2020,TJK,Pulau Pinang,0,0,0,Tajikistan
15105,9/1/2020,TJK,Sabah,0,0,0,Tajikistan
15106,9/1/2020,TJK,Selangor,0,0,0,Tajikistan
15107,9/1/2020,TKL,Selangor,0,0,0,Tokelau
15108,9/1/2020,TKM,Johor,0,0,0,Turkmenistan
15109,9/1/2020,TKM,Kedah,0,0,0,Turkmenistan
15110,9/1/2020,TKM,Kelantan,0,0,0,Turkmenistan
15111,9/1/2020,TKM,Perlis,0,0,0,Turkmenistan
15112,9/1/2020,TKM,Pulau Pinang,0,0,0,Turkmenistan
15113,9/1/2020,TKM,Sabah,0,0,0,Turkmenistan
15114,9/1/2020,TKM,Sarawak,0,0,0,Turkmenistan
15115,9/1/2020,TKM,Selangor,2,1,1,Turkmenistan
15116,9/1/2020,TLS,Johor,0,0,0,Timor-Leste
15117,9/1/2020,TLS,Kedah,0,0,0,Timor-Leste
15118,9/1/2020,TLS,Perlis,0,0,0,Timor-Leste
15119,9/1/2020,TLS,Pulau Pinang,0,0,0,Timor-Leste
15120,9/1/2020,TLS,Sabah,0,0,0,Timor-Leste
15121,9/1/2020,TLS,Sarawak,0,0,0,Timor-Leste
15122,9/1/2020,TLS,Selangor,6,3,3,Timor-Leste
15123,9/1/2020,TON,Johor,0,0,0,Tonga
15124,9/1/2020,TON,Pulau Pinang,0,0,0,Tonga
15125,9/1/2020,TON,Sarawak,0,0,0,Tonga
15126,9/1/2020,TON,Selangor,0,0,0,Tonga
15127,9/1/2020,TTO,Johor,0,0,0,Trinidad and Tobago
15128,9/1/2020,TTO,Kedah,0,0,0,Trinidad and Tobago
15129,9/1/2020,TTO,Pahang,0,0,0,Trinidad and Tobago
15130,9/1/2020,TTO,Pulau Pinang,0,0,0,Trinidad and Tobago
15131,9/1/2020,TTO,Sabah,0,0,0,Trinidad and Tobago
15132,9/1/2020,TTO,Sarawak,0,0,0,Trinidad and Tobago
15133,9/1/2020,TTO,Selangor,0,0,0,Trinidad and Tobago
15134,9/1/2020,TUN,Johor,0,0,0,Tunisia
15135,9/1/2020,TUN,Kedah,0,0,0,Tunisia
15136,9/1/2020,TUN,Kelantan,0,0,0,Tunisia
15137,9/1/2020,TUN,Melaka,0,0,0,Tunisia
15138,9/1/2020,TUN,Perak,0,0,0,Tunisia
15139,9/1/2020,TUN,Perlis,0,0,0,Tunisia
15140,9/1/2020,TUN,Pulau Pinang,0,0,0,Tunisia
15141,9/1/2020,TUN,Sabah,0,0,0,Tunisia
15142,9/1/2020,TUN,Sarawak,0,0,0,Tunisia
15143,9/1/2020,TUN,Selangor,6,2,4,Tunisia
15144,9/1/2020,TUN,W.P. Labuan,0,0,0,Tunisia
15145,9/1/2020,TUR,Johor,0,0,0,Turkey
15146,9/1/2020,TUR,Kedah,0,0,0,Turkey
15147,9/1/2020,TUR,Kelantan,0,0,0,Turkey
15148,9/1/2020,TUR,Melaka,0,0,0,Turkey
15149,9/1/2020,TUR,Negeri Sembilan,0,0,0,Turkey
15150,9/1/2020,TUR,Pahang,0,0,0,Turkey
15151,9/1/2020,TUR,Perak,0,0,0,Turkey
15152,9/1/2020,TUR,Perlis,0,0,0,Turkey
15153,9/1/2020,TUR,Pulau Pinang,0,0,0,Turkey
15154,9/1/2020,TUR,Sabah,0,0,0,Turkey
15155,9/1/2020,TUR,Sarawak,0,0,0,Turkey
15156,9/1/2020,TUR,Selangor,15,8,7,Turkey
15157,9/1/2020,TUR,W.P. Labuan,0,0,0,Turkey
15158,9/1/2020,TUV,Selangor,0,0,0,Tuvalu
15159,9/1/2020,TWN,Johor,0,0,0,Taiwan
15160,9/1/2020,TWN,Kedah,0,0,0,Taiwan
15161,9/1/2020,TWN,Kelantan,0,0,0,Taiwan
15162,9/1/2020,TWN,Melaka,0,0,0,Taiwan
15163,9/1/2020,TWN,Negeri Sembilan,0,0,0,Taiwan
15164,9/1/2020,TWN,Pahang,0,0,0,Taiwan
15165,9/1/2020,TWN,Perak,0,0,0,Taiwan
15166,9/1/2020,TWN,Perlis,0,0,0,Taiwan
15167,9/1/2020,TWN,Pulau Pinang,5,3,2,Taiwan
15168,9/1/2020,TWN,Sabah,0,0,0,Taiwan
15169,9/1/2020,TWN,Sarawak,2,1,1,Taiwan
15170,9/1/2020,TWN,Selangor,95,63,32,Taiwan
15171,9/1/2020,TWN,W.P. Labuan,0,0,0,Taiwan
15172,9/1/2020,TZA,Johor,0,0,0,"Tanzania, United Republic of"
15173,9/1/2020,TZA,Kedah,0,0,0,"Tanzania, United Republic of"
15174,9/1/2020,TZA,Perak,0,0,0,"Tanzania, United Republic of"
15175,9/1/2020,TZA,Perlis,0,0,0,"Tanzania, United Republic of"
15176,9/1/2020,TZA,Pulau Pinang,0,0,0,"Tanzania, United Republic of"
15177,9/1/2020,TZA,Sabah,0,0,0,"Tanzania, United Republic of"
15178,9/1/2020,TZA,Sarawak,0,0,0,"Tanzania, United Republic of"
15179,9/1/2020,TZA,Selangor,7,3,4,"Tanzania, United Republic of"
15180,9/1/2020,UGA,Johor,0,0,0,Uganda
15181,9/1/2020,UGA,Kedah,0,0,0,Uganda
15182,9/1/2020,UGA,Perak,0,0,0,Uganda
15183,9/1/2020,UGA,Perlis,0,0,0,Uganda
15184,9/1/2020,UGA,Pulau Pinang,0,0,0,Uganda
15185,9/1/2020,UGA,Sabah,0,0,0,Uganda
15186,9/1/2020,UGA,Sarawak,0,0,0,Uganda
15187,9/1/2020,UGA,Selangor,0,0,0,Uganda
15188,9/1/2020,UKR,Johor,31,31,0,Ukraine
15189,9/1/2020,UKR,Kedah,0,0,0,Ukraine
15190,9/1/2020,UKR,Kelantan,0,0,0,Ukraine
15191,9/1/2020,UKR,Melaka,0,0,0,Ukraine
15192,9/1/2020,UKR,Negeri Sembilan,0,0,0,Ukraine
15193,9/1/2020,UKR,Pahang,0,0,0,Ukraine
15194,9/1/2020,UKR,Perak,0,0,0,Ukraine
15195,9/1/2020,UKR,Perlis,0,0,0,Ukraine
15196,9/1/2020,UKR,Pulau Pinang,0,0,0,Ukraine
15197,9/1/2020,UKR,Sabah,0,0,0,Ukraine
15198,9/1/2020,UKR,Sarawak,0,0,0,Ukraine
15199,9/1/2020,UKR,Selangor,112,110,2,Ukraine
15200,9/1/2020,UKR,W.P. Labuan,0,0,0,Ukraine
15201,9/1/2020,URY,Johor,0,0,0,Uruguay
15202,9/1/2020,URY,Kedah,0,0,0,Uruguay
15203,9/1/2020,URY,Kelantan,0,0,0,Uruguay
15204,9/1/2020,URY,Perak,0,0,0,Uruguay
15205,9/1/2020,URY,Perlis,0,0,0,Uruguay
15206,9/1/2020,URY,Pulau Pinang,0,0,0,Uruguay
15207,9/1/2020,URY,Sabah,0,0,0,Uruguay
15208,9/1/2020,URY,Sarawak,0,0,0,Uruguay
15209,9/1/2020,URY,Selangor,0,0,0,Uruguay
15210,9/1/2020,URY,W.P. Labuan,0,0,0,Uruguay
15211,9/1/2020,USA,Johor,0,0,0,United States Of America
15212,9/1/2020,USA,Kedah,0,0,0,United States Of America
15213,9/1/2020,USA,Kelantan,0,0,0,United States Of America
15214,9/1/2020,USA,Melaka,0,0,0,United States Of America
15215,9/1/2020,USA,Negeri Sembilan,0,0,0,United States Of America
15216,9/1/2020,USA,Pahang,0,0,0,United States Of America
15217,9/1/2020,USA,Perak,0,0,0,United States Of America
15218,9/1/2020,USA,Perlis,0,0,0,United States Of America
15219,9/1/2020,USA,Pulau Pinang,1,1,0,United States Of America
15220,9/1/2020,USA,Sabah,1,1,0,United States Of America
15221,9/1/2020,USA,Sarawak,0,0,0,United States Of America
15222,9/1/2020,USA,Selangor,179,104,75,United States Of America
15223,9/1/2020,USA,Terengganu,0,0,0,United States Of America
15224,9/1/2020,USA,W.P. Labuan,0,0,0,United States Of America
15225,9/1/2020,UZB,Johor,0,0,0,Uzbekistan
15226,9/1/2020,UZB,Kedah,0,0,0,Uzbekistan
15227,9/1/2020,UZB,Kelantan,0,0,0,Uzbekistan
15228,9/1/2020,UZB,Perak,0,0,0,Uzbekistan
15229,9/1/2020,UZB,Perlis,0,0,0,Uzbekistan
15230,9/1/2020,UZB,Pulau Pinang,0,0,0,Uzbekistan
15231,9/1/2020,UZB,Sabah,0,0,0,Uzbekistan
15232,9/1/2020,UZB,Sarawak,0,0,0,Uzbekistan
15233,9/1/2020,UZB,Selangor,9,4,5,Uzbekistan
15234,9/1/2020,VAT,Johor,0,0,0,Holy See (Vatican City State)
15235,9/1/2020,VAT,Sarawak,0,0,0,Holy See (Vatican City State)
15236,9/1/2020,VAT,Selangor,1,1,0,Holy See (Vatican City State)
15237,9/1/2020,VCT,Johor,0,0,0,Saint Vincent and the Grenadines
15238,9/1/2020,VCT,Kedah,0,0,0,Saint Vincent and the Grenadines
15239,9/1/2020,VCT,Pulau Pinang,0,0,0,Saint Vincent and the Grenadines
15240,9/1/2020,VCT,Sarawak,0,0,0,Saint Vincent and the Grenadines
15241,9/1/2020,VCT,Selangor,0,0,0,Saint Vincent and the Grenadines
15242,9/1/2020,VEN,Johor,0,0,0,Venezuela
15243,9/1/2020,VEN,Kedah,0,0,0,Venezuela
15244,9/1/2020,VEN,Kelantan,0,0,0,Venezuela
15245,9/1/2020,VEN,Melaka,0,0,0,Venezuela
15246,9/1/2020,VEN,Perak,0,0,0,Venezuela
15247,9/1/2020,VEN,Perlis,0,0,0,Venezuela
15248,9/1/2020,VEN,Pulau Pinang,0,0,0,Venezuela
15249,9/1/2020,VEN,Sabah,0,0,0,Venezuela
15250,9/1/2020,VEN,Sarawak,0,0,0,Venezuela
15251,9/1/2020,VEN,Selangor,1,0,1,Venezuela
15252,9/1/2020,VEN,W.P. Labuan,0,0,0,Venezuela
15253,9/1/2020,VNM,Johor,4,0,4,Vietnam
15254,9/1/2020,VNM,Kedah,0,0,0,Vietnam
15255,9/1/2020,VNM,Kelantan,0,0,0,Vietnam
15256,9/1/2020,VNM,Melaka,0,0,0,Vietnam
15257,9/1/2020,VNM,Negeri Sembilan,0,0,0,Vietnam
15258,9/1/2020,VNM,Pahang,0,0,0,Vietnam
15259,9/1/2020,VNM,Perak,0,0,0,Vietnam
15260,9/1/2020,VNM,Perlis,0,0,0,Vietnam
15261,9/1/2020,VNM,Pulau Pinang,0,0,0,Vietnam
15262,9/1/2020,VNM,Sabah,0,0,0,Vietnam
15263,9/1/2020,VNM,Sarawak,1,0,1,Vietnam
15264,9/1/2020,VNM,Selangor,93,26,67,Vietnam
15265,9/1/2020,VNM,Terengganu,0,0,0,Vietnam
15266,9/1/2020,VNM,W.P. Labuan,0,0,0,Vietnam
15267,9/1/2020,VUT,Johor,0,0,0,Vanuatu
15268,9/1/2020,VUT,Kedah,0,0,0,Vanuatu
15269,9/1/2020,VUT,Pulau Pinang,0,0,0,Vanuatu
15270,9/1/2020,VUT,Sabah,0,0,0,Vanuatu
15271,9/1/2020,VUT,Sarawak,0,0,0,Vanuatu
15272,9/1/2020,VUT,Selangor,1,1,0,Vanuatu
15273,9/1/2020,WSM,Johor,0,0,0,Samoa
15274,9/1/2020,WSM,Sarawak,0,0,0,Samoa
15275,9/1/2020,WSM,Selangor,0,0,0,Samoa
15276,9/1/2020,YEM,Johor,0,0,0,Yemen
15277,9/1/2020,YEM,Kedah,0,0,0,Yemen
15278,9/1/2020,YEM,Kelantan,0,0,0,Yemen
15279,9/1/2020,YEM,Melaka,0,0,0,Yemen
15280,9/1/2020,YEM,Pahang,0,0,0,Yemen
15281,9/1/2020,YEM,Perak,0,0,0,Yemen
15282,9/1/2020,YEM,Perlis,0,0,0,Yemen
15283,9/1/2020,YEM,Pulau Pinang,0,0,0,Yemen
15284,9/1/2020,YEM,Sabah,0,0,0,Yemen
15285,9/1/2020,YEM,Sarawak,0,0,0,Yemen
15286,9/1/2020,YEM,Selangor,25,20,5,Yemen
15287,9/1/2020,YEM,W.P. Labuan,0,0,0,Yemen
15288,9/1/2020,ZAF,Johor,0,0,0,South Africa
15289,9/1/2020,ZAF,Kedah,0,0,0,South Africa
15290,9/1/2020,ZAF,Kelantan,0,0,0,South Africa
15291,9/1/2020,ZAF,Melaka,0,0,0,South Africa
15292,9/1/2020,ZAF,Pahang,0,0,0,South Africa
15293,9/1/2020,ZAF,Perak,0,0,0,South Africa
15294,9/1/2020,ZAF,Perlis,0,0,0,South Africa
15295,9/1/2020,ZAF,Pulau Pinang,0,0,0,South Africa
15296,9/1/2020,ZAF,Sabah,0,0,0,South Africa
15297,9/1/2020,ZAF,Sarawak,0,0,0,South Africa
15298,9/1/2020,ZAF,Selangor,23,14,9,South Africa
15299,9/1/2020,ZAF,Terengganu,0,0,0,South Africa
15300,9/1/2020,ZAF,W.P. Labuan,0,0,0,South Africa
15301,9/1/2020,ZMB,Johor,0,0,0,Zambia
15302,9/1/2020,ZMB,Kedah,0,0,0,Zambia
15303,9/1/2020,ZMB,Perak,0,0,0,Zambia
15304,9/1/2020,ZMB,Perlis,0,0,0,Zambia
15305,9/1/2020,ZMB,Pulau Pinang,0,0,0,Zambia
15306,9/1/2020,ZMB,Sabah,0,0,0,Zambia
15307,9/1/2020,ZMB,Sarawak,0,0,0,Zambia
15308,9/1/2020,ZMB,Selangor,8,4,4,Zambia
15309,9/1/2020,ZWE,Johor,0,0,0,Zimbabwe
15310,9/1/2020,ZWE,Kedah,0,0,0,Zimbabwe
15311,9/1/2020,ZWE,Kelantan,0,0,0,Zimbabwe
15312,9/1/2020,ZWE,Perak,0,0,0,Zimbabwe
15313,9/1/2020,ZWE,Perlis,0,0,0,Zimbabwe
15314,9/1/2020,ZWE,Pulau Pinang,0,0,0,Zimbabwe
15315,9/1/2020,ZWE,Sabah,0,0,0,Zimbabwe
15316,9/1/2020,ZWE,Sarawak,0,0,0,Zimbabwe
15317,9/1/2020,ZWE,Selangor,0,0,0,Zimbabwe
15318,10/1/2020,ABW,Kedah,0,0,0,Aruba
15319,10/1/2020,ABW,Pulau Pinang,0,0,0,Aruba
15320,10/1/2020,AFG,Johor,0,0,0,Afghanistan
15321,10/1/2020,AFG,Kedah,0,0,0,Afghanistan
15322,10/1/2020,AFG,Perlis,0,0,0,Afghanistan
15323,10/1/2020,AFG,Pulau Pinang,0,0,0,Afghanistan
15324,10/1/2020,AFG,Sarawak,0,0,0,Afghanistan
15325,10/1/2020,AFG,Selangor,12,7,5,Afghanistan
15326,10/1/2020,AGO,Johor,0,0,0,Angola
15327,10/1/2020,AGO,Kedah,0,0,0,Angola
15328,10/1/2020,AGO,Sabah,0,0,0,Angola
15329,10/1/2020,AGO,Selangor,0,0,0,Angola
15330,10/1/2020,AIA,Selangor,0,0,0,Anguilla
15331,10/1/2020,ALB,Johor,0,0,0,Albania
15332,10/1/2020,ALB,Kedah,0,0,0,Albania
15333,10/1/2020,ALB,Perak,0,0,0,Albania
15334,10/1/2020,ALB,Perlis,0,0,0,Albania
15335,10/1/2020,ALB,Pulau Pinang,0,0,0,Albania
15336,10/1/2020,ALB,Sabah,0,0,0,Albania
15337,10/1/2020,ALB,Sarawak,0,0,0,Albania
15338,10/1/2020,ALB,Selangor,3,2,1,Albania
15339,10/1/2020,AND,Johor,0,0,0,Andorra
15340,10/1/2020,AND,Kedah,0,0,0,Andorra
15341,10/1/2020,AND,Perlis,0,0,0,Andorra
15342,10/1/2020,AND,Pulau Pinang,0,0,0,Andorra
15343,10/1/2020,AND,Selangor,0,0,0,Andorra
15344,10/1/2020,ANT,Selangor,0,0,0,Netherlands Antilles
15345,10/1/2020,ARE,Johor,0,0,0,United Arab Emirates
15346,10/1/2020,ARE,Kedah,0,0,0,United Arab Emirates
15347,10/1/2020,ARE,Kelantan,0,0,0,United Arab Emirates
15348,10/1/2020,ARE,Perak,0,0,0,United Arab Emirates
15349,10/1/2020,ARE,Perlis,0,0,0,United Arab Emirates
15350,10/1/2020,ARE,Pulau Pinang,0,0,0,United Arab Emirates
15351,10/1/2020,ARE,Sabah,0,0,0,United Arab Emirates
15352,10/1/2020,ARE,Sarawak,0,0,0,United Arab Emirates
15353,10/1/2020,ARE,Selangor,6,4,2,United Arab Emirates
15354,10/1/2020,ARG,Johor,0,0,0,Argentina
15355,10/1/2020,ARG,Kedah,0,0,0,Argentina
15356,10/1/2020,ARG,Kelantan,0,0,0,Argentina
15357,10/1/2020,ARG,Melaka,0,0,0,Argentina
15358,10/1/2020,ARG,Perak,0,0,0,Argentina
15359,10/1/2020,ARG,Perlis,0,0,0,Argentina
15360,10/1/2020,ARG,Pulau Pinang,0,0,0,Argentina
15361,10/1/2020,ARG,Sabah,0,0,0,Argentina
15362,10/1/2020,ARG,Sarawak,0,0,0,Argentina
15363,10/1/2020,ARG,Selangor,1,0,1,Argentina
15364,10/1/2020,ARG,W.P. Labuan,0,0,0,Argentina
15365,10/1/2020,ARM,Johor,0,0,0,Armenia
15366,10/1/2020,ARM,Kedah,0,0,0,Armenia
15367,10/1/2020,ARM,Kelantan,0,0,0,Armenia
15368,10/1/2020,ARM,Perak,0,0,0,Armenia
15369,10/1/2020,ARM,Perlis,0,0,0,Armenia
15370,10/1/2020,ARM,Pulau Pinang,0,0,0,Armenia
15371,10/1/2020,ARM,Sabah,0,0,0,Armenia
15372,10/1/2020,ARM,Sarawak,0,0,0,Armenia
15373,10/1/2020,ARM,Selangor,0,0,0,Armenia
15374,10/1/2020,ATA,Selangor,0,0,0,Antarctica
15375,10/1/2020,ATG,Johor,0,0,0,Antigua and Barbuda
15376,10/1/2020,ATG,Kedah,0,0,0,Antigua and Barbuda
15377,10/1/2020,ATG,Pulau Pinang,0,0,0,Antigua and Barbuda
15378,10/1/2020,ATG,Sarawak,0,0,0,Antigua and Barbuda
15379,10/1/2020,ATG,Selangor,1,1,0,Antigua and Barbuda
15380,10/1/2020,AUS,Johor,3,3,0,Australia
15381,10/1/2020,AUS,Kedah,0,0,0,Australia
15382,10/1/2020,AUS,Kelantan,0,0,0,Australia
15383,10/1/2020,AUS,Melaka,0,0,0,Australia
15384,10/1/2020,AUS,Negeri Sembilan,0,0,0,Australia
15385,10/1/2020,AUS,Pahang,0,0,0,Australia
15386,10/1/2020,AUS,Perak,0,0,0,Australia
15387,10/1/2020,AUS,Perlis,0,0,0,Australia
15388,10/1/2020,AUS,Pulau Pinang,5,2,3,Australia
15389,10/1/2020,AUS,Sabah,0,0,0,Australia
15390,10/1/2020,AUS,Sarawak,4,1,3,Australia
15391,10/1/2020,AUS,Selangor,89,60,29,Australia
15392,10/1/2020,AUS,Terengganu,0,0,0,Australia
15393,10/1/2020,AUS,W.P. Labuan,0,0,0,Australia
15394,10/1/2020,AUT,Johor,1,1,0,Austria
15395,10/1/2020,AUT,Kedah,0,0,0,Austria
15396,10/1/2020,AUT,Kelantan,0,0,0,Austria
15397,10/1/2020,AUT,Melaka,0,0,0,Austria
15398,10/1/2020,AUT,Negeri Sembilan,0,0,0,Austria
15399,10/1/2020,AUT,Pahang,0,0,0,Austria
15400,10/1/2020,AUT,Perak,0,0,0,Austria
15401,10/1/2020,AUT,Perlis,0,0,0,Austria
15402,10/1/2020,AUT,Pulau Pinang,0,0,0,Austria
15403,10/1/2020,AUT,Sabah,1,1,0,Austria
15404,10/1/2020,AUT,Sarawak,0,0,0,Austria
15405,10/1/2020,AUT,Selangor,6,4,2,Austria
15406,10/1/2020,AUT,Terengganu,0,0,0,Austria
15407,10/1/2020,AUT,W.P. Labuan,0,0,0,Austria
15408,10/1/2020,AZE,Johor,0,0,0,Azerbaijan
15409,10/1/2020,AZE,Kedah,0,0,0,Azerbaijan
15410,10/1/2020,AZE,Kelantan,0,0,0,Azerbaijan
15411,10/1/2020,AZE,Melaka,0,0,0,Azerbaijan
15412,10/1/2020,AZE,Perlis,0,0,0,Azerbaijan
15413,10/1/2020,AZE,Pulau Pinang,0,0,0,Azerbaijan
15414,10/1/2020,AZE,Sabah,0,0,0,Azerbaijan
15415,10/1/2020,AZE,Sarawak,0,0,0,Azerbaijan
15416,10/1/2020,AZE,Selangor,4,2,2,Azerbaijan
15417,10/1/2020,AZE,W.P. Labuan,0,0,0,Azerbaijan
15418,10/1/2020,BDI,Pulau Pinang,0,0,0,Burundi
15419,10/1/2020,BDI,Sarawak,0,0,0,Burundi
15420,10/1/2020,BDI,Selangor,0,0,0,Burundi
15421,10/1/2020,BEL,Johor,0,0,0,Belgium
15422,10/1/2020,BEL,Kedah,0,0,0,Belgium
15423,10/1/2020,BEL,Kelantan,0,0,0,Belgium
15424,10/1/2020,BEL,Melaka,0,0,0,Belgium
15425,10/1/2020,BEL,Negeri Sembilan,0,0,0,Belgium
15426,10/1/2020,BEL,Pahang,0,0,0,Belgium
15427,10/1/2020,BEL,Perak,1,1,0,Belgium
15428,10/1/2020,BEL,Perlis,0,0,0,Belgium
15429,10/1/2020,BEL,Pulau Pinang,0,0,0,Belgium
15430,10/1/2020,BEL,Sabah,0,0,0,Belgium
15431,10/1/2020,BEL,Sarawak,0,0,0,Belgium
15432,10/1/2020,BEL,Selangor,20,13,7,Belgium
15433,10/1/2020,BEL,W.P. Labuan,0,0,0,Belgium
15434,10/1/2020,BEN,Johor,0,0,0,Benin
15435,10/1/2020,BEN,Kedah,0,0,0,Benin
15436,10/1/2020,BEN,Perak,0,0,0,Benin
15437,10/1/2020,BEN,Pulau Pinang,0,0,0,Benin
15438,10/1/2020,BEN,Sabah,0,0,0,Benin
15439,10/1/2020,BEN,Sarawak,0,0,0,Benin
15440,10/1/2020,BEN,Selangor,0,0,0,Benin
15441,10/1/2020,BFA,Perak,0,0,0,Burkina Faso
15442,10/1/2020,BFA,Pulau Pinang,0,0,0,Burkina Faso
15443,10/1/2020,BFA,Selangor,0,0,0,Burkina Faso
15444,10/1/2020,BGD,Johor,2,2,0,Bangladesh
15445,10/1/2020,BGD,Kedah,0,0,0,Bangladesh
15446,10/1/2020,BGD,Kelantan,0,0,0,Bangladesh
15447,10/1/2020,BGD,Melaka,0,0,0,Bangladesh
15448,10/1/2020,BGD,Negeri Sembilan,0,0,0,Bangladesh
15449,10/1/2020,BGD,Pahang,0,0,0,Bangladesh
15450,10/1/2020,BGD,Perak,0,0,0,Bangladesh
15451,10/1/2020,BGD,Perlis,0,0,0,Bangladesh
15452,10/1/2020,BGD,Pulau Pinang,0,0,0,Bangladesh
15453,10/1/2020,BGD,Sabah,0,0,0,Bangladesh
15454,10/1/2020,BGD,Sarawak,0,0,0,Bangladesh
15455,10/1/2020,BGD,Selangor,61,57,4,Bangladesh
15456,10/1/2020,BGD,W.P. Labuan,0,0,0,Bangladesh
15457,10/1/2020,BGR,Johor,0,0,0,Bulgaria
15458,10/1/2020,BGR,Kedah,0,0,0,Bulgaria
15459,10/1/2020,BGR,Kelantan,0,0,0,Bulgaria
15460,10/1/2020,BGR,Pahang,0,0,0,Bulgaria
15461,10/1/2020,BGR,Perak,0,0,0,Bulgaria
15462,10/1/2020,BGR,Perlis,0,0,0,Bulgaria
15463,10/1/2020,BGR,Pulau Pinang,0,0,0,Bulgaria
15464,10/1/2020,BGR,Sabah,0,0,0,Bulgaria
15465,10/1/2020,BGR,Sarawak,0,0,0,Bulgaria
15466,10/1/2020,BGR,Selangor,17,16,1,Bulgaria
15467,10/1/2020,BGR,W.P. Labuan,0,0,0,Bulgaria
15468,10/1/2020,BHR,Johor,0,0,0,Bahrain
15469,10/1/2020,BHR,Kedah,0,0,0,Bahrain
15470,10/1/2020,BHR,Kelantan,0,0,0,Bahrain
15471,10/1/2020,BHR,Perlis,0,0,0,Bahrain
15472,10/1/2020,BHR,Pulau Pinang,0,0,0,Bahrain
15473,10/1/2020,BHR,Sabah,0,0,0,Bahrain
15474,10/1/2020,BHR,Sarawak,0,0,0,Bahrain
15475,10/1/2020,BHR,Selangor,2,1,1,Bahrain
15476,10/1/2020,BHS,Johor,0,0,0,Bahamas
15477,10/1/2020,BHS,Kedah,0,0,0,Bahamas
15478,10/1/2020,BHS,Perak,0,0,0,Bahamas
15479,10/1/2020,BHS,Sabah,0,0,0,Bahamas
15480,10/1/2020,BHS,Sarawak,0,0,0,Bahamas
15481,10/1/2020,BHS,Selangor,0,0,0,Bahamas
15482,10/1/2020,BIH,Johor,0,0,0,Bosnia and Herzegovina
15483,10/1/2020,BIH,Kedah,0,0,0,Bosnia and Herzegovina
15484,10/1/2020,BIH,Perlis,0,0,0,Bosnia and Herzegovina
15485,10/1/2020,BIH,Pulau Pinang,0,0,0,Bosnia and Herzegovina
15486,10/1/2020,BIH,Sabah,0,0,0,Bosnia and Herzegovina
15487,10/1/2020,BIH,Sarawak,0,0,0,Bosnia and Herzegovina
15488,10/1/2020,BIH,Selangor,10,6,4,Bosnia and Herzegovina
15489,10/1/2020,BLR,Johor,0,0,0,Belarus
15490,10/1/2020,BLR,Kedah,0,0,0,Belarus
15491,10/1/2020,BLR,Kelantan,0,0,0,Belarus
15492,10/1/2020,BLR,Pahang,0,0,0,Belarus
15493,10/1/2020,BLR,Perak,0,0,0,Belarus
15494,10/1/2020,BLR,Perlis,0,0,0,Belarus
15495,10/1/2020,BLR,Pulau Pinang,0,0,0,Belarus
15496,10/1/2020,BLR,Sabah,0,0,0,Belarus
15497,10/1/2020,BLR,Sarawak,0,0,0,Belarus
15498,10/1/2020,BLR,Selangor,1,0,1,Belarus
15499,10/1/2020,BLR,W.P. Labuan,0,0,0,Belarus
15500,10/1/2020,BLZ,Johor,0,0,0,Belize
15501,10/1/2020,BLZ,Pulau Pinang,0,0,0,Belize
15502,10/1/2020,BLZ,Sarawak,0,0,0,Belize
15503,10/1/2020,BLZ,Selangor,1,0,1,Belize
15504,10/1/2020,BMU,Selangor,0,0,0,Bermuda
15505,10/1/2020,BOL,Johor,0,0,0,Bolivia
15506,10/1/2020,BOL,Kedah,0,0,0,Bolivia
15507,10/1/2020,BOL,Melaka,0,0,0,Bolivia
15508,10/1/2020,BOL,Perak,0,0,0,Bolivia
15509,10/1/2020,BOL,Perlis,0,0,0,Bolivia
15510,10/1/2020,BOL,Pulau Pinang,0,0,0,Bolivia
15511,10/1/2020,BOL,Sabah,0,0,0,Bolivia
15512,10/1/2020,BOL,Sarawak,0,0,0,Bolivia
15513,10/1/2020,BOL,Selangor,0,0,0,Bolivia
15514,10/1/2020,BRA,Johor,0,0,0,Brazil
15515,10/1/2020,BRA,Kedah,0,0,0,Brazil
15516,10/1/2020,BRA,Kelantan,0,0,0,Brazil
15517,10/1/2020,BRA,Melaka,0,0,0,Brazil
15518,10/1/2020,BRA,Pahang,0,0,0,Brazil
15519,10/1/2020,BRA,Perak,0,0,0,Brazil
15520,10/1/2020,BRA,Perlis,0,0,0,Brazil
15521,10/1/2020,BRA,Pulau Pinang,0,0,0,Brazil
15522,10/1/2020,BRA,Sabah,0,0,0,Brazil
15523,10/1/2020,BRA,Sarawak,0,0,0,Brazil
15524,10/1/2020,BRA,Selangor,10,8,2,Brazil
15525,10/1/2020,BRA,W.P. Labuan,0,0,0,Brazil
15526,10/1/2020,BRB,Johor,0,0,0,Barbados
15527,10/1/2020,BRB,Kedah,0,0,0,Barbados
15528,10/1/2020,BRB,Perlis,0,0,0,Barbados
15529,10/1/2020,BRB,Pulau Pinang,0,0,0,Barbados
15530,10/1/2020,BRB,Selangor,0,0,0,Barbados
15531,10/1/2020,BRN,Johor,1,1,0,Brunei Darussalam
15532,10/1/2020,BRN,Kedah,0,0,0,Brunei Darussalam
15533,10/1/2020,BRN,Kelantan,0,0,0,Brunei Darussalam
15534,10/1/2020,BRN,Melaka,0,0,0,Brunei Darussalam
15535,10/1/2020,BRN,Pahang,0,0,0,Brunei Darussalam
15536,10/1/2020,BRN,Perak,0,0,0,Brunei Darussalam
15537,10/1/2020,BRN,Perlis,0,0,0,Brunei Darussalam
15538,10/1/2020,BRN,Pulau Pinang,0,0,0,Brunei Darussalam
15539,10/1/2020,BRN,Sabah,0,0,0,Brunei Darussalam
15540,10/1/2020,BRN,Sarawak,198,188,10,Brunei Darussalam
15541,10/1/2020,BRN,Selangor,29,15,14,Brunei Darussalam
15542,10/1/2020,BRN,W.P. Labuan,0,0,0,Brunei Darussalam
15543,10/1/2020,BTN,Johor,0,0,0,Bhutan
15544,10/1/2020,BTN,Kedah,0,0,0,Bhutan
15545,10/1/2020,BTN,Perak,0,0,0,Bhutan
15546,10/1/2020,BTN,Perlis,0,0,0,Bhutan
15547,10/1/2020,BTN,Pulau Pinang,0,0,0,Bhutan
15548,10/1/2020,BTN,Sabah,0,0,0,Bhutan
15549,10/1/2020,BTN,Sarawak,0,0,0,Bhutan
15550,10/1/2020,BTN,Selangor,1,0,1,Bhutan
15551,10/1/2020,BWA,Johor,0,0,0,Botswana
15552,10/1/2020,BWA,Kedah,0,0,0,Botswana
15553,10/1/2020,BWA,Perlis,0,0,0,Botswana
15554,10/1/2020,BWA,Pulau Pinang,0,0,0,Botswana
15555,10/1/2020,BWA,Sabah,0,0,0,Botswana
15556,10/1/2020,BWA,Sarawak,0,0,0,Botswana
15557,10/1/2020,BWA,Selangor,0,0,0,Botswana
15558,10/1/2020,CAF,Kedah,0,0,0,Central African Republic
15559,10/1/2020,CAF,Selangor,0,0,0,Central African Republic
15560,10/1/2020,CAN,Johor,1,1,0,Canada
15561,10/1/2020,CAN,Kedah,0,0,0,Canada
15562,10/1/2020,CAN,Kelantan,0,0,0,Canada
15563,10/1/2020,CAN,Melaka,0,0,0,Canada
15564,10/1/2020,CAN,Negeri Sembilan,0,0,0,Canada
15565,10/1/2020,CAN,Pahang,0,0,0,Canada
15566,10/1/2020,CAN,Perak,0,0,0,Canada
15567,10/1/2020,CAN,Perlis,0,0,0,Canada
15568,10/1/2020,CAN,Pulau Pinang,2,1,1,Canada
15569,10/1/2020,CAN,Sabah,0,0,0,Canada
15570,10/1/2020,CAN,Sarawak,0,0,0,Canada
15571,10/1/2020,CAN,Selangor,40,26,14,Canada
15572,10/1/2020,CAN,Terengganu,0,0,0,Canada
15573,10/1/2020,CAN,W.P. Labuan,0,0,0,Canada
15574,10/1/2020,CCK,Selangor,0,0,0,Cocos (Keeling) Islands
15575,10/1/2020,CHE,Johor,0,0,0,Switzerland
15576,10/1/2020,CHE,Kedah,0,0,0,Switzerland
15577,10/1/2020,CHE,Kelantan,0,0,0,Switzerland
15578,10/1/2020,CHE,Melaka,0,0,0,Switzerland
15579,10/1/2020,CHE,Negeri Sembilan,0,0,0,Switzerland
15580,10/1/2020,CHE,Pahang,0,0,0,Switzerland
15581,10/1/2020,CHE,Perak,0,0,0,Switzerland
15582,10/1/2020,CHE,Perlis,0,0,0,Switzerland
15583,10/1/2020,CHE,Pulau Pinang,2,2,0,Switzerland
15584,10/1/2020,CHE,Sabah,0,0,0,Switzerland
15585,10/1/2020,CHE,Sarawak,0,0,0,Switzerland
15586,10/1/2020,CHE,Selangor,21,12,9,Switzerland
15587,10/1/2020,CHE,W.P. Labuan,0,0,0,Switzerland
15588,10/1/2020,CHL,Johor,0,0,0,Chile
15589,10/1/2020,CHL,Kedah,0,0,0,Chile
15590,10/1/2020,CHL,Kelantan,0,0,0,Chile
15591,10/1/2020,CHL,Melaka,0,0,0,Chile
15592,10/1/2020,CHL,Pahang,0,0,0,Chile
15593,10/1/2020,CHL,Perak,0,0,0,Chile
15594,10/1/2020,CHL,Perlis,0,0,0,Chile
15595,10/1/2020,CHL,Pulau Pinang,0,0,0,Chile
15596,10/1/2020,CHL,Sabah,0,0,0,Chile
15597,10/1/2020,CHL,Sarawak,0,0,0,Chile
15598,10/1/2020,CHL,Selangor,4,4,0,Chile
15599,10/1/2020,CHN,Johor,43,32,11,China
15600,10/1/2020,CHN,Kedah,0,0,0,China
15601,10/1/2020,CHN,Kelantan,0,0,0,China
15602,10/1/2020,CHN,Melaka,0,0,0,China
15603,10/1/2020,CHN,Pahang,0,0,0,China
15604,10/1/2020,CHN,Perak,0,0,0,China
15605,10/1/2020,CHN,Perlis,0,0,0,China
15606,10/1/2020,CHN,Pulau Pinang,3,2,1,China
15607,10/1/2020,CHN,Sabah,0,0,0,China
15608,10/1/2020,CHN,Sarawak,101,55,46,China
15609,10/1/2020,CHN,Selangor,1142,908,234,China
15610,10/1/2020,CHN,Terengganu,0,0,0,China
15611,10/1/2020,CHN,W.P. Labuan,0,0,0,China
15612,10/1/2020,CIV,Johor,0,0,0,C��te d'Iv
15613,10/1/2020,CIV,Kedah,0,0,0,C��te d'Iv
15614,10/1/2020,CIV,Pulau Pinang,0,0,0,C��te d'Iv
15615,10/1/2020,CIV,Sabah,0,0,0,C��te d'Iv
15616,10/1/2020,CIV,Sarawak,0,0,0,C��te d'Iv
15617,10/1/2020,CIV,Selangor,0,0,0,C��te d'Iv
15618,10/1/2020,CMR,Johor,0,0,0,Cameroon
15619,10/1/2020,CMR,Kedah,0,0,0,Cameroon
15620,10/1/2020,CMR,Pulau Pinang,0,0,0,Cameroon
15621,10/1/2020,CMR,Sabah,0,0,0,Cameroon
15622,10/1/2020,CMR,Sarawak,0,0,0,Cameroon
15623,10/1/2020,CMR,Selangor,0,0,0,Cameroon
15624,10/1/2020,COD,Johor,0,0,0,"Congo, the Democratic Republic of the"
15625,10/1/2020,COD,Pulau Pinang,0,0,0,"Congo, the Democratic Republic of the"
15626,10/1/2020,COD,Sarawak,0,0,0,"Congo, the Democratic Republic of the"
15627,10/1/2020,COD,Selangor,1,0,1,"Congo, the Democratic Republic of the"
15628,10/1/2020,COG,Johor,0,0,0,Congo
15629,10/1/2020,COG,Kedah,0,0,0,Congo
15630,10/1/2020,COG,Selangor,0,0,0,Congo
15631,10/1/2020,COK,Selangor,0,0,0,Cook Islands
15632,10/1/2020,COL,Johor,0,0,0,Colombia
15633,10/1/2020,COL,Kedah,0,0,0,Colombia
15634,10/1/2020,COL,Perak,0,0,0,Colombia
15635,10/1/2020,COL,Pulau Pinang,0,0,0,Colombia
15636,10/1/2020,COL,Sabah,0,0,0,Colombia
15637,10/1/2020,COL,Sarawak,0,0,0,Colombia
15638,10/1/2020,COL,Selangor,1,1,0,Colombia
15639,10/1/2020,COL,W.P. Labuan,0,0,0,Colombia
15640,10/1/2020,COM,Johor,0,0,0,Comoros
15641,10/1/2020,COM,Kedah,0,0,0,Comoros
15642,10/1/2020,COM,Selangor,2,0,2,Comoros
15643,10/1/2020,CPV,Johor,0,0,0,Cape Verde
15644,10/1/2020,CPV,Kedah,0,0,0,Cape Verde
15645,10/1/2020,CPV,Pulau Pinang,0,0,0,Cape Verde
15646,10/1/2020,CPV,Sabah,0,0,0,Cape Verde
15647,10/1/2020,CPV,Selangor,0,0,0,Cape Verde
15648,10/1/2020,CRI,Johor,2,2,0,Costa Rica
15649,10/1/2020,CRI,Kedah,0,0,0,Costa Rica
15650,10/1/2020,CRI,Perak,0,0,0,Costa Rica
15651,10/1/2020,CRI,Perlis,0,0,0,Costa Rica
15652,10/1/2020,CRI,Pulau Pinang,0,0,0,Costa Rica
15653,10/1/2020,CRI,Sabah,0,0,0,Costa Rica
15654,10/1/2020,CRI,Sarawak,0,0,0,Costa Rica
15655,10/1/2020,CRI,Selangor,1,1,0,Costa Rica
15656,10/1/2020,CUB,Johor,0,0,0,Cuba
15657,10/1/2020,CUB,Kedah,0,0,0,Cuba
15658,10/1/2020,CUB,Perlis,0,0,0,Cuba
15659,10/1/2020,CUB,Pulau Pinang,0,0,0,Cuba
15660,10/1/2020,CUB,Sabah,0,0,0,Cuba
15661,10/1/2020,CUB,Sarawak,0,0,0,Cuba
15662,10/1/2020,CUB,Selangor,0,0,0,Cuba
15663,10/1/2020,CYP,Johor,0,0,0,Cyprus
15664,10/1/2020,CYP,Kedah,0,0,0,Cyprus
15665,10/1/2020,CYP,Perak,0,0,0,Cyprus
15666,10/1/2020,CYP,Perlis,0,0,0,Cyprus
15667,10/1/2020,CYP,Pulau Pinang,0,0,0,Cyprus
15668,10/1/2020,CYP,Sabah,0,0,0,Cyprus
15669,10/1/2020,CYP,Sarawak,0,0,0,Cyprus
15670,10/1/2020,CYP,Selangor,0,0,0,Cyprus
15671,10/1/2020,CZE,Johor,0,0,0,Czech Republic
15672,10/1/2020,CZE,Kedah,0,0,0,Czech Republic
15673,10/1/2020,CZE,Kelantan,0,0,0,Czech Republic
15674,10/1/2020,CZE,Melaka,0,0,0,Czech Republic
15675,10/1/2020,CZE,Negeri Sembilan,0,0,0,Czech Republic
15676,10/1/2020,CZE,Perak,0,0,0,Czech Republic
15677,10/1/2020,CZE,Perlis,0,0,0,Czech Republic
15678,10/1/2020,CZE,Pulau Pinang,0,0,0,Czech Republic
15679,10/1/2020,CZE,Sabah,0,0,0,Czech Republic
15680,10/1/2020,CZE,Sarawak,0,0,0,Czech Republic
15681,10/1/2020,CZE,Selangor,5,4,1,Czech Republic
15682,10/1/2020,CZE,W.P. Labuan,0,0,0,Czech Republic
15683,10/1/2020,DEU,Johor,1,1,0,Germany
15684,10/1/2020,DEU,Kedah,0,0,0,Germany
15685,10/1/2020,DEU,Kelantan,0,0,0,Germany
15686,10/1/2020,DEU,Melaka,0,0,0,Germany
15687,10/1/2020,DEU,Negeri Sembilan,0,0,0,Germany
15688,10/1/2020,DEU,Pahang,0,0,0,Germany
15689,10/1/2020,DEU,Perak,0,0,0,Germany
15690,10/1/2020,DEU,Perlis,0,0,0,Germany
15691,10/1/2020,DEU,Pulau Pinang,1,0,1,Germany
15692,10/1/2020,DEU,Sabah,0,0,0,Germany
15693,10/1/2020,DEU,Sarawak,0,0,0,Germany
15694,10/1/2020,DEU,Selangor,110,87,23,Germany
15695,10/1/2020,DEU,Terengganu,0,0,0,Germany
15696,10/1/2020,DEU,W.P. Labuan,0,0,0,Germany
15697,10/1/2020,DJI,Johor,0,0,0,Djibouti
15698,10/1/2020,DJI,Selangor,2,2,0,Djibouti
15699,10/1/2020,DMA,Johor,0,0,0,Dominica
15700,10/1/2020,DMA,Kedah,0,0,0,Dominica
15701,10/1/2020,DMA,Pulau Pinang,0,0,0,Dominica
15702,10/1/2020,DMA,Sabah,0,0,0,Dominica
15703,10/1/2020,DMA,Sarawak,0,0,0,Dominica
15704,10/1/2020,DMA,Selangor,0,0,0,Dominica
15705,10/1/2020,DMA,W.P. Labuan,0,0,0,Dominica
15706,10/1/2020,DNK,Johor,8,8,0,Denmark
15707,10/1/2020,DNK,Kedah,0,0,0,Denmark
15708,10/1/2020,DNK,Kelantan,0,0,0,Denmark
15709,10/1/2020,DNK,Melaka,0,0,0,Denmark
15710,10/1/2020,DNK,Negeri Sembilan,0,0,0,Denmark
15711,10/1/2020,DNK,Pahang,0,0,0,Denmark
15712,10/1/2020,DNK,Perak,0,0,0,Denmark
15713,10/1/2020,DNK,Perlis,0,0,0,Denmark
15714,10/1/2020,DNK,Pulau Pinang,0,0,0,Denmark
15715,10/1/2020,DNK,Sabah,0,0,0,Denmark
15716,10/1/2020,DNK,Sarawak,1,1,0,Denmark
15717,10/1/2020,DNK,Selangor,19,17,2,Denmark
15718,10/1/2020,DNK,W.P. Labuan,0,0,0,Denmark
15719,10/1/2020,DOM,Johor,0,0,0,Dominican Republic
15720,10/1/2020,DOM,Kedah,0,0,0,Dominican Republic
15721,10/1/2020,DOM,Perak,0,0,0,Dominican Republic
15722,10/1/2020,DOM,Perlis,0,0,0,Dominican Republic
15723,10/1/2020,DOM,Pulau Pinang,0,0,0,Dominican Republic
15724,10/1/2020,DOM,Sabah,0,0,0,Dominican Republic
15725,10/1/2020,DOM,Sarawak,0,0,0,Dominican Republic
15726,10/1/2020,DOM,Selangor,0,0,0,Dominican Republic
15727,10/1/2020,DZA,Johor,0,0,0,Algeria
15728,10/1/2020,DZA,Kedah,0,0,0,Algeria
15729,10/1/2020,DZA,Kelantan,0,0,0,Algeria
15730,10/1/2020,DZA,Melaka,0,0,0,Algeria
15731,10/1/2020,DZA,Perak,0,0,0,Algeria
15732,10/1/2020,DZA,Perlis,0,0,0,Algeria
15733,10/1/2020,DZA,Pulau Pinang,0,0,0,Algeria
15734,10/1/2020,DZA,Sabah,0,0,0,Algeria
15735,10/1/2020,DZA,Sarawak,0,0,0,Algeria
15736,10/1/2020,DZA,Selangor,1,1,0,Algeria
15737,10/1/2020,DZA,W.P. Labuan,0,0,0,Algeria
15738,10/1/2020,ECU,Johor,0,0,0,Ecuador
15739,10/1/2020,ECU,Kedah,0,0,0,Ecuador
15740,10/1/2020,ECU,Perak,0,0,0,Ecuador
15741,10/1/2020,ECU,Perlis,0,0,0,Ecuador
15742,10/1/2020,ECU,Pulau Pinang,0,0,0,Ecuador
15743,10/1/2020,ECU,Sabah,0,0,0,Ecuador
15744,10/1/2020,ECU,Sarawak,0,0,0,Ecuador
15745,10/1/2020,ECU,Selangor,0,0,0,Ecuador
15746,10/1/2020,EGY,Johor,0,0,0,Egypt
15747,10/1/2020,EGY,Kedah,0,0,0,Egypt
15748,10/1/2020,EGY,Kelantan,0,0,0,Egypt
15749,10/1/2020,EGY,Melaka,0,0,0,Egypt
15750,10/1/2020,EGY,Pahang,0,0,0,Egypt
15751,10/1/2020,EGY,Perak,0,0,0,Egypt
15752,10/1/2020,EGY,Perlis,0,0,0,Egypt
15753,10/1/2020,EGY,Pulau Pinang,0,0,0,Egypt
15754,10/1/2020,EGY,Sabah,0,0,0,Egypt
15755,10/1/2020,EGY,Sarawak,1,1,0,Egypt
15756,10/1/2020,EGY,Selangor,52,38,14,Egypt
15757,10/1/2020,EGY,Terengganu,0,0,0,Egypt
15758,10/1/2020,EGY,W.P. Labuan,0,0,0,Egypt
15759,10/1/2020,ERI,Johor,0,0,0,Eritrea
15760,10/1/2020,ERI,Pulau Pinang,0,0,0,Eritrea
15761,10/1/2020,ERI,Sabah,0,0,0,Eritrea
15762,10/1/2020,ERI,Selangor,0,0,0,Eritrea
15763,10/1/2020,ESP,Johor,0,0,0,Spain
15764,10/1/2020,ESP,Kedah,0,0,0,Spain
15765,10/1/2020,ESP,Kelantan,0,0,0,Spain
15766,10/1/2020,ESP,Melaka,0,0,0,Spain
15767,10/1/2020,ESP,Negeri Sembilan,0,0,0,Spain
15768,10/1/2020,ESP,Pahang,0,0,0,Spain
15769,10/1/2020,ESP,Perak,0,0,0,Spain
15770,10/1/2020,ESP,Perlis,0,0,0,Spain
15771,10/1/2020,ESP,Pulau Pinang,0,0,0,Spain
15772,10/1/2020,ESP,Sabah,0,0,0,Spain
15773,10/1/2020,ESP,Sarawak,0,0,0,Spain
15774,10/1/2020,ESP,Selangor,12,6,6,Spain
15775,10/1/2020,ESP,W.P. Labuan,0,0,0,Spain
15776,10/1/2020,EST,Johor,0,0,0,Estonia
15777,10/1/2020,EST,Kedah,0,0,0,Estonia
15778,10/1/2020,EST,Kelantan,0,0,0,Estonia
15779,10/1/2020,EST,Pahang,0,0,0,Estonia
15780,10/1/2020,EST,Perak,0,0,0,Estonia
15781,10/1/2020,EST,Perlis,0,0,0,Estonia
15782,10/1/2020,EST,Pulau Pinang,0,0,0,Estonia
15783,10/1/2020,EST,Sabah,0,0,0,Estonia
15784,10/1/2020,EST,Sarawak,0,0,0,Estonia
15785,10/1/2020,EST,Selangor,0,0,0,Estonia
15786,10/1/2020,EST,W.P. Labuan,0,0,0,Estonia
15787,10/1/2020,ETH,Johor,0,0,0,Ethiopia
15788,10/1/2020,ETH,Kedah,0,0,0,Ethiopia
15789,10/1/2020,ETH,Pulau Pinang,0,0,0,Ethiopia
15790,10/1/2020,ETH,Sarawak,0,0,0,Ethiopia
15791,10/1/2020,ETH,Selangor,0,0,0,Ethiopia
15792,10/1/2020,FIN,Johor,0,0,0,Finland
15793,10/1/2020,FIN,Kedah,0,0,0,Finland
15794,10/1/2020,FIN,Kelantan,0,0,0,Finland
15795,10/1/2020,FIN,Melaka,0,0,0,Finland
15796,10/1/2020,FIN,Negeri Sembilan,0,0,0,Finland
15797,10/1/2020,FIN,Pahang,0,0,0,Finland
15798,10/1/2020,FIN,Perak,0,0,0,Finland
15799,10/1/2020,FIN,Perlis,0,0,0,Finland
15800,10/1/2020,FIN,Pulau Pinang,0,0,0,Finland
15801,10/1/2020,FIN,Sabah,0,0,0,Finland
15802,10/1/2020,FIN,Sarawak,0,0,0,Finland
15803,10/1/2020,FIN,Selangor,2,1,1,Finland
15804,10/1/2020,FIN,W.P. Labuan,0,0,0,Finland
15805,10/1/2020,FJI,Johor,0,0,0,Fiji
15806,10/1/2020,FJI,Kedah,0,0,0,Fiji
15807,10/1/2020,FJI,Kelantan,0,0,0,Fiji
15808,10/1/2020,FJI,Perak,0,0,0,Fiji
15809,10/1/2020,FJI,Perlis,0,0,0,Fiji
15810,10/1/2020,FJI,Pulau Pinang,0,0,0,Fiji
15811,10/1/2020,FJI,Sabah,0,0,0,Fiji
15812,10/1/2020,FJI,Sarawak,0,0,0,Fiji
15813,10/1/2020,FJI,Selangor,0,0,0,Fiji
15814,10/1/2020,FRA,Johor,2,2,0,France
15815,10/1/2020,FRA,Kedah,0,0,0,France
15816,10/1/2020,FRA,Kelantan,0,0,0,France
15817,10/1/2020,FRA,Melaka,0,0,0,France
15818,10/1/2020,FRA,Negeri Sembilan,0,0,0,France
15819,10/1/2020,FRA,Pahang,0,0,0,France
15820,10/1/2020,FRA,Perak,0,0,0,France
15821,10/1/2020,FRA,Perlis,0,0,0,France
15822,10/1/2020,FRA,Pulau Pinang,0,0,0,France
15823,10/1/2020,FRA,Sabah,0,0,0,France
15824,10/1/2020,FRA,Sarawak,0,0,0,France
15825,10/1/2020,FRA,Selangor,78,48,30,France
15826,10/1/2020,FRA,Terengganu,0,0,0,France
15827,10/1/2020,FRA,W.P. Labuan,0,0,0,France
15828,10/1/2020,FSM,Johor,0,0,0,"Micronesia, Federated States of"
15829,10/1/2020,FSM,Pulau Pinang,0,0,0,"Micronesia, Federated States of"
15830,10/1/2020,FSM,Selangor,0,0,0,"Micronesia, Federated States of"
15831,10/1/2020,GAB,Johor,0,0,0,Gabon
15832,10/1/2020,GAB,Pulau Pinang,0,0,0,Gabon
15833,10/1/2020,GAB,Sarawak,0,0,0,Gabon
15834,10/1/2020,GAB,Selangor,0,0,0,Gabon
15835,10/1/2020,GBR,Johor,4,4,0,United Kingdom
15836,10/1/2020,GBR,Kedah,0,0,0,United Kingdom
15837,10/1/2020,GBR,Kelantan,0,0,0,United Kingdom
15838,10/1/2020,GBR,Melaka,0,0,0,United Kingdom
15839,10/1/2020,GBR,Negeri Sembilan,0,0,0,United Kingdom
15840,10/1/2020,GBR,Pahang,0,0,0,United Kingdom
15841,10/1/2020,GBR,Perak,0,0,0,United Kingdom
15842,10/1/2020,GBR,Perlis,0,0,0,United Kingdom
15843,10/1/2020,GBR,Pulau Pinang,5,5,0,United Kingdom
15844,10/1/2020,GBR,Sabah,1,1,0,United Kingdom
15845,10/1/2020,GBR,Sarawak,0,0,0,United Kingdom
15846,10/1/2020,GBR,Selangor,209,156,53,United Kingdom
15847,10/1/2020,GBR,Terengganu,0,0,0,United Kingdom
15848,10/1/2020,GBR,W.P. Labuan,0,0,0,United Kingdom
15849,10/1/2020,GEO,Johor,0,0,0,Georgia
15850,10/1/2020,GEO,Kedah,0,0,0,Georgia
15851,10/1/2020,GEO,Melaka,0,0,0,Georgia
15852,10/1/2020,GEO,Perak,0,0,0,Georgia
15853,10/1/2020,GEO,Perlis,0,0,0,Georgia
15854,10/1/2020,GEO,Pulau Pinang,0,0,0,Georgia
15855,10/1/2020,GEO,Sabah,0,0,0,Georgia
15856,10/1/2020,GEO,Sarawak,0,0,0,Georgia
15857,10/1/2020,GEO,Selangor,9,8,1,Georgia
15858,10/1/2020,GHA,Johor,0,0,0,Ghana
15859,10/1/2020,GHA,Kedah,0,0,0,Ghana
15860,10/1/2020,GHA,Kelantan,0,0,0,Ghana
15861,10/1/2020,GHA,Pulau Pinang,0,0,0,Ghana
15862,10/1/2020,GHA,Sabah,0,0,0,Ghana
15863,10/1/2020,GHA,Sarawak,0,0,0,Ghana
15864,10/1/2020,GHA,Selangor,2,1,1,Ghana
15865,10/1/2020,GIB,Johor,0,0,0,Gibraltar
15866,10/1/2020,GIB,Sarawak,0,0,0,Gibraltar
15867,10/1/2020,GIN,Johor,0,0,0,Guinea
15868,10/1/2020,GIN,Kedah,0,0,0,Guinea
15869,10/1/2020,GIN,Kelantan,0,0,0,Guinea
15870,10/1/2020,GIN,Perlis,0,0,0,Guinea
15871,10/1/2020,GIN,Pulau Pinang,0,0,0,Guinea
15872,10/1/2020,GIN,Sabah,0,0,0,Guinea
15873,10/1/2020,GIN,Sarawak,0,0,0,Guinea
15874,10/1/2020,GIN,Selangor,0,0,0,Guinea
15875,10/1/2020,GLP,Selangor,0,0,0,Guadeloupe
15876,10/1/2020,GMB,Johor,0,0,0,Gambia
15877,10/1/2020,GMB,Kedah,0,0,0,Gambia
15878,10/1/2020,GMB,Kelantan,0,0,0,Gambia
15879,10/1/2020,GMB,Pulau Pinang,0,0,0,Gambia
15880,10/1/2020,GMB,Sabah,0,0,0,Gambia
15881,10/1/2020,GMB,Sarawak,0,0,0,Gambia
15882,10/1/2020,GMB,Selangor,0,0,0,Gambia
15883,10/1/2020,GNB,Johor,0,0,0,Guinea-Bissau
15884,10/1/2020,GNB,Selangor,0,0,0,Guinea-Bissau
15885,10/1/2020,GNQ,Johor,0,0,0,Equatorial Guinea
15886,10/1/2020,GNQ,Selangor,0,0,0,Equatorial Guinea
15887,10/1/2020,GRC,Johor,0,0,0,Greece
15888,10/1/2020,GRC,Kedah,0,0,0,Greece
15889,10/1/2020,GRC,Kelantan,0,0,0,Greece
15890,10/1/2020,GRC,Melaka,0,0,0,Greece
15891,10/1/2020,GRC,Negeri Sembilan,0,0,0,Greece
15892,10/1/2020,GRC,Pahang,0,0,0,Greece
15893,10/1/2020,GRC,Perak,0,0,0,Greece
15894,10/1/2020,GRC,Perlis,0,0,0,Greece
15895,10/1/2020,GRC,Pulau Pinang,0,0,0,Greece
15896,10/1/2020,GRC,Sabah,0,0,0,Greece
15897,10/1/2020,GRC,Sarawak,0,0,0,Greece
15898,10/1/2020,GRC,Selangor,14,13,1,Greece
15899,10/1/2020,GRD,Johor,0,0,0,Grenada
15900,10/1/2020,GRD,Kedah,0,0,0,Grenada
15901,10/1/2020,GRD,Pulau Pinang,0,0,0,Grenada
15902,10/1/2020,GRD,Sabah,0,0,0,Grenada
15903,10/1/2020,GRD,Sarawak,0,0,0,Grenada
15904,10/1/2020,GRD,Selangor,0,0,0,Grenada
15905,10/1/2020,GRL,Johor,0,0,0,Greenland
15906,10/1/2020,GRL,Selangor,0,0,0,Greenland
15907,10/1/2020,GTM,Johor,0,0,0,Guatemala
15908,10/1/2020,GTM,Kedah,0,0,0,Guatemala
15909,10/1/2020,GTM,Pahang,0,0,0,Guatemala
15910,10/1/2020,GTM,Perak,0,0,0,Guatemala
15911,10/1/2020,GTM,Pulau Pinang,0,0,0,Guatemala
15912,10/1/2020,GTM,Sabah,0,0,0,Guatemala
15913,10/1/2020,GTM,Sarawak,0,0,0,Guatemala
15914,10/1/2020,GTM,Selangor,0,0,0,Guatemala
15915,10/1/2020,GTM,W.P. Labuan,0,0,0,Guatemala
15916,10/1/2020,GUY,Johor,0,0,0,Guyana
15917,10/1/2020,GUY,Kedah,0,0,0,Guyana
15918,10/1/2020,GUY,Pulau Pinang,0,0,0,Guyana
15919,10/1/2020,GUY,Sarawak,0,0,0,Guyana
15920,10/1/2020,GUY,Selangor,0,0,0,Guyana
15921,10/1/2020,HKG,Johor,0,0,0,Hong Kong
15922,10/1/2020,HKG,Kedah,0,0,0,Hong Kong
15923,10/1/2020,HKG,Kelantan,0,0,0,Hong Kong
15924,10/1/2020,HKG,Pahang,0,0,0,Hong Kong
15925,10/1/2020,HKG,Perak,0,0,0,Hong Kong
15926,10/1/2020,HKG,Perlis,0,0,0,Hong Kong
15927,10/1/2020,HKG,Pulau Pinang,0,0,0,Hong Kong
15928,10/1/2020,HKG,Sabah,0,0,0,Hong Kong
15929,10/1/2020,HKG,Sarawak,0,0,0,Hong Kong
15930,10/1/2020,HKG,Selangor,0,0,0,Hong Kong
15931,10/1/2020,HKG,Terengganu,0,0,0,Hong Kong
15932,10/1/2020,HMD,Johor,0,0,0,Heard Island and McDonald Islands
15933,10/1/2020,HND,Johor,0,0,0,Honduras
15934,10/1/2020,HND,Kedah,0,0,0,Honduras
15935,10/1/2020,HND,Perak,0,0,0,Honduras
15936,10/1/2020,HND,Pulau Pinang,0,0,0,Honduras
15937,10/1/2020,HND,Sabah,0,0,0,Honduras
15938,10/1/2020,HND,Sarawak,0,0,0,Honduras
15939,10/1/2020,HND,Selangor,3,3,0,Honduras
15940,10/1/2020,HRV,Johor,0,0,0,Croatia
15941,10/1/2020,HRV,Kedah,0,0,0,Croatia
15942,10/1/2020,HRV,Kelantan,0,0,0,Croatia
15943,10/1/2020,HRV,Melaka,0,0,0,Croatia
15944,10/1/2020,HRV,Pahang,0,0,0,Croatia
15945,10/1/2020,HRV,Perak,0,0,0,Croatia
15946,10/1/2020,HRV,Perlis,0,0,0,Croatia
15947,10/1/2020,HRV,Pulau Pinang,0,0,0,Croatia
15948,10/1/2020,HRV,Sabah,0,0,0,Croatia
15949,10/1/2020,HRV,Sarawak,0,0,0,Croatia
15950,10/1/2020,HRV,Selangor,10,9,1,Croatia
15951,10/1/2020,HTI,Johor,0,0,0,Haiti
15952,10/1/2020,HTI,Kedah,0,0,0,Haiti
15953,10/1/2020,HTI,Kelantan,0,0,0,Haiti
15954,10/1/2020,HTI,Perak,0,0,0,Haiti
15955,10/1/2020,HTI,Pulau Pinang,0,0,0,Haiti
15956,10/1/2020,HTI,Sabah,0,0,0,Haiti
15957,10/1/2020,HTI,Selangor,0,0,0,Haiti
15958,10/1/2020,HUN,Johor,0,0,0,Hungary
15959,10/1/2020,HUN,Kedah,0,0,0,Hungary
15960,10/1/2020,HUN,Kelantan,0,0,0,Hungary
15961,10/1/2020,HUN,Pahang,0,0,0,Hungary
15962,10/1/2020,HUN,Perak,0,0,0,Hungary
15963,10/1/2020,HUN,Perlis,0,0,0,Hungary
15964,10/1/2020,HUN,Pulau Pinang,0,0,0,Hungary
15965,10/1/2020,HUN,Sabah,0,0,0,Hungary
15966,10/1/2020,HUN,Sarawak,0,0,0,Hungary
15967,10/1/2020,HUN,Selangor,4,2,2,Hungary
15968,10/1/2020,HUN,W.P. Labuan,0,0,0,Hungary
15969,10/1/2020,IDN,Johor,238,227,11,Indonesia
15970,10/1/2020,IDN,Kedah,3,3,0,Indonesia
15971,10/1/2020,IDN,Kelantan,0,0,0,Indonesia
15972,10/1/2020,IDN,Melaka,2,1,1,Indonesia
15973,10/1/2020,IDN,Negeri Sembilan,0,0,0,Indonesia
15974,10/1/2020,IDN,Pahang,0,0,0,Indonesia
15975,10/1/2020,IDN,Perak,0,0,0,Indonesia
15976,10/1/2020,IDN,Perlis,7,5,2,Indonesia
15977,10/1/2020,IDN,Pulau Pinang,2,2,0,Indonesia
15978,10/1/2020,IDN,Sabah,0,0,0,Indonesia
15979,10/1/2020,IDN,Sarawak,276,260,16,Indonesia
15980,10/1/2020,IDN,Selangor,445,369,76,Indonesia
15981,10/1/2020,IDN,Terengganu,0,0,0,Indonesia
15982,10/1/2020,IDN,W.P. Labuan,1,1,0,Indonesia
15983,10/1/2020,IND,Johor,39,37,2,India
15984,10/1/2020,IND,Kedah,0,0,0,India
15985,10/1/2020,IND,Kelantan,0,0,0,India
15986,10/1/2020,IND,Melaka,0,0,0,India
15987,10/1/2020,IND,Negeri Sembilan,0,0,0,India
15988,10/1/2020,IND,Pahang,0,0,0,India
15989,10/1/2020,IND,Perak,0,0,0,India
15990,10/1/2020,IND,Perlis,0,0,0,India
15991,10/1/2020,IND,Pulau Pinang,0,0,0,India
15992,10/1/2020,IND,Sabah,0,0,0,India
15993,10/1/2020,IND,Sarawak,0,0,0,India
15994,10/1/2020,IND,Selangor,353,305,48,India
15995,10/1/2020,IND,Terengganu,0,0,0,India
15996,10/1/2020,IND,W.P. Labuan,0,0,0,India
15997,10/1/2020,IOT,Pulau Pinang,0,0,0,British Indian Ocean Territory
15998,10/1/2020,IOT,Selangor,0,0,0,British Indian Ocean Territory
15999,10/1/2020,IRL,Johor,0,0,0,Ireland
16000,10/1/2020,IRL,Kedah,0,0,0,Ireland
16001,10/1/2020,IRL,Kelantan,0,0,0,Ireland
16002,10/1/2020,IRL,Negeri Sembilan,0,0,0,Ireland
16003,10/1/2020,IRL,Pahang,0,0,0,Ireland
16004,10/1/2020,IRL,Perak,0,0,0,Ireland
16005,10/1/2020,IRL,Perlis,0,0,0,Ireland
16006,10/1/2020,IRL,Pulau Pinang,0,0,0,Ireland
16007,10/1/2020,IRL,Sabah,0,0,0,Ireland
16008,10/1/2020,IRL,Sarawak,0,0,0,Ireland
16009,10/1/2020,IRL,Selangor,19,11,8,Ireland
16010,10/1/2020,IRL,Terengganu,0,0,0,Ireland
16011,10/1/2020,IRL,W.P. Labuan,0,0,0,Ireland
16012,10/1/2020,IRN,Johor,0,0,0,Iran
16013,10/1/2020,IRN,Kedah,0,0,0,Iran
16014,10/1/2020,IRN,Kelantan,0,0,0,Iran
16015,10/1/2020,IRN,Perak,0,0,0,Iran
16016,10/1/2020,IRN,Perlis,0,0,0,Iran
16017,10/1/2020,IRN,Pulau Pinang,0,0,0,Iran
16018,10/1/2020,IRN,Sabah,0,0,0,Iran
16019,10/1/2020,IRN,Sarawak,0,0,0,Iran
16020,10/1/2020,IRN,Selangor,30,13,17,Iran
16021,10/1/2020,IRN,W.P. Labuan,0,0,0,Iran
16022,10/1/2020,IRQ,Johor,0,0,0,Iraq
16023,10/1/2020,IRQ,Kedah,0,0,0,Iraq
16024,10/1/2020,IRQ,Kelantan,0,0,0,Iraq
16025,10/1/2020,IRQ,Melaka,0,0,0,Iraq
16026,10/1/2020,IRQ,Pahang,0,0,0,Iraq
16027,10/1/2020,IRQ,Perak,0,0,0,Iraq
16028,10/1/2020,IRQ,Perlis,0,0,0,Iraq
16029,10/1/2020,IRQ,Pulau Pinang,0,0,0,Iraq
16030,10/1/2020,IRQ,Sabah,0,0,0,Iraq
16031,10/1/2020,IRQ,Sarawak,0,0,0,Iraq
16032,10/1/2020,IRQ,Selangor,10,6,4,Iraq
16033,10/1/2020,ISL,Johor,0,0,0,Iceland
16034,10/1/2020,ISL,Kedah,0,0,0,Iceland
16035,10/1/2020,ISL,Kelantan,0,0,0,Iceland
16036,10/1/2020,ISL,Perak,0,0,0,Iceland
16037,10/1/2020,ISL,Perlis,0,0,0,Iceland
16038,10/1/2020,ISL,Pulau Pinang,0,0,0,Iceland
16039,10/1/2020,ISL,Sabah,0,0,0,Iceland
16040,10/1/2020,ISL,Sarawak,0,0,0,Iceland
16041,10/1/2020,ISL,Selangor,0,0,0,Iceland
16042,10/1/2020,ISL,W.P. Labuan,0,0,0,Iceland
16043,10/1/2020,ISR,Pulau Pinang,0,0,0,Israel
16044,10/1/2020,ITA,Johor,0,0,0,Italy
16045,10/1/2020,ITA,Kedah,0,0,0,Italy
16046,10/1/2020,ITA,Kelantan,0,0,0,Italy
16047,10/1/2020,ITA,Melaka,0,0,0,Italy
16048,10/1/2020,ITA,Negeri Sembilan,0,0,0,Italy
16049,10/1/2020,ITA,Pahang,0,0,0,Italy
16050,10/1/2020,ITA,Perak,0,0,0,Italy
16051,10/1/2020,ITA,Perlis,0,0,0,Italy
16052,10/1/2020,ITA,Pulau Pinang,0,0,0,Italy
16053,10/1/2020,ITA,Sabah,0,0,0,Italy
16054,10/1/2020,ITA,Sarawak,0,0,0,Italy
16055,10/1/2020,ITA,Selangor,38,34,4,Italy
16056,10/1/2020,ITA,W.P. Labuan,0,0,0,Italy
16057,10/1/2020,JAM,Johor,0,0,0,Jamaica
16058,10/1/2020,JAM,Kedah,0,0,0,Jamaica
16059,10/1/2020,JAM,Perak,0,0,0,Jamaica
16060,10/1/2020,JAM,Pulau Pinang,0,0,0,Jamaica
16061,10/1/2020,JAM,Sabah,0,0,0,Jamaica
16062,10/1/2020,JAM,Sarawak,0,0,0,Jamaica
16063,10/1/2020,JAM,Selangor,0,0,0,Jamaica
16064,10/1/2020,JAM,W.P. Labuan,0,0,0,Jamaica
16065,10/1/2020,JOR,Johor,0,0,0,Jordan
16066,10/1/2020,JOR,Kedah,0,0,0,Jordan
16067,10/1/2020,JOR,Kelantan,0,0,0,Jordan
16068,10/1/2020,JOR,Melaka,0,0,0,Jordan
16069,10/1/2020,JOR,Perlis,0,0,0,Jordan
16070,10/1/2020,JOR,Pulau Pinang,0,0,0,Jordan
16071,10/1/2020,JOR,Sabah,0,0,0,Jordan
16072,10/1/2020,JOR,Sarawak,0,0,0,Jordan
16073,10/1/2020,JOR,Selangor,5,4,1,Jordan
16074,10/1/2020,JOR,W.P. Labuan,0,0,0,Jordan
16075,10/1/2020,JPN,Johor,6,6,0,Japan
16076,10/1/2020,JPN,Kedah,0,0,0,Japan
16077,10/1/2020,JPN,Kelantan,0,0,0,Japan
16078,10/1/2020,JPN,Melaka,0,0,0,Japan
16079,10/1/2020,JPN,Negeri Sembilan,0,0,0,Japan
16080,10/1/2020,JPN,Pahang,0,0,0,Japan
16081,10/1/2020,JPN,Perak,0,0,0,Japan
16082,10/1/2020,JPN,Perlis,0,0,0,Japan
16083,10/1/2020,JPN,Pulau Pinang,3,3,0,Japan
16084,10/1/2020,JPN,Sabah,0,0,0,Japan
16085,10/1/2020,JPN,Sarawak,0,0,0,Japan
16086,10/1/2020,JPN,Selangor,481,323,158,Japan
16087,10/1/2020,JPN,W.P. Labuan,0,0,0,Japan
16088,10/1/2020,KAZ,Johor,0,0,0,Kazakhstan
16089,10/1/2020,KAZ,Kedah,0,0,0,Kazakhstan
16090,10/1/2020,KAZ,Kelantan,0,0,0,Kazakhstan
16091,10/1/2020,KAZ,Melaka,0,0,0,Kazakhstan
16092,10/1/2020,KAZ,Perak,0,0,0,Kazakhstan
16093,10/1/2020,KAZ,Perlis,0,0,0,Kazakhstan
16094,10/1/2020,KAZ,Pulau Pinang,0,0,0,Kazakhstan
16095,10/1/2020,KAZ,Sabah,0,0,0,Kazakhstan
16096,10/1/2020,KAZ,Sarawak,0,0,0,Kazakhstan
16097,10/1/2020,KAZ,Selangor,2,0,2,Kazakhstan
16098,10/1/2020,KAZ,W.P. Labuan,0,0,0,Kazakhstan
16099,10/1/2020,KEN,Johor,0,0,0,Kenya
16100,10/1/2020,KEN,Kedah,0,0,0,Kenya
16101,10/1/2020,KEN,Kelantan,0,0,0,Kenya
16102,10/1/2020,KEN,Perak,0,0,0,Kenya
16103,10/1/2020,KEN,Perlis,0,0,0,Kenya
16104,10/1/2020,KEN,Pulau Pinang,0,0,0,Kenya
16105,10/1/2020,KEN,Sabah,0,0,0,Kenya
16106,10/1/2020,KEN,Sarawak,0,0,0,Kenya
16107,10/1/2020,KEN,Selangor,6,2,4,Kenya
16108,10/1/2020,KGZ,Johor,0,0,0,Kyrgyzstan
16109,10/1/2020,KGZ,Kedah,0,0,0,Kyrgyzstan
16110,10/1/2020,KGZ,Kelantan,0,0,0,Kyrgyzstan
16111,10/1/2020,KGZ,Perak,0,0,0,Kyrgyzstan
16112,10/1/2020,KGZ,Perlis,0,0,0,Kyrgyzstan
16113,10/1/2020,KGZ,Pulau Pinang,0,0,0,Kyrgyzstan
16114,10/1/2020,KGZ,Sabah,0,0,0,Kyrgyzstan
16115,10/1/2020,KGZ,Sarawak,0,0,0,Kyrgyzstan
16116,10/1/2020,KGZ,Selangor,4,3,1,Kyrgyzstan
16117,10/1/2020,KHM,Johor,0,0,0,Cambodia
16118,10/1/2020,KHM,Kedah,0,0,0,Cambodia
16119,10/1/2020,KHM,Kelantan,0,0,0,Cambodia
16120,10/1/2020,KHM,Melaka,0,0,0,Cambodia
16121,10/1/2020,KHM,Negeri Sembilan,0,0,0,Cambodia
16122,10/1/2020,KHM,Pahang,0,0,0,Cambodia
16123,10/1/2020,KHM,Perak,0,0,0,Cambodia
16124,10/1/2020,KHM,Perlis,22,22,0,Cambodia
16125,10/1/2020,KHM,Pulau Pinang,0,0,0,Cambodia
16126,10/1/2020,KHM,Sabah,0,0,0,Cambodia
16127,10/1/2020,KHM,Sarawak,0,0,0,Cambodia
16128,10/1/2020,KHM,Selangor,5,3,2,Cambodia
16129,10/1/2020,KHM,W.P. Labuan,0,0,0,Cambodia
16130,10/1/2020,KIR,Johor,0,0,0,Kiribati
16131,10/1/2020,KIR,Sabah,0,0,0,Kiribati
16132,10/1/2020,KIR,Selangor,12,12,0,Kiribati
16133,10/1/2020,KNA,Johor,0,0,0,Saint Kitts and Nevis
16134,10/1/2020,KNA,Kedah,0,0,0,Saint Kitts and Nevis
16135,10/1/2020,KNA,Perlis,0,0,0,Saint Kitts and Nevis
16136,10/1/2020,KNA,Pulau Pinang,0,0,0,Saint Kitts and Nevis
16137,10/1/2020,KNA,Sabah,0,0,0,Saint Kitts and Nevis
16138,10/1/2020,KNA,Selangor,2,2,0,Saint Kitts and Nevis
16139,10/1/2020,KNA,W.P. Labuan,0,0,0,Saint Kitts and Nevis
16140,10/1/2020,KOR,Johor,4,4,0,"Korea, Republic of (South Korea)"
16141,10/1/2020,KOR,Kedah,0,0,0,"Korea, Republic of (South Korea)"
16142,10/1/2020,KOR,Kelantan,0,0,0,"Korea, Republic of (South Korea)"
16143,10/1/2020,KOR,Melaka,0,0,0,"Korea, Republic of (South Korea)"
16144,10/1/2020,KOR,Negeri Sembilan,0,0,0,"Korea, Republic of (South Korea)"
16145,10/1/2020,KOR,Pahang,0,0,0,"Korea, Republic of (South Korea)"
16146,10/1/2020,KOR,Perak,0,0,0,"Korea, Republic of (South Korea)"
16147,10/1/2020,KOR,Perlis,0,0,0,"Korea, Republic of (South Korea)"
16148,10/1/2020,KOR,Pulau Pinang,1,1,0,"Korea, Republic of (South Korea)"
16149,10/1/2020,KOR,Sabah,0,0,0,"Korea, Republic of (South Korea)"
16150,10/1/2020,KOR,Sarawak,1,1,0,"Korea, Republic of (South Korea)"
16151,10/1/2020,KOR,Selangor,305,173,132,"Korea, Republic of (South Korea)"
16152,10/1/2020,KOR,Terengganu,0,0,0,"Korea, Republic of (South Korea)"
16153,10/1/2020,KOR,W.P. Labuan,0,0,0,"Korea, Republic of (South Korea)"
16154,10/1/2020,KWT,Johor,0,0,0,Kuwait
16155,10/1/2020,KWT,Kedah,0,0,0,Kuwait
16156,10/1/2020,KWT,Kelantan,0,0,0,Kuwait
16157,10/1/2020,KWT,Perak,0,0,0,Kuwait
16158,10/1/2020,KWT,Perlis,0,0,0,Kuwait
16159,10/1/2020,KWT,Pulau Pinang,0,0,0,Kuwait
16160,10/1/2020,KWT,Sabah,0,0,0,Kuwait
16161,10/1/2020,KWT,Sarawak,0,0,0,Kuwait
16162,10/1/2020,KWT,Selangor,3,3,0,Kuwait
16163,10/1/2020,KWT,W.P. Labuan,0,0,0,Kuwait
16164,10/1/2020,LAO,Johor,0,0,0,Lao People's Democratic Republic
16165,10/1/2020,LAO,Kedah,0,0,0,Lao People's Democratic Republic
16166,10/1/2020,LAO,Kelantan,0,0,0,Lao People's Democratic Republic
16167,10/1/2020,LAO,Melaka,0,0,0,Lao People's Democratic Republic
16168,10/1/2020,LAO,Perak,0,0,0,Lao People's Democratic Republic
16169,10/1/2020,LAO,Perlis,0,0,0,Lao People's Democratic Republic
16170,10/1/2020,LAO,Pulau Pinang,0,0,0,Lao People's Democratic Republic
16171,10/1/2020,LAO,Sabah,0,0,0,Lao People's Democratic Republic
16172,10/1/2020,LAO,Sarawak,0,0,0,Lao People's Democratic Republic
16173,10/1/2020,LAO,Selangor,3,3,0,Lao People's Democratic Republic
16174,10/1/2020,LAO,W.P. Labuan,0,0,0,Lao People's Democratic Republic
16175,10/1/2020,LBN,Johor,0,0,0,Lebanon
16176,10/1/2020,LBN,Kedah,0,0,0,Lebanon
16177,10/1/2020,LBN,Kelantan,0,0,0,Lebanon
16178,10/1/2020,LBN,Pahang,0,0,0,Lebanon
16179,10/1/2020,LBN,Perak,0,0,0,Lebanon
16180,10/1/2020,LBN,Perlis,0,0,0,Lebanon
16181,10/1/2020,LBN,Pulau Pinang,0,0,0,Lebanon
16182,10/1/2020,LBN,Sabah,0,0,0,Lebanon
16183,10/1/2020,LBN,Sarawak,0,0,0,Lebanon
16184,10/1/2020,LBN,Selangor,3,1,2,Lebanon
16185,10/1/2020,LBN,W.P. Labuan,0,0,0,Lebanon
16186,10/1/2020,LBR,Johor,0,0,0,Liberia
16187,10/1/2020,LBR,Kedah,0,0,0,Liberia
16188,10/1/2020,LBR,Sabah,0,0,0,Liberia
16189,10/1/2020,LBR,Sarawak,0,0,0,Liberia
16190,10/1/2020,LBR,Selangor,0,0,0,Liberia
16191,10/1/2020,LBY,Johor,2,2,0,Libyan Arab Jamahiriya
16192,10/1/2020,LBY,Kedah,0,0,0,Libyan Arab Jamahiriya
16193,10/1/2020,LBY,Perlis,0,0,0,Libyan Arab Jamahiriya
16194,10/1/2020,LBY,Pulau Pinang,0,0,0,Libyan Arab Jamahiriya
16195,10/1/2020,LBY,Sabah,0,0,0,Libyan Arab Jamahiriya
16196,10/1/2020,LBY,Sarawak,0,0,0,Libyan Arab Jamahiriya
16197,10/1/2020,LBY,Selangor,3,3,0,Libyan Arab Jamahiriya
16198,10/1/2020,LCA,Johor,0,0,0,Saint Lucia
16199,10/1/2020,LCA,Kedah,0,0,0,Saint Lucia
16200,10/1/2020,LCA,Pulau Pinang,0,0,0,Saint Lucia
16201,10/1/2020,LCA,Sarawak,0,0,0,Saint Lucia
16202,10/1/2020,LCA,Selangor,1,1,0,Saint Lucia
16203,10/1/2020,LIE,Johor,0,0,0,Liechtenstein
16204,10/1/2020,LIE,Kedah,0,0,0,Liechtenstein
16205,10/1/2020,LIE,Perlis,0,0,0,Liechtenstein
16206,10/1/2020,LIE,Pulau Pinang,0,0,0,Liechtenstein
16207,10/1/2020,LIE,Sabah,0,0,0,Liechtenstein
16208,10/1/2020,LIE,Sarawak,0,0,0,Liechtenstein
16209,10/1/2020,LIE,Selangor,0,0,0,Liechtenstein
16210,10/1/2020,LKA,Johor,2,2,0,Sri Lanka
16211,10/1/2020,LKA,Kedah,0,0,0,Sri Lanka
16212,10/1/2020,LKA,Kelantan,0,0,0,Sri Lanka
16213,10/1/2020,LKA,Melaka,0,0,0,Sri Lanka
16214,10/1/2020,LKA,Pahang,0,0,0,Sri Lanka
16215,10/1/2020,LKA,Perak,0,0,0,Sri Lanka
16216,10/1/2020,LKA,Perlis,0,0,0,Sri Lanka
16217,10/1/2020,LKA,Pulau Pinang,0,0,0,Sri Lanka
16218,10/1/2020,LKA,Sabah,0,0,0,Sri Lanka
16219,10/1/2020,LKA,Sarawak,0,0,0,Sri Lanka
16220,10/1/2020,LKA,Selangor,23,19,4,Sri Lanka
16221,10/1/2020,LKA,W.P. Labuan,0,0,0,Sri Lanka
16222,10/1/2020,LSO,Johor,0,0,0,Lesotho
16223,10/1/2020,LSO,Kedah,0,0,0,Lesotho
16224,10/1/2020,LSO,Pulau Pinang,0,0,0,Lesotho
16225,10/1/2020,LSO,Sarawak,0,0,0,Lesotho
16226,10/1/2020,LSO,Selangor,0,0,0,Lesotho
16227,10/1/2020,LTU,Johor,0,0,0,Lithuania
16228,10/1/2020,LTU,Kedah,0,0,0,Lithuania
16229,10/1/2020,LTU,Kelantan,0,0,0,Lithuania
16230,10/1/2020,LTU,Pahang,0,0,0,Lithuania
16231,10/1/2020,LTU,Perak,0,0,0,Lithuania
16232,10/1/2020,LTU,Perlis,0,0,0,Lithuania
16233,10/1/2020,LTU,Pulau Pinang,0,0,0,Lithuania
16234,10/1/2020,LTU,Sabah,0,0,0,Lithuania
16235,10/1/2020,LTU,Sarawak,0,0,0,Lithuania
16236,10/1/2020,LTU,Selangor,7,4,3,Lithuania
16237,10/1/2020,LTU,W.P. Labuan,0,0,0,Lithuania
16238,10/1/2020,LUX,Johor,0,0,0,Luxembourg
16239,10/1/2020,LUX,Kedah,0,0,0,Luxembourg
16240,10/1/2020,LUX,Kelantan,0,0,0,Luxembourg
16241,10/1/2020,LUX,Perak,0,0,0,Luxembourg
16242,10/1/2020,LUX,Perlis,0,0,0,Luxembourg
16243,10/1/2020,LUX,Pulau Pinang,0,0,0,Luxembourg
16244,10/1/2020,LUX,Sabah,0,0,0,Luxembourg
16245,10/1/2020,LUX,Sarawak,0,0,0,Luxembourg
16246,10/1/2020,LUX,Selangor,2,2,0,Luxembourg
16247,10/1/2020,LVA,Johor,0,0,0,Latvia
16248,10/1/2020,LVA,Kedah,0,0,0,Latvia
16249,10/1/2020,LVA,Kelantan,0,0,0,Latvia
16250,10/1/2020,LVA,Pahang,0,0,0,Latvia
16251,10/1/2020,LVA,Perak,0,0,0,Latvia
16252,10/1/2020,LVA,Perlis,0,0,0,Latvia
16253,10/1/2020,LVA,Pulau Pinang,0,0,0,Latvia
16254,10/1/2020,LVA,Sabah,0,0,0,Latvia
16255,10/1/2020,LVA,Sarawak,0,0,0,Latvia
16256,10/1/2020,LVA,Selangor,4,3,1,Latvia
16257,10/1/2020,LVA,W.P. Labuan,0,0,0,Latvia
16258,10/1/2020,MAC,Johor,0,0,0,Macao
16259,10/1/2020,MAC,Pahang,0,0,0,Macao
16260,10/1/2020,MAC,Perak,0,0,0,Macao
16261,10/1/2020,MAC,Selangor,0,0,0,Macao
16262,10/1/2020,MAC,W.P. Labuan,0,0,0,Macao
16263,10/1/2020,MAR,Johor,0,0,0,Morocco
16264,10/1/2020,MAR,Kedah,0,0,0,Morocco
16265,10/1/2020,MAR,Kelantan,0,0,0,Morocco
16266,10/1/2020,MAR,Melaka,0,0,0,Morocco
16267,10/1/2020,MAR,Pahang,0,0,0,Morocco
16268,10/1/2020,MAR,Perak,0,0,0,Morocco
16269,10/1/2020,MAR,Perlis,0,0,0,Morocco
16270,10/1/2020,MAR,Pulau Pinang,0,0,0,Morocco
16271,10/1/2020,MAR,Sabah,0,0,0,Morocco
16272,10/1/2020,MAR,Sarawak,0,0,0,Morocco
16273,10/1/2020,MAR,Selangor,10,7,3,Morocco
16274,10/1/2020,MAR,W.P. Labuan,0,0,0,Morocco
16275,10/1/2020,MCO,Johor,0,0,0,Monaco
16276,10/1/2020,MCO,Kedah,0,0,0,Monaco
16277,10/1/2020,MCO,Sabah,0,0,0,Monaco
16278,10/1/2020,MCO,Selangor,0,0,0,Monaco
16279,10/1/2020,MDA,Johor,0,0,0,"Moldova, Republic of"
16280,10/1/2020,MDA,Kedah,0,0,0,"Moldova, Republic of"
16281,10/1/2020,MDA,Kelantan,0,0,0,"Moldova, Republic of"
16282,10/1/2020,MDA,Negeri Sembilan,0,0,0,"Moldova, Republic of"
16283,10/1/2020,MDA,Perlis,0,0,0,"Moldova, Republic of"
16284,10/1/2020,MDA,Pulau Pinang,0,0,0,"Moldova, Republic of"
16285,10/1/2020,MDA,Sabah,0,0,0,"Moldova, Republic of"
16286,10/1/2020,MDA,Sarawak,0,0,0,"Moldova, Republic of"
16287,10/1/2020,MDA,Selangor,0,0,0,"Moldova, Republic of"
16288,10/1/2020,MDG,Johor,0,0,0,Madagascar
16289,10/1/2020,MDG,Kedah,0,0,0,Madagascar
16290,10/1/2020,MDG,Perak,0,0,0,Madagascar
16291,10/1/2020,MDG,Perlis,0,0,0,Madagascar
16292,10/1/2020,MDG,Pulau Pinang,0,0,0,Madagascar
16293,10/1/2020,MDG,Sabah,0,0,0,Madagascar
16294,10/1/2020,MDG,Sarawak,0,0,0,Madagascar
16295,10/1/2020,MDG,Selangor,0,0,0,Madagascar
16296,10/1/2020,MDV,Johor,0,0,0,Maldives
16297,10/1/2020,MDV,Kedah,0,0,0,Maldives
16298,10/1/2020,MDV,Kelantan,0,0,0,Maldives
16299,10/1/2020,MDV,Perak,0,0,0,Maldives
16300,10/1/2020,MDV,Perlis,0,0,0,Maldives
16301,10/1/2020,MDV,Pulau Pinang,0,0,0,Maldives
16302,10/1/2020,MDV,Sabah,0,0,0,Maldives
16303,10/1/2020,MDV,Sarawak,0,0,0,Maldives
16304,10/1/2020,MDV,Selangor,83,30,53,Maldives
16305,10/1/2020,MEX,Johor,2,2,0,Mexico
16306,10/1/2020,MEX,Kedah,0,0,0,Mexico
16307,10/1/2020,MEX,Kelantan,0,0,0,Mexico
16308,10/1/2020,MEX,Pahang,0,0,0,Mexico
16309,10/1/2020,MEX,Perak,0,0,0,Mexico
16310,10/1/2020,MEX,Perlis,0,0,0,Mexico
16311,10/1/2020,MEX,Pulau Pinang,0,0,0,Mexico
16312,10/1/2020,MEX,Sabah,0,0,0,Mexico
16313,10/1/2020,MEX,Sarawak,0,0,0,Mexico
16314,10/1/2020,MEX,Selangor,12,10,2,Mexico
16315,10/1/2020,MEX,W.P. Labuan,0,0,0,Mexico
16316,10/1/2020,MHL,Johor,0,0,0,Marshall Islands
16317,10/1/2020,MHL,Kedah,0,0,0,Marshall Islands
16318,10/1/2020,MHL,Perak,0,0,0,Marshall Islands
16319,10/1/2020,MHL,Pulau Pinang,0,0,0,Marshall Islands
16320,10/1/2020,MHL,Sabah,0,0,0,Marshall Islands
16321,10/1/2020,MHL,Selangor,0,0,0,Marshall Islands
16322,10/1/2020,MKD,Johor,0,0,0,"Macedonia, the former Yugoslav Republic of"
16323,10/1/2020,MKD,Kedah,0,0,0,"Macedonia, the former Yugoslav Republic of"
16324,10/1/2020,MKD,Perak,0,0,0,"Macedonia, the former Yugoslav Republic of"
16325,10/1/2020,MKD,Pulau Pinang,0,0,0,"Macedonia, the former Yugoslav Republic of"
16326,10/1/2020,MKD,Sabah,0,0,0,"Macedonia, the former Yugoslav Republic of"
16327,10/1/2020,MKD,Sarawak,0,0,0,"Macedonia, the former Yugoslav Republic of"
16328,10/1/2020,MKD,Selangor,4,2,2,"Macedonia, the former Yugoslav Republic of"
16329,10/1/2020,MLI,Johor,0,0,0,Mali
16330,10/1/2020,MLI,Sabah,0,0,0,Mali
16331,10/1/2020,MLI,Selangor,1,1,0,Mali
16332,10/1/2020,MLT,Johor,0,0,0,Malta
16333,10/1/2020,MLT,Kedah,0,0,0,Malta
16334,10/1/2020,MLT,Kelantan,0,0,0,Malta
16335,10/1/2020,MLT,Perak,0,0,0,Malta
16336,10/1/2020,MLT,Perlis,0,0,0,Malta
16337,10/1/2020,MLT,Pulau Pinang,0,0,0,Malta
16338,10/1/2020,MLT,Sabah,0,0,0,Malta
16339,10/1/2020,MLT,Sarawak,0,0,0,Malta
16340,10/1/2020,MLT,Selangor,1,1,0,Malta
16341,10/1/2020,MLT,W.P. Labuan,0,0,0,Malta
16342,10/1/2020,MMR,Johor,14,14,0,Myanmar
16343,10/1/2020,MMR,Kedah,0,0,0,Myanmar
16344,10/1/2020,MMR,Kelantan,0,0,0,Myanmar
16345,10/1/2020,MMR,Negeri Sembilan,0,0,0,Myanmar
16346,10/1/2020,MMR,Pahang,0,0,0,Myanmar
16347,10/1/2020,MMR,Perak,0,0,0,Myanmar
16348,10/1/2020,MMR,Perlis,0,0,0,Myanmar
16349,10/1/2020,MMR,Pulau Pinang,2,1,1,Myanmar
16350,10/1/2020,MMR,Sabah,0,0,0,Myanmar
16351,10/1/2020,MMR,Sarawak,0,0,0,Myanmar
16352,10/1/2020,MMR,Selangor,64,56,8,Myanmar
16353,10/1/2020,MMR,Terengganu,0,0,0,Myanmar
16354,10/1/2020,MMR,W.P. Labuan,0,0,0,Myanmar
16355,10/1/2020,MNE,Johor,0,0,0,Montenegro
16356,10/1/2020,MNE,Kedah,0,0,0,Montenegro
16357,10/1/2020,MNE,Pulau Pinang,0,0,0,Montenegro
16358,10/1/2020,MNE,Sabah,0,0,0,Montenegro
16359,10/1/2020,MNE,Sarawak,0,0,0,Montenegro
16360,10/1/2020,MNE,Selangor,0,0,0,Montenegro
16361,10/1/2020,MNG,Johor,0,0,0,Mongolia
16362,10/1/2020,MNG,Kedah,0,0,0,Mongolia
16363,10/1/2020,MNG,Kelantan,0,0,0,Mongolia
16364,10/1/2020,MNG,Perak,0,0,0,Mongolia
16365,10/1/2020,MNG,Perlis,0,0,0,Mongolia
16366,10/1/2020,MNG,Pulau Pinang,0,0,0,Mongolia
16367,10/1/2020,MNG,Sabah,0,0,0,Mongolia
16368,10/1/2020,MNG,Sarawak,0,0,0,Mongolia
16369,10/1/2020,MNG,Selangor,4,2,2,Mongolia
16370,10/1/2020,MNP,Selangor,0,0,0,Northern Mariana Islands
16371,10/1/2020,MOZ,Johor,0,0,0,Mozambique
16372,10/1/2020,MOZ,Kedah,0,0,0,Mozambique
16373,10/1/2020,MOZ,Perak,0,0,0,Mozambique
16374,10/1/2020,MOZ,Pulau Pinang,0,0,0,Mozambique
16375,10/1/2020,MOZ,Sabah,0,0,0,Mozambique
16376,10/1/2020,MOZ,Sarawak,0,0,0,Mozambique
16377,10/1/2020,MOZ,Selangor,1,0,1,Mozambique
16378,10/1/2020,MRT,Johor,0,0,0,Mauritania
16379,10/1/2020,MRT,Kedah,0,0,0,Mauritania
16380,10/1/2020,MRT,Pulau Pinang,0,0,0,Mauritania
16381,10/1/2020,MRT,Sabah,0,0,0,Mauritania
16382,10/1/2020,MRT,Sarawak,0,0,0,Mauritania
16383,10/1/2020,MRT,Selangor,0,0,0,Mauritania
16384,10/1/2020,MUS,Johor,0,0,0,Mauritius
16385,10/1/2020,MUS,Kedah,0,0,0,Mauritius
16386,10/1/2020,MUS,Kelantan,0,0,0,Mauritius
16387,10/1/2020,MUS,Pahang,0,0,0,Mauritius
16388,10/1/2020,MUS,Perak,0,0,0,Mauritius
16389,10/1/2020,MUS,Perlis,0,0,0,Mauritius
16390,10/1/2020,MUS,Pulau Pinang,0,0,0,Mauritius
16391,10/1/2020,MUS,Sabah,0,0,0,Mauritius
16392,10/1/2020,MUS,Sarawak,0,0,0,Mauritius
16393,10/1/2020,MUS,Selangor,11,5,6,Mauritius
16394,10/1/2020,MWI,Johor,0,0,0,Malawi
16395,10/1/2020,MWI,Pulau Pinang,0,0,0,Malawi
16396,10/1/2020,MWI,Sabah,0,0,0,Malawi
16397,10/1/2020,MWI,Sarawak,0,0,0,Malawi
16398,10/1/2020,MWI,Selangor,0,0,0,Malawi
16399,10/1/2020,MYT,Selangor,0,0,0,Mayotte
16400,10/1/2020,NAM,Johor,0,0,0,Namibia
16401,10/1/2020,NAM,Kedah,0,0,0,Namibia
16402,10/1/2020,NAM,Perak,0,0,0,Namibia
16403,10/1/2020,NAM,Perlis,0,0,0,Namibia
16404,10/1/2020,NAM,Pulau Pinang,0,0,0,Namibia
16405,10/1/2020,NAM,Sabah,0,0,0,Namibia
16406,10/1/2020,NAM,Sarawak,0,0,0,Namibia
16407,10/1/2020,NAM,Selangor,1,1,0,Namibia
16408,10/1/2020,NCL,Selangor,0,0,0,New Caledonia
16409,10/1/2020,NER,Johor,0,0,0,Niger
16410,10/1/2020,NER,Sabah,0,0,0,Niger
16411,10/1/2020,NER,Selangor,0,0,0,Niger
16412,10/1/2020,NGA,Johor,0,0,0,Nigeria
16413,10/1/2020,NGA,Kedah,0,0,0,Nigeria
16414,10/1/2020,NGA,Perlis,0,0,0,Nigeria
16415,10/1/2020,NGA,Pulau Pinang,0,0,0,Nigeria
16416,10/1/2020,NGA,Sabah,0,0,0,Nigeria
16417,10/1/2020,NGA,Sarawak,0,0,0,Nigeria
16418,10/1/2020,NGA,Selangor,24,18,6,Nigeria
16419,10/1/2020,NIC,Johor,0,0,0,Nicaragua
16420,10/1/2020,NIC,Kedah,0,0,0,Nicaragua
16421,10/1/2020,NIC,Pulau Pinang,0,0,0,Nicaragua
16422,10/1/2020,NIC,Sabah,0,0,0,Nicaragua
16423,10/1/2020,NIC,Selangor,2,1,1,Nicaragua
16424,10/1/2020,NLD,Johor,3,3,0,Netherlands
16425,10/1/2020,NLD,Kedah,0,0,0,Netherlands
16426,10/1/2020,NLD,Kelantan,0,0,0,Netherlands
16427,10/1/2020,NLD,Melaka,0,0,0,Netherlands
16428,10/1/2020,NLD,Negeri Sembilan,0,0,0,Netherlands
16429,10/1/2020,NLD,Pahang,0,0,0,Netherlands
16430,10/1/2020,NLD,Perak,0,0,0,Netherlands
16431,10/1/2020,NLD,Perlis,0,0,0,Netherlands
16432,10/1/2020,NLD,Pulau Pinang,0,0,0,Netherlands
16433,10/1/2020,NLD,Sabah,0,0,0,Netherlands
16434,10/1/2020,NLD,Sarawak,0,0,0,Netherlands
16435,10/1/2020,NLD,Selangor,53,42,11,Netherlands
16436,10/1/2020,NLD,Terengganu,0,0,0,Netherlands
16437,10/1/2020,NLD,W.P. Labuan,0,0,0,Netherlands
16438,10/1/2020,NOR,Johor,0,0,0,Norway
16439,10/1/2020,NOR,Kedah,0,0,0,Norway
16440,10/1/2020,NOR,Kelantan,0,0,0,Norway
16441,10/1/2020,NOR,Melaka,0,0,0,Norway
16442,10/1/2020,NOR,Pahang,0,0,0,Norway
16443,10/1/2020,NOR,Perak,0,0,0,Norway
16444,10/1/2020,NOR,Perlis,0,0,0,Norway
16445,10/1/2020,NOR,Pulau Pinang,0,0,0,Norway
16446,10/1/2020,NOR,Sabah,0,0,0,Norway
16447,10/1/2020,NOR,Sarawak,0,0,0,Norway
16448,10/1/2020,NOR,Selangor,8,7,1,Norway
16449,10/1/2020,NOR,W.P. Labuan,0,0,0,Norway
16450,10/1/2020,NPL,Johor,0,0,0,Nepal
16451,10/1/2020,NPL,Kedah,0,0,0,Nepal
16452,10/1/2020,NPL,Pahang,0,0,0,Nepal
16453,10/1/2020,NPL,Perak,0,0,0,Nepal
16454,10/1/2020,NPL,Perlis,0,0,0,Nepal
16455,10/1/2020,NPL,Pulau Pinang,0,0,0,Nepal
16456,10/1/2020,NPL,Sabah,0,0,0,Nepal
16457,10/1/2020,NPL,Sarawak,0,0,0,Nepal
16458,10/1/2020,NPL,Selangor,49,43,6,Nepal
16459,10/1/2020,NPL,W.P. Labuan,0,0,0,Nepal
16460,10/1/2020,NRU,Johor,0,0,0,Nauru
16461,10/1/2020,NRU,Pulau Pinang,0,0,0,Nauru
16462,10/1/2020,NRU,Selangor,0,0,0,Nauru
16463,10/1/2020,NZL,Johor,1,1,0,New Zealand
16464,10/1/2020,NZL,Kedah,0,0,0,New Zealand
16465,10/1/2020,NZL,Kelantan,0,0,0,New Zealand
16466,10/1/2020,NZL,Melaka,0,0,0,New Zealand
16467,10/1/2020,NZL,Negeri Sembilan,0,0,0,New Zealand
16468,10/1/2020,NZL,Pahang,0,0,0,New Zealand
16469,10/1/2020,NZL,Perak,0,0,0,New Zealand
16470,10/1/2020,NZL,Perlis,0,0,0,New Zealand
16471,10/1/2020,NZL,Pulau Pinang,0,0,0,New Zealand
16472,10/1/2020,NZL,Sabah,0,0,0,New Zealand
16473,10/1/2020,NZL,Sarawak,0,0,0,New Zealand
16474,10/1/2020,NZL,Selangor,28,21,7,New Zealand
16475,10/1/2020,NZL,Terengganu,0,0,0,New Zealand
16476,10/1/2020,NZL,W.P. Labuan,0,0,0,New Zealand
16477,10/1/2020,OMN,Johor,0,0,0,Oman
16478,10/1/2020,OMN,Kedah,0,0,0,Oman
16479,10/1/2020,OMN,Kelantan,0,0,0,Oman
16480,10/1/2020,OMN,Melaka,0,0,0,Oman
16481,10/1/2020,OMN,Perak,0,0,0,Oman
16482,10/1/2020,OMN,Perlis,0,0,0,Oman
16483,10/1/2020,OMN,Pulau Pinang,0,0,0,Oman
16484,10/1/2020,OMN,Sabah,0,0,0,Oman
16485,10/1/2020,OMN,Sarawak,0,0,0,Oman
16486,10/1/2020,OMN,Selangor,9,7,2,Oman
16487,10/1/2020,PAK,Johor,2,2,0,Pakistan
16488,10/1/2020,PAK,Kedah,0,0,0,Pakistan
16489,10/1/2020,PAK,Kelantan,0,0,0,Pakistan
16490,10/1/2020,PAK,Melaka,0,0,0,Pakistan
16491,10/1/2020,PAK,Negeri Sembilan,0,0,0,Pakistan
16492,10/1/2020,PAK,Pahang,0,0,0,Pakistan
16493,10/1/2020,PAK,Perak,0,0,0,Pakistan
16494,10/1/2020,PAK,Perlis,0,0,0,Pakistan
16495,10/1/2020,PAK,Pulau Pinang,0,0,0,Pakistan
16496,10/1/2020,PAK,Sabah,0,0,0,Pakistan
16497,10/1/2020,PAK,Sarawak,0,0,0,Pakistan
16498,10/1/2020,PAK,Selangor,76,45,31,Pakistan
16499,10/1/2020,PAK,W.P. Labuan,0,0,0,Pakistan
16500,10/1/2020,PAN,Johor,0,0,0,Panama
16501,10/1/2020,PAN,Kedah,0,0,0,Panama
16502,10/1/2020,PAN,Perak,0,0,0,Panama
16503,10/1/2020,PAN,Perlis,0,0,0,Panama
16504,10/1/2020,PAN,Pulau Pinang,0,0,0,Panama
16505,10/1/2020,PAN,Sabah,0,0,0,Panama
16506,10/1/2020,PAN,Sarawak,0,0,0,Panama
16507,10/1/2020,PAN,Selangor,0,0,0,Panama
16508,10/1/2020,PER,Johor,2,2,0,Peru
16509,10/1/2020,PER,Kedah,0,0,0,Peru
16510,10/1/2020,PER,Kelantan,0,0,0,Peru
16511,10/1/2020,PER,Pahang,0,0,0,Peru
16512,10/1/2020,PER,Perak,0,0,0,Peru
16513,10/1/2020,PER,Perlis,0,0,0,Peru
16514,10/1/2020,PER,Pulau Pinang,0,0,0,Peru
16515,10/1/2020,PER,Sabah,0,0,0,Peru
16516,10/1/2020,PER,Sarawak,0,0,0,Peru
16517,10/1/2020,PER,Selangor,0,0,0,Peru
16518,10/1/2020,PER,W.P. Labuan,0,0,0,Peru
16519,10/1/2020,PHL,Johor,37,36,1,Philippines
16520,10/1/2020,PHL,Kedah,0,0,0,Philippines
16521,10/1/2020,PHL,Kelantan,0,0,0,Philippines
16522,10/1/2020,PHL,Melaka,0,0,0,Philippines
16523,10/1/2020,PHL,Negeri Sembilan,0,0,0,Philippines
16524,10/1/2020,PHL,Pahang,0,0,0,Philippines
16525,10/1/2020,PHL,Perak,0,0,0,Philippines
16526,10/1/2020,PHL,Perlis,0,0,0,Philippines
16527,10/1/2020,PHL,Pulau Pinang,2,2,0,Philippines
16528,10/1/2020,PHL,Sabah,0,0,0,Philippines
16529,10/1/2020,PHL,Sarawak,32,32,0,Philippines
16530,10/1/2020,PHL,Selangor,380,346,34,Philippines
16531,10/1/2020,PHL,Terengganu,0,0,0,Philippines
16532,10/1/2020,PHL,W.P. Labuan,4,4,0,Philippines
16533,10/1/2020,PLW,Johor,0,0,0,Palau
16534,10/1/2020,PLW,Pulau Pinang,0,0,0,Palau
16535,10/1/2020,PLW,Selangor,0,0,0,Palau
16536,10/1/2020,PNG,Johor,0,0,0,Papua New Guinea
16537,10/1/2020,PNG,Kedah,0,0,0,Papua New Guinea
16538,10/1/2020,PNG,Kelantan,0,0,0,Papua New Guinea
16539,10/1/2020,PNG,Perak,0,0,0,Papua New Guinea
16540,10/1/2020,PNG,Pulau Pinang,0,0,0,Papua New Guinea
16541,10/1/2020,PNG,Sabah,0,0,0,Papua New Guinea
16542,10/1/2020,PNG,Sarawak,0,0,0,Papua New Guinea
16543,10/1/2020,PNG,Selangor,0,0,0,Papua New Guinea
16544,10/1/2020,POL,Johor,4,4,0,Poland
16545,10/1/2020,POL,Kedah,0,0,0,Poland
16546,10/1/2020,POL,Kelantan,0,0,0,Poland
16547,10/1/2020,POL,Melaka,0,0,0,Poland
16548,10/1/2020,POL,Negeri Sembilan,0,0,0,Poland
16549,10/1/2020,POL,Pahang,0,0,0,Poland
16550,10/1/2020,POL,Perak,0,0,0,Poland
16551,10/1/2020,POL,Perlis,0,0,0,Poland
16552,10/1/2020,POL,Pulau Pinang,0,0,0,Poland
16553,10/1/2020,POL,Sabah,0,0,0,Poland
16554,10/1/2020,POL,Sarawak,0,0,0,Poland
16555,10/1/2020,POL,Selangor,22,20,2,Poland
16556,10/1/2020,POL,Terengganu,0,0,0,Poland
16557,10/1/2020,POL,W.P. Labuan,0,0,0,Poland
16558,10/1/2020,PRK,Selangor,0,0,0,"Korea, Democratic People's Republic of"
16559,10/1/2020,PRT,Johor,1,1,0,Portugal
16560,10/1/2020,PRT,Kedah,0,0,0,Portugal
16561,10/1/2020,PRT,Kelantan,0,0,0,Portugal
16562,10/1/2020,PRT,Melaka,0,0,0,Portugal
16563,10/1/2020,PRT,Pahang,0,0,0,Portugal
16564,10/1/2020,PRT,Perak,0,0,0,Portugal
16565,10/1/2020,PRT,Perlis,0,0,0,Portugal
16566,10/1/2020,PRT,Pulau Pinang,0,0,0,Portugal
16567,10/1/2020,PRT,Sabah,0,0,0,Portugal
16568,10/1/2020,PRT,Sarawak,0,0,0,Portugal
16569,10/1/2020,PRT,Selangor,15,9,6,Portugal
16570,10/1/2020,PRT,W.P. Labuan,0,0,0,Portugal
16571,10/1/2020,PRY,Johor,0,0,0,Paraguay
16572,10/1/2020,PRY,Kedah,0,0,0,Paraguay
16573,10/1/2020,PRY,Perak,0,0,0,Paraguay
16574,10/1/2020,PRY,Perlis,0,0,0,Paraguay
16575,10/1/2020,PRY,Pulau Pinang,0,0,0,Paraguay
16576,10/1/2020,PRY,Sabah,0,0,0,Paraguay
16577,10/1/2020,PRY,Sarawak,0,0,0,Paraguay
16578,10/1/2020,PRY,Selangor,0,0,0,Paraguay
16579,10/1/2020,PSE,Johor,0,0,0,"Palestinian Territory, Occupied"
16580,10/1/2020,PSE,Kedah,0,0,0,"Palestinian Territory, Occupied"
16581,10/1/2020,PSE,Kelantan,0,0,0,"Palestinian Territory, Occupied"
16582,10/1/2020,PSE,Melaka,0,0,0,"Palestinian Territory, Occupied"
16583,10/1/2020,PSE,Perak,0,0,0,"Palestinian Territory, Occupied"
16584,10/1/2020,PSE,Perlis,0,0,0,"Palestinian Territory, Occupied"
16585,10/1/2020,PSE,Pulau Pinang,0,0,0,"Palestinian Territory, Occupied"
16586,10/1/2020,PSE,Sabah,0,0,0,"Palestinian Territory, Occupied"
16587,10/1/2020,PSE,Sarawak,0,0,0,"Palestinian Territory, Occupied"
16588,10/1/2020,PSE,Selangor,10,8,2,"Palestinian Territory, Occupied"
16589,10/1/2020,QAT,Johor,0,0,0,Qatar
16590,10/1/2020,QAT,Kedah,0,0,0,Qatar
16591,10/1/2020,QAT,Perlis,0,0,0,Qatar
16592,10/1/2020,QAT,Pulau Pinang,0,0,0,Qatar
16593,10/1/2020,QAT,Sabah,0,0,0,Qatar
16594,10/1/2020,QAT,Sarawak,0,0,0,Qatar
16595,10/1/2020,QAT,Selangor,0,0,0,Qatar
16596,10/1/2020,REU,Johor,0,0,0,Reunion
16597,10/1/2020,REU,Sarawak,0,0,0,Reunion
16598,10/1/2020,ROU,Johor,0,0,0,Romania
16599,10/1/2020,ROU,Kedah,0,0,0,Romania
16600,10/1/2020,ROU,Kelantan,0,0,0,Romania
16601,10/1/2020,ROU,Negeri Sembilan,0,0,0,Romania
16602,10/1/2020,ROU,Pahang,0,0,0,Romania
16603,10/1/2020,ROU,Perak,0,0,0,Romania
16604,10/1/2020,ROU,Perlis,0,0,0,Romania
16605,10/1/2020,ROU,Pulau Pinang,0,0,0,Romania
16606,10/1/2020,ROU,Sabah,0,0,0,Romania
16607,10/1/2020,ROU,Sarawak,0,0,0,Romania
16608,10/1/2020,ROU,Selangor,18,14,4,Romania
16609,10/1/2020,ROU,W.P. Labuan,0,0,0,Romania
16610,10/1/2020,RUS,Johor,6,6,0,Russia
16611,10/1/2020,RUS,Kedah,0,0,0,Russia
16612,10/1/2020,RUS,Kelantan,0,0,0,Russia
16613,10/1/2020,RUS,Melaka,0,0,0,Russia
16614,10/1/2020,RUS,Negeri Sembilan,0,0,0,Russia
16615,10/1/2020,RUS,Pahang,0,0,0,Russia
16616,10/1/2020,RUS,Perak,0,0,0,Russia
16617,10/1/2020,RUS,Perlis,0,0,0,Russia
16618,10/1/2020,RUS,Pulau Pinang,0,0,0,Russia
16619,10/1/2020,RUS,Sabah,0,0,0,Russia
16620,10/1/2020,RUS,Sarawak,0,0,0,Russia
16621,10/1/2020,RUS,Selangor,28,19,9,Russia
16622,10/1/2020,RUS,W.P. Labuan,0,0,0,Russia
16623,10/1/2020,RWA,Johor,0,0,0,Rwanda
16624,10/1/2020,RWA,Kedah,0,0,0,Rwanda
16625,10/1/2020,RWA,Pulau Pinang,0,0,0,Rwanda
16626,10/1/2020,RWA,Selangor,0,0,0,Rwanda
16627,10/1/2020,SAU,Johor,0,0,0,Saudi Arabia
16628,10/1/2020,SAU,Kedah,0,0,0,Saudi Arabia
16629,10/1/2020,SAU,Kelantan,0,0,0,Saudi Arabia
16630,10/1/2020,SAU,Melaka,0,0,0,Saudi Arabia
16631,10/1/2020,SAU,Perak,0,0,0,Saudi Arabia
16632,10/1/2020,SAU,Perlis,0,0,0,Saudi Arabia
16633,10/1/2020,SAU,Pulau Pinang,0,0,0,Saudi Arabia
16634,10/1/2020,SAU,Sabah,0,0,0,Saudi Arabia
16635,10/1/2020,SAU,Sarawak,0,0,0,Saudi Arabia
16636,10/1/2020,SAU,Selangor,105,63,42,Saudi Arabia
16637,10/1/2020,SAU,W.P. Labuan,0,0,0,Saudi Arabia
16638,10/1/2020,SDN,Johor,0,0,0,Sudan
16639,10/1/2020,SDN,Kedah,0,0,0,Sudan
16640,10/1/2020,SDN,Kelantan,0,0,0,Sudan
16641,10/1/2020,SDN,Perlis,0,0,0,Sudan
16642,10/1/2020,SDN,Pulau Pinang,0,0,0,Sudan
16643,10/1/2020,SDN,Sabah,0,0,0,Sudan
16644,10/1/2020,SDN,Sarawak,0,0,0,Sudan
16645,10/1/2020,SDN,Selangor,28,21,7,Sudan
16646,10/1/2020,SDN,W.P. Labuan,0,0,0,Sudan
16647,10/1/2020,SEN,Johor,0,0,0,Senegal
16648,10/1/2020,SEN,Kedah,0,0,0,Senegal
16649,10/1/2020,SEN,Kelantan,0,0,0,Senegal
16650,10/1/2020,SEN,Perak,0,0,0,Senegal
16651,10/1/2020,SEN,Perlis,0,0,0,Senegal
16652,10/1/2020,SEN,Pulau Pinang,0,0,0,Senegal
16653,10/1/2020,SEN,Sabah,0,0,0,Senegal
16654,10/1/2020,SEN,Sarawak,0,0,0,Senegal
16655,10/1/2020,SEN,Selangor,1,0,1,Senegal
16656,10/1/2020,SGP,Johor,596,524,72,Singapore
16657,10/1/2020,SGP,Kedah,2,1,1,Singapore
16658,10/1/2020,SGP,Kelantan,0,0,0,Singapore
16659,10/1/2020,SGP,Melaka,0,0,0,Singapore
16660,10/1/2020,SGP,Negeri Sembilan,0,0,0,Singapore
16661,10/1/2020,SGP,Pahang,0,0,0,Singapore
16662,10/1/2020,SGP,Perak,2,1,1,Singapore
16663,10/1/2020,SGP,Perlis,0,0,0,Singapore
16664,10/1/2020,SGP,Pulau Pinang,30,22,8,Singapore
16665,10/1/2020,SGP,Sabah,0,0,0,Singapore
16666,10/1/2020,SGP,Sarawak,5,4,1,Singapore
16667,10/1/2020,SGP,Selangor,226,169,57,Singapore
16668,10/1/2020,SGP,Terengganu,0,0,0,Singapore
16669,10/1/2020,SGP,W.P. Labuan,0,0,0,Singapore
16670,10/1/2020,SGS,Johor,0,0,0,South Georgia and the South Sandwich Islands
16671,10/1/2020,SGS,Sabah,0,0,0,South Georgia and the South Sandwich Islands
16672,10/1/2020,SGS,Selangor,0,0,0,South Georgia and the South Sandwich Islands
16673,10/1/2020,SHN,Sarawak,0,0,0,"Saint Helena, Ascension and Tristan da Cunha"
16674,10/1/2020,SLB,Johor,0,0,0,Solomon Islands
16675,10/1/2020,SLB,Perlis,0,0,0,Solomon Islands
16676,10/1/2020,SLB,Pulau Pinang,0,0,0,Solomon Islands
16677,10/1/2020,SLB,Sabah,0,0,0,Solomon Islands
16678,10/1/2020,SLB,Sarawak,0,0,0,Solomon Islands
16679,10/1/2020,SLB,Selangor,0,0,0,Solomon Islands
16680,10/1/2020,SLB,W.P. Labuan,0,0,0,Solomon Islands
16681,10/1/2020,SLE,Johor,0,0,0,Sierra Leone
16682,10/1/2020,SLE,Kedah,0,0,0,Sierra Leone
16683,10/1/2020,SLE,Perak,0,0,0,Sierra Leone
16684,10/1/2020,SLE,Pulau Pinang,0,0,0,Sierra Leone
16685,10/1/2020,SLE,Sabah,0,0,0,Sierra Leone
16686,10/1/2020,SLE,Selangor,0,0,0,Sierra Leone
16687,10/1/2020,SLV,Johor,0,0,0,El Salvador
16688,10/1/2020,SLV,Kedah,0,0,0,El Salvador
16689,10/1/2020,SLV,Perak,0,0,0,El Salvador
16690,10/1/2020,SLV,Perlis,0,0,0,El Salvador
16691,10/1/2020,SLV,Pulau Pinang,0,0,0,El Salvador
16692,10/1/2020,SLV,Sabah,0,0,0,El Salvador
16693,10/1/2020,SLV,Selangor,0,0,0,El Salvador
16694,10/1/2020,SLV,W.P. Labuan,0,0,0,El Salvador
16695,10/1/2020,SMR,Johor,0,0,0,San Marino
16696,10/1/2020,SMR,Selangor,0,0,0,San Marino
16697,10/1/2020,SOM,Johor,0,0,0,Somalia
16698,10/1/2020,SOM,Kedah,0,0,0,Somalia
16699,10/1/2020,SOM,Kelantan,0,0,0,Somalia
16700,10/1/2020,SOM,Perlis,0,0,0,Somalia
16701,10/1/2020,SOM,Sabah,0,0,0,Somalia
16702,10/1/2020,SOM,Sarawak,0,0,0,Somalia
16703,10/1/2020,SOM,Selangor,2,2,0,Somalia
16704,10/1/2020,SRB,Johor,2,2,0,Serbia
16705,10/1/2020,SRB,Kedah,0,0,0,Serbia
16706,10/1/2020,SRB,Kelantan,0,0,0,Serbia
16707,10/1/2020,SRB,Pahang,0,0,0,Serbia
16708,10/1/2020,SRB,Perak,0,0,0,Serbia
16709,10/1/2020,SRB,Perlis,0,0,0,Serbia
16710,10/1/2020,SRB,Pulau Pinang,0,0,0,Serbia
16711,10/1/2020,SRB,Sabah,0,0,0,Serbia
16712,10/1/2020,SRB,Sarawak,0,0,0,Serbia
16713,10/1/2020,SRB,Selangor,4,1,3,Serbia
16714,10/1/2020,STP,Selangor,0,0,0,Sao Tome and Principe
16715,10/1/2020,SUR,Johor,0,0,0,Suriname
16716,10/1/2020,SUR,Kedah,0,0,0,Suriname
16717,10/1/2020,SUR,Kelantan,0,0,0,Suriname
16718,10/1/2020,SUR,Perak,0,0,0,Suriname
16719,10/1/2020,SUR,Perlis,0,0,0,Suriname
16720,10/1/2020,SUR,Pulau Pinang,0,0,0,Suriname
16721,10/1/2020,SUR,Sabah,0,0,0,Suriname
16722,10/1/2020,SUR,Sarawak,0,0,0,Suriname
16723,10/1/2020,SUR,Selangor,0,0,0,Suriname
16724,10/1/2020,SVK,Johor,0,0,0,Slovakia
16725,10/1/2020,SVK,Kedah,0,0,0,Slovakia
16726,10/1/2020,SVK,Kelantan,0,0,0,Slovakia
16727,10/1/2020,SVK,Negeri Sembilan,0,0,0,Slovakia
16728,10/1/2020,SVK,Pahang,0,0,0,Slovakia
16729,10/1/2020,SVK,Perak,0,0,0,Slovakia
16730,10/1/2020,SVK,Perlis,0,0,0,Slovakia
16731,10/1/2020,SVK,Pulau Pinang,0,0,0,Slovakia
16732,10/1/2020,SVK,Sabah,0,0,0,Slovakia
16733,10/1/2020,SVK,Sarawak,0,0,0,Slovakia
16734,10/1/2020,SVK,Selangor,17,15,2,Slovakia
16735,10/1/2020,SVK,W.P. Labuan,0,0,0,Slovakia
16736,10/1/2020,SVN,Johor,0,0,0,Slovenia
16737,10/1/2020,SVN,Kedah,0,0,0,Slovenia
16738,10/1/2020,SVN,Kelantan,0,0,0,Slovenia
16739,10/1/2020,SVN,Perak,0,0,0,Slovenia
16740,10/1/2020,SVN,Perlis,0,0,0,Slovenia
16741,10/1/2020,SVN,Pulau Pinang,0,0,0,Slovenia
16742,10/1/2020,SVN,Sabah,0,0,0,Slovenia
16743,10/1/2020,SVN,Sarawak,0,0,0,Slovenia
16744,10/1/2020,SVN,Selangor,0,0,0,Slovenia
16745,10/1/2020,SVN,W.P. Labuan,0,0,0,Slovenia
16746,10/1/2020,SWE,Johor,1,1,0,Sweden
16747,10/1/2020,SWE,Kedah,0,0,0,Sweden
16748,10/1/2020,SWE,Kelantan,0,0,0,Sweden
16749,10/1/2020,SWE,Melaka,0,0,0,Sweden
16750,10/1/2020,SWE,Negeri Sembilan,0,0,0,Sweden
16751,10/1/2020,SWE,Pahang,0,0,0,Sweden
16752,10/1/2020,SWE,Perak,0,0,0,Sweden
16753,10/1/2020,SWE,Perlis,0,0,0,Sweden
16754,10/1/2020,SWE,Pulau Pinang,0,0,0,Sweden
16755,10/1/2020,SWE,Sabah,0,0,0,Sweden
16756,10/1/2020,SWE,Sarawak,0,0,0,Sweden
16757,10/1/2020,SWE,Selangor,21,15,6,Sweden
16758,10/1/2020,SWE,W.P. Labuan,0,0,0,Sweden
16759,10/1/2020,SWZ,Johor,0,0,0,Swaziland
16760,10/1/2020,SWZ,Kedah,0,0,0,Swaziland
16761,10/1/2020,SWZ,Pulau Pinang,0,0,0,Swaziland
16762,10/1/2020,SWZ,Sabah,0,0,0,Swaziland
16763,10/1/2020,SWZ,Selangor,0,0,0,Swaziland
16764,10/1/2020,SYC,Johor,0,0,0,Seychelles
16765,10/1/2020,SYC,Kedah,0,0,0,Seychelles
16766,10/1/2020,SYC,Pulau Pinang,0,0,0,Seychelles
16767,10/1/2020,SYC,Sabah,0,0,0,Seychelles
16768,10/1/2020,SYC,Sarawak,0,0,0,Seychelles
16769,10/1/2020,SYC,Selangor,3,2,1,Seychelles
16770,10/1/2020,SYR,Johor,0,0,0,Syrian Arab Republic
16771,10/1/2020,SYR,Kedah,0,0,0,Syrian Arab Republic
16772,10/1/2020,SYR,Kelantan,0,0,0,Syrian Arab Republic
16773,10/1/2020,SYR,Pahang,0,0,0,Syrian Arab Republic
16774,10/1/2020,SYR,Perlis,0,0,0,Syrian Arab Republic
16775,10/1/2020,SYR,Pulau Pinang,0,0,0,Syrian Arab Republic
16776,10/1/2020,SYR,Sabah,0,0,0,Syrian Arab Republic
16777,10/1/2020,SYR,Sarawak,0,0,0,Syrian Arab Republic
16778,10/1/2020,SYR,Selangor,29,27,2,Syrian Arab Republic
16779,10/1/2020,SYR,W.P. Labuan,0,0,0,Syrian Arab Republic
16780,10/1/2020,TCA,Perlis,0,0,0,Turks and Caicos
16781,10/1/2020,TCD,Johor,0,0,0,Chad
16782,10/1/2020,TCD,Kedah,0,0,0,Chad
16783,10/1/2020,TCD,Perlis,0,0,0,Chad
16784,10/1/2020,TCD,Selangor,0,0,0,Chad
16785,10/1/2020,TGO,Johor,0,0,0,Togo
16786,10/1/2020,TGO,Perak,0,0,0,Togo
16787,10/1/2020,TGO,Pulau Pinang,0,0,0,Togo
16788,10/1/2020,TGO,Selangor,1,0,1,Togo
16789,10/1/2020,THA,Johor,106,105,1,Thailand
16790,10/1/2020,THA,Kedah,9601,8863,738,Thailand
16791,10/1/2020,THA,Kelantan,1,0,1,Thailand
16792,10/1/2020,THA,Melaka,0,0,0,Thailand
16793,10/1/2020,THA,Negeri Sembilan,0,0,0,Thailand
16794,10/1/2020,THA,Pahang,0,0,0,Thailand
16795,10/1/2020,THA,Perak,1,0,1,Thailand
16796,10/1/2020,THA,Perlis,5460,5248,212,Thailand
16797,10/1/2020,THA,Pulau Pinang,0,0,0,Thailand
16798,10/1/2020,THA,Sabah,0,0,0,Thailand
16799,10/1/2020,THA,Sarawak,17,16,1,Thailand
16800,10/1/2020,THA,Selangor,139,69,70,Thailand
16801,10/1/2020,THA,Terengganu,0,0,0,Thailand
16802,10/1/2020,THA,W.P. Labuan,0,0,0,Thailand
16803,10/1/2020,TJK,Johor,0,0,0,Tajikistan
16804,10/1/2020,TJK,Kedah,0,0,0,Tajikistan
16805,10/1/2020,TJK,Perlis,0,0,0,Tajikistan
16806,10/1/2020,TJK,Pulau Pinang,0,0,0,Tajikistan
16807,10/1/2020,TJK,Sabah,0,0,0,Tajikistan
16808,10/1/2020,TJK,Selangor,1,0,1,Tajikistan
16809,10/1/2020,TKL,Selangor,0,0,0,Tokelau
16810,10/1/2020,TKM,Johor,0,0,0,Turkmenistan
16811,10/1/2020,TKM,Kedah,0,0,0,Turkmenistan
16812,10/1/2020,TKM,Kelantan,0,0,0,Turkmenistan
16813,10/1/2020,TKM,Perlis,0,0,0,Turkmenistan
16814,10/1/2020,TKM,Pulau Pinang,0,0,0,Turkmenistan
16815,10/1/2020,TKM,Sabah,0,0,0,Turkmenistan
16816,10/1/2020,TKM,Sarawak,0,0,0,Turkmenistan
16817,10/1/2020,TKM,Selangor,0,0,0,Turkmenistan
16818,10/1/2020,TLS,Johor,0,0,0,Timor-Leste
16819,10/1/2020,TLS,Kedah,0,0,0,Timor-Leste
16820,10/1/2020,TLS,Perlis,0,0,0,Timor-Leste
16821,10/1/2020,TLS,Pulau Pinang,0,0,0,Timor-Leste
16822,10/1/2020,TLS,Sabah,0,0,0,Timor-Leste
16823,10/1/2020,TLS,Sarawak,0,0,0,Timor-Leste
16824,10/1/2020,TLS,Selangor,0,0,0,Timor-Leste
16825,10/1/2020,TON,Johor,0,0,0,Tonga
16826,10/1/2020,TON,Pulau Pinang,0,0,0,Tonga
16827,10/1/2020,TON,Sarawak,0,0,0,Tonga
16828,10/1/2020,TON,Selangor,0,0,0,Tonga
16829,10/1/2020,TTO,Johor,0,0,0,Trinidad and Tobago
16830,10/1/2020,TTO,Kedah,0,0,0,Trinidad and Tobago
16831,10/1/2020,TTO,Pahang,0,0,0,Trinidad and Tobago
16832,10/1/2020,TTO,Pulau Pinang,0,0,0,Trinidad and Tobago
16833,10/1/2020,TTO,Sabah,0,0,0,Trinidad and Tobago
16834,10/1/2020,TTO,Sarawak,0,0,0,Trinidad and Tobago
16835,10/1/2020,TTO,Selangor,0,0,0,Trinidad and Tobago
16836,10/1/2020,TUN,Johor,0,0,0,Tunisia
16837,10/1/2020,TUN,Kedah,0,0,0,Tunisia
16838,10/1/2020,TUN,Kelantan,0,0,0,Tunisia
16839,10/1/2020,TUN,Melaka,0,0,0,Tunisia
16840,10/1/2020,TUN,Perak,0,0,0,Tunisia
16841,10/1/2020,TUN,Perlis,0,0,0,Tunisia
16842,10/1/2020,TUN,Pulau Pinang,0,0,0,Tunisia
16843,10/1/2020,TUN,Sabah,0,0,0,Tunisia
16844,10/1/2020,TUN,Sarawak,0,0,0,Tunisia
16845,10/1/2020,TUN,Selangor,7,3,4,Tunisia
16846,10/1/2020,TUN,W.P. Labuan,0,0,0,Tunisia
16847,10/1/2020,TUR,Johor,0,0,0,Turkey
16848,10/1/2020,TUR,Kedah,0,0,0,Turkey
16849,10/1/2020,TUR,Kelantan,0,0,0,Turkey
16850,10/1/2020,TUR,Melaka,0,0,0,Turkey
16851,10/1/2020,TUR,Negeri Sembilan,0,0,0,Turkey
16852,10/1/2020,TUR,Pahang,0,0,0,Turkey
16853,10/1/2020,TUR,Perak,0,0,0,Turkey
16854,10/1/2020,TUR,Perlis,0,0,0,Turkey
16855,10/1/2020,TUR,Pulau Pinang,0,0,0,Turkey
16856,10/1/2020,TUR,Sabah,0,0,0,Turkey
16857,10/1/2020,TUR,Sarawak,0,0,0,Turkey
16858,10/1/2020,TUR,Selangor,20,18,2,Turkey
16859,10/1/2020,TUR,W.P. Labuan,0,0,0,Turkey
16860,10/1/2020,TUV,Selangor,0,0,0,Tuvalu
16861,10/1/2020,TWN,Johor,9,6,3,Taiwan
16862,10/1/2020,TWN,Kedah,0,0,0,Taiwan
16863,10/1/2020,TWN,Kelantan,0,0,0,Taiwan
16864,10/1/2020,TWN,Melaka,0,0,0,Taiwan
16865,10/1/2020,TWN,Negeri Sembilan,0,0,0,Taiwan
16866,10/1/2020,TWN,Pahang,0,0,0,Taiwan
16867,10/1/2020,TWN,Perak,0,0,0,Taiwan
16868,10/1/2020,TWN,Perlis,0,0,0,Taiwan
16869,10/1/2020,TWN,Pulau Pinang,7,3,4,Taiwan
16870,10/1/2020,TWN,Sabah,0,0,0,Taiwan
16871,10/1/2020,TWN,Sarawak,3,3,0,Taiwan
16872,10/1/2020,TWN,Selangor,123,87,36,Taiwan
16873,10/1/2020,TWN,W.P. Labuan,0,0,0,Taiwan
16874,10/1/2020,TZA,Johor,0,0,0,"Tanzania, United Republic of"
16875,10/1/2020,TZA,Kedah,0,0,0,"Tanzania, United Republic of"
16876,10/1/2020,TZA,Perak,0,0,0,"Tanzania, United Republic of"
16877,10/1/2020,TZA,Perlis,0,0,0,"Tanzania, United Republic of"
16878,10/1/2020,TZA,Pulau Pinang,0,0,0,"Tanzania, United Republic of"
16879,10/1/2020,TZA,Sabah,0,0,0,"Tanzania, United Republic of"
16880,10/1/2020,TZA,Sarawak,0,0,0,"Tanzania, United Republic of"
16881,10/1/2020,TZA,Selangor,2,1,1,"Tanzania, United Republic of"
16882,10/1/2020,UGA,Johor,0,0,0,Uganda
16883,10/1/2020,UGA,Kedah,0,0,0,Uganda
16884,10/1/2020,UGA,Perak,0,0,0,Uganda
16885,10/1/2020,UGA,Perlis,0,0,0,Uganda
16886,10/1/2020,UGA,Pulau Pinang,0,0,0,Uganda
16887,10/1/2020,UGA,Sabah,0,0,0,Uganda
16888,10/1/2020,UGA,Sarawak,0,0,0,Uganda
16889,10/1/2020,UGA,Selangor,0,0,0,Uganda
16890,10/1/2020,UKR,Johor,4,4,0,Ukraine
16891,10/1/2020,UKR,Kedah,0,0,0,Ukraine
16892,10/1/2020,UKR,Kelantan,0,0,0,Ukraine
16893,10/1/2020,UKR,Melaka,0,0,0,Ukraine
16894,10/1/2020,UKR,Negeri Sembilan,0,0,0,Ukraine
16895,10/1/2020,UKR,Pahang,0,0,0,Ukraine
16896,10/1/2020,UKR,Perak,0,0,0,Ukraine
16897,10/1/2020,UKR,Perlis,0,0,0,Ukraine
16898,10/1/2020,UKR,Pulau Pinang,0,0,0,Ukraine
16899,10/1/2020,UKR,Sabah,0,0,0,Ukraine
16900,10/1/2020,UKR,Sarawak,0,0,0,Ukraine
16901,10/1/2020,UKR,Selangor,63,60,3,Ukraine
16902,10/1/2020,UKR,W.P. Labuan,0,0,0,Ukraine
16903,10/1/2020,URY,Johor,0,0,0,Uruguay
16904,10/1/2020,URY,Kedah,0,0,0,Uruguay
16905,10/1/2020,URY,Kelantan,0,0,0,Uruguay
16906,10/1/2020,URY,Perak,0,0,0,Uruguay
16907,10/1/2020,URY,Perlis,0,0,0,Uruguay
16908,10/1/2020,URY,Pulau Pinang,0,0,0,Uruguay
16909,10/1/2020,URY,Sabah,0,0,0,Uruguay
16910,10/1/2020,URY,Sarawak,0,0,0,Uruguay
16911,10/1/2020,URY,Selangor,0,0,0,Uruguay
16912,10/1/2020,URY,W.P. Labuan,0,0,0,Uruguay
16913,10/1/2020,USA,Johor,3,3,0,United States Of America
16914,10/1/2020,USA,Kedah,0,0,0,United States Of America
16915,10/1/2020,USA,Kelantan,0,0,0,United States Of America
16916,10/1/2020,USA,Melaka,0,0,0,United States Of America
16917,10/1/2020,USA,Negeri Sembilan,0,0,0,United States Of America
16918,10/1/2020,USA,Pahang,0,0,0,United States Of America
16919,10/1/2020,USA,Perak,1,0,1,United States Of America
16920,10/1/2020,USA,Perlis,0,0,0,United States Of America
16921,10/1/2020,USA,Pulau Pinang,1,0,1,United States Of America
16922,10/1/2020,USA,Sabah,0,0,0,United States Of America
16923,10/1/2020,USA,Sarawak,0,0,0,United States Of America
16924,10/1/2020,USA,Selangor,106,82,24,United States Of America
16925,10/1/2020,USA,Terengganu,0,0,0,United States Of America
16926,10/1/2020,USA,W.P. Labuan,0,0,0,United States Of America
16927,10/1/2020,UZB,Johor,0,0,0,Uzbekistan
16928,10/1/2020,UZB,Kedah,0,0,0,Uzbekistan
16929,10/1/2020,UZB,Kelantan,0,0,0,Uzbekistan
16930,10/1/2020,UZB,Perak,0,0,0,Uzbekistan
16931,10/1/2020,UZB,Perlis,0,0,0,Uzbekistan
16932,10/1/2020,UZB,Pulau Pinang,0,0,0,Uzbekistan
16933,10/1/2020,UZB,Sabah,0,0,0,Uzbekistan
16934,10/1/2020,UZB,Sarawak,0,0,0,Uzbekistan
16935,10/1/2020,UZB,Selangor,5,4,1,Uzbekistan
16936,10/1/2020,VAT,Johor,0,0,0,Holy See (Vatican City State)
16937,10/1/2020,VAT,Sarawak,0,0,0,Holy See (Vatican City State)
16938,10/1/2020,VAT,Selangor,0,0,0,Holy See (Vatican City State)
16939,10/1/2020,VCT,Johor,0,0,0,Saint Vincent and the Grenadines
16940,10/1/2020,VCT,Kedah,0,0,0,Saint Vincent and the Grenadines
16941,10/1/2020,VCT,Pulau Pinang,0,0,0,Saint Vincent and the Grenadines
16942,10/1/2020,VCT,Sarawak,0,0,0,Saint Vincent and the Grenadines
16943,10/1/2020,VCT,Selangor,0,0,0,Saint Vincent and the Grenadines
16944,10/1/2020,VEN,Johor,0,0,0,Venezuela
16945,10/1/2020,VEN,Kedah,0,0,0,Venezuela
16946,10/1/2020,VEN,Kelantan,0,0,0,Venezuela
16947,10/1/2020,VEN,Melaka,0,0,0,Venezuela
16948,10/1/2020,VEN,Perak,0,0,0,Venezuela
16949,10/1/2020,VEN,Perlis,0,0,0,Venezuela
16950,10/1/2020,VEN,Pulau Pinang,0,0,0,Venezuela
16951,10/1/2020,VEN,Sabah,0,0,0,Venezuela
16952,10/1/2020,VEN,Sarawak,0,0,0,Venezuela
16953,10/1/2020,VEN,Selangor,1,1,0,Venezuela
16954,10/1/2020,VEN,W.P. Labuan,0,0,0,Venezuela
16955,10/1/2020,VNM,Johor,0,0,0,Vietnam
16956,10/1/2020,VNM,Kedah,0,0,0,Vietnam
16957,10/1/2020,VNM,Kelantan,0,0,0,Vietnam
16958,10/1/2020,VNM,Melaka,0,0,0,Vietnam
16959,10/1/2020,VNM,Negeri Sembilan,0,0,0,Vietnam
16960,10/1/2020,VNM,Pahang,0,0,0,Vietnam
16961,10/1/2020,VNM,Perak,0,0,0,Vietnam
16962,10/1/2020,VNM,Perlis,0,0,0,Vietnam
16963,10/1/2020,VNM,Pulau Pinang,0,0,0,Vietnam
16964,10/1/2020,VNM,Sabah,0,0,0,Vietnam
16965,10/1/2020,VNM,Sarawak,3,0,3,Vietnam
16966,10/1/2020,VNM,Selangor,95,42,53,Vietnam
16967,10/1/2020,VNM,Terengganu,0,0,0,Vietnam
16968,10/1/2020,VNM,W.P. Labuan,0,0,0,Vietnam
16969,10/1/2020,VUT,Johor,0,0,0,Vanuatu
16970,10/1/2020,VUT,Kedah,0,0,0,Vanuatu
16971,10/1/2020,VUT,Pulau Pinang,0,0,0,Vanuatu
16972,10/1/2020,VUT,Sabah,0,0,0,Vanuatu
16973,10/1/2020,VUT,Sarawak,0,0,0,Vanuatu
16974,10/1/2020,VUT,Selangor,0,0,0,Vanuatu
16975,10/1/2020,WSM,Johor,0,0,0,Samoa
16976,10/1/2020,WSM,Sarawak,0,0,0,Samoa
16977,10/1/2020,WSM,Selangor,0,0,0,Samoa
16978,10/1/2020,YEM,Johor,0,0,0,Yemen
16979,10/1/2020,YEM,Kedah,0,0,0,Yemen
16980,10/1/2020,YEM,Kelantan,0,0,0,Yemen
16981,10/1/2020,YEM,Melaka,0,0,0,Yemen
16982,10/1/2020,YEM,Pahang,0,0,0,Yemen
16983,10/1/2020,YEM,Perak,0,0,0,Yemen
16984,10/1/2020,YEM,Perlis,0,0,0,Yemen
16985,10/1/2020,YEM,Pulau Pinang,0,0,0,Yemen
16986,10/1/2020,YEM,Sabah,0,0,0,Yemen
16987,10/1/2020,YEM,Sarawak,0,0,0,Yemen
16988,10/1/2020,YEM,Selangor,26,19,7,Yemen
16989,10/1/2020,YEM,W.P. Labuan,0,0,0,Yemen
16990,10/1/2020,ZAF,Johor,2,2,0,South Africa
16991,10/1/2020,ZAF,Kedah,0,0,0,South Africa
16992,10/1/2020,ZAF,Kelantan,0,0,0,South Africa
16993,10/1/2020,ZAF,Melaka,0,0,0,South Africa
16994,10/1/2020,ZAF,Pahang,0,0,0,South Africa
16995,10/1/2020,ZAF,Perak,0,0,0,South Africa
16996,10/1/2020,ZAF,Perlis,0,0,0,South Africa
16997,10/1/2020,ZAF,Pulau Pinang,0,0,0,South Africa
16998,10/1/2020,ZAF,Sabah,0,0,0,South Africa
16999,10/1/2020,ZAF,Sarawak,0,0,0,South Africa
17000,10/1/2020,ZAF,Selangor,30,23,7,South Africa
17001,10/1/2020,ZAF,Terengganu,0,0,0,South Africa
17002,10/1/2020,ZAF,W.P. Labuan,0,0,0,South Africa
17003,10/1/2020,ZMB,Johor,0,0,0,Zambia
17004,10/1/2020,ZMB,Kedah,0,0,0,Zambia
17005,10/1/2020,ZMB,Perak,0,0,0,Zambia
17006,10/1/2020,ZMB,Perlis,0,0,0,Zambia
17007,10/1/2020,ZMB,Pulau Pinang,0,0,0,Zambia
17008,10/1/2020,ZMB,Sabah,0,0,0,Zambia
17009,10/1/2020,ZMB,Sarawak,0,0,0,Zambia
17010,10/1/2020,ZMB,Selangor,2,1,1,Zambia
17011,10/1/2020,ZWE,Johor,0,0,0,Zimbabwe
17012,10/1/2020,ZWE,Kedah,0,0,0,Zimbabwe
17013,10/1/2020,ZWE,Kelantan,0,0,0,Zimbabwe
17014,10/1/2020,ZWE,Perak,0,0,0,Zimbabwe
17015,10/1/2020,ZWE,Perlis,0,0,0,Zimbabwe
17016,10/1/2020,ZWE,Pulau Pinang,0,0,0,Zimbabwe
17017,10/1/2020,ZWE,Sabah,0,0,0,Zimbabwe
17018,10/1/2020,ZWE,Sarawak,0,0,0,Zimbabwe
17019,10/1/2020,ZWE,Selangor,8,3,5,Zimbabwe
17020,11/1/2020,ABW,Kedah,0,0,0,Aruba
17021,11/1/2020,ABW,Pulau Pinang,0,0,0,Aruba
17022,11/1/2020,AFG,Johor,0,0,0,Afghanistan
17023,11/1/2020,AFG,Kedah,0,0,0,Afghanistan
17024,11/1/2020,AFG,Perlis,0,0,0,Afghanistan
17025,11/1/2020,AFG,Pulau Pinang,0,0,0,Afghanistan
17026,11/1/2020,AFG,Sarawak,0,0,0,Afghanistan
17027,11/1/2020,AFG,Selangor,4,4,0,Afghanistan
17028,11/1/2020,AGO,Johor,0,0,0,Angola
17029,11/1/2020,AGO,Kedah,0,0,0,Angola
17030,11/1/2020,AGO,Sabah,0,0,0,Angola
17031,11/1/2020,AGO,Selangor,0,0,0,Angola
17032,11/1/2020,AIA,Selangor,0,0,0,Anguilla
17033,11/1/2020,ALB,Johor,0,0,0,Albania
17034,11/1/2020,ALB,Kedah,0,0,0,Albania
17035,11/1/2020,ALB,Perak,0,0,0,Albania
17036,11/1/2020,ALB,Perlis,0,0,0,Albania
17037,11/1/2020,ALB,Pulau Pinang,0,0,0,Albania
17038,11/1/2020,ALB,Sabah,0,0,0,Albania
17039,11/1/2020,ALB,Sarawak,0,0,0,Albania
17040,11/1/2020,ALB,Selangor,0,0,0,Albania
17041,11/1/2020,AND,Johor,0,0,0,Andorra
17042,11/1/2020,AND,Kedah,0,0,0,Andorra
17043,11/1/2020,AND,Perlis,0,0,0,Andorra
17044,11/1/2020,AND,Pulau Pinang,0,0,0,Andorra
17045,11/1/2020,AND,Selangor,0,0,0,Andorra
17046,11/1/2020,ANT,Selangor,0,0,0,Netherlands Antilles
17047,11/1/2020,ARE,Johor,0,0,0,United Arab Emirates
17048,11/1/2020,ARE,Kedah,0,0,0,United Arab Emirates
17049,11/1/2020,ARE,Kelantan,0,0,0,United Arab Emirates
17050,11/1/2020,ARE,Perak,0,0,0,United Arab Emirates
17051,11/1/2020,ARE,Perlis,0,0,0,United Arab Emirates
17052,11/1/2020,ARE,Pulau Pinang,0,0,0,United Arab Emirates
17053,11/1/2020,ARE,Sabah,0,0,0,United Arab Emirates
17054,11/1/2020,ARE,Sarawak,0,0,0,United Arab Emirates
17055,11/1/2020,ARE,Selangor,0,0,0,United Arab Emirates
17056,11/1/2020,ARG,Johor,0,0,0,Argentina
17057,11/1/2020,ARG,Kedah,0,0,0,Argentina
17058,11/1/2020,ARG,Kelantan,0,0,0,Argentina
17059,11/1/2020,ARG,Melaka,0,0,0,Argentina
17060,11/1/2020,ARG,Perak,0,0,0,Argentina
17061,11/1/2020,ARG,Perlis,0,0,0,Argentina
17062,11/1/2020,ARG,Pulau Pinang,0,0,0,Argentina
17063,11/1/2020,ARG,Sabah,0,0,0,Argentina
17064,11/1/2020,ARG,Sarawak,0,0,0,Argentina
17065,11/1/2020,ARG,Selangor,3,3,0,Argentina
17066,11/1/2020,ARG,W.P. Labuan,0,0,0,Argentina
17067,11/1/2020,ARM,Johor,0,0,0,Armenia
17068,11/1/2020,ARM,Kedah,0,0,0,Armenia
17069,11/1/2020,ARM,Kelantan,0,0,0,Armenia
17070,11/1/2020,ARM,Perak,0,0,0,Armenia
17071,11/1/2020,ARM,Perlis,0,0,0,Armenia
17072,11/1/2020,ARM,Pulau Pinang,0,0,0,Armenia
17073,11/1/2020,ARM,Sabah,0,0,0,Armenia
17074,11/1/2020,ARM,Sarawak,0,0,0,Armenia
17075,11/1/2020,ARM,Selangor,0,0,0,Armenia
17076,11/1/2020,ATA,Selangor,0,0,0,Antarctica
17077,11/1/2020,ATG,Johor,0,0,0,Antigua and Barbuda
17078,11/1/2020,ATG,Kedah,0,0,0,Antigua and Barbuda
17079,11/1/2020,ATG,Pulau Pinang,0,0,0,Antigua and Barbuda
17080,11/1/2020,ATG,Sarawak,0,0,0,Antigua and Barbuda
17081,11/1/2020,ATG,Selangor,0,0,0,Antigua and Barbuda
17082,11/1/2020,AUS,Johor,41,38,3,Australia
17083,11/1/2020,AUS,Kedah,0,0,0,Australia
17084,11/1/2020,AUS,Kelantan,0,0,0,Australia
17085,11/1/2020,AUS,Melaka,0,0,0,Australia
17086,11/1/2020,AUS,Negeri Sembilan,0,0,0,Australia
17087,11/1/2020,AUS,Pahang,0,0,0,Australia
17088,11/1/2020,AUS,Perak,0,0,0,Australia
17089,11/1/2020,AUS,Perlis,0,0,0,Australia
17090,11/1/2020,AUS,Pulau Pinang,5,5,0,Australia
17091,11/1/2020,AUS,Sabah,3,3,0,Australia
17092,11/1/2020,AUS,Sarawak,0,0,0,Australia
17093,11/1/2020,AUS,Selangor,126,87,39,Australia
17094,11/1/2020,AUS,Terengganu,0,0,0,Australia
17095,11/1/2020,AUS,W.P. Labuan,0,0,0,Australia
17096,11/1/2020,AUT,Johor,0,0,0,Austria
17097,11/1/2020,AUT,Kedah,0,0,0,Austria
17098,11/1/2020,AUT,Kelantan,0,0,0,Austria
17099,11/1/2020,AUT,Melaka,0,0,0,Austria
17100,11/1/2020,AUT,Negeri Sembilan,0,0,0,Austria
17101,11/1/2020,AUT,Pahang,0,0,0,Austria
17102,11/1/2020,AUT,Perak,0,0,0,Austria
17103,11/1/2020,AUT,Perlis,0,0,0,Austria
17104,11/1/2020,AUT,Pulau Pinang,0,0,0,Austria
17105,11/1/2020,AUT,Sabah,0,0,0,Austria
17106,11/1/2020,AUT,Sarawak,0,0,0,Austria
17107,11/1/2020,AUT,Selangor,4,4,0,Austria
17108,11/1/2020,AUT,Terengganu,0,0,0,Austria
17109,11/1/2020,AUT,W.P. Labuan,0,0,0,Austria
17110,11/1/2020,AZE,Johor,0,0,0,Azerbaijan
17111,11/1/2020,AZE,Kedah,0,0,0,Azerbaijan
17112,11/1/2020,AZE,Kelantan,0,0,0,Azerbaijan
17113,11/1/2020,AZE,Melaka,0,0,0,Azerbaijan
17114,11/1/2020,AZE,Perlis,0,0,0,Azerbaijan
17115,11/1/2020,AZE,Pulau Pinang,0,0,0,Azerbaijan
17116,11/1/2020,AZE,Sabah,0,0,0,Azerbaijan
17117,11/1/2020,AZE,Sarawak,0,0,0,Azerbaijan
17118,11/1/2020,AZE,Selangor,2,2,0,Azerbaijan
17119,11/1/2020,AZE,W.P. Labuan,0,0,0,Azerbaijan
17120,11/1/2020,BDI,Pulau Pinang,0,0,0,Burundi
17121,11/1/2020,BDI,Sarawak,0,0,0,Burundi
17122,11/1/2020,BDI,Selangor,0,0,0,Burundi
17123,11/1/2020,BEL,Johor,0,0,0,Belgium
17124,11/1/2020,BEL,Kedah,0,0,0,Belgium
17125,11/1/2020,BEL,Kelantan,0,0,0,Belgium
17126,11/1/2020,BEL,Melaka,0,0,0,Belgium
17127,11/1/2020,BEL,Negeri Sembilan,0,0,0,Belgium
17128,11/1/2020,BEL,Pahang,0,0,0,Belgium
17129,11/1/2020,BEL,Perak,0,0,0,Belgium
17130,11/1/2020,BEL,Perlis,0,0,0,Belgium
17131,11/1/2020,BEL,Pulau Pinang,0,0,0,Belgium
17132,11/1/2020,BEL,Sabah,0,0,0,Belgium
17133,11/1/2020,BEL,Sarawak,0,0,0,Belgium
17134,11/1/2020,BEL,Selangor,13,11,2,Belgium
17135,11/1/2020,BEL,W.P. Labuan,0,0,0,Belgium
17136,11/1/2020,BEN,Johor,0,0,0,Benin
17137,11/1/2020,BEN,Kedah,0,0,0,Benin
17138,11/1/2020,BEN,Perak,0,0,0,Benin
17139,11/1/2020,BEN,Pulau Pinang,0,0,0,Benin
17140,11/1/2020,BEN,Sabah,0,0,0,Benin
17141,11/1/2020,BEN,Sarawak,0,0,0,Benin
17142,11/1/2020,BEN,Selangor,0,0,0,Benin
17143,11/1/2020,BFA,Perak,0,0,0,Burkina Faso
17144,11/1/2020,BFA,Pulau Pinang,0,0,0,Burkina Faso
17145,11/1/2020,BFA,Selangor,0,0,0,Burkina Faso
17146,11/1/2020,BGD,Johor,0,0,0,Bangladesh
17147,11/1/2020,BGD,Kedah,0,0,0,Bangladesh
17148,11/1/2020,BGD,Kelantan,0,0,0,Bangladesh
17149,11/1/2020,BGD,Melaka,0,0,0,Bangladesh
17150,11/1/2020,BGD,Negeri Sembilan,0,0,0,Bangladesh
17151,11/1/2020,BGD,Pahang,0,0,0,Bangladesh
17152,11/1/2020,BGD,Perak,0,0,0,Bangladesh
17153,11/1/2020,BGD,Perlis,0,0,0,Bangladesh
17154,11/1/2020,BGD,Pulau Pinang,0,0,0,Bangladesh
17155,11/1/2020,BGD,Sabah,0,0,0,Bangladesh
17156,11/1/2020,BGD,Sarawak,3,3,0,Bangladesh
17157,11/1/2020,BGD,Selangor,66,56,10,Bangladesh
17158,11/1/2020,BGD,W.P. Labuan,0,0,0,Bangladesh
17159,11/1/2020,BGR,Johor,0,0,0,Bulgaria
17160,11/1/2020,BGR,Kedah,0,0,0,Bulgaria
17161,11/1/2020,BGR,Kelantan,0,0,0,Bulgaria
17162,11/1/2020,BGR,Pahang,0,0,0,Bulgaria
17163,11/1/2020,BGR,Perak,0,0,0,Bulgaria
17164,11/1/2020,BGR,Perlis,0,0,0,Bulgaria
17165,11/1/2020,BGR,Pulau Pinang,0,0,0,Bulgaria
17166,11/1/2020,BGR,Sabah,0,0,0,Bulgaria
17167,11/1/2020,BGR,Sarawak,0,0,0,Bulgaria
17168,11/1/2020,BGR,Selangor,9,8,1,Bulgaria
17169,11/1/2020,BGR,W.P. Labuan,0,0,0,Bulgaria
17170,11/1/2020,BHR,Johor,0,0,0,Bahrain
17171,11/1/2020,BHR,Kedah,0,0,0,Bahrain
17172,11/1/2020,BHR,Kelantan,0,0,0,Bahrain
17173,11/1/2020,BHR,Perlis,0,0,0,Bahrain
17174,11/1/2020,BHR,Pulau Pinang,0,0,0,Bahrain
17175,11/1/2020,BHR,Sabah,0,0,0,Bahrain
17176,11/1/2020,BHR,Sarawak,0,0,0,Bahrain
17177,11/1/2020,BHR,Selangor,2,2,0,Bahrain
17178,11/1/2020,BHS,Johor,0,0,0,Bahamas
17179,11/1/2020,BHS,Kedah,0,0,0,Bahamas
17180,11/1/2020,BHS,Perak,0,0,0,Bahamas
17181,11/1/2020,BHS,Sabah,0,0,0,Bahamas
17182,11/1/2020,BHS,Sarawak,0,0,0,Bahamas
17183,11/1/2020,BHS,Selangor,0,0,0,Bahamas
17184,11/1/2020,BIH,Johor,0,0,0,Bosnia and Herzegovina
17185,11/1/2020,BIH,Kedah,0,0,0,Bosnia and Herzegovina
17186,11/1/2020,BIH,Perlis,0,0,0,Bosnia and Herzegovina
17187,11/1/2020,BIH,Pulau Pinang,0,0,0,Bosnia and Herzegovina
17188,11/1/2020,BIH,Sabah,0,0,0,Bosnia and Herzegovina
17189,11/1/2020,BIH,Sarawak,0,0,0,Bosnia and Herzegovina
17190,11/1/2020,BIH,Selangor,3,2,1,Bosnia and Herzegovina
17191,11/1/2020,BLR,Johor,0,0,0,Belarus
17192,11/1/2020,BLR,Kedah,0,0,0,Belarus
17193,11/1/2020,BLR,Kelantan,0,0,0,Belarus
17194,11/1/2020,BLR,Pahang,0,0,0,Belarus
17195,11/1/2020,BLR,Perak,0,0,0,Belarus
17196,11/1/2020,BLR,Perlis,0,0,0,Belarus
17197,11/1/2020,BLR,Pulau Pinang,0,0,0,Belarus
17198,11/1/2020,BLR,Sabah,0,0,0,Belarus
17199,11/1/2020,BLR,Sarawak,0,0,0,Belarus
17200,11/1/2020,BLR,Selangor,2,0,2,Belarus
17201,11/1/2020,BLR,W.P. Labuan,0,0,0,Belarus
17202,11/1/2020,BLZ,Johor,0,0,0,Belize
17203,11/1/2020,BLZ,Pulau Pinang,0,0,0,Belize
17204,11/1/2020,BLZ,Sarawak,0,0,0,Belize
17205,11/1/2020,BLZ,Selangor,1,1,0,Belize
17206,11/1/2020,BMU,Selangor,0,0,0,Bermuda
17207,11/1/2020,BOL,Johor,0,0,0,Bolivia
17208,11/1/2020,BOL,Kedah,0,0,0,Bolivia
17209,11/1/2020,BOL,Melaka,0,0,0,Bolivia
17210,11/1/2020,BOL,Perak,0,0,0,Bolivia
17211,11/1/2020,BOL,Perlis,0,0,0,Bolivia
17212,11/1/2020,BOL,Pulau Pinang,0,0,0,Bolivia
17213,11/1/2020,BOL,Sabah,0,0,0,Bolivia
17214,11/1/2020,BOL,Sarawak,0,0,0,Bolivia
17215,11/1/2020,BOL,Selangor,0,0,0,Bolivia
17216,11/1/2020,BRA,Johor,1,0,1,Brazil
17217,11/1/2020,BRA,Kedah,0,0,0,Brazil
17218,11/1/2020,BRA,Kelantan,0,0,0,Brazil
17219,11/1/2020,BRA,Melaka,0,0,0,Brazil
17220,11/1/2020,BRA,Pahang,0,0,0,Brazil
17221,11/1/2020,BRA,Perak,0,0,0,Brazil
17222,11/1/2020,BRA,Perlis,0,0,0,Brazil
17223,11/1/2020,BRA,Pulau Pinang,0,0,0,Brazil
17224,11/1/2020,BRA,Sabah,0,0,0,Brazil
17225,11/1/2020,BRA,Sarawak,0,0,0,Brazil
17226,11/1/2020,BRA,Selangor,4,4,0,Brazil
17227,11/1/2020,BRA,W.P. Labuan,0,0,0,Brazil
17228,11/1/2020,BRB,Johor,0,0,0,Barbados
17229,11/1/2020,BRB,Kedah,0,0,0,Barbados
17230,11/1/2020,BRB,Perlis,0,0,0,Barbados
17231,11/1/2020,BRB,Pulau Pinang,0,0,0,Barbados
17232,11/1/2020,BRB,Selangor,0,0,0,Barbados
17233,11/1/2020,BRN,Johor,0,0,0,Brunei Darussalam
17234,11/1/2020,BRN,Kedah,0,0,0,Brunei Darussalam
17235,11/1/2020,BRN,Kelantan,0,0,0,Brunei Darussalam
17236,11/1/2020,BRN,Melaka,0,0,0,Brunei Darussalam
17237,11/1/2020,BRN,Pahang,0,0,0,Brunei Darussalam
17238,11/1/2020,BRN,Perak,0,0,0,Brunei Darussalam
17239,11/1/2020,BRN,Perlis,0,0,0,Brunei Darussalam
17240,11/1/2020,BRN,Pulau Pinang,0,0,0,Brunei Darussalam
17241,11/1/2020,BRN,Sabah,0,0,0,Brunei Darussalam
17242,11/1/2020,BRN,Sarawak,322,312,10,Brunei Darussalam
17243,11/1/2020,BRN,Selangor,8,5,3,Brunei Darussalam
17244,11/1/2020,BRN,W.P. Labuan,4,3,1,Brunei Darussalam
17245,11/1/2020,BTN,Johor,0,0,0,Bhutan
17246,11/1/2020,BTN,Kedah,0,0,0,Bhutan
17247,11/1/2020,BTN,Perak,0,0,0,Bhutan
17248,11/1/2020,BTN,Perlis,0,0,0,Bhutan
17249,11/1/2020,BTN,Pulau Pinang,0,0,0,Bhutan
17250,11/1/2020,BTN,Sabah,0,0,0,Bhutan
17251,11/1/2020,BTN,Sarawak,0,0,0,Bhutan
17252,11/1/2020,BTN,Selangor,0,0,0,Bhutan
17253,11/1/2020,BWA,Johor,0,0,0,Botswana
17254,11/1/2020,BWA,Kedah,0,0,0,Botswana
17255,11/1/2020,BWA,Perlis,0,0,0,Botswana
17256,11/1/2020,BWA,Pulau Pinang,0,0,0,Botswana
17257,11/1/2020,BWA,Sabah,0,0,0,Botswana
17258,11/1/2020,BWA,Sarawak,0,0,0,Botswana
17259,11/1/2020,BWA,Selangor,0,0,0,Botswana
17260,11/1/2020,CAF,Kedah,0,0,0,Central African Republic
17261,11/1/2020,CAF,Selangor,0,0,0,Central African Republic
17262,11/1/2020,CAN,Johor,0,0,0,Canada
17263,11/1/2020,CAN,Kedah,0,0,0,Canada
17264,11/1/2020,CAN,Kelantan,0,0,0,Canada
17265,11/1/2020,CAN,Melaka,0,0,0,Canada
17266,11/1/2020,CAN,Negeri Sembilan,0,0,0,Canada
17267,11/1/2020,CAN,Pahang,0,0,0,Canada
17268,11/1/2020,CAN,Perak,2,1,1,Canada
17269,11/1/2020,CAN,Perlis,0,0,0,Canada
17270,11/1/2020,CAN,Pulau Pinang,1,1,0,Canada
17271,11/1/2020,CAN,Sabah,0,0,0,Canada
17272,11/1/2020,CAN,Sarawak,0,0,0,Canada
17273,11/1/2020,CAN,Selangor,49,33,16,Canada
17274,11/1/2020,CAN,Terengganu,0,0,0,Canada
17275,11/1/2020,CAN,W.P. Labuan,0,0,0,Canada
17276,11/1/2020,CCK,Selangor,0,0,0,Cocos (Keeling) Islands
17277,11/1/2020,CHE,Johor,0,0,0,Switzerland
17278,11/1/2020,CHE,Kedah,0,0,0,Switzerland
17279,11/1/2020,CHE,Kelantan,0,0,0,Switzerland
17280,11/1/2020,CHE,Melaka,0,0,0,Switzerland
17281,11/1/2020,CHE,Negeri Sembilan,0,0,0,Switzerland
17282,11/1/2020,CHE,Pahang,0,0,0,Switzerland
17283,11/1/2020,CHE,Perak,0,0,0,Switzerland
17284,11/1/2020,CHE,Perlis,0,0,0,Switzerland
17285,11/1/2020,CHE,Pulau Pinang,0,0,0,Switzerland
17286,11/1/2020,CHE,Sabah,0,0,0,Switzerland
17287,11/1/2020,CHE,Sarawak,0,0,0,Switzerland
17288,11/1/2020,CHE,Selangor,16,11,5,Switzerland
17289,11/1/2020,CHE,W.P. Labuan,0,0,0,Switzerland
17290,11/1/2020,CHL,Johor,0,0,0,Chile
17291,11/1/2020,CHL,Kedah,0,0,0,Chile
17292,11/1/2020,CHL,Kelantan,0,0,0,Chile
17293,11/1/2020,CHL,Melaka,0,0,0,Chile
17294,11/1/2020,CHL,Pahang,0,0,0,Chile
17295,11/1/2020,CHL,Perak,0,0,0,Chile
17296,11/1/2020,CHL,Perlis,0,0,0,Chile
17297,11/1/2020,CHL,Pulau Pinang,0,0,0,Chile
17298,11/1/2020,CHL,Sabah,0,0,0,Chile
17299,11/1/2020,CHL,Sarawak,0,0,0,Chile
17300,11/1/2020,CHL,Selangor,0,0,0,Chile
17301,11/1/2020,CHN,Johor,26,23,3,China
17302,11/1/2020,CHN,Kedah,0,0,0,China
17303,11/1/2020,CHN,Kelantan,0,0,0,China
17304,11/1/2020,CHN,Melaka,0,0,0,China
17305,11/1/2020,CHN,Pahang,0,0,0,China
17306,11/1/2020,CHN,Perak,0,0,0,China
17307,11/1/2020,CHN,Perlis,0,0,0,China
17308,11/1/2020,CHN,Pulau Pinang,2,0,2,China
17309,11/1/2020,CHN,Sabah,0,0,0,China
17310,11/1/2020,CHN,Sarawak,231,188,43,China
17311,11/1/2020,CHN,Selangor,1374,1094,280,China
17312,11/1/2020,CHN,Terengganu,0,0,0,China
17313,11/1/2020,CHN,W.P. Labuan,0,0,0,China
17314,11/1/2020,CIV,Johor,0,0,0,C��te d'Iv
17315,11/1/2020,CIV,Kedah,0,0,0,C��te d'Iv
17316,11/1/2020,CIV,Pulau Pinang,0,0,0,C��te d'Iv
17317,11/1/2020,CIV,Sabah,0,0,0,C��te d'Iv
17318,11/1/2020,CIV,Sarawak,0,0,0,C��te d'Iv
17319,11/1/2020,CIV,Selangor,0,0,0,C��te d'Iv
17320,11/1/2020,CMR,Johor,0,0,0,Cameroon
17321,11/1/2020,CMR,Kedah,0,0,0,Cameroon
17322,11/1/2020,CMR,Pulau Pinang,0,0,0,Cameroon
17323,11/1/2020,CMR,Sabah,0,0,0,Cameroon
17324,11/1/2020,CMR,Sarawak,0,0,0,Cameroon
17325,11/1/2020,CMR,Selangor,0,0,0,Cameroon
17326,11/1/2020,COD,Johor,0,0,0,"Congo, the Democratic Republic of the"
17327,11/1/2020,COD,Pulau Pinang,0,0,0,"Congo, the Democratic Republic of the"
17328,11/1/2020,COD,Sarawak,0,0,0,"Congo, the Democratic Republic of the"
17329,11/1/2020,COD,Selangor,0,0,0,"Congo, the Democratic Republic of the"
17330,11/1/2020,COG,Johor,0,0,0,Congo
17331,11/1/2020,COG,Kedah,0,0,0,Congo
17332,11/1/2020,COG,Selangor,0,0,0,Congo
17333,11/1/2020,COK,Selangor,0,0,0,Cook Islands
17334,11/1/2020,COL,Johor,0,0,0,Colombia
17335,11/1/2020,COL,Kedah,0,0,0,Colombia
17336,11/1/2020,COL,Perak,0,0,0,Colombia
17337,11/1/2020,COL,Pulau Pinang,0,0,0,Colombia
17338,11/1/2020,COL,Sabah,0,0,0,Colombia
17339,11/1/2020,COL,Sarawak,0,0,0,Colombia
17340,11/1/2020,COL,Selangor,3,0,3,Colombia
17341,11/1/2020,COL,W.P. Labuan,0,0,0,Colombia
17342,11/1/2020,COM,Johor,0,0,0,Comoros
17343,11/1/2020,COM,Kedah,0,0,0,Comoros
17344,11/1/2020,COM,Selangor,2,0,2,Comoros
17345,11/1/2020,CPV,Johor,0,0,0,Cape Verde
17346,11/1/2020,CPV,Kedah,0,0,0,Cape Verde
17347,11/1/2020,CPV,Pulau Pinang,0,0,0,Cape Verde
17348,11/1/2020,CPV,Sabah,0,0,0,Cape Verde
17349,11/1/2020,CPV,Selangor,0,0,0,Cape Verde
17350,11/1/2020,CRI,Johor,0,0,0,Costa Rica
17351,11/1/2020,CRI,Kedah,0,0,0,Costa Rica
17352,11/1/2020,CRI,Perak,0,0,0,Costa Rica
17353,11/1/2020,CRI,Perlis,0,0,0,Costa Rica
17354,11/1/2020,CRI,Pulau Pinang,0,0,0,Costa Rica
17355,11/1/2020,CRI,Sabah,0,0,0,Costa Rica
17356,11/1/2020,CRI,Sarawak,0,0,0,Costa Rica
17357,11/1/2020,CRI,Selangor,0,0,0,Costa Rica
17358,11/1/2020,CUB,Johor,0,0,0,Cuba
17359,11/1/2020,CUB,Kedah,0,0,0,Cuba
17360,11/1/2020,CUB,Perlis,0,0,0,Cuba
17361,11/1/2020,CUB,Pulau Pinang,0,0,0,Cuba
17362,11/1/2020,CUB,Sabah,0,0,0,Cuba
17363,11/1/2020,CUB,Sarawak,0,0,0,Cuba
17364,11/1/2020,CUB,Selangor,0,0,0,Cuba
17365,11/1/2020,CYP,Johor,0,0,0,Cyprus
17366,11/1/2020,CYP,Kedah,0,0,0,Cyprus
17367,11/1/2020,CYP,Perak,0,0,0,Cyprus
17368,11/1/2020,CYP,Perlis,0,0,0,Cyprus
17369,11/1/2020,CYP,Pulau Pinang,0,0,0,Cyprus
17370,11/1/2020,CYP,Sabah,0,0,0,Cyprus
17371,11/1/2020,CYP,Sarawak,0,0,0,Cyprus
17372,11/1/2020,CYP,Selangor,0,0,0,Cyprus
17373,11/1/2020,CZE,Johor,0,0,0,Czech Republic
17374,11/1/2020,CZE,Kedah,0,0,0,Czech Republic
17375,11/1/2020,CZE,Kelantan,0,0,0,Czech Republic
17376,11/1/2020,CZE,Melaka,0,0,0,Czech Republic
17377,11/1/2020,CZE,Negeri Sembilan,0,0,0,Czech Republic
17378,11/1/2020,CZE,Perak,0,0,0,Czech Republic
17379,11/1/2020,CZE,Perlis,0,0,0,Czech Republic
17380,11/1/2020,CZE,Pulau Pinang,0,0,0,Czech Republic
17381,11/1/2020,CZE,Sabah,0,0,0,Czech Republic
17382,11/1/2020,CZE,Sarawak,0,0,0,Czech Republic
17383,11/1/2020,CZE,Selangor,8,7,1,Czech Republic
17384,11/1/2020,CZE,W.P. Labuan,0,0,0,Czech Republic
17385,11/1/2020,DEU,Johor,6,6,0,Germany
17386,11/1/2020,DEU,Kedah,0,0,0,Germany
17387,11/1/2020,DEU,Kelantan,0,0,0,Germany
17388,11/1/2020,DEU,Melaka,0,0,0,Germany
17389,11/1/2020,DEU,Negeri Sembilan,0,0,0,Germany
17390,11/1/2020,DEU,Pahang,0,0,0,Germany
17391,11/1/2020,DEU,Perak,0,0,0,Germany
17392,11/1/2020,DEU,Perlis,0,0,0,Germany
17393,11/1/2020,DEU,Pulau Pinang,1,0,1,Germany
17394,11/1/2020,DEU,Sabah,0,0,0,Germany
17395,11/1/2020,DEU,Sarawak,0,0,0,Germany
17396,11/1/2020,DEU,Selangor,48,40,8,Germany
17397,11/1/2020,DEU,Terengganu,0,0,0,Germany
17398,11/1/2020,DEU,W.P. Labuan,0,0,0,Germany
17399,11/1/2020,DJI,Johor,0,0,0,Djibouti
17400,11/1/2020,DJI,Selangor,0,0,0,Djibouti
17401,11/1/2020,DMA,Johor,0,0,0,Dominica
17402,11/1/2020,DMA,Kedah,0,0,0,Dominica
17403,11/1/2020,DMA,Pulau Pinang,0,0,0,Dominica
17404,11/1/2020,DMA,Sabah,0,0,0,Dominica
17405,11/1/2020,DMA,Sarawak,0,0,0,Dominica
17406,11/1/2020,DMA,Selangor,0,0,0,Dominica
17407,11/1/2020,DMA,W.P. Labuan,0,0,0,Dominica
17408,11/1/2020,DNK,Johor,4,2,2,Denmark
17409,11/1/2020,DNK,Kedah,0,0,0,Denmark
17410,11/1/2020,DNK,Kelantan,0,0,0,Denmark
17411,11/1/2020,DNK,Melaka,0,0,0,Denmark
17412,11/1/2020,DNK,Negeri Sembilan,0,0,0,Denmark
17413,11/1/2020,DNK,Pahang,0,0,0,Denmark
17414,11/1/2020,DNK,Perak,0,0,0,Denmark
17415,11/1/2020,DNK,Perlis,0,0,0,Denmark
17416,11/1/2020,DNK,Pulau Pinang,0,0,0,Denmark
17417,11/1/2020,DNK,Sabah,0,0,0,Denmark
17418,11/1/2020,DNK,Sarawak,0,0,0,Denmark
17419,11/1/2020,DNK,Selangor,20,17,3,Denmark
17420,11/1/2020,DNK,W.P. Labuan,0,0,0,Denmark
17421,11/1/2020,DOM,Johor,0,0,0,Dominican Republic
17422,11/1/2020,DOM,Kedah,0,0,0,Dominican Republic
17423,11/1/2020,DOM,Perak,0,0,0,Dominican Republic
17424,11/1/2020,DOM,Perlis,0,0,0,Dominican Republic
17425,11/1/2020,DOM,Pulau Pinang,0,0,0,Dominican Republic
17426,11/1/2020,DOM,Sabah,0,0,0,Dominican Republic
17427,11/1/2020,DOM,Sarawak,0,0,0,Dominican Republic
17428,11/1/2020,DOM,Selangor,0,0,0,Dominican Republic
17429,11/1/2020,DZA,Johor,0,0,0,Algeria
17430,11/1/2020,DZA,Kedah,0,0,0,Algeria
17431,11/1/2020,DZA,Kelantan,0,0,0,Algeria
17432,11/1/2020,DZA,Melaka,0,0,0,Algeria
17433,11/1/2020,DZA,Perak,0,0,0,Algeria
17434,11/1/2020,DZA,Perlis,0,0,0,Algeria
17435,11/1/2020,DZA,Pulau Pinang,0,0,0,Algeria
17436,11/1/2020,DZA,Sabah,0,0,0,Algeria
17437,11/1/2020,DZA,Sarawak,0,0,0,Algeria
17438,11/1/2020,DZA,Selangor,4,3,1,Algeria
17439,11/1/2020,DZA,W.P. Labuan,0,0,0,Algeria
17440,11/1/2020,ECU,Johor,0,0,0,Ecuador
17441,11/1/2020,ECU,Kedah,0,0,0,Ecuador
17442,11/1/2020,ECU,Perak,0,0,0,Ecuador
17443,11/1/2020,ECU,Perlis,0,0,0,Ecuador
17444,11/1/2020,ECU,Pulau Pinang,0,0,0,Ecuador
17445,11/1/2020,ECU,Sabah,0,0,0,Ecuador
17446,11/1/2020,ECU,Sarawak,0,0,0,Ecuador
17447,11/1/2020,ECU,Selangor,1,1,0,Ecuador
17448,11/1/2020,EGY,Johor,0,0,0,Egypt
17449,11/1/2020,EGY,Kedah,0,0,0,Egypt
17450,11/1/2020,EGY,Kelantan,0,0,0,Egypt
17451,11/1/2020,EGY,Melaka,0,0,0,Egypt
17452,11/1/2020,EGY,Pahang,0,0,0,Egypt
17453,11/1/2020,EGY,Perak,0,0,0,Egypt
17454,11/1/2020,EGY,Perlis,0,0,0,Egypt
17455,11/1/2020,EGY,Pulau Pinang,0,0,0,Egypt
17456,11/1/2020,EGY,Sabah,0,0,0,Egypt
17457,11/1/2020,EGY,Sarawak,0,0,0,Egypt
17458,11/1/2020,EGY,Selangor,28,23,5,Egypt
17459,11/1/2020,EGY,Terengganu,0,0,0,Egypt
17460,11/1/2020,EGY,W.P. Labuan,0,0,0,Egypt
17461,11/1/2020,ERI,Johor,0,0,0,Eritrea
17462,11/1/2020,ERI,Pulau Pinang,0,0,0,Eritrea
17463,11/1/2020,ERI,Sabah,0,0,0,Eritrea
17464,11/1/2020,ERI,Selangor,0,0,0,Eritrea
17465,11/1/2020,ESP,Johor,0,0,0,Spain
17466,11/1/2020,ESP,Kedah,0,0,0,Spain
17467,11/1/2020,ESP,Kelantan,0,0,0,Spain
17468,11/1/2020,ESP,Melaka,0,0,0,Spain
17469,11/1/2020,ESP,Negeri Sembilan,0,0,0,Spain
17470,11/1/2020,ESP,Pahang,0,0,0,Spain
17471,11/1/2020,ESP,Perak,0,0,0,Spain
17472,11/1/2020,ESP,Perlis,0,0,0,Spain
17473,11/1/2020,ESP,Pulau Pinang,0,0,0,Spain
17474,11/1/2020,ESP,Sabah,0,0,0,Spain
17475,11/1/2020,ESP,Sarawak,0,0,0,Spain
17476,11/1/2020,ESP,Selangor,14,12,2,Spain
17477,11/1/2020,ESP,W.P. Labuan,0,0,0,Spain
17478,11/1/2020,EST,Johor,0,0,0,Estonia
17479,11/1/2020,EST,Kedah,0,0,0,Estonia
17480,11/1/2020,EST,Kelantan,0,0,0,Estonia
17481,11/1/2020,EST,Pahang,0,0,0,Estonia
17482,11/1/2020,EST,Perak,0,0,0,Estonia
17483,11/1/2020,EST,Perlis,0,0,0,Estonia
17484,11/1/2020,EST,Pulau Pinang,0,0,0,Estonia
17485,11/1/2020,EST,Sabah,0,0,0,Estonia
17486,11/1/2020,EST,Sarawak,0,0,0,Estonia
17487,11/1/2020,EST,Selangor,3,3,0,Estonia
17488,11/1/2020,EST,W.P. Labuan,0,0,0,Estonia
17489,11/1/2020,ETH,Johor,0,0,0,Ethiopia
17490,11/1/2020,ETH,Kedah,0,0,0,Ethiopia
17491,11/1/2020,ETH,Pulau Pinang,0,0,0,Ethiopia
17492,11/1/2020,ETH,Sarawak,0,0,0,Ethiopia
17493,11/1/2020,ETH,Selangor,0,0,0,Ethiopia
17494,11/1/2020,FIN,Johor,0,0,0,Finland
17495,11/1/2020,FIN,Kedah,0,0,0,Finland
17496,11/1/2020,FIN,Kelantan,0,0,0,Finland
17497,11/1/2020,FIN,Melaka,0,0,0,Finland
17498,11/1/2020,FIN,Negeri Sembilan,0,0,0,Finland
17499,11/1/2020,FIN,Pahang,0,0,0,Finland
17500,11/1/2020,FIN,Perak,0,0,0,Finland
17501,11/1/2020,FIN,Perlis,0,0,0,Finland
17502,11/1/2020,FIN,Pulau Pinang,0,0,0,Finland
17503,11/1/2020,FIN,Sabah,0,0,0,Finland
17504,11/1/2020,FIN,Sarawak,0,0,0,Finland
17505,11/1/2020,FIN,Selangor,5,5,0,Finland
17506,11/1/2020,FIN,W.P. Labuan,0,0,0,Finland
17507,11/1/2020,FJI,Johor,0,0,0,Fiji
17508,11/1/2020,FJI,Kedah,0,0,0,Fiji
17509,11/1/2020,FJI,Kelantan,0,0,0,Fiji
17510,11/1/2020,FJI,Perak,0,0,0,Fiji
17511,11/1/2020,FJI,Perlis,0,0,0,Fiji
17512,11/1/2020,FJI,Pulau Pinang,0,0,0,Fiji
17513,11/1/2020,FJI,Sabah,0,0,0,Fiji
17514,11/1/2020,FJI,Sarawak,0,0,0,Fiji
17515,11/1/2020,FJI,Selangor,1,0,1,Fiji
17516,11/1/2020,FRA,Johor,2,2,0,France
17517,11/1/2020,FRA,Kedah,0,0,0,France
17518,11/1/2020,FRA,Kelantan,0,0,0,France
17519,11/1/2020,FRA,Melaka,0,0,0,France
17520,11/1/2020,FRA,Negeri Sembilan,0,0,0,France
17521,11/1/2020,FRA,Pahang,0,0,0,France
17522,11/1/2020,FRA,Perak,0,0,0,France
17523,11/1/2020,FRA,Perlis,0,0,0,France
17524,11/1/2020,FRA,Pulau Pinang,0,0,0,France
17525,11/1/2020,FRA,Sabah,0,0,0,France
17526,11/1/2020,FRA,Sarawak,0,0,0,France
17527,11/1/2020,FRA,Selangor,44,35,9,France
17528,11/1/2020,FRA,Terengganu,0,0,0,France
17529,11/1/2020,FRA,W.P. Labuan,0,0,0,France
17530,11/1/2020,FSM,Johor,0,0,0,"Micronesia, Federated States of"
17531,11/1/2020,FSM,Pulau Pinang,0,0,0,"Micronesia, Federated States of"
17532,11/1/2020,FSM,Selangor,0,0,0,"Micronesia, Federated States of"
17533,11/1/2020,GAB,Johor,0,0,0,Gabon
17534,11/1/2020,GAB,Pulau Pinang,0,0,0,Gabon
17535,11/1/2020,GAB,Sarawak,0,0,0,Gabon
17536,11/1/2020,GAB,Selangor,0,0,0,Gabon
17537,11/1/2020,GBR,Johor,37,37,0,United Kingdom
17538,11/1/2020,GBR,Kedah,0,0,0,United Kingdom
17539,11/1/2020,GBR,Kelantan,0,0,0,United Kingdom
17540,11/1/2020,GBR,Melaka,0,0,0,United Kingdom
17541,11/1/2020,GBR,Negeri Sembilan,0,0,0,United Kingdom
17542,11/1/2020,GBR,Pahang,0,0,0,United Kingdom
17543,11/1/2020,GBR,Perak,1,0,1,United Kingdom
17544,11/1/2020,GBR,Perlis,0,0,0,United Kingdom
17545,11/1/2020,GBR,Pulau Pinang,5,4,1,United Kingdom
17546,11/1/2020,GBR,Sabah,0,0,0,United Kingdom
17547,11/1/2020,GBR,Sarawak,0,0,0,United Kingdom
17548,11/1/2020,GBR,Selangor,199,160,39,United Kingdom
17549,11/1/2020,GBR,Terengganu,0,0,0,United Kingdom
17550,11/1/2020,GBR,W.P. Labuan,0,0,0,United Kingdom
17551,11/1/2020,GEO,Johor,2,2,0,Georgia
17552,11/1/2020,GEO,Kedah,0,0,0,Georgia
17553,11/1/2020,GEO,Melaka,0,0,0,Georgia
17554,11/1/2020,GEO,Perak,0,0,0,Georgia
17555,11/1/2020,GEO,Perlis,0,0,0,Georgia
17556,11/1/2020,GEO,Pulau Pinang,0,0,0,Georgia
17557,11/1/2020,GEO,Sabah,0,0,0,Georgia
17558,11/1/2020,GEO,Sarawak,0,0,0,Georgia
17559,11/1/2020,GEO,Selangor,5,3,2,Georgia
17560,11/1/2020,GHA,Johor,0,0,0,Ghana
17561,11/1/2020,GHA,Kedah,0,0,0,Ghana
17562,11/1/2020,GHA,Kelantan,0,0,0,Ghana
17563,11/1/2020,GHA,Pulau Pinang,0,0,0,Ghana
17564,11/1/2020,GHA,Sabah,0,0,0,Ghana
17565,11/1/2020,GHA,Sarawak,0,0,0,Ghana
17566,11/1/2020,GHA,Selangor,2,1,1,Ghana
17567,11/1/2020,GIB,Johor,0,0,0,Gibraltar
17568,11/1/2020,GIB,Sarawak,0,0,0,Gibraltar
17569,11/1/2020,GIN,Johor,0,0,0,Guinea
17570,11/1/2020,GIN,Kedah,0,0,0,Guinea
17571,11/1/2020,GIN,Kelantan,0,0,0,Guinea
17572,11/1/2020,GIN,Perlis,0,0,0,Guinea
17573,11/1/2020,GIN,Pulau Pinang,0,0,0,Guinea
17574,11/1/2020,GIN,Sabah,0,0,0,Guinea
17575,11/1/2020,GIN,Sarawak,0,0,0,Guinea
17576,11/1/2020,GIN,Selangor,0,0,0,Guinea
17577,11/1/2020,GLP,Selangor,0,0,0,Guadeloupe
17578,11/1/2020,GMB,Johor,0,0,0,Gambia
17579,11/1/2020,GMB,Kedah,0,0,0,Gambia
17580,11/1/2020,GMB,Kelantan,0,0,0,Gambia
17581,11/1/2020,GMB,Pulau Pinang,0,0,0,Gambia
17582,11/1/2020,GMB,Sabah,0,0,0,Gambia
17583,11/1/2020,GMB,Sarawak,0,0,0,Gambia
17584,11/1/2020,GMB,Selangor,1,0,1,Gambia
17585,11/1/2020,GNB,Johor,0,0,0,Guinea-Bissau
17586,11/1/2020,GNB,Selangor,0,0,0,Guinea-Bissau
17587,11/1/2020,GNQ,Johor,0,0,0,Equatorial Guinea
17588,11/1/2020,GNQ,Selangor,0,0,0,Equatorial Guinea
17589,11/1/2020,GRC,Johor,0,0,0,Greece
17590,11/1/2020,GRC,Kedah,0,0,0,Greece
17591,11/1/2020,GRC,Kelantan,0,0,0,Greece
17592,11/1/2020,GRC,Melaka,0,0,0,Greece
17593,11/1/2020,GRC,Negeri Sembilan,0,0,0,Greece
17594,11/1/2020,GRC,Pahang,0,0,0,Greece
17595,11/1/2020,GRC,Perak,0,0,0,Greece
17596,11/1/2020,GRC,Perlis,0,0,0,Greece
17597,11/1/2020,GRC,Pulau Pinang,0,0,0,Greece
17598,11/1/2020,GRC,Sabah,0,0,0,Greece
17599,11/1/2020,GRC,Sarawak,0,0,0,Greece
17600,11/1/2020,GRC,Selangor,5,3,2,Greece
17601,11/1/2020,GRD,Johor,0,0,0,Grenada
17602,11/1/2020,GRD,Kedah,0,0,0,Grenada
17603,11/1/2020,GRD,Pulau Pinang,0,0,0,Grenada
17604,11/1/2020,GRD,Sabah,0,0,0,Grenada
17605,11/1/2020,GRD,Sarawak,0,0,0,Grenada
17606,11/1/2020,GRD,Selangor,0,0,0,Grenada
17607,11/1/2020,GRL,Johor,0,0,0,Greenland
17608,11/1/2020,GRL,Selangor,0,0,0,Greenland
17609,11/1/2020,GTM,Johor,0,0,0,Guatemala
17610,11/1/2020,GTM,Kedah,0,0,0,Guatemala
17611,11/1/2020,GTM,Pahang,0,0,0,Guatemala
17612,11/1/2020,GTM,Perak,0,0,0,Guatemala
17613,11/1/2020,GTM,Pulau Pinang,0,0,0,Guatemala
17614,11/1/2020,GTM,Sabah,0,0,0,Guatemala
17615,11/1/2020,GTM,Sarawak,0,0,0,Guatemala
17616,11/1/2020,GTM,Selangor,0,0,0,Guatemala
17617,11/1/2020,GTM,W.P. Labuan,0,0,0,Guatemala
17618,11/1/2020,GUY,Johor,0,0,0,Guyana
17619,11/1/2020,GUY,Kedah,0,0,0,Guyana
17620,11/1/2020,GUY,Pulau Pinang,0,0,0,Guyana
17621,11/1/2020,GUY,Sarawak,0,0,0,Guyana
17622,11/1/2020,GUY,Selangor,0,0,0,Guyana
17623,11/1/2020,HKG,Johor,0,0,0,Hong Kong
17624,11/1/2020,HKG,Kedah,0,0,0,Hong Kong
17625,11/1/2020,HKG,Kelantan,0,0,0,Hong Kong
17626,11/1/2020,HKG,Pahang,0,0,0,Hong Kong
17627,11/1/2020,HKG,Perak,0,0,0,Hong Kong
17628,11/1/2020,HKG,Perlis,0,0,0,Hong Kong
17629,11/1/2020,HKG,Pulau Pinang,0,0,0,Hong Kong
17630,11/1/2020,HKG,Sabah,0,0,0,Hong Kong
17631,11/1/2020,HKG,Sarawak,0,0,0,Hong Kong
17632,11/1/2020,HKG,Selangor,2,1,1,Hong Kong
17633,11/1/2020,HKG,Terengganu,0,0,0,Hong Kong
17634,11/1/2020,HMD,Johor,0,0,0,Heard Island and McDonald Islands
17635,11/1/2020,HND,Johor,0,0,0,Honduras
17636,11/1/2020,HND,Kedah,0,0,0,Honduras
17637,11/1/2020,HND,Perak,0,0,0,Honduras
17638,11/1/2020,HND,Pulau Pinang,0,0,0,Honduras
17639,11/1/2020,HND,Sabah,0,0,0,Honduras
17640,11/1/2020,HND,Sarawak,0,0,0,Honduras
17641,11/1/2020,HND,Selangor,0,0,0,Honduras
17642,11/1/2020,HRV,Johor,0,0,0,Croatia
17643,11/1/2020,HRV,Kedah,0,0,0,Croatia
17644,11/1/2020,HRV,Kelantan,0,0,0,Croatia
17645,11/1/2020,HRV,Melaka,0,0,0,Croatia
17646,11/1/2020,HRV,Pahang,0,0,0,Croatia
17647,11/1/2020,HRV,Perak,0,0,0,Croatia
17648,11/1/2020,HRV,Perlis,0,0,0,Croatia
17649,11/1/2020,HRV,Pulau Pinang,0,0,0,Croatia
17650,11/1/2020,HRV,Sabah,0,0,0,Croatia
17651,11/1/2020,HRV,Sarawak,0,0,0,Croatia
17652,11/1/2020,HRV,Selangor,14,14,0,Croatia
17653,11/1/2020,HTI,Johor,0,0,0,Haiti
17654,11/1/2020,HTI,Kedah,0,0,0,Haiti
17655,11/1/2020,HTI,Kelantan,0,0,0,Haiti
17656,11/1/2020,HTI,Perak,0,0,0,Haiti
17657,11/1/2020,HTI,Pulau Pinang,0,0,0,Haiti
17658,11/1/2020,HTI,Sabah,0,0,0,Haiti
17659,11/1/2020,HTI,Selangor,0,0,0,Haiti
17660,11/1/2020,HUN,Johor,0,0,0,Hungary
17661,11/1/2020,HUN,Kedah,0,0,0,Hungary
17662,11/1/2020,HUN,Kelantan,0,0,0,Hungary
17663,11/1/2020,HUN,Pahang,0,0,0,Hungary
17664,11/1/2020,HUN,Perak,0,0,0,Hungary
17665,11/1/2020,HUN,Perlis,0,0,0,Hungary
17666,11/1/2020,HUN,Pulau Pinang,0,0,0,Hungary
17667,11/1/2020,HUN,Sabah,0,0,0,Hungary
17668,11/1/2020,HUN,Sarawak,0,0,0,Hungary
17669,11/1/2020,HUN,Selangor,5,5,0,Hungary
17670,11/1/2020,HUN,W.P. Labuan,0,0,0,Hungary
17671,11/1/2020,IDN,Johor,224,195,29,Indonesia
17672,11/1/2020,IDN,Kedah,0,0,0,Indonesia
17673,11/1/2020,IDN,Kelantan,0,0,0,Indonesia
17674,11/1/2020,IDN,Melaka,0,0,0,Indonesia
17675,11/1/2020,IDN,Negeri Sembilan,0,0,0,Indonesia
17676,11/1/2020,IDN,Pahang,0,0,0,Indonesia
17677,11/1/2020,IDN,Perak,0,0,0,Indonesia
17678,11/1/2020,IDN,Perlis,6,5,1,Indonesia
17679,11/1/2020,IDN,Pulau Pinang,4,2,2,Indonesia
17680,11/1/2020,IDN,Sabah,1,0,1,Indonesia
17681,11/1/2020,IDN,Sarawak,362,361,1,Indonesia
17682,11/1/2020,IDN,Selangor,364,251,113,Indonesia
17683,11/1/2020,IDN,Terengganu,0,0,0,Indonesia
17684,11/1/2020,IDN,W.P. Labuan,3,3,0,Indonesia
17685,11/1/2020,IND,Johor,34,34,0,India
17686,11/1/2020,IND,Kedah,0,0,0,India
17687,11/1/2020,IND,Kelantan,0,0,0,India
17688,11/1/2020,IND,Melaka,0,0,0,India
17689,11/1/2020,IND,Negeri Sembilan,0,0,0,India
17690,11/1/2020,IND,Pahang,0,0,0,India
17691,11/1/2020,IND,Perak,0,0,0,India
17692,11/1/2020,IND,Perlis,0,0,0,India
17693,11/1/2020,IND,Pulau Pinang,1,1,0,India
17694,11/1/2020,IND,Sabah,0,0,0,India
17695,11/1/2020,IND,Sarawak,0,0,0,India
17696,11/1/2020,IND,Selangor,392,336,56,India
17697,11/1/2020,IND,Terengganu,0,0,0,India
17698,11/1/2020,IND,W.P. Labuan,0,0,0,India
17699,11/1/2020,IOT,Pulau Pinang,0,0,0,British Indian Ocean Territory
17700,11/1/2020,IOT,Selangor,0,0,0,British Indian Ocean Territory
17701,11/1/2020,IRL,Johor,0,0,0,Ireland
17702,11/1/2020,IRL,Kedah,0,0,0,Ireland
17703,11/1/2020,IRL,Kelantan,0,0,0,Ireland
17704,11/1/2020,IRL,Negeri Sembilan,0,0,0,Ireland
17705,11/1/2020,IRL,Pahang,0,0,0,Ireland
17706,11/1/2020,IRL,Perak,0,0,0,Ireland
17707,11/1/2020,IRL,Perlis,0,0,0,Ireland
17708,11/1/2020,IRL,Pulau Pinang,1,1,0,Ireland
17709,11/1/2020,IRL,Sabah,0,0,0,Ireland
17710,11/1/2020,IRL,Sarawak,0,0,0,Ireland
17711,11/1/2020,IRL,Selangor,16,11,5,Ireland
17712,11/1/2020,IRL,Terengganu,0,0,0,Ireland
17713,11/1/2020,IRL,W.P. Labuan,0,0,0,Ireland
17714,11/1/2020,IRN,Johor,0,0,0,Iran
17715,11/1/2020,IRN,Kedah,0,0,0,Iran
17716,11/1/2020,IRN,Kelantan,0,0,0,Iran
17717,11/1/2020,IRN,Perak,0,0,0,Iran
17718,11/1/2020,IRN,Perlis,0,0,0,Iran
17719,11/1/2020,IRN,Pulau Pinang,0,0,0,Iran
17720,11/1/2020,IRN,Sabah,0,0,0,Iran
17721,11/1/2020,IRN,Sarawak,0,0,0,Iran
17722,11/1/2020,IRN,Selangor,26,13,13,Iran
17723,11/1/2020,IRN,W.P. Labuan,0,0,0,Iran
17724,11/1/2020,IRQ,Johor,0,0,0,Iraq
17725,11/1/2020,IRQ,Kedah,0,0,0,Iraq
17726,11/1/2020,IRQ,Kelantan,0,0,0,Iraq
17727,11/1/2020,IRQ,Melaka,0,0,0,Iraq
17728,11/1/2020,IRQ,Pahang,0,0,0,Iraq
17729,11/1/2020,IRQ,Perak,0,0,0,Iraq
17730,11/1/2020,IRQ,Perlis,0,0,0,Iraq
17731,11/1/2020,IRQ,Pulau Pinang,0,0,0,Iraq
17732,11/1/2020,IRQ,Sabah,0,0,0,Iraq
17733,11/1/2020,IRQ,Sarawak,0,0,0,Iraq
17734,11/1/2020,IRQ,Selangor,11,8,3,Iraq
17735,11/1/2020,ISL,Johor,0,0,0,Iceland
17736,11/1/2020,ISL,Kedah,0,0,0,Iceland
17737,11/1/2020,ISL,Kelantan,0,0,0,Iceland
17738,11/1/2020,ISL,Perak,0,0,0,Iceland
17739,11/1/2020,ISL,Perlis,0,0,0,Iceland
17740,11/1/2020,ISL,Pulau Pinang,0,0,0,Iceland
17741,11/1/2020,ISL,Sabah,0,0,0,Iceland
17742,11/1/2020,ISL,Sarawak,0,0,0,Iceland
17743,11/1/2020,ISL,Selangor,0,0,0,Iceland
17744,11/1/2020,ISL,W.P. Labuan,0,0,0,Iceland
17745,11/1/2020,ISR,Pulau Pinang,0,0,0,Israel
17746,11/1/2020,ITA,Johor,0,0,0,Italy
17747,11/1/2020,ITA,Kedah,0,0,0,Italy
17748,11/1/2020,ITA,Kelantan,0,0,0,Italy
17749,11/1/2020,ITA,Melaka,0,0,0,Italy
17750,11/1/2020,ITA,Negeri Sembilan,0,0,0,Italy
17751,11/1/2020,ITA,Pahang,0,0,0,Italy
17752,11/1/2020,ITA,Perak,0,0,0,Italy
17753,11/1/2020,ITA,Perlis,0,0,0,Italy
17754,11/1/2020,ITA,Pulau Pinang,0,0,0,Italy
17755,11/1/2020,ITA,Sabah,1,1,0,Italy
17756,11/1/2020,ITA,Sarawak,0,0,0,Italy
17757,11/1/2020,ITA,Selangor,17,16,1,Italy
17758,11/1/2020,ITA,W.P. Labuan,0,0,0,Italy
17759,11/1/2020,JAM,Johor,0,0,0,Jamaica
17760,11/1/2020,JAM,Kedah,0,0,0,Jamaica
17761,11/1/2020,JAM,Perak,0,0,0,Jamaica
17762,11/1/2020,JAM,Pulau Pinang,0,0,0,Jamaica
17763,11/1/2020,JAM,Sabah,0,0,0,Jamaica
17764,11/1/2020,JAM,Sarawak,0,0,0,Jamaica
17765,11/1/2020,JAM,Selangor,1,0,1,Jamaica
17766,11/1/2020,JAM,W.P. Labuan,0,0,0,Jamaica
17767,11/1/2020,JOR,Johor,0,0,0,Jordan
17768,11/1/2020,JOR,Kedah,0,0,0,Jordan
17769,11/1/2020,JOR,Kelantan,0,0,0,Jordan
17770,11/1/2020,JOR,Melaka,0,0,0,Jordan
17771,11/1/2020,JOR,Perlis,0,0,0,Jordan
17772,11/1/2020,JOR,Pulau Pinang,0,0,0,Jordan
17773,11/1/2020,JOR,Sabah,0,0,0,Jordan
17774,11/1/2020,JOR,Sarawak,0,0,0,Jordan
17775,11/1/2020,JOR,Selangor,3,3,0,Jordan
17776,11/1/2020,JOR,W.P. Labuan,0,0,0,Jordan
17777,11/1/2020,JPN,Johor,3,3,0,Japan
17778,11/1/2020,JPN,Kedah,0,0,0,Japan
17779,11/1/2020,JPN,Kelantan,0,0,0,Japan
17780,11/1/2020,JPN,Melaka,0,0,0,Japan
17781,11/1/2020,JPN,Negeri Sembilan,0,0,0,Japan
17782,11/1/2020,JPN,Pahang,0,0,0,Japan
17783,11/1/2020,JPN,Perak,0,0,0,Japan
17784,11/1/2020,JPN,Perlis,0,0,0,Japan
17785,11/1/2020,JPN,Pulau Pinang,12,8,4,Japan
17786,11/1/2020,JPN,Sabah,0,0,0,Japan
17787,11/1/2020,JPN,Sarawak,6,5,1,Japan
17788,11/1/2020,JPN,Selangor,342,226,116,Japan
17789,11/1/2020,JPN,W.P. Labuan,0,0,0,Japan
17790,11/1/2020,KAZ,Johor,0,0,0,Kazakhstan
17791,11/1/2020,KAZ,Kedah,0,0,0,Kazakhstan
17792,11/1/2020,KAZ,Kelantan,0,0,0,Kazakhstan
17793,11/1/2020,KAZ,Melaka,0,0,0,Kazakhstan
17794,11/1/2020,KAZ,Perak,0,0,0,Kazakhstan
17795,11/1/2020,KAZ,Perlis,0,0,0,Kazakhstan
17796,11/1/2020,KAZ,Pulau Pinang,0,0,0,Kazakhstan
17797,11/1/2020,KAZ,Sabah,0,0,0,Kazakhstan
17798,11/1/2020,KAZ,Sarawak,0,0,0,Kazakhstan
17799,11/1/2020,KAZ,Selangor,8,4,4,Kazakhstan
17800,11/1/2020,KAZ,W.P. Labuan,0,0,0,Kazakhstan
17801,11/1/2020,KEN,Johor,0,0,0,Kenya
17802,11/1/2020,KEN,Kedah,0,0,0,Kenya
17803,11/1/2020,KEN,Kelantan,0,0,0,Kenya
17804,11/1/2020,KEN,Perak,0,0,0,Kenya
17805,11/1/2020,KEN,Perlis,0,0,0,Kenya
17806,11/1/2020,KEN,Pulau Pinang,0,0,0,Kenya
17807,11/1/2020,KEN,Sabah,0,0,0,Kenya
17808,11/1/2020,KEN,Sarawak,0,0,0,Kenya
17809,11/1/2020,KEN,Selangor,1,1,0,Kenya
17810,11/1/2020,KGZ,Johor,0,0,0,Kyrgyzstan
17811,11/1/2020,KGZ,Kedah,0,0,0,Kyrgyzstan
17812,11/1/2020,KGZ,Kelantan,0,0,0,Kyrgyzstan
17813,11/1/2020,KGZ,Perak,0,0,0,Kyrgyzstan
17814,11/1/2020,KGZ,Perlis,0,0,0,Kyrgyzstan
17815,11/1/2020,KGZ,Pulau Pinang,0,0,0,Kyrgyzstan
17816,11/1/2020,KGZ,Sabah,0,0,0,Kyrgyzstan
17817,11/1/2020,KGZ,Sarawak,0,0,0,Kyrgyzstan
17818,11/1/2020,KGZ,Selangor,1,0,1,Kyrgyzstan
17819,11/1/2020,KHM,Johor,0,0,0,Cambodia
17820,11/1/2020,KHM,Kedah,0,0,0,Cambodia
17821,11/1/2020,KHM,Kelantan,0,0,0,Cambodia
17822,11/1/2020,KHM,Melaka,0,0,0,Cambodia
17823,11/1/2020,KHM,Negeri Sembilan,0,0,0,Cambodia
17824,11/1/2020,KHM,Pahang,0,0,0,Cambodia
17825,11/1/2020,KHM,Perak,0,0,0,Cambodia
17826,11/1/2020,KHM,Perlis,0,0,0,Cambodia
17827,11/1/2020,KHM,Pulau Pinang,0,0,0,Cambodia
17828,11/1/2020,KHM,Sabah,0,0,0,Cambodia
17829,11/1/2020,KHM,Sarawak,0,0,0,Cambodia
17830,11/1/2020,KHM,Selangor,9,3,6,Cambodia
17831,11/1/2020,KHM,W.P. Labuan,0,0,0,Cambodia
17832,11/1/2020,KIR,Johor,0,0,0,Kiribati
17833,11/1/2020,KIR,Sabah,0,0,0,Kiribati
17834,11/1/2020,KIR,Selangor,10,10,0,Kiribati
17835,11/1/2020,KNA,Johor,0,0,0,Saint Kitts and Nevis
17836,11/1/2020,KNA,Kedah,0,0,0,Saint Kitts and Nevis
17837,11/1/2020,KNA,Perlis,0,0,0,Saint Kitts and Nevis
17838,11/1/2020,KNA,Pulau Pinang,0,0,0,Saint Kitts and Nevis
17839,11/1/2020,KNA,Sabah,0,0,0,Saint Kitts and Nevis
17840,11/1/2020,KNA,Selangor,0,0,0,Saint Kitts and Nevis
17841,11/1/2020,KNA,W.P. Labuan,0,0,0,Saint Kitts and Nevis
17842,11/1/2020,KOR,Johor,1,1,0,"Korea, Republic of (South Korea)"
17843,11/1/2020,KOR,Kedah,0,0,0,"Korea, Republic of (South Korea)"
17844,11/1/2020,KOR,Kelantan,0,0,0,"Korea, Republic of (South Korea)"
17845,11/1/2020,KOR,Melaka,0,0,0,"Korea, Republic of (South Korea)"
17846,11/1/2020,KOR,Negeri Sembilan,0,0,0,"Korea, Republic of (South Korea)"
17847,11/1/2020,KOR,Pahang,0,0,0,"Korea, Republic of (South Korea)"
17848,11/1/2020,KOR,Perak,0,0,0,"Korea, Republic of (South Korea)"
17849,11/1/2020,KOR,Perlis,0,0,0,"Korea, Republic of (South Korea)"
17850,11/1/2020,KOR,Pulau Pinang,0,0,0,"Korea, Republic of (South Korea)"
17851,11/1/2020,KOR,Sabah,0,0,0,"Korea, Republic of (South Korea)"
17852,11/1/2020,KOR,Sarawak,9,7,2,"Korea, Republic of (South Korea)"
17853,11/1/2020,KOR,Selangor,225,153,72,"Korea, Republic of (South Korea)"
17854,11/1/2020,KOR,Terengganu,0,0,0,"Korea, Republic of (South Korea)"
17855,11/1/2020,KOR,W.P. Labuan,0,0,0,"Korea, Republic of (South Korea)"
17856,11/1/2020,KWT,Johor,0,0,0,Kuwait
17857,11/1/2020,KWT,Kedah,0,0,0,Kuwait
17858,11/1/2020,KWT,Kelantan,0,0,0,Kuwait
17859,11/1/2020,KWT,Perak,0,0,0,Kuwait
17860,11/1/2020,KWT,Perlis,0,0,0,Kuwait
17861,11/1/2020,KWT,Pulau Pinang,0,0,0,Kuwait
17862,11/1/2020,KWT,Sabah,0,0,0,Kuwait
17863,11/1/2020,KWT,Sarawak,0,0,0,Kuwait
17864,11/1/2020,KWT,Selangor,0,0,0,Kuwait
17865,11/1/2020,KWT,W.P. Labuan,0,0,0,Kuwait
17866,11/1/2020,LAO,Johor,0,0,0,Lao People's Democratic Republic
17867,11/1/2020,LAO,Kedah,0,0,0,Lao People's Democratic Republic
17868,11/1/2020,LAO,Kelantan,0,0,0,Lao People's Democratic Republic
17869,11/1/2020,LAO,Melaka,0,0,0,Lao People's Democratic Republic
17870,11/1/2020,LAO,Perak,0,0,0,Lao People's Democratic Republic
17871,11/1/2020,LAO,Perlis,0,0,0,Lao People's Democratic Republic
17872,11/1/2020,LAO,Pulau Pinang,0,0,0,Lao People's Democratic Republic
17873,11/1/2020,LAO,Sabah,0,0,0,Lao People's Democratic Republic
17874,11/1/2020,LAO,Sarawak,0,0,0,Lao People's Democratic Republic
17875,11/1/2020,LAO,Selangor,3,1,2,Lao People's Democratic Republic
17876,11/1/2020,LAO,W.P. Labuan,0,0,0,Lao People's Democratic Republic
17877,11/1/2020,LBN,Johor,0,0,0,Lebanon
17878,11/1/2020,LBN,Kedah,0,0,0,Lebanon
17879,11/1/2020,LBN,Kelantan,0,0,0,Lebanon
17880,11/1/2020,LBN,Pahang,0,0,0,Lebanon
17881,11/1/2020,LBN,Perak,0,0,0,Lebanon
17882,11/1/2020,LBN,Perlis,0,0,0,Lebanon
17883,11/1/2020,LBN,Pulau Pinang,0,0,0,Lebanon
17884,11/1/2020,LBN,Sabah,0,0,0,Lebanon
17885,11/1/2020,LBN,Sarawak,0,0,0,Lebanon
17886,11/1/2020,LBN,Selangor,2,2,0,Lebanon
17887,11/1/2020,LBN,W.P. Labuan,0,0,0,Lebanon
17888,11/1/2020,LBR,Johor,0,0,0,Liberia
17889,11/1/2020,LBR,Kedah,0,0,0,Liberia
17890,11/1/2020,LBR,Sabah,0,0,0,Liberia
17891,11/1/2020,LBR,Sarawak,0,0,0,Liberia
17892,11/1/2020,LBR,Selangor,1,1,0,Liberia
17893,11/1/2020,LBY,Johor,0,0,0,Libyan Arab Jamahiriya
17894,11/1/2020,LBY,Kedah,0,0,0,Libyan Arab Jamahiriya
17895,11/1/2020,LBY,Perlis,0,0,0,Libyan Arab Jamahiriya
17896,11/1/2020,LBY,Pulau Pinang,0,0,0,Libyan Arab Jamahiriya
17897,11/1/2020,LBY,Sabah,0,0,0,Libyan Arab Jamahiriya
17898,11/1/2020,LBY,Sarawak,0,0,0,Libyan Arab Jamahiriya
17899,11/1/2020,LBY,Selangor,1,0,1,Libyan Arab Jamahiriya
17900,11/1/2020,LCA,Johor,0,0,0,Saint Lucia
17901,11/1/2020,LCA,Kedah,0,0,0,Saint Lucia
17902,11/1/2020,LCA,Pulau Pinang,0,0,0,Saint Lucia
17903,11/1/2020,LCA,Sarawak,0,0,0,Saint Lucia
17904,11/1/2020,LCA,Selangor,0,0,0,Saint Lucia
17905,11/1/2020,LIE,Johor,0,0,0,Liechtenstein
17906,11/1/2020,LIE,Kedah,0,0,0,Liechtenstein
17907,11/1/2020,LIE,Perlis,0,0,0,Liechtenstein
17908,11/1/2020,LIE,Pulau Pinang,0,0,0,Liechtenstein
17909,11/1/2020,LIE,Sabah,0,0,0,Liechtenstein
17910,11/1/2020,LIE,Sarawak,0,0,0,Liechtenstein
17911,11/1/2020,LIE,Selangor,0,0,0,Liechtenstein
17912,11/1/2020,LKA,Johor,0,0,0,Sri Lanka
17913,11/1/2020,LKA,Kedah,0,0,0,Sri Lanka
17914,11/1/2020,LKA,Kelantan,0,0,0,Sri Lanka
17915,11/1/2020,LKA,Melaka,0,0,0,Sri Lanka
17916,11/1/2020,LKA,Pahang,0,0,0,Sri Lanka
17917,11/1/2020,LKA,Perak,0,0,0,Sri Lanka
17918,11/1/2020,LKA,Perlis,0,0,0,Sri Lanka
17919,11/1/2020,LKA,Pulau Pinang,0,0,0,Sri Lanka
17920,11/1/2020,LKA,Sabah,0,0,0,Sri Lanka
17921,11/1/2020,LKA,Sarawak,0,0,0,Sri Lanka
17922,11/1/2020,LKA,Selangor,21,12,9,Sri Lanka
17923,11/1/2020,LKA,W.P. Labuan,0,0,0,Sri Lanka
17924,11/1/2020,LSO,Johor,0,0,0,Lesotho
17925,11/1/2020,LSO,Kedah,0,0,0,Lesotho
17926,11/1/2020,LSO,Pulau Pinang,0,0,0,Lesotho
17927,11/1/2020,LSO,Sarawak,0,0,0,Lesotho
17928,11/1/2020,LSO,Selangor,0,0,0,Lesotho
17929,11/1/2020,LTU,Johor,0,0,0,Lithuania
17930,11/1/2020,LTU,Kedah,0,0,0,Lithuania
17931,11/1/2020,LTU,Kelantan,0,0,0,Lithuania
17932,11/1/2020,LTU,Pahang,0,0,0,Lithuania
17933,11/1/2020,LTU,Perak,0,0,0,Lithuania
17934,11/1/2020,LTU,Perlis,0,0,0,Lithuania
17935,11/1/2020,LTU,Pulau Pinang,0,0,0,Lithuania
17936,11/1/2020,LTU,Sabah,0,0,0,Lithuania
17937,11/1/2020,LTU,Sarawak,0,0,0,Lithuania
17938,11/1/2020,LTU,Selangor,3,3,0,Lithuania
17939,11/1/2020,LTU,W.P. Labuan,0,0,0,Lithuania
17940,11/1/2020,LUX,Johor,0,0,0,Luxembourg
17941,11/1/2020,LUX,Kedah,0,0,0,Luxembourg
17942,11/1/2020,LUX,Kelantan,0,0,0,Luxembourg
17943,11/1/2020,LUX,Perak,0,0,0,Luxembourg
17944,11/1/2020,LUX,Perlis,0,0,0,Luxembourg
17945,11/1/2020,LUX,Pulau Pinang,0,0,0,Luxembourg
17946,11/1/2020,LUX,Sabah,0,0,0,Luxembourg
17947,11/1/2020,LUX,Sarawak,0,0,0,Luxembourg
17948,11/1/2020,LUX,Selangor,0,0,0,Luxembourg
17949,11/1/2020,LVA,Johor,0,0,0,Latvia
17950,11/1/2020,LVA,Kedah,0,0,0,Latvia
17951,11/1/2020,LVA,Kelantan,0,0,0,Latvia
17952,11/1/2020,LVA,Pahang,0,0,0,Latvia
17953,11/1/2020,LVA,Perak,0,0,0,Latvia
17954,11/1/2020,LVA,Perlis,0,0,0,Latvia
17955,11/1/2020,LVA,Pulau Pinang,0,0,0,Latvia
17956,11/1/2020,LVA,Sabah,0,0,0,Latvia
17957,11/1/2020,LVA,Sarawak,0,0,0,Latvia
17958,11/1/2020,LVA,Selangor,2,2,0,Latvia
17959,11/1/2020,LVA,W.P. Labuan,0,0,0,Latvia
17960,11/1/2020,MAC,Johor,0,0,0,Macao
17961,11/1/2020,MAC,Pahang,0,0,0,Macao
17962,11/1/2020,MAC,Perak,0,0,0,Macao
17963,11/1/2020,MAC,Selangor,0,0,0,Macao
17964,11/1/2020,MAC,W.P. Labuan,0,0,0,Macao
17965,11/1/2020,MAR,Johor,0,0,0,Morocco
17966,11/1/2020,MAR,Kedah,0,0,0,Morocco
17967,11/1/2020,MAR,Kelantan,0,0,0,Morocco
17968,11/1/2020,MAR,Melaka,0,0,0,Morocco
17969,11/1/2020,MAR,Pahang,0,0,0,Morocco
17970,11/1/2020,MAR,Perak,0,0,0,Morocco
17971,11/1/2020,MAR,Perlis,0,0,0,Morocco
17972,11/1/2020,MAR,Pulau Pinang,0,0,0,Morocco
17973,11/1/2020,MAR,Sabah,0,0,0,Morocco
17974,11/1/2020,MAR,Sarawak,0,0,0,Morocco
17975,11/1/2020,MAR,Selangor,7,3,4,Morocco
17976,11/1/2020,MAR,W.P. Labuan,0,0,0,Morocco
17977,11/1/2020,MCO,Johor,0,0,0,Monaco
17978,11/1/2020,MCO,Kedah,0,0,0,Monaco
17979,11/1/2020,MCO,Sabah,0,0,0,Monaco
17980,11/1/2020,MCO,Selangor,0,0,0,Monaco
17981,11/1/2020,MDA,Johor,0,0,0,"Moldova, Republic of"
17982,11/1/2020,MDA,Kedah,0,0,0,"Moldova, Republic of"
17983,11/1/2020,MDA,Kelantan,0,0,0,"Moldova, Republic of"
17984,11/1/2020,MDA,Negeri Sembilan,0,0,0,"Moldova, Republic of"
17985,11/1/2020,MDA,Perlis,0,0,0,"Moldova, Republic of"
17986,11/1/2020,MDA,Pulau Pinang,0,0,0,"Moldova, Republic of"
17987,11/1/2020,MDA,Sabah,0,0,0,"Moldova, Republic of"
17988,11/1/2020,MDA,Sarawak,0,0,0,"Moldova, Republic of"
17989,11/1/2020,MDA,Selangor,0,0,0,"Moldova, Republic of"
17990,11/1/2020,MDG,Johor,0,0,0,Madagascar
17991,11/1/2020,MDG,Kedah,0,0,0,Madagascar
17992,11/1/2020,MDG,Perak,0,0,0,Madagascar
17993,11/1/2020,MDG,Perlis,0,0,0,Madagascar
17994,11/1/2020,MDG,Pulau Pinang,0,0,0,Madagascar
17995,11/1/2020,MDG,Sabah,0,0,0,Madagascar
17996,11/1/2020,MDG,Sarawak,0,0,0,Madagascar
17997,11/1/2020,MDG,Selangor,0,0,0,Madagascar
17998,11/1/2020,MDV,Johor,0,0,0,Maldives
17999,11/1/2020,MDV,Kedah,0,0,0,Maldives
18000,11/1/2020,MDV,Kelantan,0,0,0,Maldives
18001,11/1/2020,MDV,Perak,0,0,0,Maldives
18002,11/1/2020,MDV,Perlis,0,0,0,Maldives
18003,11/1/2020,MDV,Pulau Pinang,0,0,0,Maldives
18004,11/1/2020,MDV,Sabah,0,0,0,Maldives
18005,11/1/2020,MDV,Sarawak,0,0,0,Maldives
18006,11/1/2020,MDV,Selangor,16,12,4,Maldives
18007,11/1/2020,MEX,Johor,0,0,0,Mexico
18008,11/1/2020,MEX,Kedah,0,0,0,Mexico
18009,11/1/2020,MEX,Kelantan,0,0,0,Mexico
18010,11/1/2020,MEX,Pahang,0,0,0,Mexico
18011,11/1/2020,MEX,Perak,0,0,0,Mexico
18012,11/1/2020,MEX,Perlis,0,0,0,Mexico
18013,11/1/2020,MEX,Pulau Pinang,0,0,0,Mexico
18014,11/1/2020,MEX,Sabah,0,0,0,Mexico
18015,11/1/2020,MEX,Sarawak,0,0,0,Mexico
18016,11/1/2020,MEX,Selangor,6,4,2,Mexico
18017,11/1/2020,MEX,W.P. Labuan,0,0,0,Mexico
18018,11/1/2020,MHL,Johor,0,0,0,Marshall Islands
18019,11/1/2020,MHL,Kedah,0,0,0,Marshall Islands
18020,11/1/2020,MHL,Perak,0,0,0,Marshall Islands
18021,11/1/2020,MHL,Pulau Pinang,0,0,0,Marshall Islands
18022,11/1/2020,MHL,Sabah,0,0,0,Marshall Islands
18023,11/1/2020,MHL,Selangor,0,0,0,Marshall Islands
18024,11/1/2020,MKD,Johor,0,0,0,"Macedonia, the former Yugoslav Republic of"
18025,11/1/2020,MKD,Kedah,0,0,0,"Macedonia, the former Yugoslav Republic of"
18026,11/1/2020,MKD,Perak,0,0,0,"Macedonia, the former Yugoslav Republic of"
18027,11/1/2020,MKD,Pulau Pinang,0,0,0,"Macedonia, the former Yugoslav Republic of"
18028,11/1/2020,MKD,Sabah,0,0,0,"Macedonia, the former Yugoslav Republic of"
18029,11/1/2020,MKD,Sarawak,0,0,0,"Macedonia, the former Yugoslav Republic of"
18030,11/1/2020,MKD,Selangor,0,0,0,"Macedonia, the former Yugoslav Republic of"
18031,11/1/2020,MLI,Johor,0,0,0,Mali
18032,11/1/2020,MLI,Sabah,0,0,0,Mali
18033,11/1/2020,MLI,Selangor,0,0,0,Mali
18034,11/1/2020,MLT,Johor,0,0,0,Malta
18035,11/1/2020,MLT,Kedah,0,0,0,Malta
18036,11/1/2020,MLT,Kelantan,0,0,0,Malta
18037,11/1/2020,MLT,Perak,0,0,0,Malta
18038,11/1/2020,MLT,Perlis,0,0,0,Malta
18039,11/1/2020,MLT,Pulau Pinang,0,0,0,Malta
18040,11/1/2020,MLT,Sabah,0,0,0,Malta
18041,11/1/2020,MLT,Sarawak,0,0,0,Malta
18042,11/1/2020,MLT,Selangor,0,0,0,Malta
18043,11/1/2020,MLT,W.P. Labuan,0,0,0,Malta
18044,11/1/2020,MMR,Johor,39,39,0,Myanmar
18045,11/1/2020,MMR,Kedah,0,0,0,Myanmar
18046,11/1/2020,MMR,Kelantan,0,0,0,Myanmar
18047,11/1/2020,MMR,Negeri Sembilan,0,0,0,Myanmar
18048,11/1/2020,MMR,Pahang,0,0,0,Myanmar
18049,11/1/2020,MMR,Perak,0,0,0,Myanmar
18050,11/1/2020,MMR,Perlis,0,0,0,Myanmar
18051,11/1/2020,MMR,Pulau Pinang,0,0,0,Myanmar
18052,11/1/2020,MMR,Sabah,0,0,0,Myanmar
18053,11/1/2020,MMR,Sarawak,0,0,0,Myanmar
18054,11/1/2020,MMR,Selangor,122,104,18,Myanmar
18055,11/1/2020,MMR,Terengganu,0,0,0,Myanmar
18056,11/1/2020,MMR,W.P. Labuan,0,0,0,Myanmar
18057,11/1/2020,MNE,Johor,0,0,0,Montenegro
18058,11/1/2020,MNE,Kedah,0,0,0,Montenegro
18059,11/1/2020,MNE,Pulau Pinang,0,0,0,Montenegro
18060,11/1/2020,MNE,Sabah,0,0,0,Montenegro
18061,11/1/2020,MNE,Sarawak,0,0,0,Montenegro
18062,11/1/2020,MNE,Selangor,1,1,0,Montenegro
18063,11/1/2020,MNG,Johor,0,0,0,Mongolia
18064,11/1/2020,MNG,Kedah,0,0,0,Mongolia
18065,11/1/2020,MNG,Kelantan,0,0,0,Mongolia
18066,11/1/2020,MNG,Perak,0,0,0,Mongolia
18067,11/1/2020,MNG,Perlis,0,0,0,Mongolia
18068,11/1/2020,MNG,Pulau Pinang,0,0,0,Mongolia
18069,11/1/2020,MNG,Sabah,0,0,0,Mongolia
18070,11/1/2020,MNG,Sarawak,0,0,0,Mongolia
18071,11/1/2020,MNG,Selangor,2,0,2,Mongolia
18072,11/1/2020,MNP,Selangor,0,0,0,Northern Mariana Islands
18073,11/1/2020,MOZ,Johor,0,0,0,Mozambique
18074,11/1/2020,MOZ,Kedah,0,0,0,Mozambique
18075,11/1/2020,MOZ,Perak,0,0,0,Mozambique
18076,11/1/2020,MOZ,Pulau Pinang,0,0,0,Mozambique
18077,11/1/2020,MOZ,Sabah,0,0,0,Mozambique
18078,11/1/2020,MOZ,Sarawak,0,0,0,Mozambique
18079,11/1/2020,MOZ,Selangor,0,0,0,Mozambique
18080,11/1/2020,MRT,Johor,0,0,0,Mauritania
18081,11/1/2020,MRT,Kedah,0,0,0,Mauritania
18082,11/1/2020,MRT,Pulau Pinang,0,0,0,Mauritania
18083,11/1/2020,MRT,Sabah,0,0,0,Mauritania
18084,11/1/2020,MRT,Sarawak,0,0,0,Mauritania
18085,11/1/2020,MRT,Selangor,0,0,0,Mauritania
18086,11/1/2020,MUS,Johor,1,1,0,Mauritius
18087,11/1/2020,MUS,Kedah,0,0,0,Mauritius
18088,11/1/2020,MUS,Kelantan,0,0,0,Mauritius
18089,11/1/2020,MUS,Pahang,0,0,0,Mauritius
18090,11/1/2020,MUS,Perak,0,0,0,Mauritius
18091,11/1/2020,MUS,Perlis,0,0,0,Mauritius
18092,11/1/2020,MUS,Pulau Pinang,0,0,0,Mauritius
18093,11/1/2020,MUS,Sabah,0,0,0,Mauritius
18094,11/1/2020,MUS,Sarawak,0,0,0,Mauritius
18095,11/1/2020,MUS,Selangor,5,3,2,Mauritius
18096,11/1/2020,MWI,Johor,0,0,0,Malawi
18097,11/1/2020,MWI,Pulau Pinang,0,0,0,Malawi
18098,11/1/2020,MWI,Sabah,0,0,0,Malawi
18099,11/1/2020,MWI,Sarawak,0,0,0,Malawi
18100,11/1/2020,MWI,Selangor,1,1,0,Malawi
18101,11/1/2020,MYT,Selangor,0,0,0,Mayotte
18102,11/1/2020,NAM,Johor,0,0,0,Namibia
18103,11/1/2020,NAM,Kedah,0,0,0,Namibia
18104,11/1/2020,NAM,Perak,0,0,0,Namibia
18105,11/1/2020,NAM,Perlis,0,0,0,Namibia
18106,11/1/2020,NAM,Pulau Pinang,0,0,0,Namibia
18107,11/1/2020,NAM,Sabah,0,0,0,Namibia
18108,11/1/2020,NAM,Sarawak,0,0,0,Namibia
18109,11/1/2020,NAM,Selangor,0,0,0,Namibia
18110,11/1/2020,NCL,Selangor,0,0,0,New Caledonia
18111,11/1/2020,NER,Johor,0,0,0,Niger
18112,11/1/2020,NER,Sabah,0,0,0,Niger
18113,11/1/2020,NER,Selangor,0,0,0,Niger
18114,11/1/2020,NGA,Johor,0,0,0,Nigeria
18115,11/1/2020,NGA,Kedah,0,0,0,Nigeria
18116,11/1/2020,NGA,Perlis,0,0,0,Nigeria
18117,11/1/2020,NGA,Pulau Pinang,0,0,0,Nigeria
18118,11/1/2020,NGA,Sabah,0,0,0,Nigeria
18119,11/1/2020,NGA,Sarawak,0,0,0,Nigeria
18120,11/1/2020,NGA,Selangor,64,55,9,Nigeria
18121,11/1/2020,NIC,Johor,0,0,0,Nicaragua
18122,11/1/2020,NIC,Kedah,0,0,0,Nicaragua
18123,11/1/2020,NIC,Pulau Pinang,0,0,0,Nicaragua
18124,11/1/2020,NIC,Sabah,0,0,0,Nicaragua
18125,11/1/2020,NIC,Selangor,0,0,0,Nicaragua
18126,11/1/2020,NLD,Johor,1,1,0,Netherlands
18127,11/1/2020,NLD,Kedah,0,0,0,Netherlands
18128,11/1/2020,NLD,Kelantan,0,0,0,Netherlands
18129,11/1/2020,NLD,Melaka,0,0,0,Netherlands
18130,11/1/2020,NLD,Negeri Sembilan,0,0,0,Netherlands
18131,11/1/2020,NLD,Pahang,0,0,0,Netherlands
18132,11/1/2020,NLD,Perak,0,0,0,Netherlands
18133,11/1/2020,NLD,Perlis,0,0,0,Netherlands
18134,11/1/2020,NLD,Pulau Pinang,5,4,1,Netherlands
18135,11/1/2020,NLD,Sabah,0,0,0,Netherlands
18136,11/1/2020,NLD,Sarawak,0,0,0,Netherlands
18137,11/1/2020,NLD,Selangor,47,41,6,Netherlands
18138,11/1/2020,NLD,Terengganu,0,0,0,Netherlands
18139,11/1/2020,NLD,W.P. Labuan,0,0,0,Netherlands
18140,11/1/2020,NOR,Johor,0,0,0,Norway
18141,11/1/2020,NOR,Kedah,0,0,0,Norway
18142,11/1/2020,NOR,Kelantan,0,0,0,Norway
18143,11/1/2020,NOR,Melaka,0,0,0,Norway
18144,11/1/2020,NOR,Pahang,0,0,0,Norway
18145,11/1/2020,NOR,Perak,0,0,0,Norway
18146,11/1/2020,NOR,Perlis,0,0,0,Norway
18147,11/1/2020,NOR,Pulau Pinang,0,0,0,Norway
18148,11/1/2020,NOR,Sabah,0,0,0,Norway
18149,11/1/2020,NOR,Sarawak,0,0,0,Norway
18150,11/1/2020,NOR,Selangor,13,12,1,Norway
18151,11/1/2020,NOR,W.P. Labuan,0,0,0,Norway
18152,11/1/2020,NPL,Johor,0,0,0,Nepal
18153,11/1/2020,NPL,Kedah,0,0,0,Nepal
18154,11/1/2020,NPL,Pahang,0,0,0,Nepal
18155,11/1/2020,NPL,Perak,0,0,0,Nepal
18156,11/1/2020,NPL,Perlis,0,0,0,Nepal
18157,11/1/2020,NPL,Pulau Pinang,0,0,0,Nepal
18158,11/1/2020,NPL,Sabah,0,0,0,Nepal
18159,11/1/2020,NPL,Sarawak,0,0,0,Nepal
18160,11/1/2020,NPL,Selangor,163,159,4,Nepal
18161,11/1/2020,NPL,W.P. Labuan,0,0,0,Nepal
18162,11/1/2020,NRU,Johor,0,0,0,Nauru
18163,11/1/2020,NRU,Pulau Pinang,0,0,0,Nauru
18164,11/1/2020,NRU,Selangor,0,0,0,Nauru
18165,11/1/2020,NZL,Johor,3,3,0,New Zealand
18166,11/1/2020,NZL,Kedah,0,0,0,New Zealand
18167,11/1/2020,NZL,Kelantan,0,0,0,New Zealand
18168,11/1/2020,NZL,Melaka,0,0,0,New Zealand
18169,11/1/2020,NZL,Negeri Sembilan,0,0,0,New Zealand
18170,11/1/2020,NZL,Pahang,0,0,0,New Zealand
18171,11/1/2020,NZL,Perak,0,0,0,New Zealand
18172,11/1/2020,NZL,Perlis,0,0,0,New Zealand
18173,11/1/2020,NZL,Pulau Pinang,1,1,0,New Zealand
18174,11/1/2020,NZL,Sabah,0,0,0,New Zealand
18175,11/1/2020,NZL,Sarawak,0,0,0,New Zealand
18176,11/1/2020,NZL,Selangor,19,16,3,New Zealand
18177,11/1/2020,NZL,Terengganu,0,0,0,New Zealand
18178,11/1/2020,NZL,W.P. Labuan,0,0,0,New Zealand
18179,11/1/2020,OMN,Johor,0,0,0,Oman
18180,11/1/2020,OMN,Kedah,0,0,0,Oman
18181,11/1/2020,OMN,Kelantan,0,0,0,Oman
18182,11/1/2020,OMN,Melaka,0,0,0,Oman
18183,11/1/2020,OMN,Perak,0,0,0,Oman
18184,11/1/2020,OMN,Perlis,0,0,0,Oman
18185,11/1/2020,OMN,Pulau Pinang,0,0,0,Oman
18186,11/1/2020,OMN,Sabah,0,0,0,Oman
18187,11/1/2020,OMN,Sarawak,0,0,0,Oman
18188,11/1/2020,OMN,Selangor,16,12,4,Oman
18189,11/1/2020,PAK,Johor,0,0,0,Pakistan
18190,11/1/2020,PAK,Kedah,0,0,0,Pakistan
18191,11/1/2020,PAK,Kelantan,0,0,0,Pakistan
18192,11/1/2020,PAK,Melaka,0,0,0,Pakistan
18193,11/1/2020,PAK,Negeri Sembilan,0,0,0,Pakistan
18194,11/1/2020,PAK,Pahang,0,0,0,Pakistan
18195,11/1/2020,PAK,Perak,0,0,0,Pakistan
18196,11/1/2020,PAK,Perlis,0,0,0,Pakistan
18197,11/1/2020,PAK,Pulau Pinang,0,0,0,Pakistan
18198,11/1/2020,PAK,Sabah,0,0,0,Pakistan
18199,11/1/2020,PAK,Sarawak,1,1,0,Pakistan
18200,11/1/2020,PAK,Selangor,73,69,4,Pakistan
18201,11/1/2020,PAK,W.P. Labuan,0,0,0,Pakistan
18202,11/1/2020,PAN,Johor,0,0,0,Panama
18203,11/1/2020,PAN,Kedah,0,0,0,Panama
18204,11/1/2020,PAN,Perak,0,0,0,Panama
18205,11/1/2020,PAN,Perlis,0,0,0,Panama
18206,11/1/2020,PAN,Pulau Pinang,0,0,0,Panama
18207,11/1/2020,PAN,Sabah,0,0,0,Panama
18208,11/1/2020,PAN,Sarawak,0,0,0,Panama
18209,11/1/2020,PAN,Selangor,0,0,0,Panama
18210,11/1/2020,PER,Johor,0,0,0,Peru
18211,11/1/2020,PER,Kedah,0,0,0,Peru
18212,11/1/2020,PER,Kelantan,0,0,0,Peru
18213,11/1/2020,PER,Pahang,0,0,0,Peru
18214,11/1/2020,PER,Perak,0,0,0,Peru
18215,11/1/2020,PER,Perlis,0,0,0,Peru
18216,11/1/2020,PER,Pulau Pinang,0,0,0,Peru
18217,11/1/2020,PER,Sabah,0,0,0,Peru
18218,11/1/2020,PER,Sarawak,0,0,0,Peru
18219,11/1/2020,PER,Selangor,1,1,0,Peru
18220,11/1/2020,PER,W.P. Labuan,0,0,0,Peru
18221,11/1/2020,PHL,Johor,45,42,3,Philippines
18222,11/1/2020,PHL,Kedah,0,0,0,Philippines
18223,11/1/2020,PHL,Kelantan,0,0,0,Philippines
18224,11/1/2020,PHL,Melaka,0,0,0,Philippines
18225,11/1/2020,PHL,Negeri Sembilan,0,0,0,Philippines
18226,11/1/2020,PHL,Pahang,0,0,0,Philippines
18227,11/1/2020,PHL,Perak,1,1,0,Philippines
18228,11/1/2020,PHL,Perlis,0,0,0,Philippines
18229,11/1/2020,PHL,Pulau Pinang,0,0,0,Philippines
18230,11/1/2020,PHL,Sabah,0,0,0,Philippines
18231,11/1/2020,PHL,Sarawak,62,62,0,Philippines
18232,11/1/2020,PHL,Selangor,261,227,34,Philippines
18233,11/1/2020,PHL,Terengganu,0,0,0,Philippines
18234,11/1/2020,PHL,W.P. Labuan,5,5,0,Philippines
18235,11/1/2020,PLW,Johor,0,0,0,Palau
18236,11/1/2020,PLW,Pulau Pinang,0,0,0,Palau
18237,11/1/2020,PLW,Selangor,0,0,0,Palau
18238,11/1/2020,PNG,Johor,0,0,0,Papua New Guinea
18239,11/1/2020,PNG,Kedah,0,0,0,Papua New Guinea
18240,11/1/2020,PNG,Kelantan,0,0,0,Papua New Guinea
18241,11/1/2020,PNG,Perak,0,0,0,Papua New Guinea
18242,11/1/2020,PNG,Pulau Pinang,0,0,0,Papua New Guinea
18243,11/1/2020,PNG,Sabah,0,0,0,Papua New Guinea
18244,11/1/2020,PNG,Sarawak,0,0,0,Papua New Guinea
18245,11/1/2020,PNG,Selangor,0,0,0,Papua New Guinea
18246,11/1/2020,POL,Johor,0,0,0,Poland
18247,11/1/2020,POL,Kedah,0,0,0,Poland
18248,11/1/2020,POL,Kelantan,0,0,0,Poland
18249,11/1/2020,POL,Melaka,0,0,0,Poland
18250,11/1/2020,POL,Negeri Sembilan,0,0,0,Poland
18251,11/1/2020,POL,Pahang,0,0,0,Poland
18252,11/1/2020,POL,Perak,0,0,0,Poland
18253,11/1/2020,POL,Perlis,0,0,0,Poland
18254,11/1/2020,POL,Pulau Pinang,0,0,0,Poland
18255,11/1/2020,POL,Sabah,0,0,0,Poland
18256,11/1/2020,POL,Sarawak,0,0,0,Poland
18257,11/1/2020,POL,Selangor,19,18,1,Poland
18258,11/1/2020,POL,Terengganu,0,0,0,Poland
18259,11/1/2020,POL,W.P. Labuan,0,0,0,Poland
18260,11/1/2020,PRK,Selangor,0,0,0,"Korea, Democratic People's Republic of"
18261,11/1/2020,PRT,Johor,1,1,0,Portugal
18262,11/1/2020,PRT,Kedah,0,0,0,Portugal
18263,11/1/2020,PRT,Kelantan,0,0,0,Portugal
18264,11/1/2020,PRT,Melaka,0,0,0,Portugal
18265,11/1/2020,PRT,Pahang,0,0,0,Portugal
18266,11/1/2020,PRT,Perak,0,0,0,Portugal
18267,11/1/2020,PRT,Perlis,0,0,0,Portugal
18268,11/1/2020,PRT,Pulau Pinang,0,0,0,Portugal
18269,11/1/2020,PRT,Sabah,0,0,0,Portugal
18270,11/1/2020,PRT,Sarawak,0,0,0,Portugal
18271,11/1/2020,PRT,Selangor,8,5,3,Portugal
18272,11/1/2020,PRT,W.P. Labuan,0,0,0,Portugal
18273,11/1/2020,PRY,Johor,0,0,0,Paraguay
18274,11/1/2020,PRY,Kedah,0,0,0,Paraguay
18275,11/1/2020,PRY,Perak,0,0,0,Paraguay
18276,11/1/2020,PRY,Perlis,0,0,0,Paraguay
18277,11/1/2020,PRY,Pulau Pinang,0,0,0,Paraguay
18278,11/1/2020,PRY,Sabah,0,0,0,Paraguay
18279,11/1/2020,PRY,Sarawak,0,0,0,Paraguay
18280,11/1/2020,PRY,Selangor,0,0,0,Paraguay
18281,11/1/2020,PSE,Johor,0,0,0,"Palestinian Territory, Occupied"
18282,11/1/2020,PSE,Kedah,0,0,0,"Palestinian Territory, Occupied"
18283,11/1/2020,PSE,Kelantan,0,0,0,"Palestinian Territory, Occupied"
18284,11/1/2020,PSE,Melaka,0,0,0,"Palestinian Territory, Occupied"
18285,11/1/2020,PSE,Perak,0,0,0,"Palestinian Territory, Occupied"
18286,11/1/2020,PSE,Perlis,0,0,0,"Palestinian Territory, Occupied"
18287,11/1/2020,PSE,Pulau Pinang,0,0,0,"Palestinian Territory, Occupied"
18288,11/1/2020,PSE,Sabah,0,0,0,"Palestinian Territory, Occupied"
18289,11/1/2020,PSE,Sarawak,0,0,0,"Palestinian Territory, Occupied"
18290,11/1/2020,PSE,Selangor,3,1,2,"Palestinian Territory, Occupied"
18291,11/1/2020,QAT,Johor,0,0,0,Qatar
18292,11/1/2020,QAT,Kedah,0,0,0,Qatar
18293,11/1/2020,QAT,Perlis,0,0,0,Qatar
18294,11/1/2020,QAT,Pulau Pinang,0,0,0,Qatar
18295,11/1/2020,QAT,Sabah,0,0,0,Qatar
18296,11/1/2020,QAT,Sarawak,0,0,0,Qatar
18297,11/1/2020,QAT,Selangor,2,2,0,Qatar
18298,11/1/2020,REU,Johor,0,0,0,Reunion
18299,11/1/2020,REU,Sarawak,0,0,0,Reunion
18300,11/1/2020,ROU,Johor,0,0,0,Romania
18301,11/1/2020,ROU,Kedah,0,0,0,Romania
18302,11/1/2020,ROU,Kelantan,0,0,0,Romania
18303,11/1/2020,ROU,Negeri Sembilan,0,0,0,Romania
18304,11/1/2020,ROU,Pahang,0,0,0,Romania
18305,11/1/2020,ROU,Perak,0,0,0,Romania
18306,11/1/2020,ROU,Perlis,0,0,0,Romania
18307,11/1/2020,ROU,Pulau Pinang,0,0,0,Romania
18308,11/1/2020,ROU,Sabah,0,0,0,Romania
18309,11/1/2020,ROU,Sarawak,0,0,0,Romania
18310,11/1/2020,ROU,Selangor,15,15,0,Romania
18311,11/1/2020,ROU,W.P. Labuan,0,0,0,Romania
18312,11/1/2020,RUS,Johor,1,1,0,Russia
18313,11/1/2020,RUS,Kedah,0,0,0,Russia
18314,11/1/2020,RUS,Kelantan,0,0,0,Russia
18315,11/1/2020,RUS,Melaka,0,0,0,Russia
18316,11/1/2020,RUS,Negeri Sembilan,0,0,0,Russia
18317,11/1/2020,RUS,Pahang,0,0,0,Russia
18318,11/1/2020,RUS,Perak,0,0,0,Russia
18319,11/1/2020,RUS,Perlis,0,0,0,Russia
18320,11/1/2020,RUS,Pulau Pinang,0,0,0,Russia
18321,11/1/2020,RUS,Sabah,0,0,0,Russia
18322,11/1/2020,RUS,Sarawak,0,0,0,Russia
18323,11/1/2020,RUS,Selangor,53,47,6,Russia
18324,11/1/2020,RUS,W.P. Labuan,0,0,0,Russia
18325,11/1/2020,RWA,Johor,0,0,0,Rwanda
18326,11/1/2020,RWA,Kedah,0,0,0,Rwanda
18327,11/1/2020,RWA,Pulau Pinang,0,0,0,Rwanda
18328,11/1/2020,RWA,Selangor,0,0,0,Rwanda
18329,11/1/2020,SAU,Johor,0,0,0,Saudi Arabia
18330,11/1/2020,SAU,Kedah,0,0,0,Saudi Arabia
18331,11/1/2020,SAU,Kelantan,0,0,0,Saudi Arabia
18332,11/1/2020,SAU,Melaka,0,0,0,Saudi Arabia
18333,11/1/2020,SAU,Perak,0,0,0,Saudi Arabia
18334,11/1/2020,SAU,Perlis,0,0,0,Saudi Arabia
18335,11/1/2020,SAU,Pulau Pinang,0,0,0,Saudi Arabia
18336,11/1/2020,SAU,Sabah,0,0,0,Saudi Arabia
18337,11/1/2020,SAU,Sarawak,0,0,0,Saudi Arabia
18338,11/1/2020,SAU,Selangor,28,16,12,Saudi Arabia
18339,11/1/2020,SAU,W.P. Labuan,0,0,0,Saudi Arabia
18340,11/1/2020,SDN,Johor,0,0,0,Sudan
18341,11/1/2020,SDN,Kedah,0,0,0,Sudan
18342,11/1/2020,SDN,Kelantan,0,0,0,Sudan
18343,11/1/2020,SDN,Perlis,0,0,0,Sudan
18344,11/1/2020,SDN,Pulau Pinang,0,0,0,Sudan
18345,11/1/2020,SDN,Sabah,0,0,0,Sudan
18346,11/1/2020,SDN,Sarawak,0,0,0,Sudan
18347,11/1/2020,SDN,Selangor,5,4,1,Sudan
18348,11/1/2020,SDN,W.P. Labuan,0,0,0,Sudan
18349,11/1/2020,SEN,Johor,0,0,0,Senegal
18350,11/1/2020,SEN,Kedah,0,0,0,Senegal
18351,11/1/2020,SEN,Kelantan,0,0,0,Senegal
18352,11/1/2020,SEN,Perak,0,0,0,Senegal
18353,11/1/2020,SEN,Perlis,0,0,0,Senegal
18354,11/1/2020,SEN,Pulau Pinang,0,0,0,Senegal
18355,11/1/2020,SEN,Sabah,0,0,0,Senegal
18356,11/1/2020,SEN,Sarawak,0,0,0,Senegal
18357,11/1/2020,SEN,Selangor,2,1,1,Senegal
18358,11/1/2020,SGP,Johor,467,400,67,Singapore
18359,11/1/2020,SGP,Kedah,1,1,0,Singapore
18360,11/1/2020,SGP,Kelantan,3,2,1,Singapore
18361,11/1/2020,SGP,Melaka,0,0,0,Singapore
18362,11/1/2020,SGP,Negeri Sembilan,0,0,0,Singapore
18363,11/1/2020,SGP,Pahang,0,0,0,Singapore
18364,11/1/2020,SGP,Perak,6,3,3,Singapore
18365,11/1/2020,SGP,Perlis,0,0,0,Singapore
18366,11/1/2020,SGP,Pulau Pinang,37,28,9,Singapore
18367,11/1/2020,SGP,Sabah,0,0,0,Singapore
18368,11/1/2020,SGP,Sarawak,15,11,4,Singapore
18369,11/1/2020,SGP,Selangor,211,147,64,Singapore
18370,11/1/2020,SGP,Terengganu,0,0,0,Singapore
18371,11/1/2020,SGP,W.P. Labuan,0,0,0,Singapore
18372,11/1/2020,SGS,Johor,0,0,0,South Georgia and the South Sandwich Islands
18373,11/1/2020,SGS,Sabah,0,0,0,South Georgia and the South Sandwich Islands
18374,11/1/2020,SGS,Selangor,0,0,0,South Georgia and the South Sandwich Islands
18375,11/1/2020,SHN,Sarawak,0,0,0,"Saint Helena, Ascension and Tristan da Cunha"
18376,11/1/2020,SLB,Johor,0,0,0,Solomon Islands
18377,11/1/2020,SLB,Perlis,0,0,0,Solomon Islands
18378,11/1/2020,SLB,Pulau Pinang,0,0,0,Solomon Islands
18379,11/1/2020,SLB,Sabah,0,0,0,Solomon Islands
18380,11/1/2020,SLB,Sarawak,0,0,0,Solomon Islands
18381,11/1/2020,SLB,Selangor,0,0,0,Solomon Islands
18382,11/1/2020,SLB,W.P. Labuan,0,0,0,Solomon Islands
18383,11/1/2020,SLE,Johor,0,0,0,Sierra Leone
18384,11/1/2020,SLE,Kedah,0,0,0,Sierra Leone
18385,11/1/2020,SLE,Perak,0,0,0,Sierra Leone
18386,11/1/2020,SLE,Pulau Pinang,0,0,0,Sierra Leone
18387,11/1/2020,SLE,Sabah,0,0,0,Sierra Leone
18388,11/1/2020,SLE,Selangor,0,0,0,Sierra Leone
18389,11/1/2020,SLV,Johor,0,0,0,El Salvador
18390,11/1/2020,SLV,Kedah,0,0,0,El Salvador
18391,11/1/2020,SLV,Perak,0,0,0,El Salvador
18392,11/1/2020,SLV,Perlis,0,0,0,El Salvador
18393,11/1/2020,SLV,Pulau Pinang,0,0,0,El Salvador
18394,11/1/2020,SLV,Sabah,0,0,0,El Salvador
18395,11/1/2020,SLV,Selangor,0,0,0,El Salvador
18396,11/1/2020,SLV,W.P. Labuan,0,0,0,El Salvador
18397,11/1/2020,SMR,Johor,0,0,0,San Marino
18398,11/1/2020,SMR,Selangor,0,0,0,San Marino
18399,11/1/2020,SOM,Johor,0,0,0,Somalia
18400,11/1/2020,SOM,Kedah,0,0,0,Somalia
18401,11/1/2020,SOM,Kelantan,0,0,0,Somalia
18402,11/1/2020,SOM,Perlis,0,0,0,Somalia
18403,11/1/2020,SOM,Sabah,0,0,0,Somalia
18404,11/1/2020,SOM,Sarawak,0,0,0,Somalia
18405,11/1/2020,SOM,Selangor,1,0,1,Somalia
18406,11/1/2020,SRB,Johor,0,0,0,Serbia
18407,11/1/2020,SRB,Kedah,0,0,0,Serbia
18408,11/1/2020,SRB,Kelantan,0,0,0,Serbia
18409,11/1/2020,SRB,Pahang,0,0,0,Serbia
18410,11/1/2020,SRB,Perak,0,0,0,Serbia
18411,11/1/2020,SRB,Perlis,0,0,0,Serbia
18412,11/1/2020,SRB,Pulau Pinang,0,0,0,Serbia
18413,11/1/2020,SRB,Sabah,0,0,0,Serbia
18414,11/1/2020,SRB,Sarawak,0,0,0,Serbia
18415,11/1/2020,SRB,Selangor,1,1,0,Serbia
18416,11/1/2020,STP,Selangor,0,0,0,Sao Tome and Principe
18417,11/1/2020,SUR,Johor,0,0,0,Suriname
18418,11/1/2020,SUR,Kedah,0,0,0,Suriname
18419,11/1/2020,SUR,Kelantan,0,0,0,Suriname
18420,11/1/2020,SUR,Perak,0,0,0,Suriname
18421,11/1/2020,SUR,Perlis,0,0,0,Suriname
18422,11/1/2020,SUR,Pulau Pinang,0,0,0,Suriname
18423,11/1/2020,SUR,Sabah,0,0,0,Suriname
18424,11/1/2020,SUR,Sarawak,0,0,0,Suriname
18425,11/1/2020,SUR,Selangor,0,0,0,Suriname
18426,11/1/2020,SVK,Johor,0,0,0,Slovakia
18427,11/1/2020,SVK,Kedah,0,0,0,Slovakia
18428,11/1/2020,SVK,Kelantan,0,0,0,Slovakia
18429,11/1/2020,SVK,Negeri Sembilan,0,0,0,Slovakia
18430,11/1/2020,SVK,Pahang,0,0,0,Slovakia
18431,11/1/2020,SVK,Perak,0,0,0,Slovakia
18432,11/1/2020,SVK,Perlis,0,0,0,Slovakia
18433,11/1/2020,SVK,Pulau Pinang,0,0,0,Slovakia
18434,11/1/2020,SVK,Sabah,0,0,0,Slovakia
18435,11/1/2020,SVK,Sarawak,0,0,0,Slovakia
18436,11/1/2020,SVK,Selangor,4,4,0,Slovakia
18437,11/1/2020,SVK,W.P. Labuan,0,0,0,Slovakia
18438,11/1/2020,SVN,Johor,0,0,0,Slovenia
18439,11/1/2020,SVN,Kedah,0,0,0,Slovenia
18440,11/1/2020,SVN,Kelantan,0,0,0,Slovenia
18441,11/1/2020,SVN,Perak,0,0,0,Slovenia
18442,11/1/2020,SVN,Perlis,0,0,0,Slovenia
18443,11/1/2020,SVN,Pulau Pinang,0,0,0,Slovenia
18444,11/1/2020,SVN,Sabah,0,0,0,Slovenia
18445,11/1/2020,SVN,Sarawak,0,0,0,Slovenia
18446,11/1/2020,SVN,Selangor,4,4,0,Slovenia
18447,11/1/2020,SVN,W.P. Labuan,0,0,0,Slovenia
18448,11/1/2020,SWE,Johor,1,1,0,Sweden
18449,11/1/2020,SWE,Kedah,0,0,0,Sweden
18450,11/1/2020,SWE,Kelantan,0,0,0,Sweden
18451,11/1/2020,SWE,Melaka,0,0,0,Sweden
18452,11/1/2020,SWE,Negeri Sembilan,0,0,0,Sweden
18453,11/1/2020,SWE,Pahang,0,0,0,Sweden
18454,11/1/2020,SWE,Perak,0,0,0,Sweden
18455,11/1/2020,SWE,Perlis,0,0,0,Sweden
18456,11/1/2020,SWE,Pulau Pinang,0,0,0,Sweden
18457,11/1/2020,SWE,Sabah,0,0,0,Sweden
18458,11/1/2020,SWE,Sarawak,0,0,0,Sweden
18459,11/1/2020,SWE,Selangor,24,19,5,Sweden
18460,11/1/2020,SWE,W.P. Labuan,0,0,0,Sweden
18461,11/1/2020,SWZ,Johor,0,0,0,Swaziland
18462,11/1/2020,SWZ,Kedah,0,0,0,Swaziland
18463,11/1/2020,SWZ,Pulau Pinang,0,0,0,Swaziland
18464,11/1/2020,SWZ,Sabah,0,0,0,Swaziland
18465,11/1/2020,SWZ,Selangor,1,1,0,Swaziland
18466,11/1/2020,SYC,Johor,0,0,0,Seychelles
18467,11/1/2020,SYC,Kedah,0,0,0,Seychelles
18468,11/1/2020,SYC,Pulau Pinang,0,0,0,Seychelles
18469,11/1/2020,SYC,Sabah,0,0,0,Seychelles
18470,11/1/2020,SYC,Sarawak,0,0,0,Seychelles
18471,11/1/2020,SYC,Selangor,1,0,1,Seychelles
18472,11/1/2020,SYR,Johor,0,0,0,Syrian Arab Republic
18473,11/1/2020,SYR,Kedah,0,0,0,Syrian Arab Republic
18474,11/1/2020,SYR,Kelantan,0,0,0,Syrian Arab Republic
18475,11/1/2020,SYR,Pahang,0,0,0,Syrian Arab Republic
18476,11/1/2020,SYR,Perlis,0,0,0,Syrian Arab Republic
18477,11/1/2020,SYR,Pulau Pinang,0,0,0,Syrian Arab Republic
18478,11/1/2020,SYR,Sabah,0,0,0,Syrian Arab Republic
18479,11/1/2020,SYR,Sarawak,0,0,0,Syrian Arab Republic
18480,11/1/2020,SYR,Selangor,8,6,2,Syrian Arab Republic
18481,11/1/2020,SYR,W.P. Labuan,0,0,0,Syrian Arab Republic
18482,11/1/2020,TCA,Perlis,0,0,0,Turks and Caicos
18483,11/1/2020,TCD,Johor,0,0,0,Chad
18484,11/1/2020,TCD,Kedah,0,0,0,Chad
18485,11/1/2020,TCD,Perlis,0,0,0,Chad
18486,11/1/2020,TCD,Selangor,0,0,0,Chad
18487,11/1/2020,TGO,Johor,0,0,0,Togo
18488,11/1/2020,TGO,Perak,0,0,0,Togo
18489,11/1/2020,TGO,Pulau Pinang,0,0,0,Togo
18490,11/1/2020,TGO,Selangor,0,0,0,Togo
18491,11/1/2020,THA,Johor,74,74,0,Thailand
18492,11/1/2020,THA,Kedah,10589,9805,784,Thailand
18493,11/1/2020,THA,Kelantan,2,0,2,Thailand
18494,11/1/2020,THA,Melaka,0,0,0,Thailand
18495,11/1/2020,THA,Negeri Sembilan,0,0,0,Thailand
18496,11/1/2020,THA,Pahang,0,0,0,Thailand
18497,11/1/2020,THA,Perak,5,2,3,Thailand
18498,11/1/2020,THA,Perlis,6790,6462,328,Thailand
18499,11/1/2020,THA,Pulau Pinang,0,0,0,Thailand
18500,11/1/2020,THA,Sabah,0,0,0,Thailand
18501,11/1/2020,THA,Sarawak,12,12,0,Thailand
18502,11/1/2020,THA,Selangor,161,75,86,Thailand
18503,11/1/2020,THA,Terengganu,0,0,0,Thailand
18504,11/1/2020,THA,W.P. Labuan,1,0,1,Thailand
18505,11/1/2020,TJK,Johor,0,0,0,Tajikistan
18506,11/1/2020,TJK,Kedah,0,0,0,Tajikistan
18507,11/1/2020,TJK,Perlis,0,0,0,Tajikistan
18508,11/1/2020,TJK,Pulau Pinang,0,0,0,Tajikistan
18509,11/1/2020,TJK,Sabah,0,0,0,Tajikistan
18510,11/1/2020,TJK,Selangor,2,2,0,Tajikistan
18511,11/1/2020,TKL,Selangor,0,0,0,Tokelau
18512,11/1/2020,TKM,Johor,0,0,0,Turkmenistan
18513,11/1/2020,TKM,Kedah,0,0,0,Turkmenistan
18514,11/1/2020,TKM,Kelantan,0,0,0,Turkmenistan
18515,11/1/2020,TKM,Perlis,0,0,0,Turkmenistan
18516,11/1/2020,TKM,Pulau Pinang,0,0,0,Turkmenistan
18517,11/1/2020,TKM,Sabah,0,0,0,Turkmenistan
18518,11/1/2020,TKM,Sarawak,0,0,0,Turkmenistan
18519,11/1/2020,TKM,Selangor,0,0,0,Turkmenistan
18520,11/1/2020,TLS,Johor,0,0,0,Timor-Leste
18521,11/1/2020,TLS,Kedah,0,0,0,Timor-Leste
18522,11/1/2020,TLS,Perlis,0,0,0,Timor-Leste
18523,11/1/2020,TLS,Pulau Pinang,0,0,0,Timor-Leste
18524,11/1/2020,TLS,Sabah,0,0,0,Timor-Leste
18525,11/1/2020,TLS,Sarawak,0,0,0,Timor-Leste
18526,11/1/2020,TLS,Selangor,1,0,1,Timor-Leste
18527,11/1/2020,TON,Johor,0,0,0,Tonga
18528,11/1/2020,TON,Pulau Pinang,0,0,0,Tonga
18529,11/1/2020,TON,Sarawak,0,0,0,Tonga
18530,11/1/2020,TON,Selangor,0,0,0,Tonga
18531,11/1/2020,TTO,Johor,0,0,0,Trinidad and Tobago
18532,11/1/2020,TTO,Kedah,0,0,0,Trinidad and Tobago
18533,11/1/2020,TTO,Pahang,0,0,0,Trinidad and Tobago
18534,11/1/2020,TTO,Pulau Pinang,0,0,0,Trinidad and Tobago
18535,11/1/2020,TTO,Sabah,0,0,0,Trinidad and Tobago
18536,11/1/2020,TTO,Sarawak,0,0,0,Trinidad and Tobago
18537,11/1/2020,TTO,Selangor,1,1,0,Trinidad and Tobago
18538,11/1/2020,TUN,Johor,0,0,0,Tunisia
18539,11/1/2020,TUN,Kedah,0,0,0,Tunisia
18540,11/1/2020,TUN,Kelantan,0,0,0,Tunisia
18541,11/1/2020,TUN,Melaka,0,0,0,Tunisia
18542,11/1/2020,TUN,Perak,0,0,0,Tunisia
18543,11/1/2020,TUN,Perlis,0,0,0,Tunisia
18544,11/1/2020,TUN,Pulau Pinang,0,0,0,Tunisia
18545,11/1/2020,TUN,Sabah,0,0,0,Tunisia
18546,11/1/2020,TUN,Sarawak,0,0,0,Tunisia
18547,11/1/2020,TUN,Selangor,2,2,0,Tunisia
18548,11/1/2020,TUN,W.P. Labuan,0,0,0,Tunisia
18549,11/1/2020,TUR,Johor,0,0,0,Turkey
18550,11/1/2020,TUR,Kedah,0,0,0,Turkey
18551,11/1/2020,TUR,Kelantan,0,0,0,Turkey
18552,11/1/2020,TUR,Melaka,0,0,0,Turkey
18553,11/1/2020,TUR,Negeri Sembilan,0,0,0,Turkey
18554,11/1/2020,TUR,Pahang,0,0,0,Turkey
18555,11/1/2020,TUR,Perak,0,0,0,Turkey
18556,11/1/2020,TUR,Perlis,0,0,0,Turkey
18557,11/1/2020,TUR,Pulau Pinang,0,0,0,Turkey
18558,11/1/2020,TUR,Sabah,0,0,0,Turkey
18559,11/1/2020,TUR,Sarawak,0,0,0,Turkey
18560,11/1/2020,TUR,Selangor,16,14,2,Turkey
18561,11/1/2020,TUR,W.P. Labuan,0,0,0,Turkey
18562,11/1/2020,TUV,Selangor,0,0,0,Tuvalu
18563,11/1/2020,TWN,Johor,1,1,0,Taiwan
18564,11/1/2020,TWN,Kedah,0,0,0,Taiwan
18565,11/1/2020,TWN,Kelantan,0,0,0,Taiwan
18566,11/1/2020,TWN,Melaka,0,0,0,Taiwan
18567,11/1/2020,TWN,Negeri Sembilan,0,0,0,Taiwan
18568,11/1/2020,TWN,Pahang,0,0,0,Taiwan
18569,11/1/2020,TWN,Perak,0,0,0,Taiwan
18570,11/1/2020,TWN,Perlis,0,0,0,Taiwan
18571,11/1/2020,TWN,Pulau Pinang,12,7,5,Taiwan
18572,11/1/2020,TWN,Sabah,0,0,0,Taiwan
18573,11/1/2020,TWN,Sarawak,1,1,0,Taiwan
18574,11/1/2020,TWN,Selangor,89,71,18,Taiwan
18575,11/1/2020,TWN,W.P. Labuan,0,0,0,Taiwan
18576,11/1/2020,TZA,Johor,0,0,0,"Tanzania, United Republic of"
18577,11/1/2020,TZA,Kedah,0,0,0,"Tanzania, United Republic of"
18578,11/1/2020,TZA,Perak,0,0,0,"Tanzania, United Republic of"
18579,11/1/2020,TZA,Perlis,0,0,0,"Tanzania, United Republic of"
18580,11/1/2020,TZA,Pulau Pinang,0,0,0,"Tanzania, United Republic of"
18581,11/1/2020,TZA,Sabah,0,0,0,"Tanzania, United Republic of"
18582,11/1/2020,TZA,Sarawak,0,0,0,"Tanzania, United Republic of"
18583,11/1/2020,TZA,Selangor,3,2,1,"Tanzania, United Republic of"
18584,11/1/2020,UGA,Johor,0,0,0,Uganda
18585,11/1/2020,UGA,Kedah,0,0,0,Uganda
18586,11/1/2020,UGA,Perak,0,0,0,Uganda
18587,11/1/2020,UGA,Perlis,0,0,0,Uganda
18588,11/1/2020,UGA,Pulau Pinang,0,0,0,Uganda
18589,11/1/2020,UGA,Sabah,0,0,0,Uganda
18590,11/1/2020,UGA,Sarawak,0,0,0,Uganda
18591,11/1/2020,UGA,Selangor,1,1,0,Uganda
18592,11/1/2020,UKR,Johor,0,0,0,Ukraine
18593,11/1/2020,UKR,Kedah,0,0,0,Ukraine
18594,11/1/2020,UKR,Kelantan,0,0,0,Ukraine
18595,11/1/2020,UKR,Melaka,0,0,0,Ukraine
18596,11/1/2020,UKR,Negeri Sembilan,0,0,0,Ukraine
18597,11/1/2020,UKR,Pahang,0,0,0,Ukraine
18598,11/1/2020,UKR,Perak,0,0,0,Ukraine
18599,11/1/2020,UKR,Perlis,0,0,0,Ukraine
18600,11/1/2020,UKR,Pulau Pinang,0,0,0,Ukraine
18601,11/1/2020,UKR,Sabah,0,0,0,Ukraine
18602,11/1/2020,UKR,Sarawak,0,0,0,Ukraine
18603,11/1/2020,UKR,Selangor,47,47,0,Ukraine
18604,11/1/2020,UKR,W.P. Labuan,0,0,0,Ukraine
18605,11/1/2020,URY,Johor,0,0,0,Uruguay
18606,11/1/2020,URY,Kedah,0,0,0,Uruguay
18607,11/1/2020,URY,Kelantan,0,0,0,Uruguay
18608,11/1/2020,URY,Perak,0,0,0,Uruguay
18609,11/1/2020,URY,Perlis,0,0,0,Uruguay
18610,11/1/2020,URY,Pulau Pinang,0,0,0,Uruguay
18611,11/1/2020,URY,Sabah,0,0,0,Uruguay
18612,11/1/2020,URY,Sarawak,0,0,0,Uruguay
18613,11/1/2020,URY,Selangor,1,1,0,Uruguay
18614,11/1/2020,URY,W.P. Labuan,0,0,0,Uruguay
18615,11/1/2020,USA,Johor,0,0,0,United States Of America
18616,11/1/2020,USA,Kedah,0,0,0,United States Of America
18617,11/1/2020,USA,Kelantan,0,0,0,United States Of America
18618,11/1/2020,USA,Melaka,0,0,0,United States Of America
18619,11/1/2020,USA,Negeri Sembilan,0,0,0,United States Of America
18620,11/1/2020,USA,Pahang,0,0,0,United States Of America
18621,11/1/2020,USA,Perak,0,0,0,United States Of America
18622,11/1/2020,USA,Perlis,0,0,0,United States Of America
18623,11/1/2020,USA,Pulau Pinang,11,6,5,United States Of America
18624,11/1/2020,USA,Sabah,0,0,0,United States Of America
18625,11/1/2020,USA,Sarawak,0,0,0,United States Of America
18626,11/1/2020,USA,Selangor,105,79,26,United States Of America
18627,11/1/2020,USA,Terengganu,0,0,0,United States Of America
18628,11/1/2020,USA,W.P. Labuan,0,0,0,United States Of America
18629,11/1/2020,UZB,Johor,0,0,0,Uzbekistan
18630,11/1/2020,UZB,Kedah,0,0,0,Uzbekistan
18631,11/1/2020,UZB,Kelantan,0,0,0,Uzbekistan
18632,11/1/2020,UZB,Perak,0,0,0,Uzbekistan
18633,11/1/2020,UZB,Perlis,0,0,0,Uzbekistan
18634,11/1/2020,UZB,Pulau Pinang,0,0,0,Uzbekistan
18635,11/1/2020,UZB,Sabah,0,0,0,Uzbekistan
18636,11/1/2020,UZB,Sarawak,0,0,0,Uzbekistan
18637,11/1/2020,UZB,Selangor,1,0,1,Uzbekistan
18638,11/1/2020,VAT,Johor,0,0,0,Holy See (Vatican City State)
18639,11/1/2020,VAT,Sarawak,0,0,0,Holy See (Vatican City State)
18640,11/1/2020,VAT,Selangor,0,0,0,Holy See (Vatican City State)
18641,11/1/2020,VCT,Johor,0,0,0,Saint Vincent and the Grenadines
18642,11/1/2020,VCT,Kedah,0,0,0,Saint Vincent and the Grenadines
18643,11/1/2020,VCT,Pulau Pinang,0,0,0,Saint Vincent and the Grenadines
18644,11/1/2020,VCT,Sarawak,0,0,0,Saint Vincent and the Grenadines
18645,11/1/2020,VCT,Selangor,0,0,0,Saint Vincent and the Grenadines
18646,11/1/2020,VEN,Johor,0,0,0,Venezuela
18647,11/1/2020,VEN,Kedah,0,0,0,Venezuela
18648,11/1/2020,VEN,Kelantan,0,0,0,Venezuela
18649,11/1/2020,VEN,Melaka,0,0,0,Venezuela
18650,11/1/2020,VEN,Perak,0,0,0,Venezuela
18651,11/1/2020,VEN,Perlis,0,0,0,Venezuela
18652,11/1/2020,VEN,Pulau Pinang,0,0,0,Venezuela
18653,11/1/2020,VEN,Sabah,0,0,0,Venezuela
18654,11/1/2020,VEN,Sarawak,0,0,0,Venezuela
18655,11/1/2020,VEN,Selangor,0,0,0,Venezuela
18656,11/1/2020,VEN,W.P. Labuan,0,0,0,Venezuela
18657,11/1/2020,VNM,Johor,1,0,1,Vietnam
18658,11/1/2020,VNM,Kedah,2,0,2,Vietnam
18659,11/1/2020,VNM,Kelantan,0,0,0,Vietnam
18660,11/1/2020,VNM,Melaka,0,0,0,Vietnam
18661,11/1/2020,VNM,Negeri Sembilan,0,0,0,Vietnam
18662,11/1/2020,VNM,Pahang,0,0,0,Vietnam
18663,11/1/2020,VNM,Perak,0,0,0,Vietnam
18664,11/1/2020,VNM,Perlis,0,0,0,Vietnam
18665,11/1/2020,VNM,Pulau Pinang,0,0,0,Vietnam
18666,11/1/2020,VNM,Sabah,0,0,0,Vietnam
18667,11/1/2020,VNM,Sarawak,0,0,0,Vietnam
18668,11/1/2020,VNM,Selangor,170,44,126,Vietnam
18669,11/1/2020,VNM,Terengganu,0,0,0,Vietnam
18670,11/1/2020,VNM,W.P. Labuan,0,0,0,Vietnam
18671,11/1/2020,VUT,Johor,0,0,0,Vanuatu
18672,11/1/2020,VUT,Kedah,0,0,0,Vanuatu
18673,11/1/2020,VUT,Pulau Pinang,0,0,0,Vanuatu
18674,11/1/2020,VUT,Sabah,0,0,0,Vanuatu
18675,11/1/2020,VUT,Sarawak,0,0,0,Vanuatu
18676,11/1/2020,VUT,Selangor,0,0,0,Vanuatu
18677,11/1/2020,WSM,Johor,0,0,0,Samoa
18678,11/1/2020,WSM,Sarawak,0,0,0,Samoa
18679,11/1/2020,WSM,Selangor,0,0,0,Samoa
18680,11/1/2020,YEM,Johor,0,0,0,Yemen
18681,11/1/2020,YEM,Kedah,0,0,0,Yemen
18682,11/1/2020,YEM,Kelantan,0,0,0,Yemen
18683,11/1/2020,YEM,Melaka,0,0,0,Yemen
18684,11/1/2020,YEM,Pahang,0,0,0,Yemen
18685,11/1/2020,YEM,Perak,0,0,0,Yemen
18686,11/1/2020,YEM,Perlis,0,0,0,Yemen
18687,11/1/2020,YEM,Pulau Pinang,0,0,0,Yemen
18688,11/1/2020,YEM,Sabah,0,0,0,Yemen
18689,11/1/2020,YEM,Sarawak,0,0,0,Yemen
18690,11/1/2020,YEM,Selangor,14,12,2,Yemen
18691,11/1/2020,YEM,W.P. Labuan,0,0,0,Yemen
18692,11/1/2020,ZAF,Johor,1,1,0,South Africa
18693,11/1/2020,ZAF,Kedah,0,0,0,South Africa
18694,11/1/2020,ZAF,Kelantan,0,0,0,South Africa
18695,11/1/2020,ZAF,Melaka,0,0,0,South Africa
18696,11/1/2020,ZAF,Pahang,0,0,0,South Africa
18697,11/1/2020,ZAF,Perak,0,0,0,South Africa
18698,11/1/2020,ZAF,Perlis,0,0,0,South Africa
18699,11/1/2020,ZAF,Pulau Pinang,0,0,0,South Africa
18700,11/1/2020,ZAF,Sabah,0,0,0,South Africa
18701,11/1/2020,ZAF,Sarawak,1,0,1,South Africa
18702,11/1/2020,ZAF,Selangor,15,14,1,South Africa
18703,11/1/2020,ZAF,Terengganu,0,0,0,South Africa
18704,11/1/2020,ZAF,W.P. Labuan,0,0,0,South Africa
18705,11/1/2020,ZMB,Johor,0,0,0,Zambia
18706,11/1/2020,ZMB,Kedah,0,0,0,Zambia
18707,11/1/2020,ZMB,Perak,0,0,0,Zambia
18708,11/1/2020,ZMB,Perlis,0,0,0,Zambia
18709,11/1/2020,ZMB,Pulau Pinang,0,0,0,Zambia
18710,11/1/2020,ZMB,Sabah,0,0,0,Zambia
18711,11/1/2020,ZMB,Sarawak,0,0,0,Zambia
18712,11/1/2020,ZMB,Selangor,2,2,0,Zambia
18713,11/1/2020,ZWE,Johor,0,0,0,Zimbabwe
18714,11/1/2020,ZWE,Kedah,0,0,0,Zimbabwe
18715,11/1/2020,ZWE,Kelantan,0,0,0,Zimbabwe
18716,11/1/2020,ZWE,Perak,0,0,0,Zimbabwe
18717,11/1/2020,ZWE,Perlis,0,0,0,Zimbabwe
18718,11/1/2020,ZWE,Pulau Pinang,0,0,0,Zimbabwe
18719,11/1/2020,ZWE,Sabah,0,0,0,Zimbabwe
18720,11/1/2020,ZWE,Sarawak,0,0,0,Zimbabwe
18721,11/1/2020,ZWE,Selangor,1,0,1,Zimbabwe
18722,12/1/2020,ABW,Kedah,0,0,0,Aruba
18723,12/1/2020,ABW,Pulau Pinang,0,0,0,Aruba
18724,12/1/2020,AFG,Johor,0,0,0,Afghanistan
18725,12/1/2020,AFG,Kedah,0,0,0,Afghanistan
18726,12/1/2020,AFG,Perlis,0,0,0,Afghanistan
18727,12/1/2020,AFG,Pulau Pinang,0,0,0,Afghanistan
18728,12/1/2020,AFG,Sarawak,0,0,0,Afghanistan
18729,12/1/2020,AFG,Selangor,2,2,0,Afghanistan
18730,12/1/2020,AGO,Johor,0,0,0,Angola
18731,12/1/2020,AGO,Kedah,0,0,0,Angola
18732,12/1/2020,AGO,Sabah,0,0,0,Angola
18733,12/1/2020,AGO,Selangor,0,0,0,Angola
18734,12/1/2020,AIA,Selangor,0,0,0,Anguilla
18735,12/1/2020,ALB,Johor,1,1,0,Albania
18736,12/1/2020,ALB,Kedah,0,0,0,Albania
18737,12/1/2020,ALB,Perak,0,0,0,Albania
18738,12/1/2020,ALB,Perlis,0,0,0,Albania
18739,12/1/2020,ALB,Pulau Pinang,0,0,0,Albania
18740,12/1/2020,ALB,Sabah,0,0,0,Albania
18741,12/1/2020,ALB,Sarawak,0,0,0,Albania
18742,12/1/2020,ALB,Selangor,0,0,0,Albania
18743,12/1/2020,AND,Johor,0,0,0,Andorra
18744,12/1/2020,AND,Kedah,0,0,0,Andorra
18745,12/1/2020,AND,Perlis,0,0,0,Andorra
18746,12/1/2020,AND,Pulau Pinang,0,0,0,Andorra
18747,12/1/2020,AND,Selangor,0,0,0,Andorra
18748,12/1/2020,ANT,Selangor,0,0,0,Netherlands Antilles
18749,12/1/2020,ARE,Johor,0,0,0,United Arab Emirates
18750,12/1/2020,ARE,Kedah,0,0,0,United Arab Emirates
18751,12/1/2020,ARE,Kelantan,0,0,0,United Arab Emirates
18752,12/1/2020,ARE,Perak,0,0,0,United Arab Emirates
18753,12/1/2020,ARE,Perlis,0,0,0,United Arab Emirates
18754,12/1/2020,ARE,Pulau Pinang,0,0,0,United Arab Emirates
18755,12/1/2020,ARE,Sabah,0,0,0,United Arab Emirates
18756,12/1/2020,ARE,Sarawak,0,0,0,United Arab Emirates
18757,12/1/2020,ARE,Selangor,10,5,5,United Arab Emirates
18758,12/1/2020,ARG,Johor,0,0,0,Argentina
18759,12/1/2020,ARG,Kedah,0,0,0,Argentina
18760,12/1/2020,ARG,Kelantan,0,0,0,Argentina
18761,12/1/2020,ARG,Melaka,0,0,0,Argentina
18762,12/1/2020,ARG,Perak,0,0,0,Argentina
18763,12/1/2020,ARG,Perlis,0,0,0,Argentina
18764,12/1/2020,ARG,Pulau Pinang,0,0,0,Argentina
18765,12/1/2020,ARG,Sabah,0,0,0,Argentina
18766,12/1/2020,ARG,Sarawak,0,0,0,Argentina
18767,12/1/2020,ARG,Selangor,10,5,5,Argentina
18768,12/1/2020,ARG,W.P. Labuan,0,0,0,Argentina
18769,12/1/2020,ARM,Johor,0,0,0,Armenia
18770,12/1/2020,ARM,Kedah,0,0,0,Armenia
18771,12/1/2020,ARM,Kelantan,0,0,0,Armenia
18772,12/1/2020,ARM,Perak,0,0,0,Armenia
18773,12/1/2020,ARM,Perlis,0,0,0,Armenia
18774,12/1/2020,ARM,Pulau Pinang,0,0,0,Armenia
18775,12/1/2020,ARM,Sabah,0,0,0,Armenia
18776,12/1/2020,ARM,Sarawak,0,0,0,Armenia
18777,12/1/2020,ARM,Selangor,0,0,0,Armenia
18778,12/1/2020,ATA,Selangor,0,0,0,Antarctica
18779,12/1/2020,ATG,Johor,0,0,0,Antigua and Barbuda
18780,12/1/2020,ATG,Kedah,0,0,0,Antigua and Barbuda
18781,12/1/2020,ATG,Pulau Pinang,0,0,0,Antigua and Barbuda
18782,12/1/2020,ATG,Sarawak,0,0,0,Antigua and Barbuda
18783,12/1/2020,ATG,Selangor,0,0,0,Antigua and Barbuda
18784,12/1/2020,AUS,Johor,11,8,3,Australia
18785,12/1/2020,AUS,Kedah,0,0,0,Australia
18786,12/1/2020,AUS,Kelantan,0,0,0,Australia
18787,12/1/2020,AUS,Melaka,0,0,0,Australia
18788,12/1/2020,AUS,Negeri Sembilan,0,0,0,Australia
18789,12/1/2020,AUS,Pahang,0,0,0,Australia
18790,12/1/2020,AUS,Perak,4,2,2,Australia
18791,12/1/2020,AUS,Perlis,0,0,0,Australia
18792,12/1/2020,AUS,Pulau Pinang,5,2,3,Australia
18793,12/1/2020,AUS,Sabah,0,0,0,Australia
18794,12/1/2020,AUS,Sarawak,1,1,0,Australia
18795,12/1/2020,AUS,Selangor,102,68,34,Australia
18796,12/1/2020,AUS,Terengganu,0,0,0,Australia
18797,12/1/2020,AUS,W.P. Labuan,0,0,0,Australia
18798,12/1/2020,AUT,Johor,0,0,0,Austria
18799,12/1/2020,AUT,Kedah,0,0,0,Austria
18800,12/1/2020,AUT,Kelantan,0,0,0,Austria
18801,12/1/2020,AUT,Melaka,0,0,0,Austria
18802,12/1/2020,AUT,Negeri Sembilan,0,0,0,Austria
18803,12/1/2020,AUT,Pahang,0,0,0,Austria
18804,12/1/2020,AUT,Perak,0,0,0,Austria
18805,12/1/2020,AUT,Perlis,0,0,0,Austria
18806,12/1/2020,AUT,Pulau Pinang,0,0,0,Austria
18807,12/1/2020,AUT,Sabah,0,0,0,Austria
18808,12/1/2020,AUT,Sarawak,0,0,0,Austria
18809,12/1/2020,AUT,Selangor,5,5,0,Austria
18810,12/1/2020,AUT,Terengganu,0,0,0,Austria
18811,12/1/2020,AUT,W.P. Labuan,0,0,0,Austria
18812,12/1/2020,AZE,Johor,0,0,0,Azerbaijan
18813,12/1/2020,AZE,Kedah,0,0,0,Azerbaijan
18814,12/1/2020,AZE,Kelantan,0,0,0,Azerbaijan
18815,12/1/2020,AZE,Melaka,0,0,0,Azerbaijan
18816,12/1/2020,AZE,Perlis,0,0,0,Azerbaijan
18817,12/1/2020,AZE,Pulau Pinang,0,0,0,Azerbaijan
18818,12/1/2020,AZE,Sabah,0,0,0,Azerbaijan
18819,12/1/2020,AZE,Sarawak,0,0,0,Azerbaijan
18820,12/1/2020,AZE,Selangor,1,1,0,Azerbaijan
18821,12/1/2020,AZE,W.P. Labuan,0,0,0,Azerbaijan
18822,12/1/2020,BDI,Pulau Pinang,0,0,0,Burundi
18823,12/1/2020,BDI,Sarawak,0,0,0,Burundi
18824,12/1/2020,BDI,Selangor,0,0,0,Burundi
18825,12/1/2020,BEL,Johor,1,1,0,Belgium
18826,12/1/2020,BEL,Kedah,0,0,0,Belgium
18827,12/1/2020,BEL,Kelantan,0,0,0,Belgium
18828,12/1/2020,BEL,Melaka,0,0,0,Belgium
18829,12/1/2020,BEL,Negeri Sembilan,0,0,0,Belgium
18830,12/1/2020,BEL,Pahang,0,0,0,Belgium
18831,12/1/2020,BEL,Perak,0,0,0,Belgium
18832,12/1/2020,BEL,Perlis,0,0,0,Belgium
18833,12/1/2020,BEL,Pulau Pinang,0,0,0,Belgium
18834,12/1/2020,BEL,Sabah,0,0,0,Belgium
18835,12/1/2020,BEL,Sarawak,0,0,0,Belgium
18836,12/1/2020,BEL,Selangor,13,8,5,Belgium
18837,12/1/2020,BEL,W.P. Labuan,0,0,0,Belgium
18838,12/1/2020,BEN,Johor,0,0,0,Benin
18839,12/1/2020,BEN,Kedah,0,0,0,Benin
18840,12/1/2020,BEN,Perak,0,0,0,Benin
18841,12/1/2020,BEN,Pulau Pinang,0,0,0,Benin
18842,12/1/2020,BEN,Sabah,0,0,0,Benin
18843,12/1/2020,BEN,Sarawak,0,0,0,Benin
18844,12/1/2020,BEN,Selangor,1,0,1,Benin
18845,12/1/2020,BFA,Perak,0,0,0,Burkina Faso
18846,12/1/2020,BFA,Pulau Pinang,0,0,0,Burkina Faso
18847,12/1/2020,BFA,Selangor,0,0,0,Burkina Faso
18848,12/1/2020,BGD,Johor,2,2,0,Bangladesh
18849,12/1/2020,BGD,Kedah,0,0,0,Bangladesh
18850,12/1/2020,BGD,Kelantan,0,0,0,Bangladesh
18851,12/1/2020,BGD,Melaka,0,0,0,Bangladesh
18852,12/1/2020,BGD,Negeri Sembilan,0,0,0,Bangladesh
18853,12/1/2020,BGD,Pahang,0,0,0,Bangladesh
18854,12/1/2020,BGD,Perak,0,0,0,Bangladesh
18855,12/1/2020,BGD,Perlis,0,0,0,Bangladesh
18856,12/1/2020,BGD,Pulau Pinang,0,0,0,Bangladesh
18857,12/1/2020,BGD,Sabah,0,0,0,Bangladesh
18858,12/1/2020,BGD,Sarawak,0,0,0,Bangladesh
18859,12/1/2020,BGD,Selangor,58,44,14,Bangladesh
18860,12/1/2020,BGD,W.P. Labuan,0,0,0,Bangladesh
18861,12/1/2020,BGR,Johor,0,0,0,Bulgaria
18862,12/1/2020,BGR,Kedah,0,0,0,Bulgaria
18863,12/1/2020,BGR,Kelantan,0,0,0,Bulgaria
18864,12/1/2020,BGR,Pahang,0,0,0,Bulgaria
18865,12/1/2020,BGR,Perak,0,0,0,Bulgaria
18866,12/1/2020,BGR,Perlis,0,0,0,Bulgaria
18867,12/1/2020,BGR,Pulau Pinang,0,0,0,Bulgaria
18868,12/1/2020,BGR,Sabah,0,0,0,Bulgaria
18869,12/1/2020,BGR,Sarawak,0,0,0,Bulgaria
18870,12/1/2020,BGR,Selangor,5,5,0,Bulgaria
18871,12/1/2020,BGR,W.P. Labuan,0,0,0,Bulgaria
18872,12/1/2020,BHR,Johor,0,0,0,Bahrain
18873,12/1/2020,BHR,Kedah,0,0,0,Bahrain
18874,12/1/2020,BHR,Kelantan,0,0,0,Bahrain
18875,12/1/2020,BHR,Perlis,0,0,0,Bahrain
18876,12/1/2020,BHR,Pulau Pinang,0,0,0,Bahrain
18877,12/1/2020,BHR,Sabah,0,0,0,Bahrain
18878,12/1/2020,BHR,Sarawak,0,0,0,Bahrain
18879,12/1/2020,BHR,Selangor,2,1,1,Bahrain
18880,12/1/2020,BHS,Johor,0,0,0,Bahamas
18881,12/1/2020,BHS,Kedah,0,0,0,Bahamas
18882,12/1/2020,BHS,Perak,0,0,0,Bahamas
18883,12/1/2020,BHS,Sabah,0,0,0,Bahamas
18884,12/1/2020,BHS,Sarawak,0,0,0,Bahamas
18885,12/1/2020,BHS,Selangor,0,0,0,Bahamas
18886,12/1/2020,BIH,Johor,0,0,0,Bosnia and Herzegovina
18887,12/1/2020,BIH,Kedah,0,0,0,Bosnia and Herzegovina
18888,12/1/2020,BIH,Perlis,0,0,0,Bosnia and Herzegovina
18889,12/1/2020,BIH,Pulau Pinang,0,0,0,Bosnia and Herzegovina
18890,12/1/2020,BIH,Sabah,0,0,0,Bosnia and Herzegovina
18891,12/1/2020,BIH,Sarawak,0,0,0,Bosnia and Herzegovina
18892,12/1/2020,BIH,Selangor,1,1,0,Bosnia and Herzegovina
18893,12/1/2020,BLR,Johor,0,0,0,Belarus
18894,12/1/2020,BLR,Kedah,0,0,0,Belarus
18895,12/1/2020,BLR,Kelantan,0,0,0,Belarus
18896,12/1/2020,BLR,Pahang,0,0,0,Belarus
18897,12/1/2020,BLR,Perak,0,0,0,Belarus
18898,12/1/2020,BLR,Perlis,0,0,0,Belarus
18899,12/1/2020,BLR,Pulau Pinang,0,0,0,Belarus
18900,12/1/2020,BLR,Sabah,0,0,0,Belarus
18901,12/1/2020,BLR,Sarawak,0,0,0,Belarus
18902,12/1/2020,BLR,Selangor,0,0,0,Belarus
18903,12/1/2020,BLR,W.P. Labuan,0,0,0,Belarus
18904,12/1/2020,BLZ,Johor,0,0,0,Belize
18905,12/1/2020,BLZ,Pulau Pinang,0,0,0,Belize
18906,12/1/2020,BLZ,Sarawak,0,0,0,Belize
18907,12/1/2020,BLZ,Selangor,0,0,0,Belize
18908,12/1/2020,BMU,Selangor,0,0,0,Bermuda
18909,12/1/2020,BOL,Johor,0,0,0,Bolivia
18910,12/1/2020,BOL,Kedah,0,0,0,Bolivia
18911,12/1/2020,BOL,Melaka,0,0,0,Bolivia
18912,12/1/2020,BOL,Perak,0,0,0,Bolivia
18913,12/1/2020,BOL,Perlis,0,0,0,Bolivia
18914,12/1/2020,BOL,Pulau Pinang,0,0,0,Bolivia
18915,12/1/2020,BOL,Sabah,0,0,0,Bolivia
18916,12/1/2020,BOL,Sarawak,0,0,0,Bolivia
18917,12/1/2020,BOL,Selangor,0,0,0,Bolivia
18918,12/1/2020,BRA,Johor,0,0,0,Brazil
18919,12/1/2020,BRA,Kedah,0,0,0,Brazil
18920,12/1/2020,BRA,Kelantan,0,0,0,Brazil
18921,12/1/2020,BRA,Melaka,0,0,0,Brazil
18922,12/1/2020,BRA,Pahang,0,0,0,Brazil
18923,12/1/2020,BRA,Perak,0,0,0,Brazil
18924,12/1/2020,BRA,Perlis,0,0,0,Brazil
18925,12/1/2020,BRA,Pulau Pinang,1,0,1,Brazil
18926,12/1/2020,BRA,Sabah,0,0,0,Brazil
18927,12/1/2020,BRA,Sarawak,0,0,0,Brazil
18928,12/1/2020,BRA,Selangor,12,9,3,Brazil
18929,12/1/2020,BRA,W.P. Labuan,0,0,0,Brazil
18930,12/1/2020,BRB,Johor,0,0,0,Barbados
18931,12/1/2020,BRB,Kedah,0,0,0,Barbados
18932,12/1/2020,BRB,Perlis,0,0,0,Barbados
18933,12/1/2020,BRB,Pulau Pinang,0,0,0,Barbados
18934,12/1/2020,BRB,Selangor,0,0,0,Barbados
18935,12/1/2020,BRN,Johor,0,0,0,Brunei Darussalam
18936,12/1/2020,BRN,Kedah,0,0,0,Brunei Darussalam
18937,12/1/2020,BRN,Kelantan,0,0,0,Brunei Darussalam
18938,12/1/2020,BRN,Melaka,0,0,0,Brunei Darussalam
18939,12/1/2020,BRN,Pahang,0,0,0,Brunei Darussalam
18940,12/1/2020,BRN,Perak,0,0,0,Brunei Darussalam
18941,12/1/2020,BRN,Perlis,0,0,0,Brunei Darussalam
18942,12/1/2020,BRN,Pulau Pinang,0,0,0,Brunei Darussalam
18943,12/1/2020,BRN,Sabah,0,0,0,Brunei Darussalam
18944,12/1/2020,BRN,Sarawak,367,360,7,Brunei Darussalam
18945,12/1/2020,BRN,Selangor,19,10,9,Brunei Darussalam
18946,12/1/2020,BRN,W.P. Labuan,0,0,0,Brunei Darussalam
18947,12/1/2020,BTN,Johor,0,0,0,Bhutan
18948,12/1/2020,BTN,Kedah,0,0,0,Bhutan
18949,12/1/2020,BTN,Perak,0,0,0,Bhutan
18950,12/1/2020,BTN,Perlis,0,0,0,Bhutan
18951,12/1/2020,BTN,Pulau Pinang,0,0,0,Bhutan
18952,12/1/2020,BTN,Sabah,0,0,0,Bhutan
18953,12/1/2020,BTN,Sarawak,0,0,0,Bhutan
18954,12/1/2020,BTN,Selangor,0,0,0,Bhutan
18955,12/1/2020,BWA,Johor,0,0,0,Botswana
18956,12/1/2020,BWA,Kedah,0,0,0,Botswana
18957,12/1/2020,BWA,Perlis,0,0,0,Botswana
18958,12/1/2020,BWA,Pulau Pinang,0,0,0,Botswana
18959,12/1/2020,BWA,Sabah,0,0,0,Botswana
18960,12/1/2020,BWA,Sarawak,0,0,0,Botswana
18961,12/1/2020,BWA,Selangor,0,0,0,Botswana
18962,12/1/2020,CAF,Kedah,0,0,0,Central African Republic
18963,12/1/2020,CAF,Selangor,0,0,0,Central African Republic
18964,12/1/2020,CAN,Johor,0,0,0,Canada
18965,12/1/2020,CAN,Kedah,0,0,0,Canada
18966,12/1/2020,CAN,Kelantan,0,0,0,Canada
18967,12/1/2020,CAN,Melaka,0,0,0,Canada
18968,12/1/2020,CAN,Negeri Sembilan,0,0,0,Canada
18969,12/1/2020,CAN,Pahang,0,0,0,Canada
18970,12/1/2020,CAN,Perak,0,0,0,Canada
18971,12/1/2020,CAN,Perlis,0,0,0,Canada
18972,12/1/2020,CAN,Pulau Pinang,1,1,0,Canada
18973,12/1/2020,CAN,Sabah,0,0,0,Canada
18974,12/1/2020,CAN,Sarawak,1,1,0,Canada
18975,12/1/2020,CAN,Selangor,33,21,12,Canada
18976,12/1/2020,CAN,Terengganu,0,0,0,Canada
18977,12/1/2020,CAN,W.P. Labuan,0,0,0,Canada
18978,12/1/2020,CCK,Selangor,0,0,0,Cocos (Keeling) Islands
18979,12/1/2020,CHE,Johor,0,0,0,Switzerland
18980,12/1/2020,CHE,Kedah,0,0,0,Switzerland
18981,12/1/2020,CHE,Kelantan,0,0,0,Switzerland
18982,12/1/2020,CHE,Melaka,0,0,0,Switzerland
18983,12/1/2020,CHE,Negeri Sembilan,0,0,0,Switzerland
18984,12/1/2020,CHE,Pahang,0,0,0,Switzerland
18985,12/1/2020,CHE,Perak,0,0,0,Switzerland
18986,12/1/2020,CHE,Perlis,0,0,0,Switzerland
18987,12/1/2020,CHE,Pulau Pinang,0,0,0,Switzerland
18988,12/1/2020,CHE,Sabah,0,0,0,Switzerland
18989,12/1/2020,CHE,Sarawak,0,0,0,Switzerland
18990,12/1/2020,CHE,Selangor,7,4,3,Switzerland
18991,12/1/2020,CHE,W.P. Labuan,0,0,0,Switzerland
18992,12/1/2020,CHL,Johor,0,0,0,Chile
18993,12/1/2020,CHL,Kedah,0,0,0,Chile
18994,12/1/2020,CHL,Kelantan,0,0,0,Chile
18995,12/1/2020,CHL,Melaka,0,0,0,Chile
18996,12/1/2020,CHL,Pahang,0,0,0,Chile
18997,12/1/2020,CHL,Perak,0,0,0,Chile
18998,12/1/2020,CHL,Perlis,0,0,0,Chile
18999,12/1/2020,CHL,Pulau Pinang,0,0,0,Chile
19000,12/1/2020,CHL,Sabah,0,0,0,Chile
19001,12/1/2020,CHL,Sarawak,0,0,0,Chile
19002,12/1/2020,CHL,Selangor,1,1,0,Chile
19003,12/1/2020,CHN,Johor,46,40,6,China
19004,12/1/2020,CHN,Kedah,0,0,0,China
19005,12/1/2020,CHN,Kelantan,0,0,0,China
19006,12/1/2020,CHN,Melaka,0,0,0,China
19007,12/1/2020,CHN,Pahang,0,0,0,China
19008,12/1/2020,CHN,Perak,0,0,0,China
19009,12/1/2020,CHN,Perlis,0,0,0,China
19010,12/1/2020,CHN,Pulau Pinang,2,2,0,China
19011,12/1/2020,CHN,Sabah,5,5,0,China
19012,12/1/2020,CHN,Sarawak,106,105,1,China
19013,12/1/2020,CHN,Selangor,875,695,180,China
19014,12/1/2020,CHN,Terengganu,0,0,0,China
19015,12/1/2020,CHN,W.P. Labuan,0,0,0,China
19016,12/1/2020,CIV,Johor,0,0,0,C��te d'Iv
19017,12/1/2020,CIV,Kedah,0,0,0,C��te d'Iv
19018,12/1/2020,CIV,Pulau Pinang,0,0,0,C��te d'Iv
19019,12/1/2020,CIV,Sabah,0,0,0,C��te d'Iv
19020,12/1/2020,CIV,Sarawak,0,0,0,C��te d'Iv
19021,12/1/2020,CIV,Selangor,2,2,0,C��te d'Iv
19022,12/1/2020,CMR,Johor,0,0,0,Cameroon
19023,12/1/2020,CMR,Kedah,0,0,0,Cameroon
19024,12/1/2020,CMR,Pulau Pinang,0,0,0,Cameroon
19025,12/1/2020,CMR,Sabah,0,0,0,Cameroon
19026,12/1/2020,CMR,Sarawak,0,0,0,Cameroon
19027,12/1/2020,CMR,Selangor,0,0,0,Cameroon
19028,12/1/2020,COD,Johor,0,0,0,"Congo, the Democratic Republic of the"
19029,12/1/2020,COD,Pulau Pinang,0,0,0,"Congo, the Democratic Republic of the"
19030,12/1/2020,COD,Sarawak,0,0,0,"Congo, the Democratic Republic of the"
19031,12/1/2020,COD,Selangor,0,0,0,"Congo, the Democratic Republic of the"
19032,12/1/2020,COG,Johor,0,0,0,Congo
19033,12/1/2020,COG,Kedah,0,0,0,Congo
19034,12/1/2020,COG,Selangor,0,0,0,Congo
19035,12/1/2020,COK,Selangor,0,0,0,Cook Islands
19036,12/1/2020,COL,Johor,0,0,0,Colombia
19037,12/1/2020,COL,Kedah,0,0,0,Colombia
19038,12/1/2020,COL,Perak,0,0,0,Colombia
19039,12/1/2020,COL,Pulau Pinang,0,0,0,Colombia
19040,12/1/2020,COL,Sabah,0,0,0,Colombia
19041,12/1/2020,COL,Sarawak,0,0,0,Colombia
19042,12/1/2020,COL,Selangor,4,2,2,Colombia
19043,12/1/2020,COL,W.P. Labuan,0,0,0,Colombia
19044,12/1/2020,COM,Johor,0,0,0,Comoros
19045,12/1/2020,COM,Kedah,0,0,0,Comoros
19046,12/1/2020,COM,Selangor,0,0,0,Comoros
19047,12/1/2020,CPV,Johor,0,0,0,Cape Verde
19048,12/1/2020,CPV,Kedah,0,0,0,Cape Verde
19049,12/1/2020,CPV,Pulau Pinang,0,0,0,Cape Verde
19050,12/1/2020,CPV,Sabah,0,0,0,Cape Verde
19051,12/1/2020,CPV,Selangor,0,0,0,Cape Verde
19052,12/1/2020,CRI,Johor,0,0,0,Costa Rica
19053,12/1/2020,CRI,Kedah,0,0,0,Costa Rica
19054,12/1/2020,CRI,Perak,0,0,0,Costa Rica
19055,12/1/2020,CRI,Perlis,0,0,0,Costa Rica
19056,12/1/2020,CRI,Pulau Pinang,0,0,0,Costa Rica
19057,12/1/2020,CRI,Sabah,0,0,0,Costa Rica
19058,12/1/2020,CRI,Sarawak,0,0,0,Costa Rica
19059,12/1/2020,CRI,Selangor,1,1,0,Costa Rica
19060,12/1/2020,CUB,Johor,0,0,0,Cuba
19061,12/1/2020,CUB,Kedah,0,0,0,Cuba
19062,12/1/2020,CUB,Perlis,0,0,0,Cuba
19063,12/1/2020,CUB,Pulau Pinang,0,0,0,Cuba
19064,12/1/2020,CUB,Sabah,0,0,0,Cuba
19065,12/1/2020,CUB,Sarawak,0,0,0,Cuba
19066,12/1/2020,CUB,Selangor,0,0,0,Cuba
19067,12/1/2020,CYP,Johor,0,0,0,Cyprus
19068,12/1/2020,CYP,Kedah,0,0,0,Cyprus
19069,12/1/2020,CYP,Perak,0,0,0,Cyprus
19070,12/1/2020,CYP,Perlis,0,0,0,Cyprus
19071,12/1/2020,CYP,Pulau Pinang,0,0,0,Cyprus
19072,12/1/2020,CYP,Sabah,0,0,0,Cyprus
19073,12/1/2020,CYP,Sarawak,0,0,0,Cyprus
19074,12/1/2020,CYP,Selangor,0,0,0,Cyprus
19075,12/1/2020,CZE,Johor,0,0,0,Czech Republic
19076,12/1/2020,CZE,Kedah,0,0,0,Czech Republic
19077,12/1/2020,CZE,Kelantan,0,0,0,Czech Republic
19078,12/1/2020,CZE,Melaka,0,0,0,Czech Republic
19079,12/1/2020,CZE,Negeri Sembilan,0,0,0,Czech Republic
19080,12/1/2020,CZE,Perak,0,0,0,Czech Republic
19081,12/1/2020,CZE,Perlis,0,0,0,Czech Republic
19082,12/1/2020,CZE,Pulau Pinang,0,0,0,Czech Republic
19083,12/1/2020,CZE,Sabah,0,0,0,Czech Republic
19084,12/1/2020,CZE,Sarawak,0,0,0,Czech Republic
19085,12/1/2020,CZE,Selangor,4,3,1,Czech Republic
19086,12/1/2020,CZE,W.P. Labuan,0,0,0,Czech Republic
19087,12/1/2020,DEU,Johor,1,1,0,Germany
19088,12/1/2020,DEU,Kedah,0,0,0,Germany
19089,12/1/2020,DEU,Kelantan,0,0,0,Germany
19090,12/1/2020,DEU,Melaka,0,0,0,Germany
19091,12/1/2020,DEU,Negeri Sembilan,0,0,0,Germany
19092,12/1/2020,DEU,Pahang,0,0,0,Germany
19093,12/1/2020,DEU,Perak,0,0,0,Germany
19094,12/1/2020,DEU,Perlis,0,0,0,Germany
19095,12/1/2020,DEU,Pulau Pinang,0,0,0,Germany
19096,12/1/2020,DEU,Sabah,0,0,0,Germany
19097,12/1/2020,DEU,Sarawak,0,0,0,Germany
19098,12/1/2020,DEU,Selangor,34,25,9,Germany
19099,12/1/2020,DEU,Terengganu,0,0,0,Germany
19100,12/1/2020,DEU,W.P. Labuan,0,0,0,Germany
19101,12/1/2020,DJI,Johor,0,0,0,Djibouti
19102,12/1/2020,DJI,Selangor,0,0,0,Djibouti
19103,12/1/2020,DMA,Johor,0,0,0,Dominica
19104,12/1/2020,DMA,Kedah,0,0,0,Dominica
19105,12/1/2020,DMA,Pulau Pinang,0,0,0,Dominica
19106,12/1/2020,DMA,Sabah,0,0,0,Dominica
19107,12/1/2020,DMA,Sarawak,0,0,0,Dominica
19108,12/1/2020,DMA,Selangor,0,0,0,Dominica
19109,12/1/2020,DMA,W.P. Labuan,0,0,0,Dominica
19110,12/1/2020,DNK,Johor,1,1,0,Denmark
19111,12/1/2020,DNK,Kedah,0,0,0,Denmark
19112,12/1/2020,DNK,Kelantan,0,0,0,Denmark
19113,12/1/2020,DNK,Melaka,0,0,0,Denmark
19114,12/1/2020,DNK,Negeri Sembilan,0,0,0,Denmark
19115,12/1/2020,DNK,Pahang,0,0,0,Denmark
19116,12/1/2020,DNK,Perak,0,0,0,Denmark
19117,12/1/2020,DNK,Perlis,0,0,0,Denmark
19118,12/1/2020,DNK,Pulau Pinang,0,0,0,Denmark
19119,12/1/2020,DNK,Sabah,0,0,0,Denmark
19120,12/1/2020,DNK,Sarawak,0,0,0,Denmark
19121,12/1/2020,DNK,Selangor,11,5,6,Denmark
19122,12/1/2020,DNK,W.P. Labuan,0,0,0,Denmark
19123,12/1/2020,DOM,Johor,0,0,0,Dominican Republic
19124,12/1/2020,DOM,Kedah,0,0,0,Dominican Republic
19125,12/1/2020,DOM,Perak,0,0,0,Dominican Republic
19126,12/1/2020,DOM,Perlis,0,0,0,Dominican Republic
19127,12/1/2020,DOM,Pulau Pinang,0,0,0,Dominican Republic
19128,12/1/2020,DOM,Sabah,0,0,0,Dominican Republic
19129,12/1/2020,DOM,Sarawak,0,0,0,Dominican Republic
19130,12/1/2020,DOM,Selangor,0,0,0,Dominican Republic
19131,12/1/2020,DZA,Johor,0,0,0,Algeria
19132,12/1/2020,DZA,Kedah,0,0,0,Algeria
19133,12/1/2020,DZA,Kelantan,0,0,0,Algeria
19134,12/1/2020,DZA,Melaka,0,0,0,Algeria
19135,12/1/2020,DZA,Perak,0,0,0,Algeria
19136,12/1/2020,DZA,Perlis,0,0,0,Algeria
19137,12/1/2020,DZA,Pulau Pinang,0,0,0,Algeria
19138,12/1/2020,DZA,Sabah,0,0,0,Algeria
19139,12/1/2020,DZA,Sarawak,0,0,0,Algeria
19140,12/1/2020,DZA,Selangor,9,7,2,Algeria
19141,12/1/2020,DZA,W.P. Labuan,0,0,0,Algeria
19142,12/1/2020,ECU,Johor,0,0,0,Ecuador
19143,12/1/2020,ECU,Kedah,0,0,0,Ecuador
19144,12/1/2020,ECU,Perak,0,0,0,Ecuador
19145,12/1/2020,ECU,Perlis,0,0,0,Ecuador
19146,12/1/2020,ECU,Pulau Pinang,0,0,0,Ecuador
19147,12/1/2020,ECU,Sabah,0,0,0,Ecuador
19148,12/1/2020,ECU,Sarawak,0,0,0,Ecuador
19149,12/1/2020,ECU,Selangor,1,1,0,Ecuador
19150,12/1/2020,EGY,Johor,0,0,0,Egypt
19151,12/1/2020,EGY,Kedah,0,0,0,Egypt
19152,12/1/2020,EGY,Kelantan,0,0,0,Egypt
19153,12/1/2020,EGY,Melaka,0,0,0,Egypt
19154,12/1/2020,EGY,Pahang,0,0,0,Egypt
19155,12/1/2020,EGY,Perak,0,0,0,Egypt
19156,12/1/2020,EGY,Perlis,0,0,0,Egypt
19157,12/1/2020,EGY,Pulau Pinang,0,0,0,Egypt
19158,12/1/2020,EGY,Sabah,0,0,0,Egypt
19159,12/1/2020,EGY,Sarawak,0,0,0,Egypt
19160,12/1/2020,EGY,Selangor,50,39,11,Egypt
19161,12/1/2020,EGY,Terengganu,0,0,0,Egypt
19162,12/1/2020,EGY,W.P. Labuan,0,0,0,Egypt
19163,12/1/2020,ERI,Johor,0,0,0,Eritrea
19164,12/1/2020,ERI,Pulau Pinang,0,0,0,Eritrea
19165,12/1/2020,ERI,Sabah,0,0,0,Eritrea
19166,12/1/2020,ERI,Selangor,0,0,0,Eritrea
19167,12/1/2020,ESP,Johor,0,0,0,Spain
19168,12/1/2020,ESP,Kedah,0,0,0,Spain
19169,12/1/2020,ESP,Kelantan,0,0,0,Spain
19170,12/1/2020,ESP,Melaka,0,0,0,Spain
19171,12/1/2020,ESP,Negeri Sembilan,0,0,0,Spain
19172,12/1/2020,ESP,Pahang,0,0,0,Spain
19173,12/1/2020,ESP,Perak,0,0,0,Spain
19174,12/1/2020,ESP,Perlis,0,0,0,Spain
19175,12/1/2020,ESP,Pulau Pinang,0,0,0,Spain
19176,12/1/2020,ESP,Sabah,0,0,0,Spain
19177,12/1/2020,ESP,Sarawak,0,0,0,Spain
19178,12/1/2020,ESP,Selangor,28,17,11,Spain
19179,12/1/2020,ESP,W.P. Labuan,0,0,0,Spain
19180,12/1/2020,EST,Johor,0,0,0,Estonia
19181,12/1/2020,EST,Kedah,0,0,0,Estonia
19182,12/1/2020,EST,Kelantan,0,0,0,Estonia
19183,12/1/2020,EST,Pahang,0,0,0,Estonia
19184,12/1/2020,EST,Perak,0,0,0,Estonia
19185,12/1/2020,EST,Perlis,0,0,0,Estonia
19186,12/1/2020,EST,Pulau Pinang,0,0,0,Estonia
19187,12/1/2020,EST,Sabah,0,0,0,Estonia
19188,12/1/2020,EST,Sarawak,0,0,0,Estonia
19189,12/1/2020,EST,Selangor,1,1,0,Estonia
19190,12/1/2020,EST,W.P. Labuan,0,0,0,Estonia
19191,12/1/2020,ETH,Johor,0,0,0,Ethiopia
19192,12/1/2020,ETH,Kedah,0,0,0,Ethiopia
19193,12/1/2020,ETH,Pulau Pinang,0,0,0,Ethiopia
19194,12/1/2020,ETH,Sarawak,0,0,0,Ethiopia
19195,12/1/2020,ETH,Selangor,3,3,0,Ethiopia
19196,12/1/2020,FIN,Johor,1,1,0,Finland
19197,12/1/2020,FIN,Kedah,0,0,0,Finland
19198,12/1/2020,FIN,Kelantan,0,0,0,Finland
19199,12/1/2020,FIN,Melaka,0,0,0,Finland
19200,12/1/2020,FIN,Negeri Sembilan,0,0,0,Finland
19201,12/1/2020,FIN,Pahang,0,0,0,Finland
19202,12/1/2020,FIN,Perak,0,0,0,Finland
19203,12/1/2020,FIN,Perlis,0,0,0,Finland
19204,12/1/2020,FIN,Pulau Pinang,0,0,0,Finland
19205,12/1/2020,FIN,Sabah,0,0,0,Finland
19206,12/1/2020,FIN,Sarawak,0,0,0,Finland
19207,12/1/2020,FIN,Selangor,7,6,1,Finland
19208,12/1/2020,FIN,W.P. Labuan,0,0,0,Finland
19209,12/1/2020,FJI,Johor,0,0,0,Fiji
19210,12/1/2020,FJI,Kedah,0,0,0,Fiji
19211,12/1/2020,FJI,Kelantan,0,0,0,Fiji
19212,12/1/2020,FJI,Perak,0,0,0,Fiji
19213,12/1/2020,FJI,Perlis,0,0,0,Fiji
19214,12/1/2020,FJI,Pulau Pinang,0,0,0,Fiji
19215,12/1/2020,FJI,Sabah,0,0,0,Fiji
19216,12/1/2020,FJI,Sarawak,0,0,0,Fiji
19217,12/1/2020,FJI,Selangor,5,3,2,Fiji
19218,12/1/2020,FRA,Johor,1,0,1,France
19219,12/1/2020,FRA,Kedah,0,0,0,France
19220,12/1/2020,FRA,Kelantan,0,0,0,France
19221,12/1/2020,FRA,Melaka,0,0,0,France
19222,12/1/2020,FRA,Negeri Sembilan,0,0,0,France
19223,12/1/2020,FRA,Pahang,0,0,0,France
19224,12/1/2020,FRA,Perak,0,0,0,France
19225,12/1/2020,FRA,Perlis,0,0,0,France
19226,12/1/2020,FRA,Pulau Pinang,4,1,3,France
19227,12/1/2020,FRA,Sabah,0,0,0,France
19228,12/1/2020,FRA,Sarawak,0,0,0,France
19229,12/1/2020,FRA,Selangor,53,37,16,France
19230,12/1/2020,FRA,Terengganu,0,0,0,France
19231,12/1/2020,FRA,W.P. Labuan,0,0,0,France
19232,12/1/2020,FSM,Johor,0,0,0,"Micronesia, Federated States of"
19233,12/1/2020,FSM,Pulau Pinang,0,0,0,"Micronesia, Federated States of"
19234,12/1/2020,FSM,Selangor,0,0,0,"Micronesia, Federated States of"
19235,12/1/2020,GAB,Johor,0,0,0,Gabon
19236,12/1/2020,GAB,Pulau Pinang,0,0,0,Gabon
19237,12/1/2020,GAB,Sarawak,0,0,0,Gabon
19238,12/1/2020,GAB,Selangor,0,0,0,Gabon
19239,12/1/2020,GBR,Johor,2,2,0,United Kingdom
19240,12/1/2020,GBR,Kedah,0,0,0,United Kingdom
19241,12/1/2020,GBR,Kelantan,0,0,0,United Kingdom
19242,12/1/2020,GBR,Melaka,0,0,0,United Kingdom
19243,12/1/2020,GBR,Negeri Sembilan,0,0,0,United Kingdom
19244,12/1/2020,GBR,Pahang,0,0,0,United Kingdom
19245,12/1/2020,GBR,Perak,0,0,0,United Kingdom
19246,12/1/2020,GBR,Perlis,0,0,0,United Kingdom
19247,12/1/2020,GBR,Pulau Pinang,1,1,0,United Kingdom
19248,12/1/2020,GBR,Sabah,1,1,0,United Kingdom
19249,12/1/2020,GBR,Sarawak,1,1,0,United Kingdom
19250,12/1/2020,GBR,Selangor,185,135,50,United Kingdom
19251,12/1/2020,GBR,Terengganu,0,0,0,United Kingdom
19252,12/1/2020,GBR,W.P. Labuan,0,0,0,United Kingdom
19253,12/1/2020,GEO,Johor,2,2,0,Georgia
19254,12/1/2020,GEO,Kedah,0,0,0,Georgia
19255,12/1/2020,GEO,Melaka,0,0,0,Georgia
19256,12/1/2020,GEO,Perak,0,0,0,Georgia
19257,12/1/2020,GEO,Perlis,0,0,0,Georgia
19258,12/1/2020,GEO,Pulau Pinang,0,0,0,Georgia
19259,12/1/2020,GEO,Sabah,0,0,0,Georgia
19260,12/1/2020,GEO,Sarawak,0,0,0,Georgia
19261,12/1/2020,GEO,Selangor,3,3,0,Georgia
19262,12/1/2020,GHA,Johor,0,0,0,Ghana
19263,12/1/2020,GHA,Kedah,0,0,0,Ghana
19264,12/1/2020,GHA,Kelantan,0,0,0,Ghana
19265,12/1/2020,GHA,Pulau Pinang,0,0,0,Ghana
19266,12/1/2020,GHA,Sabah,0,0,0,Ghana
19267,12/1/2020,GHA,Sarawak,0,0,0,Ghana
19268,12/1/2020,GHA,Selangor,6,5,1,Ghana
19269,12/1/2020,GIB,Johor,0,0,0,Gibraltar
19270,12/1/2020,GIB,Sarawak,0,0,0,Gibraltar
19271,12/1/2020,GIN,Johor,0,0,0,Guinea
19272,12/1/2020,GIN,Kedah,0,0,0,Guinea
19273,12/1/2020,GIN,Kelantan,0,0,0,Guinea
19274,12/1/2020,GIN,Perlis,0,0,0,Guinea
19275,12/1/2020,GIN,Pulau Pinang,0,0,0,Guinea
19276,12/1/2020,GIN,Sabah,0,0,0,Guinea
19277,12/1/2020,GIN,Sarawak,0,0,0,Guinea
19278,12/1/2020,GIN,Selangor,1,0,1,Guinea
19279,12/1/2020,GLP,Selangor,0,0,0,Guadeloupe
19280,12/1/2020,GMB,Johor,0,0,0,Gambia
19281,12/1/2020,GMB,Kedah,0,0,0,Gambia
19282,12/1/2020,GMB,Kelantan,0,0,0,Gambia
19283,12/1/2020,GMB,Pulau Pinang,0,0,0,Gambia
19284,12/1/2020,GMB,Sabah,0,0,0,Gambia
19285,12/1/2020,GMB,Sarawak,0,0,0,Gambia
19286,12/1/2020,GMB,Selangor,1,0,1,Gambia
19287,12/1/2020,GNB,Johor,0,0,0,Guinea-Bissau
19288,12/1/2020,GNB,Selangor,0,0,0,Guinea-Bissau
19289,12/1/2020,GNQ,Johor,0,0,0,Equatorial Guinea
19290,12/1/2020,GNQ,Selangor,1,0,1,Equatorial Guinea
19291,12/1/2020,GRC,Johor,2,2,0,Greece
19292,12/1/2020,GRC,Kedah,0,0,0,Greece
19293,12/1/2020,GRC,Kelantan,0,0,0,Greece
19294,12/1/2020,GRC,Melaka,0,0,0,Greece
19295,12/1/2020,GRC,Negeri Sembilan,0,0,0,Greece
19296,12/1/2020,GRC,Pahang,0,0,0,Greece
19297,12/1/2020,GRC,Perak,0,0,0,Greece
19298,12/1/2020,GRC,Perlis,0,0,0,Greece
19299,12/1/2020,GRC,Pulau Pinang,0,0,0,Greece
19300,12/1/2020,GRC,Sabah,0,0,0,Greece
19301,12/1/2020,GRC,Sarawak,0,0,0,Greece
19302,12/1/2020,GRC,Selangor,4,4,0,Greece
19303,12/1/2020,GRD,Johor,0,0,0,Grenada
19304,12/1/2020,GRD,Kedah,0,0,0,Grenada
19305,12/1/2020,GRD,Pulau Pinang,0,0,0,Grenada
19306,12/1/2020,GRD,Sabah,0,0,0,Grenada
19307,12/1/2020,GRD,Sarawak,0,0,0,Grenada
19308,12/1/2020,GRD,Selangor,0,0,0,Grenada
19309,12/1/2020,GRL,Johor,0,0,0,Greenland
19310,12/1/2020,GRL,Selangor,0,0,0,Greenland
19311,12/1/2020,GTM,Johor,0,0,0,Guatemala
19312,12/1/2020,GTM,Kedah,0,0,0,Guatemala
19313,12/1/2020,GTM,Pahang,0,0,0,Guatemala
19314,12/1/2020,GTM,Perak,0,0,0,Guatemala
19315,12/1/2020,GTM,Pulau Pinang,0,0,0,Guatemala
19316,12/1/2020,GTM,Sabah,0,0,0,Guatemala
19317,12/1/2020,GTM,Sarawak,0,0,0,Guatemala
19318,12/1/2020,GTM,Selangor,0,0,0,Guatemala
19319,12/1/2020,GTM,W.P. Labuan,0,0,0,Guatemala
19320,12/1/2020,GUY,Johor,0,0,0,Guyana
19321,12/1/2020,GUY,Kedah,0,0,0,Guyana
19322,12/1/2020,GUY,Pulau Pinang,0,0,0,Guyana
19323,12/1/2020,GUY,Sarawak,0,0,0,Guyana
19324,12/1/2020,GUY,Selangor,0,0,0,Guyana
19325,12/1/2020,HKG,Johor,0,0,0,Hong Kong
19326,12/1/2020,HKG,Kedah,0,0,0,Hong Kong
19327,12/1/2020,HKG,Kelantan,0,0,0,Hong Kong
19328,12/1/2020,HKG,Pahang,0,0,0,Hong Kong
19329,12/1/2020,HKG,Perak,0,0,0,Hong Kong
19330,12/1/2020,HKG,Perlis,0,0,0,Hong Kong
19331,12/1/2020,HKG,Pulau Pinang,3,1,2,Hong Kong
19332,12/1/2020,HKG,Sabah,0,0,0,Hong Kong
19333,12/1/2020,HKG,Sarawak,0,0,0,Hong Kong
19334,12/1/2020,HKG,Selangor,11,9,2,Hong Kong
19335,12/1/2020,HKG,Terengganu,0,0,0,Hong Kong
19336,12/1/2020,HMD,Johor,0,0,0,Heard Island and McDonald Islands
19337,12/1/2020,HND,Johor,0,0,0,Honduras
19338,12/1/2020,HND,Kedah,0,0,0,Honduras
19339,12/1/2020,HND,Perak,0,0,0,Honduras
19340,12/1/2020,HND,Pulau Pinang,0,0,0,Honduras
19341,12/1/2020,HND,Sabah,0,0,0,Honduras
19342,12/1/2020,HND,Sarawak,0,0,0,Honduras
19343,12/1/2020,HND,Selangor,5,5,0,Honduras
19344,12/1/2020,HRV,Johor,3,3,0,Croatia
19345,12/1/2020,HRV,Kedah,0,0,0,Croatia
19346,12/1/2020,HRV,Kelantan,0,0,0,Croatia
19347,12/1/2020,HRV,Melaka,0,0,0,Croatia
19348,12/1/2020,HRV,Pahang,0,0,0,Croatia
19349,12/1/2020,HRV,Perak,0,0,0,Croatia
19350,12/1/2020,HRV,Perlis,0,0,0,Croatia
19351,12/1/2020,HRV,Pulau Pinang,0,0,0,Croatia
19352,12/1/2020,HRV,Sabah,0,0,0,Croatia
19353,12/1/2020,HRV,Sarawak,0,0,0,Croatia
19354,12/1/2020,HRV,Selangor,15,15,0,Croatia
19355,12/1/2020,HTI,Johor,0,0,0,Haiti
19356,12/1/2020,HTI,Kedah,0,0,0,Haiti
19357,12/1/2020,HTI,Kelantan,0,0,0,Haiti
19358,12/1/2020,HTI,Perak,0,0,0,Haiti
19359,12/1/2020,HTI,Pulau Pinang,0,0,0,Haiti
19360,12/1/2020,HTI,Sabah,0,0,0,Haiti
19361,12/1/2020,HTI,Selangor,0,0,0,Haiti
19362,12/1/2020,HUN,Johor,0,0,0,Hungary
19363,12/1/2020,HUN,Kedah,0,0,0,Hungary
19364,12/1/2020,HUN,Kelantan,0,0,0,Hungary
19365,12/1/2020,HUN,Pahang,0,0,0,Hungary
19366,12/1/2020,HUN,Perak,0,0,0,Hungary
19367,12/1/2020,HUN,Perlis,0,0,0,Hungary
19368,12/1/2020,HUN,Pulau Pinang,0,0,0,Hungary
19369,12/1/2020,HUN,Sabah,0,0,0,Hungary
19370,12/1/2020,HUN,Sarawak,0,0,0,Hungary
19371,12/1/2020,HUN,Selangor,1,1,0,Hungary
19372,12/1/2020,HUN,W.P. Labuan,0,0,0,Hungary
19373,12/1/2020,IDN,Johor,250,206,44,Indonesia
19374,12/1/2020,IDN,Kedah,3,3,0,Indonesia
19375,12/1/2020,IDN,Kelantan,0,0,0,Indonesia
19376,12/1/2020,IDN,Melaka,0,0,0,Indonesia
19377,12/1/2020,IDN,Negeri Sembilan,0,0,0,Indonesia
19378,12/1/2020,IDN,Pahang,1,1,0,Indonesia
19379,12/1/2020,IDN,Perak,0,0,0,Indonesia
19380,12/1/2020,IDN,Perlis,8,6,2,Indonesia
19381,12/1/2020,IDN,Pulau Pinang,4,1,3,Indonesia
19382,12/1/2020,IDN,Sabah,2,0,2,Indonesia
19383,12/1/2020,IDN,Sarawak,286,277,9,Indonesia
19384,12/1/2020,IDN,Selangor,479,312,167,Indonesia
19385,12/1/2020,IDN,Terengganu,0,0,0,Indonesia
19386,12/1/2020,IDN,W.P. Labuan,3,3,0,Indonesia
19387,12/1/2020,IND,Johor,16,16,0,India
19388,12/1/2020,IND,Kedah,0,0,0,India
19389,12/1/2020,IND,Kelantan,0,0,0,India
19390,12/1/2020,IND,Melaka,0,0,0,India
19391,12/1/2020,IND,Negeri Sembilan,0,0,0,India
19392,12/1/2020,IND,Pahang,0,0,0,India
19393,12/1/2020,IND,Perak,0,0,0,India
19394,12/1/2020,IND,Perlis,0,0,0,India
19395,12/1/2020,IND,Pulau Pinang,3,2,1,India
19396,12/1/2020,IND,Sabah,0,0,0,India
19397,12/1/2020,IND,Sarawak,0,0,0,India
19398,12/1/2020,IND,Selangor,470,376,94,India
19399,12/1/2020,IND,Terengganu,0,0,0,India
19400,12/1/2020,IND,W.P. Labuan,1,1,0,India
19401,12/1/2020,IOT,Pulau Pinang,0,0,0,British Indian Ocean Territory
19402,12/1/2020,IOT,Selangor,0,0,0,British Indian Ocean Territory
19403,12/1/2020,IRL,Johor,1,1,0,Ireland
19404,12/1/2020,IRL,Kedah,0,0,0,Ireland
19405,12/1/2020,IRL,Kelantan,0,0,0,Ireland
19406,12/1/2020,IRL,Negeri Sembilan,0,0,0,Ireland
19407,12/1/2020,IRL,Pahang,0,0,0,Ireland
19408,12/1/2020,IRL,Perak,0,0,0,Ireland
19409,12/1/2020,IRL,Perlis,0,0,0,Ireland
19410,12/1/2020,IRL,Pulau Pinang,0,0,0,Ireland
19411,12/1/2020,IRL,Sabah,0,0,0,Ireland
19412,12/1/2020,IRL,Sarawak,0,0,0,Ireland
19413,12/1/2020,IRL,Selangor,11,9,2,Ireland
19414,12/1/2020,IRL,Terengganu,0,0,0,Ireland
19415,12/1/2020,IRL,W.P. Labuan,0,0,0,Ireland
19416,12/1/2020,IRN,Johor,0,0,0,Iran
19417,12/1/2020,IRN,Kedah,0,0,0,Iran
19418,12/1/2020,IRN,Kelantan,0,0,0,Iran
19419,12/1/2020,IRN,Perak,0,0,0,Iran
19420,12/1/2020,IRN,Perlis,0,0,0,Iran
19421,12/1/2020,IRN,Pulau Pinang,0,0,0,Iran
19422,12/1/2020,IRN,Sabah,0,0,0,Iran
19423,12/1/2020,IRN,Sarawak,0,0,0,Iran
19424,12/1/2020,IRN,Selangor,12,6,6,Iran
19425,12/1/2020,IRN,W.P. Labuan,0,0,0,Iran
19426,12/1/2020,IRQ,Johor,0,0,0,Iraq
19427,12/1/2020,IRQ,Kedah,0,0,0,Iraq
19428,12/1/2020,IRQ,Kelantan,0,0,0,Iraq
19429,12/1/2020,IRQ,Melaka,0,0,0,Iraq
19430,12/1/2020,IRQ,Pahang,0,0,0,Iraq
19431,12/1/2020,IRQ,Perak,0,0,0,Iraq
19432,12/1/2020,IRQ,Perlis,0,0,0,Iraq
19433,12/1/2020,IRQ,Pulau Pinang,0,0,0,Iraq
19434,12/1/2020,IRQ,Sabah,0,0,0,Iraq
19435,12/1/2020,IRQ,Sarawak,0,0,0,Iraq
19436,12/1/2020,IRQ,Selangor,8,6,2,Iraq
19437,12/1/2020,ISL,Johor,0,0,0,Iceland
19438,12/1/2020,ISL,Kedah,0,0,0,Iceland
19439,12/1/2020,ISL,Kelantan,0,0,0,Iceland
19440,12/1/2020,ISL,Perak,0,0,0,Iceland
19441,12/1/2020,ISL,Perlis,0,0,0,Iceland
19442,12/1/2020,ISL,Pulau Pinang,0,0,0,Iceland
19443,12/1/2020,ISL,Sabah,0,0,0,Iceland
19444,12/1/2020,ISL,Sarawak,0,0,0,Iceland
19445,12/1/2020,ISL,Selangor,0,0,0,Iceland
19446,12/1/2020,ISL,W.P. Labuan,0,0,0,Iceland
19447,12/1/2020,ISR,Pulau Pinang,0,0,0,Israel
19448,12/1/2020,ITA,Johor,0,0,0,Italy
19449,12/1/2020,ITA,Kedah,0,0,0,Italy
19450,12/1/2020,ITA,Kelantan,0,0,0,Italy
19451,12/1/2020,ITA,Melaka,0,0,0,Italy
19452,12/1/2020,ITA,Negeri Sembilan,0,0,0,Italy
19453,12/1/2020,ITA,Pahang,0,0,0,Italy
19454,12/1/2020,ITA,Perak,0,0,0,Italy
19455,12/1/2020,ITA,Perlis,0,0,0,Italy
19456,12/1/2020,ITA,Pulau Pinang,0,0,0,Italy
19457,12/1/2020,ITA,Sabah,0,0,0,Italy
19458,12/1/2020,ITA,Sarawak,1,1,0,Italy
19459,12/1/2020,ITA,Selangor,15,13,2,Italy
19460,12/1/2020,ITA,W.P. Labuan,0,0,0,Italy
19461,12/1/2020,JAM,Johor,0,0,0,Jamaica
19462,12/1/2020,JAM,Kedah,0,0,0,Jamaica
19463,12/1/2020,JAM,Perak,0,0,0,Jamaica
19464,12/1/2020,JAM,Pulau Pinang,0,0,0,Jamaica
19465,12/1/2020,JAM,Sabah,0,0,0,Jamaica
19466,12/1/2020,JAM,Sarawak,0,0,0,Jamaica
19467,12/1/2020,JAM,Selangor,0,0,0,Jamaica
19468,12/1/2020,JAM,W.P. Labuan,0,0,0,Jamaica
19469,12/1/2020,JOR,Johor,0,0,0,Jordan
19470,12/1/2020,JOR,Kedah,0,0,0,Jordan
19471,12/1/2020,JOR,Kelantan,0,0,0,Jordan
19472,12/1/2020,JOR,Melaka,0,0,0,Jordan
19473,12/1/2020,JOR,Perlis,0,0,0,Jordan
19474,12/1/2020,JOR,Pulau Pinang,0,0,0,Jordan
19475,12/1/2020,JOR,Sabah,0,0,0,Jordan
19476,12/1/2020,JOR,Sarawak,0,0,0,Jordan
19477,12/1/2020,JOR,Selangor,7,5,2,Jordan
19478,12/1/2020,JOR,W.P. Labuan,0,0,0,Jordan
19479,12/1/2020,JPN,Johor,3,3,0,Japan
19480,12/1/2020,JPN,Kedah,0,0,0,Japan
19481,12/1/2020,JPN,Kelantan,0,0,0,Japan
19482,12/1/2020,JPN,Melaka,0,0,0,Japan
19483,12/1/2020,JPN,Negeri Sembilan,0,0,0,Japan
19484,12/1/2020,JPN,Pahang,0,0,0,Japan
19485,12/1/2020,JPN,Perak,0,0,0,Japan
19486,12/1/2020,JPN,Perlis,0,0,0,Japan
19487,12/1/2020,JPN,Pulau Pinang,25,20,5,Japan
19488,12/1/2020,JPN,Sabah,0,0,0,Japan
19489,12/1/2020,JPN,Sarawak,2,2,0,Japan
19490,12/1/2020,JPN,Selangor,387,252,135,Japan
19491,12/1/2020,JPN,W.P. Labuan,0,0,0,Japan
19492,12/1/2020,KAZ,Johor,0,0,0,Kazakhstan
19493,12/1/2020,KAZ,Kedah,0,0,0,Kazakhstan
19494,12/1/2020,KAZ,Kelantan,0,0,0,Kazakhstan
19495,12/1/2020,KAZ,Melaka,0,0,0,Kazakhstan
19496,12/1/2020,KAZ,Perak,0,0,0,Kazakhstan
19497,12/1/2020,KAZ,Perlis,0,0,0,Kazakhstan
19498,12/1/2020,KAZ,Pulau Pinang,0,0,0,Kazakhstan
19499,12/1/2020,KAZ,Sabah,0,0,0,Kazakhstan
19500,12/1/2020,KAZ,Sarawak,0,0,0,Kazakhstan
19501,12/1/2020,KAZ,Selangor,3,2,1,Kazakhstan
19502,12/1/2020,KAZ,W.P. Labuan,0,0,0,Kazakhstan
19503,12/1/2020,KEN,Johor,0,0,0,Kenya
19504,12/1/2020,KEN,Kedah,0,0,0,Kenya
19505,12/1/2020,KEN,Kelantan,0,0,0,Kenya
19506,12/1/2020,KEN,Perak,0,0,0,Kenya
19507,12/1/2020,KEN,Perlis,0,0,0,Kenya
19508,12/1/2020,KEN,Pulau Pinang,0,0,0,Kenya
19509,12/1/2020,KEN,Sabah,0,0,0,Kenya
19510,12/1/2020,KEN,Sarawak,0,0,0,Kenya
19511,12/1/2020,KEN,Selangor,4,4,0,Kenya
19512,12/1/2020,KGZ,Johor,0,0,0,Kyrgyzstan
19513,12/1/2020,KGZ,Kedah,0,0,0,Kyrgyzstan
19514,12/1/2020,KGZ,Kelantan,0,0,0,Kyrgyzstan
19515,12/1/2020,KGZ,Perak,0,0,0,Kyrgyzstan
19516,12/1/2020,KGZ,Perlis,0,0,0,Kyrgyzstan
19517,12/1/2020,KGZ,Pulau Pinang,0,0,0,Kyrgyzstan
19518,12/1/2020,KGZ,Sabah,0,0,0,Kyrgyzstan
19519,12/1/2020,KGZ,Sarawak,0,0,0,Kyrgyzstan
19520,12/1/2020,KGZ,Selangor,3,3,0,Kyrgyzstan
19521,12/1/2020,KHM,Johor,0,0,0,Cambodia
19522,12/1/2020,KHM,Kedah,0,0,0,Cambodia
19523,12/1/2020,KHM,Kelantan,0,0,0,Cambodia
19524,12/1/2020,KHM,Melaka,0,0,0,Cambodia
19525,12/1/2020,KHM,Negeri Sembilan,0,0,0,Cambodia
19526,12/1/2020,KHM,Pahang,0,0,0,Cambodia
19527,12/1/2020,KHM,Perak,0,0,0,Cambodia
19528,12/1/2020,KHM,Perlis,0,0,0,Cambodia
19529,12/1/2020,KHM,Pulau Pinang,0,0,0,Cambodia
19530,12/1/2020,KHM,Sabah,1,1,0,Cambodia
19531,12/1/2020,KHM,Sarawak,0,0,0,Cambodia
19532,12/1/2020,KHM,Selangor,8,2,6,Cambodia
19533,12/1/2020,KHM,W.P. Labuan,0,0,0,Cambodia
19534,12/1/2020,KIR,Johor,0,0,0,Kiribati
19535,12/1/2020,KIR,Sabah,0,0,0,Kiribati
19536,12/1/2020,KIR,Selangor,8,8,0,Kiribati
19537,12/1/2020,KNA,Johor,0,0,0,Saint Kitts and Nevis
19538,12/1/2020,KNA,Kedah,0,0,0,Saint Kitts and Nevis
19539,12/1/2020,KNA,Perlis,0,0,0,Saint Kitts and Nevis
19540,12/1/2020,KNA,Pulau Pinang,0,0,0,Saint Kitts and Nevis
19541,12/1/2020,KNA,Sabah,0,0,0,Saint Kitts and Nevis
19542,12/1/2020,KNA,Selangor,1,0,1,Saint Kitts and Nevis
19543,12/1/2020,KNA,W.P. Labuan,0,0,0,Saint Kitts and Nevis
19544,12/1/2020,KOR,Johor,1,1,0,"Korea, Republic of (South Korea)"
19545,12/1/2020,KOR,Kedah,0,0,0,"Korea, Republic of (South Korea)"
19546,12/1/2020,KOR,Kelantan,0,0,0,"Korea, Republic of (South Korea)"
19547,12/1/2020,KOR,Melaka,0,0,0,"Korea, Republic of (South Korea)"
19548,12/1/2020,KOR,Negeri Sembilan,0,0,0,"Korea, Republic of (South Korea)"
19549,12/1/2020,KOR,Pahang,0,0,0,"Korea, Republic of (South Korea)"
19550,12/1/2020,KOR,Perak,0,0,0,"Korea, Republic of (South Korea)"
19551,12/1/2020,KOR,Perlis,0,0,0,"Korea, Republic of (South Korea)"
19552,12/1/2020,KOR,Pulau Pinang,3,3,0,"Korea, Republic of (South Korea)"
19553,12/1/2020,KOR,Sabah,0,0,0,"Korea, Republic of (South Korea)"
19554,12/1/2020,KOR,Sarawak,2,2,0,"Korea, Republic of (South Korea)"
19555,12/1/2020,KOR,Selangor,268,191,77,"Korea, Republic of (South Korea)"
19556,12/1/2020,KOR,Terengganu,0,0,0,"Korea, Republic of (South Korea)"
19557,12/1/2020,KOR,W.P. Labuan,0,0,0,"Korea, Republic of (South Korea)"
19558,12/1/2020,KWT,Johor,0,0,0,Kuwait
19559,12/1/2020,KWT,Kedah,0,0,0,Kuwait
19560,12/1/2020,KWT,Kelantan,0,0,0,Kuwait
19561,12/1/2020,KWT,Perak,0,0,0,Kuwait
19562,12/1/2020,KWT,Perlis,0,0,0,Kuwait
19563,12/1/2020,KWT,Pulau Pinang,0,0,0,Kuwait
19564,12/1/2020,KWT,Sabah,0,0,0,Kuwait
19565,12/1/2020,KWT,Sarawak,0,0,0,Kuwait
19566,12/1/2020,KWT,Selangor,3,2,1,Kuwait
19567,12/1/2020,KWT,W.P. Labuan,0,0,0,Kuwait
19568,12/1/2020,LAO,Johor,0,0,0,Lao People's Democratic Republic
19569,12/1/2020,LAO,Kedah,0,0,0,Lao People's Democratic Republic
19570,12/1/2020,LAO,Kelantan,0,0,0,Lao People's Democratic Republic
19571,12/1/2020,LAO,Melaka,0,0,0,Lao People's Democratic Republic
19572,12/1/2020,LAO,Perak,0,0,0,Lao People's Democratic Republic
19573,12/1/2020,LAO,Perlis,0,0,0,Lao People's Democratic Republic
19574,12/1/2020,LAO,Pulau Pinang,0,0,0,Lao People's Democratic Republic
19575,12/1/2020,LAO,Sabah,0,0,0,Lao People's Democratic Republic
19576,12/1/2020,LAO,Sarawak,0,0,0,Lao People's Democratic Republic
19577,12/1/2020,LAO,Selangor,3,1,2,Lao People's Democratic Republic
19578,12/1/2020,LAO,W.P. Labuan,0,0,0,Lao People's Democratic Republic
19579,12/1/2020,LBN,Johor,0,0,0,Lebanon
19580,12/1/2020,LBN,Kedah,0,0,0,Lebanon
19581,12/1/2020,LBN,Kelantan,0,0,0,Lebanon
19582,12/1/2020,LBN,Pahang,0,0,0,Lebanon
19583,12/1/2020,LBN,Perak,0,0,0,Lebanon
19584,12/1/2020,LBN,Perlis,0,0,0,Lebanon
19585,12/1/2020,LBN,Pulau Pinang,0,0,0,Lebanon
19586,12/1/2020,LBN,Sabah,0,0,0,Lebanon
19587,12/1/2020,LBN,Sarawak,0,0,0,Lebanon
19588,12/1/2020,LBN,Selangor,6,4,2,Lebanon
19589,12/1/2020,LBN,W.P. Labuan,0,0,0,Lebanon
19590,12/1/2020,LBR,Johor,0,0,0,Liberia
19591,12/1/2020,LBR,Kedah,0,0,0,Liberia
19592,12/1/2020,LBR,Sabah,0,0,0,Liberia
19593,12/1/2020,LBR,Sarawak,0,0,0,Liberia
19594,12/1/2020,LBR,Selangor,1,1,0,Liberia
19595,12/1/2020,LBY,Johor,0,0,0,Libyan Arab Jamahiriya
19596,12/1/2020,LBY,Kedah,0,0,0,Libyan Arab Jamahiriya
19597,12/1/2020,LBY,Perlis,0,0,0,Libyan Arab Jamahiriya
19598,12/1/2020,LBY,Pulau Pinang,0,0,0,Libyan Arab Jamahiriya
19599,12/1/2020,LBY,Sabah,0,0,0,Libyan Arab Jamahiriya
19600,12/1/2020,LBY,Sarawak,0,0,0,Libyan Arab Jamahiriya
19601,12/1/2020,LBY,Selangor,3,3,0,Libyan Arab Jamahiriya
19602,12/1/2020,LCA,Johor,0,0,0,Saint Lucia
19603,12/1/2020,LCA,Kedah,0,0,0,Saint Lucia
19604,12/1/2020,LCA,Pulau Pinang,0,0,0,Saint Lucia
19605,12/1/2020,LCA,Sarawak,0,0,0,Saint Lucia
19606,12/1/2020,LCA,Selangor,0,0,0,Saint Lucia
19607,12/1/2020,LIE,Johor,0,0,0,Liechtenstein
19608,12/1/2020,LIE,Kedah,0,0,0,Liechtenstein
19609,12/1/2020,LIE,Perlis,0,0,0,Liechtenstein
19610,12/1/2020,LIE,Pulau Pinang,0,0,0,Liechtenstein
19611,12/1/2020,LIE,Sabah,0,0,0,Liechtenstein
19612,12/1/2020,LIE,Sarawak,0,0,0,Liechtenstein
19613,12/1/2020,LIE,Selangor,0,0,0,Liechtenstein
19614,12/1/2020,LKA,Johor,0,0,0,Sri Lanka
19615,12/1/2020,LKA,Kedah,0,0,0,Sri Lanka
19616,12/1/2020,LKA,Kelantan,0,0,0,Sri Lanka
19617,12/1/2020,LKA,Melaka,0,0,0,Sri Lanka
19618,12/1/2020,LKA,Pahang,0,0,0,Sri Lanka
19619,12/1/2020,LKA,Perak,0,0,0,Sri Lanka
19620,12/1/2020,LKA,Perlis,0,0,0,Sri Lanka
19621,12/1/2020,LKA,Pulau Pinang,0,0,0,Sri Lanka
19622,12/1/2020,LKA,Sabah,0,0,0,Sri Lanka
19623,12/1/2020,LKA,Sarawak,0,0,0,Sri Lanka
19624,12/1/2020,LKA,Selangor,37,32,5,Sri Lanka
19625,12/1/2020,LKA,W.P. Labuan,0,0,0,Sri Lanka
19626,12/1/2020,LSO,Johor,0,0,0,Lesotho
19627,12/1/2020,LSO,Kedah,0,0,0,Lesotho
19628,12/1/2020,LSO,Pulau Pinang,0,0,0,Lesotho
19629,12/1/2020,LSO,Sarawak,0,0,0,Lesotho
19630,12/1/2020,LSO,Selangor,1,1,0,Lesotho
19631,12/1/2020,LTU,Johor,0,0,0,Lithuania
19632,12/1/2020,LTU,Kedah,0,0,0,Lithuania
19633,12/1/2020,LTU,Kelantan,0,0,0,Lithuania
19634,12/1/2020,LTU,Pahang,0,0,0,Lithuania
19635,12/1/2020,LTU,Perak,0,0,0,Lithuania
19636,12/1/2020,LTU,Perlis,0,0,0,Lithuania
19637,12/1/2020,LTU,Pulau Pinang,0,0,0,Lithuania
19638,12/1/2020,LTU,Sabah,0,0,0,Lithuania
19639,12/1/2020,LTU,Sarawak,0,0,0,Lithuania
19640,12/1/2020,LTU,Selangor,3,3,0,Lithuania
19641,12/1/2020,LTU,W.P. Labuan,0,0,0,Lithuania
19642,12/1/2020,LUX,Johor,0,0,0,Luxembourg
19643,12/1/2020,LUX,Kedah,0,0,0,Luxembourg
19644,12/1/2020,LUX,Kelantan,0,0,0,Luxembourg
19645,12/1/2020,LUX,Perak,0,0,0,Luxembourg
19646,12/1/2020,LUX,Perlis,0,0,0,Luxembourg
19647,12/1/2020,LUX,Pulau Pinang,0,0,0,Luxembourg
19648,12/1/2020,LUX,Sabah,0,0,0,Luxembourg
19649,12/1/2020,LUX,Sarawak,0,0,0,Luxembourg
19650,12/1/2020,LUX,Selangor,0,0,0,Luxembourg
19651,12/1/2020,LVA,Johor,0,0,0,Latvia
19652,12/1/2020,LVA,Kedah,0,0,0,Latvia
19653,12/1/2020,LVA,Kelantan,0,0,0,Latvia
19654,12/1/2020,LVA,Pahang,0,0,0,Latvia
19655,12/1/2020,LVA,Perak,0,0,0,Latvia
19656,12/1/2020,LVA,Perlis,0,0,0,Latvia
19657,12/1/2020,LVA,Pulau Pinang,0,0,0,Latvia
19658,12/1/2020,LVA,Sabah,0,0,0,Latvia
19659,12/1/2020,LVA,Sarawak,0,0,0,Latvia
19660,12/1/2020,LVA,Selangor,1,1,0,Latvia
19661,12/1/2020,LVA,W.P. Labuan,0,0,0,Latvia
19662,12/1/2020,MAC,Johor,0,0,0,Macao
19663,12/1/2020,MAC,Pahang,0,0,0,Macao
19664,12/1/2020,MAC,Perak,0,0,0,Macao
19665,12/1/2020,MAC,Selangor,0,0,0,Macao
19666,12/1/2020,MAC,W.P. Labuan,0,0,0,Macao
19667,12/1/2020,MAR,Johor,0,0,0,Morocco
19668,12/1/2020,MAR,Kedah,0,0,0,Morocco
19669,12/1/2020,MAR,Kelantan,0,0,0,Morocco
19670,12/1/2020,MAR,Melaka,0,0,0,Morocco
19671,12/1/2020,MAR,Pahang,0,0,0,Morocco
19672,12/1/2020,MAR,Perak,0,0,0,Morocco
19673,12/1/2020,MAR,Perlis,0,0,0,Morocco
19674,12/1/2020,MAR,Pulau Pinang,0,0,0,Morocco
19675,12/1/2020,MAR,Sabah,0,0,0,Morocco
19676,12/1/2020,MAR,Sarawak,0,0,0,Morocco
19677,12/1/2020,MAR,Selangor,4,2,2,Morocco
19678,12/1/2020,MAR,W.P. Labuan,0,0,0,Morocco
19679,12/1/2020,MCO,Johor,0,0,0,Monaco
19680,12/1/2020,MCO,Kedah,0,0,0,Monaco
19681,12/1/2020,MCO,Sabah,0,0,0,Monaco
19682,12/1/2020,MCO,Selangor,0,0,0,Monaco
19683,12/1/2020,MDA,Johor,0,0,0,"Moldova, Republic of"
19684,12/1/2020,MDA,Kedah,0,0,0,"Moldova, Republic of"
19685,12/1/2020,MDA,Kelantan,0,0,0,"Moldova, Republic of"
19686,12/1/2020,MDA,Negeri Sembilan,0,0,0,"Moldova, Republic of"
19687,12/1/2020,MDA,Perlis,0,0,0,"Moldova, Republic of"
19688,12/1/2020,MDA,Pulau Pinang,0,0,0,"Moldova, Republic of"
19689,12/1/2020,MDA,Sabah,0,0,0,"Moldova, Republic of"
19690,12/1/2020,MDA,Sarawak,0,0,0,"Moldova, Republic of"
19691,12/1/2020,MDA,Selangor,0,0,0,"Moldova, Republic of"
19692,12/1/2020,MDG,Johor,0,0,0,Madagascar
19693,12/1/2020,MDG,Kedah,0,0,0,Madagascar
19694,12/1/2020,MDG,Perak,0,0,0,Madagascar
19695,12/1/2020,MDG,Perlis,0,0,0,Madagascar
19696,12/1/2020,MDG,Pulau Pinang,0,0,0,Madagascar
19697,12/1/2020,MDG,Sabah,0,0,0,Madagascar
19698,12/1/2020,MDG,Sarawak,0,0,0,Madagascar
19699,12/1/2020,MDG,Selangor,0,0,0,Madagascar
19700,12/1/2020,MDV,Johor,0,0,0,Maldives
19701,12/1/2020,MDV,Kedah,0,0,0,Maldives
19702,12/1/2020,MDV,Kelantan,0,0,0,Maldives
19703,12/1/2020,MDV,Perak,0,0,0,Maldives
19704,12/1/2020,MDV,Perlis,0,0,0,Maldives
19705,12/1/2020,MDV,Pulau Pinang,0,0,0,Maldives
19706,12/1/2020,MDV,Sabah,0,0,0,Maldives
19707,12/1/2020,MDV,Sarawak,0,0,0,Maldives
19708,12/1/2020,MDV,Selangor,17,11,6,Maldives
19709,12/1/2020,MEX,Johor,0,0,0,Mexico
19710,12/1/2020,MEX,Kedah,0,0,0,Mexico
19711,12/1/2020,MEX,Kelantan,0,0,0,Mexico
19712,12/1/2020,MEX,Pahang,0,0,0,Mexico
19713,12/1/2020,MEX,Perak,0,0,0,Mexico
19714,12/1/2020,MEX,Perlis,0,0,0,Mexico
19715,12/1/2020,MEX,Pulau Pinang,0,0,0,Mexico
19716,12/1/2020,MEX,Sabah,0,0,0,Mexico
19717,12/1/2020,MEX,Sarawak,0,0,0,Mexico
19718,12/1/2020,MEX,Selangor,1,1,0,Mexico
19719,12/1/2020,MEX,W.P. Labuan,0,0,0,Mexico
19720,12/1/2020,MHL,Johor,0,0,0,Marshall Islands
19721,12/1/2020,MHL,Kedah,0,0,0,Marshall Islands
19722,12/1/2020,MHL,Perak,0,0,0,Marshall Islands
19723,12/1/2020,MHL,Pulau Pinang,0,0,0,Marshall Islands
19724,12/1/2020,MHL,Sabah,0,0,0,Marshall Islands
19725,12/1/2020,MHL,Selangor,0,0,0,Marshall Islands
19726,12/1/2020,MKD,Johor,0,0,0,"Macedonia, the former Yugoslav Republic of"
19727,12/1/2020,MKD,Kedah,0,0,0,"Macedonia, the former Yugoslav Republic of"
19728,12/1/2020,MKD,Perak,0,0,0,"Macedonia, the former Yugoslav Republic of"
19729,12/1/2020,MKD,Pulau Pinang,0,0,0,"Macedonia, the former Yugoslav Republic of"
19730,12/1/2020,MKD,Sabah,0,0,0,"Macedonia, the former Yugoslav Republic of"
19731,12/1/2020,MKD,Sarawak,0,0,0,"Macedonia, the former Yugoslav Republic of"
19732,12/1/2020,MKD,Selangor,0,0,0,"Macedonia, the former Yugoslav Republic of"
19733,12/1/2020,MLI,Johor,0,0,0,Mali
19734,12/1/2020,MLI,Sabah,0,0,0,Mali
19735,12/1/2020,MLI,Selangor,0,0,0,Mali
19736,12/1/2020,MLT,Johor,0,0,0,Malta
19737,12/1/2020,MLT,Kedah,0,0,0,Malta
19738,12/1/2020,MLT,Kelantan,0,0,0,Malta
19739,12/1/2020,MLT,Perak,0,0,0,Malta
19740,12/1/2020,MLT,Perlis,0,0,0,Malta
19741,12/1/2020,MLT,Pulau Pinang,0,0,0,Malta
19742,12/1/2020,MLT,Sabah,0,0,0,Malta
19743,12/1/2020,MLT,Sarawak,0,0,0,Malta
19744,12/1/2020,MLT,Selangor,0,0,0,Malta
19745,12/1/2020,MLT,W.P. Labuan,0,0,0,Malta
19746,12/1/2020,MMR,Johor,33,33,0,Myanmar
19747,12/1/2020,MMR,Kedah,0,0,0,Myanmar
19748,12/1/2020,MMR,Kelantan,0,0,0,Myanmar
19749,12/1/2020,MMR,Negeri Sembilan,0,0,0,Myanmar
19750,12/1/2020,MMR,Pahang,0,0,0,Myanmar
19751,12/1/2020,MMR,Perak,0,0,0,Myanmar
19752,12/1/2020,MMR,Perlis,0,0,0,Myanmar
19753,12/1/2020,MMR,Pulau Pinang,1,1,0,Myanmar
19754,12/1/2020,MMR,Sabah,0,0,0,Myanmar
19755,12/1/2020,MMR,Sarawak,0,0,0,Myanmar
19756,12/1/2020,MMR,Selangor,105,96,9,Myanmar
19757,12/1/2020,MMR,Terengganu,0,0,0,Myanmar
19758,12/1/2020,MMR,W.P. Labuan,0,0,0,Myanmar
19759,12/1/2020,MNE,Johor,0,0,0,Montenegro
19760,12/1/2020,MNE,Kedah,0,0,0,Montenegro
19761,12/1/2020,MNE,Pulau Pinang,0,0,0,Montenegro
19762,12/1/2020,MNE,Sabah,0,0,0,Montenegro
19763,12/1/2020,MNE,Sarawak,0,0,0,Montenegro
19764,12/1/2020,MNE,Selangor,5,5,0,Montenegro
19765,12/1/2020,MNG,Johor,0,0,0,Mongolia
19766,12/1/2020,MNG,Kedah,0,0,0,Mongolia
19767,12/1/2020,MNG,Kelantan,0,0,0,Mongolia
19768,12/1/2020,MNG,Perak,0,0,0,Mongolia
19769,12/1/2020,MNG,Perlis,0,0,0,Mongolia
19770,12/1/2020,MNG,Pulau Pinang,0,0,0,Mongolia
19771,12/1/2020,MNG,Sabah,0,0,0,Mongolia
19772,12/1/2020,MNG,Sarawak,0,0,0,Mongolia
19773,12/1/2020,MNG,Selangor,0,0,0,Mongolia
19774,12/1/2020,MNP,Selangor,0,0,0,Northern Mariana Islands
19775,12/1/2020,MOZ,Johor,0,0,0,Mozambique
19776,12/1/2020,MOZ,Kedah,0,0,0,Mozambique
19777,12/1/2020,MOZ,Perak,0,0,0,Mozambique
19778,12/1/2020,MOZ,Pulau Pinang,0,0,0,Mozambique
19779,12/1/2020,MOZ,Sabah,0,0,0,Mozambique
19780,12/1/2020,MOZ,Sarawak,0,0,0,Mozambique
19781,12/1/2020,MOZ,Selangor,3,3,0,Mozambique
19782,12/1/2020,MRT,Johor,0,0,0,Mauritania
19783,12/1/2020,MRT,Kedah,0,0,0,Mauritania
19784,12/1/2020,MRT,Pulau Pinang,0,0,0,Mauritania
19785,12/1/2020,MRT,Sabah,0,0,0,Mauritania
19786,12/1/2020,MRT,Sarawak,0,0,0,Mauritania
19787,12/1/2020,MRT,Selangor,0,0,0,Mauritania
19788,12/1/2020,MUS,Johor,0,0,0,Mauritius
19789,12/1/2020,MUS,Kedah,0,0,0,Mauritius
19790,12/1/2020,MUS,Kelantan,0,0,0,Mauritius
19791,12/1/2020,MUS,Pahang,0,0,0,Mauritius
19792,12/1/2020,MUS,Perak,0,0,0,Mauritius
19793,12/1/2020,MUS,Perlis,0,0,0,Mauritius
19794,12/1/2020,MUS,Pulau Pinang,0,0,0,Mauritius
19795,12/1/2020,MUS,Sabah,0,0,0,Mauritius
19796,12/1/2020,MUS,Sarawak,0,0,0,Mauritius
19797,12/1/2020,MUS,Selangor,5,0,5,Mauritius
19798,12/1/2020,MWI,Johor,0,0,0,Malawi
19799,12/1/2020,MWI,Pulau Pinang,0,0,0,Malawi
19800,12/1/2020,MWI,Sabah,0,0,0,Malawi
19801,12/1/2020,MWI,Sarawak,0,0,0,Malawi
19802,12/1/2020,MWI,Selangor,1,1,0,Malawi
19803,12/1/2020,MYT,Selangor,0,0,0,Mayotte
19804,12/1/2020,NAM,Johor,0,0,0,Namibia
19805,12/1/2020,NAM,Kedah,0,0,0,Namibia
19806,12/1/2020,NAM,Perak,0,0,0,Namibia
19807,12/1/2020,NAM,Perlis,0,0,0,Namibia
19808,12/1/2020,NAM,Pulau Pinang,0,0,0,Namibia
19809,12/1/2020,NAM,Sabah,0,0,0,Namibia
19810,12/1/2020,NAM,Sarawak,0,0,0,Namibia
19811,12/1/2020,NAM,Selangor,2,2,0,Namibia
19812,12/1/2020,NCL,Selangor,0,0,0,New Caledonia
19813,12/1/2020,NER,Johor,0,0,0,Niger
19814,12/1/2020,NER,Sabah,0,0,0,Niger
19815,12/1/2020,NER,Selangor,0,0,0,Niger
19816,12/1/2020,NGA,Johor,0,0,0,Nigeria
19817,12/1/2020,NGA,Kedah,0,0,0,Nigeria
19818,12/1/2020,NGA,Perlis,0,0,0,Nigeria
19819,12/1/2020,NGA,Pulau Pinang,0,0,0,Nigeria
19820,12/1/2020,NGA,Sabah,0,0,0,Nigeria
19821,12/1/2020,NGA,Sarawak,0,0,0,Nigeria
19822,12/1/2020,NGA,Selangor,36,30,6,Nigeria
19823,12/1/2020,NIC,Johor,0,0,0,Nicaragua
19824,12/1/2020,NIC,Kedah,0,0,0,Nicaragua
19825,12/1/2020,NIC,Pulau Pinang,0,0,0,Nicaragua
19826,12/1/2020,NIC,Sabah,0,0,0,Nicaragua
19827,12/1/2020,NIC,Selangor,0,0,0,Nicaragua
19828,12/1/2020,NLD,Johor,1,1,0,Netherlands
19829,12/1/2020,NLD,Kedah,0,0,0,Netherlands
19830,12/1/2020,NLD,Kelantan,0,0,0,Netherlands
19831,12/1/2020,NLD,Melaka,0,0,0,Netherlands
19832,12/1/2020,NLD,Negeri Sembilan,0,0,0,Netherlands
19833,12/1/2020,NLD,Pahang,0,0,0,Netherlands
19834,12/1/2020,NLD,Perak,0,0,0,Netherlands
19835,12/1/2020,NLD,Perlis,0,0,0,Netherlands
19836,12/1/2020,NLD,Pulau Pinang,1,1,0,Netherlands
19837,12/1/2020,NLD,Sabah,0,0,0,Netherlands
19838,12/1/2020,NLD,Sarawak,1,1,0,Netherlands
19839,12/1/2020,NLD,Selangor,22,19,3,Netherlands
19840,12/1/2020,NLD,Terengganu,0,0,0,Netherlands
19841,12/1/2020,NLD,W.P. Labuan,0,0,0,Netherlands
19842,12/1/2020,NOR,Johor,0,0,0,Norway
19843,12/1/2020,NOR,Kedah,0,0,0,Norway
19844,12/1/2020,NOR,Kelantan,0,0,0,Norway
19845,12/1/2020,NOR,Melaka,0,0,0,Norway
19846,12/1/2020,NOR,Pahang,0,0,0,Norway
19847,12/1/2020,NOR,Perak,0,0,0,Norway
19848,12/1/2020,NOR,Perlis,0,0,0,Norway
19849,12/1/2020,NOR,Pulau Pinang,0,0,0,Norway
19850,12/1/2020,NOR,Sabah,0,0,0,Norway
19851,12/1/2020,NOR,Sarawak,0,0,0,Norway
19852,12/1/2020,NOR,Selangor,6,5,1,Norway
19853,12/1/2020,NOR,W.P. Labuan,0,0,0,Norway
19854,12/1/2020,NPL,Johor,0,0,0,Nepal
19855,12/1/2020,NPL,Kedah,0,0,0,Nepal
19856,12/1/2020,NPL,Pahang,0,0,0,Nepal
19857,12/1/2020,NPL,Perak,0,0,0,Nepal
19858,12/1/2020,NPL,Perlis,0,0,0,Nepal
19859,12/1/2020,NPL,Pulau Pinang,0,0,0,Nepal
19860,12/1/2020,NPL,Sabah,0,0,0,Nepal
19861,12/1/2020,NPL,Sarawak,0,0,0,Nepal
19862,12/1/2020,NPL,Selangor,189,185,4,Nepal
19863,12/1/2020,NPL,W.P. Labuan,0,0,0,Nepal
19864,12/1/2020,NRU,Johor,0,0,0,Nauru
19865,12/1/2020,NRU,Pulau Pinang,0,0,0,Nauru
19866,12/1/2020,NRU,Selangor,0,0,0,Nauru
19867,12/1/2020,NZL,Johor,1,1,0,New Zealand
19868,12/1/2020,NZL,Kedah,0,0,0,New Zealand
19869,12/1/2020,NZL,Kelantan,0,0,0,New Zealand
19870,12/1/2020,NZL,Melaka,0,0,0,New Zealand
19871,12/1/2020,NZL,Negeri Sembilan,0,0,0,New Zealand
19872,12/1/2020,NZL,Pahang,0,0,0,New Zealand
19873,12/1/2020,NZL,Perak,2,1,1,New Zealand
19874,12/1/2020,NZL,Perlis,0,0,0,New Zealand
19875,12/1/2020,NZL,Pulau Pinang,0,0,0,New Zealand
19876,12/1/2020,NZL,Sabah,0,0,0,New Zealand
19877,12/1/2020,NZL,Sarawak,0,0,0,New Zealand
19878,12/1/2020,NZL,Selangor,19,15,4,New Zealand
19879,12/1/2020,NZL,Terengganu,0,0,0,New Zealand
19880,12/1/2020,NZL,W.P. Labuan,0,0,0,New Zealand
19881,12/1/2020,OMN,Johor,0,0,0,Oman
19882,12/1/2020,OMN,Kedah,0,0,0,Oman
19883,12/1/2020,OMN,Kelantan,0,0,0,Oman
19884,12/1/2020,OMN,Melaka,0,0,0,Oman
19885,12/1/2020,OMN,Perak,0,0,0,Oman
19886,12/1/2020,OMN,Perlis,0,0,0,Oman
19887,12/1/2020,OMN,Pulau Pinang,0,0,0,Oman
19888,12/1/2020,OMN,Sabah,0,0,0,Oman
19889,12/1/2020,OMN,Sarawak,0,0,0,Oman
19890,12/1/2020,OMN,Selangor,5,0,5,Oman
19891,12/1/2020,PAK,Johor,3,3,0,Pakistan
19892,12/1/2020,PAK,Kedah,0,0,0,Pakistan
19893,12/1/2020,PAK,Kelantan,0,0,0,Pakistan
19894,12/1/2020,PAK,Melaka,0,0,0,Pakistan
19895,12/1/2020,PAK,Negeri Sembilan,0,0,0,Pakistan
19896,12/1/2020,PAK,Pahang,0,0,0,Pakistan
19897,12/1/2020,PAK,Perak,0,0,0,Pakistan
19898,12/1/2020,PAK,Perlis,0,0,0,Pakistan
19899,12/1/2020,PAK,Pulau Pinang,0,0,0,Pakistan
19900,12/1/2020,PAK,Sabah,0,0,0,Pakistan
19901,12/1/2020,PAK,Sarawak,0,0,0,Pakistan
19902,12/1/2020,PAK,Selangor,115,99,16,Pakistan
19903,12/1/2020,PAK,W.P. Labuan,0,0,0,Pakistan
19904,12/1/2020,PAN,Johor,0,0,0,Panama
19905,12/1/2020,PAN,Kedah,0,0,0,Panama
19906,12/1/2020,PAN,Perak,0,0,0,Panama
19907,12/1/2020,PAN,Perlis,0,0,0,Panama
19908,12/1/2020,PAN,Pulau Pinang,0,0,0,Panama
19909,12/1/2020,PAN,Sabah,0,0,0,Panama
19910,12/1/2020,PAN,Sarawak,0,0,0,Panama
19911,12/1/2020,PAN,Selangor,0,0,0,Panama
19912,12/1/2020,PER,Johor,0,0,0,Peru
19913,12/1/2020,PER,Kedah,0,0,0,Peru
19914,12/1/2020,PER,Kelantan,0,0,0,Peru
19915,12/1/2020,PER,Pahang,0,0,0,Peru
19916,12/1/2020,PER,Perak,0,0,0,Peru
19917,12/1/2020,PER,Perlis,0,0,0,Peru
19918,12/1/2020,PER,Pulau Pinang,0,0,0,Peru
19919,12/1/2020,PER,Sabah,0,0,0,Peru
19920,12/1/2020,PER,Sarawak,0,0,0,Peru
19921,12/1/2020,PER,Selangor,13,8,5,Peru
19922,12/1/2020,PER,W.P. Labuan,0,0,0,Peru
19923,12/1/2020,PHL,Johor,85,80,5,Philippines
19924,12/1/2020,PHL,Kedah,0,0,0,Philippines
19925,12/1/2020,PHL,Kelantan,0,0,0,Philippines
19926,12/1/2020,PHL,Melaka,0,0,0,Philippines
19927,12/1/2020,PHL,Negeri Sembilan,0,0,0,Philippines
19928,12/1/2020,PHL,Pahang,0,0,0,Philippines
19929,12/1/2020,PHL,Perak,0,0,0,Philippines
19930,12/1/2020,PHL,Perlis,0,0,0,Philippines
19931,12/1/2020,PHL,Pulau Pinang,0,0,0,Philippines
19932,12/1/2020,PHL,Sabah,2,1,1,Philippines
19933,12/1/2020,PHL,Sarawak,61,58,3,Philippines
19934,12/1/2020,PHL,Selangor,255,209,46,Philippines
19935,12/1/2020,PHL,Terengganu,0,0,0,Philippines
19936,12/1/2020,PHL,W.P. Labuan,4,4,0,Philippines
19937,12/1/2020,PLW,Johor,0,0,0,Palau
19938,12/1/2020,PLW,Pulau Pinang,0,0,0,Palau
19939,12/1/2020,PLW,Selangor,0,0,0,Palau
19940,12/1/2020,PNG,Johor,0,0,0,Papua New Guinea
19941,12/1/2020,PNG,Kedah,0,0,0,Papua New Guinea
19942,12/1/2020,PNG,Kelantan,0,0,0,Papua New Guinea
19943,12/1/2020,PNG,Perak,0,0,0,Papua New Guinea
19944,12/1/2020,PNG,Pulau Pinang,0,0,0,Papua New Guinea
19945,12/1/2020,PNG,Sabah,0,0,0,Papua New Guinea
19946,12/1/2020,PNG,Sarawak,1,1,0,Papua New Guinea
19947,12/1/2020,PNG,Selangor,0,0,0,Papua New Guinea
19948,12/1/2020,POL,Johor,4,4,0,Poland
19949,12/1/2020,POL,Kedah,0,0,0,Poland
19950,12/1/2020,POL,Kelantan,0,0,0,Poland
19951,12/1/2020,POL,Melaka,0,0,0,Poland
19952,12/1/2020,POL,Negeri Sembilan,0,0,0,Poland
19953,12/1/2020,POL,Pahang,0,0,0,Poland
19954,12/1/2020,POL,Perak,0,0,0,Poland
19955,12/1/2020,POL,Perlis,0,0,0,Poland
19956,12/1/2020,POL,Pulau Pinang,0,0,0,Poland
19957,12/1/2020,POL,Sabah,0,0,0,Poland
19958,12/1/2020,POL,Sarawak,0,0,0,Poland
19959,12/1/2020,POL,Selangor,8,7,1,Poland
19960,12/1/2020,POL,Terengganu,0,0,0,Poland
19961,12/1/2020,POL,W.P. Labuan,0,0,0,Poland
19962,12/1/2020,PRK,Selangor,0,0,0,"Korea, Democratic People's Republic of"
19963,12/1/2020,PRT,Johor,0,0,0,Portugal
19964,12/1/2020,PRT,Kedah,0,0,0,Portugal
19965,12/1/2020,PRT,Kelantan,0,0,0,Portugal
19966,12/1/2020,PRT,Melaka,0,0,0,Portugal
19967,12/1/2020,PRT,Pahang,0,0,0,Portugal
19968,12/1/2020,PRT,Perak,0,0,0,Portugal
19969,12/1/2020,PRT,Perlis,0,0,0,Portugal
19970,12/1/2020,PRT,Pulau Pinang,0,0,0,Portugal
19971,12/1/2020,PRT,Sabah,0,0,0,Portugal
19972,12/1/2020,PRT,Sarawak,0,0,0,Portugal
19973,12/1/2020,PRT,Selangor,1,0,1,Portugal
19974,12/1/2020,PRT,W.P. Labuan,0,0,0,Portugal
19975,12/1/2020,PRY,Johor,0,0,0,Paraguay
19976,12/1/2020,PRY,Kedah,0,0,0,Paraguay
19977,12/1/2020,PRY,Perak,0,0,0,Paraguay
19978,12/1/2020,PRY,Perlis,0,0,0,Paraguay
19979,12/1/2020,PRY,Pulau Pinang,0,0,0,Paraguay
19980,12/1/2020,PRY,Sabah,0,0,0,Paraguay
19981,12/1/2020,PRY,Sarawak,0,0,0,Paraguay
19982,12/1/2020,PRY,Selangor,0,0,0,Paraguay
19983,12/1/2020,PSE,Johor,0,0,0,"Palestinian Territory, Occupied"
19984,12/1/2020,PSE,Kedah,0,0,0,"Palestinian Territory, Occupied"
19985,12/1/2020,PSE,Kelantan,0,0,0,"Palestinian Territory, Occupied"
19986,12/1/2020,PSE,Melaka,0,0,0,"Palestinian Territory, Occupied"
19987,12/1/2020,PSE,Perak,0,0,0,"Palestinian Territory, Occupied"
19988,12/1/2020,PSE,Perlis,0,0,0,"Palestinian Territory, Occupied"
19989,12/1/2020,PSE,Pulau Pinang,0,0,0,"Palestinian Territory, Occupied"
19990,12/1/2020,PSE,Sabah,0,0,0,"Palestinian Territory, Occupied"
19991,12/1/2020,PSE,Sarawak,0,0,0,"Palestinian Territory, Occupied"
19992,12/1/2020,PSE,Selangor,4,3,1,"Palestinian Territory, Occupied"
19993,12/1/2020,QAT,Johor,0,0,0,Qatar
19994,12/1/2020,QAT,Kedah,0,0,0,Qatar
19995,12/1/2020,QAT,Perlis,0,0,0,Qatar
19996,12/1/2020,QAT,Pulau Pinang,0,0,0,Qatar
19997,12/1/2020,QAT,Sabah,0,0,0,Qatar
19998,12/1/2020,QAT,Sarawak,0,0,0,Qatar
19999,12/1/2020,QAT,Selangor,2,2,0,Qatar
20000,12/1/2020,REU,Johor,0,0,0,Reunion
20001,12/1/2020,REU,Sarawak,0,0,0,Reunion
20002,12/1/2020,ROU,Johor,0,0,0,Romania
20003,12/1/2020,ROU,Kedah,0,0,0,Romania
20004,12/1/2020,ROU,Kelantan,0,0,0,Romania
20005,12/1/2020,ROU,Negeri Sembilan,0,0,0,Romania
20006,12/1/2020,ROU,Pahang,0,0,0,Romania
20007,12/1/2020,ROU,Perak,0,0,0,Romania
20008,12/1/2020,ROU,Perlis,0,0,0,Romania
20009,12/1/2020,ROU,Pulau Pinang,0,0,0,Romania
20010,12/1/2020,ROU,Sabah,0,0,0,Romania
20011,12/1/2020,ROU,Sarawak,0,0,0,Romania
20012,12/1/2020,ROU,Selangor,10,8,2,Romania
20013,12/1/2020,ROU,W.P. Labuan,0,0,0,Romania
20014,12/1/2020,RUS,Johor,7,7,0,Russia
20015,12/1/2020,RUS,Kedah,0,0,0,Russia
20016,12/1/2020,RUS,Kelantan,0,0,0,Russia
20017,12/1/2020,RUS,Melaka,0,0,0,Russia
20018,12/1/2020,RUS,Negeri Sembilan,0,0,0,Russia
20019,12/1/2020,RUS,Pahang,0,0,0,Russia
20020,12/1/2020,RUS,Perak,0,0,0,Russia
20021,12/1/2020,RUS,Perlis,0,0,0,Russia
20022,12/1/2020,RUS,Pulau Pinang,0,0,0,Russia
20023,12/1/2020,RUS,Sabah,0,0,0,Russia
20024,12/1/2020,RUS,Sarawak,0,0,0,Russia
20025,12/1/2020,RUS,Selangor,28,24,4,Russia
20026,12/1/2020,RUS,W.P. Labuan,0,0,0,Russia
20027,12/1/2020,RWA,Johor,0,0,0,Rwanda
20028,12/1/2020,RWA,Kedah,0,0,0,Rwanda
20029,12/1/2020,RWA,Pulau Pinang,0,0,0,Rwanda
20030,12/1/2020,RWA,Selangor,0,0,0,Rwanda
20031,12/1/2020,SAU,Johor,0,0,0,Saudi Arabia
20032,12/1/2020,SAU,Kedah,0,0,0,Saudi Arabia
20033,12/1/2020,SAU,Kelantan,0,0,0,Saudi Arabia
20034,12/1/2020,SAU,Melaka,0,0,0,Saudi Arabia
20035,12/1/2020,SAU,Perak,0,0,0,Saudi Arabia
20036,12/1/2020,SAU,Perlis,0,0,0,Saudi Arabia
20037,12/1/2020,SAU,Pulau Pinang,0,0,0,Saudi Arabia
20038,12/1/2020,SAU,Sabah,0,0,0,Saudi Arabia
20039,12/1/2020,SAU,Sarawak,0,0,0,Saudi Arabia
20040,12/1/2020,SAU,Selangor,14,6,8,Saudi Arabia
20041,12/1/2020,SAU,W.P. Labuan,0,0,0,Saudi Arabia
20042,12/1/2020,SDN,Johor,0,0,0,Sudan
20043,12/1/2020,SDN,Kedah,0,0,0,Sudan
20044,12/1/2020,SDN,Kelantan,0,0,0,Sudan
20045,12/1/2020,SDN,Perlis,0,0,0,Sudan
20046,12/1/2020,SDN,Pulau Pinang,0,0,0,Sudan
20047,12/1/2020,SDN,Sabah,0,0,0,Sudan
20048,12/1/2020,SDN,Sarawak,0,0,0,Sudan
20049,12/1/2020,SDN,Selangor,7,6,1,Sudan
20050,12/1/2020,SDN,W.P. Labuan,0,0,0,Sudan
20051,12/1/2020,SEN,Johor,0,0,0,Senegal
20052,12/1/2020,SEN,Kedah,0,0,0,Senegal
20053,12/1/2020,SEN,Kelantan,0,0,0,Senegal
20054,12/1/2020,SEN,Perak,0,0,0,Senegal
20055,12/1/2020,SEN,Perlis,0,0,0,Senegal
20056,12/1/2020,SEN,Pulau Pinang,0,0,0,Senegal
20057,12/1/2020,SEN,Sabah,0,0,0,Senegal
20058,12/1/2020,SEN,Sarawak,0,0,0,Senegal
20059,12/1/2020,SEN,Selangor,1,0,1,Senegal
20060,12/1/2020,SGP,Johor,304,244,60,Singapore
20061,12/1/2020,SGP,Kedah,1,1,0,Singapore
20062,12/1/2020,SGP,Kelantan,0,0,0,Singapore
20063,12/1/2020,SGP,Melaka,0,0,0,Singapore
20064,12/1/2020,SGP,Negeri Sembilan,0,0,0,Singapore
20065,12/1/2020,SGP,Pahang,0,0,0,Singapore
20066,12/1/2020,SGP,Perak,0,0,0,Singapore
20067,12/1/2020,SGP,Perlis,0,0,0,Singapore
20068,12/1/2020,SGP,Pulau Pinang,24,17,7,Singapore
20069,12/1/2020,SGP,Sabah,0,0,0,Singapore
20070,12/1/2020,SGP,Sarawak,5,2,3,Singapore
20071,12/1/2020,SGP,Selangor,112,71,41,Singapore
20072,12/1/2020,SGP,Terengganu,0,0,0,Singapore
20073,12/1/2020,SGP,W.P. Labuan,0,0,0,Singapore
20074,12/1/2020,SGS,Johor,0,0,0,South Georgia and the South Sandwich Islands
20075,12/1/2020,SGS,Sabah,0,0,0,South Georgia and the South Sandwich Islands
20076,12/1/2020,SGS,Selangor,0,0,0,South Georgia and the South Sandwich Islands
20077,12/1/2020,SHN,Sarawak,0,0,0,"Saint Helena, Ascension and Tristan da Cunha"
20078,12/1/2020,SLB,Johor,0,0,0,Solomon Islands
20079,12/1/2020,SLB,Perlis,0,0,0,Solomon Islands
20080,12/1/2020,SLB,Pulau Pinang,0,0,0,Solomon Islands
20081,12/1/2020,SLB,Sabah,0,0,0,Solomon Islands
20082,12/1/2020,SLB,Sarawak,0,0,0,Solomon Islands
20083,12/1/2020,SLB,Selangor,0,0,0,Solomon Islands
20084,12/1/2020,SLB,W.P. Labuan,0,0,0,Solomon Islands
20085,12/1/2020,SLE,Johor,0,0,0,Sierra Leone
20086,12/1/2020,SLE,Kedah,0,0,0,Sierra Leone
20087,12/1/2020,SLE,Perak,0,0,0,Sierra Leone
20088,12/1/2020,SLE,Pulau Pinang,0,0,0,Sierra Leone
20089,12/1/2020,SLE,Sabah,0,0,0,Sierra Leone
20090,12/1/2020,SLE,Selangor,0,0,0,Sierra Leone
20091,12/1/2020,SLV,Johor,0,0,0,El Salvador
20092,12/1/2020,SLV,Kedah,0,0,0,El Salvador
20093,12/1/2020,SLV,Perak,0,0,0,El Salvador
20094,12/1/2020,SLV,Perlis,0,0,0,El Salvador
20095,12/1/2020,SLV,Pulau Pinang,0,0,0,El Salvador
20096,12/1/2020,SLV,Sabah,0,0,0,El Salvador
20097,12/1/2020,SLV,Selangor,0,0,0,El Salvador
20098,12/1/2020,SLV,W.P. Labuan,0,0,0,El Salvador
20099,12/1/2020,SMR,Johor,0,0,0,San Marino
20100,12/1/2020,SMR,Selangor,0,0,0,San Marino
20101,12/1/2020,SOM,Johor,0,0,0,Somalia
20102,12/1/2020,SOM,Kedah,0,0,0,Somalia
20103,12/1/2020,SOM,Kelantan,0,0,0,Somalia
20104,12/1/2020,SOM,Perlis,0,0,0,Somalia
20105,12/1/2020,SOM,Sabah,0,0,0,Somalia
20106,12/1/2020,SOM,Sarawak,0,0,0,Somalia
20107,12/1/2020,SOM,Selangor,3,2,1,Somalia
20108,12/1/2020,SRB,Johor,0,0,0,Serbia
20109,12/1/2020,SRB,Kedah,0,0,0,Serbia
20110,12/1/2020,SRB,Kelantan,0,0,0,Serbia
20111,12/1/2020,SRB,Pahang,0,0,0,Serbia
20112,12/1/2020,SRB,Perak,0,0,0,Serbia
20113,12/1/2020,SRB,Perlis,0,0,0,Serbia
20114,12/1/2020,SRB,Pulau Pinang,0,0,0,Serbia
20115,12/1/2020,SRB,Sabah,0,0,0,Serbia
20116,12/1/2020,SRB,Sarawak,0,0,0,Serbia
20117,12/1/2020,SRB,Selangor,0,0,0,Serbia
20118,12/1/2020,STP,Selangor,0,0,0,Sao Tome and Principe
20119,12/1/2020,SUR,Johor,0,0,0,Suriname
20120,12/1/2020,SUR,Kedah,0,0,0,Suriname
20121,12/1/2020,SUR,Kelantan,0,0,0,Suriname
20122,12/1/2020,SUR,Perak,0,0,0,Suriname
20123,12/1/2020,SUR,Perlis,0,0,0,Suriname
20124,12/1/2020,SUR,Pulau Pinang,0,0,0,Suriname
20125,12/1/2020,SUR,Sabah,0,0,0,Suriname
20126,12/1/2020,SUR,Sarawak,0,0,0,Suriname
20127,12/1/2020,SUR,Selangor,0,0,0,Suriname
20128,12/1/2020,SVK,Johor,0,0,0,Slovakia
20129,12/1/2020,SVK,Kedah,0,0,0,Slovakia
20130,12/1/2020,SVK,Kelantan,0,0,0,Slovakia
20131,12/1/2020,SVK,Negeri Sembilan,0,0,0,Slovakia
20132,12/1/2020,SVK,Pahang,0,0,0,Slovakia
20133,12/1/2020,SVK,Perak,0,0,0,Slovakia
20134,12/1/2020,SVK,Perlis,0,0,0,Slovakia
20135,12/1/2020,SVK,Pulau Pinang,0,0,0,Slovakia
20136,12/1/2020,SVK,Sabah,0,0,0,Slovakia
20137,12/1/2020,SVK,Sarawak,0,0,0,Slovakia
20138,12/1/2020,SVK,Selangor,0,0,0,Slovakia
20139,12/1/2020,SVK,W.P. Labuan,0,0,0,Slovakia
20140,12/1/2020,SVN,Johor,0,0,0,Slovenia
20141,12/1/2020,SVN,Kedah,0,0,0,Slovenia
20142,12/1/2020,SVN,Kelantan,0,0,0,Slovenia
20143,12/1/2020,SVN,Perak,0,0,0,Slovenia
20144,12/1/2020,SVN,Perlis,0,0,0,Slovenia
20145,12/1/2020,SVN,Pulau Pinang,0,0,0,Slovenia
20146,12/1/2020,SVN,Sabah,0,0,0,Slovenia
20147,12/1/2020,SVN,Sarawak,0,0,0,Slovenia
20148,12/1/2020,SVN,Selangor,0,0,0,Slovenia
20149,12/1/2020,SVN,W.P. Labuan,0,0,0,Slovenia
20150,12/1/2020,SWE,Johor,2,2,0,Sweden
20151,12/1/2020,SWE,Kedah,0,0,0,Sweden
20152,12/1/2020,SWE,Kelantan,0,0,0,Sweden
20153,12/1/2020,SWE,Melaka,0,0,0,Sweden
20154,12/1/2020,SWE,Negeri Sembilan,0,0,0,Sweden
20155,12/1/2020,SWE,Pahang,0,0,0,Sweden
20156,12/1/2020,SWE,Perak,0,0,0,Sweden
20157,12/1/2020,SWE,Perlis,0,0,0,Sweden
20158,12/1/2020,SWE,Pulau Pinang,0,0,0,Sweden
20159,12/1/2020,SWE,Sabah,0,0,0,Sweden
20160,12/1/2020,SWE,Sarawak,0,0,0,Sweden
20161,12/1/2020,SWE,Selangor,20,15,5,Sweden
20162,12/1/2020,SWE,W.P. Labuan,0,0,0,Sweden
20163,12/1/2020,SWZ,Johor,0,0,0,Swaziland
20164,12/1/2020,SWZ,Kedah,0,0,0,Swaziland
20165,12/1/2020,SWZ,Pulau Pinang,0,0,0,Swaziland
20166,12/1/2020,SWZ,Sabah,0,0,0,Swaziland
20167,12/1/2020,SWZ,Selangor,1,1,0,Swaziland
20168,12/1/2020,SYC,Johor,0,0,0,Seychelles
20169,12/1/2020,SYC,Kedah,0,0,0,Seychelles
20170,12/1/2020,SYC,Pulau Pinang,0,0,0,Seychelles
20171,12/1/2020,SYC,Sabah,0,0,0,Seychelles
20172,12/1/2020,SYC,Sarawak,0,0,0,Seychelles
20173,12/1/2020,SYC,Selangor,0,0,0,Seychelles
20174,12/1/2020,SYR,Johor,0,0,0,Syrian Arab Republic
20175,12/1/2020,SYR,Kedah,0,0,0,Syrian Arab Republic
20176,12/1/2020,SYR,Kelantan,0,0,0,Syrian Arab Republic
20177,12/1/2020,SYR,Pahang,0,0,0,Syrian Arab Republic
20178,12/1/2020,SYR,Perlis,0,0,0,Syrian Arab Republic
20179,12/1/2020,SYR,Pulau Pinang,0,0,0,Syrian Arab Republic
20180,12/1/2020,SYR,Sabah,0,0,0,Syrian Arab Republic
20181,12/1/2020,SYR,Sarawak,0,0,0,Syrian Arab Republic
20182,12/1/2020,SYR,Selangor,6,6,0,Syrian Arab Republic
20183,12/1/2020,SYR,W.P. Labuan,0,0,0,Syrian Arab Republic
20184,12/1/2020,TCA,Perlis,0,0,0,Turks and Caicos
20185,12/1/2020,TCD,Johor,0,0,0,Chad
20186,12/1/2020,TCD,Kedah,0,0,0,Chad
20187,12/1/2020,TCD,Perlis,0,0,0,Chad
20188,12/1/2020,TCD,Selangor,0,0,0,Chad
20189,12/1/2020,TGO,Johor,0,0,0,Togo
20190,12/1/2020,TGO,Perak,0,0,0,Togo
20191,12/1/2020,TGO,Pulau Pinang,0,0,0,Togo
20192,12/1/2020,TGO,Selangor,0,0,0,Togo
20193,12/1/2020,THA,Johor,115,115,0,Thailand
20194,12/1/2020,THA,Kedah,14203,13891,312,Thailand
20195,12/1/2020,THA,Kelantan,2,1,1,Thailand
20196,12/1/2020,THA,Melaka,0,0,0,Thailand
20197,12/1/2020,THA,Negeri Sembilan,0,0,0,Thailand
20198,12/1/2020,THA,Pahang,0,0,0,Thailand
20199,12/1/2020,THA,Perak,0,0,0,Thailand
20200,12/1/2020,THA,Perlis,8789,8405,384,Thailand
20201,12/1/2020,THA,Pulau Pinang,0,0,0,Thailand
20202,12/1/2020,THA,Sabah,0,0,0,Thailand
20203,12/1/2020,THA,Sarawak,12,12,0,Thailand
20204,12/1/2020,THA,Selangor,203,110,93,Thailand
20205,12/1/2020,THA,Terengganu,0,0,0,Thailand
20206,12/1/2020,THA,W.P. Labuan,0,0,0,Thailand
20207,12/1/2020,TJK,Johor,0,0,0,Tajikistan
20208,12/1/2020,TJK,Kedah,0,0,0,Tajikistan
20209,12/1/2020,TJK,Perlis,0,0,0,Tajikistan
20210,12/1/2020,TJK,Pulau Pinang,0,0,0,Tajikistan
20211,12/1/2020,TJK,Sabah,0,0,0,Tajikistan
20212,12/1/2020,TJK,Selangor,2,2,0,Tajikistan
20213,12/1/2020,TKL,Selangor,0,0,0,Tokelau
20214,12/1/2020,TKM,Johor,0,0,0,Turkmenistan
20215,12/1/2020,TKM,Kedah,0,0,0,Turkmenistan
20216,12/1/2020,TKM,Kelantan,0,0,0,Turkmenistan
20217,12/1/2020,TKM,Perlis,0,0,0,Turkmenistan
20218,12/1/2020,TKM,Pulau Pinang,0,0,0,Turkmenistan
20219,12/1/2020,TKM,Sabah,0,0,0,Turkmenistan
20220,12/1/2020,TKM,Sarawak,0,0,0,Turkmenistan
20221,12/1/2020,TKM,Selangor,0,0,0,Turkmenistan
20222,12/1/2020,TLS,Johor,0,0,0,Timor-Leste
20223,12/1/2020,TLS,Kedah,0,0,0,Timor-Leste
20224,12/1/2020,TLS,Perlis,0,0,0,Timor-Leste
20225,12/1/2020,TLS,Pulau Pinang,0,0,0,Timor-Leste
20226,12/1/2020,TLS,Sabah,0,0,0,Timor-Leste
20227,12/1/2020,TLS,Sarawak,0,0,0,Timor-Leste
20228,12/1/2020,TLS,Selangor,3,2,1,Timor-Leste
20229,12/1/2020,TON,Johor,0,0,0,Tonga
20230,12/1/2020,TON,Pulau Pinang,0,0,0,Tonga
20231,12/1/2020,TON,Sarawak,0,0,0,Tonga
20232,12/1/2020,TON,Selangor,0,0,0,Tonga
20233,12/1/2020,TTO,Johor,0,0,0,Trinidad and Tobago
20234,12/1/2020,TTO,Kedah,0,0,0,Trinidad and Tobago
20235,12/1/2020,TTO,Pahang,0,0,0,Trinidad and Tobago
20236,12/1/2020,TTO,Pulau Pinang,0,0,0,Trinidad and Tobago
20237,12/1/2020,TTO,Sabah,0,0,0,Trinidad and Tobago
20238,12/1/2020,TTO,Sarawak,0,0,0,Trinidad and Tobago
20239,12/1/2020,TTO,Selangor,0,0,0,Trinidad and Tobago
20240,12/1/2020,TUN,Johor,0,0,0,Tunisia
20241,12/1/2020,TUN,Kedah,0,0,0,Tunisia
20242,12/1/2020,TUN,Kelantan,0,0,0,Tunisia
20243,12/1/2020,TUN,Melaka,0,0,0,Tunisia
20244,12/1/2020,TUN,Perak,0,0,0,Tunisia
20245,12/1/2020,TUN,Perlis,0,0,0,Tunisia
20246,12/1/2020,TUN,Pulau Pinang,0,0,0,Tunisia
20247,12/1/2020,TUN,Sabah,0,0,0,Tunisia
20248,12/1/2020,TUN,Sarawak,0,0,0,Tunisia
20249,12/1/2020,TUN,Selangor,1,1,0,Tunisia
20250,12/1/2020,TUN,W.P. Labuan,0,0,0,Tunisia
20251,12/1/2020,TUR,Johor,0,0,0,Turkey
20252,12/1/2020,TUR,Kedah,0,0,0,Turkey
20253,12/1/2020,TUR,Kelantan,0,0,0,Turkey
20254,12/1/2020,TUR,Melaka,0,0,0,Turkey
20255,12/1/2020,TUR,Negeri Sembilan,0,0,0,Turkey
20256,12/1/2020,TUR,Pahang,0,0,0,Turkey
20257,12/1/2020,TUR,Perak,0,0,0,Turkey
20258,12/1/2020,TUR,Perlis,0,0,0,Turkey
20259,12/1/2020,TUR,Pulau Pinang,0,0,0,Turkey
20260,12/1/2020,TUR,Sabah,0,0,0,Turkey
20261,12/1/2020,TUR,Sarawak,0,0,0,Turkey
20262,12/1/2020,TUR,Selangor,5,4,1,Turkey
20263,12/1/2020,TUR,W.P. Labuan,0,0,0,Turkey
20264,12/1/2020,TUV,Selangor,0,0,0,Tuvalu
20265,12/1/2020,TWN,Johor,0,0,0,Taiwan
20266,12/1/2020,TWN,Kedah,0,0,0,Taiwan
20267,12/1/2020,TWN,Kelantan,0,0,0,Taiwan
20268,12/1/2020,TWN,Melaka,0,0,0,Taiwan
20269,12/1/2020,TWN,Negeri Sembilan,0,0,0,Taiwan
20270,12/1/2020,TWN,Pahang,0,0,0,Taiwan
20271,12/1/2020,TWN,Perak,0,0,0,Taiwan
20272,12/1/2020,TWN,Perlis,0,0,0,Taiwan
20273,12/1/2020,TWN,Pulau Pinang,10,5,5,Taiwan
20274,12/1/2020,TWN,Sabah,0,0,0,Taiwan
20275,12/1/2020,TWN,Sarawak,4,4,0,Taiwan
20276,12/1/2020,TWN,Selangor,71,51,20,Taiwan
20277,12/1/2020,TWN,W.P. Labuan,0,0,0,Taiwan
20278,12/1/2020,TZA,Johor,0,0,0,"Tanzania, United Republic of"
20279,12/1/2020,TZA,Kedah,0,0,0,"Tanzania, United Republic of"
20280,12/1/2020,TZA,Perak,0,0,0,"Tanzania, United Republic of"
20281,12/1/2020,TZA,Perlis,0,0,0,"Tanzania, United Republic of"
20282,12/1/2020,TZA,Pulau Pinang,0,0,0,"Tanzania, United Republic of"
20283,12/1/2020,TZA,Sabah,0,0,0,"Tanzania, United Republic of"
20284,12/1/2020,TZA,Sarawak,0,0,0,"Tanzania, United Republic of"
20285,12/1/2020,TZA,Selangor,4,1,3,"Tanzania, United Republic of"
20286,12/1/2020,UGA,Johor,0,0,0,Uganda
20287,12/1/2020,UGA,Kedah,0,0,0,Uganda
20288,12/1/2020,UGA,Perak,0,0,0,Uganda
20289,12/1/2020,UGA,Perlis,0,0,0,Uganda
20290,12/1/2020,UGA,Pulau Pinang,0,0,0,Uganda
20291,12/1/2020,UGA,Sabah,0,0,0,Uganda
20292,12/1/2020,UGA,Sarawak,0,0,0,Uganda
20293,12/1/2020,UGA,Selangor,1,1,0,Uganda
20294,12/1/2020,UKR,Johor,34,34,0,Ukraine
20295,12/1/2020,UKR,Kedah,0,0,0,Ukraine
20296,12/1/2020,UKR,Kelantan,0,0,0,Ukraine
20297,12/1/2020,UKR,Melaka,10,10,0,Ukraine
20298,12/1/2020,UKR,Negeri Sembilan,0,0,0,Ukraine
20299,12/1/2020,UKR,Pahang,0,0,0,Ukraine
20300,12/1/2020,UKR,Perak,0,0,0,Ukraine
20301,12/1/2020,UKR,Perlis,0,0,0,Ukraine
20302,12/1/2020,UKR,Pulau Pinang,0,0,0,Ukraine
20303,12/1/2020,UKR,Sabah,0,0,0,Ukraine
20304,12/1/2020,UKR,Sarawak,0,0,0,Ukraine
20305,12/1/2020,UKR,Selangor,31,30,1,Ukraine
20306,12/1/2020,UKR,W.P. Labuan,0,0,0,Ukraine
20307,12/1/2020,URY,Johor,0,0,0,Uruguay
20308,12/1/2020,URY,Kedah,0,0,0,Uruguay
20309,12/1/2020,URY,Kelantan,0,0,0,Uruguay
20310,12/1/2020,URY,Perak,0,0,0,Uruguay
20311,12/1/2020,URY,Perlis,0,0,0,Uruguay
20312,12/1/2020,URY,Pulau Pinang,0,0,0,Uruguay
20313,12/1/2020,URY,Sabah,0,0,0,Uruguay
20314,12/1/2020,URY,Sarawak,0,0,0,Uruguay
20315,12/1/2020,URY,Selangor,0,0,0,Uruguay
20316,12/1/2020,URY,W.P. Labuan,0,0,0,Uruguay
20317,12/1/2020,USA,Johor,1,1,0,United States Of America
20318,12/1/2020,USA,Kedah,0,0,0,United States Of America
20319,12/1/2020,USA,Kelantan,0,0,0,United States Of America
20320,12/1/2020,USA,Melaka,0,0,0,United States Of America
20321,12/1/2020,USA,Negeri Sembilan,0,0,0,United States Of America
20322,12/1/2020,USA,Pahang,0,0,0,United States Of America
20323,12/1/2020,USA,Perak,0,0,0,United States Of America
20324,12/1/2020,USA,Perlis,0,0,0,United States Of America
20325,12/1/2020,USA,Pulau Pinang,8,5,3,United States Of America
20326,12/1/2020,USA,Sabah,0,0,0,United States Of America
20327,12/1/2020,USA,Sarawak,0,0,0,United States Of America
20328,12/1/2020,USA,Selangor,113,74,39,United States Of America
20329,12/1/2020,USA,Terengganu,0,0,0,United States Of America
20330,12/1/2020,USA,W.P. Labuan,0,0,0,United States Of America
20331,12/1/2020,UZB,Johor,1,0,1,Uzbekistan
20332,12/1/2020,UZB,Kedah,0,0,0,Uzbekistan
20333,12/1/2020,UZB,Kelantan,0,0,0,Uzbekistan
20334,12/1/2020,UZB,Perak,0,0,0,Uzbekistan
20335,12/1/2020,UZB,Perlis,0,0,0,Uzbekistan
20336,12/1/2020,UZB,Pulau Pinang,0,0,0,Uzbekistan
20337,12/1/2020,UZB,Sabah,0,0,0,Uzbekistan
20338,12/1/2020,UZB,Sarawak,0,0,0,Uzbekistan
20339,12/1/2020,UZB,Selangor,3,2,1,Uzbekistan
20340,12/1/2020,VAT,Johor,0,0,0,Holy See (Vatican City State)
20341,12/1/2020,VAT,Sarawak,0,0,0,Holy See (Vatican City State)
20342,12/1/2020,VAT,Selangor,0,0,0,Holy See (Vatican City State)
20343,12/1/2020,VCT,Johor,0,0,0,Saint Vincent and the Grenadines
20344,12/1/2020,VCT,Kedah,0,0,0,Saint Vincent and the Grenadines
20345,12/1/2020,VCT,Pulau Pinang,0,0,0,Saint Vincent and the Grenadines
20346,12/1/2020,VCT,Sarawak,0,0,0,Saint Vincent and the Grenadines
20347,12/1/2020,VCT,Selangor,0,0,0,Saint Vincent and the Grenadines
20348,12/1/2020,VEN,Johor,0,0,0,Venezuela
20349,12/1/2020,VEN,Kedah,0,0,0,Venezuela
20350,12/1/2020,VEN,Kelantan,0,0,0,Venezuela
20351,12/1/2020,VEN,Melaka,0,0,0,Venezuela
20352,12/1/2020,VEN,Perak,0,0,0,Venezuela
20353,12/1/2020,VEN,Perlis,0,0,0,Venezuela
20354,12/1/2020,VEN,Pulau Pinang,0,0,0,Venezuela
20355,12/1/2020,VEN,Sabah,0,0,0,Venezuela
20356,12/1/2020,VEN,Sarawak,0,0,0,Venezuela
20357,12/1/2020,VEN,Selangor,1,1,0,Venezuela
20358,12/1/2020,VEN,W.P. Labuan,0,0,0,Venezuela
20359,12/1/2020,VNM,Johor,2,0,2,Vietnam
20360,12/1/2020,VNM,Kedah,0,0,0,Vietnam
20361,12/1/2020,VNM,Kelantan,0,0,0,Vietnam
20362,12/1/2020,VNM,Melaka,0,0,0,Vietnam
20363,12/1/2020,VNM,Negeri Sembilan,0,0,0,Vietnam
20364,12/1/2020,VNM,Pahang,0,0,0,Vietnam
20365,12/1/2020,VNM,Perak,0,0,0,Vietnam
20366,12/1/2020,VNM,Perlis,0,0,0,Vietnam
20367,12/1/2020,VNM,Pulau Pinang,0,0,0,Vietnam
20368,12/1/2020,VNM,Sabah,0,0,0,Vietnam
20369,12/1/2020,VNM,Sarawak,1,1,0,Vietnam
20370,12/1/2020,VNM,Selangor,73,32,41,Vietnam
20371,12/1/2020,VNM,Terengganu,20,20,0,Vietnam
20372,12/1/2020,VNM,W.P. Labuan,0,0,0,Vietnam
20373,12/1/2020,VUT,Johor,0,0,0,Vanuatu
20374,12/1/2020,VUT,Kedah,0,0,0,Vanuatu
20375,12/1/2020,VUT,Pulau Pinang,0,0,0,Vanuatu
20376,12/1/2020,VUT,Sabah,0,0,0,Vanuatu
20377,12/1/2020,VUT,Sarawak,0,0,0,Vanuatu
20378,12/1/2020,VUT,Selangor,0,0,0,Vanuatu
20379,12/1/2020,WSM,Johor,0,0,0,Samoa
20380,12/1/2020,WSM,Sarawak,0,0,0,Samoa
20381,12/1/2020,WSM,Selangor,0,0,0,Samoa
20382,12/1/2020,YEM,Johor,4,4,0,Yemen
20383,12/1/2020,YEM,Kedah,0,0,0,Yemen
20384,12/1/2020,YEM,Kelantan,0,0,0,Yemen
20385,12/1/2020,YEM,Melaka,0,0,0,Yemen
20386,12/1/2020,YEM,Pahang,0,0,0,Yemen
20387,12/1/2020,YEM,Perak,0,0,0,Yemen
20388,12/1/2020,YEM,Perlis,0,0,0,Yemen
20389,12/1/2020,YEM,Pulau Pinang,0,0,0,Yemen
20390,12/1/2020,YEM,Sabah,0,0,0,Yemen
20391,12/1/2020,YEM,Sarawak,0,0,0,Yemen
20392,12/1/2020,YEM,Selangor,24,19,5,Yemen
20393,12/1/2020,YEM,W.P. Labuan,0,0,0,Yemen
20394,12/1/2020,ZAF,Johor,5,5,0,South Africa
20395,12/1/2020,ZAF,Kedah,0,0,0,South Africa
20396,12/1/2020,ZAF,Kelantan,0,0,0,South Africa
20397,12/1/2020,ZAF,Melaka,0,0,0,South Africa
20398,12/1/2020,ZAF,Pahang,0,0,0,South Africa
20399,12/1/2020,ZAF,Perak,0,0,0,South Africa
20400,12/1/2020,ZAF,Perlis,0,0,0,South Africa
20401,12/1/2020,ZAF,Pulau Pinang,0,0,0,South Africa
20402,12/1/2020,ZAF,Sabah,0,0,0,South Africa
20403,12/1/2020,ZAF,Sarawak,1,0,1,South Africa
20404,12/1/2020,ZAF,Selangor,20,12,8,South Africa
20405,12/1/2020,ZAF,Terengganu,0,0,0,South Africa
20406,12/1/2020,ZAF,W.P. Labuan,0,0,0,South Africa
20407,12/1/2020,ZMB,Johor,0,0,0,Zambia
20408,12/1/2020,ZMB,Kedah,0,0,0,Zambia
20409,12/1/2020,ZMB,Perak,0,0,0,Zambia
20410,12/1/2020,ZMB,Perlis,0,0,0,Zambia
20411,12/1/2020,ZMB,Pulau Pinang,0,0,0,Zambia
20412,12/1/2020,ZMB,Sabah,0,0,0,Zambia
20413,12/1/2020,ZMB,Sarawak,0,0,0,Zambia
20414,12/1/2020,ZMB,Selangor,4,3,1,Zambia
20415,12/1/2020,ZWE,Johor,0,0,0,Zimbabwe
20416,12/1/2020,ZWE,Kedah,0,0,0,Zimbabwe
20417,12/1/2020,ZWE,Kelantan,0,0,0,Zimbabwe
20418,12/1/2020,ZWE,Perak,0,0,0,Zimbabwe
20419,12/1/2020,ZWE,Perlis,0,0,0,Zimbabwe
20420,12/1/2020,ZWE,Pulau Pinang,0,0,0,Zimbabwe
20421,12/1/2020,ZWE,Sabah,0,0,0,Zimbabwe
20422,12/1/2020,ZWE,Sarawak,0,0,0,Zimbabwe
20423,12/1/2020,ZWE,Selangor,2,1,1,Zimbabwe
20424,1/1/2021,ABW,Kedah,0,0,0,Aruba
20425,1/1/2021,ABW,Pulau Pinang,0,0,0,Aruba
20426,1/1/2021,AFG,Johor,0,0,0,Afghanistan
20427,1/1/2021,AFG,Kedah,0,0,0,Afghanistan
20428,1/1/2021,AFG,Perlis,0,0,0,Afghanistan
20429,1/1/2021,AFG,Pulau Pinang,0,0,0,Afghanistan
20430,1/1/2021,AFG,Sarawak,0,0,0,Afghanistan
20431,1/1/2021,AFG,Selangor,15,10,5,Afghanistan
20432,1/1/2021,AGO,Johor,0,0,0,Angola
20433,1/1/2021,AGO,Kedah,0,0,0,Angola
20434,1/1/2021,AGO,Sabah,0,0,0,Angola
20435,1/1/2021,AGO,Selangor,0,0,0,Angola
20436,1/1/2021,AIA,Selangor,0,0,0,Anguilla
20437,1/1/2021,ALB,Johor,0,0,0,Albania
20438,1/1/2021,ALB,Kedah,0,0,0,Albania
20439,1/1/2021,ALB,Perak,0,0,0,Albania
20440,1/1/2021,ALB,Perlis,0,0,0,Albania
20441,1/1/2021,ALB,Pulau Pinang,0,0,0,Albania
20442,1/1/2021,ALB,Sabah,0,0,0,Albania
20443,1/1/2021,ALB,Sarawak,0,0,0,Albania
20444,1/1/2021,ALB,Selangor,1,1,0,Albania
20445,1/1/2021,AND,Johor,0,0,0,Andorra
20446,1/1/2021,AND,Kedah,0,0,0,Andorra
20447,1/1/2021,AND,Perlis,0,0,0,Andorra
20448,1/1/2021,AND,Pulau Pinang,0,0,0,Andorra
20449,1/1/2021,AND,Selangor,0,0,0,Andorra
20450,1/1/2021,ANT,Selangor,0,0,0,Netherlands Antilles
20451,1/1/2021,ARE,Johor,0,0,0,United Arab Emirates
20452,1/1/2021,ARE,Kedah,0,0,0,United Arab Emirates
20453,1/1/2021,ARE,Kelantan,0,0,0,United Arab Emirates
20454,1/1/2021,ARE,Perak,0,0,0,United Arab Emirates
20455,1/1/2021,ARE,Perlis,0,0,0,United Arab Emirates
20456,1/1/2021,ARE,Pulau Pinang,0,0,0,United Arab Emirates
20457,1/1/2021,ARE,Sabah,0,0,0,United Arab Emirates
20458,1/1/2021,ARE,Sarawak,0,0,0,United Arab Emirates
20459,1/1/2021,ARE,Selangor,8,7,1,United Arab Emirates
20460,1/1/2021,ARG,Johor,0,0,0,Argentina
20461,1/1/2021,ARG,Kedah,0,0,0,Argentina
20462,1/1/2021,ARG,Kelantan,0,0,0,Argentina
20463,1/1/2021,ARG,Melaka,0,0,0,Argentina
20464,1/1/2021,ARG,Perak,0,0,0,Argentina
20465,1/1/2021,ARG,Perlis,0,0,0,Argentina
20466,1/1/2021,ARG,Pulau Pinang,0,0,0,Argentina
20467,1/1/2021,ARG,Sabah,0,0,0,Argentina
20468,1/1/2021,ARG,Sarawak,0,0,0,Argentina
20469,1/1/2021,ARG,Selangor,13,4,9,Argentina
20470,1/1/2021,ARG,W.P. Labuan,0,0,0,Argentina
20471,1/1/2021,ARM,Johor,0,0,0,Armenia
20472,1/1/2021,ARM,Kedah,0,0,0,Armenia
20473,1/1/2021,ARM,Kelantan,0,0,0,Armenia
20474,1/1/2021,ARM,Perak,0,0,0,Armenia
20475,1/1/2021,ARM,Perlis,0,0,0,Armenia
20476,1/1/2021,ARM,Pulau Pinang,0,0,0,Armenia
20477,1/1/2021,ARM,Sabah,0,0,0,Armenia
20478,1/1/2021,ARM,Sarawak,0,0,0,Armenia
20479,1/1/2021,ARM,Selangor,0,0,0,Armenia
20480,1/1/2021,ATA,Selangor,0,0,0,Antarctica
20481,1/1/2021,ATG,Johor,0,0,0,Antigua and Barbuda
20482,1/1/2021,ATG,Kedah,0,0,0,Antigua and Barbuda
20483,1/1/2021,ATG,Pulau Pinang,0,0,0,Antigua and Barbuda
20484,1/1/2021,ATG,Sarawak,0,0,0,Antigua and Barbuda
20485,1/1/2021,ATG,Selangor,0,0,0,Antigua and Barbuda
20486,1/1/2021,AUS,Johor,9,5,4,Australia
20487,1/1/2021,AUS,Kedah,0,0,0,Australia
20488,1/1/2021,AUS,Kelantan,0,0,0,Australia
20489,1/1/2021,AUS,Melaka,0,0,0,Australia
20490,1/1/2021,AUS,Negeri Sembilan,0,0,0,Australia
20491,1/1/2021,AUS,Pahang,0,0,0,Australia
20492,1/1/2021,AUS,Perak,1,1,0,Australia
20493,1/1/2021,AUS,Perlis,0,0,0,Australia
20494,1/1/2021,AUS,Pulau Pinang,5,2,3,Australia
20495,1/1/2021,AUS,Sabah,0,0,0,Australia
20496,1/1/2021,AUS,Sarawak,2,2,0,Australia
20497,1/1/2021,AUS,Selangor,135,89,46,Australia
20498,1/1/2021,AUS,Terengganu,0,0,0,Australia
20499,1/1/2021,AUS,W.P. Labuan,0,0,0,Australia
20500,1/1/2021,AUT,Johor,0,0,0,Austria
20501,1/1/2021,AUT,Kedah,0,0,0,Austria
20502,1/1/2021,AUT,Kelantan,0,0,0,Austria
20503,1/1/2021,AUT,Melaka,0,0,0,Austria
20504,1/1/2021,AUT,Negeri Sembilan,0,0,0,Austria
20505,1/1/2021,AUT,Pahang,0,0,0,Austria
20506,1/1/2021,AUT,Perak,0,0,0,Austria
20507,1/1/2021,AUT,Perlis,0,0,0,Austria
20508,1/1/2021,AUT,Pulau Pinang,0,0,0,Austria
20509,1/1/2021,AUT,Sabah,0,0,0,Austria
20510,1/1/2021,AUT,Sarawak,0,0,0,Austria
20511,1/1/2021,AUT,Selangor,19,14,5,Austria
20512,1/1/2021,AUT,Terengganu,0,0,0,Austria
20513,1/1/2021,AUT,W.P. Labuan,0,0,0,Austria
20514,1/1/2021,AZE,Johor,0,0,0,Azerbaijan
20515,1/1/2021,AZE,Kedah,0,0,0,Azerbaijan
20516,1/1/2021,AZE,Kelantan,0,0,0,Azerbaijan
20517,1/1/2021,AZE,Melaka,0,0,0,Azerbaijan
20518,1/1/2021,AZE,Perlis,0,0,0,Azerbaijan
20519,1/1/2021,AZE,Pulau Pinang,0,0,0,Azerbaijan
20520,1/1/2021,AZE,Sabah,0,0,0,Azerbaijan
20521,1/1/2021,AZE,Sarawak,0,0,0,Azerbaijan
20522,1/1/2021,AZE,Selangor,1,1,0,Azerbaijan
20523,1/1/2021,AZE,W.P. Labuan,0,0,0,Azerbaijan
20524,1/1/2021,BDI,Pulau Pinang,0,0,0,Burundi
20525,1/1/2021,BDI,Sarawak,0,0,0,Burundi
20526,1/1/2021,BDI,Selangor,0,0,0,Burundi
20527,1/1/2021,BEL,Johor,0,0,0,Belgium
20528,1/1/2021,BEL,Kedah,0,0,0,Belgium
20529,1/1/2021,BEL,Kelantan,0,0,0,Belgium
20530,1/1/2021,BEL,Melaka,0,0,0,Belgium
20531,1/1/2021,BEL,Negeri Sembilan,0,0,0,Belgium
20532,1/1/2021,BEL,Pahang,0,0,0,Belgium
20533,1/1/2021,BEL,Perak,0,0,0,Belgium
20534,1/1/2021,BEL,Perlis,0,0,0,Belgium
20535,1/1/2021,BEL,Pulau Pinang,0,0,0,Belgium
20536,1/1/2021,BEL,Sabah,0,0,0,Belgium
20537,1/1/2021,BEL,Sarawak,0,0,0,Belgium
20538,1/1/2021,BEL,Selangor,21,14,7,Belgium
20539,1/1/2021,BEL,W.P. Labuan,0,0,0,Belgium
20540,1/1/2021,BEN,Johor,0,0,0,Benin
20541,1/1/2021,BEN,Kedah,0,0,0,Benin
20542,1/1/2021,BEN,Perak,0,0,0,Benin
20543,1/1/2021,BEN,Pulau Pinang,0,0,0,Benin
20544,1/1/2021,BEN,Sabah,0,0,0,Benin
20545,1/1/2021,BEN,Sarawak,0,0,0,Benin
20546,1/1/2021,BEN,Selangor,0,0,0,Benin
20547,1/1/2021,BFA,Perak,0,0,0,Burkina Faso
20548,1/1/2021,BFA,Pulau Pinang,0,0,0,Burkina Faso
20549,1/1/2021,BFA,Selangor,0,0,0,Burkina Faso
20550,1/1/2021,BGD,Johor,7,7,0,Bangladesh
20551,1/1/2021,BGD,Kedah,0,0,0,Bangladesh
20552,1/1/2021,BGD,Kelantan,0,0,0,Bangladesh
20553,1/1/2021,BGD,Melaka,0,0,0,Bangladesh
20554,1/1/2021,BGD,Negeri Sembilan,0,0,0,Bangladesh
20555,1/1/2021,BGD,Pahang,0,0,0,Bangladesh
20556,1/1/2021,BGD,Perak,0,0,0,Bangladesh
20557,1/1/2021,BGD,Perlis,0,0,0,Bangladesh
20558,1/1/2021,BGD,Pulau Pinang,0,0,0,Bangladesh
20559,1/1/2021,BGD,Sabah,0,0,0,Bangladesh
20560,1/1/2021,BGD,Sarawak,0,0,0,Bangladesh
20561,1/1/2021,BGD,Selangor,99,94,5,Bangladesh
20562,1/1/2021,BGD,W.P. Labuan,0,0,0,Bangladesh
20563,1/1/2021,BGR,Johor,0,0,0,Bulgaria
20564,1/1/2021,BGR,Kedah,0,0,0,Bulgaria
20565,1/1/2021,BGR,Kelantan,0,0,0,Bulgaria
20566,1/1/2021,BGR,Pahang,0,0,0,Bulgaria
20567,1/1/2021,BGR,Perak,0,0,0,Bulgaria
20568,1/1/2021,BGR,Perlis,0,0,0,Bulgaria
20569,1/1/2021,BGR,Pulau Pinang,0,0,0,Bulgaria
20570,1/1/2021,BGR,Sabah,0,0,0,Bulgaria
20571,1/1/2021,BGR,Sarawak,0,0,0,Bulgaria
20572,1/1/2021,BGR,Selangor,17,15,2,Bulgaria
20573,1/1/2021,BGR,W.P. Labuan,0,0,0,Bulgaria
20574,1/1/2021,BHR,Johor,0,0,0,Bahrain
20575,1/1/2021,BHR,Kedah,0,0,0,Bahrain
20576,1/1/2021,BHR,Kelantan,0,0,0,Bahrain
20577,1/1/2021,BHR,Perlis,0,0,0,Bahrain
20578,1/1/2021,BHR,Pulau Pinang,0,0,0,Bahrain
20579,1/1/2021,BHR,Sabah,0,0,0,Bahrain
20580,1/1/2021,BHR,Sarawak,0,0,0,Bahrain
20581,1/1/2021,BHR,Selangor,0,0,0,Bahrain
20582,1/1/2021,BHS,Johor,0,0,0,Bahamas
20583,1/1/2021,BHS,Kedah,0,0,0,Bahamas
20584,1/1/2021,BHS,Perak,0,0,0,Bahamas
20585,1/1/2021,BHS,Sabah,0,0,0,Bahamas
20586,1/1/2021,BHS,Sarawak,0,0,0,Bahamas
20587,1/1/2021,BHS,Selangor,0,0,0,Bahamas
20588,1/1/2021,BIH,Johor,0,0,0,Bosnia and Herzegovina
20589,1/1/2021,BIH,Kedah,0,0,0,Bosnia and Herzegovina
20590,1/1/2021,BIH,Perlis,0,0,0,Bosnia and Herzegovina
20591,1/1/2021,BIH,Pulau Pinang,0,0,0,Bosnia and Herzegovina
20592,1/1/2021,BIH,Sabah,0,0,0,Bosnia and Herzegovina
20593,1/1/2021,BIH,Sarawak,0,0,0,Bosnia and Herzegovina
20594,1/1/2021,BIH,Selangor,10,7,3,Bosnia and Herzegovina
20595,1/1/2021,BLR,Johor,0,0,0,Belarus
20596,1/1/2021,BLR,Kedah,0,0,0,Belarus
20597,1/1/2021,BLR,Kelantan,0,0,0,Belarus
20598,1/1/2021,BLR,Pahang,0,0,0,Belarus
20599,1/1/2021,BLR,Perak,0,0,0,Belarus
20600,1/1/2021,BLR,Perlis,0,0,0,Belarus
20601,1/1/2021,BLR,Pulau Pinang,0,0,0,Belarus
20602,1/1/2021,BLR,Sabah,0,0,0,Belarus
20603,1/1/2021,BLR,Sarawak,0,0,0,Belarus
20604,1/1/2021,BLR,Selangor,2,1,1,Belarus
20605,1/1/2021,BLR,W.P. Labuan,0,0,0,Belarus
20606,1/1/2021,BLZ,Johor,0,0,0,Belize
20607,1/1/2021,BLZ,Pulau Pinang,0,0,0,Belize
20608,1/1/2021,BLZ,Sarawak,0,0,0,Belize
20609,1/1/2021,BLZ,Selangor,1,1,0,Belize
20610,1/1/2021,BMU,Selangor,0,0,0,Bermuda
20611,1/1/2021,BOL,Johor,0,0,0,Bolivia
20612,1/1/2021,BOL,Kedah,0,0,0,Bolivia
20613,1/1/2021,BOL,Melaka,0,0,0,Bolivia
20614,1/1/2021,BOL,Perak,0,0,0,Bolivia
20615,1/1/2021,BOL,Perlis,0,0,0,Bolivia
20616,1/1/2021,BOL,Pulau Pinang,0,0,0,Bolivia
20617,1/1/2021,BOL,Sabah,0,0,0,Bolivia
20618,1/1/2021,BOL,Sarawak,0,0,0,Bolivia
20619,1/1/2021,BOL,Selangor,0,0,0,Bolivia
20620,1/1/2021,BRA,Johor,0,0,0,Brazil
20621,1/1/2021,BRA,Kedah,0,0,0,Brazil
20622,1/1/2021,BRA,Kelantan,0,0,0,Brazil
20623,1/1/2021,BRA,Melaka,0,0,0,Brazil
20624,1/1/2021,BRA,Pahang,0,0,0,Brazil
20625,1/1/2021,BRA,Perak,0,0,0,Brazil
20626,1/1/2021,BRA,Perlis,0,0,0,Brazil
20627,1/1/2021,BRA,Pulau Pinang,0,0,0,Brazil
20628,1/1/2021,BRA,Sabah,0,0,0,Brazil
20629,1/1/2021,BRA,Sarawak,0,0,0,Brazil
20630,1/1/2021,BRA,Selangor,35,25,10,Brazil
20631,1/1/2021,BRA,W.P. Labuan,0,0,0,Brazil
20632,1/1/2021,BRB,Johor,0,0,0,Barbados
20633,1/1/2021,BRB,Kedah,0,0,0,Barbados
20634,1/1/2021,BRB,Perlis,0,0,0,Barbados
20635,1/1/2021,BRB,Pulau Pinang,0,0,0,Barbados
20636,1/1/2021,BRB,Selangor,1,1,0,Barbados
20637,1/1/2021,BRN,Johor,1,1,0,Brunei Darussalam
20638,1/1/2021,BRN,Kedah,0,0,0,Brunei Darussalam
20639,1/1/2021,BRN,Kelantan,0,0,0,Brunei Darussalam
20640,1/1/2021,BRN,Melaka,0,0,0,Brunei Darussalam
20641,1/1/2021,BRN,Pahang,0,0,0,Brunei Darussalam
20642,1/1/2021,BRN,Perak,0,0,0,Brunei Darussalam
20643,1/1/2021,BRN,Perlis,0,0,0,Brunei Darussalam
20644,1/1/2021,BRN,Pulau Pinang,0,0,0,Brunei Darussalam
20645,1/1/2021,BRN,Sabah,0,0,0,Brunei Darussalam
20646,1/1/2021,BRN,Sarawak,326,322,4,Brunei Darussalam
20647,1/1/2021,BRN,Selangor,8,7,1,Brunei Darussalam
20648,1/1/2021,BRN,W.P. Labuan,2,2,0,Brunei Darussalam
20649,1/1/2021,BTN,Johor,0,0,0,Bhutan
20650,1/1/2021,BTN,Kedah,0,0,0,Bhutan
20651,1/1/2021,BTN,Perak,0,0,0,Bhutan
20652,1/1/2021,BTN,Perlis,0,0,0,Bhutan
20653,1/1/2021,BTN,Pulau Pinang,0,0,0,Bhutan
20654,1/1/2021,BTN,Sabah,0,0,0,Bhutan
20655,1/1/2021,BTN,Sarawak,0,0,0,Bhutan
20656,1/1/2021,BTN,Selangor,0,0,0,Bhutan
20657,1/1/2021,BWA,Johor,0,0,0,Botswana
20658,1/1/2021,BWA,Kedah,0,0,0,Botswana
20659,1/1/2021,BWA,Perlis,0,0,0,Botswana
20660,1/1/2021,BWA,Pulau Pinang,0,0,0,Botswana
20661,1/1/2021,BWA,Sabah,0,0,0,Botswana
20662,1/1/2021,BWA,Sarawak,0,0,0,Botswana
20663,1/1/2021,BWA,Selangor,0,0,0,Botswana
20664,1/1/2021,CAF,Kedah,0,0,0,Central African Republic
20665,1/1/2021,CAF,Selangor,0,0,0,Central African Republic
20666,1/1/2021,CAN,Johor,2,2,0,Canada
20667,1/1/2021,CAN,Kedah,0,0,0,Canada
20668,1/1/2021,CAN,Kelantan,0,0,0,Canada
20669,1/1/2021,CAN,Melaka,0,0,0,Canada
20670,1/1/2021,CAN,Negeri Sembilan,0,0,0,Canada
20671,1/1/2021,CAN,Pahang,0,0,0,Canada
20672,1/1/2021,CAN,Perak,0,0,0,Canada
20673,1/1/2021,CAN,Perlis,0,0,0,Canada
20674,1/1/2021,CAN,Pulau Pinang,0,0,0,Canada
20675,1/1/2021,CAN,Sabah,0,0,0,Canada
20676,1/1/2021,CAN,Sarawak,0,0,0,Canada
20677,1/1/2021,CAN,Selangor,81,53,28,Canada
20678,1/1/2021,CAN,Terengganu,0,0,0,Canada
20679,1/1/2021,CAN,W.P. Labuan,0,0,0,Canada
20680,1/1/2021,CCK,Selangor,0,0,0,Cocos (Keeling) Islands
20681,1/1/2021,CHE,Johor,1,0,1,Switzerland
20682,1/1/2021,CHE,Kedah,0,0,0,Switzerland
20683,1/1/2021,CHE,Kelantan,0,0,0,Switzerland
20684,1/1/2021,CHE,Melaka,0,0,0,Switzerland
20685,1/1/2021,CHE,Negeri Sembilan,0,0,0,Switzerland
20686,1/1/2021,CHE,Pahang,0,0,0,Switzerland
20687,1/1/2021,CHE,Perak,0,0,0,Switzerland
20688,1/1/2021,CHE,Perlis,0,0,0,Switzerland
20689,1/1/2021,CHE,Pulau Pinang,1,1,0,Switzerland
20690,1/1/2021,CHE,Sabah,0,0,0,Switzerland
20691,1/1/2021,CHE,Sarawak,0,0,0,Switzerland
20692,1/1/2021,CHE,Selangor,14,6,8,Switzerland
20693,1/1/2021,CHE,W.P. Labuan,0,0,0,Switzerland
20694,1/1/2021,CHL,Johor,0,0,0,Chile
20695,1/1/2021,CHL,Kedah,0,0,0,Chile
20696,1/1/2021,CHL,Kelantan,0,0,0,Chile
20697,1/1/2021,CHL,Melaka,0,0,0,Chile
20698,1/1/2021,CHL,Pahang,0,0,0,Chile
20699,1/1/2021,CHL,Perak,0,0,0,Chile
20700,1/1/2021,CHL,Perlis,0,0,0,Chile
20701,1/1/2021,CHL,Pulau Pinang,0,0,0,Chile
20702,1/1/2021,CHL,Sabah,0,0,0,Chile
20703,1/1/2021,CHL,Sarawak,0,0,0,Chile
20704,1/1/2021,CHL,Selangor,1,1,0,Chile
20705,1/1/2021,CHN,Johor,24,22,2,China
20706,1/1/2021,CHN,Kedah,0,0,0,China
20707,1/1/2021,CHN,Kelantan,0,0,0,China
20708,1/1/2021,CHN,Melaka,0,0,0,China
20709,1/1/2021,CHN,Pahang,0,0,0,China
20710,1/1/2021,CHN,Perak,0,0,0,China
20711,1/1/2021,CHN,Perlis,0,0,0,China
20712,1/1/2021,CHN,Pulau Pinang,3,3,0,China
20713,1/1/2021,CHN,Sabah,0,0,0,China
20714,1/1/2021,CHN,Sarawak,209,200,9,China
20715,1/1/2021,CHN,Selangor,870,717,153,China
20716,1/1/2021,CHN,Terengganu,0,0,0,China
20717,1/1/2021,CHN,W.P. Labuan,0,0,0,China
20718,1/1/2021,CIV,Johor,0,0,0,C��te d'Iv
20719,1/1/2021,CIV,Kedah,0,0,0,C��te d'Iv
20720,1/1/2021,CIV,Pulau Pinang,0,0,0,C��te d'Iv
20721,1/1/2021,CIV,Sabah,0,0,0,C��te d'Iv
20722,1/1/2021,CIV,Sarawak,0,0,0,C��te d'Iv
20723,1/1/2021,CIV,Selangor,1,1,0,C��te d'Iv
20724,1/1/2021,CMR,Johor,0,0,0,Cameroon
20725,1/1/2021,CMR,Kedah,0,0,0,Cameroon
20726,1/1/2021,CMR,Pulau Pinang,0,0,0,Cameroon
20727,1/1/2021,CMR,Sabah,0,0,0,Cameroon
20728,1/1/2021,CMR,Sarawak,0,0,0,Cameroon
20729,1/1/2021,CMR,Selangor,2,1,1,Cameroon
20730,1/1/2021,COD,Johor,0,0,0,"Congo, the Democratic Republic of the"
20731,1/1/2021,COD,Pulau Pinang,0,0,0,"Congo, the Democratic Republic of the"
20732,1/1/2021,COD,Sarawak,0,0,0,"Congo, the Democratic Republic of the"
20733,1/1/2021,COD,Selangor,0,0,0,"Congo, the Democratic Republic of the"
20734,1/1/2021,COG,Johor,0,0,0,Congo
20735,1/1/2021,COG,Kedah,0,0,0,Congo
20736,1/1/2021,COG,Selangor,0,0,0,Congo
20737,1/1/2021,COK,Selangor,0,0,0,Cook Islands
20738,1/1/2021,COL,Johor,0,0,0,Colombia
20739,1/1/2021,COL,Kedah,0,0,0,Colombia
20740,1/1/2021,COL,Perak,0,0,0,Colombia
20741,1/1/2021,COL,Pulau Pinang,0,0,0,Colombia
20742,1/1/2021,COL,Sabah,0,0,0,Colombia
20743,1/1/2021,COL,Sarawak,0,0,0,Colombia
20744,1/1/2021,COL,Selangor,6,1,5,Colombia
20745,1/1/2021,COL,W.P. Labuan,0,0,0,Colombia
20746,1/1/2021,COM,Johor,0,0,0,Comoros
20747,1/1/2021,COM,Kedah,0,0,0,Comoros
20748,1/1/2021,COM,Selangor,0,0,0,Comoros
20749,1/1/2021,CPV,Johor,0,0,0,Cape Verde
20750,1/1/2021,CPV,Kedah,0,0,0,Cape Verde
20751,1/1/2021,CPV,Pulau Pinang,0,0,0,Cape Verde
20752,1/1/2021,CPV,Sabah,0,0,0,Cape Verde
20753,1/1/2021,CPV,Selangor,0,0,0,Cape Verde
20754,1/1/2021,CRI,Johor,0,0,0,Costa Rica
20755,1/1/2021,CRI,Kedah,0,0,0,Costa Rica
20756,1/1/2021,CRI,Perak,0,0,0,Costa Rica
20757,1/1/2021,CRI,Perlis,0,0,0,Costa Rica
20758,1/1/2021,CRI,Pulau Pinang,0,0,0,Costa Rica
20759,1/1/2021,CRI,Sabah,0,0,0,Costa Rica
20760,1/1/2021,CRI,Sarawak,0,0,0,Costa Rica
20761,1/1/2021,CRI,Selangor,21,11,10,Costa Rica
20762,1/1/2021,CUB,Johor,0,0,0,Cuba
20763,1/1/2021,CUB,Kedah,0,0,0,Cuba
20764,1/1/2021,CUB,Perlis,0,0,0,Cuba
20765,1/1/2021,CUB,Pulau Pinang,0,0,0,Cuba
20766,1/1/2021,CUB,Sabah,0,0,0,Cuba
20767,1/1/2021,CUB,Sarawak,0,0,0,Cuba
20768,1/1/2021,CUB,Selangor,0,0,0,Cuba
20769,1/1/2021,CYP,Johor,0,0,0,Cyprus
20770,1/1/2021,CYP,Kedah,0,0,0,Cyprus
20771,1/1/2021,CYP,Perak,0,0,0,Cyprus
20772,1/1/2021,CYP,Perlis,0,0,0,Cyprus
20773,1/1/2021,CYP,Pulau Pinang,0,0,0,Cyprus
20774,1/1/2021,CYP,Sabah,0,0,0,Cyprus
20775,1/1/2021,CYP,Sarawak,0,0,0,Cyprus
20776,1/1/2021,CYP,Selangor,0,0,0,Cyprus
20777,1/1/2021,CZE,Johor,0,0,0,Czech Republic
20778,1/1/2021,CZE,Kedah,0,0,0,Czech Republic
20779,1/1/2021,CZE,Kelantan,0,0,0,Czech Republic
20780,1/1/2021,CZE,Melaka,0,0,0,Czech Republic
20781,1/1/2021,CZE,Negeri Sembilan,0,0,0,Czech Republic
20782,1/1/2021,CZE,Perak,0,0,0,Czech Republic
20783,1/1/2021,CZE,Perlis,0,0,0,Czech Republic
20784,1/1/2021,CZE,Pulau Pinang,0,0,0,Czech Republic
20785,1/1/2021,CZE,Sabah,0,0,0,Czech Republic
20786,1/1/2021,CZE,Sarawak,0,0,0,Czech Republic
20787,1/1/2021,CZE,Selangor,11,11,0,Czech Republic
20788,1/1/2021,CZE,W.P. Labuan,0,0,0,Czech Republic
20789,1/1/2021,DEU,Johor,1,1,0,Germany
20790,1/1/2021,DEU,Kedah,0,0,0,Germany
20791,1/1/2021,DEU,Kelantan,0,0,0,Germany
20792,1/1/2021,DEU,Melaka,0,0,0,Germany
20793,1/1/2021,DEU,Negeri Sembilan,0,0,0,Germany
20794,1/1/2021,DEU,Pahang,0,0,0,Germany
20795,1/1/2021,DEU,Perak,0,0,0,Germany
20796,1/1/2021,DEU,Perlis,0,0,0,Germany
20797,1/1/2021,DEU,Pulau Pinang,0,0,0,Germany
20798,1/1/2021,DEU,Sabah,0,0,0,Germany
20799,1/1/2021,DEU,Sarawak,0,0,0,Germany
20800,1/1/2021,DEU,Selangor,96,79,17,Germany
20801,1/1/2021,DEU,Terengganu,0,0,0,Germany
20802,1/1/2021,DEU,W.P. Labuan,0,0,0,Germany
20803,1/1/2021,DJI,Johor,0,0,0,Djibouti
20804,1/1/2021,DJI,Selangor,0,0,0,Djibouti
20805,1/1/2021,DMA,Johor,0,0,0,Dominica
20806,1/1/2021,DMA,Kedah,0,0,0,Dominica
20807,1/1/2021,DMA,Pulau Pinang,0,0,0,Dominica
20808,1/1/2021,DMA,Sabah,0,0,0,Dominica
20809,1/1/2021,DMA,Sarawak,0,0,0,Dominica
20810,1/1/2021,DMA,Selangor,1,1,0,Dominica
20811,1/1/2021,DMA,W.P. Labuan,0,0,0,Dominica
20812,1/1/2021,DNK,Johor,0,0,0,Denmark
20813,1/1/2021,DNK,Kedah,0,0,0,Denmark
20814,1/1/2021,DNK,Kelantan,0,0,0,Denmark
20815,1/1/2021,DNK,Melaka,0,0,0,Denmark
20816,1/1/2021,DNK,Negeri Sembilan,0,0,0,Denmark
20817,1/1/2021,DNK,Pahang,0,0,0,Denmark
20818,1/1/2021,DNK,Perak,0,0,0,Denmark
20819,1/1/2021,DNK,Perlis,0,0,0,Denmark
20820,1/1/2021,DNK,Pulau Pinang,0,0,0,Denmark
20821,1/1/2021,DNK,Sabah,0,0,0,Denmark
20822,1/1/2021,DNK,Sarawak,0,0,0,Denmark
20823,1/1/2021,DNK,Selangor,26,18,8,Denmark
20824,1/1/2021,DNK,W.P. Labuan,0,0,0,Denmark
20825,1/1/2021,DOM,Johor,0,0,0,Dominican Republic
20826,1/1/2021,DOM,Kedah,0,0,0,Dominican Republic
20827,1/1/2021,DOM,Perak,0,0,0,Dominican Republic
20828,1/1/2021,DOM,Perlis,0,0,0,Dominican Republic
20829,1/1/2021,DOM,Pulau Pinang,0,0,0,Dominican Republic
20830,1/1/2021,DOM,Sabah,0,0,0,Dominican Republic
20831,1/1/2021,DOM,Sarawak,0,0,0,Dominican Republic
20832,1/1/2021,DOM,Selangor,0,0,0,Dominican Republic
20833,1/1/2021,DZA,Johor,0,0,0,Algeria
20834,1/1/2021,DZA,Kedah,0,0,0,Algeria
20835,1/1/2021,DZA,Kelantan,0,0,0,Algeria
20836,1/1/2021,DZA,Melaka,0,0,0,Algeria
20837,1/1/2021,DZA,Perak,0,0,0,Algeria
20838,1/1/2021,DZA,Perlis,0,0,0,Algeria
20839,1/1/2021,DZA,Pulau Pinang,0,0,0,Algeria
20840,1/1/2021,DZA,Sabah,0,0,0,Algeria
20841,1/1/2021,DZA,Sarawak,0,0,0,Algeria
20842,1/1/2021,DZA,Selangor,9,5,4,Algeria
20843,1/1/2021,DZA,W.P. Labuan,0,0,0,Algeria
20844,1/1/2021,ECU,Johor,0,0,0,Ecuador
20845,1/1/2021,ECU,Kedah,0,0,0,Ecuador
20846,1/1/2021,ECU,Perak,0,0,0,Ecuador
20847,1/1/2021,ECU,Perlis,0,0,0,Ecuador
20848,1/1/2021,ECU,Pulau Pinang,0,0,0,Ecuador
20849,1/1/2021,ECU,Sabah,0,0,0,Ecuador
20850,1/1/2021,ECU,Sarawak,0,0,0,Ecuador
20851,1/1/2021,ECU,Selangor,0,0,0,Ecuador
20852,1/1/2021,EGY,Johor,0,0,0,Egypt
20853,1/1/2021,EGY,Kedah,0,0,0,Egypt
20854,1/1/2021,EGY,Kelantan,0,0,0,Egypt
20855,1/1/2021,EGY,Melaka,0,0,0,Egypt
20856,1/1/2021,EGY,Pahang,0,0,0,Egypt
20857,1/1/2021,EGY,Perak,0,0,0,Egypt
20858,1/1/2021,EGY,Perlis,0,0,0,Egypt
20859,1/1/2021,EGY,Pulau Pinang,0,0,0,Egypt
20860,1/1/2021,EGY,Sabah,0,0,0,Egypt
20861,1/1/2021,EGY,Sarawak,0,0,0,Egypt
20862,1/1/2021,EGY,Selangor,40,30,10,Egypt
20863,1/1/2021,EGY,Terengganu,0,0,0,Egypt
20864,1/1/2021,EGY,W.P. Labuan,0,0,0,Egypt
20865,1/1/2021,ERI,Johor,0,0,0,Eritrea
20866,1/1/2021,ERI,Pulau Pinang,0,0,0,Eritrea
20867,1/1/2021,ERI,Sabah,0,0,0,Eritrea
20868,1/1/2021,ERI,Selangor,0,0,0,Eritrea
20869,1/1/2021,ESP,Johor,0,0,0,Spain
20870,1/1/2021,ESP,Kedah,0,0,0,Spain
20871,1/1/2021,ESP,Kelantan,0,0,0,Spain
20872,1/1/2021,ESP,Melaka,0,0,0,Spain
20873,1/1/2021,ESP,Negeri Sembilan,0,0,0,Spain
20874,1/1/2021,ESP,Pahang,0,0,0,Spain
20875,1/1/2021,ESP,Perak,0,0,0,Spain
20876,1/1/2021,ESP,Perlis,0,0,0,Spain
20877,1/1/2021,ESP,Pulau Pinang,1,1,0,Spain
20878,1/1/2021,ESP,Sabah,0,0,0,Spain
20879,1/1/2021,ESP,Sarawak,0,0,0,Spain
20880,1/1/2021,ESP,Selangor,19,12,7,Spain
20881,1/1/2021,ESP,W.P. Labuan,0,0,0,Spain
20882,1/1/2021,EST,Johor,0,0,0,Estonia
20883,1/1/2021,EST,Kedah,0,0,0,Estonia
20884,1/1/2021,EST,Kelantan,0,0,0,Estonia
20885,1/1/2021,EST,Pahang,0,0,0,Estonia
20886,1/1/2021,EST,Perak,0,0,0,Estonia
20887,1/1/2021,EST,Perlis,0,0,0,Estonia
20888,1/1/2021,EST,Pulau Pinang,0,0,0,Estonia
20889,1/1/2021,EST,Sabah,0,0,0,Estonia
20890,1/1/2021,EST,Sarawak,0,0,0,Estonia
20891,1/1/2021,EST,Selangor,1,1,0,Estonia
20892,1/1/2021,EST,W.P. Labuan,0,0,0,Estonia
20893,1/1/2021,ETH,Johor,0,0,0,Ethiopia
20894,1/1/2021,ETH,Kedah,0,0,0,Ethiopia
20895,1/1/2021,ETH,Pulau Pinang,0,0,0,Ethiopia
20896,1/1/2021,ETH,Sarawak,0,0,0,Ethiopia
20897,1/1/2021,ETH,Selangor,0,0,0,Ethiopia
20898,1/1/2021,FIN,Johor,0,0,0,Finland
20899,1/1/2021,FIN,Kedah,0,0,0,Finland
20900,1/1/2021,FIN,Kelantan,0,0,0,Finland
20901,1/1/2021,FIN,Melaka,0,0,0,Finland
20902,1/1/2021,FIN,Negeri Sembilan,0,0,0,Finland
20903,1/1/2021,FIN,Pahang,0,0,0,Finland
20904,1/1/2021,FIN,Perak,0,0,0,Finland
20905,1/1/2021,FIN,Perlis,0,0,0,Finland
20906,1/1/2021,FIN,Pulau Pinang,0,0,0,Finland
20907,1/1/2021,FIN,Sabah,0,0,0,Finland
20908,1/1/2021,FIN,Sarawak,0,0,0,Finland
20909,1/1/2021,FIN,Selangor,9,6,3,Finland
20910,1/1/2021,FIN,W.P. Labuan,0,0,0,Finland
20911,1/1/2021,FJI,Johor,0,0,0,Fiji
20912,1/1/2021,FJI,Kedah,0,0,0,Fiji
20913,1/1/2021,FJI,Kelantan,0,0,0,Fiji
20914,1/1/2021,FJI,Perak,0,0,0,Fiji
20915,1/1/2021,FJI,Perlis,0,0,0,Fiji
20916,1/1/2021,FJI,Pulau Pinang,0,0,0,Fiji
20917,1/1/2021,FJI,Sabah,0,0,0,Fiji
20918,1/1/2021,FJI,Sarawak,0,0,0,Fiji
20919,1/1/2021,FJI,Selangor,0,0,0,Fiji
20920,1/1/2021,FRA,Johor,2,2,0,France
20921,1/1/2021,FRA,Kedah,0,0,0,France
20922,1/1/2021,FRA,Kelantan,0,0,0,France
20923,1/1/2021,FRA,Melaka,0,0,0,France
20924,1/1/2021,FRA,Negeri Sembilan,0,0,0,France
20925,1/1/2021,FRA,Pahang,0,0,0,France
20926,1/1/2021,FRA,Perak,0,0,0,France
20927,1/1/2021,FRA,Perlis,0,0,0,France
20928,1/1/2021,FRA,Pulau Pinang,0,0,0,France
20929,1/1/2021,FRA,Sabah,0,0,0,France
20930,1/1/2021,FRA,Sarawak,0,0,0,France
20931,1/1/2021,FRA,Selangor,117,86,31,France
20932,1/1/2021,FRA,Terengganu,0,0,0,France
20933,1/1/2021,FRA,W.P. Labuan,0,0,0,France
20934,1/1/2021,FSM,Johor,0,0,0,"Micronesia, Federated States of"
20935,1/1/2021,FSM,Pulau Pinang,0,0,0,"Micronesia, Federated States of"
20936,1/1/2021,FSM,Selangor,0,0,0,"Micronesia, Federated States of"
20937,1/1/2021,GAB,Johor,0,0,0,Gabon
20938,1/1/2021,GAB,Pulau Pinang,0,0,0,Gabon
20939,1/1/2021,GAB,Sarawak,0,0,0,Gabon
20940,1/1/2021,GAB,Selangor,1,1,0,Gabon
20941,1/1/2021,GBR,Johor,10,9,1,United Kingdom
20942,1/1/2021,GBR,Kedah,0,0,0,United Kingdom
20943,1/1/2021,GBR,Kelantan,0,0,0,United Kingdom
20944,1/1/2021,GBR,Melaka,0,0,0,United Kingdom
20945,1/1/2021,GBR,Negeri Sembilan,0,0,0,United Kingdom
20946,1/1/2021,GBR,Pahang,0,0,0,United Kingdom
20947,1/1/2021,GBR,Perak,1,0,1,United Kingdom
20948,1/1/2021,GBR,Perlis,0,0,0,United Kingdom
20949,1/1/2021,GBR,Pulau Pinang,3,3,0,United Kingdom
20950,1/1/2021,GBR,Sabah,0,0,0,United Kingdom
20951,1/1/2021,GBR,Sarawak,1,1,0,United Kingdom
20952,1/1/2021,GBR,Selangor,228,179,49,United Kingdom
20953,1/1/2021,GBR,Terengganu,0,0,0,United Kingdom
20954,1/1/2021,GBR,W.P. Labuan,0,0,0,United Kingdom
20955,1/1/2021,GEO,Johor,0,0,0,Georgia
20956,1/1/2021,GEO,Kedah,0,0,0,Georgia
20957,1/1/2021,GEO,Melaka,0,0,0,Georgia
20958,1/1/2021,GEO,Perak,0,0,0,Georgia
20959,1/1/2021,GEO,Perlis,0,0,0,Georgia
20960,1/1/2021,GEO,Pulau Pinang,0,0,0,Georgia
20961,1/1/2021,GEO,Sabah,0,0,0,Georgia
20962,1/1/2021,GEO,Sarawak,0,0,0,Georgia
20963,1/1/2021,GEO,Selangor,2,2,0,Georgia
20964,1/1/2021,GHA,Johor,0,0,0,Ghana
20965,1/1/2021,GHA,Kedah,0,0,0,Ghana
20966,1/1/2021,GHA,Kelantan,0,0,0,Ghana
20967,1/1/2021,GHA,Pulau Pinang,0,0,0,Ghana
20968,1/1/2021,GHA,Sabah,0,0,0,Ghana
20969,1/1/2021,GHA,Sarawak,0,0,0,Ghana
20970,1/1/2021,GHA,Selangor,7,7,0,Ghana
20971,1/1/2021,GIB,Johor,0,0,0,Gibraltar
20972,1/1/2021,GIB,Sarawak,0,0,0,Gibraltar
20973,1/1/2021,GIN,Johor,0,0,0,Guinea
20974,1/1/2021,GIN,Kedah,0,0,0,Guinea
20975,1/1/2021,GIN,Kelantan,0,0,0,Guinea
20976,1/1/2021,GIN,Perlis,0,0,0,Guinea
20977,1/1/2021,GIN,Pulau Pinang,0,0,0,Guinea
20978,1/1/2021,GIN,Sabah,0,0,0,Guinea
20979,1/1/2021,GIN,Sarawak,0,0,0,Guinea
20980,1/1/2021,GIN,Selangor,0,0,0,Guinea
20981,1/1/2021,GLP,Selangor,0,0,0,Guadeloupe
20982,1/1/2021,GMB,Johor,0,0,0,Gambia
20983,1/1/2021,GMB,Kedah,0,0,0,Gambia
20984,1/1/2021,GMB,Kelantan,0,0,0,Gambia
20985,1/1/2021,GMB,Pulau Pinang,0,0,0,Gambia
20986,1/1/2021,GMB,Sabah,0,0,0,Gambia
20987,1/1/2021,GMB,Sarawak,0,0,0,Gambia
20988,1/1/2021,GMB,Selangor,1,0,1,Gambia
20989,1/1/2021,GNB,Johor,0,0,0,Guinea-Bissau
20990,1/1/2021,GNB,Selangor,0,0,0,Guinea-Bissau
20991,1/1/2021,GNQ,Johor,0,0,0,Equatorial Guinea
20992,1/1/2021,GNQ,Selangor,0,0,0,Equatorial Guinea
20993,1/1/2021,GRC,Johor,0,0,0,Greece
20994,1/1/2021,GRC,Kedah,0,0,0,Greece
20995,1/1/2021,GRC,Kelantan,0,0,0,Greece
20996,1/1/2021,GRC,Melaka,0,0,0,Greece
20997,1/1/2021,GRC,Negeri Sembilan,0,0,0,Greece
20998,1/1/2021,GRC,Pahang,0,0,0,Greece
20999,1/1/2021,GRC,Perak,0,0,0,Greece
21000,1/1/2021,GRC,Perlis,0,0,0,Greece
21001,1/1/2021,GRC,Pulau Pinang,0,0,0,Greece
21002,1/1/2021,GRC,Sabah,0,0,0,Greece
21003,1/1/2021,GRC,Sarawak,0,0,0,Greece
21004,1/1/2021,GRC,Selangor,1,1,0,Greece
21005,1/1/2021,GRD,Johor,0,0,0,Grenada
21006,1/1/2021,GRD,Kedah,0,0,0,Grenada
21007,1/1/2021,GRD,Pulau Pinang,0,0,0,Grenada
21008,1/1/2021,GRD,Sabah,0,0,0,Grenada
21009,1/1/2021,GRD,Sarawak,0,0,0,Grenada
21010,1/1/2021,GRD,Selangor,0,0,0,Grenada
21011,1/1/2021,GRL,Johor,0,0,0,Greenland
21012,1/1/2021,GRL,Selangor,0,0,0,Greenland
21013,1/1/2021,GTM,Johor,0,0,0,Guatemala
21014,1/1/2021,GTM,Kedah,0,0,0,Guatemala
21015,1/1/2021,GTM,Pahang,0,0,0,Guatemala
21016,1/1/2021,GTM,Perak,0,0,0,Guatemala
21017,1/1/2021,GTM,Pulau Pinang,0,0,0,Guatemala
21018,1/1/2021,GTM,Sabah,0,0,0,Guatemala
21019,1/1/2021,GTM,Sarawak,0,0,0,Guatemala
21020,1/1/2021,GTM,Selangor,0,0,0,Guatemala
21021,1/1/2021,GTM,W.P. Labuan,0,0,0,Guatemala
21022,1/1/2021,GUY,Johor,0,0,0,Guyana
21023,1/1/2021,GUY,Kedah,0,0,0,Guyana
21024,1/1/2021,GUY,Pulau Pinang,0,0,0,Guyana
21025,1/1/2021,GUY,Sarawak,0,0,0,Guyana
21026,1/1/2021,GUY,Selangor,0,0,0,Guyana
21027,1/1/2021,HKG,Johor,0,0,0,Hong Kong
21028,1/1/2021,HKG,Kedah,0,0,0,Hong Kong
21029,1/1/2021,HKG,Kelantan,0,0,0,Hong Kong
21030,1/1/2021,HKG,Pahang,0,0,0,Hong Kong
21031,1/1/2021,HKG,Perak,0,0,0,Hong Kong
21032,1/1/2021,HKG,Perlis,0,0,0,Hong Kong
21033,1/1/2021,HKG,Pulau Pinang,5,3,2,Hong Kong
21034,1/1/2021,HKG,Sabah,0,0,0,Hong Kong
21035,1/1/2021,HKG,Sarawak,0,0,0,Hong Kong
21036,1/1/2021,HKG,Selangor,2,2,0,Hong Kong
21037,1/1/2021,HKG,Terengganu,0,0,0,Hong Kong
21038,1/1/2021,HMD,Johor,0,0,0,Heard Island and McDonald Islands
21039,1/1/2021,HND,Johor,0,0,0,Honduras
21040,1/1/2021,HND,Kedah,0,0,0,Honduras
21041,1/1/2021,HND,Perak,0,0,0,Honduras
21042,1/1/2021,HND,Pulau Pinang,0,0,0,Honduras
21043,1/1/2021,HND,Sabah,0,0,0,Honduras
21044,1/1/2021,HND,Sarawak,0,0,0,Honduras
21045,1/1/2021,HND,Selangor,1,0,1,Honduras
21046,1/1/2021,HRV,Johor,12,12,0,Croatia
21047,1/1/2021,HRV,Kedah,0,0,0,Croatia
21048,1/1/2021,HRV,Kelantan,0,0,0,Croatia
21049,1/1/2021,HRV,Melaka,0,0,0,Croatia
21050,1/1/2021,HRV,Pahang,0,0,0,Croatia
21051,1/1/2021,HRV,Perak,0,0,0,Croatia
21052,1/1/2021,HRV,Perlis,0,0,0,Croatia
21053,1/1/2021,HRV,Pulau Pinang,0,0,0,Croatia
21054,1/1/2021,HRV,Sabah,0,0,0,Croatia
21055,1/1/2021,HRV,Sarawak,0,0,0,Croatia
21056,1/1/2021,HRV,Selangor,36,36,0,Croatia
21057,1/1/2021,HTI,Johor,0,0,0,Haiti
21058,1/1/2021,HTI,Kedah,0,0,0,Haiti
21059,1/1/2021,HTI,Kelantan,0,0,0,Haiti
21060,1/1/2021,HTI,Perak,0,0,0,Haiti
21061,1/1/2021,HTI,Pulau Pinang,0,0,0,Haiti
21062,1/1/2021,HTI,Sabah,0,0,0,Haiti
21063,1/1/2021,HTI,Selangor,0,0,0,Haiti
21064,1/1/2021,HUN,Johor,0,0,0,Hungary
21065,1/1/2021,HUN,Kedah,0,0,0,Hungary
21066,1/1/2021,HUN,Kelantan,0,0,0,Hungary
21067,1/1/2021,HUN,Pahang,0,0,0,Hungary
21068,1/1/2021,HUN,Perak,0,0,0,Hungary
21069,1/1/2021,HUN,Perlis,0,0,0,Hungary
21070,1/1/2021,HUN,Pulau Pinang,0,0,0,Hungary
21071,1/1/2021,HUN,Sabah,0,0,0,Hungary
21072,1/1/2021,HUN,Sarawak,0,0,0,Hungary
21073,1/1/2021,HUN,Selangor,12,9,3,Hungary
21074,1/1/2021,HUN,W.P. Labuan,0,0,0,Hungary
21075,1/1/2021,IDN,Johor,236,200,36,Indonesia
21076,1/1/2021,IDN,Kedah,5,5,0,Indonesia
21077,1/1/2021,IDN,Kelantan,0,0,0,Indonesia
21078,1/1/2021,IDN,Melaka,0,0,0,Indonesia
21079,1/1/2021,IDN,Negeri Sembilan,0,0,0,Indonesia
21080,1/1/2021,IDN,Pahang,0,0,0,Indonesia
21081,1/1/2021,IDN,Perak,0,0,0,Indonesia
21082,1/1/2021,IDN,Perlis,4,3,1,Indonesia
21083,1/1/2021,IDN,Pulau Pinang,16,5,11,Indonesia
21084,1/1/2021,IDN,Sabah,4,0,4,Indonesia
21085,1/1/2021,IDN,Sarawak,313,309,4,Indonesia
21086,1/1/2021,IDN,Selangor,543,378,165,Indonesia
21087,1/1/2021,IDN,Terengganu,0,0,0,Indonesia
21088,1/1/2021,IDN,W.P. Labuan,2,2,0,Indonesia
21089,1/1/2021,IND,Johor,49,48,1,India
21090,1/1/2021,IND,Kedah,0,0,0,India
21091,1/1/2021,IND,Kelantan,0,0,0,India
21092,1/1/2021,IND,Melaka,0,0,0,India
21093,1/1/2021,IND,Negeri Sembilan,0,0,0,India
21094,1/1/2021,IND,Pahang,0,0,0,India
21095,1/1/2021,IND,Perak,0,0,0,India
21096,1/1/2021,IND,Perlis,0,0,0,India
21097,1/1/2021,IND,Pulau Pinang,1,1,0,India
21098,1/1/2021,IND,Sabah,0,0,0,India
21099,1/1/2021,IND,Sarawak,0,0,0,India
21100,1/1/2021,IND,Selangor,707,581,126,India
21101,1/1/2021,IND,Terengganu,0,0,0,India
21102,1/1/2021,IND,W.P. Labuan,0,0,0,India
21103,1/1/2021,IOT,Pulau Pinang,0,0,0,British Indian Ocean Territory
21104,1/1/2021,IOT,Selangor,0,0,0,British Indian Ocean Territory
21105,1/1/2021,IRL,Johor,0,0,0,Ireland
21106,1/1/2021,IRL,Kedah,0,0,0,Ireland
21107,1/1/2021,IRL,Kelantan,0,0,0,Ireland
21108,1/1/2021,IRL,Negeri Sembilan,0,0,0,Ireland
21109,1/1/2021,IRL,Pahang,0,0,0,Ireland
21110,1/1/2021,IRL,Perak,0,0,0,Ireland
21111,1/1/2021,IRL,Perlis,0,0,0,Ireland
21112,1/1/2021,IRL,Pulau Pinang,0,0,0,Ireland
21113,1/1/2021,IRL,Sabah,0,0,0,Ireland
21114,1/1/2021,IRL,Sarawak,0,0,0,Ireland
21115,1/1/2021,IRL,Selangor,15,12,3,Ireland
21116,1/1/2021,IRL,Terengganu,0,0,0,Ireland
21117,1/1/2021,IRL,W.P. Labuan,0,0,0,Ireland
21118,1/1/2021,IRN,Johor,0,0,0,Iran
21119,1/1/2021,IRN,Kedah,0,0,0,Iran
21120,1/1/2021,IRN,Kelantan,0,0,0,Iran
21121,1/1/2021,IRN,Perak,0,0,0,Iran
21122,1/1/2021,IRN,Perlis,0,0,0,Iran
21123,1/1/2021,IRN,Pulau Pinang,0,0,0,Iran
21124,1/1/2021,IRN,Sabah,0,0,0,Iran
21125,1/1/2021,IRN,Sarawak,0,0,0,Iran
21126,1/1/2021,IRN,Selangor,49,41,8,Iran
21127,1/1/2021,IRN,W.P. Labuan,0,0,0,Iran
21128,1/1/2021,IRQ,Johor,0,0,0,Iraq
21129,1/1/2021,IRQ,Kedah,0,0,0,Iraq
21130,1/1/2021,IRQ,Kelantan,0,0,0,Iraq
21131,1/1/2021,IRQ,Melaka,0,0,0,Iraq
21132,1/1/2021,IRQ,Pahang,0,0,0,Iraq
21133,1/1/2021,IRQ,Perak,0,0,0,Iraq
21134,1/1/2021,IRQ,Perlis,0,0,0,Iraq
21135,1/1/2021,IRQ,Pulau Pinang,0,0,0,Iraq
21136,1/1/2021,IRQ,Sabah,0,0,0,Iraq
21137,1/1/2021,IRQ,Sarawak,0,0,0,Iraq
21138,1/1/2021,IRQ,Selangor,11,9,2,Iraq
21139,1/1/2021,ISL,Johor,0,0,0,Iceland
21140,1/1/2021,ISL,Kedah,0,0,0,Iceland
21141,1/1/2021,ISL,Kelantan,0,0,0,Iceland
21142,1/1/2021,ISL,Perak,0,0,0,Iceland
21143,1/1/2021,ISL,Perlis,0,0,0,Iceland
21144,1/1/2021,ISL,Pulau Pinang,0,0,0,Iceland
21145,1/1/2021,ISL,Sabah,0,0,0,Iceland
21146,1/1/2021,ISL,Sarawak,0,0,0,Iceland
21147,1/1/2021,ISL,Selangor,2,1,1,Iceland
21148,1/1/2021,ISL,W.P. Labuan,0,0,0,Iceland
21149,1/1/2021,ISR,Pulau Pinang,0,0,0,Israel
21150,1/1/2021,ITA,Johor,0,0,0,Italy
21151,1/1/2021,ITA,Kedah,0,0,0,Italy
21152,1/1/2021,ITA,Kelantan,0,0,0,Italy
21153,1/1/2021,ITA,Melaka,0,0,0,Italy
21154,1/1/2021,ITA,Negeri Sembilan,0,0,0,Italy
21155,1/1/2021,ITA,Pahang,0,0,0,Italy
21156,1/1/2021,ITA,Perak,0,0,0,Italy
21157,1/1/2021,ITA,Perlis,0,0,0,Italy
21158,1/1/2021,ITA,Pulau Pinang,0,0,0,Italy
21159,1/1/2021,ITA,Sabah,0,0,0,Italy
21160,1/1/2021,ITA,Sarawak,0,0,0,Italy
21161,1/1/2021,ITA,Selangor,47,39,8,Italy
21162,1/1/2021,ITA,W.P. Labuan,0,0,0,Italy
21163,1/1/2021,JAM,Johor,0,0,0,Jamaica
21164,1/1/2021,JAM,Kedah,0,0,0,Jamaica
21165,1/1/2021,JAM,Perak,0,0,0,Jamaica
21166,1/1/2021,JAM,Pulau Pinang,0,0,0,Jamaica
21167,1/1/2021,JAM,Sabah,0,0,0,Jamaica
21168,1/1/2021,JAM,Sarawak,0,0,0,Jamaica
21169,1/1/2021,JAM,Selangor,0,0,0,Jamaica
21170,1/1/2021,JAM,W.P. Labuan,0,0,0,Jamaica
21171,1/1/2021,JOR,Johor,0,0,0,Jordan
21172,1/1/2021,JOR,Kedah,0,0,0,Jordan
21173,1/1/2021,JOR,Kelantan,0,0,0,Jordan
21174,1/1/2021,JOR,Melaka,0,0,0,Jordan
21175,1/1/2021,JOR,Perlis,0,0,0,Jordan
21176,1/1/2021,JOR,Pulau Pinang,0,0,0,Jordan
21177,1/1/2021,JOR,Sabah,0,0,0,Jordan
21178,1/1/2021,JOR,Sarawak,0,0,0,Jordan
21179,1/1/2021,JOR,Selangor,8,6,2,Jordan
21180,1/1/2021,JOR,W.P. Labuan,0,0,0,Jordan
21181,1/1/2021,JPN,Johor,3,3,0,Japan
21182,1/1/2021,JPN,Kedah,0,0,0,Japan
21183,1/1/2021,JPN,Kelantan,0,0,0,Japan
21184,1/1/2021,JPN,Melaka,0,0,0,Japan
21185,1/1/2021,JPN,Negeri Sembilan,0,0,0,Japan
21186,1/1/2021,JPN,Pahang,0,0,0,Japan
21187,1/1/2021,JPN,Perak,0,0,0,Japan
21188,1/1/2021,JPN,Perlis,0,0,0,Japan
21189,1/1/2021,JPN,Pulau Pinang,18,15,3,Japan
21190,1/1/2021,JPN,Sabah,0,0,0,Japan
21191,1/1/2021,JPN,Sarawak,6,6,0,Japan
21192,1/1/2021,JPN,Selangor,369,256,113,Japan
21193,1/1/2021,JPN,W.P. Labuan,0,0,0,Japan
21194,1/1/2021,KAZ,Johor,0,0,0,Kazakhstan
21195,1/1/2021,KAZ,Kedah,0,0,0,Kazakhstan
21196,1/1/2021,KAZ,Kelantan,0,0,0,Kazakhstan
21197,1/1/2021,KAZ,Melaka,0,0,0,Kazakhstan
21198,1/1/2021,KAZ,Perak,0,0,0,Kazakhstan
21199,1/1/2021,KAZ,Perlis,0,0,0,Kazakhstan
21200,1/1/2021,KAZ,Pulau Pinang,0,0,0,Kazakhstan
21201,1/1/2021,KAZ,Sabah,0,0,0,Kazakhstan
21202,1/1/2021,KAZ,Sarawak,0,0,0,Kazakhstan
21203,1/1/2021,KAZ,Selangor,5,1,4,Kazakhstan
21204,1/1/2021,KAZ,W.P. Labuan,0,0,0,Kazakhstan
21205,1/1/2021,KEN,Johor,0,0,0,Kenya
21206,1/1/2021,KEN,Kedah,0,0,0,Kenya
21207,1/1/2021,KEN,Kelantan,0,0,0,Kenya
21208,1/1/2021,KEN,Perak,0,0,0,Kenya
21209,1/1/2021,KEN,Perlis,0,0,0,Kenya
21210,1/1/2021,KEN,Pulau Pinang,0,0,0,Kenya
21211,1/1/2021,KEN,Sabah,0,0,0,Kenya
21212,1/1/2021,KEN,Sarawak,0,0,0,Kenya
21213,1/1/2021,KEN,Selangor,9,7,2,Kenya
21214,1/1/2021,KGZ,Johor,0,0,0,Kyrgyzstan
21215,1/1/2021,KGZ,Kedah,0,0,0,Kyrgyzstan
21216,1/1/2021,KGZ,Kelantan,0,0,0,Kyrgyzstan
21217,1/1/2021,KGZ,Perak,0,0,0,Kyrgyzstan
21218,1/1/2021,KGZ,Perlis,0,0,0,Kyrgyzstan
21219,1/1/2021,KGZ,Pulau Pinang,0,0,0,Kyrgyzstan
21220,1/1/2021,KGZ,Sabah,0,0,0,Kyrgyzstan
21221,1/1/2021,KGZ,Sarawak,0,0,0,Kyrgyzstan
21222,1/1/2021,KGZ,Selangor,4,1,3,Kyrgyzstan
21223,1/1/2021,KHM,Johor,0,0,0,Cambodia
21224,1/1/2021,KHM,Kedah,0,0,0,Cambodia
21225,1/1/2021,KHM,Kelantan,0,0,0,Cambodia
21226,1/1/2021,KHM,Melaka,0,0,0,Cambodia
21227,1/1/2021,KHM,Negeri Sembilan,0,0,0,Cambodia
21228,1/1/2021,KHM,Pahang,0,0,0,Cambodia
21229,1/1/2021,KHM,Perak,0,0,0,Cambodia
21230,1/1/2021,KHM,Perlis,0,0,0,Cambodia
21231,1/1/2021,KHM,Pulau Pinang,0,0,0,Cambodia
21232,1/1/2021,KHM,Sabah,0,0,0,Cambodia
21233,1/1/2021,KHM,Sarawak,0,0,0,Cambodia
21234,1/1/2021,KHM,Selangor,9,4,5,Cambodia
21235,1/1/2021,KHM,W.P. Labuan,0,0,0,Cambodia
21236,1/1/2021,KIR,Johor,0,0,0,Kiribati
21237,1/1/2021,KIR,Sabah,0,0,0,Kiribati
21238,1/1/2021,KIR,Selangor,6,6,0,Kiribati
21239,1/1/2021,KNA,Johor,0,0,0,Saint Kitts and Nevis
21240,1/1/2021,KNA,Kedah,0,0,0,Saint Kitts and Nevis
21241,1/1/2021,KNA,Perlis,0,0,0,Saint Kitts and Nevis
21242,1/1/2021,KNA,Pulau Pinang,0,0,0,Saint Kitts and Nevis
21243,1/1/2021,KNA,Sabah,0,0,0,Saint Kitts and Nevis
21244,1/1/2021,KNA,Selangor,0,0,0,Saint Kitts and Nevis
21245,1/1/2021,KNA,W.P. Labuan,0,0,0,Saint Kitts and Nevis
21246,1/1/2021,KOR,Johor,6,6,0,"Korea, Republic of (South Korea)"
21247,1/1/2021,KOR,Kedah,0,0,0,"Korea, Republic of (South Korea)"
21248,1/1/2021,KOR,Kelantan,0,0,0,"Korea, Republic of (South Korea)"
21249,1/1/2021,KOR,Melaka,0,0,0,"Korea, Republic of (South Korea)"
21250,1/1/2021,KOR,Negeri Sembilan,0,0,0,"Korea, Republic of (South Korea)"
21251,1/1/2021,KOR,Pahang,0,0,0,"Korea, Republic of (South Korea)"
21252,1/1/2021,KOR,Perak,0,0,0,"Korea, Republic of (South Korea)"
21253,1/1/2021,KOR,Perlis,0,0,0,"Korea, Republic of (South Korea)"
21254,1/1/2021,KOR,Pulau Pinang,2,1,1,"Korea, Republic of (South Korea)"
21255,1/1/2021,KOR,Sabah,0,0,0,"Korea, Republic of (South Korea)"
21256,1/1/2021,KOR,Sarawak,3,3,0,"Korea, Republic of (South Korea)"
21257,1/1/2021,KOR,Selangor,226,145,81,"Korea, Republic of (South Korea)"
21258,1/1/2021,KOR,Terengganu,0,0,0,"Korea, Republic of (South Korea)"
21259,1/1/2021,KOR,W.P. Labuan,0,0,0,"Korea, Republic of (South Korea)"
21260,1/1/2021,KWT,Johor,0,0,0,Kuwait
21261,1/1/2021,KWT,Kedah,0,0,0,Kuwait
21262,1/1/2021,KWT,Kelantan,0,0,0,Kuwait
21263,1/1/2021,KWT,Perak,0,0,0,Kuwait
21264,1/1/2021,KWT,Perlis,0,0,0,Kuwait
21265,1/1/2021,KWT,Pulau Pinang,0,0,0,Kuwait
21266,1/1/2021,KWT,Sabah,0,0,0,Kuwait
21267,1/1/2021,KWT,Sarawak,0,0,0,Kuwait
21268,1/1/2021,KWT,Selangor,9,6,3,Kuwait
21269,1/1/2021,KWT,W.P. Labuan,0,0,0,Kuwait
21270,1/1/2021,LAO,Johor,0,0,0,Lao People's Democratic Republic
21271,1/1/2021,LAO,Kedah,0,0,0,Lao People's Democratic Republic
21272,1/1/2021,LAO,Kelantan,0,0,0,Lao People's Democratic Republic
21273,1/1/2021,LAO,Melaka,0,0,0,Lao People's Democratic Republic
21274,1/1/2021,LAO,Perak,0,0,0,Lao People's Democratic Republic
21275,1/1/2021,LAO,Perlis,0,0,0,Lao People's Democratic Republic
21276,1/1/2021,LAO,Pulau Pinang,0,0,0,Lao People's Democratic Republic
21277,1/1/2021,LAO,Sabah,0,0,0,Lao People's Democratic Republic
21278,1/1/2021,LAO,Sarawak,0,0,0,Lao People's Democratic Republic
21279,1/1/2021,LAO,Selangor,3,1,2,Lao People's Democratic Republic
21280,1/1/2021,LAO,W.P. Labuan,0,0,0,Lao People's Democratic Republic
21281,1/1/2021,LBN,Johor,0,0,0,Lebanon
21282,1/1/2021,LBN,Kedah,0,0,0,Lebanon
21283,1/1/2021,LBN,Kelantan,0,0,0,Lebanon
21284,1/1/2021,LBN,Pahang,0,0,0,Lebanon
21285,1/1/2021,LBN,Perak,0,0,0,Lebanon
21286,1/1/2021,LBN,Perlis,0,0,0,Lebanon
21287,1/1/2021,LBN,Pulau Pinang,0,0,0,Lebanon
21288,1/1/2021,LBN,Sabah,0,0,0,Lebanon
21289,1/1/2021,LBN,Sarawak,0,0,0,Lebanon
21290,1/1/2021,LBN,Selangor,2,2,0,Lebanon
21291,1/1/2021,LBN,W.P. Labuan,0,0,0,Lebanon
21292,1/1/2021,LBR,Johor,0,0,0,Liberia
21293,1/1/2021,LBR,Kedah,0,0,0,Liberia
21294,1/1/2021,LBR,Sabah,0,0,0,Liberia
21295,1/1/2021,LBR,Sarawak,0,0,0,Liberia
21296,1/1/2021,LBR,Selangor,0,0,0,Liberia
21297,1/1/2021,LBY,Johor,0,0,0,Libyan Arab Jamahiriya
21298,1/1/2021,LBY,Kedah,0,0,0,Libyan Arab Jamahiriya
21299,1/1/2021,LBY,Perlis,0,0,0,Libyan Arab Jamahiriya
21300,1/1/2021,LBY,Pulau Pinang,0,0,0,Libyan Arab Jamahiriya
21301,1/1/2021,LBY,Sabah,0,0,0,Libyan Arab Jamahiriya
21302,1/1/2021,LBY,Sarawak,0,0,0,Libyan Arab Jamahiriya
21303,1/1/2021,LBY,Selangor,13,11,2,Libyan Arab Jamahiriya
21304,1/1/2021,LCA,Johor,0,0,0,Saint Lucia
21305,1/1/2021,LCA,Kedah,0,0,0,Saint Lucia
21306,1/1/2021,LCA,Pulau Pinang,0,0,0,Saint Lucia
21307,1/1/2021,LCA,Sarawak,0,0,0,Saint Lucia
21308,1/1/2021,LCA,Selangor,1,1,0,Saint Lucia
21309,1/1/2021,LIE,Johor,0,0,0,Liechtenstein
21310,1/1/2021,LIE,Kedah,0,0,0,Liechtenstein
21311,1/1/2021,LIE,Perlis,0,0,0,Liechtenstein
21312,1/1/2021,LIE,Pulau Pinang,0,0,0,Liechtenstein
21313,1/1/2021,LIE,Sabah,0,0,0,Liechtenstein
21314,1/1/2021,LIE,Sarawak,0,0,0,Liechtenstein
21315,1/1/2021,LIE,Selangor,0,0,0,Liechtenstein
21316,1/1/2021,LKA,Johor,9,9,0,Sri Lanka
21317,1/1/2021,LKA,Kedah,0,0,0,Sri Lanka
21318,1/1/2021,LKA,Kelantan,0,0,0,Sri Lanka
21319,1/1/2021,LKA,Melaka,0,0,0,Sri Lanka
21320,1/1/2021,LKA,Pahang,0,0,0,Sri Lanka
21321,1/1/2021,LKA,Perak,0,0,0,Sri Lanka
21322,1/1/2021,LKA,Perlis,0,0,0,Sri Lanka
21323,1/1/2021,LKA,Pulau Pinang,0,0,0,Sri Lanka
21324,1/1/2021,LKA,Sabah,0,0,0,Sri Lanka
21325,1/1/2021,LKA,Sarawak,0,0,0,Sri Lanka
21326,1/1/2021,LKA,Selangor,39,32,7,Sri Lanka
21327,1/1/2021,LKA,W.P. Labuan,0,0,0,Sri Lanka
21328,1/1/2021,LSO,Johor,0,0,0,Lesotho
21329,1/1/2021,LSO,Kedah,0,0,0,Lesotho
21330,1/1/2021,LSO,Pulau Pinang,0,0,0,Lesotho
21331,1/1/2021,LSO,Sarawak,0,0,0,Lesotho
21332,1/1/2021,LSO,Selangor,0,0,0,Lesotho
21333,1/1/2021,LTU,Johor,2,2,0,Lithuania
21334,1/1/2021,LTU,Kedah,0,0,0,Lithuania
21335,1/1/2021,LTU,Kelantan,0,0,0,Lithuania
21336,1/1/2021,LTU,Pahang,0,0,0,Lithuania
21337,1/1/2021,LTU,Perak,0,0,0,Lithuania
21338,1/1/2021,LTU,Perlis,0,0,0,Lithuania
21339,1/1/2021,LTU,Pulau Pinang,0,0,0,Lithuania
21340,1/1/2021,LTU,Sabah,0,0,0,Lithuania
21341,1/1/2021,LTU,Sarawak,0,0,0,Lithuania
21342,1/1/2021,LTU,Selangor,6,5,1,Lithuania
21343,1/1/2021,LTU,W.P. Labuan,0,0,0,Lithuania
21344,1/1/2021,LUX,Johor,0,0,0,Luxembourg
21345,1/1/2021,LUX,Kedah,0,0,0,Luxembourg
21346,1/1/2021,LUX,Kelantan,0,0,0,Luxembourg
21347,1/1/2021,LUX,Perak,0,0,0,Luxembourg
21348,1/1/2021,LUX,Perlis,0,0,0,Luxembourg
21349,1/1/2021,LUX,Pulau Pinang,0,0,0,Luxembourg
21350,1/1/2021,LUX,Sabah,0,0,0,Luxembourg
21351,1/1/2021,LUX,Sarawak,0,0,0,Luxembourg
21352,1/1/2021,LUX,Selangor,0,0,0,Luxembourg
21353,1/1/2021,LVA,Johor,0,0,0,Latvia
21354,1/1/2021,LVA,Kedah,0,0,0,Latvia
21355,1/1/2021,LVA,Kelantan,0,0,0,Latvia
21356,1/1/2021,LVA,Pahang,0,0,0,Latvia
21357,1/1/2021,LVA,Perak,0,0,0,Latvia
21358,1/1/2021,LVA,Perlis,0,0,0,Latvia
21359,1/1/2021,LVA,Pulau Pinang,0,0,0,Latvia
21360,1/1/2021,LVA,Sabah,0,0,0,Latvia
21361,1/1/2021,LVA,Sarawak,0,0,0,Latvia
21362,1/1/2021,LVA,Selangor,1,0,1,Latvia
21363,1/1/2021,LVA,W.P. Labuan,0,0,0,Latvia
21364,1/1/2021,MAC,Johor,0,0,0,Macao
21365,1/1/2021,MAC,Pahang,0,0,0,Macao
21366,1/1/2021,MAC,Perak,0,0,0,Macao
21367,1/1/2021,MAC,Selangor,0,0,0,Macao
21368,1/1/2021,MAC,W.P. Labuan,0,0,0,Macao
21369,1/1/2021,MAR,Johor,0,0,0,Morocco
21370,1/1/2021,MAR,Kedah,0,0,0,Morocco
21371,1/1/2021,MAR,Kelantan,0,0,0,Morocco
21372,1/1/2021,MAR,Melaka,0,0,0,Morocco
21373,1/1/2021,MAR,Pahang,0,0,0,Morocco
21374,1/1/2021,MAR,Perak,0,0,0,Morocco
21375,1/1/2021,MAR,Perlis,0,0,0,Morocco
21376,1/1/2021,MAR,Pulau Pinang,0,0,0,Morocco
21377,1/1/2021,MAR,Sabah,0,0,0,Morocco
21378,1/1/2021,MAR,Sarawak,0,0,0,Morocco
21379,1/1/2021,MAR,Selangor,8,4,4,Morocco
21380,1/1/2021,MAR,W.P. Labuan,0,0,0,Morocco
21381,1/1/2021,MCO,Johor,0,0,0,Monaco
21382,1/1/2021,MCO,Kedah,0,0,0,Monaco
21383,1/1/2021,MCO,Sabah,0,0,0,Monaco
21384,1/1/2021,MCO,Selangor,0,0,0,Monaco
21385,1/1/2021,MDA,Johor,0,0,0,"Moldova, Republic of"
21386,1/1/2021,MDA,Kedah,0,0,0,"Moldova, Republic of"
21387,1/1/2021,MDA,Kelantan,0,0,0,"Moldova, Republic of"
21388,1/1/2021,MDA,Negeri Sembilan,0,0,0,"Moldova, Republic of"
21389,1/1/2021,MDA,Perlis,0,0,0,"Moldova, Republic of"
21390,1/1/2021,MDA,Pulau Pinang,0,0,0,"Moldova, Republic of"
21391,1/1/2021,MDA,Sabah,0,0,0,"Moldova, Republic of"
21392,1/1/2021,MDA,Sarawak,0,0,0,"Moldova, Republic of"
21393,1/1/2021,MDA,Selangor,0,0,0,"Moldova, Republic of"
21394,1/1/2021,MDG,Johor,0,0,0,Madagascar
21395,1/1/2021,MDG,Kedah,0,0,0,Madagascar
21396,1/1/2021,MDG,Perak,0,0,0,Madagascar
21397,1/1/2021,MDG,Perlis,0,0,0,Madagascar
21398,1/1/2021,MDG,Pulau Pinang,0,0,0,Madagascar
21399,1/1/2021,MDG,Sabah,0,0,0,Madagascar
21400,1/1/2021,MDG,Sarawak,0,0,0,Madagascar
21401,1/1/2021,MDG,Selangor,0,0,0,Madagascar
21402,1/1/2021,MDV,Johor,0,0,0,Maldives
21403,1/1/2021,MDV,Kedah,0,0,0,Maldives
21404,1/1/2021,MDV,Kelantan,0,0,0,Maldives
21405,1/1/2021,MDV,Perak,0,0,0,Maldives
21406,1/1/2021,MDV,Perlis,0,0,0,Maldives
21407,1/1/2021,MDV,Pulau Pinang,0,0,0,Maldives
21408,1/1/2021,MDV,Sabah,0,0,0,Maldives
21409,1/1/2021,MDV,Sarawak,0,0,0,Maldives
21410,1/1/2021,MDV,Selangor,40,19,21,Maldives
21411,1/1/2021,MEX,Johor,0,0,0,Mexico
21412,1/1/2021,MEX,Kedah,0,0,0,Mexico
21413,1/1/2021,MEX,Kelantan,0,0,0,Mexico
21414,1/1/2021,MEX,Pahang,0,0,0,Mexico
21415,1/1/2021,MEX,Perak,0,0,0,Mexico
21416,1/1/2021,MEX,Perlis,0,0,0,Mexico
21417,1/1/2021,MEX,Pulau Pinang,0,0,0,Mexico
21418,1/1/2021,MEX,Sabah,0,0,0,Mexico
21419,1/1/2021,MEX,Sarawak,0,0,0,Mexico
21420,1/1/2021,MEX,Selangor,7,7,0,Mexico
21421,1/1/2021,MEX,W.P. Labuan,0,0,0,Mexico
21422,1/1/2021,MHL,Johor,0,0,0,Marshall Islands
21423,1/1/2021,MHL,Kedah,0,0,0,Marshall Islands
21424,1/1/2021,MHL,Perak,0,0,0,Marshall Islands
21425,1/1/2021,MHL,Pulau Pinang,0,0,0,Marshall Islands
21426,1/1/2021,MHL,Sabah,0,0,0,Marshall Islands
21427,1/1/2021,MHL,Selangor,0,0,0,Marshall Islands
21428,1/1/2021,MKD,Johor,0,0,0,"Macedonia, the former Yugoslav Republic of"
21429,1/1/2021,MKD,Kedah,0,0,0,"Macedonia, the former Yugoslav Republic of"
21430,1/1/2021,MKD,Perak,0,0,0,"Macedonia, the former Yugoslav Republic of"
21431,1/1/2021,MKD,Pulau Pinang,0,0,0,"Macedonia, the former Yugoslav Republic of"
21432,1/1/2021,MKD,Sabah,0,0,0,"Macedonia, the former Yugoslav Republic of"
21433,1/1/2021,MKD,Sarawak,0,0,0,"Macedonia, the former Yugoslav Republic of"
21434,1/1/2021,MKD,Selangor,0,0,0,"Macedonia, the former Yugoslav Republic of"
21435,1/1/2021,MLI,Johor,0,0,0,Mali
21436,1/1/2021,MLI,Sabah,0,0,0,Mali
21437,1/1/2021,MLI,Selangor,1,1,0,Mali
21438,1/1/2021,MLT,Johor,0,0,0,Malta
21439,1/1/2021,MLT,Kedah,0,0,0,Malta
21440,1/1/2021,MLT,Kelantan,0,0,0,Malta
21441,1/1/2021,MLT,Perak,0,0,0,Malta
21442,1/1/2021,MLT,Perlis,0,0,0,Malta
21443,1/1/2021,MLT,Pulau Pinang,0,0,0,Malta
21444,1/1/2021,MLT,Sabah,0,0,0,Malta
21445,1/1/2021,MLT,Sarawak,0,0,0,Malta
21446,1/1/2021,MLT,Selangor,1,1,0,Malta
21447,1/1/2021,MLT,W.P. Labuan,0,0,0,Malta
21448,1/1/2021,MMR,Johor,9,9,0,Myanmar
21449,1/1/2021,MMR,Kedah,0,0,0,Myanmar
21450,1/1/2021,MMR,Kelantan,0,0,0,Myanmar
21451,1/1/2021,MMR,Negeri Sembilan,0,0,0,Myanmar
21452,1/1/2021,MMR,Pahang,0,0,0,Myanmar
21453,1/1/2021,MMR,Perak,0,0,0,Myanmar
21454,1/1/2021,MMR,Perlis,0,0,0,Myanmar
21455,1/1/2021,MMR,Pulau Pinang,0,0,0,Myanmar
21456,1/1/2021,MMR,Sabah,0,0,0,Myanmar
21457,1/1/2021,MMR,Sarawak,0,0,0,Myanmar
21458,1/1/2021,MMR,Selangor,121,114,7,Myanmar
21459,1/1/2021,MMR,Terengganu,0,0,0,Myanmar
21460,1/1/2021,MMR,W.P. Labuan,0,0,0,Myanmar
21461,1/1/2021,MNE,Johor,6,6,0,Montenegro
21462,1/1/2021,MNE,Kedah,0,0,0,Montenegro
21463,1/1/2021,MNE,Pulau Pinang,0,0,0,Montenegro
21464,1/1/2021,MNE,Sabah,0,0,0,Montenegro
21465,1/1/2021,MNE,Sarawak,0,0,0,Montenegro
21466,1/1/2021,MNE,Selangor,1,1,0,Montenegro
21467,1/1/2021,MNG,Johor,0,0,0,Mongolia
21468,1/1/2021,MNG,Kedah,0,0,0,Mongolia
21469,1/1/2021,MNG,Kelantan,0,0,0,Mongolia
21470,1/1/2021,MNG,Perak,0,0,0,Mongolia
21471,1/1/2021,MNG,Perlis,0,0,0,Mongolia
21472,1/1/2021,MNG,Pulau Pinang,0,0,0,Mongolia
21473,1/1/2021,MNG,Sabah,0,0,0,Mongolia
21474,1/1/2021,MNG,Sarawak,0,0,0,Mongolia
21475,1/1/2021,MNG,Selangor,0,0,0,Mongolia
21476,1/1/2021,MNP,Selangor,0,0,0,Northern Mariana Islands
21477,1/1/2021,MOZ,Johor,0,0,0,Mozambique
21478,1/1/2021,MOZ,Kedah,0,0,0,Mozambique
21479,1/1/2021,MOZ,Perak,0,0,0,Mozambique
21480,1/1/2021,MOZ,Pulau Pinang,0,0,0,Mozambique
21481,1/1/2021,MOZ,Sabah,0,0,0,Mozambique
21482,1/1/2021,MOZ,Sarawak,0,0,0,Mozambique
21483,1/1/2021,MOZ,Selangor,2,1,1,Mozambique
21484,1/1/2021,MRT,Johor,0,0,0,Mauritania
21485,1/1/2021,MRT,Kedah,0,0,0,Mauritania
21486,1/1/2021,MRT,Pulau Pinang,0,0,0,Mauritania
21487,1/1/2021,MRT,Sabah,0,0,0,Mauritania
21488,1/1/2021,MRT,Sarawak,0,0,0,Mauritania
21489,1/1/2021,MRT,Selangor,5,4,1,Mauritania
21490,1/1/2021,MUS,Johor,0,0,0,Mauritius
21491,1/1/2021,MUS,Kedah,0,0,0,Mauritius
21492,1/1/2021,MUS,Kelantan,0,0,0,Mauritius
21493,1/1/2021,MUS,Pahang,0,0,0,Mauritius
21494,1/1/2021,MUS,Perak,0,0,0,Mauritius
21495,1/1/2021,MUS,Perlis,0,0,0,Mauritius
21496,1/1/2021,MUS,Pulau Pinang,0,0,0,Mauritius
21497,1/1/2021,MUS,Sabah,0,0,0,Mauritius
21498,1/1/2021,MUS,Sarawak,0,0,0,Mauritius
21499,1/1/2021,MUS,Selangor,8,5,3,Mauritius
21500,1/1/2021,MWI,Johor,0,0,0,Malawi
21501,1/1/2021,MWI,Pulau Pinang,0,0,0,Malawi
21502,1/1/2021,MWI,Sabah,0,0,0,Malawi
21503,1/1/2021,MWI,Sarawak,0,0,0,Malawi
21504,1/1/2021,MWI,Selangor,0,0,0,Malawi
21505,1/1/2021,MYT,Selangor,0,0,0,Mayotte
21506,1/1/2021,NAM,Johor,0,0,0,Namibia
21507,1/1/2021,NAM,Kedah,0,0,0,Namibia
21508,1/1/2021,NAM,Perak,0,0,0,Namibia
21509,1/1/2021,NAM,Perlis,0,0,0,Namibia
21510,1/1/2021,NAM,Pulau Pinang,0,0,0,Namibia
21511,1/1/2021,NAM,Sabah,0,0,0,Namibia
21512,1/1/2021,NAM,Sarawak,0,0,0,Namibia
21513,1/1/2021,NAM,Selangor,0,0,0,Namibia
21514,1/1/2021,NCL,Selangor,0,0,0,New Caledonia
21515,1/1/2021,NER,Johor,0,0,0,Niger
21516,1/1/2021,NER,Sabah,0,0,0,Niger
21517,1/1/2021,NER,Selangor,0,0,0,Niger
21518,1/1/2021,NGA,Johor,0,0,0,Nigeria
21519,1/1/2021,NGA,Kedah,0,0,0,Nigeria
21520,1/1/2021,NGA,Perlis,0,0,0,Nigeria
21521,1/1/2021,NGA,Pulau Pinang,0,0,0,Nigeria
21522,1/1/2021,NGA,Sabah,0,0,0,Nigeria
21523,1/1/2021,NGA,Sarawak,0,0,0,Nigeria
21524,1/1/2021,NGA,Selangor,39,36,3,Nigeria
21525,1/1/2021,NIC,Johor,0,0,0,Nicaragua
21526,1/1/2021,NIC,Kedah,0,0,0,Nicaragua
21527,1/1/2021,NIC,Pulau Pinang,0,0,0,Nicaragua
21528,1/1/2021,NIC,Sabah,0,0,0,Nicaragua
21529,1/1/2021,NIC,Selangor,0,0,0,Nicaragua
21530,1/1/2021,NLD,Johor,2,2,0,Netherlands
21531,1/1/2021,NLD,Kedah,0,0,0,Netherlands
21532,1/1/2021,NLD,Kelantan,0,0,0,Netherlands
21533,1/1/2021,NLD,Melaka,0,0,0,Netherlands
21534,1/1/2021,NLD,Negeri Sembilan,0,0,0,Netherlands
21535,1/1/2021,NLD,Pahang,0,0,0,Netherlands
21536,1/1/2021,NLD,Perak,0,0,0,Netherlands
21537,1/1/2021,NLD,Perlis,0,0,0,Netherlands
21538,1/1/2021,NLD,Pulau Pinang,0,0,0,Netherlands
21539,1/1/2021,NLD,Sabah,0,0,0,Netherlands
21540,1/1/2021,NLD,Sarawak,0,0,0,Netherlands
21541,1/1/2021,NLD,Selangor,56,44,12,Netherlands
21542,1/1/2021,NLD,Terengganu,0,0,0,Netherlands
21543,1/1/2021,NLD,W.P. Labuan,0,0,0,Netherlands
21544,1/1/2021,NOR,Johor,0,0,0,Norway
21545,1/1/2021,NOR,Kedah,0,0,0,Norway
21546,1/1/2021,NOR,Kelantan,0,0,0,Norway
21547,1/1/2021,NOR,Melaka,0,0,0,Norway
21548,1/1/2021,NOR,Pahang,0,0,0,Norway
21549,1/1/2021,NOR,Perak,0,0,0,Norway
21550,1/1/2021,NOR,Perlis,0,0,0,Norway
21551,1/1/2021,NOR,Pulau Pinang,0,0,0,Norway
21552,1/1/2021,NOR,Sabah,0,0,0,Norway
21553,1/1/2021,NOR,Sarawak,0,0,0,Norway
21554,1/1/2021,NOR,Selangor,24,21,3,Norway
21555,1/1/2021,NOR,W.P. Labuan,0,0,0,Norway
21556,1/1/2021,NPL,Johor,0,0,0,Nepal
21557,1/1/2021,NPL,Kedah,0,0,0,Nepal
21558,1/1/2021,NPL,Pahang,0,0,0,Nepal
21559,1/1/2021,NPL,Perak,0,0,0,Nepal
21560,1/1/2021,NPL,Perlis,0,0,0,Nepal
21561,1/1/2021,NPL,Pulau Pinang,0,0,0,Nepal
21562,1/1/2021,NPL,Sabah,0,0,0,Nepal
21563,1/1/2021,NPL,Sarawak,0,0,0,Nepal
21564,1/1/2021,NPL,Selangor,75,73,2,Nepal
21565,1/1/2021,NPL,W.P. Labuan,0,0,0,Nepal
21566,1/1/2021,NRU,Johor,0,0,0,Nauru
21567,1/1/2021,NRU,Pulau Pinang,0,0,0,Nauru
21568,1/1/2021,NRU,Selangor,0,0,0,Nauru
21569,1/1/2021,NZL,Johor,1,0,1,New Zealand
21570,1/1/2021,NZL,Kedah,0,0,0,New Zealand
21571,1/1/2021,NZL,Kelantan,0,0,0,New Zealand
21572,1/1/2021,NZL,Melaka,0,0,0,New Zealand
21573,1/1/2021,NZL,Negeri Sembilan,0,0,0,New Zealand
21574,1/1/2021,NZL,Pahang,0,0,0,New Zealand
21575,1/1/2021,NZL,Perak,0,0,0,New Zealand
21576,1/1/2021,NZL,Perlis,0,0,0,New Zealand
21577,1/1/2021,NZL,Pulau Pinang,4,2,2,New Zealand
21578,1/1/2021,NZL,Sabah,0,0,0,New Zealand
21579,1/1/2021,NZL,Sarawak,0,0,0,New Zealand
21580,1/1/2021,NZL,Selangor,23,15,8,New Zealand
21581,1/1/2021,NZL,Terengganu,0,0,0,New Zealand
21582,1/1/2021,NZL,W.P. Labuan,0,0,0,New Zealand
21583,1/1/2021,OMN,Johor,0,0,0,Oman
21584,1/1/2021,OMN,Kedah,0,0,0,Oman
21585,1/1/2021,OMN,Kelantan,0,0,0,Oman
21586,1/1/2021,OMN,Melaka,0,0,0,Oman
21587,1/1/2021,OMN,Perak,0,0,0,Oman
21588,1/1/2021,OMN,Perlis,0,0,0,Oman
21589,1/1/2021,OMN,Pulau Pinang,0,0,0,Oman
21590,1/1/2021,OMN,Sabah,0,0,0,Oman
21591,1/1/2021,OMN,Sarawak,0,0,0,Oman
21592,1/1/2021,OMN,Selangor,6,3,3,Oman
21593,1/1/2021,PAK,Johor,0,0,0,Pakistan
21594,1/1/2021,PAK,Kedah,0,0,0,Pakistan
21595,1/1/2021,PAK,Kelantan,0,0,0,Pakistan
21596,1/1/2021,PAK,Melaka,0,0,0,Pakistan
21597,1/1/2021,PAK,Negeri Sembilan,0,0,0,Pakistan
21598,1/1/2021,PAK,Pahang,0,0,0,Pakistan
21599,1/1/2021,PAK,Perak,0,0,0,Pakistan
21600,1/1/2021,PAK,Perlis,0,0,0,Pakistan
21601,1/1/2021,PAK,Pulau Pinang,0,0,0,Pakistan
21602,1/1/2021,PAK,Sabah,2,2,0,Pakistan
21603,1/1/2021,PAK,Sarawak,0,0,0,Pakistan
21604,1/1/2021,PAK,Selangor,187,162,25,Pakistan
21605,1/1/2021,PAK,W.P. Labuan,0,0,0,Pakistan
21606,1/1/2021,PAN,Johor,0,0,0,Panama
21607,1/1/2021,PAN,Kedah,0,0,0,Panama
21608,1/1/2021,PAN,Perak,0,0,0,Panama
21609,1/1/2021,PAN,Perlis,0,0,0,Panama
21610,1/1/2021,PAN,Pulau Pinang,0,0,0,Panama
21611,1/1/2021,PAN,Sabah,0,0,0,Panama
21612,1/1/2021,PAN,Sarawak,0,0,0,Panama
21613,1/1/2021,PAN,Selangor,3,1,2,Panama
21614,1/1/2021,PER,Johor,0,0,0,Peru
21615,1/1/2021,PER,Kedah,0,0,0,Peru
21616,1/1/2021,PER,Kelantan,0,0,0,Peru
21617,1/1/2021,PER,Pahang,0,0,0,Peru
21618,1/1/2021,PER,Perak,0,0,0,Peru
21619,1/1/2021,PER,Perlis,0,0,0,Peru
21620,1/1/2021,PER,Pulau Pinang,0,0,0,Peru
21621,1/1/2021,PER,Sabah,0,0,0,Peru
21622,1/1/2021,PER,Sarawak,0,0,0,Peru
21623,1/1/2021,PER,Selangor,1,1,0,Peru
21624,1/1/2021,PER,W.P. Labuan,0,0,0,Peru
21625,1/1/2021,PHL,Johor,57,56,1,Philippines
21626,1/1/2021,PHL,Kedah,0,0,0,Philippines
21627,1/1/2021,PHL,Kelantan,0,0,0,Philippines
21628,1/1/2021,PHL,Melaka,0,0,0,Philippines
21629,1/1/2021,PHL,Negeri Sembilan,0,0,0,Philippines
21630,1/1/2021,PHL,Pahang,0,0,0,Philippines
21631,1/1/2021,PHL,Perak,1,0,1,Philippines
21632,1/1/2021,PHL,Perlis,0,0,0,Philippines
21633,1/1/2021,PHL,Pulau Pinang,3,1,2,Philippines
21634,1/1/2021,PHL,Sabah,3,3,0,Philippines
21635,1/1/2021,PHL,Sarawak,56,55,1,Philippines
21636,1/1/2021,PHL,Selangor,436,357,79,Philippines
21637,1/1/2021,PHL,Terengganu,0,0,0,Philippines
21638,1/1/2021,PHL,W.P. Labuan,2,2,0,Philippines
21639,1/1/2021,PLW,Johor,0,0,0,Palau
21640,1/1/2021,PLW,Pulau Pinang,0,0,0,Palau
21641,1/1/2021,PLW,Selangor,0,0,0,Palau
21642,1/1/2021,PNG,Johor,0,0,0,Papua New Guinea
21643,1/1/2021,PNG,Kedah,0,0,0,Papua New Guinea
21644,1/1/2021,PNG,Kelantan,0,0,0,Papua New Guinea
21645,1/1/2021,PNG,Perak,0,0,0,Papua New Guinea
21646,1/1/2021,PNG,Pulau Pinang,0,0,0,Papua New Guinea
21647,1/1/2021,PNG,Sabah,0,0,0,Papua New Guinea
21648,1/1/2021,PNG,Sarawak,0,0,0,Papua New Guinea
21649,1/1/2021,PNG,Selangor,2,2,0,Papua New Guinea
21650,1/1/2021,POL,Johor,1,1,0,Poland
21651,1/1/2021,POL,Kedah,0,0,0,Poland
21652,1/1/2021,POL,Kelantan,0,0,0,Poland
21653,1/1/2021,POL,Melaka,0,0,0,Poland
21654,1/1/2021,POL,Negeri Sembilan,0,0,0,Poland
21655,1/1/2021,POL,Pahang,0,0,0,Poland
21656,1/1/2021,POL,Perak,0,0,0,Poland
21657,1/1/2021,POL,Perlis,0,0,0,Poland
21658,1/1/2021,POL,Pulau Pinang,0,0,0,Poland
21659,1/1/2021,POL,Sabah,0,0,0,Poland
21660,1/1/2021,POL,Sarawak,0,0,0,Poland
21661,1/1/2021,POL,Selangor,28,25,3,Poland
21662,1/1/2021,POL,Terengganu,0,0,0,Poland
21663,1/1/2021,POL,W.P. Labuan,0,0,0,Poland
21664,1/1/2021,PRK,Selangor,0,0,0,"Korea, Democratic People's Republic of"
21665,1/1/2021,PRT,Johor,0,0,0,Portugal
21666,1/1/2021,PRT,Kedah,0,0,0,Portugal
21667,1/1/2021,PRT,Kelantan,0,0,0,Portugal
21668,1/1/2021,PRT,Melaka,0,0,0,Portugal
21669,1/1/2021,PRT,Pahang,0,0,0,Portugal
21670,1/1/2021,PRT,Perak,0,0,0,Portugal
21671,1/1/2021,PRT,Perlis,0,0,0,Portugal
21672,1/1/2021,PRT,Pulau Pinang,0,0,0,Portugal
21673,1/1/2021,PRT,Sabah,0,0,0,Portugal
21674,1/1/2021,PRT,Sarawak,0,0,0,Portugal
21675,1/1/2021,PRT,Selangor,13,7,6,Portugal
21676,1/1/2021,PRT,W.P. Labuan,0,0,0,Portugal
21677,1/1/2021,PRY,Johor,0,0,0,Paraguay
21678,1/1/2021,PRY,Kedah,0,0,0,Paraguay
21679,1/1/2021,PRY,Perak,0,0,0,Paraguay
21680,1/1/2021,PRY,Perlis,0,0,0,Paraguay
21681,1/1/2021,PRY,Pulau Pinang,0,0,0,Paraguay
21682,1/1/2021,PRY,Sabah,0,0,0,Paraguay
21683,1/1/2021,PRY,Sarawak,0,0,0,Paraguay
21684,1/1/2021,PRY,Selangor,0,0,0,Paraguay
21685,1/1/2021,PSE,Johor,0,0,0,"Palestinian Territory, Occupied"
21686,1/1/2021,PSE,Kedah,0,0,0,"Palestinian Territory, Occupied"
21687,1/1/2021,PSE,Kelantan,0,0,0,"Palestinian Territory, Occupied"
21688,1/1/2021,PSE,Melaka,0,0,0,"Palestinian Territory, Occupied"
21689,1/1/2021,PSE,Perak,0,0,0,"Palestinian Territory, Occupied"
21690,1/1/2021,PSE,Perlis,0,0,0,"Palestinian Territory, Occupied"
21691,1/1/2021,PSE,Pulau Pinang,0,0,0,"Palestinian Territory, Occupied"
21692,1/1/2021,PSE,Sabah,0,0,0,"Palestinian Territory, Occupied"
21693,1/1/2021,PSE,Sarawak,0,0,0,"Palestinian Territory, Occupied"
21694,1/1/2021,PSE,Selangor,9,8,1,"Palestinian Territory, Occupied"
21695,1/1/2021,QAT,Johor,0,0,0,Qatar
21696,1/1/2021,QAT,Kedah,0,0,0,Qatar
21697,1/1/2021,QAT,Perlis,0,0,0,Qatar
21698,1/1/2021,QAT,Pulau Pinang,0,0,0,Qatar
21699,1/1/2021,QAT,Sabah,0,0,0,Qatar
21700,1/1/2021,QAT,Sarawak,0,0,0,Qatar
21701,1/1/2021,QAT,Selangor,5,2,3,Qatar
21702,1/1/2021,REU,Johor,0,0,0,Reunion
21703,1/1/2021,REU,Sarawak,0,0,0,Reunion
21704,1/1/2021,ROU,Johor,3,3,0,Romania
21705,1/1/2021,ROU,Kedah,0,0,0,Romania
21706,1/1/2021,ROU,Kelantan,0,0,0,Romania
21707,1/1/2021,ROU,Negeri Sembilan,0,0,0,Romania
21708,1/1/2021,ROU,Pahang,0,0,0,Romania
21709,1/1/2021,ROU,Perak,0,0,0,Romania
21710,1/1/2021,ROU,Perlis,0,0,0,Romania
21711,1/1/2021,ROU,Pulau Pinang,0,0,0,Romania
21712,1/1/2021,ROU,Sabah,0,0,0,Romania
21713,1/1/2021,ROU,Sarawak,0,0,0,Romania
21714,1/1/2021,ROU,Selangor,20,18,2,Romania
21715,1/1/2021,ROU,W.P. Labuan,0,0,0,Romania
21716,1/1/2021,RUS,Johor,4,4,0,Russia
21717,1/1/2021,RUS,Kedah,0,0,0,Russia
21718,1/1/2021,RUS,Kelantan,0,0,0,Russia
21719,1/1/2021,RUS,Melaka,0,0,0,Russia
21720,1/1/2021,RUS,Negeri Sembilan,0,0,0,Russia
21721,1/1/2021,RUS,Pahang,0,0,0,Russia
21722,1/1/2021,RUS,Perak,0,0,0,Russia
21723,1/1/2021,RUS,Perlis,0,0,0,Russia
21724,1/1/2021,RUS,Pulau Pinang,0,0,0,Russia
21725,1/1/2021,RUS,Sabah,0,0,0,Russia
21726,1/1/2021,RUS,Sarawak,0,0,0,Russia
21727,1/1/2021,RUS,Selangor,47,40,7,Russia
21728,1/1/2021,RUS,W.P. Labuan,0,0,0,Russia
21729,1/1/2021,RWA,Johor,0,0,0,Rwanda
21730,1/1/2021,RWA,Kedah,0,0,0,Rwanda
21731,1/1/2021,RWA,Pulau Pinang,0,0,0,Rwanda
21732,1/1/2021,RWA,Selangor,0,0,0,Rwanda
21733,1/1/2021,SAU,Johor,0,0,0,Saudi Arabia
21734,1/1/2021,SAU,Kedah,0,0,0,Saudi Arabia
21735,1/1/2021,SAU,Kelantan,0,0,0,Saudi Arabia
21736,1/1/2021,SAU,Melaka,0,0,0,Saudi Arabia
21737,1/1/2021,SAU,Perak,0,0,0,Saudi Arabia
21738,1/1/2021,SAU,Perlis,0,0,0,Saudi Arabia
21739,1/1/2021,SAU,Pulau Pinang,0,0,0,Saudi Arabia
21740,1/1/2021,SAU,Sabah,0,0,0,Saudi Arabia
21741,1/1/2021,SAU,Sarawak,0,0,0,Saudi Arabia
21742,1/1/2021,SAU,Selangor,52,28,24,Saudi Arabia
21743,1/1/2021,SAU,W.P. Labuan,0,0,0,Saudi Arabia
21744,1/1/2021,SDN,Johor,0,0,0,Sudan
21745,1/1/2021,SDN,Kedah,0,0,0,Sudan
21746,1/1/2021,SDN,Kelantan,0,0,0,Sudan
21747,1/1/2021,SDN,Perlis,0,0,0,Sudan
21748,1/1/2021,SDN,Pulau Pinang,0,0,0,Sudan
21749,1/1/2021,SDN,Sabah,0,0,0,Sudan
21750,1/1/2021,SDN,Sarawak,0,0,0,Sudan
21751,1/1/2021,SDN,Selangor,23,21,2,Sudan
21752,1/1/2021,SDN,W.P. Labuan,0,0,0,Sudan
21753,1/1/2021,SEN,Johor,0,0,0,Senegal
21754,1/1/2021,SEN,Kedah,0,0,0,Senegal
21755,1/1/2021,SEN,Kelantan,0,0,0,Senegal
21756,1/1/2021,SEN,Perak,0,0,0,Senegal
21757,1/1/2021,SEN,Perlis,0,0,0,Senegal
21758,1/1/2021,SEN,Pulau Pinang,0,0,0,Senegal
21759,1/1/2021,SEN,Sabah,0,0,0,Senegal
21760,1/1/2021,SEN,Sarawak,0,0,0,Senegal
21761,1/1/2021,SEN,Selangor,2,1,1,Senegal
21762,1/1/2021,SGP,Johor,271,232,39,Singapore
21763,1/1/2021,SGP,Kedah,3,3,0,Singapore
21764,1/1/2021,SGP,Kelantan,0,0,0,Singapore
21765,1/1/2021,SGP,Melaka,0,0,0,Singapore
21766,1/1/2021,SGP,Negeri Sembilan,0,0,0,Singapore
21767,1/1/2021,SGP,Pahang,0,0,0,Singapore
21768,1/1/2021,SGP,Perak,2,1,1,Singapore
21769,1/1/2021,SGP,Perlis,3,3,0,Singapore
21770,1/1/2021,SGP,Pulau Pinang,11,3,8,Singapore
21771,1/1/2021,SGP,Sabah,0,0,0,Singapore
21772,1/1/2021,SGP,Sarawak,18,5,13,Singapore
21773,1/1/2021,SGP,Selangor,131,81,50,Singapore
21774,1/1/2021,SGP,Terengganu,0,0,0,Singapore
21775,1/1/2021,SGP,W.P. Labuan,0,0,0,Singapore
21776,1/1/2021,SGS,Johor,0,0,0,South Georgia and the South Sandwich Islands
21777,1/1/2021,SGS,Sabah,0,0,0,South Georgia and the South Sandwich Islands
21778,1/1/2021,SGS,Selangor,0,0,0,South Georgia and the South Sandwich Islands
21779,1/1/2021,SHN,Sarawak,0,0,0,"Saint Helena, Ascension and Tristan da Cunha"
21780,1/1/2021,SLB,Johor,0,0,0,Solomon Islands
21781,1/1/2021,SLB,Perlis,0,0,0,Solomon Islands
21782,1/1/2021,SLB,Pulau Pinang,0,0,0,Solomon Islands
21783,1/1/2021,SLB,Sabah,0,0,0,Solomon Islands
21784,1/1/2021,SLB,Sarawak,0,0,0,Solomon Islands
21785,1/1/2021,SLB,Selangor,0,0,0,Solomon Islands
21786,1/1/2021,SLB,W.P. Labuan,0,0,0,Solomon Islands
21787,1/1/2021,SLE,Johor,0,0,0,Sierra Leone
21788,1/1/2021,SLE,Kedah,0,0,0,Sierra Leone
21789,1/1/2021,SLE,Perak,0,0,0,Sierra Leone
21790,1/1/2021,SLE,Pulau Pinang,0,0,0,Sierra Leone
21791,1/1/2021,SLE,Sabah,0,0,0,Sierra Leone
21792,1/1/2021,SLE,Selangor,1,1,0,Sierra Leone
21793,1/1/2021,SLV,Johor,0,0,0,El Salvador
21794,1/1/2021,SLV,Kedah,0,0,0,El Salvador
21795,1/1/2021,SLV,Perak,0,0,0,El Salvador
21796,1/1/2021,SLV,Perlis,0,0,0,El Salvador
21797,1/1/2021,SLV,Pulau Pinang,0,0,0,El Salvador
21798,1/1/2021,SLV,Sabah,0,0,0,El Salvador
21799,1/1/2021,SLV,Selangor,0,0,0,El Salvador
21800,1/1/2021,SLV,W.P. Labuan,0,0,0,El Salvador
21801,1/1/2021,SMR,Johor,0,0,0,San Marino
21802,1/1/2021,SMR,Selangor,1,1,0,San Marino
21803,1/1/2021,SOM,Johor,0,0,0,Somalia
21804,1/1/2021,SOM,Kedah,0,0,0,Somalia
21805,1/1/2021,SOM,Kelantan,0,0,0,Somalia
21806,1/1/2021,SOM,Perlis,0,0,0,Somalia
21807,1/1/2021,SOM,Sabah,0,0,0,Somalia
21808,1/1/2021,SOM,Sarawak,0,0,0,Somalia
21809,1/1/2021,SOM,Selangor,3,2,1,Somalia
21810,1/1/2021,SRB,Johor,0,0,0,Serbia
21811,1/1/2021,SRB,Kedah,0,0,0,Serbia
21812,1/1/2021,SRB,Kelantan,0,0,0,Serbia
21813,1/1/2021,SRB,Pahang,0,0,0,Serbia
21814,1/1/2021,SRB,Perak,0,0,0,Serbia
21815,1/1/2021,SRB,Perlis,0,0,0,Serbia
21816,1/1/2021,SRB,Pulau Pinang,0,0,0,Serbia
21817,1/1/2021,SRB,Sabah,0,0,0,Serbia
21818,1/1/2021,SRB,Sarawak,0,0,0,Serbia
21819,1/1/2021,SRB,Selangor,3,2,1,Serbia
21820,1/1/2021,STP,Selangor,2,2,0,Sao Tome and Principe
21821,1/1/2021,SUR,Johor,0,0,0,Suriname
21822,1/1/2021,SUR,Kedah,0,0,0,Suriname
21823,1/1/2021,SUR,Kelantan,0,0,0,Suriname
21824,1/1/2021,SUR,Perak,0,0,0,Suriname
21825,1/1/2021,SUR,Perlis,0,0,0,Suriname
21826,1/1/2021,SUR,Pulau Pinang,0,0,0,Suriname
21827,1/1/2021,SUR,Sabah,0,0,0,Suriname
21828,1/1/2021,SUR,Sarawak,0,0,0,Suriname
21829,1/1/2021,SUR,Selangor,0,0,0,Suriname
21830,1/1/2021,SVK,Johor,0,0,0,Slovakia
21831,1/1/2021,SVK,Kedah,0,0,0,Slovakia
21832,1/1/2021,SVK,Kelantan,0,0,0,Slovakia
21833,1/1/2021,SVK,Negeri Sembilan,0,0,0,Slovakia
21834,1/1/2021,SVK,Pahang,0,0,0,Slovakia
21835,1/1/2021,SVK,Perak,0,0,0,Slovakia
21836,1/1/2021,SVK,Perlis,0,0,0,Slovakia
21837,1/1/2021,SVK,Pulau Pinang,0,0,0,Slovakia
21838,1/1/2021,SVK,Sabah,0,0,0,Slovakia
21839,1/1/2021,SVK,Sarawak,0,0,0,Slovakia
21840,1/1/2021,SVK,Selangor,9,8,1,Slovakia
21841,1/1/2021,SVK,W.P. Labuan,0,0,0,Slovakia
21842,1/1/2021,SVN,Johor,0,0,0,Slovenia
21843,1/1/2021,SVN,Kedah,0,0,0,Slovenia
21844,1/1/2021,SVN,Kelantan,0,0,0,Slovenia
21845,1/1/2021,SVN,Perak,0,0,0,Slovenia
21846,1/1/2021,SVN,Perlis,0,0,0,Slovenia
21847,1/1/2021,SVN,Pulau Pinang,0,0,0,Slovenia
21848,1/1/2021,SVN,Sabah,0,0,0,Slovenia
21849,1/1/2021,SVN,Sarawak,0,0,0,Slovenia
21850,1/1/2021,SVN,Selangor,2,1,1,Slovenia
21851,1/1/2021,SVN,W.P. Labuan,0,0,0,Slovenia
21852,1/1/2021,SWE,Johor,0,0,0,Sweden
21853,1/1/2021,SWE,Kedah,0,0,0,Sweden
21854,1/1/2021,SWE,Kelantan,0,0,0,Sweden
21855,1/1/2021,SWE,Melaka,0,0,0,Sweden
21856,1/1/2021,SWE,Negeri Sembilan,0,0,0,Sweden
21857,1/1/2021,SWE,Pahang,0,0,0,Sweden
21858,1/1/2021,SWE,Perak,0,0,0,Sweden
21859,1/1/2021,SWE,Perlis,0,0,0,Sweden
21860,1/1/2021,SWE,Pulau Pinang,1,1,0,Sweden
21861,1/1/2021,SWE,Sabah,0,0,0,Sweden
21862,1/1/2021,SWE,Sarawak,0,0,0,Sweden
21863,1/1/2021,SWE,Selangor,29,25,4,Sweden
21864,1/1/2021,SWE,W.P. Labuan,0,0,0,Sweden
21865,1/1/2021,SWZ,Johor,0,0,0,Swaziland
21866,1/1/2021,SWZ,Kedah,0,0,0,Swaziland
21867,1/1/2021,SWZ,Pulau Pinang,0,0,0,Swaziland
21868,1/1/2021,SWZ,Sabah,0,0,0,Swaziland
21869,1/1/2021,SWZ,Selangor,5,2,3,Swaziland
21870,1/1/2021,SYC,Johor,0,0,0,Seychelles
21871,1/1/2021,SYC,Kedah,0,0,0,Seychelles
21872,1/1/2021,SYC,Pulau Pinang,0,0,0,Seychelles
21873,1/1/2021,SYC,Sabah,0,0,0,Seychelles
21874,1/1/2021,SYC,Sarawak,0,0,0,Seychelles
21875,1/1/2021,SYC,Selangor,2,0,2,Seychelles
21876,1/1/2021,SYR,Johor,0,0,0,Syrian Arab Republic
21877,1/1/2021,SYR,Kedah,0,0,0,Syrian Arab Republic
21878,1/1/2021,SYR,Kelantan,0,0,0,Syrian Arab Republic
21879,1/1/2021,SYR,Pahang,0,0,0,Syrian Arab Republic
21880,1/1/2021,SYR,Perlis,0,0,0,Syrian Arab Republic
21881,1/1/2021,SYR,Pulau Pinang,0,0,0,Syrian Arab Republic
21882,1/1/2021,SYR,Sabah,0,0,0,Syrian Arab Republic
21883,1/1/2021,SYR,Sarawak,0,0,0,Syrian Arab Republic
21884,1/1/2021,SYR,Selangor,10,5,5,Syrian Arab Republic
21885,1/1/2021,SYR,W.P. Labuan,0,0,0,Syrian Arab Republic
21886,1/1/2021,TCA,Perlis,0,0,0,Turks and Caicos
21887,1/1/2021,TCD,Johor,0,0,0,Chad
21888,1/1/2021,TCD,Kedah,0,0,0,Chad
21889,1/1/2021,TCD,Perlis,0,0,0,Chad
21890,1/1/2021,TCD,Selangor,0,0,0,Chad
21891,1/1/2021,TGO,Johor,0,0,0,Togo
21892,1/1/2021,TGO,Perak,0,0,0,Togo
21893,1/1/2021,TGO,Pulau Pinang,0,0,0,Togo
21894,1/1/2021,TGO,Selangor,0,0,0,Togo
21895,1/1/2021,THA,Johor,0,0,0,Thailand
21896,1/1/2021,THA,Kedah,17920,17905,15,Thailand
21897,1/1/2021,THA,Kelantan,0,0,0,Thailand
21898,1/1/2021,THA,Melaka,0,0,0,Thailand
21899,1/1/2021,THA,Negeri Sembilan,0,0,0,Thailand
21900,1/1/2021,THA,Pahang,0,0,0,Thailand
21901,1/1/2021,THA,Perak,0,0,0,Thailand
21902,1/1/2021,THA,Perlis,9926,9477,449,Thailand
21903,1/1/2021,THA,Pulau Pinang,4,2,2,Thailand
21904,1/1/2021,THA,Sabah,0,0,0,Thailand
21905,1/1/2021,THA,Sarawak,11,11,0,Thailand
21906,1/1/2021,THA,Selangor,93,38,55,Thailand
21907,1/1/2021,THA,Terengganu,7,7,0,Thailand
21908,1/1/2021,THA,W.P. Labuan,0,0,0,Thailand
21909,1/1/2021,TJK,Johor,0,0,0,Tajikistan
21910,1/1/2021,TJK,Kedah,0,0,0,Tajikistan
21911,1/1/2021,TJK,Perlis,0,0,0,Tajikistan
21912,1/1/2021,TJK,Pulau Pinang,0,0,0,Tajikistan
21913,1/1/2021,TJK,Sabah,0,0,0,Tajikistan
21914,1/1/2021,TJK,Selangor,0,0,0,Tajikistan
21915,1/1/2021,TKL,Selangor,0,0,0,Tokelau
21916,1/1/2021,TKM,Johor,0,0,0,Turkmenistan
21917,1/1/2021,TKM,Kedah,0,0,0,Turkmenistan
21918,1/1/2021,TKM,Kelantan,0,0,0,Turkmenistan
21919,1/1/2021,TKM,Perlis,0,0,0,Turkmenistan
21920,1/1/2021,TKM,Pulau Pinang,0,0,0,Turkmenistan
21921,1/1/2021,TKM,Sabah,0,0,0,Turkmenistan
21922,1/1/2021,TKM,Sarawak,0,0,0,Turkmenistan
21923,1/1/2021,TKM,Selangor,0,0,0,Turkmenistan
21924,1/1/2021,TLS,Johor,0,0,0,Timor-Leste
21925,1/1/2021,TLS,Kedah,0,0,0,Timor-Leste
21926,1/1/2021,TLS,Perlis,0,0,0,Timor-Leste
21927,1/1/2021,TLS,Pulau Pinang,0,0,0,Timor-Leste
21928,1/1/2021,TLS,Sabah,0,0,0,Timor-Leste
21929,1/1/2021,TLS,Sarawak,0,0,0,Timor-Leste
21930,1/1/2021,TLS,Selangor,0,0,0,Timor-Leste
21931,1/1/2021,TON,Johor,0,0,0,Tonga
21932,1/1/2021,TON,Pulau Pinang,0,0,0,Tonga
21933,1/1/2021,TON,Sarawak,0,0,0,Tonga
21934,1/1/2021,TON,Selangor,0,0,0,Tonga
21935,1/1/2021,TTO,Johor,0,0,0,Trinidad and Tobago
21936,1/1/2021,TTO,Kedah,0,0,0,Trinidad and Tobago
21937,1/1/2021,TTO,Pahang,0,0,0,Trinidad and Tobago
21938,1/1/2021,TTO,Pulau Pinang,0,0,0,Trinidad and Tobago
21939,1/1/2021,TTO,Sabah,0,0,0,Trinidad and Tobago
21940,1/1/2021,TTO,Sarawak,0,0,0,Trinidad and Tobago
21941,1/1/2021,TTO,Selangor,3,1,2,Trinidad and Tobago
21942,1/1/2021,TUN,Johor,0,0,0,Tunisia
21943,1/1/2021,TUN,Kedah,0,0,0,Tunisia
21944,1/1/2021,TUN,Kelantan,0,0,0,Tunisia
21945,1/1/2021,TUN,Melaka,0,0,0,Tunisia
21946,1/1/2021,TUN,Perak,0,0,0,Tunisia
21947,1/1/2021,TUN,Perlis,0,0,0,Tunisia
21948,1/1/2021,TUN,Pulau Pinang,0,0,0,Tunisia
21949,1/1/2021,TUN,Sabah,0,0,0,Tunisia
21950,1/1/2021,TUN,Sarawak,0,0,0,Tunisia
21951,1/1/2021,TUN,Selangor,4,2,2,Tunisia
21952,1/1/2021,TUN,W.P. Labuan,0,0,0,Tunisia
21953,1/1/2021,TUR,Johor,0,0,0,Turkey
21954,1/1/2021,TUR,Kedah,0,0,0,Turkey
21955,1/1/2021,TUR,Kelantan,0,0,0,Turkey
21956,1/1/2021,TUR,Melaka,0,0,0,Turkey
21957,1/1/2021,TUR,Negeri Sembilan,0,0,0,Turkey
21958,1/1/2021,TUR,Pahang,0,0,0,Turkey
21959,1/1/2021,TUR,Perak,0,0,0,Turkey
21960,1/1/2021,TUR,Perlis,0,0,0,Turkey
21961,1/1/2021,TUR,Pulau Pinang,0,0,0,Turkey
21962,1/1/2021,TUR,Sabah,0,0,0,Turkey
21963,1/1/2021,TUR,Sarawak,0,0,0,Turkey
21964,1/1/2021,TUR,Selangor,18,15,3,Turkey
21965,1/1/2021,TUR,W.P. Labuan,0,0,0,Turkey
21966,1/1/2021,TUV,Selangor,0,0,0,Tuvalu
21967,1/1/2021,TWN,Johor,1,1,0,Taiwan
21968,1/1/2021,TWN,Kedah,0,0,0,Taiwan
21969,1/1/2021,TWN,Kelantan,0,0,0,Taiwan
21970,1/1/2021,TWN,Melaka,0,0,0,Taiwan
21971,1/1/2021,TWN,Negeri Sembilan,0,0,0,Taiwan
21972,1/1/2021,TWN,Pahang,0,0,0,Taiwan
21973,1/1/2021,TWN,Perak,0,0,0,Taiwan
21974,1/1/2021,TWN,Perlis,0,0,0,Taiwan
21975,1/1/2021,TWN,Pulau Pinang,8,3,5,Taiwan
21976,1/1/2021,TWN,Sabah,0,0,0,Taiwan
21977,1/1/2021,TWN,Sarawak,1,1,0,Taiwan
21978,1/1/2021,TWN,Selangor,80,47,33,Taiwan
21979,1/1/2021,TWN,W.P. Labuan,0,0,0,Taiwan
21980,1/1/2021,TZA,Johor,0,0,0,"Tanzania, United Republic of"
21981,1/1/2021,TZA,Kedah,0,0,0,"Tanzania, United Republic of"
21982,1/1/2021,TZA,Perak,0,0,0,"Tanzania, United Republic of"
21983,1/1/2021,TZA,Perlis,0,0,0,"Tanzania, United Republic of"
21984,1/1/2021,TZA,Pulau Pinang,0,0,0,"Tanzania, United Republic of"
21985,1/1/2021,TZA,Sabah,0,0,0,"Tanzania, United Republic of"
21986,1/1/2021,TZA,Sarawak,0,0,0,"Tanzania, United Republic of"
21987,1/1/2021,TZA,Selangor,7,2,5,"Tanzania, United Republic of"
21988,1/1/2021,UGA,Johor,0,0,0,Uganda
21989,1/1/2021,UGA,Kedah,0,0,0,Uganda
21990,1/1/2021,UGA,Perak,0,0,0,Uganda
21991,1/1/2021,UGA,Perlis,0,0,0,Uganda
21992,1/1/2021,UGA,Pulau Pinang,0,0,0,Uganda
21993,1/1/2021,UGA,Sabah,0,0,0,Uganda
21994,1/1/2021,UGA,Sarawak,0,0,0,Uganda
21995,1/1/2021,UGA,Selangor,3,3,0,Uganda
21996,1/1/2021,UKR,Johor,13,13,0,Ukraine
21997,1/1/2021,UKR,Kedah,0,0,0,Ukraine
21998,1/1/2021,UKR,Kelantan,0,0,0,Ukraine
21999,1/1/2021,UKR,Melaka,0,0,0,Ukraine
22000,1/1/2021,UKR,Negeri Sembilan,0,0,0,Ukraine
22001,1/1/2021,UKR,Pahang,0,0,0,Ukraine
22002,1/1/2021,UKR,Perak,0,0,0,Ukraine
22003,1/1/2021,UKR,Perlis,0,0,0,Ukraine
22004,1/1/2021,UKR,Pulau Pinang,0,0,0,Ukraine
22005,1/1/2021,UKR,Sabah,0,0,0,Ukraine
22006,1/1/2021,UKR,Sarawak,0,0,0,Ukraine
22007,1/1/2021,UKR,Selangor,80,71,9,Ukraine
22008,1/1/2021,UKR,W.P. Labuan,0,0,0,Ukraine
22009,1/1/2021,URY,Johor,0,0,0,Uruguay
22010,1/1/2021,URY,Kedah,0,0,0,Uruguay
22011,1/1/2021,URY,Kelantan,0,0,0,Uruguay
22012,1/1/2021,URY,Perak,0,0,0,Uruguay
22013,1/1/2021,URY,Perlis,0,0,0,Uruguay
22014,1/1/2021,URY,Pulau Pinang,0,0,0,Uruguay
22015,1/1/2021,URY,Sabah,0,0,0,Uruguay
22016,1/1/2021,URY,Sarawak,0,0,0,Uruguay
22017,1/1/2021,URY,Selangor,0,0,0,Uruguay
22018,1/1/2021,URY,W.P. Labuan,0,0,0,Uruguay
22019,1/1/2021,USA,Johor,5,5,0,United States Of America
22020,1/1/2021,USA,Kedah,0,0,0,United States Of America
22021,1/1/2021,USA,Kelantan,0,0,0,United States Of America
22022,1/1/2021,USA,Melaka,0,0,0,United States Of America
22023,1/1/2021,USA,Negeri Sembilan,0,0,0,United States Of America
22024,1/1/2021,USA,Pahang,0,0,0,United States Of America
22025,1/1/2021,USA,Perak,4,2,2,United States Of America
22026,1/1/2021,USA,Perlis,0,0,0,United States Of America
22027,1/1/2021,USA,Pulau Pinang,2,1,1,United States Of America
22028,1/1/2021,USA,Sabah,1,1,0,United States Of America
22029,1/1/2021,USA,Sarawak,0,0,0,United States Of America
22030,1/1/2021,USA,Selangor,176,131,45,United States Of America
22031,1/1/2021,USA,Terengganu,0,0,0,United States Of America
22032,1/1/2021,USA,W.P. Labuan,0,0,0,United States Of America
22033,1/1/2021,UZB,Johor,0,0,0,Uzbekistan
22034,1/1/2021,UZB,Kedah,0,0,0,Uzbekistan
22035,1/1/2021,UZB,Kelantan,0,0,0,Uzbekistan
22036,1/1/2021,UZB,Perak,0,0,0,Uzbekistan
22037,1/1/2021,UZB,Perlis,0,0,0,Uzbekistan
22038,1/1/2021,UZB,Pulau Pinang,0,0,0,Uzbekistan
22039,1/1/2021,UZB,Sabah,0,0,0,Uzbekistan
22040,1/1/2021,UZB,Sarawak,0,0,0,Uzbekistan
22041,1/1/2021,UZB,Selangor,14,7,7,Uzbekistan
22042,1/1/2021,VAT,Johor,0,0,0,Holy See (Vatican City State)
22043,1/1/2021,VAT,Sarawak,0,0,0,Holy See (Vatican City State)
22044,1/1/2021,VAT,Selangor,1,1,0,Holy See (Vatican City State)
22045,1/1/2021,VCT,Johor,0,0,0,Saint Vincent and the Grenadines
22046,1/1/2021,VCT,Kedah,0,0,0,Saint Vincent and the Grenadines
22047,1/1/2021,VCT,Pulau Pinang,0,0,0,Saint Vincent and the Grenadines
22048,1/1/2021,VCT,Sarawak,0,0,0,Saint Vincent and the Grenadines
22049,1/1/2021,VCT,Selangor,0,0,0,Saint Vincent and the Grenadines
22050,1/1/2021,VEN,Johor,0,0,0,Venezuela
22051,1/1/2021,VEN,Kedah,0,0,0,Venezuela
22052,1/1/2021,VEN,Kelantan,0,0,0,Venezuela
22053,1/1/2021,VEN,Melaka,0,0,0,Venezuela
22054,1/1/2021,VEN,Perak,0,0,0,Venezuela
22055,1/1/2021,VEN,Perlis,0,0,0,Venezuela
22056,1/1/2021,VEN,Pulau Pinang,0,0,0,Venezuela
22057,1/1/2021,VEN,Sabah,0,0,0,Venezuela
22058,1/1/2021,VEN,Sarawak,0,0,0,Venezuela
22059,1/1/2021,VEN,Selangor,4,4,0,Venezuela
22060,1/1/2021,VEN,W.P. Labuan,0,0,0,Venezuela
22061,1/1/2021,VNM,Johor,3,0,3,Vietnam
22062,1/1/2021,VNM,Kedah,0,0,0,Vietnam
22063,1/1/2021,VNM,Kelantan,0,0,0,Vietnam
22064,1/1/2021,VNM,Melaka,0,0,0,Vietnam
22065,1/1/2021,VNM,Negeri Sembilan,0,0,0,Vietnam
22066,1/1/2021,VNM,Pahang,0,0,0,Vietnam
22067,1/1/2021,VNM,Perak,0,0,0,Vietnam
22068,1/1/2021,VNM,Perlis,0,0,0,Vietnam
22069,1/1/2021,VNM,Pulau Pinang,1,0,1,Vietnam
22070,1/1/2021,VNM,Sabah,0,0,0,Vietnam
22071,1/1/2021,VNM,Sarawak,0,0,0,Vietnam
22072,1/1/2021,VNM,Selangor,93,23,70,Vietnam
22073,1/1/2021,VNM,Terengganu,6,6,0,Vietnam
22074,1/1/2021,VNM,W.P. Labuan,0,0,0,Vietnam
22075,1/1/2021,VUT,Johor,0,0,0,Vanuatu
22076,1/1/2021,VUT,Kedah,0,0,0,Vanuatu
22077,1/1/2021,VUT,Pulau Pinang,0,0,0,Vanuatu
22078,1/1/2021,VUT,Sabah,0,0,0,Vanuatu
22079,1/1/2021,VUT,Sarawak,0,0,0,Vanuatu
22080,1/1/2021,VUT,Selangor,0,0,0,Vanuatu
22081,1/1/2021,WSM,Johor,0,0,0,Samoa
22082,1/1/2021,WSM,Sarawak,0,0,0,Samoa
22083,1/1/2021,WSM,Selangor,0,0,0,Samoa
22084,1/1/2021,YEM,Johor,0,0,0,Yemen
22085,1/1/2021,YEM,Kedah,0,0,0,Yemen
22086,1/1/2021,YEM,Kelantan,0,0,0,Yemen
22087,1/1/2021,YEM,Melaka,0,0,0,Yemen
22088,1/1/2021,YEM,Pahang,0,0,0,Yemen
22089,1/1/2021,YEM,Perak,0,0,0,Yemen
22090,1/1/2021,YEM,Perlis,0,0,0,Yemen
22091,1/1/2021,YEM,Pulau Pinang,0,0,0,Yemen
22092,1/1/2021,YEM,Sabah,0,0,0,Yemen
22093,1/1/2021,YEM,Sarawak,0,0,0,Yemen
22094,1/1/2021,YEM,Selangor,23,19,4,Yemen
22095,1/1/2021,YEM,W.P. Labuan,0,0,0,Yemen
22096,1/1/2021,ZAF,Johor,2,2,0,South Africa
22097,1/1/2021,ZAF,Kedah,0,0,0,South Africa
22098,1/1/2021,ZAF,Kelantan,0,0,0,South Africa
22099,1/1/2021,ZAF,Melaka,0,0,0,South Africa
22100,1/1/2021,ZAF,Pahang,0,0,0,South Africa
22101,1/1/2021,ZAF,Perak,0,0,0,South Africa
22102,1/1/2021,ZAF,Perlis,0,0,0,South Africa
22103,1/1/2021,ZAF,Pulau Pinang,0,0,0,South Africa
22104,1/1/2021,ZAF,Sabah,0,0,0,South Africa
22105,1/1/2021,ZAF,Sarawak,0,0,0,South Africa
22106,1/1/2021,ZAF,Selangor,26,19,7,South Africa
22107,1/1/2021,ZAF,Terengganu,0,0,0,South Africa
22108,1/1/2021,ZAF,W.P. Labuan,0,0,0,South Africa
22109,1/1/2021,ZMB,Johor,0,0,0,Zambia
22110,1/1/2021,ZMB,Kedah,0,0,0,Zambia
22111,1/1/2021,ZMB,Perak,0,0,0,Zambia
22112,1/1/2021,ZMB,Perlis,0,0,0,Zambia
22113,1/1/2021,ZMB,Pulau Pinang,0,0,0,Zambia
22114,1/1/2021,ZMB,Sabah,0,0,0,Zambia
22115,1/1/2021,ZMB,Sarawak,0,0,0,Zambia
22116,1/1/2021,ZMB,Selangor,5,4,1,Zambia
22117,1/1/2021,ZWE,Johor,0,0,0,Zimbabwe
22118,1/1/2021,ZWE,Kedah,0,0,0,Zimbabwe
22119,1/1/2021,ZWE,Kelantan,0,0,0,Zimbabwe
22120,1/1/2021,ZWE,Perak,0,0,0,Zimbabwe
22121,1/1/2021,ZWE,Perlis,0,0,0,Zimbabwe
22122,1/1/2021,ZWE,Pulau Pinang,0,0,0,Zimbabwe
22123,1/1/2021,ZWE,Sabah,0,0,0,Zimbabwe
22124,1/1/2021,ZWE,Sarawak,0,0,0,Zimbabwe
22125,1/1/2021,ZWE,Selangor,1,1,0,Zimbabwe
22126,2/1/2021,ABW,Kedah,0,0,0,Aruba
22127,2/1/2021,ABW,Pulau Pinang,0,0,0,Aruba
22128,2/1/2021,AFG,Johor,0,0,0,Afghanistan
22129,2/1/2021,AFG,Kedah,0,0,0,Afghanistan
22130,2/1/2021,AFG,Perlis,0,0,0,Afghanistan
22131,2/1/2021,AFG,Pulau Pinang,0,0,0,Afghanistan
22132,2/1/2021,AFG,Sarawak,0,0,0,Afghanistan
22133,2/1/2021,AFG,Selangor,17,15,2,Afghanistan
22134,2/1/2021,AGO,Johor,0,0,0,Angola
22135,2/1/2021,AGO,Kedah,0,0,0,Angola
22136,2/1/2021,AGO,Sabah,0,0,0,Angola
22137,2/1/2021,AGO,Selangor,0,0,0,Angola
22138,2/1/2021,AIA,Selangor,0,0,0,Anguilla
22139,2/1/2021,ALB,Johor,0,0,0,Albania
22140,2/1/2021,ALB,Kedah,0,0,0,Albania
22141,2/1/2021,ALB,Perak,0,0,0,Albania
22142,2/1/2021,ALB,Perlis,0,0,0,Albania
22143,2/1/2021,ALB,Pulau Pinang,0,0,0,Albania
22144,2/1/2021,ALB,Sabah,0,0,0,Albania
22145,2/1/2021,ALB,Sarawak,0,0,0,Albania
22146,2/1/2021,ALB,Selangor,0,0,0,Albania
22147,2/1/2021,AND,Johor,0,0,0,Andorra
22148,2/1/2021,AND,Kedah,0,0,0,Andorra
22149,2/1/2021,AND,Perlis,0,0,0,Andorra
22150,2/1/2021,AND,Pulau Pinang,0,0,0,Andorra
22151,2/1/2021,AND,Selangor,0,0,0,Andorra
22152,2/1/2021,ANT,Selangor,0,0,0,Netherlands Antilles
22153,2/1/2021,ARE,Johor,0,0,0,United Arab Emirates
22154,2/1/2021,ARE,Kedah,0,0,0,United Arab Emirates
22155,2/1/2021,ARE,Kelantan,0,0,0,United Arab Emirates
22156,2/1/2021,ARE,Perak,0,0,0,United Arab Emirates
22157,2/1/2021,ARE,Perlis,0,0,0,United Arab Emirates
22158,2/1/2021,ARE,Pulau Pinang,0,0,0,United Arab Emirates
22159,2/1/2021,ARE,Sabah,0,0,0,United Arab Emirates
22160,2/1/2021,ARE,Sarawak,0,0,0,United Arab Emirates
22161,2/1/2021,ARE,Selangor,2,1,1,United Arab Emirates
22162,2/1/2021,ARG,Johor,0,0,0,Argentina
22163,2/1/2021,ARG,Kedah,0,0,0,Argentina
22164,2/1/2021,ARG,Kelantan,0,0,0,Argentina
22165,2/1/2021,ARG,Melaka,0,0,0,Argentina
22166,2/1/2021,ARG,Perak,0,0,0,Argentina
22167,2/1/2021,ARG,Perlis,0,0,0,Argentina
22168,2/1/2021,ARG,Pulau Pinang,0,0,0,Argentina
22169,2/1/2021,ARG,Sabah,0,0,0,Argentina
22170,2/1/2021,ARG,Sarawak,0,0,0,Argentina
22171,2/1/2021,ARG,Selangor,4,4,0,Argentina
22172,2/1/2021,ARG,W.P. Labuan,0,0,0,Argentina
22173,2/1/2021,ARM,Johor,0,0,0,Armenia
22174,2/1/2021,ARM,Kedah,0,0,0,Armenia
22175,2/1/2021,ARM,Kelantan,0,0,0,Armenia
22176,2/1/2021,ARM,Perak,0,0,0,Armenia
22177,2/1/2021,ARM,Perlis,0,0,0,Armenia
22178,2/1/2021,ARM,Pulau Pinang,1,0,1,Armenia
22179,2/1/2021,ARM,Sabah,0,0,0,Armenia
22180,2/1/2021,ARM,Sarawak,0,0,0,Armenia
22181,2/1/2021,ARM,Selangor,0,0,0,Armenia
22182,2/1/2021,ATA,Selangor,0,0,0,Antarctica
22183,2/1/2021,ATG,Johor,0,0,0,Antigua and Barbuda
22184,2/1/2021,ATG,Kedah,0,0,0,Antigua and Barbuda
22185,2/1/2021,ATG,Pulau Pinang,0,0,0,Antigua and Barbuda
22186,2/1/2021,ATG,Sarawak,0,0,0,Antigua and Barbuda
22187,2/1/2021,ATG,Selangor,0,0,0,Antigua and Barbuda
22188,2/1/2021,AUS,Johor,1,1,0,Australia
22189,2/1/2021,AUS,Kedah,0,0,0,Australia
22190,2/1/2021,AUS,Kelantan,0,0,0,Australia
22191,2/1/2021,AUS,Melaka,0,0,0,Australia
22192,2/1/2021,AUS,Negeri Sembilan,0,0,0,Australia
22193,2/1/2021,AUS,Pahang,0,0,0,Australia
22194,2/1/2021,AUS,Perak,2,1,1,Australia
22195,2/1/2021,AUS,Perlis,0,0,0,Australia
22196,2/1/2021,AUS,Pulau Pinang,4,3,1,Australia
22197,2/1/2021,AUS,Sabah,0,0,0,Australia
22198,2/1/2021,AUS,Sarawak,0,0,0,Australia
22199,2/1/2021,AUS,Selangor,80,50,30,Australia
22200,2/1/2021,AUS,Terengganu,0,0,0,Australia
22201,2/1/2021,AUS,W.P. Labuan,0,0,0,Australia
22202,2/1/2021,AUT,Johor,0,0,0,Austria
22203,2/1/2021,AUT,Kedah,0,0,0,Austria
22204,2/1/2021,AUT,Kelantan,0,0,0,Austria
22205,2/1/2021,AUT,Melaka,0,0,0,Austria
22206,2/1/2021,AUT,Negeri Sembilan,0,0,0,Austria
22207,2/1/2021,AUT,Pahang,0,0,0,Austria
22208,2/1/2021,AUT,Perak,0,0,0,Austria
22209,2/1/2021,AUT,Perlis,0,0,0,Austria
22210,2/1/2021,AUT,Pulau Pinang,0,0,0,Austria
22211,2/1/2021,AUT,Sabah,0,0,0,Austria
22212,2/1/2021,AUT,Sarawak,0,0,0,Austria
22213,2/1/2021,AUT,Selangor,13,13,0,Austria
22214,2/1/2021,AUT,Terengganu,0,0,0,Austria
22215,2/1/2021,AUT,W.P. Labuan,0,0,0,Austria
22216,2/1/2021,AZE,Johor,0,0,0,Azerbaijan
22217,2/1/2021,AZE,Kedah,0,0,0,Azerbaijan
22218,2/1/2021,AZE,Kelantan,0,0,0,Azerbaijan
22219,2/1/2021,AZE,Melaka,0,0,0,Azerbaijan
22220,2/1/2021,AZE,Perlis,0,0,0,Azerbaijan
22221,2/1/2021,AZE,Pulau Pinang,0,0,0,Azerbaijan
22222,2/1/2021,AZE,Sabah,0,0,0,Azerbaijan
22223,2/1/2021,AZE,Sarawak,0,0,0,Azerbaijan
22224,2/1/2021,AZE,Selangor,0,0,0,Azerbaijan
22225,2/1/2021,AZE,W.P. Labuan,0,0,0,Azerbaijan
22226,2/1/2021,BDI,Pulau Pinang,0,0,0,Burundi
22227,2/1/2021,BDI,Sarawak,0,0,0,Burundi
22228,2/1/2021,BDI,Selangor,0,0,0,Burundi
22229,2/1/2021,BEL,Johor,0,0,0,Belgium
22230,2/1/2021,BEL,Kedah,0,0,0,Belgium
22231,2/1/2021,BEL,Kelantan,0,0,0,Belgium
22232,2/1/2021,BEL,Melaka,0,0,0,Belgium
22233,2/1/2021,BEL,Negeri Sembilan,0,0,0,Belgium
22234,2/1/2021,BEL,Pahang,0,0,0,Belgium
22235,2/1/2021,BEL,Perak,0,0,0,Belgium
22236,2/1/2021,BEL,Perlis,0,0,0,Belgium
22237,2/1/2021,BEL,Pulau Pinang,0,0,0,Belgium
22238,2/1/2021,BEL,Sabah,0,0,0,Belgium
22239,2/1/2021,BEL,Sarawak,0,0,0,Belgium
22240,2/1/2021,BEL,Selangor,13,9,4,Belgium
22241,2/1/2021,BEL,W.P. Labuan,0,0,0,Belgium
22242,2/1/2021,BEN,Johor,0,0,0,Benin
22243,2/1/2021,BEN,Kedah,0,0,0,Benin
22244,2/1/2021,BEN,Perak,0,0,0,Benin
22245,2/1/2021,BEN,Pulau Pinang,0,0,0,Benin
22246,2/1/2021,BEN,Sabah,0,0,0,Benin
22247,2/1/2021,BEN,Sarawak,0,0,0,Benin
22248,2/1/2021,BEN,Selangor,0,0,0,Benin
22249,2/1/2021,BFA,Perak,0,0,0,Burkina Faso
22250,2/1/2021,BFA,Pulau Pinang,0,0,0,Burkina Faso
22251,2/1/2021,BFA,Selangor,0,0,0,Burkina Faso
22252,2/1/2021,BGD,Johor,4,4,0,Bangladesh
22253,2/1/2021,BGD,Kedah,0,0,0,Bangladesh
22254,2/1/2021,BGD,Kelantan,0,0,0,Bangladesh
22255,2/1/2021,BGD,Melaka,0,0,0,Bangladesh
22256,2/1/2021,BGD,Negeri Sembilan,0,0,0,Bangladesh
22257,2/1/2021,BGD,Pahang,0,0,0,Bangladesh
22258,2/1/2021,BGD,Perak,0,0,0,Bangladesh
22259,2/1/2021,BGD,Perlis,0,0,0,Bangladesh
22260,2/1/2021,BGD,Pulau Pinang,0,0,0,Bangladesh
22261,2/1/2021,BGD,Sabah,0,0,0,Bangladesh
22262,2/1/2021,BGD,Sarawak,0,0,0,Bangladesh
22263,2/1/2021,BGD,Selangor,143,101,42,Bangladesh
22264,2/1/2021,BGD,W.P. Labuan,0,0,0,Bangladesh
22265,2/1/2021,BGR,Johor,0,0,0,Bulgaria
22266,2/1/2021,BGR,Kedah,0,0,0,Bulgaria
22267,2/1/2021,BGR,Kelantan,0,0,0,Bulgaria
22268,2/1/2021,BGR,Pahang,0,0,0,Bulgaria
22269,2/1/2021,BGR,Perak,0,0,0,Bulgaria
22270,2/1/2021,BGR,Perlis,0,0,0,Bulgaria
22271,2/1/2021,BGR,Pulau Pinang,0,0,0,Bulgaria
22272,2/1/2021,BGR,Sabah,0,0,0,Bulgaria
22273,2/1/2021,BGR,Sarawak,0,0,0,Bulgaria
22274,2/1/2021,BGR,Selangor,18,18,0,Bulgaria
22275,2/1/2021,BGR,W.P. Labuan,0,0,0,Bulgaria
22276,2/1/2021,BHR,Johor,0,0,0,Bahrain
22277,2/1/2021,BHR,Kedah,0,0,0,Bahrain
22278,2/1/2021,BHR,Kelantan,0,0,0,Bahrain
22279,2/1/2021,BHR,Perlis,0,0,0,Bahrain
22280,2/1/2021,BHR,Pulau Pinang,0,0,0,Bahrain
22281,2/1/2021,BHR,Sabah,0,0,0,Bahrain
22282,2/1/2021,BHR,Sarawak,0,0,0,Bahrain
22283,2/1/2021,BHR,Selangor,1,1,0,Bahrain
22284,2/1/2021,BHS,Johor,0,0,0,Bahamas
22285,2/1/2021,BHS,Kedah,0,0,0,Bahamas
22286,2/1/2021,BHS,Perak,0,0,0,Bahamas
22287,2/1/2021,BHS,Sabah,0,0,0,Bahamas
22288,2/1/2021,BHS,Sarawak,0,0,0,Bahamas
22289,2/1/2021,BHS,Selangor,0,0,0,Bahamas
22290,2/1/2021,BIH,Johor,0,0,0,Bosnia and Herzegovina
22291,2/1/2021,BIH,Kedah,0,0,0,Bosnia and Herzegovina
22292,2/1/2021,BIH,Perlis,0,0,0,Bosnia and Herzegovina
22293,2/1/2021,BIH,Pulau Pinang,0,0,0,Bosnia and Herzegovina
22294,2/1/2021,BIH,Sabah,0,0,0,Bosnia and Herzegovina
22295,2/1/2021,BIH,Sarawak,0,0,0,Bosnia and Herzegovina
22296,2/1/2021,BIH,Selangor,1,0,1,Bosnia and Herzegovina
22297,2/1/2021,BLR,Johor,0,0,0,Belarus
22298,2/1/2021,BLR,Kedah,0,0,0,Belarus
22299,2/1/2021,BLR,Kelantan,0,0,0,Belarus
22300,2/1/2021,BLR,Pahang,0,0,0,Belarus
22301,2/1/2021,BLR,Perak,0,0,0,Belarus
22302,2/1/2021,BLR,Perlis,0,0,0,Belarus
22303,2/1/2021,BLR,Pulau Pinang,0,0,0,Belarus
22304,2/1/2021,BLR,Sabah,0,0,0,Belarus
22305,2/1/2021,BLR,Sarawak,0,0,0,Belarus
22306,2/1/2021,BLR,Selangor,0,0,0,Belarus
22307,2/1/2021,BLR,W.P. Labuan,0,0,0,Belarus
22308,2/1/2021,BLZ,Johor,0,0,0,Belize
22309,2/1/2021,BLZ,Pulau Pinang,0,0,0,Belize
22310,2/1/2021,BLZ,Sarawak,0,0,0,Belize
22311,2/1/2021,BLZ,Selangor,0,0,0,Belize
22312,2/1/2021,BMU,Selangor,0,0,0,Bermuda
22313,2/1/2021,BOL,Johor,0,0,0,Bolivia
22314,2/1/2021,BOL,Kedah,0,0,0,Bolivia
22315,2/1/2021,BOL,Melaka,0,0,0,Bolivia
22316,2/1/2021,BOL,Perak,0,0,0,Bolivia
22317,2/1/2021,BOL,Perlis,0,0,0,Bolivia
22318,2/1/2021,BOL,Pulau Pinang,0,0,0,Bolivia
22319,2/1/2021,BOL,Sabah,0,0,0,Bolivia
22320,2/1/2021,BOL,Sarawak,0,0,0,Bolivia
22321,2/1/2021,BOL,Selangor,0,0,0,Bolivia
22322,2/1/2021,BRA,Johor,12,12,0,Brazil
22323,2/1/2021,BRA,Kedah,0,0,0,Brazil
22324,2/1/2021,BRA,Kelantan,0,0,0,Brazil
22325,2/1/2021,BRA,Melaka,0,0,0,Brazil
22326,2/1/2021,BRA,Pahang,0,0,0,Brazil
22327,2/1/2021,BRA,Perak,0,0,0,Brazil
22328,2/1/2021,BRA,Perlis,0,0,0,Brazil
22329,2/1/2021,BRA,Pulau Pinang,0,0,0,Brazil
22330,2/1/2021,BRA,Sabah,0,0,0,Brazil
22331,2/1/2021,BRA,Sarawak,0,0,0,Brazil
22332,2/1/2021,BRA,Selangor,30,20,10,Brazil
22333,2/1/2021,BRA,W.P. Labuan,0,0,0,Brazil
22334,2/1/2021,BRB,Johor,0,0,0,Barbados
22335,2/1/2021,BRB,Kedah,0,0,0,Barbados
22336,2/1/2021,BRB,Perlis,0,0,0,Barbados
22337,2/1/2021,BRB,Pulau Pinang,0,0,0,Barbados
22338,2/1/2021,BRB,Selangor,0,0,0,Barbados
22339,2/1/2021,BRN,Johor,0,0,0,Brunei Darussalam
22340,2/1/2021,BRN,Kedah,0,0,0,Brunei Darussalam
22341,2/1/2021,BRN,Kelantan,0,0,0,Brunei Darussalam
22342,2/1/2021,BRN,Melaka,0,0,0,Brunei Darussalam
22343,2/1/2021,BRN,Pahang,0,0,0,Brunei Darussalam
22344,2/1/2021,BRN,Perak,0,0,0,Brunei Darussalam
22345,2/1/2021,BRN,Perlis,0,0,0,Brunei Darussalam
22346,2/1/2021,BRN,Pulau Pinang,0,0,0,Brunei Darussalam
22347,2/1/2021,BRN,Sabah,0,0,0,Brunei Darussalam
22348,2/1/2021,BRN,Sarawak,355,347,8,Brunei Darussalam
22349,2/1/2021,BRN,Selangor,6,4,2,Brunei Darussalam
22350,2/1/2021,BRN,W.P. Labuan,1,1,0,Brunei Darussalam
22351,2/1/2021,BTN,Johor,0,0,0,Bhutan
22352,2/1/2021,BTN,Kedah,0,0,0,Bhutan
22353,2/1/2021,BTN,Perak,0,0,0,Bhutan
22354,2/1/2021,BTN,Perlis,0,0,0,Bhutan
22355,2/1/2021,BTN,Pulau Pinang,0,0,0,Bhutan
22356,2/1/2021,BTN,Sabah,0,0,0,Bhutan
22357,2/1/2021,BTN,Sarawak,0,0,0,Bhutan
22358,2/1/2021,BTN,Selangor,2,0,2,Bhutan
22359,2/1/2021,BWA,Johor,0,0,0,Botswana
22360,2/1/2021,BWA,Kedah,0,0,0,Botswana
22361,2/1/2021,BWA,Perlis,0,0,0,Botswana
22362,2/1/2021,BWA,Pulau Pinang,0,0,0,Botswana
22363,2/1/2021,BWA,Sabah,0,0,0,Botswana
22364,2/1/2021,BWA,Sarawak,0,0,0,Botswana
22365,2/1/2021,BWA,Selangor,0,0,0,Botswana
22366,2/1/2021,CAF,Kedah,0,0,0,Central African Republic
22367,2/1/2021,CAF,Selangor,0,0,0,Central African Republic
22368,2/1/2021,CAN,Johor,0,0,0,Canada
22369,2/1/2021,CAN,Kedah,0,0,0,Canada
22370,2/1/2021,CAN,Kelantan,0,0,0,Canada
22371,2/1/2021,CAN,Melaka,0,0,0,Canada
22372,2/1/2021,CAN,Negeri Sembilan,0,0,0,Canada
22373,2/1/2021,CAN,Pahang,0,0,0,Canada
22374,2/1/2021,CAN,Perak,0,0,0,Canada
22375,2/1/2021,CAN,Perlis,0,0,0,Canada
22376,2/1/2021,CAN,Pulau Pinang,1,1,0,Canada
22377,2/1/2021,CAN,Sabah,0,0,0,Canada
22378,2/1/2021,CAN,Sarawak,0,0,0,Canada
22379,2/1/2021,CAN,Selangor,31,24,7,Canada
22380,2/1/2021,CAN,Terengganu,0,0,0,Canada
22381,2/1/2021,CAN,W.P. Labuan,0,0,0,Canada
22382,2/1/2021,CCK,Selangor,0,0,0,Cocos (Keeling) Islands
22383,2/1/2021,CHE,Johor,0,0,0,Switzerland
22384,2/1/2021,CHE,Kedah,0,0,0,Switzerland
22385,2/1/2021,CHE,Kelantan,0,0,0,Switzerland
22386,2/1/2021,CHE,Melaka,0,0,0,Switzerland
22387,2/1/2021,CHE,Negeri Sembilan,0,0,0,Switzerland
22388,2/1/2021,CHE,Pahang,0,0,0,Switzerland
22389,2/1/2021,CHE,Perak,0,0,0,Switzerland
22390,2/1/2021,CHE,Perlis,0,0,0,Switzerland
22391,2/1/2021,CHE,Pulau Pinang,0,0,0,Switzerland
22392,2/1/2021,CHE,Sabah,0,0,0,Switzerland
22393,2/1/2021,CHE,Sarawak,0,0,0,Switzerland
22394,2/1/2021,CHE,Selangor,9,5,4,Switzerland
22395,2/1/2021,CHE,W.P. Labuan,0,0,0,Switzerland
22396,2/1/2021,CHL,Johor,0,0,0,Chile
22397,2/1/2021,CHL,Kedah,0,0,0,Chile
22398,2/1/2021,CHL,Kelantan,0,0,0,Chile
22399,2/1/2021,CHL,Melaka,0,0,0,Chile
22400,2/1/2021,CHL,Pahang,0,0,0,Chile
22401,2/1/2021,CHL,Perak,0,0,0,Chile
22402,2/1/2021,CHL,Perlis,0,0,0,Chile
22403,2/1/2021,CHL,Pulau Pinang,0,0,0,Chile
22404,2/1/2021,CHL,Sabah,0,0,0,Chile
22405,2/1/2021,CHL,Sarawak,0,0,0,Chile
22406,2/1/2021,CHL,Selangor,2,1,1,Chile
22407,2/1/2021,CHN,Johor,32,17,15,China
22408,2/1/2021,CHN,Kedah,0,0,0,China
22409,2/1/2021,CHN,Kelantan,0,0,0,China
22410,2/1/2021,CHN,Melaka,0,0,0,China
22411,2/1/2021,CHN,Pahang,0,0,0,China
22412,2/1/2021,CHN,Perak,0,0,0,China
22413,2/1/2021,CHN,Perlis,0,0,0,China
22414,2/1/2021,CHN,Pulau Pinang,6,1,5,China
22415,2/1/2021,CHN,Sabah,0,0,0,China
22416,2/1/2021,CHN,Sarawak,48,46,2,China
22417,2/1/2021,CHN,Selangor,768,623,145,China
22418,2/1/2021,CHN,Terengganu,0,0,0,China
22419,2/1/2021,CHN,W.P. Labuan,0,0,0,China
22420,2/1/2021,CIV,Johor,0,0,0,C��te d'Iv
22421,2/1/2021,CIV,Kedah,0,0,0,C��te d'Iv
22422,2/1/2021,CIV,Pulau Pinang,0,0,0,C��te d'Iv
22423,2/1/2021,CIV,Sabah,0,0,0,C��te d'Iv
22424,2/1/2021,CIV,Sarawak,0,0,0,C��te d'Iv
22425,2/1/2021,CIV,Selangor,0,0,0,C��te d'Iv
22426,2/1/2021,CMR,Johor,0,0,0,Cameroon
22427,2/1/2021,CMR,Kedah,0,0,0,Cameroon
22428,2/1/2021,CMR,Pulau Pinang,0,0,0,Cameroon
22429,2/1/2021,CMR,Sabah,0,0,0,Cameroon
22430,2/1/2021,CMR,Sarawak,0,0,0,Cameroon
22431,2/1/2021,CMR,Selangor,2,2,0,Cameroon
22432,2/1/2021,COD,Johor,0,0,0,"Congo, the Democratic Republic of the"
22433,2/1/2021,COD,Pulau Pinang,0,0,0,"Congo, the Democratic Republic of the"
22434,2/1/2021,COD,Sarawak,0,0,0,"Congo, the Democratic Republic of the"
22435,2/1/2021,COD,Selangor,0,0,0,"Congo, the Democratic Republic of the"
22436,2/1/2021,COG,Johor,0,0,0,Congo
22437,2/1/2021,COG,Kedah,0,0,0,Congo
22438,2/1/2021,COG,Selangor,0,0,0,Congo
22439,2/1/2021,COK,Selangor,0,0,0,Cook Islands
22440,2/1/2021,COL,Johor,0,0,0,Colombia
22441,2/1/2021,COL,Kedah,0,0,0,Colombia
22442,2/1/2021,COL,Perak,0,0,0,Colombia
22443,2/1/2021,COL,Pulau Pinang,0,0,0,Colombia
22444,2/1/2021,COL,Sabah,0,0,0,Colombia
22445,2/1/2021,COL,Sarawak,0,0,0,Colombia
22446,2/1/2021,COL,Selangor,5,3,2,Colombia
22447,2/1/2021,COL,W.P. Labuan,0,0,0,Colombia
22448,2/1/2021,COM,Johor,0,0,0,Comoros
22449,2/1/2021,COM,Kedah,0,0,0,Comoros
22450,2/1/2021,COM,Selangor,3,2,1,Comoros
22451,2/1/2021,CPV,Johor,0,0,0,Cape Verde
22452,2/1/2021,CPV,Kedah,0,0,0,Cape Verde
22453,2/1/2021,CPV,Pulau Pinang,0,0,0,Cape Verde
22454,2/1/2021,CPV,Sabah,0,0,0,Cape Verde
22455,2/1/2021,CPV,Selangor,0,0,0,Cape Verde
22456,2/1/2021,CRI,Johor,0,0,0,Costa Rica
22457,2/1/2021,CRI,Kedah,0,0,0,Costa Rica
22458,2/1/2021,CRI,Perak,0,0,0,Costa Rica
22459,2/1/2021,CRI,Perlis,0,0,0,Costa Rica
22460,2/1/2021,CRI,Pulau Pinang,0,0,0,Costa Rica
22461,2/1/2021,CRI,Sabah,0,0,0,Costa Rica
22462,2/1/2021,CRI,Sarawak,0,0,0,Costa Rica
22463,2/1/2021,CRI,Selangor,18,14,4,Costa Rica
22464,2/1/2021,CUB,Johor,0,0,0,Cuba
22465,2/1/2021,CUB,Kedah,0,0,0,Cuba
22466,2/1/2021,CUB,Perlis,0,0,0,Cuba
22467,2/1/2021,CUB,Pulau Pinang,0,0,0,Cuba
22468,2/1/2021,CUB,Sabah,0,0,0,Cuba
22469,2/1/2021,CUB,Sarawak,0,0,0,Cuba
22470,2/1/2021,CUB,Selangor,0,0,0,Cuba
22471,2/1/2021,CYP,Johor,0,0,0,Cyprus
22472,2/1/2021,CYP,Kedah,0,0,0,Cyprus
22473,2/1/2021,CYP,Perak,0,0,0,Cyprus
22474,2/1/2021,CYP,Perlis,0,0,0,Cyprus
22475,2/1/2021,CYP,Pulau Pinang,0,0,0,Cyprus
22476,2/1/2021,CYP,Sabah,0,0,0,Cyprus
22477,2/1/2021,CYP,Sarawak,0,0,0,Cyprus
22478,2/1/2021,CYP,Selangor,3,2,1,Cyprus
22479,2/1/2021,CZE,Johor,2,2,0,Czech Republic
22480,2/1/2021,CZE,Kedah,0,0,0,Czech Republic
22481,2/1/2021,CZE,Kelantan,0,0,0,Czech Republic
22482,2/1/2021,CZE,Melaka,0,0,0,Czech Republic
22483,2/1/2021,CZE,Negeri Sembilan,0,0,0,Czech Republic
22484,2/1/2021,CZE,Perak,0,0,0,Czech Republic
22485,2/1/2021,CZE,Perlis,0,0,0,Czech Republic
22486,2/1/2021,CZE,Pulau Pinang,0,0,0,Czech Republic
22487,2/1/2021,CZE,Sabah,0,0,0,Czech Republic
22488,2/1/2021,CZE,Sarawak,0,0,0,Czech Republic
22489,2/1/2021,CZE,Selangor,4,4,0,Czech Republic
22490,2/1/2021,CZE,W.P. Labuan,0,0,0,Czech Republic
22491,2/1/2021,DEU,Johor,0,0,0,Germany
22492,2/1/2021,DEU,Kedah,0,0,0,Germany
22493,2/1/2021,DEU,Kelantan,0,0,0,Germany
22494,2/1/2021,DEU,Melaka,0,0,0,Germany
22495,2/1/2021,DEU,Negeri Sembilan,0,0,0,Germany
22496,2/1/2021,DEU,Pahang,0,0,0,Germany
22497,2/1/2021,DEU,Perak,0,0,0,Germany
22498,2/1/2021,DEU,Perlis,0,0,0,Germany
22499,2/1/2021,DEU,Pulau Pinang,1,1,0,Germany
22500,2/1/2021,DEU,Sabah,0,0,0,Germany
22501,2/1/2021,DEU,Sarawak,0,0,0,Germany
22502,2/1/2021,DEU,Selangor,65,56,9,Germany
22503,2/1/2021,DEU,Terengganu,0,0,0,Germany
22504,2/1/2021,DEU,W.P. Labuan,0,0,0,Germany
22505,2/1/2021,DJI,Johor,0,0,0,Djibouti
22506,2/1/2021,DJI,Selangor,0,0,0,Djibouti
22507,2/1/2021,DMA,Johor,0,0,0,Dominica
22508,2/1/2021,DMA,Kedah,0,0,0,Dominica
22509,2/1/2021,DMA,Pulau Pinang,0,0,0,Dominica
22510,2/1/2021,DMA,Sabah,0,0,0,Dominica
22511,2/1/2021,DMA,Sarawak,0,0,0,Dominica
22512,2/1/2021,DMA,Selangor,1,1,0,Dominica
22513,2/1/2021,DMA,W.P. Labuan,0,0,0,Dominica
22514,2/1/2021,DNK,Johor,9,9,0,Denmark
22515,2/1/2021,DNK,Kedah,0,0,0,Denmark
22516,2/1/2021,DNK,Kelantan,0,0,0,Denmark
22517,2/1/2021,DNK,Melaka,0,0,0,Denmark
22518,2/1/2021,DNK,Negeri Sembilan,0,0,0,Denmark
22519,2/1/2021,DNK,Pahang,0,0,0,Denmark
22520,2/1/2021,DNK,Perak,0,0,0,Denmark
22521,2/1/2021,DNK,Perlis,0,0,0,Denmark
22522,2/1/2021,DNK,Pulau Pinang,0,0,0,Denmark
22523,2/1/2021,DNK,Sabah,0,0,0,Denmark
22524,2/1/2021,DNK,Sarawak,0,0,0,Denmark
22525,2/1/2021,DNK,Selangor,8,8,0,Denmark
22526,2/1/2021,DNK,W.P. Labuan,0,0,0,Denmark
22527,2/1/2021,DOM,Johor,0,0,0,Dominican Republic
22528,2/1/2021,DOM,Kedah,0,0,0,Dominican Republic
22529,2/1/2021,DOM,Perak,0,0,0,Dominican Republic
22530,2/1/2021,DOM,Perlis,0,0,0,Dominican Republic
22531,2/1/2021,DOM,Pulau Pinang,0,0,0,Dominican Republic
22532,2/1/2021,DOM,Sabah,0,0,0,Dominican Republic
22533,2/1/2021,DOM,Sarawak,0,0,0,Dominican Republic
22534,2/1/2021,DOM,Selangor,0,0,0,Dominican Republic
22535,2/1/2021,DZA,Johor,0,0,0,Algeria
22536,2/1/2021,DZA,Kedah,0,0,0,Algeria
22537,2/1/2021,DZA,Kelantan,0,0,0,Algeria
22538,2/1/2021,DZA,Melaka,0,0,0,Algeria
22539,2/1/2021,DZA,Perak,0,0,0,Algeria
22540,2/1/2021,DZA,Perlis,0,0,0,Algeria
22541,2/1/2021,DZA,Pulau Pinang,0,0,0,Algeria
22542,2/1/2021,DZA,Sabah,0,0,0,Algeria
22543,2/1/2021,DZA,Sarawak,0,0,0,Algeria
22544,2/1/2021,DZA,Selangor,4,3,1,Algeria
22545,2/1/2021,DZA,W.P. Labuan,0,0,0,Algeria
22546,2/1/2021,ECU,Johor,0,0,0,Ecuador
22547,2/1/2021,ECU,Kedah,0,0,0,Ecuador
22548,2/1/2021,ECU,Perak,0,0,0,Ecuador
22549,2/1/2021,ECU,Perlis,0,0,0,Ecuador
22550,2/1/2021,ECU,Pulau Pinang,0,0,0,Ecuador
22551,2/1/2021,ECU,Sabah,0,0,0,Ecuador
22552,2/1/2021,ECU,Sarawak,0,0,0,Ecuador
22553,2/1/2021,ECU,Selangor,0,0,0,Ecuador
22554,2/1/2021,EGY,Johor,0,0,0,Egypt
22555,2/1/2021,EGY,Kedah,0,0,0,Egypt
22556,2/1/2021,EGY,Kelantan,0,0,0,Egypt
22557,2/1/2021,EGY,Melaka,0,0,0,Egypt
22558,2/1/2021,EGY,Pahang,0,0,0,Egypt
22559,2/1/2021,EGY,Perak,0,0,0,Egypt
22560,2/1/2021,EGY,Perlis,0,0,0,Egypt
22561,2/1/2021,EGY,Pulau Pinang,0,0,0,Egypt
22562,2/1/2021,EGY,Sabah,0,0,0,Egypt
22563,2/1/2021,EGY,Sarawak,0,0,0,Egypt
22564,2/1/2021,EGY,Selangor,56,44,12,Egypt
22565,2/1/2021,EGY,Terengganu,0,0,0,Egypt
22566,2/1/2021,EGY,W.P. Labuan,0,0,0,Egypt
22567,2/1/2021,ERI,Johor,0,0,0,Eritrea
22568,2/1/2021,ERI,Pulau Pinang,0,0,0,Eritrea
22569,2/1/2021,ERI,Sabah,0,0,0,Eritrea
22570,2/1/2021,ERI,Selangor,1,1,0,Eritrea
22571,2/1/2021,ESP,Johor,2,2,0,Spain
22572,2/1/2021,ESP,Kedah,0,0,0,Spain
22573,2/1/2021,ESP,Kelantan,0,0,0,Spain
22574,2/1/2021,ESP,Melaka,0,0,0,Spain
22575,2/1/2021,ESP,Negeri Sembilan,0,0,0,Spain
22576,2/1/2021,ESP,Pahang,0,0,0,Spain
22577,2/1/2021,ESP,Perak,0,0,0,Spain
22578,2/1/2021,ESP,Perlis,0,0,0,Spain
22579,2/1/2021,ESP,Pulau Pinang,0,0,0,Spain
22580,2/1/2021,ESP,Sabah,0,0,0,Spain
22581,2/1/2021,ESP,Sarawak,0,0,0,Spain
22582,2/1/2021,ESP,Selangor,16,13,3,Spain
22583,2/1/2021,ESP,W.P. Labuan,0,0,0,Spain
22584,2/1/2021,EST,Johor,0,0,0,Estonia
22585,2/1/2021,EST,Kedah,0,0,0,Estonia
22586,2/1/2021,EST,Kelantan,0,0,0,Estonia
22587,2/1/2021,EST,Pahang,0,0,0,Estonia
22588,2/1/2021,EST,Perak,0,0,0,Estonia
22589,2/1/2021,EST,Perlis,0,0,0,Estonia
22590,2/1/2021,EST,Pulau Pinang,0,0,0,Estonia
22591,2/1/2021,EST,Sabah,0,0,0,Estonia
22592,2/1/2021,EST,Sarawak,0,0,0,Estonia
22593,2/1/2021,EST,Selangor,0,0,0,Estonia
22594,2/1/2021,EST,W.P. Labuan,0,0,0,Estonia
22595,2/1/2021,ETH,Johor,0,0,0,Ethiopia
22596,2/1/2021,ETH,Kedah,0,0,0,Ethiopia
22597,2/1/2021,ETH,Pulau Pinang,0,0,0,Ethiopia
22598,2/1/2021,ETH,Sarawak,0,0,0,Ethiopia
22599,2/1/2021,ETH,Selangor,0,0,0,Ethiopia
22600,2/1/2021,FIN,Johor,0,0,0,Finland
22601,2/1/2021,FIN,Kedah,0,0,0,Finland
22602,2/1/2021,FIN,Kelantan,0,0,0,Finland
22603,2/1/2021,FIN,Melaka,0,0,0,Finland
22604,2/1/2021,FIN,Negeri Sembilan,0,0,0,Finland
22605,2/1/2021,FIN,Pahang,0,0,0,Finland
22606,2/1/2021,FIN,Perak,0,0,0,Finland
22607,2/1/2021,FIN,Perlis,0,0,0,Finland
22608,2/1/2021,FIN,Pulau Pinang,0,0,0,Finland
22609,2/1/2021,FIN,Sabah,0,0,0,Finland
22610,2/1/2021,FIN,Sarawak,0,0,0,Finland
22611,2/1/2021,FIN,Selangor,12,8,4,Finland
22612,2/1/2021,FIN,W.P. Labuan,0,0,0,Finland
22613,2/1/2021,FJI,Johor,0,0,0,Fiji
22614,2/1/2021,FJI,Kedah,0,0,0,Fiji
22615,2/1/2021,FJI,Kelantan,0,0,0,Fiji
22616,2/1/2021,FJI,Perak,0,0,0,Fiji
22617,2/1/2021,FJI,Perlis,0,0,0,Fiji
22618,2/1/2021,FJI,Pulau Pinang,0,0,0,Fiji
22619,2/1/2021,FJI,Sabah,0,0,0,Fiji
22620,2/1/2021,FJI,Sarawak,0,0,0,Fiji
22621,2/1/2021,FJI,Selangor,0,0,0,Fiji
22622,2/1/2021,FRA,Johor,0,0,0,France
22623,2/1/2021,FRA,Kedah,0,0,0,France
22624,2/1/2021,FRA,Kelantan,0,0,0,France
22625,2/1/2021,FRA,Melaka,0,0,0,France
22626,2/1/2021,FRA,Negeri Sembilan,0,0,0,France
22627,2/1/2021,FRA,Pahang,0,0,0,France
22628,2/1/2021,FRA,Perak,0,0,0,France
22629,2/1/2021,FRA,Perlis,0,0,0,France
22630,2/1/2021,FRA,Pulau Pinang,0,0,0,France
22631,2/1/2021,FRA,Sabah,0,0,0,France
22632,2/1/2021,FRA,Sarawak,0,0,0,France
22633,2/1/2021,FRA,Selangor,52,38,14,France
22634,2/1/2021,FRA,Terengganu,0,0,0,France
22635,2/1/2021,FRA,W.P. Labuan,0,0,0,France
22636,2/1/2021,FSM,Johor,0,0,0,"Micronesia, Federated States of"
22637,2/1/2021,FSM,Pulau Pinang,0,0,0,"Micronesia, Federated States of"
22638,2/1/2021,FSM,Selangor,0,0,0,"Micronesia, Federated States of"
22639,2/1/2021,GAB,Johor,0,0,0,Gabon
22640,2/1/2021,GAB,Pulau Pinang,0,0,0,Gabon
22641,2/1/2021,GAB,Sarawak,0,0,0,Gabon
22642,2/1/2021,GAB,Selangor,0,0,0,Gabon
22643,2/1/2021,GBR,Johor,3,3,0,United Kingdom
22644,2/1/2021,GBR,Kedah,0,0,0,United Kingdom
22645,2/1/2021,GBR,Kelantan,0,0,0,United Kingdom
22646,2/1/2021,GBR,Melaka,0,0,0,United Kingdom
22647,2/1/2021,GBR,Negeri Sembilan,0,0,0,United Kingdom
22648,2/1/2021,GBR,Pahang,0,0,0,United Kingdom
22649,2/1/2021,GBR,Perak,0,0,0,United Kingdom
22650,2/1/2021,GBR,Perlis,0,0,0,United Kingdom
22651,2/1/2021,GBR,Pulau Pinang,2,2,0,United Kingdom
22652,2/1/2021,GBR,Sabah,0,0,0,United Kingdom
22653,2/1/2021,GBR,Sarawak,3,2,1,United Kingdom
22654,2/1/2021,GBR,Selangor,248,218,30,United Kingdom
22655,2/1/2021,GBR,Terengganu,0,0,0,United Kingdom
22656,2/1/2021,GBR,W.P. Labuan,0,0,0,United Kingdom
22657,2/1/2021,GEO,Johor,0,0,0,Georgia
22658,2/1/2021,GEO,Kedah,0,0,0,Georgia
22659,2/1/2021,GEO,Melaka,0,0,0,Georgia
22660,2/1/2021,GEO,Perak,0,0,0,Georgia
22661,2/1/2021,GEO,Perlis,0,0,0,Georgia
22662,2/1/2021,GEO,Pulau Pinang,0,0,0,Georgia
22663,2/1/2021,GEO,Sabah,0,0,0,Georgia
22664,2/1/2021,GEO,Sarawak,0,0,0,Georgia
22665,2/1/2021,GEO,Selangor,1,1,0,Georgia
22666,2/1/2021,GHA,Johor,1,1,0,Ghana
22667,2/1/2021,GHA,Kedah,0,0,0,Ghana
22668,2/1/2021,GHA,Kelantan,0,0,0,Ghana
22669,2/1/2021,GHA,Pulau Pinang,0,0,0,Ghana
22670,2/1/2021,GHA,Sabah,0,0,0,Ghana
22671,2/1/2021,GHA,Sarawak,0,0,0,Ghana
22672,2/1/2021,GHA,Selangor,8,8,0,Ghana
22673,2/1/2021,GIB,Johor,0,0,0,Gibraltar
22674,2/1/2021,GIB,Sarawak,0,0,0,Gibraltar
22675,2/1/2021,GIN,Johor,0,0,0,Guinea
22676,2/1/2021,GIN,Kedah,0,0,0,Guinea
22677,2/1/2021,GIN,Kelantan,0,0,0,Guinea
22678,2/1/2021,GIN,Perlis,0,0,0,Guinea
22679,2/1/2021,GIN,Pulau Pinang,0,0,0,Guinea
22680,2/1/2021,GIN,Sabah,0,0,0,Guinea
22681,2/1/2021,GIN,Sarawak,0,0,0,Guinea
22682,2/1/2021,GIN,Selangor,10,5,5,Guinea
22683,2/1/2021,GLP,Selangor,0,0,0,Guadeloupe
22684,2/1/2021,GMB,Johor,0,0,0,Gambia
22685,2/1/2021,GMB,Kedah,0,0,0,Gambia
22686,2/1/2021,GMB,Kelantan,0,0,0,Gambia
22687,2/1/2021,GMB,Pulau Pinang,0,0,0,Gambia
22688,2/1/2021,GMB,Sabah,0,0,0,Gambia
22689,2/1/2021,GMB,Sarawak,0,0,0,Gambia
22690,2/1/2021,GMB,Selangor,0,0,0,Gambia
22691,2/1/2021,GNB,Johor,0,0,0,Guinea-Bissau
22692,2/1/2021,GNB,Selangor,0,0,0,Guinea-Bissau
22693,2/1/2021,GNQ,Johor,0,0,0,Equatorial Guinea
22694,2/1/2021,GNQ,Selangor,0,0,0,Equatorial Guinea
22695,2/1/2021,GRC,Johor,0,0,0,Greece
22696,2/1/2021,GRC,Kedah,0,0,0,Greece
22697,2/1/2021,GRC,Kelantan,0,0,0,Greece
22698,2/1/2021,GRC,Melaka,0,0,0,Greece
22699,2/1/2021,GRC,Negeri Sembilan,0,0,0,Greece
22700,2/1/2021,GRC,Pahang,0,0,0,Greece
22701,2/1/2021,GRC,Perak,0,0,0,Greece
22702,2/1/2021,GRC,Perlis,0,0,0,Greece
22703,2/1/2021,GRC,Pulau Pinang,0,0,0,Greece
22704,2/1/2021,GRC,Sabah,0,0,0,Greece
22705,2/1/2021,GRC,Sarawak,0,0,0,Greece
22706,2/1/2021,GRC,Selangor,6,5,1,Greece
22707,2/1/2021,GRD,Johor,0,0,0,Grenada
22708,2/1/2021,GRD,Kedah,0,0,0,Grenada
22709,2/1/2021,GRD,Pulau Pinang,0,0,0,Grenada
22710,2/1/2021,GRD,Sabah,0,0,0,Grenada
22711,2/1/2021,GRD,Sarawak,0,0,0,Grenada
22712,2/1/2021,GRD,Selangor,0,0,0,Grenada
22713,2/1/2021,GRL,Johor,0,0,0,Greenland
22714,2/1/2021,GRL,Selangor,0,0,0,Greenland
22715,2/1/2021,GTM,Johor,0,0,0,Guatemala
22716,2/1/2021,GTM,Kedah,0,0,0,Guatemala
22717,2/1/2021,GTM,Pahang,0,0,0,Guatemala
22718,2/1/2021,GTM,Perak,0,0,0,Guatemala
22719,2/1/2021,GTM,Pulau Pinang,0,0,0,Guatemala
22720,2/1/2021,GTM,Sabah,0,0,0,Guatemala
22721,2/1/2021,GTM,Sarawak,0,0,0,Guatemala
22722,2/1/2021,GTM,Selangor,0,0,0,Guatemala
22723,2/1/2021,GTM,W.P. Labuan,0,0,0,Guatemala
22724,2/1/2021,GUY,Johor,0,0,0,Guyana
22725,2/1/2021,GUY,Kedah,0,0,0,Guyana
22726,2/1/2021,GUY,Pulau Pinang,0,0,0,Guyana
22727,2/1/2021,GUY,Sarawak,0,0,0,Guyana
22728,2/1/2021,GUY,Selangor,0,0,0,Guyana
22729,2/1/2021,HKG,Johor,0,0,0,Hong Kong
22730,2/1/2021,HKG,Kedah,0,0,0,Hong Kong
22731,2/1/2021,HKG,Kelantan,0,0,0,Hong Kong
22732,2/1/2021,HKG,Pahang,0,0,0,Hong Kong
22733,2/1/2021,HKG,Perak,1,0,1,Hong Kong
22734,2/1/2021,HKG,Perlis,0,0,0,Hong Kong
22735,2/1/2021,HKG,Pulau Pinang,0,0,0,Hong Kong
22736,2/1/2021,HKG,Sabah,0,0,0,Hong Kong
22737,2/1/2021,HKG,Sarawak,0,0,0,Hong Kong
22738,2/1/2021,HKG,Selangor,2,2,0,Hong Kong
22739,2/1/2021,HKG,Terengganu,0,0,0,Hong Kong
22740,2/1/2021,HMD,Johor,0,0,0,Heard Island and McDonald Islands
22741,2/1/2021,HND,Johor,0,0,0,Honduras
22742,2/1/2021,HND,Kedah,0,0,0,Honduras
22743,2/1/2021,HND,Perak,0,0,0,Honduras
22744,2/1/2021,HND,Pulau Pinang,0,0,0,Honduras
22745,2/1/2021,HND,Sabah,0,0,0,Honduras
22746,2/1/2021,HND,Sarawak,0,0,0,Honduras
22747,2/1/2021,HND,Selangor,1,1,0,Honduras
22748,2/1/2021,HRV,Johor,3,3,0,Croatia
22749,2/1/2021,HRV,Kedah,0,0,0,Croatia
22750,2/1/2021,HRV,Kelantan,0,0,0,Croatia
22751,2/1/2021,HRV,Melaka,0,0,0,Croatia
22752,2/1/2021,HRV,Pahang,0,0,0,Croatia
22753,2/1/2021,HRV,Perak,0,0,0,Croatia
22754,2/1/2021,HRV,Perlis,0,0,0,Croatia
22755,2/1/2021,HRV,Pulau Pinang,0,0,0,Croatia
22756,2/1/2021,HRV,Sabah,0,0,0,Croatia
22757,2/1/2021,HRV,Sarawak,0,0,0,Croatia
22758,2/1/2021,HRV,Selangor,60,59,1,Croatia
22759,2/1/2021,HTI,Johor,0,0,0,Haiti
22760,2/1/2021,HTI,Kedah,0,0,0,Haiti
22761,2/1/2021,HTI,Kelantan,0,0,0,Haiti
22762,2/1/2021,HTI,Perak,0,0,0,Haiti
22763,2/1/2021,HTI,Pulau Pinang,0,0,0,Haiti
22764,2/1/2021,HTI,Sabah,0,0,0,Haiti
22765,2/1/2021,HTI,Selangor,1,1,0,Haiti
22766,2/1/2021,HUN,Johor,0,0,0,Hungary
22767,2/1/2021,HUN,Kedah,0,0,0,Hungary
22768,2/1/2021,HUN,Kelantan,0,0,0,Hungary
22769,2/1/2021,HUN,Pahang,0,0,0,Hungary
22770,2/1/2021,HUN,Perak,0,0,0,Hungary
22771,2/1/2021,HUN,Perlis,0,0,0,Hungary
22772,2/1/2021,HUN,Pulau Pinang,0,0,0,Hungary
22773,2/1/2021,HUN,Sabah,0,0,0,Hungary
22774,2/1/2021,HUN,Sarawak,0,0,0,Hungary
22775,2/1/2021,HUN,Selangor,1,0,1,Hungary
22776,2/1/2021,HUN,W.P. Labuan,0,0,0,Hungary
22777,2/1/2021,IDN,Johor,228,188,40,Indonesia
22778,2/1/2021,IDN,Kedah,1,1,0,Indonesia
22779,2/1/2021,IDN,Kelantan,0,0,0,Indonesia
22780,2/1/2021,IDN,Melaka,0,0,0,Indonesia
22781,2/1/2021,IDN,Negeri Sembilan,0,0,0,Indonesia
22782,2/1/2021,IDN,Pahang,0,0,0,Indonesia
22783,2/1/2021,IDN,Perak,0,0,0,Indonesia
22784,2/1/2021,IDN,Perlis,9,9,0,Indonesia
22785,2/1/2021,IDN,Pulau Pinang,18,9,9,Indonesia
22786,2/1/2021,IDN,Sabah,12,5,7,Indonesia
22787,2/1/2021,IDN,Sarawak,285,284,1,Indonesia
22788,2/1/2021,IDN,Selangor,676,468,208,Indonesia
22789,2/1/2021,IDN,Terengganu,0,0,0,Indonesia
22790,2/1/2021,IDN,W.P. Labuan,0,0,0,Indonesia
22791,2/1/2021,IND,Johor,85,82,3,India
22792,2/1/2021,IND,Kedah,0,0,0,India
22793,2/1/2021,IND,Kelantan,0,0,0,India
22794,2/1/2021,IND,Melaka,0,0,0,India
22795,2/1/2021,IND,Negeri Sembilan,0,0,0,India
22796,2/1/2021,IND,Pahang,0,0,0,India
22797,2/1/2021,IND,Perak,0,0,0,India
22798,2/1/2021,IND,Perlis,0,0,0,India
22799,2/1/2021,IND,Pulau Pinang,0,0,0,India
22800,2/1/2021,IND,Sabah,0,0,0,India
22801,2/1/2021,IND,Sarawak,0,0,0,India
22802,2/1/2021,IND,Selangor,876,692,184,India
22803,2/1/2021,IND,Terengganu,0,0,0,India
22804,2/1/2021,IND,W.P. Labuan,0,0,0,India
22805,2/1/2021,IOT,Pulau Pinang,0,0,0,British Indian Ocean Territory
22806,2/1/2021,IOT,Selangor,0,0,0,British Indian Ocean Territory
22807,2/1/2021,IRL,Johor,0,0,0,Ireland
22808,2/1/2021,IRL,Kedah,0,0,0,Ireland
22809,2/1/2021,IRL,Kelantan,0,0,0,Ireland
22810,2/1/2021,IRL,Negeri Sembilan,0,0,0,Ireland
22811,2/1/2021,IRL,Pahang,0,0,0,Ireland
22812,2/1/2021,IRL,Perak,0,0,0,Ireland
22813,2/1/2021,IRL,Perlis,0,0,0,Ireland
22814,2/1/2021,IRL,Pulau Pinang,0,0,0,Ireland
22815,2/1/2021,IRL,Sabah,0,0,0,Ireland
22816,2/1/2021,IRL,Sarawak,0,0,0,Ireland
22817,2/1/2021,IRL,Selangor,3,3,0,Ireland
22818,2/1/2021,IRL,Terengganu,0,0,0,Ireland
22819,2/1/2021,IRL,W.P. Labuan,0,0,0,Ireland
22820,2/1/2021,IRN,Johor,1,1,0,Iran
22821,2/1/2021,IRN,Kedah,0,0,0,Iran
22822,2/1/2021,IRN,Kelantan,0,0,0,Iran
22823,2/1/2021,IRN,Perak,0,0,0,Iran
22824,2/1/2021,IRN,Perlis,0,0,0,Iran
22825,2/1/2021,IRN,Pulau Pinang,0,0,0,Iran
22826,2/1/2021,IRN,Sabah,0,0,0,Iran
22827,2/1/2021,IRN,Sarawak,0,0,0,Iran
22828,2/1/2021,IRN,Selangor,75,66,9,Iran
22829,2/1/2021,IRN,W.P. Labuan,0,0,0,Iran
22830,2/1/2021,IRQ,Johor,0,0,0,Iraq
22831,2/1/2021,IRQ,Kedah,0,0,0,Iraq
22832,2/1/2021,IRQ,Kelantan,0,0,0,Iraq
22833,2/1/2021,IRQ,Melaka,0,0,0,Iraq
22834,2/1/2021,IRQ,Pahang,0,0,0,Iraq
22835,2/1/2021,IRQ,Perak,0,0,0,Iraq
22836,2/1/2021,IRQ,Perlis,0,0,0,Iraq
22837,2/1/2021,IRQ,Pulau Pinang,0,0,0,Iraq
22838,2/1/2021,IRQ,Sabah,0,0,0,Iraq
22839,2/1/2021,IRQ,Sarawak,0,0,0,Iraq
22840,2/1/2021,IRQ,Selangor,29,22,7,Iraq
22841,2/1/2021,ISL,Johor,0,0,0,Iceland
22842,2/1/2021,ISL,Kedah,0,0,0,Iceland
22843,2/1/2021,ISL,Kelantan,0,0,0,Iceland
22844,2/1/2021,ISL,Perak,0,0,0,Iceland
22845,2/1/2021,ISL,Perlis,0,0,0,Iceland
22846,2/1/2021,ISL,Pulau Pinang,0,0,0,Iceland
22847,2/1/2021,ISL,Sabah,0,0,0,Iceland
22848,2/1/2021,ISL,Sarawak,0,0,0,Iceland
22849,2/1/2021,ISL,Selangor,0,0,0,Iceland
22850,2/1/2021,ISL,W.P. Labuan,0,0,0,Iceland
22851,2/1/2021,ISR,Pulau Pinang,0,0,0,Israel
22852,2/1/2021,ITA,Johor,1,1,0,Italy
22853,2/1/2021,ITA,Kedah,0,0,0,Italy
22854,2/1/2021,ITA,Kelantan,0,0,0,Italy
22855,2/1/2021,ITA,Melaka,0,0,0,Italy
22856,2/1/2021,ITA,Negeri Sembilan,0,0,0,Italy
22857,2/1/2021,ITA,Pahang,0,0,0,Italy
22858,2/1/2021,ITA,Perak,0,0,0,Italy
22859,2/1/2021,ITA,Perlis,0,0,0,Italy
22860,2/1/2021,ITA,Pulau Pinang,0,0,0,Italy
22861,2/1/2021,ITA,Sabah,0,0,0,Italy
22862,2/1/2021,ITA,Sarawak,0,0,0,Italy
22863,2/1/2021,ITA,Selangor,42,39,3,Italy
22864,2/1/2021,ITA,W.P. Labuan,0,0,0,Italy
22865,2/1/2021,JAM,Johor,0,0,0,Jamaica
22866,2/1/2021,JAM,Kedah,0,0,0,Jamaica
22867,2/1/2021,JAM,Perak,0,0,0,Jamaica
22868,2/1/2021,JAM,Pulau Pinang,0,0,0,Jamaica
22869,2/1/2021,JAM,Sabah,0,0,0,Jamaica
22870,2/1/2021,JAM,Sarawak,0,0,0,Jamaica
22871,2/1/2021,JAM,Selangor,1,0,1,Jamaica
22872,2/1/2021,JAM,W.P. Labuan,0,0,0,Jamaica
22873,2/1/2021,JOR,Johor,0,0,0,Jordan
22874,2/1/2021,JOR,Kedah,0,0,0,Jordan
22875,2/1/2021,JOR,Kelantan,0,0,0,Jordan
22876,2/1/2021,JOR,Melaka,0,0,0,Jordan
22877,2/1/2021,JOR,Perlis,0,0,0,Jordan
22878,2/1/2021,JOR,Pulau Pinang,0,0,0,Jordan
22879,2/1/2021,JOR,Sabah,0,0,0,Jordan
22880,2/1/2021,JOR,Sarawak,0,0,0,Jordan
22881,2/1/2021,JOR,Selangor,23,21,2,Jordan
22882,2/1/2021,JOR,W.P. Labuan,0,0,0,Jordan
22883,2/1/2021,JPN,Johor,1,1,0,Japan
22884,2/1/2021,JPN,Kedah,0,0,0,Japan
22885,2/1/2021,JPN,Kelantan,0,0,0,Japan
22886,2/1/2021,JPN,Melaka,0,0,0,Japan
22887,2/1/2021,JPN,Negeri Sembilan,0,0,0,Japan
22888,2/1/2021,JPN,Pahang,0,0,0,Japan
22889,2/1/2021,JPN,Perak,0,0,0,Japan
22890,2/1/2021,JPN,Perlis,0,0,0,Japan
22891,2/1/2021,JPN,Pulau Pinang,13,11,2,Japan
22892,2/1/2021,JPN,Sabah,0,0,0,Japan
22893,2/1/2021,JPN,Sarawak,9,9,0,Japan
22894,2/1/2021,JPN,Selangor,336,228,108,Japan
22895,2/1/2021,JPN,W.P. Labuan,0,0,0,Japan
22896,2/1/2021,KAZ,Johor,0,0,0,Kazakhstan
22897,2/1/2021,KAZ,Kedah,0,0,0,Kazakhstan
22898,2/1/2021,KAZ,Kelantan,0,0,0,Kazakhstan
22899,2/1/2021,KAZ,Melaka,0,0,0,Kazakhstan
22900,2/1/2021,KAZ,Perak,0,0,0,Kazakhstan
22901,2/1/2021,KAZ,Perlis,0,0,0,Kazakhstan
22902,2/1/2021,KAZ,Pulau Pinang,0,0,0,Kazakhstan
22903,2/1/2021,KAZ,Sabah,0,0,0,Kazakhstan
22904,2/1/2021,KAZ,Sarawak,0,0,0,Kazakhstan
22905,2/1/2021,KAZ,Selangor,20,10,10,Kazakhstan
22906,2/1/2021,KAZ,W.P. Labuan,0,0,0,Kazakhstan
22907,2/1/2021,KEN,Johor,0,0,0,Kenya
22908,2/1/2021,KEN,Kedah,0,0,0,Kenya
22909,2/1/2021,KEN,Kelantan,0,0,0,Kenya
22910,2/1/2021,KEN,Perak,0,0,0,Kenya
22911,2/1/2021,KEN,Perlis,0,0,0,Kenya
22912,2/1/2021,KEN,Pulau Pinang,0,0,0,Kenya
22913,2/1/2021,KEN,Sabah,0,0,0,Kenya
22914,2/1/2021,KEN,Sarawak,0,0,0,Kenya
22915,2/1/2021,KEN,Selangor,8,5,3,Kenya
22916,2/1/2021,KGZ,Johor,0,0,0,Kyrgyzstan
22917,2/1/2021,KGZ,Kedah,0,0,0,Kyrgyzstan
22918,2/1/2021,KGZ,Kelantan,0,0,0,Kyrgyzstan
22919,2/1/2021,KGZ,Perak,0,0,0,Kyrgyzstan
22920,2/1/2021,KGZ,Perlis,0,0,0,Kyrgyzstan
22921,2/1/2021,KGZ,Pulau Pinang,0,0,0,Kyrgyzstan
22922,2/1/2021,KGZ,Sabah,0,0,0,Kyrgyzstan
22923,2/1/2021,KGZ,Sarawak,0,0,0,Kyrgyzstan
22924,2/1/2021,KGZ,Selangor,2,2,0,Kyrgyzstan
22925,2/1/2021,KHM,Johor,0,0,0,Cambodia
22926,2/1/2021,KHM,Kedah,0,0,0,Cambodia
22927,2/1/2021,KHM,Kelantan,0,0,0,Cambodia
22928,2/1/2021,KHM,Melaka,0,0,0,Cambodia
22929,2/1/2021,KHM,Negeri Sembilan,0,0,0,Cambodia
22930,2/1/2021,KHM,Pahang,0,0,0,Cambodia
22931,2/1/2021,KHM,Perak,0,0,0,Cambodia
22932,2/1/2021,KHM,Perlis,0,0,0,Cambodia
22933,2/1/2021,KHM,Pulau Pinang,0,0,0,Cambodia
22934,2/1/2021,KHM,Sabah,0,0,0,Cambodia
22935,2/1/2021,KHM,Sarawak,0,0,0,Cambodia
22936,2/1/2021,KHM,Selangor,2,0,2,Cambodia
22937,2/1/2021,KHM,W.P. Labuan,0,0,0,Cambodia
22938,2/1/2021,KIR,Johor,0,0,0,Kiribati
22939,2/1/2021,KIR,Sabah,0,0,0,Kiribati
22940,2/1/2021,KIR,Selangor,10,10,0,Kiribati
22941,2/1/2021,KNA,Johor,0,0,0,Saint Kitts and Nevis
22942,2/1/2021,KNA,Kedah,0,0,0,Saint Kitts and Nevis
22943,2/1/2021,KNA,Perlis,0,0,0,Saint Kitts and Nevis
22944,2/1/2021,KNA,Pulau Pinang,0,0,0,Saint Kitts and Nevis
22945,2/1/2021,KNA,Sabah,0,0,0,Saint Kitts and Nevis
22946,2/1/2021,KNA,Selangor,1,1,0,Saint Kitts and Nevis
22947,2/1/2021,KNA,W.P. Labuan,0,0,0,Saint Kitts and Nevis
22948,2/1/2021,KOR,Johor,0,0,0,"Korea, Republic of (South Korea)"
22949,2/1/2021,KOR,Kedah,0,0,0,"Korea, Republic of (South Korea)"
22950,2/1/2021,KOR,Kelantan,0,0,0,"Korea, Republic of (South Korea)"
22951,2/1/2021,KOR,Melaka,0,0,0,"Korea, Republic of (South Korea)"
22952,2/1/2021,KOR,Negeri Sembilan,0,0,0,"Korea, Republic of (South Korea)"
22953,2/1/2021,KOR,Pahang,0,0,0,"Korea, Republic of (South Korea)"
22954,2/1/2021,KOR,Perak,0,0,0,"Korea, Republic of (South Korea)"
22955,2/1/2021,KOR,Perlis,0,0,0,"Korea, Republic of (South Korea)"
22956,2/1/2021,KOR,Pulau Pinang,2,1,1,"Korea, Republic of (South Korea)"
22957,2/1/2021,KOR,Sabah,1,1,0,"Korea, Republic of (South Korea)"
22958,2/1/2021,KOR,Sarawak,9,9,0,"Korea, Republic of (South Korea)"
22959,2/1/2021,KOR,Selangor,202,146,56,"Korea, Republic of (South Korea)"
22960,2/1/2021,KOR,Terengganu,0,0,0,"Korea, Republic of (South Korea)"
22961,2/1/2021,KOR,W.P. Labuan,0,0,0,"Korea, Republic of (South Korea)"
22962,2/1/2021,KWT,Johor,0,0,0,Kuwait
22963,2/1/2021,KWT,Kedah,0,0,0,Kuwait
22964,2/1/2021,KWT,Kelantan,0,0,0,Kuwait
22965,2/1/2021,KWT,Perak,0,0,0,Kuwait
22966,2/1/2021,KWT,Perlis,0,0,0,Kuwait
22967,2/1/2021,KWT,Pulau Pinang,0,0,0,Kuwait
22968,2/1/2021,KWT,Sabah,0,0,0,Kuwait
22969,2/1/2021,KWT,Sarawak,0,0,0,Kuwait
22970,2/1/2021,KWT,Selangor,5,3,2,Kuwait
22971,2/1/2021,KWT,W.P. Labuan,0,0,0,Kuwait
22972,2/1/2021,LAO,Johor,0,0,0,Lao People's Democratic Republic
22973,2/1/2021,LAO,Kedah,1,0,1,Lao People's Democratic Republic
22974,2/1/2021,LAO,Kelantan,0,0,0,Lao People's Democratic Republic
22975,2/1/2021,LAO,Melaka,0,0,0,Lao People's Democratic Republic
22976,2/1/2021,LAO,Perak,0,0,0,Lao People's Democratic Republic
22977,2/1/2021,LAO,Perlis,0,0,0,Lao People's Democratic Republic
22978,2/1/2021,LAO,Pulau Pinang,0,0,0,Lao People's Democratic Republic
22979,2/1/2021,LAO,Sabah,0,0,0,Lao People's Democratic Republic
22980,2/1/2021,LAO,Sarawak,0,0,0,Lao People's Democratic Republic
22981,2/1/2021,LAO,Selangor,0,0,0,Lao People's Democratic Republic
22982,2/1/2021,LAO,W.P. Labuan,0,0,0,Lao People's Democratic Republic
22983,2/1/2021,LBN,Johor,0,0,0,Lebanon
22984,2/1/2021,LBN,Kedah,0,0,0,Lebanon
22985,2/1/2021,LBN,Kelantan,0,0,0,Lebanon
22986,2/1/2021,LBN,Pahang,0,0,0,Lebanon
22987,2/1/2021,LBN,Perak,0,0,0,Lebanon
22988,2/1/2021,LBN,Perlis,0,0,0,Lebanon
22989,2/1/2021,LBN,Pulau Pinang,0,0,0,Lebanon
22990,2/1/2021,LBN,Sabah,0,0,0,Lebanon
22991,2/1/2021,LBN,Sarawak,0,0,0,Lebanon
22992,2/1/2021,LBN,Selangor,2,1,1,Lebanon
22993,2/1/2021,LBN,W.P. Labuan,0,0,0,Lebanon
22994,2/1/2021,LBR,Johor,0,0,0,Liberia
22995,2/1/2021,LBR,Kedah,0,0,0,Liberia
22996,2/1/2021,LBR,Sabah,0,0,0,Liberia
22997,2/1/2021,LBR,Sarawak,0,0,0,Liberia
22998,2/1/2021,LBR,Selangor,0,0,0,Liberia
22999,2/1/2021,LBY,Johor,0,0,0,Libyan Arab Jamahiriya
23000,2/1/2021,LBY,Kedah,0,0,0,Libyan Arab Jamahiriya
23001,2/1/2021,LBY,Perlis,0,0,0,Libyan Arab Jamahiriya
23002,2/1/2021,LBY,Pulau Pinang,0,0,0,Libyan Arab Jamahiriya
23003,2/1/2021,LBY,Sabah,0,0,0,Libyan Arab Jamahiriya
23004,2/1/2021,LBY,Sarawak,0,0,0,Libyan Arab Jamahiriya
23005,2/1/2021,LBY,Selangor,8,8,0,Libyan Arab Jamahiriya
23006,2/1/2021,LCA,Johor,0,0,0,Saint Lucia
23007,2/1/2021,LCA,Kedah,0,0,0,Saint Lucia
23008,2/1/2021,LCA,Pulau Pinang,0,0,0,Saint Lucia
23009,2/1/2021,LCA,Sarawak,0,0,0,Saint Lucia
23010,2/1/2021,LCA,Selangor,0,0,0,Saint Lucia
23011,2/1/2021,LIE,Johor,0,0,0,Liechtenstein
23012,2/1/2021,LIE,Kedah,0,0,0,Liechtenstein
23013,2/1/2021,LIE,Perlis,0,0,0,Liechtenstein
23014,2/1/2021,LIE,Pulau Pinang,0,0,0,Liechtenstein
23015,2/1/2021,LIE,Sabah,0,0,0,Liechtenstein
23016,2/1/2021,LIE,Sarawak,0,0,0,Liechtenstein
23017,2/1/2021,LIE,Selangor,0,0,0,Liechtenstein
23018,2/1/2021,LKA,Johor,2,2,0,Sri Lanka
23019,2/1/2021,LKA,Kedah,0,0,0,Sri Lanka
23020,2/1/2021,LKA,Kelantan,0,0,0,Sri Lanka
23021,2/1/2021,LKA,Melaka,0,0,0,Sri Lanka
23022,2/1/2021,LKA,Pahang,0,0,0,Sri Lanka
23023,2/1/2021,LKA,Perak,0,0,0,Sri Lanka
23024,2/1/2021,LKA,Perlis,0,0,0,Sri Lanka
23025,2/1/2021,LKA,Pulau Pinang,0,0,0,Sri Lanka
23026,2/1/2021,LKA,Sabah,0,0,0,Sri Lanka
23027,2/1/2021,LKA,Sarawak,0,0,0,Sri Lanka
23028,2/1/2021,LKA,Selangor,80,51,29,Sri Lanka
23029,2/1/2021,LKA,W.P. Labuan,0,0,0,Sri Lanka
23030,2/1/2021,LSO,Johor,0,0,0,Lesotho
23031,2/1/2021,LSO,Kedah,0,0,0,Lesotho
23032,2/1/2021,LSO,Pulau Pinang,0,0,0,Lesotho
23033,2/1/2021,LSO,Sarawak,0,0,0,Lesotho
23034,2/1/2021,LSO,Selangor,0,0,0,Lesotho
23035,2/1/2021,LTU,Johor,1,1,0,Lithuania
23036,2/1/2021,LTU,Kedah,0,0,0,Lithuania
23037,2/1/2021,LTU,Kelantan,0,0,0,Lithuania
23038,2/1/2021,LTU,Pahang,0,0,0,Lithuania
23039,2/1/2021,LTU,Perak,0,0,0,Lithuania
23040,2/1/2021,LTU,Perlis,0,0,0,Lithuania
23041,2/1/2021,LTU,Pulau Pinang,0,0,0,Lithuania
23042,2/1/2021,LTU,Sabah,0,0,0,Lithuania
23043,2/1/2021,LTU,Sarawak,0,0,0,Lithuania
23044,2/1/2021,LTU,Selangor,2,2,0,Lithuania
23045,2/1/2021,LTU,W.P. Labuan,0,0,0,Lithuania
23046,2/1/2021,LUX,Johor,0,0,0,Luxembourg
23047,2/1/2021,LUX,Kedah,0,0,0,Luxembourg
23048,2/1/2021,LUX,Kelantan,0,0,0,Luxembourg
23049,2/1/2021,LUX,Perak,0,0,0,Luxembourg
23050,2/1/2021,LUX,Perlis,0,0,0,Luxembourg
23051,2/1/2021,LUX,Pulau Pinang,0,0,0,Luxembourg
23052,2/1/2021,LUX,Sabah,0,0,0,Luxembourg
23053,2/1/2021,LUX,Sarawak,0,0,0,Luxembourg
23054,2/1/2021,LUX,Selangor,2,1,1,Luxembourg
23055,2/1/2021,LVA,Johor,0,0,0,Latvia
23056,2/1/2021,LVA,Kedah,0,0,0,Latvia
23057,2/1/2021,LVA,Kelantan,0,0,0,Latvia
23058,2/1/2021,LVA,Pahang,0,0,0,Latvia
23059,2/1/2021,LVA,Perak,0,0,0,Latvia
23060,2/1/2021,LVA,Perlis,0,0,0,Latvia
23061,2/1/2021,LVA,Pulau Pinang,0,0,0,Latvia
23062,2/1/2021,LVA,Sabah,0,0,0,Latvia
23063,2/1/2021,LVA,Sarawak,0,0,0,Latvia
23064,2/1/2021,LVA,Selangor,8,7,1,Latvia
23065,2/1/2021,LVA,W.P. Labuan,0,0,0,Latvia
23066,2/1/2021,MAC,Johor,0,0,0,Macao
23067,2/1/2021,MAC,Pahang,0,0,0,Macao
23068,2/1/2021,MAC,Perak,0,0,0,Macao
23069,2/1/2021,MAC,Selangor,0,0,0,Macao
23070,2/1/2021,MAC,W.P. Labuan,0,0,0,Macao
23071,2/1/2021,MAR,Johor,0,0,0,Morocco
23072,2/1/2021,MAR,Kedah,0,0,0,Morocco
23073,2/1/2021,MAR,Kelantan,0,0,0,Morocco
23074,2/1/2021,MAR,Melaka,0,0,0,Morocco
23075,2/1/2021,MAR,Pahang,0,0,0,Morocco
23076,2/1/2021,MAR,Perak,0,0,0,Morocco
23077,2/1/2021,MAR,Perlis,0,0,0,Morocco
23078,2/1/2021,MAR,Pulau Pinang,0,0,0,Morocco
23079,2/1/2021,MAR,Sabah,0,0,0,Morocco
23080,2/1/2021,MAR,Sarawak,0,0,0,Morocco
23081,2/1/2021,MAR,Selangor,3,1,2,Morocco
23082,2/1/2021,MAR,W.P. Labuan,0,0,0,Morocco
23083,2/1/2021,MCO,Johor,0,0,0,Monaco
23084,2/1/2021,MCO,Kedah,0,0,0,Monaco
23085,2/1/2021,MCO,Sabah,0,0,0,Monaco
23086,2/1/2021,MCO,Selangor,0,0,0,Monaco
23087,2/1/2021,MDA,Johor,0,0,0,"Moldova, Republic of"
23088,2/1/2021,MDA,Kedah,0,0,0,"Moldova, Republic of"
23089,2/1/2021,MDA,Kelantan,0,0,0,"Moldova, Republic of"
23090,2/1/2021,MDA,Negeri Sembilan,0,0,0,"Moldova, Republic of"
23091,2/1/2021,MDA,Perlis,0,0,0,"Moldova, Republic of"
23092,2/1/2021,MDA,Pulau Pinang,0,0,0,"Moldova, Republic of"
23093,2/1/2021,MDA,Sabah,0,0,0,"Moldova, Republic of"
23094,2/1/2021,MDA,Sarawak,0,0,0,"Moldova, Republic of"
23095,2/1/2021,MDA,Selangor,1,1,0,"Moldova, Republic of"
23096,2/1/2021,MDG,Johor,0,0,0,Madagascar
23097,2/1/2021,MDG,Kedah,0,0,0,Madagascar
23098,2/1/2021,MDG,Perak,0,0,0,Madagascar
23099,2/1/2021,MDG,Perlis,0,0,0,Madagascar
23100,2/1/2021,MDG,Pulau Pinang,0,0,0,Madagascar
23101,2/1/2021,MDG,Sabah,0,0,0,Madagascar
23102,2/1/2021,MDG,Sarawak,0,0,0,Madagascar
23103,2/1/2021,MDG,Selangor,0,0,0,Madagascar
23104,2/1/2021,MDV,Johor,0,0,0,Maldives
23105,2/1/2021,MDV,Kedah,0,0,0,Maldives
23106,2/1/2021,MDV,Kelantan,0,0,0,Maldives
23107,2/1/2021,MDV,Perak,0,0,0,Maldives
23108,2/1/2021,MDV,Perlis,0,0,0,Maldives
23109,2/1/2021,MDV,Pulau Pinang,0,0,0,Maldives
23110,2/1/2021,MDV,Sabah,0,0,0,Maldives
23111,2/1/2021,MDV,Sarawak,0,0,0,Maldives
23112,2/1/2021,MDV,Selangor,54,27,27,Maldives
23113,2/1/2021,MEX,Johor,0,0,0,Mexico
23114,2/1/2021,MEX,Kedah,0,0,0,Mexico
23115,2/1/2021,MEX,Kelantan,0,0,0,Mexico
23116,2/1/2021,MEX,Pahang,0,0,0,Mexico
23117,2/1/2021,MEX,Perak,0,0,0,Mexico
23118,2/1/2021,MEX,Perlis,0,0,0,Mexico
23119,2/1/2021,MEX,Pulau Pinang,0,0,0,Mexico
23120,2/1/2021,MEX,Sabah,0,0,0,Mexico
23121,2/1/2021,MEX,Sarawak,0,0,0,Mexico
23122,2/1/2021,MEX,Selangor,3,2,1,Mexico
23123,2/1/2021,MEX,W.P. Labuan,0,0,0,Mexico
23124,2/1/2021,MHL,Johor,0,0,0,Marshall Islands
23125,2/1/2021,MHL,Kedah,0,0,0,Marshall Islands
23126,2/1/2021,MHL,Perak,0,0,0,Marshall Islands
23127,2/1/2021,MHL,Pulau Pinang,0,0,0,Marshall Islands
23128,2/1/2021,MHL,Sabah,0,0,0,Marshall Islands
23129,2/1/2021,MHL,Selangor,0,0,0,Marshall Islands
23130,2/1/2021,MKD,Johor,0,0,0,"Macedonia, the former Yugoslav Republic of"
23131,2/1/2021,MKD,Kedah,0,0,0,"Macedonia, the former Yugoslav Republic of"
23132,2/1/2021,MKD,Perak,0,0,0,"Macedonia, the former Yugoslav Republic of"
23133,2/1/2021,MKD,Pulau Pinang,0,0,0,"Macedonia, the former Yugoslav Republic of"
23134,2/1/2021,MKD,Sabah,0,0,0,"Macedonia, the former Yugoslav Republic of"
23135,2/1/2021,MKD,Sarawak,0,0,0,"Macedonia, the former Yugoslav Republic of"
23136,2/1/2021,MKD,Selangor,0,0,0,"Macedonia, the former Yugoslav Republic of"
23137,2/1/2021,MLI,Johor,0,0,0,Mali
23138,2/1/2021,MLI,Sabah,0,0,0,Mali
23139,2/1/2021,MLI,Selangor,0,0,0,Mali
23140,2/1/2021,MLT,Johor,0,0,0,Malta
23141,2/1/2021,MLT,Kedah,0,0,0,Malta
23142,2/1/2021,MLT,Kelantan,0,0,0,Malta
23143,2/1/2021,MLT,Perak,0,0,0,Malta
23144,2/1/2021,MLT,Perlis,0,0,0,Malta
23145,2/1/2021,MLT,Pulau Pinang,0,0,0,Malta
23146,2/1/2021,MLT,Sabah,0,0,0,Malta
23147,2/1/2021,MLT,Sarawak,0,0,0,Malta
23148,2/1/2021,MLT,Selangor,1,1,0,Malta
23149,2/1/2021,MLT,W.P. Labuan,0,0,0,Malta
23150,2/1/2021,MMR,Johor,2,2,0,Myanmar
23151,2/1/2021,MMR,Kedah,0,0,0,Myanmar
23152,2/1/2021,MMR,Kelantan,0,0,0,Myanmar
23153,2/1/2021,MMR,Negeri Sembilan,0,0,0,Myanmar
23154,2/1/2021,MMR,Pahang,0,0,0,Myanmar
23155,2/1/2021,MMR,Perak,0,0,0,Myanmar
23156,2/1/2021,MMR,Perlis,0,0,0,Myanmar
23157,2/1/2021,MMR,Pulau Pinang,0,0,0,Myanmar
23158,2/1/2021,MMR,Sabah,0,0,0,Myanmar
23159,2/1/2021,MMR,Sarawak,0,0,0,Myanmar
23160,2/1/2021,MMR,Selangor,73,64,9,Myanmar
23161,2/1/2021,MMR,Terengganu,0,0,0,Myanmar
23162,2/1/2021,MMR,W.P. Labuan,0,0,0,Myanmar
23163,2/1/2021,MNE,Johor,0,0,0,Montenegro
23164,2/1/2021,MNE,Kedah,0,0,0,Montenegro
23165,2/1/2021,MNE,Pulau Pinang,0,0,0,Montenegro
23166,2/1/2021,MNE,Sabah,0,0,0,Montenegro
23167,2/1/2021,MNE,Sarawak,0,0,0,Montenegro
23168,2/1/2021,MNE,Selangor,8,8,0,Montenegro
23169,2/1/2021,MNG,Johor,0,0,0,Mongolia
23170,2/1/2021,MNG,Kedah,0,0,0,Mongolia
23171,2/1/2021,MNG,Kelantan,0,0,0,Mongolia
23172,2/1/2021,MNG,Perak,0,0,0,Mongolia
23173,2/1/2021,MNG,Perlis,0,0,0,Mongolia
23174,2/1/2021,MNG,Pulau Pinang,0,0,0,Mongolia
23175,2/1/2021,MNG,Sabah,0,0,0,Mongolia
23176,2/1/2021,MNG,Sarawak,0,0,0,Mongolia
23177,2/1/2021,MNG,Selangor,0,0,0,Mongolia
23178,2/1/2021,MNP,Selangor,0,0,0,Northern Mariana Islands
23179,2/1/2021,MOZ,Johor,0,0,0,Mozambique
23180,2/1/2021,MOZ,Kedah,0,0,0,Mozambique
23181,2/1/2021,MOZ,Perak,0,0,0,Mozambique
23182,2/1/2021,MOZ,Pulau Pinang,0,0,0,Mozambique
23183,2/1/2021,MOZ,Sabah,0,0,0,Mozambique
23184,2/1/2021,MOZ,Sarawak,0,0,0,Mozambique
23185,2/1/2021,MOZ,Selangor,3,1,2,Mozambique
23186,2/1/2021,MRT,Johor,0,0,0,Mauritania
23187,2/1/2021,MRT,Kedah,0,0,0,Mauritania
23188,2/1/2021,MRT,Pulau Pinang,0,0,0,Mauritania
23189,2/1/2021,MRT,Sabah,0,0,0,Mauritania
23190,2/1/2021,MRT,Sarawak,0,0,0,Mauritania
23191,2/1/2021,MRT,Selangor,4,4,0,Mauritania
23192,2/1/2021,MUS,Johor,0,0,0,Mauritius
23193,2/1/2021,MUS,Kedah,0,0,0,Mauritius
23194,2/1/2021,MUS,Kelantan,0,0,0,Mauritius
23195,2/1/2021,MUS,Pahang,0,0,0,Mauritius
23196,2/1/2021,MUS,Perak,0,0,0,Mauritius
23197,2/1/2021,MUS,Perlis,0,0,0,Mauritius
23198,2/1/2021,MUS,Pulau Pinang,0,0,0,Mauritius
23199,2/1/2021,MUS,Sabah,0,0,0,Mauritius
23200,2/1/2021,MUS,Sarawak,0,0,0,Mauritius
23201,2/1/2021,MUS,Selangor,7,1,6,Mauritius
23202,2/1/2021,MWI,Johor,0,0,0,Malawi
23203,2/1/2021,MWI,Pulau Pinang,0,0,0,Malawi
23204,2/1/2021,MWI,Sabah,0,0,0,Malawi
23205,2/1/2021,MWI,Sarawak,0,0,0,Malawi
23206,2/1/2021,MWI,Selangor,0,0,0,Malawi
23207,2/1/2021,MYT,Selangor,0,0,0,Mayotte
23208,2/1/2021,NAM,Johor,0,0,0,Namibia
23209,2/1/2021,NAM,Kedah,0,0,0,Namibia
23210,2/1/2021,NAM,Perak,0,0,0,Namibia
23211,2/1/2021,NAM,Perlis,0,0,0,Namibia
23212,2/1/2021,NAM,Pulau Pinang,0,0,0,Namibia
23213,2/1/2021,NAM,Sabah,0,0,0,Namibia
23214,2/1/2021,NAM,Sarawak,0,0,0,Namibia
23215,2/1/2021,NAM,Selangor,5,3,2,Namibia
23216,2/1/2021,NCL,Selangor,0,0,0,New Caledonia
23217,2/1/2021,NER,Johor,0,0,0,Niger
23218,2/1/2021,NER,Sabah,0,0,0,Niger
23219,2/1/2021,NER,Selangor,0,0,0,Niger
23220,2/1/2021,NGA,Johor,0,0,0,Nigeria
23221,2/1/2021,NGA,Kedah,0,0,0,Nigeria
23222,2/1/2021,NGA,Perlis,0,0,0,Nigeria
23223,2/1/2021,NGA,Pulau Pinang,0,0,0,Nigeria
23224,2/1/2021,NGA,Sabah,0,0,0,Nigeria
23225,2/1/2021,NGA,Sarawak,0,0,0,Nigeria
23226,2/1/2021,NGA,Selangor,62,52,10,Nigeria
23227,2/1/2021,NIC,Johor,0,0,0,Nicaragua
23228,2/1/2021,NIC,Kedah,0,0,0,Nicaragua
23229,2/1/2021,NIC,Pulau Pinang,0,0,0,Nicaragua
23230,2/1/2021,NIC,Sabah,0,0,0,Nicaragua
23231,2/1/2021,NIC,Selangor,0,0,0,Nicaragua
23232,2/1/2021,NLD,Johor,2,2,0,Netherlands
23233,2/1/2021,NLD,Kedah,0,0,0,Netherlands
23234,2/1/2021,NLD,Kelantan,0,0,0,Netherlands
23235,2/1/2021,NLD,Melaka,0,0,0,Netherlands
23236,2/1/2021,NLD,Negeri Sembilan,0,0,0,Netherlands
23237,2/1/2021,NLD,Pahang,0,0,0,Netherlands
23238,2/1/2021,NLD,Perak,0,0,0,Netherlands
23239,2/1/2021,NLD,Perlis,0,0,0,Netherlands
23240,2/1/2021,NLD,Pulau Pinang,0,0,0,Netherlands
23241,2/1/2021,NLD,Sabah,0,0,0,Netherlands
23242,2/1/2021,NLD,Sarawak,0,0,0,Netherlands
23243,2/1/2021,NLD,Selangor,28,20,8,Netherlands
23244,2/1/2021,NLD,Terengganu,0,0,0,Netherlands
23245,2/1/2021,NLD,W.P. Labuan,0,0,0,Netherlands
23246,2/1/2021,NOR,Johor,0,0,0,Norway
23247,2/1/2021,NOR,Kedah,0,0,0,Norway
23248,2/1/2021,NOR,Kelantan,0,0,0,Norway
23249,2/1/2021,NOR,Melaka,0,0,0,Norway
23250,2/1/2021,NOR,Pahang,0,0,0,Norway
23251,2/1/2021,NOR,Perak,0,0,0,Norway
23252,2/1/2021,NOR,Perlis,0,0,0,Norway
23253,2/1/2021,NOR,Pulau Pinang,0,0,0,Norway
23254,2/1/2021,NOR,Sabah,0,0,0,Norway
23255,2/1/2021,NOR,Sarawak,0,0,0,Norway
23256,2/1/2021,NOR,Selangor,10,10,0,Norway
23257,2/1/2021,NOR,W.P. Labuan,0,0,0,Norway
23258,2/1/2021,NPL,Johor,0,0,0,Nepal
23259,2/1/2021,NPL,Kedah,0,0,0,Nepal
23260,2/1/2021,NPL,Pahang,0,0,0,Nepal
23261,2/1/2021,NPL,Perak,0,0,0,Nepal
23262,2/1/2021,NPL,Perlis,0,0,0,Nepal
23263,2/1/2021,NPL,Pulau Pinang,0,0,0,Nepal
23264,2/1/2021,NPL,Sabah,0,0,0,Nepal
23265,2/1/2021,NPL,Sarawak,0,0,0,Nepal
23266,2/1/2021,NPL,Selangor,34,30,4,Nepal
23267,2/1/2021,NPL,W.P. Labuan,0,0,0,Nepal
23268,2/1/2021,NRU,Johor,0,0,0,Nauru
23269,2/1/2021,NRU,Pulau Pinang,0,0,0,Nauru
23270,2/1/2021,NRU,Selangor,0,0,0,Nauru
23271,2/1/2021,NZL,Johor,0,0,0,New Zealand
23272,2/1/2021,NZL,Kedah,0,0,0,New Zealand
23273,2/1/2021,NZL,Kelantan,0,0,0,New Zealand
23274,2/1/2021,NZL,Melaka,0,0,0,New Zealand
23275,2/1/2021,NZL,Negeri Sembilan,0,0,0,New Zealand
23276,2/1/2021,NZL,Pahang,0,0,0,New Zealand
23277,2/1/2021,NZL,Perak,0,0,0,New Zealand
23278,2/1/2021,NZL,Perlis,0,0,0,New Zealand
23279,2/1/2021,NZL,Pulau Pinang,0,0,0,New Zealand
23280,2/1/2021,NZL,Sabah,0,0,0,New Zealand
23281,2/1/2021,NZL,Sarawak,0,0,0,New Zealand
23282,2/1/2021,NZL,Selangor,15,13,2,New Zealand
23283,2/1/2021,NZL,Terengganu,0,0,0,New Zealand
23284,2/1/2021,NZL,W.P. Labuan,0,0,0,New Zealand
23285,2/1/2021,OMN,Johor,0,0,0,Oman
23286,2/1/2021,OMN,Kedah,0,0,0,Oman
23287,2/1/2021,OMN,Kelantan,0,0,0,Oman
23288,2/1/2021,OMN,Melaka,0,0,0,Oman
23289,2/1/2021,OMN,Perak,0,0,0,Oman
23290,2/1/2021,OMN,Perlis,0,0,0,Oman
23291,2/1/2021,OMN,Pulau Pinang,0,0,0,Oman
23292,2/1/2021,OMN,Sabah,0,0,0,Oman
23293,2/1/2021,OMN,Sarawak,0,0,0,Oman
23294,2/1/2021,OMN,Selangor,3,3,0,Oman
23295,2/1/2021,PAK,Johor,13,13,0,Pakistan
23296,2/1/2021,PAK,Kedah,0,0,0,Pakistan
23297,2/1/2021,PAK,Kelantan,0,0,0,Pakistan
23298,2/1/2021,PAK,Melaka,0,0,0,Pakistan
23299,2/1/2021,PAK,Negeri Sembilan,0,0,0,Pakistan
23300,2/1/2021,PAK,Pahang,0,0,0,Pakistan
23301,2/1/2021,PAK,Perak,0,0,0,Pakistan
23302,2/1/2021,PAK,Perlis,0,0,0,Pakistan
23303,2/1/2021,PAK,Pulau Pinang,0,0,0,Pakistan
23304,2/1/2021,PAK,Sabah,0,0,0,Pakistan
23305,2/1/2021,PAK,Sarawak,0,0,0,Pakistan
23306,2/1/2021,PAK,Selangor,224,194,30,Pakistan
23307,2/1/2021,PAK,W.P. Labuan,0,0,0,Pakistan
23308,2/1/2021,PAN,Johor,0,0,0,Panama
23309,2/1/2021,PAN,Kedah,0,0,0,Panama
23310,2/1/2021,PAN,Perak,0,0,0,Panama
23311,2/1/2021,PAN,Perlis,0,0,0,Panama
23312,2/1/2021,PAN,Pulau Pinang,0,0,0,Panama
23313,2/1/2021,PAN,Sabah,0,0,0,Panama
23314,2/1/2021,PAN,Sarawak,0,0,0,Panama
23315,2/1/2021,PAN,Selangor,2,2,0,Panama
23316,2/1/2021,PER,Johor,0,0,0,Peru
23317,2/1/2021,PER,Kedah,0,0,0,Peru
23318,2/1/2021,PER,Kelantan,0,0,0,Peru
23319,2/1/2021,PER,Pahang,0,0,0,Peru
23320,2/1/2021,PER,Perak,0,0,0,Peru
23321,2/1/2021,PER,Perlis,0,0,0,Peru
23322,2/1/2021,PER,Pulau Pinang,0,0,0,Peru
23323,2/1/2021,PER,Sabah,0,0,0,Peru
23324,2/1/2021,PER,Sarawak,0,0,0,Peru
23325,2/1/2021,PER,Selangor,0,0,0,Peru
23326,2/1/2021,PER,W.P. Labuan,0,0,0,Peru
23327,2/1/2021,PHL,Johor,78,77,1,Philippines
23328,2/1/2021,PHL,Kedah,0,0,0,Philippines
23329,2/1/2021,PHL,Kelantan,0,0,0,Philippines
23330,2/1/2021,PHL,Melaka,0,0,0,Philippines
23331,2/1/2021,PHL,Negeri Sembilan,0,0,0,Philippines
23332,2/1/2021,PHL,Pahang,0,0,0,Philippines
23333,2/1/2021,PHL,Perak,0,0,0,Philippines
23334,2/1/2021,PHL,Perlis,0,0,0,Philippines
23335,2/1/2021,PHL,Pulau Pinang,0,0,0,Philippines
23336,2/1/2021,PHL,Sabah,4,1,3,Philippines
23337,2/1/2021,PHL,Sarawak,32,32,0,Philippines
23338,2/1/2021,PHL,Selangor,424,347,77,Philippines
23339,2/1/2021,PHL,Terengganu,0,0,0,Philippines
23340,2/1/2021,PHL,W.P. Labuan,8,8,0,Philippines
23341,2/1/2021,PLW,Johor,0,0,0,Palau
23342,2/1/2021,PLW,Pulau Pinang,0,0,0,Palau
23343,2/1/2021,PLW,Selangor,0,0,0,Palau
23344,2/1/2021,PNG,Johor,0,0,0,Papua New Guinea
23345,2/1/2021,PNG,Kedah,0,0,0,Papua New Guinea
23346,2/1/2021,PNG,Kelantan,0,0,0,Papua New Guinea
23347,2/1/2021,PNG,Perak,0,0,0,Papua New Guinea
23348,2/1/2021,PNG,Pulau Pinang,0,0,0,Papua New Guinea
23349,2/1/2021,PNG,Sabah,0,0,0,Papua New Guinea
23350,2/1/2021,PNG,Sarawak,0,0,0,Papua New Guinea
23351,2/1/2021,PNG,Selangor,0,0,0,Papua New Guinea
23352,2/1/2021,POL,Johor,6,6,0,Poland
23353,2/1/2021,POL,Kedah,0,0,0,Poland
23354,2/1/2021,POL,Kelantan,0,0,0,Poland
23355,2/1/2021,POL,Melaka,0,0,0,Poland
23356,2/1/2021,POL,Negeri Sembilan,0,0,0,Poland
23357,2/1/2021,POL,Pahang,0,0,0,Poland
23358,2/1/2021,POL,Perak,0,0,0,Poland
23359,2/1/2021,POL,Perlis,0,0,0,Poland
23360,2/1/2021,POL,Pulau Pinang,0,0,0,Poland
23361,2/1/2021,POL,Sabah,0,0,0,Poland
23362,2/1/2021,POL,Sarawak,0,0,0,Poland
23363,2/1/2021,POL,Selangor,27,25,2,Poland
23364,2/1/2021,POL,Terengganu,0,0,0,Poland
23365,2/1/2021,POL,W.P. Labuan,0,0,0,Poland
23366,2/1/2021,PRK,Selangor,0,0,0,"Korea, Democratic People's Republic of"
23367,2/1/2021,PRT,Johor,0,0,0,Portugal
23368,2/1/2021,PRT,Kedah,0,0,0,Portugal
23369,2/1/2021,PRT,Kelantan,0,0,0,Portugal
23370,2/1/2021,PRT,Melaka,0,0,0,Portugal
23371,2/1/2021,PRT,Pahang,0,0,0,Portugal
23372,2/1/2021,PRT,Perak,0,0,0,Portugal
23373,2/1/2021,PRT,Perlis,0,0,0,Portugal
23374,2/1/2021,PRT,Pulau Pinang,0,0,0,Portugal
23375,2/1/2021,PRT,Sabah,0,0,0,Portugal
23376,2/1/2021,PRT,Sarawak,0,0,0,Portugal
23377,2/1/2021,PRT,Selangor,11,5,6,Portugal
23378,2/1/2021,PRT,W.P. Labuan,0,0,0,Portugal
23379,2/1/2021,PRY,Johor,0,0,0,Paraguay
23380,2/1/2021,PRY,Kedah,0,0,0,Paraguay
23381,2/1/2021,PRY,Perak,0,0,0,Paraguay
23382,2/1/2021,PRY,Perlis,0,0,0,Paraguay
23383,2/1/2021,PRY,Pulau Pinang,0,0,0,Paraguay
23384,2/1/2021,PRY,Sabah,0,0,0,Paraguay
23385,2/1/2021,PRY,Sarawak,0,0,0,Paraguay
23386,2/1/2021,PRY,Selangor,0,0,0,Paraguay
23387,2/1/2021,PSE,Johor,0,0,0,"Palestinian Territory, Occupied"
23388,2/1/2021,PSE,Kedah,0,0,0,"Palestinian Territory, Occupied"
23389,2/1/2021,PSE,Kelantan,0,0,0,"Palestinian Territory, Occupied"
23390,2/1/2021,PSE,Melaka,0,0,0,"Palestinian Territory, Occupied"
23391,2/1/2021,PSE,Perak,0,0,0,"Palestinian Territory, Occupied"
23392,2/1/2021,PSE,Perlis,0,0,0,"Palestinian Territory, Occupied"
23393,2/1/2021,PSE,Pulau Pinang,0,0,0,"Palestinian Territory, Occupied"
23394,2/1/2021,PSE,Sabah,1,1,0,"Palestinian Territory, Occupied"
23395,2/1/2021,PSE,Sarawak,0,0,0,"Palestinian Territory, Occupied"
23396,2/1/2021,PSE,Selangor,7,6,1,"Palestinian Territory, Occupied"
23397,2/1/2021,QAT,Johor,0,0,0,Qatar
23398,2/1/2021,QAT,Kedah,0,0,0,Qatar
23399,2/1/2021,QAT,Perlis,0,0,0,Qatar
23400,2/1/2021,QAT,Pulau Pinang,0,0,0,Qatar
23401,2/1/2021,QAT,Sabah,0,0,0,Qatar
23402,2/1/2021,QAT,Sarawak,0,0,0,Qatar
23403,2/1/2021,QAT,Selangor,1,0,1,Qatar
23404,2/1/2021,REU,Johor,0,0,0,Reunion
23405,2/1/2021,REU,Sarawak,0,0,0,Reunion
23406,2/1/2021,ROU,Johor,5,5,0,Romania
23407,2/1/2021,ROU,Kedah,0,0,0,Romania
23408,2/1/2021,ROU,Kelantan,0,0,0,Romania
23409,2/1/2021,ROU,Negeri Sembilan,0,0,0,Romania
23410,2/1/2021,ROU,Pahang,0,0,0,Romania
23411,2/1/2021,ROU,Perak,0,0,0,Romania
23412,2/1/2021,ROU,Perlis,0,0,0,Romania
23413,2/1/2021,ROU,Pulau Pinang,0,0,0,Romania
23414,2/1/2021,ROU,Sabah,0,0,0,Romania
23415,2/1/2021,ROU,Sarawak,0,0,0,Romania
23416,2/1/2021,ROU,Selangor,55,42,13,Romania
23417,2/1/2021,ROU,W.P. Labuan,0,0,0,Romania
23418,2/1/2021,RUS,Johor,44,40,4,Russia
23419,2/1/2021,RUS,Kedah,0,0,0,Russia
23420,2/1/2021,RUS,Kelantan,0,0,0,Russia
23421,2/1/2021,RUS,Melaka,0,0,0,Russia
23422,2/1/2021,RUS,Negeri Sembilan,0,0,0,Russia
23423,2/1/2021,RUS,Pahang,0,0,0,Russia
23424,2/1/2021,RUS,Perak,0,0,0,Russia
23425,2/1/2021,RUS,Perlis,0,0,0,Russia
23426,2/1/2021,RUS,Pulau Pinang,0,0,0,Russia
23427,2/1/2021,RUS,Sabah,0,0,0,Russia
23428,2/1/2021,RUS,Sarawak,0,0,0,Russia
23429,2/1/2021,RUS,Selangor,39,32,7,Russia
23430,2/1/2021,RUS,W.P. Labuan,0,0,0,Russia
23431,2/1/2021,RWA,Johor,0,0,0,Rwanda
23432,2/1/2021,RWA,Kedah,0,0,0,Rwanda
23433,2/1/2021,RWA,Pulau Pinang,0,0,0,Rwanda
23434,2/1/2021,RWA,Selangor,0,0,0,Rwanda
23435,2/1/2021,SAU,Johor,0,0,0,Saudi Arabia
23436,2/1/2021,SAU,Kedah,0,0,0,Saudi Arabia
23437,2/1/2021,SAU,Kelantan,0,0,0,Saudi Arabia
23438,2/1/2021,SAU,Melaka,0,0,0,Saudi Arabia
23439,2/1/2021,SAU,Perak,0,0,0,Saudi Arabia
23440,2/1/2021,SAU,Perlis,0,0,0,Saudi Arabia
23441,2/1/2021,SAU,Pulau Pinang,0,0,0,Saudi Arabia
23442,2/1/2021,SAU,Sabah,0,0,0,Saudi Arabia
23443,2/1/2021,SAU,Sarawak,0,0,0,Saudi Arabia
23444,2/1/2021,SAU,Selangor,39,23,16,Saudi Arabia
23445,2/1/2021,SAU,W.P. Labuan,0,0,0,Saudi Arabia
23446,2/1/2021,SDN,Johor,0,0,0,Sudan
23447,2/1/2021,SDN,Kedah,0,0,0,Sudan
23448,2/1/2021,SDN,Kelantan,0,0,0,Sudan
23449,2/1/2021,SDN,Perlis,0,0,0,Sudan
23450,2/1/2021,SDN,Pulau Pinang,0,0,0,Sudan
23451,2/1/2021,SDN,Sabah,0,0,0,Sudan
23452,2/1/2021,SDN,Sarawak,0,0,0,Sudan
23453,2/1/2021,SDN,Selangor,32,17,15,Sudan
23454,2/1/2021,SDN,W.P. Labuan,0,0,0,Sudan
23455,2/1/2021,SEN,Johor,0,0,0,Senegal
23456,2/1/2021,SEN,Kedah,0,0,0,Senegal
23457,2/1/2021,SEN,Kelantan,0,0,0,Senegal
23458,2/1/2021,SEN,Perak,0,0,0,Senegal
23459,2/1/2021,SEN,Perlis,0,0,0,Senegal
23460,2/1/2021,SEN,Pulau Pinang,0,0,0,Senegal
23461,2/1/2021,SEN,Sabah,0,0,0,Senegal
23462,2/1/2021,SEN,Sarawak,0,0,0,Senegal
23463,2/1/2021,SEN,Selangor,4,4,0,Senegal
23464,2/1/2021,SGP,Johor,232,198,34,Singapore
23465,2/1/2021,SGP,Kedah,1,1,0,Singapore
23466,2/1/2021,SGP,Kelantan,0,0,0,Singapore
23467,2/1/2021,SGP,Melaka,0,0,0,Singapore
23468,2/1/2021,SGP,Negeri Sembilan,0,0,0,Singapore
23469,2/1/2021,SGP,Pahang,0,0,0,Singapore
23470,2/1/2021,SGP,Perak,3,1,2,Singapore
23471,2/1/2021,SGP,Perlis,1,1,0,Singapore
23472,2/1/2021,SGP,Pulau Pinang,26,17,9,Singapore
23473,2/1/2021,SGP,Sabah,0,0,0,Singapore
23474,2/1/2021,SGP,Sarawak,5,1,4,Singapore
23475,2/1/2021,SGP,Selangor,123,84,39,Singapore
23476,2/1/2021,SGP,Terengganu,0,0,0,Singapore
23477,2/1/2021,SGP,W.P. Labuan,0,0,0,Singapore
23478,2/1/2021,SGS,Johor,1,1,0,South Georgia and the South Sandwich Islands
23479,2/1/2021,SGS,Sabah,0,0,0,South Georgia and the South Sandwich Islands
23480,2/1/2021,SGS,Selangor,0,0,0,South Georgia and the South Sandwich Islands
23481,2/1/2021,SHN,Sarawak,0,0,0,"Saint Helena, Ascension and Tristan da Cunha"
23482,2/1/2021,SLB,Johor,0,0,0,Solomon Islands
23483,2/1/2021,SLB,Perlis,0,0,0,Solomon Islands
23484,2/1/2021,SLB,Pulau Pinang,0,0,0,Solomon Islands
23485,2/1/2021,SLB,Sabah,0,0,0,Solomon Islands
23486,2/1/2021,SLB,Sarawak,0,0,0,Solomon Islands
23487,2/1/2021,SLB,Selangor,0,0,0,Solomon Islands
23488,2/1/2021,SLB,W.P. Labuan,0,0,0,Solomon Islands
23489,2/1/2021,SLE,Johor,0,0,0,Sierra Leone
23490,2/1/2021,SLE,Kedah,0,0,0,Sierra Leone
23491,2/1/2021,SLE,Perak,0,0,0,Sierra Leone
23492,2/1/2021,SLE,Pulau Pinang,0,0,0,Sierra Leone
23493,2/1/2021,SLE,Sabah,0,0,0,Sierra Leone
23494,2/1/2021,SLE,Selangor,0,0,0,Sierra Leone
23495,2/1/2021,SLV,Johor,0,0,0,El Salvador
23496,2/1/2021,SLV,Kedah,0,0,0,El Salvador
23497,2/1/2021,SLV,Perak,0,0,0,El Salvador
23498,2/1/2021,SLV,Perlis,0,0,0,El Salvador
23499,2/1/2021,SLV,Pulau Pinang,0,0,0,El Salvador
23500,2/1/2021,SLV,Sabah,0,0,0,El Salvador
23501,2/1/2021,SLV,Selangor,0,0,0,El Salvador
23502,2/1/2021,SLV,W.P. Labuan,0,0,0,El Salvador
23503,2/1/2021,SMR,Johor,0,0,0,San Marino
23504,2/1/2021,SMR,Selangor,0,0,0,San Marino
23505,2/1/2021,SOM,Johor,0,0,0,Somalia
23506,2/1/2021,SOM,Kedah,0,0,0,Somalia
23507,2/1/2021,SOM,Kelantan,0,0,0,Somalia
23508,2/1/2021,SOM,Perlis,0,0,0,Somalia
23509,2/1/2021,SOM,Sabah,0,0,0,Somalia
23510,2/1/2021,SOM,Sarawak,0,0,0,Somalia
23511,2/1/2021,SOM,Selangor,15,12,3,Somalia
23512,2/1/2021,SRB,Johor,0,0,0,Serbia
23513,2/1/2021,SRB,Kedah,0,0,0,Serbia
23514,2/1/2021,SRB,Kelantan,0,0,0,Serbia
23515,2/1/2021,SRB,Pahang,0,0,0,Serbia
23516,2/1/2021,SRB,Perak,0,0,0,Serbia
23517,2/1/2021,SRB,Perlis,0,0,0,Serbia
23518,2/1/2021,SRB,Pulau Pinang,0,0,0,Serbia
23519,2/1/2021,SRB,Sabah,0,0,0,Serbia
23520,2/1/2021,SRB,Sarawak,0,0,0,Serbia
23521,2/1/2021,SRB,Selangor,3,2,1,Serbia
23522,2/1/2021,STP,Selangor,0,0,0,Sao Tome and Principe
23523,2/1/2021,SUR,Johor,0,0,0,Suriname
23524,2/1/2021,SUR,Kedah,0,0,0,Suriname
23525,2/1/2021,SUR,Kelantan,0,0,0,Suriname
23526,2/1/2021,SUR,Perak,0,0,0,Suriname
23527,2/1/2021,SUR,Perlis,0,0,0,Suriname
23528,2/1/2021,SUR,Pulau Pinang,0,0,0,Suriname
23529,2/1/2021,SUR,Sabah,0,0,0,Suriname
23530,2/1/2021,SUR,Sarawak,0,0,0,Suriname
23531,2/1/2021,SUR,Selangor,0,0,0,Suriname
23532,2/1/2021,SVK,Johor,0,0,0,Slovakia
23533,2/1/2021,SVK,Kedah,0,0,0,Slovakia
23534,2/1/2021,SVK,Kelantan,0,0,0,Slovakia
23535,2/1/2021,SVK,Negeri Sembilan,0,0,0,Slovakia
23536,2/1/2021,SVK,Pahang,0,0,0,Slovakia
23537,2/1/2021,SVK,Perak,0,0,0,Slovakia
23538,2/1/2021,SVK,Perlis,0,0,0,Slovakia
23539,2/1/2021,SVK,Pulau Pinang,0,0,0,Slovakia
23540,2/1/2021,SVK,Sabah,0,0,0,Slovakia
23541,2/1/2021,SVK,Sarawak,0,0,0,Slovakia
23542,2/1/2021,SVK,Selangor,11,11,0,Slovakia
23543,2/1/2021,SVK,W.P. Labuan,0,0,0,Slovakia
23544,2/1/2021,SVN,Johor,0,0,0,Slovenia
23545,2/1/2021,SVN,Kedah,0,0,0,Slovenia
23546,2/1/2021,SVN,Kelantan,0,0,0,Slovenia
23547,2/1/2021,SVN,Perak,0,0,0,Slovenia
23548,2/1/2021,SVN,Perlis,0,0,0,Slovenia
23549,2/1/2021,SVN,Pulau Pinang,0,0,0,Slovenia
23550,2/1/2021,SVN,Sabah,0,0,0,Slovenia
23551,2/1/2021,SVN,Sarawak,0,0,0,Slovenia
23552,2/1/2021,SVN,Selangor,0,0,0,Slovenia
23553,2/1/2021,SVN,W.P. Labuan,0,0,0,Slovenia
23554,2/1/2021,SWE,Johor,0,0,0,Sweden
23555,2/1/2021,SWE,Kedah,0,0,0,Sweden
23556,2/1/2021,SWE,Kelantan,0,0,0,Sweden
23557,2/1/2021,SWE,Melaka,0,0,0,Sweden
23558,2/1/2021,SWE,Negeri Sembilan,0,0,0,Sweden
23559,2/1/2021,SWE,Pahang,0,0,0,Sweden
23560,2/1/2021,SWE,Perak,0,0,0,Sweden
23561,2/1/2021,SWE,Perlis,0,0,0,Sweden
23562,2/1/2021,SWE,Pulau Pinang,0,0,0,Sweden
23563,2/1/2021,SWE,Sabah,0,0,0,Sweden
23564,2/1/2021,SWE,Sarawak,0,0,0,Sweden
23565,2/1/2021,SWE,Selangor,28,25,3,Sweden
23566,2/1/2021,SWE,W.P. Labuan,0,0,0,Sweden
23567,2/1/2021,SWZ,Johor,0,0,0,Swaziland
23568,2/1/2021,SWZ,Kedah,0,0,0,Swaziland
23569,2/1/2021,SWZ,Pulau Pinang,0,0,0,Swaziland
23570,2/1/2021,SWZ,Sabah,0,0,0,Swaziland
23571,2/1/2021,SWZ,Selangor,0,0,0,Swaziland
23572,2/1/2021,SYC,Johor,0,0,0,Seychelles
23573,2/1/2021,SYC,Kedah,0,0,0,Seychelles
23574,2/1/2021,SYC,Pulau Pinang,0,0,0,Seychelles
23575,2/1/2021,SYC,Sabah,0,0,0,Seychelles
23576,2/1/2021,SYC,Sarawak,0,0,0,Seychelles
23577,2/1/2021,SYC,Selangor,5,0,5,Seychelles
23578,2/1/2021,SYR,Johor,0,0,0,Syrian Arab Republic
23579,2/1/2021,SYR,Kedah,0,0,0,Syrian Arab Republic
23580,2/1/2021,SYR,Kelantan,0,0,0,Syrian Arab Republic
23581,2/1/2021,SYR,Pahang,0,0,0,Syrian Arab Republic
23582,2/1/2021,SYR,Perlis,0,0,0,Syrian Arab Republic
23583,2/1/2021,SYR,Pulau Pinang,0,0,0,Syrian Arab Republic
23584,2/1/2021,SYR,Sabah,0,0,0,Syrian Arab Republic
23585,2/1/2021,SYR,Sarawak,0,0,0,Syrian Arab Republic
23586,2/1/2021,SYR,Selangor,18,16,2,Syrian Arab Republic
23587,2/1/2021,SYR,W.P. Labuan,0,0,0,Syrian Arab Republic
23588,2/1/2021,TCA,Perlis,0,0,0,Turks and Caicos
23589,2/1/2021,TCD,Johor,0,0,0,Chad
23590,2/1/2021,TCD,Kedah,0,0,0,Chad
23591,2/1/2021,TCD,Perlis,0,0,0,Chad
23592,2/1/2021,TCD,Selangor,0,0,0,Chad
23593,2/1/2021,TGO,Johor,0,0,0,Togo
23594,2/1/2021,TGO,Perak,0,0,0,Togo
23595,2/1/2021,TGO,Pulau Pinang,0,0,0,Togo
23596,2/1/2021,TGO,Selangor,0,0,0,Togo
23597,2/1/2021,THA,Johor,0,0,0,Thailand
23598,2/1/2021,THA,Kedah,16128,16086,42,Thailand
23599,2/1/2021,THA,Kelantan,3,1,2,Thailand
23600,2/1/2021,THA,Melaka,0,0,0,Thailand
23601,2/1/2021,THA,Negeri Sembilan,0,0,0,Thailand
23602,2/1/2021,THA,Pahang,0,0,0,Thailand
23603,2/1/2021,THA,Perak,0,0,0,Thailand
23604,2/1/2021,THA,Perlis,9325,8941,384,Thailand
23605,2/1/2021,THA,Pulau Pinang,9,4,5,Thailand
23606,2/1/2021,THA,Sabah,0,0,0,Thailand
23607,2/1/2021,THA,Sarawak,10,10,0,Thailand
23608,2/1/2021,THA,Selangor,100,51,49,Thailand
23609,2/1/2021,THA,Terengganu,6,6,0,Thailand
23610,2/1/2021,THA,W.P. Labuan,0,0,0,Thailand
23611,2/1/2021,TJK,Johor,0,0,0,Tajikistan
23612,2/1/2021,TJK,Kedah,0,0,0,Tajikistan
23613,2/1/2021,TJK,Perlis,0,0,0,Tajikistan
23614,2/1/2021,TJK,Pulau Pinang,0,0,0,Tajikistan
23615,2/1/2021,TJK,Sabah,0,0,0,Tajikistan
23616,2/1/2021,TJK,Selangor,5,3,2,Tajikistan
23617,2/1/2021,TKL,Selangor,0,0,0,Tokelau
23618,2/1/2021,TKM,Johor,0,0,0,Turkmenistan
23619,2/1/2021,TKM,Kedah,0,0,0,Turkmenistan
23620,2/1/2021,TKM,Kelantan,0,0,0,Turkmenistan
23621,2/1/2021,TKM,Perlis,0,0,0,Turkmenistan
23622,2/1/2021,TKM,Pulau Pinang,0,0,0,Turkmenistan
23623,2/1/2021,TKM,Sabah,0,0,0,Turkmenistan
23624,2/1/2021,TKM,Sarawak,0,0,0,Turkmenistan
23625,2/1/2021,TKM,Selangor,2,1,1,Turkmenistan
23626,2/1/2021,TLS,Johor,0,0,0,Timor-Leste
23627,2/1/2021,TLS,Kedah,0,0,0,Timor-Leste
23628,2/1/2021,TLS,Perlis,0,0,0,Timor-Leste
23629,2/1/2021,TLS,Pulau Pinang,0,0,0,Timor-Leste
23630,2/1/2021,TLS,Sabah,0,0,0,Timor-Leste
23631,2/1/2021,TLS,Sarawak,0,0,0,Timor-Leste
23632,2/1/2021,TLS,Selangor,1,1,0,Timor-Leste
23633,2/1/2021,TON,Johor,0,0,0,Tonga
23634,2/1/2021,TON,Pulau Pinang,0,0,0,Tonga
23635,2/1/2021,TON,Sarawak,0,0,0,Tonga
23636,2/1/2021,TON,Selangor,0,0,0,Tonga
23637,2/1/2021,TTO,Johor,0,0,0,Trinidad and Tobago
23638,2/1/2021,TTO,Kedah,0,0,0,Trinidad and Tobago
23639,2/1/2021,TTO,Pahang,0,0,0,Trinidad and Tobago
23640,2/1/2021,TTO,Pulau Pinang,0,0,0,Trinidad and Tobago
23641,2/1/2021,TTO,Sabah,0,0,0,Trinidad and Tobago
23642,2/1/2021,TTO,Sarawak,0,0,0,Trinidad and Tobago
23643,2/1/2021,TTO,Selangor,1,1,0,Trinidad and Tobago
23644,2/1/2021,TUN,Johor,0,0,0,Tunisia
23645,2/1/2021,TUN,Kedah,0,0,0,Tunisia
23646,2/1/2021,TUN,Kelantan,0,0,0,Tunisia
23647,2/1/2021,TUN,Melaka,0,0,0,Tunisia
23648,2/1/2021,TUN,Perak,0,0,0,Tunisia
23649,2/1/2021,TUN,Perlis,0,0,0,Tunisia
23650,2/1/2021,TUN,Pulau Pinang,0,0,0,Tunisia
23651,2/1/2021,TUN,Sabah,0,0,0,Tunisia
23652,2/1/2021,TUN,Sarawak,0,0,0,Tunisia
23653,2/1/2021,TUN,Selangor,3,2,1,Tunisia
23654,2/1/2021,TUN,W.P. Labuan,0,0,0,Tunisia
23655,2/1/2021,TUR,Johor,2,2,0,Turkey
23656,2/1/2021,TUR,Kedah,0,0,0,Turkey
23657,2/1/2021,TUR,Kelantan,0,0,0,Turkey
23658,2/1/2021,TUR,Melaka,0,0,0,Turkey
23659,2/1/2021,TUR,Negeri Sembilan,0,0,0,Turkey
23660,2/1/2021,TUR,Pahang,0,0,0,Turkey
23661,2/1/2021,TUR,Perak,0,0,0,Turkey
23662,2/1/2021,TUR,Perlis,0,0,0,Turkey
23663,2/1/2021,TUR,Pulau Pinang,0,0,0,Turkey
23664,2/1/2021,TUR,Sabah,0,0,0,Turkey
23665,2/1/2021,TUR,Sarawak,0,0,0,Turkey
23666,2/1/2021,TUR,Selangor,44,39,5,Turkey
23667,2/1/2021,TUR,W.P. Labuan,0,0,0,Turkey
23668,2/1/2021,TUV,Selangor,0,0,0,Tuvalu
23669,2/1/2021,TWN,Johor,0,0,0,Taiwan
23670,2/1/2021,TWN,Kedah,0,0,0,Taiwan
23671,2/1/2021,TWN,Kelantan,0,0,0,Taiwan
23672,2/1/2021,TWN,Melaka,0,0,0,Taiwan
23673,2/1/2021,TWN,Negeri Sembilan,0,0,0,Taiwan
23674,2/1/2021,TWN,Pahang,0,0,0,Taiwan
23675,2/1/2021,TWN,Perak,0,0,0,Taiwan
23676,2/1/2021,TWN,Perlis,0,0,0,Taiwan
23677,2/1/2021,TWN,Pulau Pinang,16,14,2,Taiwan
23678,2/1/2021,TWN,Sabah,0,0,0,Taiwan
23679,2/1/2021,TWN,Sarawak,0,0,0,Taiwan
23680,2/1/2021,TWN,Selangor,70,49,21,Taiwan
23681,2/1/2021,TWN,W.P. Labuan,0,0,0,Taiwan
23682,2/1/2021,TZA,Johor,0,0,0,"Tanzania, United Republic of"
23683,2/1/2021,TZA,Kedah,0,0,0,"Tanzania, United Republic of"
23684,2/1/2021,TZA,Perak,0,0,0,"Tanzania, United Republic of"
23685,2/1/2021,TZA,Perlis,0,0,0,"Tanzania, United Republic of"
23686,2/1/2021,TZA,Pulau Pinang,0,0,0,"Tanzania, United Republic of"
23687,2/1/2021,TZA,Sabah,0,0,0,"Tanzania, United Republic of"
23688,2/1/2021,TZA,Sarawak,0,0,0,"Tanzania, United Republic of"
23689,2/1/2021,TZA,Selangor,3,2,1,"Tanzania, United Republic of"
23690,2/1/2021,UGA,Johor,0,0,0,Uganda
23691,2/1/2021,UGA,Kedah,0,0,0,Uganda
23692,2/1/2021,UGA,Perak,0,0,0,Uganda
23693,2/1/2021,UGA,Perlis,0,0,0,Uganda
23694,2/1/2021,UGA,Pulau Pinang,0,0,0,Uganda
23695,2/1/2021,UGA,Sabah,0,0,0,Uganda
23696,2/1/2021,UGA,Sarawak,0,0,0,Uganda
23697,2/1/2021,UGA,Selangor,1,0,1,Uganda
23698,2/1/2021,UKR,Johor,38,38,0,Ukraine
23699,2/1/2021,UKR,Kedah,0,0,0,Ukraine
23700,2/1/2021,UKR,Kelantan,0,0,0,Ukraine
23701,2/1/2021,UKR,Melaka,0,0,0,Ukraine
23702,2/1/2021,UKR,Negeri Sembilan,0,0,0,Ukraine
23703,2/1/2021,UKR,Pahang,0,0,0,Ukraine
23704,2/1/2021,UKR,Perak,0,0,0,Ukraine
23705,2/1/2021,UKR,Perlis,0,0,0,Ukraine
23706,2/1/2021,UKR,Pulau Pinang,0,0,0,Ukraine
23707,2/1/2021,UKR,Sabah,0,0,0,Ukraine
23708,2/1/2021,UKR,Sarawak,0,0,0,Ukraine
23709,2/1/2021,UKR,Selangor,45,42,3,Ukraine
23710,2/1/2021,UKR,W.P. Labuan,0,0,0,Ukraine
23711,2/1/2021,URY,Johor,0,0,0,Uruguay
23712,2/1/2021,URY,Kedah,0,0,0,Uruguay
23713,2/1/2021,URY,Kelantan,0,0,0,Uruguay
23714,2/1/2021,URY,Perak,0,0,0,Uruguay
23715,2/1/2021,URY,Perlis,0,0,0,Uruguay
23716,2/1/2021,URY,Pulau Pinang,0,0,0,Uruguay
23717,2/1/2021,URY,Sabah,0,0,0,Uruguay
23718,2/1/2021,URY,Sarawak,0,0,0,Uruguay
23719,2/1/2021,URY,Selangor,0,0,0,Uruguay
23720,2/1/2021,URY,W.P. Labuan,0,0,0,Uruguay
23721,2/1/2021,USA,Johor,2,1,1,United States Of America
23722,2/1/2021,USA,Kedah,0,0,0,United States Of America
23723,2/1/2021,USA,Kelantan,0,0,0,United States Of America
23724,2/1/2021,USA,Melaka,0,0,0,United States Of America
23725,2/1/2021,USA,Negeri Sembilan,0,0,0,United States Of America
23726,2/1/2021,USA,Pahang,0,0,0,United States Of America
23727,2/1/2021,USA,Perak,0,0,0,United States Of America
23728,2/1/2021,USA,Perlis,0,0,0,United States Of America
23729,2/1/2021,USA,Pulau Pinang,2,1,1,United States Of America
23730,2/1/2021,USA,Sabah,0,0,0,United States Of America
23731,2/1/2021,USA,Sarawak,0,0,0,United States Of America
23732,2/1/2021,USA,Selangor,117,81,36,United States Of America
23733,2/1/2021,USA,Terengganu,0,0,0,United States Of America
23734,2/1/2021,USA,W.P. Labuan,0,0,0,United States Of America
23735,2/1/2021,UZB,Johor,0,0,0,Uzbekistan
23736,2/1/2021,UZB,Kedah,0,0,0,Uzbekistan
23737,2/1/2021,UZB,Kelantan,0,0,0,Uzbekistan
23738,2/1/2021,UZB,Perak,0,0,0,Uzbekistan
23739,2/1/2021,UZB,Perlis,0,0,0,Uzbekistan
23740,2/1/2021,UZB,Pulau Pinang,0,0,0,Uzbekistan
23741,2/1/2021,UZB,Sabah,0,0,0,Uzbekistan
23742,2/1/2021,UZB,Sarawak,0,0,0,Uzbekistan
23743,2/1/2021,UZB,Selangor,10,5,5,Uzbekistan
23744,2/1/2021,VAT,Johor,0,0,0,Holy See (Vatican City State)
23745,2/1/2021,VAT,Sarawak,0,0,0,Holy See (Vatican City State)
23746,2/1/2021,VAT,Selangor,0,0,0,Holy See (Vatican City State)
23747,2/1/2021,VCT,Johor,0,0,0,Saint Vincent and the Grenadines
23748,2/1/2021,VCT,Kedah,0,0,0,Saint Vincent and the Grenadines
23749,2/1/2021,VCT,Pulau Pinang,0,0,0,Saint Vincent and the Grenadines
23750,2/1/2021,VCT,Sarawak,0,0,0,Saint Vincent and the Grenadines
23751,2/1/2021,VCT,Selangor,0,0,0,Saint Vincent and the Grenadines
23752,2/1/2021,VEN,Johor,0,0,0,Venezuela
23753,2/1/2021,VEN,Kedah,0,0,0,Venezuela
23754,2/1/2021,VEN,Kelantan,0,0,0,Venezuela
23755,2/1/2021,VEN,Melaka,0,0,0,Venezuela
23756,2/1/2021,VEN,Perak,0,0,0,Venezuela
23757,2/1/2021,VEN,Perlis,0,0,0,Venezuela
23758,2/1/2021,VEN,Pulau Pinang,0,0,0,Venezuela
23759,2/1/2021,VEN,Sabah,0,0,0,Venezuela
23760,2/1/2021,VEN,Sarawak,0,0,0,Venezuela
23761,2/1/2021,VEN,Selangor,1,1,0,Venezuela
23762,2/1/2021,VEN,W.P. Labuan,0,0,0,Venezuela
23763,2/1/2021,VNM,Johor,1,0,1,Vietnam
23764,2/1/2021,VNM,Kedah,0,0,0,Vietnam
23765,2/1/2021,VNM,Kelantan,0,0,0,Vietnam
23766,2/1/2021,VNM,Melaka,0,0,0,Vietnam
23767,2/1/2021,VNM,Negeri Sembilan,0,0,0,Vietnam
23768,2/1/2021,VNM,Pahang,0,0,0,Vietnam
23769,2/1/2021,VNM,Perak,0,0,0,Vietnam
23770,2/1/2021,VNM,Perlis,0,0,0,Vietnam
23771,2/1/2021,VNM,Pulau Pinang,0,0,0,Vietnam
23772,2/1/2021,VNM,Sabah,0,0,0,Vietnam
23773,2/1/2021,VNM,Sarawak,0,0,0,Vietnam
23774,2/1/2021,VNM,Selangor,75,19,56,Vietnam
23775,2/1/2021,VNM,Terengganu,5,5,0,Vietnam
23776,2/1/2021,VNM,W.P. Labuan,0,0,0,Vietnam
23777,2/1/2021,VUT,Johor,0,0,0,Vanuatu
23778,2/1/2021,VUT,Kedah,0,0,0,Vanuatu
23779,2/1/2021,VUT,Pulau Pinang,0,0,0,Vanuatu
23780,2/1/2021,VUT,Sabah,0,0,0,Vanuatu
23781,2/1/2021,VUT,Sarawak,0,0,0,Vanuatu
23782,2/1/2021,VUT,Selangor,1,1,0,Vanuatu
23783,2/1/2021,WSM,Johor,0,0,0,Samoa
23784,2/1/2021,WSM,Sarawak,0,0,0,Samoa
23785,2/1/2021,WSM,Selangor,0,0,0,Samoa
23786,2/1/2021,YEM,Johor,0,0,0,Yemen
23787,2/1/2021,YEM,Kedah,0,0,0,Yemen
23788,2/1/2021,YEM,Kelantan,0,0,0,Yemen
23789,2/1/2021,YEM,Melaka,0,0,0,Yemen
23790,2/1/2021,YEM,Pahang,0,0,0,Yemen
23791,2/1/2021,YEM,Perak,0,0,0,Yemen
23792,2/1/2021,YEM,Perlis,0,0,0,Yemen
23793,2/1/2021,YEM,Pulau Pinang,0,0,0,Yemen
23794,2/1/2021,YEM,Sabah,0,0,0,Yemen
23795,2/1/2021,YEM,Sarawak,0,0,0,Yemen
23796,2/1/2021,YEM,Selangor,48,39,9,Yemen
23797,2/1/2021,YEM,W.P. Labuan,0,0,0,Yemen
23798,2/1/2021,ZAF,Johor,5,5,0,South Africa
23799,2/1/2021,ZAF,Kedah,0,0,0,South Africa
23800,2/1/2021,ZAF,Kelantan,0,0,0,South Africa
23801,2/1/2021,ZAF,Melaka,0,0,0,South Africa
23802,2/1/2021,ZAF,Pahang,0,0,0,South Africa
23803,2/1/2021,ZAF,Perak,0,0,0,South Africa
23804,2/1/2021,ZAF,Perlis,0,0,0,South Africa
23805,2/1/2021,ZAF,Pulau Pinang,0,0,0,South Africa
23806,2/1/2021,ZAF,Sabah,0,0,0,South Africa
23807,2/1/2021,ZAF,Sarawak,0,0,0,South Africa
23808,2/1/2021,ZAF,Selangor,50,47,3,South Africa
23809,2/1/2021,ZAF,Terengganu,0,0,0,South Africa
23810,2/1/2021,ZAF,W.P. Labuan,0,0,0,South Africa
23811,2/1/2021,ZMB,Johor,0,0,0,Zambia
23812,2/1/2021,ZMB,Kedah,0,0,0,Zambia
23813,2/1/2021,ZMB,Perak,0,0,0,Zambia
23814,2/1/2021,ZMB,Perlis,0,0,0,Zambia
23815,2/1/2021,ZMB,Pulau Pinang,0,0,0,Zambia
23816,2/1/2021,ZMB,Sabah,0,0,0,Zambia
23817,2/1/2021,ZMB,Sarawak,0,0,0,Zambia
23818,2/1/2021,ZMB,Selangor,9,5,4,Zambia
23819,2/1/2021,ZWE,Johor,0,0,0,Zimbabwe
23820,2/1/2021,ZWE,Kedah,0,0,0,Zimbabwe
23821,2/1/2021,ZWE,Kelantan,0,0,0,Zimbabwe
23822,2/1/2021,ZWE,Perak,0,0,0,Zimbabwe
23823,2/1/2021,ZWE,Perlis,0,0,0,Zimbabwe
23824,2/1/2021,ZWE,Pulau Pinang,0,0,0,Zimbabwe
23825,2/1/2021,ZWE,Sabah,0,0,0,Zimbabwe
23826,2/1/2021,ZWE,Sarawak,0,0,0,Zimbabwe
23827,2/1/2021,ZWE,Selangor,1,1,0,Zimbabwe
23828,3/1/2021,ABW,Kedah,0,0,0,Aruba
23829,3/1/2021,ABW,Pulau Pinang,0,0,0,Aruba
23830,3/1/2021,AFG,Johor,0,0,0,Afghanistan
23831,3/1/2021,AFG,Kedah,0,0,0,Afghanistan
23832,3/1/2021,AFG,Perlis,0,0,0,Afghanistan
23833,3/1/2021,AFG,Pulau Pinang,0,0,0,Afghanistan
23834,3/1/2021,AFG,Sarawak,0,0,0,Afghanistan
23835,3/1/2021,AFG,Selangor,36,29,7,Afghanistan
23836,3/1/2021,AGO,Johor,0,0,0,Angola
23837,3/1/2021,AGO,Kedah,0,0,0,Angola
23838,3/1/2021,AGO,Sabah,0,0,0,Angola
23839,3/1/2021,AGO,Selangor,0,0,0,Angola
23840,3/1/2021,AIA,Selangor,0,0,0,Anguilla
23841,3/1/2021,ALB,Johor,0,0,0,Albania
23842,3/1/2021,ALB,Kedah,0,0,0,Albania
23843,3/1/2021,ALB,Perak,0,0,0,Albania
23844,3/1/2021,ALB,Perlis,0,0,0,Albania
23845,3/1/2021,ALB,Pulau Pinang,0,0,0,Albania
23846,3/1/2021,ALB,Sabah,0,0,0,Albania
23847,3/1/2021,ALB,Sarawak,0,0,0,Albania
23848,3/1/2021,ALB,Selangor,0,0,0,Albania
23849,3/1/2021,AND,Johor,0,0,0,Andorra
23850,3/1/2021,AND,Kedah,0,0,0,Andorra
23851,3/1/2021,AND,Perlis,0,0,0,Andorra
23852,3/1/2021,AND,Pulau Pinang,0,0,0,Andorra
23853,3/1/2021,AND,Selangor,0,0,0,Andorra
23854,3/1/2021,ANT,Selangor,0,0,0,Netherlands Antilles
23855,3/1/2021,ARE,Johor,0,0,0,United Arab Emirates
23856,3/1/2021,ARE,Kedah,0,0,0,United Arab Emirates
23857,3/1/2021,ARE,Kelantan,0,0,0,United Arab Emirates
23858,3/1/2021,ARE,Perak,0,0,0,United Arab Emirates
23859,3/1/2021,ARE,Perlis,0,0,0,United Arab Emirates
23860,3/1/2021,ARE,Pulau Pinang,0,0,0,United Arab Emirates
23861,3/1/2021,ARE,Sabah,0,0,0,United Arab Emirates
23862,3/1/2021,ARE,Sarawak,0,0,0,United Arab Emirates
23863,3/1/2021,ARE,Selangor,4,4,0,United Arab Emirates
23864,3/1/2021,ARG,Johor,0,0,0,Argentina
23865,3/1/2021,ARG,Kedah,0,0,0,Argentina
23866,3/1/2021,ARG,Kelantan,0,0,0,Argentina
23867,3/1/2021,ARG,Melaka,0,0,0,Argentina
23868,3/1/2021,ARG,Perak,0,0,0,Argentina
23869,3/1/2021,ARG,Perlis,0,0,0,Argentina
23870,3/1/2021,ARG,Pulau Pinang,0,0,0,Argentina
23871,3/1/2021,ARG,Sabah,0,0,0,Argentina
23872,3/1/2021,ARG,Sarawak,0,0,0,Argentina
23873,3/1/2021,ARG,Selangor,8,6,2,Argentina
23874,3/1/2021,ARG,W.P. Labuan,0,0,0,Argentina
23875,3/1/2021,ARM,Johor,0,0,0,Armenia
23876,3/1/2021,ARM,Kedah,0,0,0,Armenia
23877,3/1/2021,ARM,Kelantan,0,0,0,Armenia
23878,3/1/2021,ARM,Perak,0,0,0,Armenia
23879,3/1/2021,ARM,Perlis,0,0,0,Armenia
23880,3/1/2021,ARM,Pulau Pinang,0,0,0,Armenia
23881,3/1/2021,ARM,Sabah,0,0,0,Armenia
23882,3/1/2021,ARM,Sarawak,0,0,0,Armenia
23883,3/1/2021,ARM,Selangor,1,0,1,Armenia
23884,3/1/2021,ATA,Selangor,0,0,0,Antarctica
23885,3/1/2021,ATG,Johor,0,0,0,Antigua and Barbuda
23886,3/1/2021,ATG,Kedah,0,0,0,Antigua and Barbuda
23887,3/1/2021,ATG,Pulau Pinang,0,0,0,Antigua and Barbuda
23888,3/1/2021,ATG,Sarawak,0,0,0,Antigua and Barbuda
23889,3/1/2021,ATG,Selangor,0,0,0,Antigua and Barbuda
23890,3/1/2021,AUS,Johor,2,1,1,Australia
23891,3/1/2021,AUS,Kedah,0,0,0,Australia
23892,3/1/2021,AUS,Kelantan,0,0,0,Australia
23893,3/1/2021,AUS,Melaka,0,0,0,Australia
23894,3/1/2021,AUS,Negeri Sembilan,0,0,0,Australia
23895,3/1/2021,AUS,Pahang,0,0,0,Australia
23896,3/1/2021,AUS,Perak,0,0,0,Australia
23897,3/1/2021,AUS,Perlis,0,0,0,Australia
23898,3/1/2021,AUS,Pulau Pinang,4,3,1,Australia
23899,3/1/2021,AUS,Sabah,2,2,0,Australia
23900,3/1/2021,AUS,Sarawak,0,0,0,Australia
23901,3/1/2021,AUS,Selangor,86,69,17,Australia
23902,3/1/2021,AUS,Terengganu,0,0,0,Australia
23903,3/1/2021,AUS,W.P. Labuan,0,0,0,Australia
23904,3/1/2021,AUT,Johor,0,0,0,Austria
23905,3/1/2021,AUT,Kedah,0,0,0,Austria
23906,3/1/2021,AUT,Kelantan,0,0,0,Austria
23907,3/1/2021,AUT,Melaka,0,0,0,Austria
23908,3/1/2021,AUT,Negeri Sembilan,0,0,0,Austria
23909,3/1/2021,AUT,Pahang,0,0,0,Austria
23910,3/1/2021,AUT,Perak,0,0,0,Austria
23911,3/1/2021,AUT,Perlis,0,0,0,Austria
23912,3/1/2021,AUT,Pulau Pinang,0,0,0,Austria
23913,3/1/2021,AUT,Sabah,0,0,0,Austria
23914,3/1/2021,AUT,Sarawak,0,0,0,Austria
23915,3/1/2021,AUT,Selangor,7,7,0,Austria
23916,3/1/2021,AUT,Terengganu,0,0,0,Austria
23917,3/1/2021,AUT,W.P. Labuan,0,0,0,Austria
23918,3/1/2021,AZE,Johor,0,0,0,Azerbaijan
23919,3/1/2021,AZE,Kedah,0,0,0,Azerbaijan
23920,3/1/2021,AZE,Kelantan,0,0,0,Azerbaijan
23921,3/1/2021,AZE,Melaka,0,0,0,Azerbaijan
23922,3/1/2021,AZE,Perlis,0,0,0,Azerbaijan
23923,3/1/2021,AZE,Pulau Pinang,0,0,0,Azerbaijan
23924,3/1/2021,AZE,Sabah,0,0,0,Azerbaijan
23925,3/1/2021,AZE,Sarawak,0,0,0,Azerbaijan
23926,3/1/2021,AZE,Selangor,4,2,2,Azerbaijan
23927,3/1/2021,AZE,W.P. Labuan,0,0,0,Azerbaijan
23928,3/1/2021,BDI,Pulau Pinang,0,0,0,Burundi
23929,3/1/2021,BDI,Sarawak,0,0,0,Burundi
23930,3/1/2021,BDI,Selangor,1,1,0,Burundi
23931,3/1/2021,BEL,Johor,0,0,0,Belgium
23932,3/1/2021,BEL,Kedah,0,0,0,Belgium
23933,3/1/2021,BEL,Kelantan,0,0,0,Belgium
23934,3/1/2021,BEL,Melaka,0,0,0,Belgium
23935,3/1/2021,BEL,Negeri Sembilan,0,0,0,Belgium
23936,3/1/2021,BEL,Pahang,0,0,0,Belgium
23937,3/1/2021,BEL,Perak,0,0,0,Belgium
23938,3/1/2021,BEL,Perlis,0,0,0,Belgium
23939,3/1/2021,BEL,Pulau Pinang,0,0,0,Belgium
23940,3/1/2021,BEL,Sabah,0,0,0,Belgium
23941,3/1/2021,BEL,Sarawak,0,0,0,Belgium
23942,3/1/2021,BEL,Selangor,22,20,2,Belgium
23943,3/1/2021,BEL,W.P. Labuan,0,0,0,Belgium
23944,3/1/2021,BEN,Johor,0,0,0,Benin
23945,3/1/2021,BEN,Kedah,0,0,0,Benin
23946,3/1/2021,BEN,Perak,0,0,0,Benin
23947,3/1/2021,BEN,Pulau Pinang,0,0,0,Benin
23948,3/1/2021,BEN,Sabah,0,0,0,Benin
23949,3/1/2021,BEN,Sarawak,0,0,0,Benin
23950,3/1/2021,BEN,Selangor,0,0,0,Benin
23951,3/1/2021,BFA,Perak,0,0,0,Burkina Faso
23952,3/1/2021,BFA,Pulau Pinang,0,0,0,Burkina Faso
23953,3/1/2021,BFA,Selangor,0,0,0,Burkina Faso
23954,3/1/2021,BGD,Johor,10,10,0,Bangladesh
23955,3/1/2021,BGD,Kedah,0,0,0,Bangladesh
23956,3/1/2021,BGD,Kelantan,0,0,0,Bangladesh
23957,3/1/2021,BGD,Melaka,0,0,0,Bangladesh
23958,3/1/2021,BGD,Negeri Sembilan,0,0,0,Bangladesh
23959,3/1/2021,BGD,Pahang,0,0,0,Bangladesh
23960,3/1/2021,BGD,Perak,0,0,0,Bangladesh
23961,3/1/2021,BGD,Perlis,0,0,0,Bangladesh
23962,3/1/2021,BGD,Pulau Pinang,1,1,0,Bangladesh
23963,3/1/2021,BGD,Sabah,0,0,0,Bangladesh
23964,3/1/2021,BGD,Sarawak,0,0,0,Bangladesh
23965,3/1/2021,BGD,Selangor,296,205,91,Bangladesh
23966,3/1/2021,BGD,W.P. Labuan,0,0,0,Bangladesh
23967,3/1/2021,BGR,Johor,0,0,0,Bulgaria
23968,3/1/2021,BGR,Kedah,0,0,0,Bulgaria
23969,3/1/2021,BGR,Kelantan,0,0,0,Bulgaria
23970,3/1/2021,BGR,Pahang,0,0,0,Bulgaria
23971,3/1/2021,BGR,Perak,0,0,0,Bulgaria
23972,3/1/2021,BGR,Perlis,0,0,0,Bulgaria
23973,3/1/2021,BGR,Pulau Pinang,0,0,0,Bulgaria
23974,3/1/2021,BGR,Sabah,0,0,0,Bulgaria
23975,3/1/2021,BGR,Sarawak,0,0,0,Bulgaria
23976,3/1/2021,BGR,Selangor,13,12,1,Bulgaria
23977,3/1/2021,BGR,W.P. Labuan,0,0,0,Bulgaria
23978,3/1/2021,BHR,Johor,0,0,0,Bahrain
23979,3/1/2021,BHR,Kedah,0,0,0,Bahrain
23980,3/1/2021,BHR,Kelantan,0,0,0,Bahrain
23981,3/1/2021,BHR,Perlis,0,0,0,Bahrain
23982,3/1/2021,BHR,Pulau Pinang,0,0,0,Bahrain
23983,3/1/2021,BHR,Sabah,0,0,0,Bahrain
23984,3/1/2021,BHR,Sarawak,0,0,0,Bahrain
23985,3/1/2021,BHR,Selangor,5,2,3,Bahrain
23986,3/1/2021,BHS,Johor,0,0,0,Bahamas
23987,3/1/2021,BHS,Kedah,0,0,0,Bahamas
23988,3/1/2021,BHS,Perak,0,0,0,Bahamas
23989,3/1/2021,BHS,Sabah,0,0,0,Bahamas
23990,3/1/2021,BHS,Sarawak,0,0,0,Bahamas
23991,3/1/2021,BHS,Selangor,0,0,0,Bahamas
23992,3/1/2021,BIH,Johor,0,0,0,Bosnia and Herzegovina
23993,3/1/2021,BIH,Kedah,0,0,0,Bosnia and Herzegovina
23994,3/1/2021,BIH,Perlis,0,0,0,Bosnia and Herzegovina
23995,3/1/2021,BIH,Pulau Pinang,0,0,0,Bosnia and Herzegovina
23996,3/1/2021,BIH,Sabah,0,0,0,Bosnia and Herzegovina
23997,3/1/2021,BIH,Sarawak,0,0,0,Bosnia and Herzegovina
23998,3/1/2021,BIH,Selangor,2,0,2,Bosnia and Herzegovina
23999,3/1/2021,BLR,Johor,0,0,0,Belarus
24000,3/1/2021,BLR,Kedah,0,0,0,Belarus
24001,3/1/2021,BLR,Kelantan,0,0,0,Belarus
24002,3/1/2021,BLR,Pahang,0,0,0,Belarus
24003,3/1/2021,BLR,Perak,0,0,0,Belarus
24004,3/1/2021,BLR,Perlis,0,0,0,Belarus
24005,3/1/2021,BLR,Pulau Pinang,0,0,0,Belarus
24006,3/1/2021,BLR,Sabah,0,0,0,Belarus
24007,3/1/2021,BLR,Sarawak,0,0,0,Belarus
24008,3/1/2021,BLR,Selangor,0,0,0,Belarus
24009,3/1/2021,BLR,W.P. Labuan,0,0,0,Belarus
24010,3/1/2021,BLZ,Johor,0,0,0,Belize
24011,3/1/2021,BLZ,Pulau Pinang,0,0,0,Belize
24012,3/1/2021,BLZ,Sarawak,0,0,0,Belize
24013,3/1/2021,BLZ,Selangor,0,0,0,Belize
24014,3/1/2021,BMU,Selangor,0,0,0,Bermuda
24015,3/1/2021,BOL,Johor,0,0,0,Bolivia
24016,3/1/2021,BOL,Kedah,0,0,0,Bolivia
24017,3/1/2021,BOL,Melaka,0,0,0,Bolivia
24018,3/1/2021,BOL,Perak,0,0,0,Bolivia
24019,3/1/2021,BOL,Perlis,0,0,0,Bolivia
24020,3/1/2021,BOL,Pulau Pinang,0,0,0,Bolivia
24021,3/1/2021,BOL,Sabah,0,0,0,Bolivia
24022,3/1/2021,BOL,Sarawak,0,0,0,Bolivia
24023,3/1/2021,BOL,Selangor,0,0,0,Bolivia
24024,3/1/2021,BRA,Johor,0,0,0,Brazil
24025,3/1/2021,BRA,Kedah,0,0,0,Brazil
24026,3/1/2021,BRA,Kelantan,0,0,0,Brazil
24027,3/1/2021,BRA,Melaka,0,0,0,Brazil
24028,3/1/2021,BRA,Pahang,0,0,0,Brazil
24029,3/1/2021,BRA,Perak,0,0,0,Brazil
24030,3/1/2021,BRA,Perlis,0,0,0,Brazil
24031,3/1/2021,BRA,Pulau Pinang,0,0,0,Brazil
24032,3/1/2021,BRA,Sabah,0,0,0,Brazil
24033,3/1/2021,BRA,Sarawak,0,0,0,Brazil
24034,3/1/2021,BRA,Selangor,18,12,6,Brazil
24035,3/1/2021,BRA,W.P. Labuan,0,0,0,Brazil
24036,3/1/2021,BRB,Johor,0,0,0,Barbados
24037,3/1/2021,BRB,Kedah,0,0,0,Barbados
24038,3/1/2021,BRB,Perlis,0,0,0,Barbados
24039,3/1/2021,BRB,Pulau Pinang,0,0,0,Barbados
24040,3/1/2021,BRB,Selangor,0,0,0,Barbados
24041,3/1/2021,BRN,Johor,1,0,1,Brunei Darussalam
24042,3/1/2021,BRN,Kedah,0,0,0,Brunei Darussalam
24043,3/1/2021,BRN,Kelantan,0,0,0,Brunei Darussalam
24044,3/1/2021,BRN,Melaka,0,0,0,Brunei Darussalam
24045,3/1/2021,BRN,Pahang,0,0,0,Brunei Darussalam
24046,3/1/2021,BRN,Perak,0,0,0,Brunei Darussalam
24047,3/1/2021,BRN,Perlis,0,0,0,Brunei Darussalam
24048,3/1/2021,BRN,Pulau Pinang,0,0,0,Brunei Darussalam
24049,3/1/2021,BRN,Sabah,0,0,0,Brunei Darussalam
24050,3/1/2021,BRN,Sarawak,422,406,16,Brunei Darussalam
24051,3/1/2021,BRN,Selangor,27,10,17,Brunei Darussalam
24052,3/1/2021,BRN,W.P. Labuan,1,0,1,Brunei Darussalam
24053,3/1/2021,BTN,Johor,0,0,0,Bhutan
24054,3/1/2021,BTN,Kedah,0,0,0,Bhutan
24055,3/1/2021,BTN,Perak,0,0,0,Bhutan
24056,3/1/2021,BTN,Perlis,0,0,0,Bhutan
24057,3/1/2021,BTN,Pulau Pinang,0,0,0,Bhutan
24058,3/1/2021,BTN,Sabah,0,0,0,Bhutan
24059,3/1/2021,BTN,Sarawak,0,0,0,Bhutan
24060,3/1/2021,BTN,Selangor,2,2,0,Bhutan
24061,3/1/2021,BWA,Johor,0,0,0,Botswana
24062,3/1/2021,BWA,Kedah,0,0,0,Botswana
24063,3/1/2021,BWA,Perlis,0,0,0,Botswana
24064,3/1/2021,BWA,Pulau Pinang,0,0,0,Botswana
24065,3/1/2021,BWA,Sabah,0,0,0,Botswana
24066,3/1/2021,BWA,Sarawak,0,0,0,Botswana
24067,3/1/2021,BWA,Selangor,0,0,0,Botswana
24068,3/1/2021,CAF,Kedah,0,0,0,Central African Republic
24069,3/1/2021,CAF,Selangor,0,0,0,Central African Republic
24070,3/1/2021,CAN,Johor,0,0,0,Canada
24071,3/1/2021,CAN,Kedah,0,0,0,Canada
24072,3/1/2021,CAN,Kelantan,0,0,0,Canada
24073,3/1/2021,CAN,Melaka,0,0,0,Canada
24074,3/1/2021,CAN,Negeri Sembilan,0,0,0,Canada
24075,3/1/2021,CAN,Pahang,0,0,0,Canada
24076,3/1/2021,CAN,Perak,0,0,0,Canada
24077,3/1/2021,CAN,Perlis,0,0,0,Canada
24078,3/1/2021,CAN,Pulau Pinang,1,0,1,Canada
24079,3/1/2021,CAN,Sabah,0,0,0,Canada
24080,3/1/2021,CAN,Sarawak,0,0,0,Canada
24081,3/1/2021,CAN,Selangor,36,27,9,Canada
24082,3/1/2021,CAN,Terengganu,0,0,0,Canada
24083,3/1/2021,CAN,W.P. Labuan,0,0,0,Canada
24084,3/1/2021,CCK,Selangor,0,0,0,Cocos (Keeling) Islands
24085,3/1/2021,CHE,Johor,0,0,0,Switzerland
24086,3/1/2021,CHE,Kedah,0,0,0,Switzerland
24087,3/1/2021,CHE,Kelantan,0,0,0,Switzerland
24088,3/1/2021,CHE,Melaka,0,0,0,Switzerland
24089,3/1/2021,CHE,Negeri Sembilan,0,0,0,Switzerland
24090,3/1/2021,CHE,Pahang,0,0,0,Switzerland
24091,3/1/2021,CHE,Perak,0,0,0,Switzerland
24092,3/1/2021,CHE,Perlis,0,0,0,Switzerland
24093,3/1/2021,CHE,Pulau Pinang,3,1,2,Switzerland
24094,3/1/2021,CHE,Sabah,0,0,0,Switzerland
24095,3/1/2021,CHE,Sarawak,0,0,0,Switzerland
24096,3/1/2021,CHE,Selangor,17,10,7,Switzerland
24097,3/1/2021,CHE,W.P. Labuan,0,0,0,Switzerland
24098,3/1/2021,CHL,Johor,0,0,0,Chile
24099,3/1/2021,CHL,Kedah,0,0,0,Chile
24100,3/1/2021,CHL,Kelantan,0,0,0,Chile
24101,3/1/2021,CHL,Melaka,0,0,0,Chile
24102,3/1/2021,CHL,Pahang,0,0,0,Chile
24103,3/1/2021,CHL,Perak,0,0,0,Chile
24104,3/1/2021,CHL,Perlis,0,0,0,Chile
24105,3/1/2021,CHL,Pulau Pinang,0,0,0,Chile
24106,3/1/2021,CHL,Sabah,0,0,0,Chile
24107,3/1/2021,CHL,Sarawak,0,0,0,Chile
24108,3/1/2021,CHL,Selangor,0,0,0,Chile
24109,3/1/2021,CHN,Johor,12,10,2,China
24110,3/1/2021,CHN,Kedah,4,1,3,China
24111,3/1/2021,CHN,Kelantan,0,0,0,China
24112,3/1/2021,CHN,Melaka,0,0,0,China
24113,3/1/2021,CHN,Pahang,0,0,0,China
24114,3/1/2021,CHN,Perak,0,0,0,China
24115,3/1/2021,CHN,Perlis,0,0,0,China
24116,3/1/2021,CHN,Pulau Pinang,14,6,8,China
24117,3/1/2021,CHN,Sabah,8,8,0,China
24118,3/1/2021,CHN,Sarawak,84,77,7,China
24119,3/1/2021,CHN,Selangor,1765,1479,286,China
24120,3/1/2021,CHN,Terengganu,0,0,0,China
24121,3/1/2021,CHN,W.P. Labuan,0,0,0,China
24122,3/1/2021,CIV,Johor,0,0,0,C��te d'Iv
24123,3/1/2021,CIV,Kedah,0,0,0,C��te d'Iv
24124,3/1/2021,CIV,Pulau Pinang,0,0,0,C��te d'Iv
24125,3/1/2021,CIV,Sabah,0,0,0,C��te d'Iv
24126,3/1/2021,CIV,Sarawak,0,0,0,C��te d'Iv
24127,3/1/2021,CIV,Selangor,2,1,1,C��te d'Iv
24128,3/1/2021,CMR,Johor,0,0,0,Cameroon
24129,3/1/2021,CMR,Kedah,0,0,0,Cameroon
24130,3/1/2021,CMR,Pulau Pinang,0,0,0,Cameroon
24131,3/1/2021,CMR,Sabah,0,0,0,Cameroon
24132,3/1/2021,CMR,Sarawak,0,0,0,Cameroon
24133,3/1/2021,CMR,Selangor,3,3,0,Cameroon
24134,3/1/2021,COD,Johor,0,0,0,"Congo, the Democratic Republic of the"
24135,3/1/2021,COD,Pulau Pinang,0,0,0,"Congo, the Democratic Republic of the"
24136,3/1/2021,COD,Sarawak,0,0,0,"Congo, the Democratic Republic of the"
24137,3/1/2021,COD,Selangor,1,1,0,"Congo, the Democratic Republic of the"
24138,3/1/2021,COG,Johor,0,0,0,Congo
24139,3/1/2021,COG,Kedah,0,0,0,Congo
24140,3/1/2021,COG,Selangor,0,0,0,Congo
24141,3/1/2021,COK,Selangor,0,0,0,Cook Islands
24142,3/1/2021,COL,Johor,0,0,0,Colombia
24143,3/1/2021,COL,Kedah,0,0,0,Colombia
24144,3/1/2021,COL,Perak,0,0,0,Colombia
24145,3/1/2021,COL,Pulau Pinang,0,0,0,Colombia
24146,3/1/2021,COL,Sabah,0,0,0,Colombia
24147,3/1/2021,COL,Sarawak,0,0,0,Colombia
24148,3/1/2021,COL,Selangor,10,3,7,Colombia
24149,3/1/2021,COL,W.P. Labuan,0,0,0,Colombia
24150,3/1/2021,COM,Johor,0,0,0,Comoros
24151,3/1/2021,COM,Kedah,0,0,0,Comoros
24152,3/1/2021,COM,Selangor,4,3,1,Comoros
24153,3/1/2021,CPV,Johor,0,0,0,Cape Verde
24154,3/1/2021,CPV,Kedah,0,0,0,Cape Verde
24155,3/1/2021,CPV,Pulau Pinang,0,0,0,Cape Verde
24156,3/1/2021,CPV,Sabah,0,0,0,Cape Verde
24157,3/1/2021,CPV,Selangor,0,0,0,Cape Verde
24158,3/1/2021,CRI,Johor,0,0,0,Costa Rica
24159,3/1/2021,CRI,Kedah,0,0,0,Costa Rica
24160,3/1/2021,CRI,Perak,0,0,0,Costa Rica
24161,3/1/2021,CRI,Perlis,0,0,0,Costa Rica
24162,3/1/2021,CRI,Pulau Pinang,0,0,0,Costa Rica
24163,3/1/2021,CRI,Sabah,0,0,0,Costa Rica
24164,3/1/2021,CRI,Sarawak,0,0,0,Costa Rica
24165,3/1/2021,CRI,Selangor,4,2,2,Costa Rica
24166,3/1/2021,CUB,Johor,0,0,0,Cuba
24167,3/1/2021,CUB,Kedah,0,0,0,Cuba
24168,3/1/2021,CUB,Perlis,0,0,0,Cuba
24169,3/1/2021,CUB,Pulau Pinang,0,0,0,Cuba
24170,3/1/2021,CUB,Sabah,0,0,0,Cuba
24171,3/1/2021,CUB,Sarawak,0,0,0,Cuba
24172,3/1/2021,CUB,Selangor,2,1,1,Cuba
24173,3/1/2021,CYP,Johor,0,0,0,Cyprus
24174,3/1/2021,CYP,Kedah,0,0,0,Cyprus
24175,3/1/2021,CYP,Perak,0,0,0,Cyprus
24176,3/1/2021,CYP,Perlis,0,0,0,Cyprus
24177,3/1/2021,CYP,Pulau Pinang,0,0,0,Cyprus
24178,3/1/2021,CYP,Sabah,0,0,0,Cyprus
24179,3/1/2021,CYP,Sarawak,0,0,0,Cyprus
24180,3/1/2021,CYP,Selangor,1,1,0,Cyprus
24181,3/1/2021,CZE,Johor,0,0,0,Czech Republic
24182,3/1/2021,CZE,Kedah,0,0,0,Czech Republic
24183,3/1/2021,CZE,Kelantan,0,0,0,Czech Republic
24184,3/1/2021,CZE,Melaka,0,0,0,Czech Republic
24185,3/1/2021,CZE,Negeri Sembilan,0,0,0,Czech Republic
24186,3/1/2021,CZE,Perak,0,0,0,Czech Republic
24187,3/1/2021,CZE,Perlis,0,0,0,Czech Republic
24188,3/1/2021,CZE,Pulau Pinang,0,0,0,Czech Republic
24189,3/1/2021,CZE,Sabah,0,0,0,Czech Republic
24190,3/1/2021,CZE,Sarawak,0,0,0,Czech Republic
24191,3/1/2021,CZE,Selangor,7,4,3,Czech Republic
24192,3/1/2021,CZE,W.P. Labuan,0,0,0,Czech Republic
24193,3/1/2021,DEU,Johor,0,0,0,Germany
24194,3/1/2021,DEU,Kedah,0,0,0,Germany
24195,3/1/2021,DEU,Kelantan,0,0,0,Germany
24196,3/1/2021,DEU,Melaka,0,0,0,Germany
24197,3/1/2021,DEU,Negeri Sembilan,0,0,0,Germany
24198,3/1/2021,DEU,Pahang,0,0,0,Germany
24199,3/1/2021,DEU,Perak,0,0,0,Germany
24200,3/1/2021,DEU,Perlis,0,0,0,Germany
24201,3/1/2021,DEU,Pulau Pinang,1,1,0,Germany
24202,3/1/2021,DEU,Sabah,0,0,0,Germany
24203,3/1/2021,DEU,Sarawak,0,0,0,Germany
24204,3/1/2021,DEU,Selangor,93,87,6,Germany
24205,3/1/2021,DEU,Terengganu,0,0,0,Germany
24206,3/1/2021,DEU,W.P. Labuan,0,0,0,Germany
24207,3/1/2021,DJI,Johor,0,0,0,Djibouti
24208,3/1/2021,DJI,Selangor,10,0,10,Djibouti
24209,3/1/2021,DMA,Johor,0,0,0,Dominica
24210,3/1/2021,DMA,Kedah,0,0,0,Dominica
24211,3/1/2021,DMA,Pulau Pinang,0,0,0,Dominica
24212,3/1/2021,DMA,Sabah,0,0,0,Dominica
24213,3/1/2021,DMA,Sarawak,0,0,0,Dominica
24214,3/1/2021,DMA,Selangor,1,1,0,Dominica
24215,3/1/2021,DMA,W.P. Labuan,0,0,0,Dominica
24216,3/1/2021,DNK,Johor,3,3,0,Denmark
24217,3/1/2021,DNK,Kedah,0,0,0,Denmark
24218,3/1/2021,DNK,Kelantan,0,0,0,Denmark
24219,3/1/2021,DNK,Melaka,0,0,0,Denmark
24220,3/1/2021,DNK,Negeri Sembilan,0,0,0,Denmark
24221,3/1/2021,DNK,Pahang,0,0,0,Denmark
24222,3/1/2021,DNK,Perak,0,0,0,Denmark
24223,3/1/2021,DNK,Perlis,0,0,0,Denmark
24224,3/1/2021,DNK,Pulau Pinang,0,0,0,Denmark
24225,3/1/2021,DNK,Sabah,0,0,0,Denmark
24226,3/1/2021,DNK,Sarawak,0,0,0,Denmark
24227,3/1/2021,DNK,Selangor,18,15,3,Denmark
24228,3/1/2021,DNK,W.P. Labuan,0,0,0,Denmark
24229,3/1/2021,DOM,Johor,0,0,0,Dominican Republic
24230,3/1/2021,DOM,Kedah,0,0,0,Dominican Republic
24231,3/1/2021,DOM,Perak,0,0,0,Dominican Republic
24232,3/1/2021,DOM,Perlis,0,0,0,Dominican Republic
24233,3/1/2021,DOM,Pulau Pinang,0,0,0,Dominican Republic
24234,3/1/2021,DOM,Sabah,0,0,0,Dominican Republic
24235,3/1/2021,DOM,Sarawak,0,0,0,Dominican Republic
24236,3/1/2021,DOM,Selangor,0,0,0,Dominican Republic
24237,3/1/2021,DZA,Johor,0,0,0,Algeria
24238,3/1/2021,DZA,Kedah,0,0,0,Algeria
24239,3/1/2021,DZA,Kelantan,0,0,0,Algeria
24240,3/1/2021,DZA,Melaka,0,0,0,Algeria
24241,3/1/2021,DZA,Perak,0,0,0,Algeria
24242,3/1/2021,DZA,Perlis,0,0,0,Algeria
24243,3/1/2021,DZA,Pulau Pinang,0,0,0,Algeria
24244,3/1/2021,DZA,Sabah,0,0,0,Algeria
24245,3/1/2021,DZA,Sarawak,0,0,0,Algeria
24246,3/1/2021,DZA,Selangor,4,2,2,Algeria
24247,3/1/2021,DZA,W.P. Labuan,0,0,0,Algeria
24248,3/1/2021,ECU,Johor,0,0,0,Ecuador
24249,3/1/2021,ECU,Kedah,0,0,0,Ecuador
24250,3/1/2021,ECU,Perak,0,0,0,Ecuador
24251,3/1/2021,ECU,Perlis,0,0,0,Ecuador
24252,3/1/2021,ECU,Pulau Pinang,0,0,0,Ecuador
24253,3/1/2021,ECU,Sabah,0,0,0,Ecuador
24254,3/1/2021,ECU,Sarawak,0,0,0,Ecuador
24255,3/1/2021,ECU,Selangor,0,0,0,Ecuador
24256,3/1/2021,EGY,Johor,0,0,0,Egypt
24257,3/1/2021,EGY,Kedah,0,0,0,Egypt
24258,3/1/2021,EGY,Kelantan,0,0,0,Egypt
24259,3/1/2021,EGY,Melaka,0,0,0,Egypt
24260,3/1/2021,EGY,Pahang,0,0,0,Egypt
24261,3/1/2021,EGY,Perak,0,0,0,Egypt
24262,3/1/2021,EGY,Perlis,0,0,0,Egypt
24263,3/1/2021,EGY,Pulau Pinang,0,0,0,Egypt
24264,3/1/2021,EGY,Sabah,0,0,0,Egypt
24265,3/1/2021,EGY,Sarawak,0,0,0,Egypt
24266,3/1/2021,EGY,Selangor,114,86,28,Egypt
24267,3/1/2021,EGY,Terengganu,0,0,0,Egypt
24268,3/1/2021,EGY,W.P. Labuan,0,0,0,Egypt
24269,3/1/2021,ERI,Johor,0,0,0,Eritrea
24270,3/1/2021,ERI,Pulau Pinang,0,0,0,Eritrea
24271,3/1/2021,ERI,Sabah,0,0,0,Eritrea
24272,3/1/2021,ERI,Selangor,2,1,1,Eritrea
24273,3/1/2021,ESP,Johor,0,0,0,Spain
24274,3/1/2021,ESP,Kedah,0,0,0,Spain
24275,3/1/2021,ESP,Kelantan,0,0,0,Spain
24276,3/1/2021,ESP,Melaka,0,0,0,Spain
24277,3/1/2021,ESP,Negeri Sembilan,0,0,0,Spain
24278,3/1/2021,ESP,Pahang,0,0,0,Spain
24279,3/1/2021,ESP,Perak,0,0,0,Spain
24280,3/1/2021,ESP,Perlis,0,0,0,Spain
24281,3/1/2021,ESP,Pulau Pinang,0,0,0,Spain
24282,3/1/2021,ESP,Sabah,1,1,0,Spain
24283,3/1/2021,ESP,Sarawak,0,0,0,Spain
24284,3/1/2021,ESP,Selangor,26,17,9,Spain
24285,3/1/2021,ESP,W.P. Labuan,0,0,0,Spain
24286,3/1/2021,EST,Johor,0,0,0,Estonia
24287,3/1/2021,EST,Kedah,0,0,0,Estonia
24288,3/1/2021,EST,Kelantan,0,0,0,Estonia
24289,3/1/2021,EST,Pahang,0,0,0,Estonia
24290,3/1/2021,EST,Perak,0,0,0,Estonia
24291,3/1/2021,EST,Perlis,0,0,0,Estonia
24292,3/1/2021,EST,Pulau Pinang,0,0,0,Estonia
24293,3/1/2021,EST,Sabah,0,0,0,Estonia
24294,3/1/2021,EST,Sarawak,0,0,0,Estonia
24295,3/1/2021,EST,Selangor,2,2,0,Estonia
24296,3/1/2021,EST,W.P. Labuan,0,0,0,Estonia
24297,3/1/2021,ETH,Johor,3,3,0,Ethiopia
24298,3/1/2021,ETH,Kedah,0,0,0,Ethiopia
24299,3/1/2021,ETH,Pulau Pinang,0,0,0,Ethiopia
24300,3/1/2021,ETH,Sarawak,0,0,0,Ethiopia
24301,3/1/2021,ETH,Selangor,6,5,1,Ethiopia
24302,3/1/2021,FIN,Johor,0,0,0,Finland
24303,3/1/2021,FIN,Kedah,0,0,0,Finland
24304,3/1/2021,FIN,Kelantan,0,0,0,Finland
24305,3/1/2021,FIN,Melaka,0,0,0,Finland
24306,3/1/2021,FIN,Negeri Sembilan,0,0,0,Finland
24307,3/1/2021,FIN,Pahang,0,0,0,Finland
24308,3/1/2021,FIN,Perak,0,0,0,Finland
24309,3/1/2021,FIN,Perlis,0,0,0,Finland
24310,3/1/2021,FIN,Pulau Pinang,0,0,0,Finland
24311,3/1/2021,FIN,Sabah,0,0,0,Finland
24312,3/1/2021,FIN,Sarawak,0,0,0,Finland
24313,3/1/2021,FIN,Selangor,15,13,2,Finland
24314,3/1/2021,FIN,W.P. Labuan,0,0,0,Finland
24315,3/1/2021,FJI,Johor,0,0,0,Fiji
24316,3/1/2021,FJI,Kedah,0,0,0,Fiji
24317,3/1/2021,FJI,Kelantan,0,0,0,Fiji
24318,3/1/2021,FJI,Perak,0,0,0,Fiji
24319,3/1/2021,FJI,Perlis,0,0,0,Fiji
24320,3/1/2021,FJI,Pulau Pinang,0,0,0,Fiji
24321,3/1/2021,FJI,Sabah,0,0,0,Fiji
24322,3/1/2021,FJI,Sarawak,0,0,0,Fiji
24323,3/1/2021,FJI,Selangor,1,0,1,Fiji
24324,3/1/2021,FRA,Johor,3,3,0,France
24325,3/1/2021,FRA,Kedah,0,0,0,France
24326,3/1/2021,FRA,Kelantan,0,0,0,France
24327,3/1/2021,FRA,Melaka,0,0,0,France
24328,3/1/2021,FRA,Negeri Sembilan,0,0,0,France
24329,3/1/2021,FRA,Pahang,0,0,0,France
24330,3/1/2021,FRA,Perak,0,0,0,France
24331,3/1/2021,FRA,Perlis,0,0,0,France
24332,3/1/2021,FRA,Pulau Pinang,3,3,0,France
24333,3/1/2021,FRA,Sabah,0,0,0,France
24334,3/1/2021,FRA,Sarawak,1,1,0,France
24335,3/1/2021,FRA,Selangor,72,57,15,France
24336,3/1/2021,FRA,Terengganu,0,0,0,France
24337,3/1/2021,FRA,W.P. Labuan,0,0,0,France
24338,3/1/2021,FSM,Johor,0,0,0,"Micronesia, Federated States of"
24339,3/1/2021,FSM,Pulau Pinang,0,0,0,"Micronesia, Federated States of"
24340,3/1/2021,FSM,Selangor,0,0,0,"Micronesia, Federated States of"
24341,3/1/2021,GAB,Johor,0,0,0,Gabon
24342,3/1/2021,GAB,Pulau Pinang,0,0,0,Gabon
24343,3/1/2021,GAB,Sarawak,0,0,0,Gabon
24344,3/1/2021,GAB,Selangor,1,1,0,Gabon
24345,3/1/2021,GBR,Johor,2,2,0,United Kingdom
24346,3/1/2021,GBR,Kedah,0,0,0,United Kingdom
24347,3/1/2021,GBR,Kelantan,0,0,0,United Kingdom
24348,3/1/2021,GBR,Melaka,0,0,0,United Kingdom
24349,3/1/2021,GBR,Negeri Sembilan,0,0,0,United Kingdom
24350,3/1/2021,GBR,Pahang,0,0,0,United Kingdom
24351,3/1/2021,GBR,Perak,0,0,0,United Kingdom
24352,3/1/2021,GBR,Perlis,0,0,0,United Kingdom
24353,3/1/2021,GBR,Pulau Pinang,1,1,0,United Kingdom
24354,3/1/2021,GBR,Sabah,1,1,0,United Kingdom
24355,3/1/2021,GBR,Sarawak,1,1,0,United Kingdom
24356,3/1/2021,GBR,Selangor,233,186,47,United Kingdom
24357,3/1/2021,GBR,Terengganu,0,0,0,United Kingdom
24358,3/1/2021,GBR,W.P. Labuan,0,0,0,United Kingdom
24359,3/1/2021,GEO,Johor,2,2,0,Georgia
24360,3/1/2021,GEO,Kedah,0,0,0,Georgia
24361,3/1/2021,GEO,Melaka,0,0,0,Georgia
24362,3/1/2021,GEO,Perak,0,0,0,Georgia
24363,3/1/2021,GEO,Perlis,0,0,0,Georgia
24364,3/1/2021,GEO,Pulau Pinang,0,0,0,Georgia
24365,3/1/2021,GEO,Sabah,0,0,0,Georgia
24366,3/1/2021,GEO,Sarawak,0,0,0,Georgia
24367,3/1/2021,GEO,Selangor,3,3,0,Georgia
24368,3/1/2021,GHA,Johor,0,0,0,Ghana
24369,3/1/2021,GHA,Kedah,0,0,0,Ghana
24370,3/1/2021,GHA,Kelantan,0,0,0,Ghana
24371,3/1/2021,GHA,Pulau Pinang,0,0,0,Ghana
24372,3/1/2021,GHA,Sabah,1,1,0,Ghana
24373,3/1/2021,GHA,Sarawak,0,0,0,Ghana
24374,3/1/2021,GHA,Selangor,8,4,4,Ghana
24375,3/1/2021,GIB,Johor,0,0,0,Gibraltar
24376,3/1/2021,GIB,Sarawak,0,0,0,Gibraltar
24377,3/1/2021,GIN,Johor,0,0,0,Guinea
24378,3/1/2021,GIN,Kedah,0,0,0,Guinea
24379,3/1/2021,GIN,Kelantan,0,0,0,Guinea
24380,3/1/2021,GIN,Perlis,0,0,0,Guinea
24381,3/1/2021,GIN,Pulau Pinang,0,0,0,Guinea
24382,3/1/2021,GIN,Sabah,0,0,0,Guinea
24383,3/1/2021,GIN,Sarawak,0,0,0,Guinea
24384,3/1/2021,GIN,Selangor,11,4,7,Guinea
24385,3/1/2021,GLP,Selangor,0,0,0,Guadeloupe
24386,3/1/2021,GMB,Johor,0,0,0,Gambia
24387,3/1/2021,GMB,Kedah,0,0,0,Gambia
24388,3/1/2021,GMB,Kelantan,0,0,0,Gambia
24389,3/1/2021,GMB,Pulau Pinang,0,0,0,Gambia
24390,3/1/2021,GMB,Sabah,0,0,0,Gambia
24391,3/1/2021,GMB,Sarawak,0,0,0,Gambia
24392,3/1/2021,GMB,Selangor,1,1,0,Gambia
24393,3/1/2021,GNB,Johor,0,0,0,Guinea-Bissau
24394,3/1/2021,GNB,Selangor,0,0,0,Guinea-Bissau
24395,3/1/2021,GNQ,Johor,0,0,0,Equatorial Guinea
24396,3/1/2021,GNQ,Selangor,0,0,0,Equatorial Guinea
24397,3/1/2021,GRC,Johor,0,0,0,Greece
24398,3/1/2021,GRC,Kedah,0,0,0,Greece
24399,3/1/2021,GRC,Kelantan,0,0,0,Greece
24400,3/1/2021,GRC,Melaka,0,0,0,Greece
24401,3/1/2021,GRC,Negeri Sembilan,0,0,0,Greece
24402,3/1/2021,GRC,Pahang,0,0,0,Greece
24403,3/1/2021,GRC,Perak,0,0,0,Greece
24404,3/1/2021,GRC,Perlis,0,0,0,Greece
24405,3/1/2021,GRC,Pulau Pinang,0,0,0,Greece
24406,3/1/2021,GRC,Sabah,0,0,0,Greece
24407,3/1/2021,GRC,Sarawak,0,0,0,Greece
24408,3/1/2021,GRC,Selangor,5,5,0,Greece
24409,3/1/2021,GRD,Johor,0,0,0,Grenada
24410,3/1/2021,GRD,Kedah,0,0,0,Grenada
24411,3/1/2021,GRD,Pulau Pinang,0,0,0,Grenada
24412,3/1/2021,GRD,Sabah,0,0,0,Grenada
24413,3/1/2021,GRD,Sarawak,0,0,0,Grenada
24414,3/1/2021,GRD,Selangor,0,0,0,Grenada
24415,3/1/2021,GRL,Johor,0,0,0,Greenland
24416,3/1/2021,GRL,Selangor,0,0,0,Greenland
24417,3/1/2021,GTM,Johor,0,0,0,Guatemala
24418,3/1/2021,GTM,Kedah,0,0,0,Guatemala
24419,3/1/2021,GTM,Pahang,0,0,0,Guatemala
24420,3/1/2021,GTM,Perak,0,0,0,Guatemala
24421,3/1/2021,GTM,Pulau Pinang,0,0,0,Guatemala
24422,3/1/2021,GTM,Sabah,0,0,0,Guatemala
24423,3/1/2021,GTM,Sarawak,0,0,0,Guatemala
24424,3/1/2021,GTM,Selangor,0,0,0,Guatemala
24425,3/1/2021,GTM,W.P. Labuan,0,0,0,Guatemala
24426,3/1/2021,GUY,Johor,0,0,0,Guyana
24427,3/1/2021,GUY,Kedah,0,0,0,Guyana
24428,3/1/2021,GUY,Pulau Pinang,0,0,0,Guyana
24429,3/1/2021,GUY,Sarawak,0,0,0,Guyana
24430,3/1/2021,GUY,Selangor,0,0,0,Guyana
24431,3/1/2021,HKG,Johor,0,0,0,Hong Kong
24432,3/1/2021,HKG,Kedah,0,0,0,Hong Kong
24433,3/1/2021,HKG,Kelantan,0,0,0,Hong Kong
24434,3/1/2021,HKG,Pahang,0,0,0,Hong Kong
24435,3/1/2021,HKG,Perak,0,0,0,Hong Kong
24436,3/1/2021,HKG,Perlis,0,0,0,Hong Kong
24437,3/1/2021,HKG,Pulau Pinang,5,2,3,Hong Kong
24438,3/1/2021,HKG,Sabah,0,0,0,Hong Kong
24439,3/1/2021,HKG,Sarawak,0,0,0,Hong Kong
24440,3/1/2021,HKG,Selangor,0,0,0,Hong Kong
24441,3/1/2021,HKG,Terengganu,0,0,0,Hong Kong
24442,3/1/2021,HMD,Johor,0,0,0,Heard Island and McDonald Islands
24443,3/1/2021,HND,Johor,0,0,0,Honduras
24444,3/1/2021,HND,Kedah,0,0,0,Honduras
24445,3/1/2021,HND,Perak,0,0,0,Honduras
24446,3/1/2021,HND,Pulau Pinang,0,0,0,Honduras
24447,3/1/2021,HND,Sabah,0,0,0,Honduras
24448,3/1/2021,HND,Sarawak,0,0,0,Honduras
24449,3/1/2021,HND,Selangor,0,0,0,Honduras
24450,3/1/2021,HRV,Johor,4,4,0,Croatia
24451,3/1/2021,HRV,Kedah,0,0,0,Croatia
24452,3/1/2021,HRV,Kelantan,0,0,0,Croatia
24453,3/1/2021,HRV,Melaka,0,0,0,Croatia
24454,3/1/2021,HRV,Pahang,0,0,0,Croatia
24455,3/1/2021,HRV,Perak,0,0,0,Croatia
24456,3/1/2021,HRV,Perlis,0,0,0,Croatia
24457,3/1/2021,HRV,Pulau Pinang,0,0,0,Croatia
24458,3/1/2021,HRV,Sabah,0,0,0,Croatia
24459,3/1/2021,HRV,Sarawak,0,0,0,Croatia
24460,3/1/2021,HRV,Selangor,45,41,4,Croatia
24461,3/1/2021,HTI,Johor,0,0,0,Haiti
24462,3/1/2021,HTI,Kedah,0,0,0,Haiti
24463,3/1/2021,HTI,Kelantan,0,0,0,Haiti
24464,3/1/2021,HTI,Perak,0,0,0,Haiti
24465,3/1/2021,HTI,Pulau Pinang,0,0,0,Haiti
24466,3/1/2021,HTI,Sabah,0,0,0,Haiti
24467,3/1/2021,HTI,Selangor,0,0,0,Haiti
24468,3/1/2021,HUN,Johor,0,0,0,Hungary
24469,3/1/2021,HUN,Kedah,0,0,0,Hungary
24470,3/1/2021,HUN,Kelantan,0,0,0,Hungary
24471,3/1/2021,HUN,Pahang,0,0,0,Hungary
24472,3/1/2021,HUN,Perak,0,0,0,Hungary
24473,3/1/2021,HUN,Perlis,0,0,0,Hungary
24474,3/1/2021,HUN,Pulau Pinang,0,0,0,Hungary
24475,3/1/2021,HUN,Sabah,0,0,0,Hungary
24476,3/1/2021,HUN,Sarawak,0,0,0,Hungary
24477,3/1/2021,HUN,Selangor,5,1,4,Hungary
24478,3/1/2021,HUN,W.P. Labuan,0,0,0,Hungary
24479,3/1/2021,IDN,Johor,322,254,68,Indonesia
24480,3/1/2021,IDN,Kedah,6,6,0,Indonesia
24481,3/1/2021,IDN,Kelantan,0,0,0,Indonesia
24482,3/1/2021,IDN,Melaka,2,0,2,Indonesia
24483,3/1/2021,IDN,Negeri Sembilan,0,0,0,Indonesia
24484,3/1/2021,IDN,Pahang,1,1,0,Indonesia
24485,3/1/2021,IDN,Perak,0,0,0,Indonesia
24486,3/1/2021,IDN,Perlis,9,9,0,Indonesia
24487,3/1/2021,IDN,Pulau Pinang,25,12,13,Indonesia
24488,3/1/2021,IDN,Sabah,1,1,0,Indonesia
24489,3/1/2021,IDN,Sarawak,488,488,0,Indonesia
24490,3/1/2021,IDN,Selangor,1234,703,531,Indonesia
24491,3/1/2021,IDN,Terengganu,0,0,0,Indonesia
24492,3/1/2021,IDN,W.P. Labuan,2,0,2,Indonesia
24493,3/1/2021,IND,Johor,117,116,1,India
24494,3/1/2021,IND,Kedah,0,0,0,India
24495,3/1/2021,IND,Kelantan,0,0,0,India
24496,3/1/2021,IND,Melaka,0,0,0,India
24497,3/1/2021,IND,Negeri Sembilan,0,0,0,India
24498,3/1/2021,IND,Pahang,0,0,0,India
24499,3/1/2021,IND,Perak,0,0,0,India
24500,3/1/2021,IND,Perlis,0,0,0,India
24501,3/1/2021,IND,Pulau Pinang,1,1,0,India
24502,3/1/2021,IND,Sabah,0,0,0,India
24503,3/1/2021,IND,Sarawak,0,0,0,India
24504,3/1/2021,IND,Selangor,1441,1036,405,India
24505,3/1/2021,IND,Terengganu,0,0,0,India
24506,3/1/2021,IND,W.P. Labuan,0,0,0,India
24507,3/1/2021,IOT,Pulau Pinang,0,0,0,British Indian Ocean Territory
24508,3/1/2021,IOT,Selangor,0,0,0,British Indian Ocean Territory
24509,3/1/2021,IRL,Johor,0,0,0,Ireland
24510,3/1/2021,IRL,Kedah,0,0,0,Ireland
24511,3/1/2021,IRL,Kelantan,0,0,0,Ireland
24512,3/1/2021,IRL,Negeri Sembilan,0,0,0,Ireland
24513,3/1/2021,IRL,Pahang,0,0,0,Ireland
24514,3/1/2021,IRL,Perak,0,0,0,Ireland
24515,3/1/2021,IRL,Perlis,0,0,0,Ireland
24516,3/1/2021,IRL,Pulau Pinang,0,0,0,Ireland
24517,3/1/2021,IRL,Sabah,0,0,0,Ireland
24518,3/1/2021,IRL,Sarawak,0,0,0,Ireland
24519,3/1/2021,IRL,Selangor,17,10,7,Ireland
24520,3/1/2021,IRL,Terengganu,0,0,0,Ireland
24521,3/1/2021,IRL,W.P. Labuan,0,0,0,Ireland
24522,3/1/2021,IRN,Johor,0,0,0,Iran
24523,3/1/2021,IRN,Kedah,0,0,0,Iran
24524,3/1/2021,IRN,Kelantan,0,0,0,Iran
24525,3/1/2021,IRN,Perak,0,0,0,Iran
24526,3/1/2021,IRN,Perlis,0,0,0,Iran
24527,3/1/2021,IRN,Pulau Pinang,0,0,0,Iran
24528,3/1/2021,IRN,Sabah,0,0,0,Iran
24529,3/1/2021,IRN,Sarawak,0,0,0,Iran
24530,3/1/2021,IRN,Selangor,51,33,18,Iran
24531,3/1/2021,IRN,W.P. Labuan,0,0,0,Iran
24532,3/1/2021,IRQ,Johor,0,0,0,Iraq
24533,3/1/2021,IRQ,Kedah,0,0,0,Iraq
24534,3/1/2021,IRQ,Kelantan,0,0,0,Iraq
24535,3/1/2021,IRQ,Melaka,0,0,0,Iraq
24536,3/1/2021,IRQ,Pahang,0,0,0,Iraq
24537,3/1/2021,IRQ,Perak,0,0,0,Iraq
24538,3/1/2021,IRQ,Perlis,0,0,0,Iraq
24539,3/1/2021,IRQ,Pulau Pinang,0,0,0,Iraq
24540,3/1/2021,IRQ,Sabah,0,0,0,Iraq
24541,3/1/2021,IRQ,Sarawak,0,0,0,Iraq
24542,3/1/2021,IRQ,Selangor,52,41,11,Iraq
24543,3/1/2021,ISL,Johor,0,0,0,Iceland
24544,3/1/2021,ISL,Kedah,0,0,0,Iceland
24545,3/1/2021,ISL,Kelantan,0,0,0,Iceland
24546,3/1/2021,ISL,Perak,0,0,0,Iceland
24547,3/1/2021,ISL,Perlis,0,0,0,Iceland
24548,3/1/2021,ISL,Pulau Pinang,0,0,0,Iceland
24549,3/1/2021,ISL,Sabah,0,0,0,Iceland
24550,3/1/2021,ISL,Sarawak,0,0,0,Iceland
24551,3/1/2021,ISL,Selangor,0,0,0,Iceland
24552,3/1/2021,ISL,W.P. Labuan,0,0,0,Iceland
24553,3/1/2021,ISR,Pulau Pinang,0,0,0,Israel
24554,3/1/2021,ITA,Johor,0,0,0,Italy
24555,3/1/2021,ITA,Kedah,0,0,0,Italy
24556,3/1/2021,ITA,Kelantan,0,0,0,Italy
24557,3/1/2021,ITA,Melaka,0,0,0,Italy
24558,3/1/2021,ITA,Negeri Sembilan,0,0,0,Italy
24559,3/1/2021,ITA,Pahang,0,0,0,Italy
24560,3/1/2021,ITA,Perak,0,0,0,Italy
24561,3/1/2021,ITA,Perlis,0,0,0,Italy
24562,3/1/2021,ITA,Pulau Pinang,0,0,0,Italy
24563,3/1/2021,ITA,Sabah,0,0,0,Italy
24564,3/1/2021,ITA,Sarawak,1,1,0,Italy
24565,3/1/2021,ITA,Selangor,26,19,7,Italy
24566,3/1/2021,ITA,W.P. Labuan,0,0,0,Italy
24567,3/1/2021,JAM,Johor,0,0,0,Jamaica
24568,3/1/2021,JAM,Kedah,0,0,0,Jamaica
24569,3/1/2021,JAM,Perak,0,0,0,Jamaica
24570,3/1/2021,JAM,Pulau Pinang,0,0,0,Jamaica
24571,3/1/2021,JAM,Sabah,0,0,0,Jamaica
24572,3/1/2021,JAM,Sarawak,0,0,0,Jamaica
24573,3/1/2021,JAM,Selangor,0,0,0,Jamaica
24574,3/1/2021,JAM,W.P. Labuan,0,0,0,Jamaica
24575,3/1/2021,JOR,Johor,0,0,0,Jordan
24576,3/1/2021,JOR,Kedah,0,0,0,Jordan
24577,3/1/2021,JOR,Kelantan,0,0,0,Jordan
24578,3/1/2021,JOR,Melaka,0,0,0,Jordan
24579,3/1/2021,JOR,Perlis,0,0,0,Jordan
24580,3/1/2021,JOR,Pulau Pinang,0,0,0,Jordan
24581,3/1/2021,JOR,Sabah,0,0,0,Jordan
24582,3/1/2021,JOR,Sarawak,0,0,0,Jordan
24583,3/1/2021,JOR,Selangor,43,33,10,Jordan
24584,3/1/2021,JOR,W.P. Labuan,0,0,0,Jordan
24585,3/1/2021,JPN,Johor,2,2,0,Japan
24586,3/1/2021,JPN,Kedah,0,0,0,Japan
24587,3/1/2021,JPN,Kelantan,0,0,0,Japan
24588,3/1/2021,JPN,Melaka,0,0,0,Japan
24589,3/1/2021,JPN,Negeri Sembilan,0,0,0,Japan
24590,3/1/2021,JPN,Pahang,0,0,0,Japan
24591,3/1/2021,JPN,Perak,0,0,0,Japan
24592,3/1/2021,JPN,Perlis,0,0,0,Japan
24593,3/1/2021,JPN,Pulau Pinang,37,26,11,Japan
24594,3/1/2021,JPN,Sabah,0,0,0,Japan
24595,3/1/2021,JPN,Sarawak,1,1,0,Japan
24596,3/1/2021,JPN,Selangor,386,262,124,Japan
24597,3/1/2021,JPN,W.P. Labuan,0,0,0,Japan
24598,3/1/2021,KAZ,Johor,0,0,0,Kazakhstan
24599,3/1/2021,KAZ,Kedah,0,0,0,Kazakhstan
24600,3/1/2021,KAZ,Kelantan,0,0,0,Kazakhstan
24601,3/1/2021,KAZ,Melaka,0,0,0,Kazakhstan
24602,3/1/2021,KAZ,Perak,0,0,0,Kazakhstan
24603,3/1/2021,KAZ,Perlis,0,0,0,Kazakhstan
24604,3/1/2021,KAZ,Pulau Pinang,0,0,0,Kazakhstan
24605,3/1/2021,KAZ,Sabah,0,0,0,Kazakhstan
24606,3/1/2021,KAZ,Sarawak,0,0,0,Kazakhstan
24607,3/1/2021,KAZ,Selangor,20,8,12,Kazakhstan
24608,3/1/2021,KAZ,W.P. Labuan,0,0,0,Kazakhstan
24609,3/1/2021,KEN,Johor,0,0,0,Kenya
24610,3/1/2021,KEN,Kedah,0,0,0,Kenya
24611,3/1/2021,KEN,Kelantan,0,0,0,Kenya
24612,3/1/2021,KEN,Perak,0,0,0,Kenya
24613,3/1/2021,KEN,Perlis,0,0,0,Kenya
24614,3/1/2021,KEN,Pulau Pinang,0,0,0,Kenya
24615,3/1/2021,KEN,Sabah,0,0,0,Kenya
24616,3/1/2021,KEN,Sarawak,0,0,0,Kenya
24617,3/1/2021,KEN,Selangor,33,14,19,Kenya
24618,3/1/2021,KGZ,Johor,0,0,0,Kyrgyzstan
24619,3/1/2021,KGZ,Kedah,0,0,0,Kyrgyzstan
24620,3/1/2021,KGZ,Kelantan,0,0,0,Kyrgyzstan
24621,3/1/2021,KGZ,Perak,0,0,0,Kyrgyzstan
24622,3/1/2021,KGZ,Perlis,0,0,0,Kyrgyzstan
24623,3/1/2021,KGZ,Pulau Pinang,0,0,0,Kyrgyzstan
24624,3/1/2021,KGZ,Sabah,0,0,0,Kyrgyzstan
24625,3/1/2021,KGZ,Sarawak,0,0,0,Kyrgyzstan
24626,3/1/2021,KGZ,Selangor,6,5,1,Kyrgyzstan
24627,3/1/2021,KHM,Johor,0,0,0,Cambodia
24628,3/1/2021,KHM,Kedah,0,0,0,Cambodia
24629,3/1/2021,KHM,Kelantan,0,0,0,Cambodia
24630,3/1/2021,KHM,Melaka,0,0,0,Cambodia
24631,3/1/2021,KHM,Negeri Sembilan,0,0,0,Cambodia
24632,3/1/2021,KHM,Pahang,0,0,0,Cambodia
24633,3/1/2021,KHM,Perak,0,0,0,Cambodia
24634,3/1/2021,KHM,Perlis,0,0,0,Cambodia
24635,3/1/2021,KHM,Pulau Pinang,0,0,0,Cambodia
24636,3/1/2021,KHM,Sabah,0,0,0,Cambodia
24637,3/1/2021,KHM,Sarawak,0,0,0,Cambodia
24638,3/1/2021,KHM,Selangor,12,3,9,Cambodia
24639,3/1/2021,KHM,W.P. Labuan,0,0,0,Cambodia
24640,3/1/2021,KIR,Johor,0,0,0,Kiribati
24641,3/1/2021,KIR,Sabah,0,0,0,Kiribati
24642,3/1/2021,KIR,Selangor,4,4,0,Kiribati
24643,3/1/2021,KNA,Johor,0,0,0,Saint Kitts and Nevis
24644,3/1/2021,KNA,Kedah,0,0,0,Saint Kitts and Nevis
24645,3/1/2021,KNA,Perlis,0,0,0,Saint Kitts and Nevis
24646,3/1/2021,KNA,Pulau Pinang,0,0,0,Saint Kitts and Nevis
24647,3/1/2021,KNA,Sabah,0,0,0,Saint Kitts and Nevis
24648,3/1/2021,KNA,Selangor,0,0,0,Saint Kitts and Nevis
24649,3/1/2021,KNA,W.P. Labuan,0,0,0,Saint Kitts and Nevis
24650,3/1/2021,KOR,Johor,1,1,0,"Korea, Republic of (South Korea)"
24651,3/1/2021,KOR,Kedah,0,0,0,"Korea, Republic of (South Korea)"
24652,3/1/2021,KOR,Kelantan,0,0,0,"Korea, Republic of (South Korea)"
24653,3/1/2021,KOR,Melaka,0,0,0,"Korea, Republic of (South Korea)"
24654,3/1/2021,KOR,Negeri Sembilan,0,0,0,"Korea, Republic of (South Korea)"
24655,3/1/2021,KOR,Pahang,0,0,0,"Korea, Republic of (South Korea)"
24656,3/1/2021,KOR,Perak,0,0,0,"Korea, Republic of (South Korea)"
24657,3/1/2021,KOR,Perlis,0,0,0,"Korea, Republic of (South Korea)"
24658,3/1/2021,KOR,Pulau Pinang,1,1,0,"Korea, Republic of (South Korea)"
24659,3/1/2021,KOR,Sabah,1,1,0,"Korea, Republic of (South Korea)"
24660,3/1/2021,KOR,Sarawak,2,2,0,"Korea, Republic of (South Korea)"
24661,3/1/2021,KOR,Selangor,339,230,109,"Korea, Republic of (South Korea)"
24662,3/1/2021,KOR,Terengganu,0,0,0,"Korea, Republic of (South Korea)"
24663,3/1/2021,KOR,W.P. Labuan,0,0,0,"Korea, Republic of (South Korea)"
24664,3/1/2021,KWT,Johor,0,0,0,Kuwait
24665,3/1/2021,KWT,Kedah,0,0,0,Kuwait
24666,3/1/2021,KWT,Kelantan,0,0,0,Kuwait
24667,3/1/2021,KWT,Perak,0,0,0,Kuwait
24668,3/1/2021,KWT,Perlis,0,0,0,Kuwait
24669,3/1/2021,KWT,Pulau Pinang,0,0,0,Kuwait
24670,3/1/2021,KWT,Sabah,0,0,0,Kuwait
24671,3/1/2021,KWT,Sarawak,0,0,0,Kuwait
24672,3/1/2021,KWT,Selangor,4,3,1,Kuwait
24673,3/1/2021,KWT,W.P. Labuan,0,0,0,Kuwait
24674,3/1/2021,LAO,Johor,0,0,0,Lao People's Democratic Republic
24675,3/1/2021,LAO,Kedah,0,0,0,Lao People's Democratic Republic
24676,3/1/2021,LAO,Kelantan,0,0,0,Lao People's Democratic Republic
24677,3/1/2021,LAO,Melaka,0,0,0,Lao People's Democratic Republic
24678,3/1/2021,LAO,Perak,0,0,0,Lao People's Democratic Republic
24679,3/1/2021,LAO,Perlis,0,0,0,Lao People's Democratic Republic
24680,3/1/2021,LAO,Pulau Pinang,0,0,0,Lao People's Democratic Republic
24681,3/1/2021,LAO,Sabah,0,0,0,Lao People's Democratic Republic
24682,3/1/2021,LAO,Sarawak,0,0,0,Lao People's Democratic Republic
24683,3/1/2021,LAO,Selangor,2,1,1,Lao People's Democratic Republic
24684,3/1/2021,LAO,W.P. Labuan,0,0,0,Lao People's Democratic Republic
24685,3/1/2021,LBN,Johor,0,0,0,Lebanon
24686,3/1/2021,LBN,Kedah,0,0,0,Lebanon
24687,3/1/2021,LBN,Kelantan,0,0,0,Lebanon
24688,3/1/2021,LBN,Pahang,0,0,0,Lebanon
24689,3/1/2021,LBN,Perak,0,0,0,Lebanon
24690,3/1/2021,LBN,Perlis,0,0,0,Lebanon
24691,3/1/2021,LBN,Pulau Pinang,0,0,0,Lebanon
24692,3/1/2021,LBN,Sabah,0,0,0,Lebanon
24693,3/1/2021,LBN,Sarawak,0,0,0,Lebanon
24694,3/1/2021,LBN,Selangor,4,3,1,Lebanon
24695,3/1/2021,LBN,W.P. Labuan,0,0,0,Lebanon
24696,3/1/2021,LBR,Johor,0,0,0,Liberia
24697,3/1/2021,LBR,Kedah,0,0,0,Liberia
24698,3/1/2021,LBR,Sabah,0,0,0,Liberia
24699,3/1/2021,LBR,Sarawak,0,0,0,Liberia
24700,3/1/2021,LBR,Selangor,4,3,1,Liberia
24701,3/1/2021,LBY,Johor,0,0,0,Libyan Arab Jamahiriya
24702,3/1/2021,LBY,Kedah,0,0,0,Libyan Arab Jamahiriya
24703,3/1/2021,LBY,Perlis,0,0,0,Libyan Arab Jamahiriya
24704,3/1/2021,LBY,Pulau Pinang,0,0,0,Libyan Arab Jamahiriya
24705,3/1/2021,LBY,Sabah,0,0,0,Libyan Arab Jamahiriya
24706,3/1/2021,LBY,Sarawak,0,0,0,Libyan Arab Jamahiriya
24707,3/1/2021,LBY,Selangor,66,59,7,Libyan Arab Jamahiriya
24708,3/1/2021,LCA,Johor,0,0,0,Saint Lucia
24709,3/1/2021,LCA,Kedah,0,0,0,Saint Lucia
24710,3/1/2021,LCA,Pulau Pinang,0,0,0,Saint Lucia
24711,3/1/2021,LCA,Sarawak,0,0,0,Saint Lucia
24712,3/1/2021,LCA,Selangor,0,0,0,Saint Lucia
24713,3/1/2021,LIE,Johor,0,0,0,Liechtenstein
24714,3/1/2021,LIE,Kedah,0,0,0,Liechtenstein
24715,3/1/2021,LIE,Perlis,0,0,0,Liechtenstein
24716,3/1/2021,LIE,Pulau Pinang,0,0,0,Liechtenstein
24717,3/1/2021,LIE,Sabah,0,0,0,Liechtenstein
24718,3/1/2021,LIE,Sarawak,0,0,0,Liechtenstein
24719,3/1/2021,LIE,Selangor,0,0,0,Liechtenstein
24720,3/1/2021,LKA,Johor,1,1,0,Sri Lanka
24721,3/1/2021,LKA,Kedah,0,0,0,Sri Lanka
24722,3/1/2021,LKA,Kelantan,0,0,0,Sri Lanka
24723,3/1/2021,LKA,Melaka,0,0,0,Sri Lanka
24724,3/1/2021,LKA,Pahang,0,0,0,Sri Lanka
24725,3/1/2021,LKA,Perak,0,0,0,Sri Lanka
24726,3/1/2021,LKA,Perlis,0,0,0,Sri Lanka
24727,3/1/2021,LKA,Pulau Pinang,0,0,0,Sri Lanka
24728,3/1/2021,LKA,Sabah,1,1,0,Sri Lanka
24729,3/1/2021,LKA,Sarawak,0,0,0,Sri Lanka
24730,3/1/2021,LKA,Selangor,119,62,57,Sri Lanka
24731,3/1/2021,LKA,W.P. Labuan,0,0,0,Sri Lanka
24732,3/1/2021,LSO,Johor,0,0,0,Lesotho
24733,3/1/2021,LSO,Kedah,0,0,0,Lesotho
24734,3/1/2021,LSO,Pulau Pinang,0,0,0,Lesotho
24735,3/1/2021,LSO,Sarawak,0,0,0,Lesotho
24736,3/1/2021,LSO,Selangor,0,0,0,Lesotho
24737,3/1/2021,LTU,Johor,0,0,0,Lithuania
24738,3/1/2021,LTU,Kedah,0,0,0,Lithuania
24739,3/1/2021,LTU,Kelantan,0,0,0,Lithuania
24740,3/1/2021,LTU,Pahang,0,0,0,Lithuania
24741,3/1/2021,LTU,Perak,0,0,0,Lithuania
24742,3/1/2021,LTU,Perlis,0,0,0,Lithuania
24743,3/1/2021,LTU,Pulau Pinang,0,0,0,Lithuania
24744,3/1/2021,LTU,Sabah,0,0,0,Lithuania
24745,3/1/2021,LTU,Sarawak,0,0,0,Lithuania
24746,3/1/2021,LTU,Selangor,1,1,0,Lithuania
24747,3/1/2021,LTU,W.P. Labuan,0,0,0,Lithuania
24748,3/1/2021,LUX,Johor,0,0,0,Luxembourg
24749,3/1/2021,LUX,Kedah,0,0,0,Luxembourg
24750,3/1/2021,LUX,Kelantan,0,0,0,Luxembourg
24751,3/1/2021,LUX,Perak,0,0,0,Luxembourg
24752,3/1/2021,LUX,Perlis,0,0,0,Luxembourg
24753,3/1/2021,LUX,Pulau Pinang,0,0,0,Luxembourg
24754,3/1/2021,LUX,Sabah,0,0,0,Luxembourg
24755,3/1/2021,LUX,Sarawak,0,0,0,Luxembourg
24756,3/1/2021,LUX,Selangor,0,0,0,Luxembourg
24757,3/1/2021,LVA,Johor,0,0,0,Latvia
24758,3/1/2021,LVA,Kedah,0,0,0,Latvia
24759,3/1/2021,LVA,Kelantan,0,0,0,Latvia
24760,3/1/2021,LVA,Pahang,0,0,0,Latvia
24761,3/1/2021,LVA,Perak,0,0,0,Latvia
24762,3/1/2021,LVA,Perlis,0,0,0,Latvia
24763,3/1/2021,LVA,Pulau Pinang,0,0,0,Latvia
24764,3/1/2021,LVA,Sabah,0,0,0,Latvia
24765,3/1/2021,LVA,Sarawak,0,0,0,Latvia
24766,3/1/2021,LVA,Selangor,12,11,1,Latvia
24767,3/1/2021,LVA,W.P. Labuan,0,0,0,Latvia
24768,3/1/2021,MAC,Johor,0,0,0,Macao
24769,3/1/2021,MAC,Pahang,0,0,0,Macao
24770,3/1/2021,MAC,Perak,0,0,0,Macao
24771,3/1/2021,MAC,Selangor,0,0,0,Macao
24772,3/1/2021,MAC,W.P. Labuan,0,0,0,Macao
24773,3/1/2021,MAR,Johor,0,0,0,Morocco
24774,3/1/2021,MAR,Kedah,0,0,0,Morocco
24775,3/1/2021,MAR,Kelantan,0,0,0,Morocco
24776,3/1/2021,MAR,Melaka,0,0,0,Morocco
24777,3/1/2021,MAR,Pahang,0,0,0,Morocco
24778,3/1/2021,MAR,Perak,0,0,0,Morocco
24779,3/1/2021,MAR,Perlis,0,0,0,Morocco
24780,3/1/2021,MAR,Pulau Pinang,0,0,0,Morocco
24781,3/1/2021,MAR,Sabah,0,0,0,Morocco
24782,3/1/2021,MAR,Sarawak,0,0,0,Morocco
24783,3/1/2021,MAR,Selangor,11,5,6,Morocco
24784,3/1/2021,MAR,W.P. Labuan,0,0,0,Morocco
24785,3/1/2021,MCO,Johor,0,0,0,Monaco
24786,3/1/2021,MCO,Kedah,0,0,0,Monaco
24787,3/1/2021,MCO,Sabah,0,0,0,Monaco
24788,3/1/2021,MCO,Selangor,0,0,0,Monaco
24789,3/1/2021,MDA,Johor,0,0,0,"Moldova, Republic of"
24790,3/1/2021,MDA,Kedah,0,0,0,"Moldova, Republic of"
24791,3/1/2021,MDA,Kelantan,0,0,0,"Moldova, Republic of"
24792,3/1/2021,MDA,Negeri Sembilan,0,0,0,"Moldova, Republic of"
24793,3/1/2021,MDA,Perlis,0,0,0,"Moldova, Republic of"
24794,3/1/2021,MDA,Pulau Pinang,0,0,0,"Moldova, Republic of"
24795,3/1/2021,MDA,Sabah,0,0,0,"Moldova, Republic of"
24796,3/1/2021,MDA,Sarawak,0,0,0,"Moldova, Republic of"
24797,3/1/2021,MDA,Selangor,0,0,0,"Moldova, Republic of"
24798,3/1/2021,MDG,Johor,0,0,0,Madagascar
24799,3/1/2021,MDG,Kedah,0,0,0,Madagascar
24800,3/1/2021,MDG,Perak,0,0,0,Madagascar
24801,3/1/2021,MDG,Perlis,0,0,0,Madagascar
24802,3/1/2021,MDG,Pulau Pinang,0,0,0,Madagascar
24803,3/1/2021,MDG,Sabah,0,0,0,Madagascar
24804,3/1/2021,MDG,Sarawak,0,0,0,Madagascar
24805,3/1/2021,MDG,Selangor,0,0,0,Madagascar
24806,3/1/2021,MDV,Johor,0,0,0,Maldives
24807,3/1/2021,MDV,Kedah,0,0,0,Maldives
24808,3/1/2021,MDV,Kelantan,0,0,0,Maldives
24809,3/1/2021,MDV,Perak,0,0,0,Maldives
24810,3/1/2021,MDV,Perlis,0,0,0,Maldives
24811,3/1/2021,MDV,Pulau Pinang,0,0,0,Maldives
24812,3/1/2021,MDV,Sabah,0,0,0,Maldives
24813,3/1/2021,MDV,Sarawak,0,0,0,Maldives
24814,3/1/2021,MDV,Selangor,76,36,40,Maldives
24815,3/1/2021,MEX,Johor,0,0,0,Mexico
24816,3/1/2021,MEX,Kedah,0,0,0,Mexico
24817,3/1/2021,MEX,Kelantan,0,0,0,Mexico
24818,3/1/2021,MEX,Pahang,0,0,0,Mexico
24819,3/1/2021,MEX,Perak,0,0,0,Mexico
24820,3/1/2021,MEX,Perlis,0,0,0,Mexico
24821,3/1/2021,MEX,Pulau Pinang,0,0,0,Mexico
24822,3/1/2021,MEX,Sabah,0,0,0,Mexico
24823,3/1/2021,MEX,Sarawak,0,0,0,Mexico
24824,3/1/2021,MEX,Selangor,3,3,0,Mexico
24825,3/1/2021,MEX,W.P. Labuan,0,0,0,Mexico
24826,3/1/2021,MHL,Johor,0,0,0,Marshall Islands
24827,3/1/2021,MHL,Kedah,0,0,0,Marshall Islands
24828,3/1/2021,MHL,Perak,0,0,0,Marshall Islands
24829,3/1/2021,MHL,Pulau Pinang,0,0,0,Marshall Islands
24830,3/1/2021,MHL,Sabah,0,0,0,Marshall Islands
24831,3/1/2021,MHL,Selangor,0,0,0,Marshall Islands
24832,3/1/2021,MKD,Johor,0,0,0,"Macedonia, the former Yugoslav Republic of"
24833,3/1/2021,MKD,Kedah,0,0,0,"Macedonia, the former Yugoslav Republic of"
24834,3/1/2021,MKD,Perak,0,0,0,"Macedonia, the former Yugoslav Republic of"
24835,3/1/2021,MKD,Pulau Pinang,0,0,0,"Macedonia, the former Yugoslav Republic of"
24836,3/1/2021,MKD,Sabah,0,0,0,"Macedonia, the former Yugoslav Republic of"
24837,3/1/2021,MKD,Sarawak,0,0,0,"Macedonia, the former Yugoslav Republic of"
24838,3/1/2021,MKD,Selangor,1,1,0,"Macedonia, the former Yugoslav Republic of"
24839,3/1/2021,MLI,Johor,0,0,0,Mali
24840,3/1/2021,MLI,Sabah,1,1,0,Mali
24841,3/1/2021,MLI,Selangor,2,2,0,Mali
24842,3/1/2021,MLT,Johor,0,0,0,Malta
24843,3/1/2021,MLT,Kedah,0,0,0,Malta
24844,3/1/2021,MLT,Kelantan,0,0,0,Malta
24845,3/1/2021,MLT,Perak,0,0,0,Malta
24846,3/1/2021,MLT,Perlis,0,0,0,Malta
24847,3/1/2021,MLT,Pulau Pinang,0,0,0,Malta
24848,3/1/2021,MLT,Sabah,0,0,0,Malta
24849,3/1/2021,MLT,Sarawak,0,0,0,Malta
24850,3/1/2021,MLT,Selangor,2,1,1,Malta
24851,3/1/2021,MLT,W.P. Labuan,0,0,0,Malta
24852,3/1/2021,MMR,Johor,9,9,0,Myanmar
24853,3/1/2021,MMR,Kedah,0,0,0,Myanmar
24854,3/1/2021,MMR,Kelantan,0,0,0,Myanmar
24855,3/1/2021,MMR,Negeri Sembilan,0,0,0,Myanmar
24856,3/1/2021,MMR,Pahang,0,0,0,Myanmar
24857,3/1/2021,MMR,Perak,0,0,0,Myanmar
24858,3/1/2021,MMR,Perlis,0,0,0,Myanmar
24859,3/1/2021,MMR,Pulau Pinang,0,0,0,Myanmar
24860,3/1/2021,MMR,Sabah,0,0,0,Myanmar
24861,3/1/2021,MMR,Sarawak,0,0,0,Myanmar
24862,3/1/2021,MMR,Selangor,123,101,22,Myanmar
24863,3/1/2021,MMR,Terengganu,0,0,0,Myanmar
24864,3/1/2021,MMR,W.P. Labuan,0,0,0,Myanmar
24865,3/1/2021,MNE,Johor,4,4,0,Montenegro
24866,3/1/2021,MNE,Kedah,0,0,0,Montenegro
24867,3/1/2021,MNE,Pulau Pinang,0,0,0,Montenegro
24868,3/1/2021,MNE,Sabah,0,0,0,Montenegro
24869,3/1/2021,MNE,Sarawak,0,0,0,Montenegro
24870,3/1/2021,MNE,Selangor,15,15,0,Montenegro
24871,3/1/2021,MNG,Johor,0,0,0,Mongolia
24872,3/1/2021,MNG,Kedah,0,0,0,Mongolia
24873,3/1/2021,MNG,Kelantan,0,0,0,Mongolia
24874,3/1/2021,MNG,Perak,0,0,0,Mongolia
24875,3/1/2021,MNG,Perlis,0,0,0,Mongolia
24876,3/1/2021,MNG,Pulau Pinang,0,0,0,Mongolia
24877,3/1/2021,MNG,Sabah,0,0,0,Mongolia
24878,3/1/2021,MNG,Sarawak,0,0,0,Mongolia
24879,3/1/2021,MNG,Selangor,0,0,0,Mongolia
24880,3/1/2021,MNP,Selangor,0,0,0,Northern Mariana Islands
24881,3/1/2021,MOZ,Johor,0,0,0,Mozambique
24882,3/1/2021,MOZ,Kedah,0,0,0,Mozambique
24883,3/1/2021,MOZ,Perak,0,0,0,Mozambique
24884,3/1/2021,MOZ,Pulau Pinang,0,0,0,Mozambique
24885,3/1/2021,MOZ,Sabah,0,0,0,Mozambique
24886,3/1/2021,MOZ,Sarawak,0,0,0,Mozambique
24887,3/1/2021,MOZ,Selangor,10,7,3,Mozambique
24888,3/1/2021,MRT,Johor,0,0,0,Mauritania
24889,3/1/2021,MRT,Kedah,0,0,0,Mauritania
24890,3/1/2021,MRT,Pulau Pinang,0,0,0,Mauritania
24891,3/1/2021,MRT,Sabah,0,0,0,Mauritania
24892,3/1/2021,MRT,Sarawak,0,0,0,Mauritania
24893,3/1/2021,MRT,Selangor,2,2,0,Mauritania
24894,3/1/2021,MUS,Johor,0,0,0,Mauritius
24895,3/1/2021,MUS,Kedah,0,0,0,Mauritius
24896,3/1/2021,MUS,Kelantan,0,0,0,Mauritius
24897,3/1/2021,MUS,Pahang,0,0,0,Mauritius
24898,3/1/2021,MUS,Perak,0,0,0,Mauritius
24899,3/1/2021,MUS,Perlis,0,0,0,Mauritius
24900,3/1/2021,MUS,Pulau Pinang,0,0,0,Mauritius
24901,3/1/2021,MUS,Sabah,0,0,0,Mauritius
24902,3/1/2021,MUS,Sarawak,0,0,0,Mauritius
24903,3/1/2021,MUS,Selangor,27,7,20,Mauritius
24904,3/1/2021,MWI,Johor,0,0,0,Malawi
24905,3/1/2021,MWI,Pulau Pinang,0,0,0,Malawi
24906,3/1/2021,MWI,Sabah,0,0,0,Malawi
24907,3/1/2021,MWI,Sarawak,0,0,0,Malawi
24908,3/1/2021,MWI,Selangor,8,4,4,Malawi
24909,3/1/2021,MYT,Selangor,0,0,0,Mayotte
24910,3/1/2021,NAM,Johor,0,0,0,Namibia
24911,3/1/2021,NAM,Kedah,0,0,0,Namibia
24912,3/1/2021,NAM,Perak,0,0,0,Namibia
24913,3/1/2021,NAM,Perlis,0,0,0,Namibia
24914,3/1/2021,NAM,Pulau Pinang,0,0,0,Namibia
24915,3/1/2021,NAM,Sabah,0,0,0,Namibia
24916,3/1/2021,NAM,Sarawak,0,0,0,Namibia
24917,3/1/2021,NAM,Selangor,2,0,2,Namibia
24918,3/1/2021,NCL,Selangor,0,0,0,New Caledonia
24919,3/1/2021,NER,Johor,0,0,0,Niger
24920,3/1/2021,NER,Sabah,0,0,0,Niger
24921,3/1/2021,NER,Selangor,0,0,0,Niger
24922,3/1/2021,NGA,Johor,0,0,0,Nigeria
24923,3/1/2021,NGA,Kedah,0,0,0,Nigeria
24924,3/1/2021,NGA,Perlis,0,0,0,Nigeria
24925,3/1/2021,NGA,Pulau Pinang,0,0,0,Nigeria
24926,3/1/2021,NGA,Sabah,0,0,0,Nigeria
24927,3/1/2021,NGA,Sarawak,0,0,0,Nigeria
24928,3/1/2021,NGA,Selangor,139,129,10,Nigeria
24929,3/1/2021,NIC,Johor,0,0,0,Nicaragua
24930,3/1/2021,NIC,Kedah,0,0,0,Nicaragua
24931,3/1/2021,NIC,Pulau Pinang,0,0,0,Nicaragua
24932,3/1/2021,NIC,Sabah,0,0,0,Nicaragua
24933,3/1/2021,NIC,Selangor,0,0,0,Nicaragua
24934,3/1/2021,NLD,Johor,0,0,0,Netherlands
24935,3/1/2021,NLD,Kedah,0,0,0,Netherlands
24936,3/1/2021,NLD,Kelantan,0,0,0,Netherlands
24937,3/1/2021,NLD,Melaka,0,0,0,Netherlands
24938,3/1/2021,NLD,Negeri Sembilan,0,0,0,Netherlands
24939,3/1/2021,NLD,Pahang,0,0,0,Netherlands
24940,3/1/2021,NLD,Perak,0,0,0,Netherlands
24941,3/1/2021,NLD,Perlis,0,0,0,Netherlands
24942,3/1/2021,NLD,Pulau Pinang,0,0,0,Netherlands
24943,3/1/2021,NLD,Sabah,0,0,0,Netherlands
24944,3/1/2021,NLD,Sarawak,0,0,0,Netherlands
24945,3/1/2021,NLD,Selangor,46,35,11,Netherlands
24946,3/1/2021,NLD,Terengganu,0,0,0,Netherlands
24947,3/1/2021,NLD,W.P. Labuan,0,0,0,Netherlands
24948,3/1/2021,NOR,Johor,1,1,0,Norway
24949,3/1/2021,NOR,Kedah,0,0,0,Norway
24950,3/1/2021,NOR,Kelantan,0,0,0,Norway
24951,3/1/2021,NOR,Melaka,0,0,0,Norway
24952,3/1/2021,NOR,Pahang,0,0,0,Norway
24953,3/1/2021,NOR,Perak,0,0,0,Norway
24954,3/1/2021,NOR,Perlis,0,0,0,Norway
24955,3/1/2021,NOR,Pulau Pinang,0,0,0,Norway
24956,3/1/2021,NOR,Sabah,0,0,0,Norway
24957,3/1/2021,NOR,Sarawak,0,0,0,Norway
24958,3/1/2021,NOR,Selangor,13,12,1,Norway
24959,3/1/2021,NOR,W.P. Labuan,0,0,0,Norway
24960,3/1/2021,NPL,Johor,0,0,0,Nepal
24961,3/1/2021,NPL,Kedah,0,0,0,Nepal
24962,3/1/2021,NPL,Pahang,0,0,0,Nepal
24963,3/1/2021,NPL,Perak,0,0,0,Nepal
24964,3/1/2021,NPL,Perlis,0,0,0,Nepal
24965,3/1/2021,NPL,Pulau Pinang,0,0,0,Nepal
24966,3/1/2021,NPL,Sabah,0,0,0,Nepal
24967,3/1/2021,NPL,Sarawak,0,0,0,Nepal
24968,3/1/2021,NPL,Selangor,49,46,3,Nepal
24969,3/1/2021,NPL,W.P. Labuan,0,0,0,Nepal
24970,3/1/2021,NRU,Johor,0,0,0,Nauru
24971,3/1/2021,NRU,Pulau Pinang,0,0,0,Nauru
24972,3/1/2021,NRU,Selangor,0,0,0,Nauru
24973,3/1/2021,NZL,Johor,0,0,0,New Zealand
24974,3/1/2021,NZL,Kedah,0,0,0,New Zealand
24975,3/1/2021,NZL,Kelantan,0,0,0,New Zealand
24976,3/1/2021,NZL,Melaka,0,0,0,New Zealand
24977,3/1/2021,NZL,Negeri Sembilan,0,0,0,New Zealand
24978,3/1/2021,NZL,Pahang,0,0,0,New Zealand
24979,3/1/2021,NZL,Perak,0,0,0,New Zealand
24980,3/1/2021,NZL,Perlis,0,0,0,New Zealand
24981,3/1/2021,NZL,Pulau Pinang,0,0,0,New Zealand
24982,3/1/2021,NZL,Sabah,0,0,0,New Zealand
24983,3/1/2021,NZL,Sarawak,0,0,0,New Zealand
24984,3/1/2021,NZL,Selangor,11,11,0,New Zealand
24985,3/1/2021,NZL,Terengganu,0,0,0,New Zealand
24986,3/1/2021,NZL,W.P. Labuan,0,0,0,New Zealand
24987,3/1/2021,OMN,Johor,0,0,0,Oman
24988,3/1/2021,OMN,Kedah,0,0,0,Oman
24989,3/1/2021,OMN,Kelantan,0,0,0,Oman
24990,3/1/2021,OMN,Melaka,0,0,0,Oman
24991,3/1/2021,OMN,Perak,0,0,0,Oman
24992,3/1/2021,OMN,Perlis,0,0,0,Oman
24993,3/1/2021,OMN,Pulau Pinang,0,0,0,Oman
24994,3/1/2021,OMN,Sabah,0,0,0,Oman
24995,3/1/2021,OMN,Sarawak,0,0,0,Oman
24996,3/1/2021,OMN,Selangor,34,26,8,Oman
24997,3/1/2021,PAK,Johor,9,9,0,Pakistan
24998,3/1/2021,PAK,Kedah,0,0,0,Pakistan
24999,3/1/2021,PAK,Kelantan,0,0,0,Pakistan
25000,3/1/2021,PAK,Melaka,0,0,0,Pakistan
25001,3/1/2021,PAK,Negeri Sembilan,0,0,0,Pakistan
25002,3/1/2021,PAK,Pahang,0,0,0,Pakistan
25003,3/1/2021,PAK,Perak,0,0,0,Pakistan
25004,3/1/2021,PAK,Perlis,0,0,0,Pakistan
25005,3/1/2021,PAK,Pulau Pinang,0,0,0,Pakistan
25006,3/1/2021,PAK,Sabah,0,0,0,Pakistan
25007,3/1/2021,PAK,Sarawak,1,1,0,Pakistan
25008,3/1/2021,PAK,Selangor,337,275,62,Pakistan
25009,3/1/2021,PAK,W.P. Labuan,0,0,0,Pakistan
25010,3/1/2021,PAN,Johor,0,0,0,Panama
25011,3/1/2021,PAN,Kedah,0,0,0,Panama
25012,3/1/2021,PAN,Perak,0,0,0,Panama
25013,3/1/2021,PAN,Perlis,0,0,0,Panama
25014,3/1/2021,PAN,Pulau Pinang,0,0,0,Panama
25015,3/1/2021,PAN,Sabah,0,0,0,Panama
25016,3/1/2021,PAN,Sarawak,0,0,0,Panama
25017,3/1/2021,PAN,Selangor,0,0,0,Panama
25018,3/1/2021,PER,Johor,0,0,0,Peru
25019,3/1/2021,PER,Kedah,0,0,0,Peru
25020,3/1/2021,PER,Kelantan,0,0,0,Peru
25021,3/1/2021,PER,Pahang,0,0,0,Peru
25022,3/1/2021,PER,Perak,0,0,0,Peru
25023,3/1/2021,PER,Perlis,0,0,0,Peru
25024,3/1/2021,PER,Pulau Pinang,0,0,0,Peru
25025,3/1/2021,PER,Sabah,0,0,0,Peru
25026,3/1/2021,PER,Sarawak,0,0,0,Peru
25027,3/1/2021,PER,Selangor,0,0,0,Peru
25028,3/1/2021,PER,W.P. Labuan,0,0,0,Peru
25029,3/1/2021,PHL,Johor,97,94,3,Philippines
25030,3/1/2021,PHL,Kedah,0,0,0,Philippines
25031,3/1/2021,PHL,Kelantan,0,0,0,Philippines
25032,3/1/2021,PHL,Melaka,0,0,0,Philippines
25033,3/1/2021,PHL,Negeri Sembilan,0,0,0,Philippines
25034,3/1/2021,PHL,Pahang,0,0,0,Philippines
25035,3/1/2021,PHL,Perak,0,0,0,Philippines
25036,3/1/2021,PHL,Perlis,0,0,0,Philippines
25037,3/1/2021,PHL,Pulau Pinang,1,0,1,Philippines
25038,3/1/2021,PHL,Sabah,0,0,0,Philippines
25039,3/1/2021,PHL,Sarawak,66,66,0,Philippines
25040,3/1/2021,PHL,Selangor,467,368,99,Philippines
25041,3/1/2021,PHL,Terengganu,0,0,0,Philippines
25042,3/1/2021,PHL,W.P. Labuan,3,3,0,Philippines
25043,3/1/2021,PLW,Johor,0,0,0,Palau
25044,3/1/2021,PLW,Pulau Pinang,0,0,0,Palau
25045,3/1/2021,PLW,Selangor,0,0,0,Palau
25046,3/1/2021,PNG,Johor,0,0,0,Papua New Guinea
25047,3/1/2021,PNG,Kedah,0,0,0,Papua New Guinea
25048,3/1/2021,PNG,Kelantan,0,0,0,Papua New Guinea
25049,3/1/2021,PNG,Perak,0,0,0,Papua New Guinea
25050,3/1/2021,PNG,Pulau Pinang,0,0,0,Papua New Guinea
25051,3/1/2021,PNG,Sabah,0,0,0,Papua New Guinea
25052,3/1/2021,PNG,Sarawak,0,0,0,Papua New Guinea
25053,3/1/2021,PNG,Selangor,0,0,0,Papua New Guinea
25054,3/1/2021,POL,Johor,1,1,0,Poland
25055,3/1/2021,POL,Kedah,0,0,0,Poland
25056,3/1/2021,POL,Kelantan,0,0,0,Poland
25057,3/1/2021,POL,Melaka,0,0,0,Poland
25058,3/1/2021,POL,Negeri Sembilan,0,0,0,Poland
25059,3/1/2021,POL,Pahang,0,0,0,Poland
25060,3/1/2021,POL,Perak,0,0,0,Poland
25061,3/1/2021,POL,Perlis,0,0,0,Poland
25062,3/1/2021,POL,Pulau Pinang,0,0,0,Poland
25063,3/1/2021,POL,Sabah,1,1,0,Poland
25064,3/1/2021,POL,Sarawak,0,0,0,Poland
25065,3/1/2021,POL,Selangor,27,23,4,Poland
25066,3/1/2021,POL,Terengganu,0,0,0,Poland
25067,3/1/2021,POL,W.P. Labuan,0,0,0,Poland
25068,3/1/2021,PRK,Selangor,1,1,0,"Korea, Democratic People's Republic of"
25069,3/1/2021,PRT,Johor,0,0,0,Portugal
25070,3/1/2021,PRT,Kedah,0,0,0,Portugal
25071,3/1/2021,PRT,Kelantan,0,0,0,Portugal
25072,3/1/2021,PRT,Melaka,0,0,0,Portugal
25073,3/1/2021,PRT,Pahang,0,0,0,Portugal
25074,3/1/2021,PRT,Perak,0,0,0,Portugal
25075,3/1/2021,PRT,Perlis,0,0,0,Portugal
25076,3/1/2021,PRT,Pulau Pinang,0,0,0,Portugal
25077,3/1/2021,PRT,Sabah,0,0,0,Portugal
25078,3/1/2021,PRT,Sarawak,0,0,0,Portugal
25079,3/1/2021,PRT,Selangor,6,2,4,Portugal
25080,3/1/2021,PRT,W.P. Labuan,0,0,0,Portugal
25081,3/1/2021,PRY,Johor,0,0,0,Paraguay
25082,3/1/2021,PRY,Kedah,0,0,0,Paraguay
25083,3/1/2021,PRY,Perak,0,0,0,Paraguay
25084,3/1/2021,PRY,Perlis,0,0,0,Paraguay
25085,3/1/2021,PRY,Pulau Pinang,0,0,0,Paraguay
25086,3/1/2021,PRY,Sabah,0,0,0,Paraguay
25087,3/1/2021,PRY,Sarawak,0,0,0,Paraguay
25088,3/1/2021,PRY,Selangor,0,0,0,Paraguay
25089,3/1/2021,PSE,Johor,0,0,0,"Palestinian Territory, Occupied"
25090,3/1/2021,PSE,Kedah,0,0,0,"Palestinian Territory, Occupied"
25091,3/1/2021,PSE,Kelantan,0,0,0,"Palestinian Territory, Occupied"
25092,3/1/2021,PSE,Melaka,0,0,0,"Palestinian Territory, Occupied"
25093,3/1/2021,PSE,Perak,0,0,0,"Palestinian Territory, Occupied"
25094,3/1/2021,PSE,Perlis,0,0,0,"Palestinian Territory, Occupied"
25095,3/1/2021,PSE,Pulau Pinang,0,0,0,"Palestinian Territory, Occupied"
25096,3/1/2021,PSE,Sabah,0,0,0,"Palestinian Territory, Occupied"
25097,3/1/2021,PSE,Sarawak,0,0,0,"Palestinian Territory, Occupied"
25098,3/1/2021,PSE,Selangor,20,17,3,"Palestinian Territory, Occupied"
25099,3/1/2021,QAT,Johor,0,0,0,Qatar
25100,3/1/2021,QAT,Kedah,0,0,0,Qatar
25101,3/1/2021,QAT,Perlis,0,0,0,Qatar
25102,3/1/2021,QAT,Pulau Pinang,0,0,0,Qatar
25103,3/1/2021,QAT,Sabah,0,0,0,Qatar
25104,3/1/2021,QAT,Sarawak,0,0,0,Qatar
25105,3/1/2021,QAT,Selangor,8,6,2,Qatar
25106,3/1/2021,REU,Johor,0,0,0,Reunion
25107,3/1/2021,REU,Sarawak,0,0,0,Reunion
25108,3/1/2021,ROU,Johor,0,0,0,Romania
25109,3/1/2021,ROU,Kedah,0,0,0,Romania
25110,3/1/2021,ROU,Kelantan,0,0,0,Romania
25111,3/1/2021,ROU,Negeri Sembilan,0,0,0,Romania
25112,3/1/2021,ROU,Pahang,0,0,0,Romania
25113,3/1/2021,ROU,Perak,0,0,0,Romania
25114,3/1/2021,ROU,Perlis,0,0,0,Romania
25115,3/1/2021,ROU,Pulau Pinang,0,0,0,Romania
25116,3/1/2021,ROU,Sabah,0,0,0,Romania
25117,3/1/2021,ROU,Sarawak,0,0,0,Romania
25118,3/1/2021,ROU,Selangor,28,24,4,Romania
25119,3/1/2021,ROU,W.P. Labuan,0,0,0,Romania
25120,3/1/2021,RUS,Johor,0,0,0,Russia
25121,3/1/2021,RUS,Kedah,0,0,0,Russia
25122,3/1/2021,RUS,Kelantan,0,0,0,Russia
25123,3/1/2021,RUS,Melaka,0,0,0,Russia
25124,3/1/2021,RUS,Negeri Sembilan,0,0,0,Russia
25125,3/1/2021,RUS,Pahang,0,0,0,Russia
25126,3/1/2021,RUS,Perak,0,0,0,Russia
25127,3/1/2021,RUS,Perlis,0,0,0,Russia
25128,3/1/2021,RUS,Pulau Pinang,0,0,0,Russia
25129,3/1/2021,RUS,Sabah,0,0,0,Russia
25130,3/1/2021,RUS,Sarawak,0,0,0,Russia
25131,3/1/2021,RUS,Selangor,58,45,13,Russia
25132,3/1/2021,RUS,W.P. Labuan,0,0,0,Russia
25133,3/1/2021,RWA,Johor,0,0,0,Rwanda
25134,3/1/2021,RWA,Kedah,0,0,0,Rwanda
25135,3/1/2021,RWA,Pulau Pinang,0,0,0,Rwanda
25136,3/1/2021,RWA,Selangor,0,0,0,Rwanda
25137,3/1/2021,SAU,Johor,0,0,0,Saudi Arabia
25138,3/1/2021,SAU,Kedah,0,0,0,Saudi Arabia
25139,3/1/2021,SAU,Kelantan,0,0,0,Saudi Arabia
25140,3/1/2021,SAU,Melaka,0,0,0,Saudi Arabia
25141,3/1/2021,SAU,Perak,0,0,0,Saudi Arabia
25142,3/1/2021,SAU,Perlis,0,0,0,Saudi Arabia
25143,3/1/2021,SAU,Pulau Pinang,0,0,0,Saudi Arabia
25144,3/1/2021,SAU,Sabah,0,0,0,Saudi Arabia
25145,3/1/2021,SAU,Sarawak,0,0,0,Saudi Arabia
25146,3/1/2021,SAU,Selangor,81,46,35,Saudi Arabia
25147,3/1/2021,SAU,W.P. Labuan,0,0,0,Saudi Arabia
25148,3/1/2021,SDN,Johor,0,0,0,Sudan
25149,3/1/2021,SDN,Kedah,0,0,0,Sudan
25150,3/1/2021,SDN,Kelantan,0,0,0,Sudan
25151,3/1/2021,SDN,Perlis,0,0,0,Sudan
25152,3/1/2021,SDN,Pulau Pinang,0,0,0,Sudan
25153,3/1/2021,SDN,Sabah,0,0,0,Sudan
25154,3/1/2021,SDN,Sarawak,0,0,0,Sudan
25155,3/1/2021,SDN,Selangor,59,40,19,Sudan
25156,3/1/2021,SDN,W.P. Labuan,0,0,0,Sudan
25157,3/1/2021,SEN,Johor,0,0,0,Senegal
25158,3/1/2021,SEN,Kedah,0,0,0,Senegal
25159,3/1/2021,SEN,Kelantan,0,0,0,Senegal
25160,3/1/2021,SEN,Perak,0,0,0,Senegal
25161,3/1/2021,SEN,Perlis,0,0,0,Senegal
25162,3/1/2021,SEN,Pulau Pinang,0,0,0,Senegal
25163,3/1/2021,SEN,Sabah,0,0,0,Senegal
25164,3/1/2021,SEN,Sarawak,0,0,0,Senegal
25165,3/1/2021,SEN,Selangor,3,2,1,Senegal
25166,3/1/2021,SGP,Johor,297,261,36,Singapore
25167,3/1/2021,SGP,Kedah,0,0,0,Singapore
25168,3/1/2021,SGP,Kelantan,0,0,0,Singapore
25169,3/1/2021,SGP,Melaka,0,0,0,Singapore
25170,3/1/2021,SGP,Negeri Sembilan,0,0,0,Singapore
25171,3/1/2021,SGP,Pahang,0,0,0,Singapore
25172,3/1/2021,SGP,Perak,2,0,2,Singapore
25173,3/1/2021,SGP,Perlis,0,0,0,Singapore
25174,3/1/2021,SGP,Pulau Pinang,23,13,10,Singapore
25175,3/1/2021,SGP,Sabah,0,0,0,Singapore
25176,3/1/2021,SGP,Sarawak,8,4,4,Singapore
25177,3/1/2021,SGP,Selangor,163,116,47,Singapore
25178,3/1/2021,SGP,Terengganu,0,0,0,Singapore
25179,3/1/2021,SGP,W.P. Labuan,0,0,0,Singapore
25180,3/1/2021,SGS,Johor,0,0,0,South Georgia and the South Sandwich Islands
25181,3/1/2021,SGS,Sabah,0,0,0,South Georgia and the South Sandwich Islands
25182,3/1/2021,SGS,Selangor,0,0,0,South Georgia and the South Sandwich Islands
25183,3/1/2021,SHN,Sarawak,0,0,0,"Saint Helena, Ascension and Tristan da Cunha"
25184,3/1/2021,SLB,Johor,0,0,0,Solomon Islands
25185,3/1/2021,SLB,Perlis,0,0,0,Solomon Islands
25186,3/1/2021,SLB,Pulau Pinang,0,0,0,Solomon Islands
25187,3/1/2021,SLB,Sabah,0,0,0,Solomon Islands
25188,3/1/2021,SLB,Sarawak,0,0,0,Solomon Islands
25189,3/1/2021,SLB,Selangor,0,0,0,Solomon Islands
25190,3/1/2021,SLB,W.P. Labuan,0,0,0,Solomon Islands
25191,3/1/2021,SLE,Johor,0,0,0,Sierra Leone
25192,3/1/2021,SLE,Kedah,0,0,0,Sierra Leone
25193,3/1/2021,SLE,Perak,0,0,0,Sierra Leone
25194,3/1/2021,SLE,Pulau Pinang,0,0,0,Sierra Leone
25195,3/1/2021,SLE,Sabah,0,0,0,Sierra Leone
25196,3/1/2021,SLE,Selangor,5,0,5,Sierra Leone
25197,3/1/2021,SLV,Johor,0,0,0,El Salvador
25198,3/1/2021,SLV,Kedah,0,0,0,El Salvador
25199,3/1/2021,SLV,Perak,0,0,0,El Salvador
25200,3/1/2021,SLV,Perlis,0,0,0,El Salvador
25201,3/1/2021,SLV,Pulau Pinang,0,0,0,El Salvador
25202,3/1/2021,SLV,Sabah,0,0,0,El Salvador
25203,3/1/2021,SLV,Selangor,1,1,0,El Salvador
25204,3/1/2021,SLV,W.P. Labuan,0,0,0,El Salvador
25205,3/1/2021,SMR,Johor,0,0,0,San Marino
25206,3/1/2021,SMR,Selangor,0,0,0,San Marino
25207,3/1/2021,SOM,Johor,0,0,0,Somalia
25208,3/1/2021,SOM,Kedah,0,0,0,Somalia
25209,3/1/2021,SOM,Kelantan,0,0,0,Somalia
25210,3/1/2021,SOM,Perlis,0,0,0,Somalia
25211,3/1/2021,SOM,Sabah,0,0,0,Somalia
25212,3/1/2021,SOM,Sarawak,0,0,0,Somalia
25213,3/1/2021,SOM,Selangor,36,26,10,Somalia
25214,3/1/2021,SRB,Johor,0,0,0,Serbia
25215,3/1/2021,SRB,Kedah,0,0,0,Serbia
25216,3/1/2021,SRB,Kelantan,0,0,0,Serbia
25217,3/1/2021,SRB,Pahang,0,0,0,Serbia
25218,3/1/2021,SRB,Perak,0,0,0,Serbia
25219,3/1/2021,SRB,Perlis,0,0,0,Serbia
25220,3/1/2021,SRB,Pulau Pinang,0,0,0,Serbia
25221,3/1/2021,SRB,Sabah,0,0,0,Serbia
25222,3/1/2021,SRB,Sarawak,0,0,0,Serbia
25223,3/1/2021,SRB,Selangor,1,1,0,Serbia
25224,3/1/2021,STP,Selangor,0,0,0,Sao Tome and Principe
25225,3/1/2021,SUR,Johor,0,0,0,Suriname
25226,3/1/2021,SUR,Kedah,0,0,0,Suriname
25227,3/1/2021,SUR,Kelantan,0,0,0,Suriname
25228,3/1/2021,SUR,Perak,0,0,0,Suriname
25229,3/1/2021,SUR,Perlis,0,0,0,Suriname
25230,3/1/2021,SUR,Pulau Pinang,0,0,0,Suriname
25231,3/1/2021,SUR,Sabah,0,0,0,Suriname
25232,3/1/2021,SUR,Sarawak,0,0,0,Suriname
25233,3/1/2021,SUR,Selangor,0,0,0,Suriname
25234,3/1/2021,SVK,Johor,0,0,0,Slovakia
25235,3/1/2021,SVK,Kedah,0,0,0,Slovakia
25236,3/1/2021,SVK,Kelantan,0,0,0,Slovakia
25237,3/1/2021,SVK,Negeri Sembilan,0,0,0,Slovakia
25238,3/1/2021,SVK,Pahang,0,0,0,Slovakia
25239,3/1/2021,SVK,Perak,0,0,0,Slovakia
25240,3/1/2021,SVK,Perlis,0,0,0,Slovakia
25241,3/1/2021,SVK,Pulau Pinang,0,0,0,Slovakia
25242,3/1/2021,SVK,Sabah,0,0,0,Slovakia
25243,3/1/2021,SVK,Sarawak,0,0,0,Slovakia
25244,3/1/2021,SVK,Selangor,12,10,2,Slovakia
25245,3/1/2021,SVK,W.P. Labuan,0,0,0,Slovakia
25246,3/1/2021,SVN,Johor,0,0,0,Slovenia
25247,3/1/2021,SVN,Kedah,0,0,0,Slovenia
25248,3/1/2021,SVN,Kelantan,0,0,0,Slovenia
25249,3/1/2021,SVN,Perak,0,0,0,Slovenia
25250,3/1/2021,SVN,Perlis,0,0,0,Slovenia
25251,3/1/2021,SVN,Pulau Pinang,0,0,0,Slovenia
25252,3/1/2021,SVN,Sabah,0,0,0,Slovenia
25253,3/1/2021,SVN,Sarawak,0,0,0,Slovenia
25254,3/1/2021,SVN,Selangor,2,2,0,Slovenia
25255,3/1/2021,SVN,W.P. Labuan,0,0,0,Slovenia
25256,3/1/2021,SWE,Johor,0,0,0,Sweden
25257,3/1/2021,SWE,Kedah,0,0,0,Sweden
25258,3/1/2021,SWE,Kelantan,0,0,0,Sweden
25259,3/1/2021,SWE,Melaka,0,0,0,Sweden
25260,3/1/2021,SWE,Negeri Sembilan,0,0,0,Sweden
25261,3/1/2021,SWE,Pahang,0,0,0,Sweden
25262,3/1/2021,SWE,Perak,0,0,0,Sweden
25263,3/1/2021,SWE,Perlis,0,0,0,Sweden
25264,3/1/2021,SWE,Pulau Pinang,0,0,0,Sweden
25265,3/1/2021,SWE,Sabah,0,0,0,Sweden
25266,3/1/2021,SWE,Sarawak,0,0,0,Sweden
25267,3/1/2021,SWE,Selangor,28,26,2,Sweden
25268,3/1/2021,SWE,W.P. Labuan,0,0,0,Sweden
25269,3/1/2021,SWZ,Johor,0,0,0,Swaziland
25270,3/1/2021,SWZ,Kedah,0,0,0,Swaziland
25271,3/1/2021,SWZ,Pulau Pinang,0,0,0,Swaziland
25272,3/1/2021,SWZ,Sabah,0,0,0,Swaziland
25273,3/1/2021,SWZ,Selangor,3,0,3,Swaziland
25274,3/1/2021,SYC,Johor,0,0,0,Seychelles
25275,3/1/2021,SYC,Kedah,0,0,0,Seychelles
25276,3/1/2021,SYC,Pulau Pinang,0,0,0,Seychelles
25277,3/1/2021,SYC,Sabah,0,0,0,Seychelles
25278,3/1/2021,SYC,Sarawak,0,0,0,Seychelles
25279,3/1/2021,SYC,Selangor,13,8,5,Seychelles
25280,3/1/2021,SYR,Johor,0,0,0,Syrian Arab Republic
25281,3/1/2021,SYR,Kedah,0,0,0,Syrian Arab Republic
25282,3/1/2021,SYR,Kelantan,0,0,0,Syrian Arab Republic
25283,3/1/2021,SYR,Pahang,0,0,0,Syrian Arab Republic
25284,3/1/2021,SYR,Perlis,0,0,0,Syrian Arab Republic
25285,3/1/2021,SYR,Pulau Pinang,0,0,0,Syrian Arab Republic
25286,3/1/2021,SYR,Sabah,0,0,0,Syrian Arab Republic
25287,3/1/2021,SYR,Sarawak,0,0,0,Syrian Arab Republic
25288,3/1/2021,SYR,Selangor,51,30,21,Syrian Arab Republic
25289,3/1/2021,SYR,W.P. Labuan,0,0,0,Syrian Arab Republic
25290,3/1/2021,TCA,Perlis,0,0,0,Turks and Caicos
25291,3/1/2021,TCD,Johor,0,0,0,Chad
25292,3/1/2021,TCD,Kedah,0,0,0,Chad
25293,3/1/2021,TCD,Perlis,0,0,0,Chad
25294,3/1/2021,TCD,Selangor,2,2,0,Chad
25295,3/1/2021,TGO,Johor,0,0,0,Togo
25296,3/1/2021,TGO,Perak,0,0,0,Togo
25297,3/1/2021,TGO,Pulau Pinang,0,0,0,Togo
25298,3/1/2021,TGO,Selangor,0,0,0,Togo
25299,3/1/2021,THA,Johor,0,0,0,Thailand
25300,3/1/2021,THA,Kedah,19195,19146,49,Thailand
25301,3/1/2021,THA,Kelantan,4,2,2,Thailand
25302,3/1/2021,THA,Melaka,0,0,0,Thailand
25303,3/1/2021,THA,Negeri Sembilan,0,0,0,Thailand
25304,3/1/2021,THA,Pahang,0,0,0,Thailand
25305,3/1/2021,THA,Perak,2,0,2,Thailand
25306,3/1/2021,THA,Perlis,10965,10607,358,Thailand
25307,3/1/2021,THA,Pulau Pinang,19,17,2,Thailand
25308,3/1/2021,THA,Sabah,0,0,0,Thailand
25309,3/1/2021,THA,Sarawak,11,10,1,Thailand
25310,3/1/2021,THA,Selangor,369,223,146,Thailand
25311,3/1/2021,THA,Terengganu,0,0,0,Thailand
25312,3/1/2021,THA,W.P. Labuan,0,0,0,Thailand
25313,3/1/2021,TJK,Johor,0,0,0,Tajikistan
25314,3/1/2021,TJK,Kedah,0,0,0,Tajikistan
25315,3/1/2021,TJK,Perlis,0,0,0,Tajikistan
25316,3/1/2021,TJK,Pulau Pinang,0,0,0,Tajikistan
25317,3/1/2021,TJK,Sabah,0,0,0,Tajikistan
25318,3/1/2021,TJK,Selangor,1,1,0,Tajikistan
25319,3/1/2021,TKL,Selangor,0,0,0,Tokelau
25320,3/1/2021,TKM,Johor,0,0,0,Turkmenistan
25321,3/1/2021,TKM,Kedah,0,0,0,Turkmenistan
25322,3/1/2021,TKM,Kelantan,0,0,0,Turkmenistan
25323,3/1/2021,TKM,Perlis,0,0,0,Turkmenistan
25324,3/1/2021,TKM,Pulau Pinang,0,0,0,Turkmenistan
25325,3/1/2021,TKM,Sabah,0,0,0,Turkmenistan
25326,3/1/2021,TKM,Sarawak,0,0,0,Turkmenistan
25327,3/1/2021,TKM,Selangor,0,0,0,Turkmenistan
25328,3/1/2021,TLS,Johor,0,0,0,Timor-Leste
25329,3/1/2021,TLS,Kedah,0,0,0,Timor-Leste
25330,3/1/2021,TLS,Perlis,0,0,0,Timor-Leste
25331,3/1/2021,TLS,Pulau Pinang,0,0,0,Timor-Leste
25332,3/1/2021,TLS,Sabah,0,0,0,Timor-Leste
25333,3/1/2021,TLS,Sarawak,0,0,0,Timor-Leste
25334,3/1/2021,TLS,Selangor,1,0,1,Timor-Leste
25335,3/1/2021,TON,Johor,0,0,0,Tonga
25336,3/1/2021,TON,Pulau Pinang,0,0,0,Tonga
25337,3/1/2021,TON,Sarawak,0,0,0,Tonga
25338,3/1/2021,TON,Selangor,0,0,0,Tonga
25339,3/1/2021,TTO,Johor,0,0,0,Trinidad and Tobago
25340,3/1/2021,TTO,Kedah,0,0,0,Trinidad and Tobago
25341,3/1/2021,TTO,Pahang,0,0,0,Trinidad and Tobago
25342,3/1/2021,TTO,Pulau Pinang,0,0,0,Trinidad and Tobago
25343,3/1/2021,TTO,Sabah,0,0,0,Trinidad and Tobago
25344,3/1/2021,TTO,Sarawak,0,0,0,Trinidad and Tobago
25345,3/1/2021,TTO,Selangor,0,0,0,Trinidad and Tobago
25346,3/1/2021,TUN,Johor,0,0,0,Tunisia
25347,3/1/2021,TUN,Kedah,0,0,0,Tunisia
25348,3/1/2021,TUN,Kelantan,0,0,0,Tunisia
25349,3/1/2021,TUN,Melaka,0,0,0,Tunisia
25350,3/1/2021,TUN,Perak,0,0,0,Tunisia
25351,3/1/2021,TUN,Perlis,0,0,0,Tunisia
25352,3/1/2021,TUN,Pulau Pinang,0,0,0,Tunisia
25353,3/1/2021,TUN,Sabah,0,0,0,Tunisia
25354,3/1/2021,TUN,Sarawak,0,0,0,Tunisia
25355,3/1/2021,TUN,Selangor,9,2,7,Tunisia
25356,3/1/2021,TUN,W.P. Labuan,0,0,0,Tunisia
25357,3/1/2021,TUR,Johor,0,0,0,Turkey
25358,3/1/2021,TUR,Kedah,0,0,0,Turkey
25359,3/1/2021,TUR,Kelantan,0,0,0,Turkey
25360,3/1/2021,TUR,Melaka,0,0,0,Turkey
25361,3/1/2021,TUR,Negeri Sembilan,0,0,0,Turkey
25362,3/1/2021,TUR,Pahang,0,0,0,Turkey
25363,3/1/2021,TUR,Perak,0,0,0,Turkey
25364,3/1/2021,TUR,Perlis,0,0,0,Turkey
25365,3/1/2021,TUR,Pulau Pinang,0,0,0,Turkey
25366,3/1/2021,TUR,Sabah,0,0,0,Turkey
25367,3/1/2021,TUR,Sarawak,0,0,0,Turkey
25368,3/1/2021,TUR,Selangor,30,25,5,Turkey
25369,3/1/2021,TUR,W.P. Labuan,0,0,0,Turkey
25370,3/1/2021,TUV,Selangor,0,0,0,Tuvalu
25371,3/1/2021,TWN,Johor,0,0,0,Taiwan
25372,3/1/2021,TWN,Kedah,0,0,0,Taiwan
25373,3/1/2021,TWN,Kelantan,0,0,0,Taiwan
25374,3/1/2021,TWN,Melaka,0,0,0,Taiwan
25375,3/1/2021,TWN,Negeri Sembilan,0,0,0,Taiwan
25376,3/1/2021,TWN,Pahang,0,0,0,Taiwan
25377,3/1/2021,TWN,Perak,0,0,0,Taiwan
25378,3/1/2021,TWN,Perlis,0,0,0,Taiwan
25379,3/1/2021,TWN,Pulau Pinang,11,7,4,Taiwan
25380,3/1/2021,TWN,Sabah,0,0,0,Taiwan
25381,3/1/2021,TWN,Sarawak,0,0,0,Taiwan
25382,3/1/2021,TWN,Selangor,111,71,40,Taiwan
25383,3/1/2021,TWN,W.P. Labuan,0,0,0,Taiwan
25384,3/1/2021,TZA,Johor,0,0,0,"Tanzania, United Republic of"
25385,3/1/2021,TZA,Kedah,0,0,0,"Tanzania, United Republic of"
25386,3/1/2021,TZA,Perak,0,0,0,"Tanzania, United Republic of"
25387,3/1/2021,TZA,Perlis,0,0,0,"Tanzania, United Republic of"
25388,3/1/2021,TZA,Pulau Pinang,0,0,0,"Tanzania, United Republic of"
25389,3/1/2021,TZA,Sabah,0,0,0,"Tanzania, United Republic of"
25390,3/1/2021,TZA,Sarawak,0,0,0,"Tanzania, United Republic of"
25391,3/1/2021,TZA,Selangor,38,20,18,"Tanzania, United Republic of"
25392,3/1/2021,UGA,Johor,0,0,0,Uganda
25393,3/1/2021,UGA,Kedah,0,0,0,Uganda
25394,3/1/2021,UGA,Perak,0,0,0,Uganda
25395,3/1/2021,UGA,Perlis,0,0,0,Uganda
25396,3/1/2021,UGA,Pulau Pinang,0,0,0,Uganda
25397,3/1/2021,UGA,Sabah,0,0,0,Uganda
25398,3/1/2021,UGA,Sarawak,0,0,0,Uganda
25399,3/1/2021,UGA,Selangor,5,3,2,Uganda
25400,3/1/2021,UKR,Johor,24,24,0,Ukraine
25401,3/1/2021,UKR,Kedah,0,0,0,Ukraine
25402,3/1/2021,UKR,Kelantan,0,0,0,Ukraine
25403,3/1/2021,UKR,Melaka,0,0,0,Ukraine
25404,3/1/2021,UKR,Negeri Sembilan,0,0,0,Ukraine
25405,3/1/2021,UKR,Pahang,0,0,0,Ukraine
25406,3/1/2021,UKR,Perak,0,0,0,Ukraine
25407,3/1/2021,UKR,Perlis,0,0,0,Ukraine
25408,3/1/2021,UKR,Pulau Pinang,0,0,0,Ukraine
25409,3/1/2021,UKR,Sabah,0,0,0,Ukraine
25410,3/1/2021,UKR,Sarawak,0,0,0,Ukraine
25411,3/1/2021,UKR,Selangor,47,44,3,Ukraine
25412,3/1/2021,UKR,W.P. Labuan,0,0,0,Ukraine
25413,3/1/2021,URY,Johor,0,0,0,Uruguay
25414,3/1/2021,URY,Kedah,0,0,0,Uruguay
25415,3/1/2021,URY,Kelantan,0,0,0,Uruguay
25416,3/1/2021,URY,Perak,0,0,0,Uruguay
25417,3/1/2021,URY,Perlis,0,0,0,Uruguay
25418,3/1/2021,URY,Pulau Pinang,0,0,0,Uruguay
25419,3/1/2021,URY,Sabah,0,0,0,Uruguay
25420,3/1/2021,URY,Sarawak,0,0,0,Uruguay
25421,3/1/2021,URY,Selangor,0,0,0,Uruguay
25422,3/1/2021,URY,W.P. Labuan,0,0,0,Uruguay
25423,3/1/2021,USA,Johor,1,1,0,United States Of America
25424,3/1/2021,USA,Kedah,0,0,0,United States Of America
25425,3/1/2021,USA,Kelantan,0,0,0,United States Of America
25426,3/1/2021,USA,Melaka,0,0,0,United States Of America
25427,3/1/2021,USA,Negeri Sembilan,0,0,0,United States Of America
25428,3/1/2021,USA,Pahang,0,0,0,United States Of America
25429,3/1/2021,USA,Perak,0,0,0,United States Of America
25430,3/1/2021,USA,Perlis,0,0,0,United States Of America
25431,3/1/2021,USA,Pulau Pinang,4,4,0,United States Of America
25432,3/1/2021,USA,Sabah,0,0,0,United States Of America
25433,3/1/2021,USA,Sarawak,1,1,0,United States Of America
25434,3/1/2021,USA,Selangor,150,108,42,United States Of America
25435,3/1/2021,USA,Terengganu,0,0,0,United States Of America
25436,3/1/2021,USA,W.P. Labuan,0,0,0,United States Of America
25437,3/1/2021,UZB,Johor,0,0,0,Uzbekistan
25438,3/1/2021,UZB,Kedah,0,0,0,Uzbekistan
25439,3/1/2021,UZB,Kelantan,0,0,0,Uzbekistan
25440,3/1/2021,UZB,Perak,0,0,0,Uzbekistan
25441,3/1/2021,UZB,Perlis,0,0,0,Uzbekistan
25442,3/1/2021,UZB,Pulau Pinang,0,0,0,Uzbekistan
25443,3/1/2021,UZB,Sabah,0,0,0,Uzbekistan
25444,3/1/2021,UZB,Sarawak,0,0,0,Uzbekistan
25445,3/1/2021,UZB,Selangor,14,11,3,Uzbekistan
25446,3/1/2021,VAT,Johor,0,0,0,Holy See (Vatican City State)
25447,3/1/2021,VAT,Sarawak,0,0,0,Holy See (Vatican City State)
25448,3/1/2021,VAT,Selangor,1,1,0,Holy See (Vatican City State)
25449,3/1/2021,VCT,Johor,0,0,0,Saint Vincent and the Grenadines
25450,3/1/2021,VCT,Kedah,0,0,0,Saint Vincent and the Grenadines
25451,3/1/2021,VCT,Pulau Pinang,0,0,0,Saint Vincent and the Grenadines
25452,3/1/2021,VCT,Sarawak,0,0,0,Saint Vincent and the Grenadines
25453,3/1/2021,VCT,Selangor,0,0,0,Saint Vincent and the Grenadines
25454,3/1/2021,VEN,Johor,0,0,0,Venezuela
25455,3/1/2021,VEN,Kedah,0,0,0,Venezuela
25456,3/1/2021,VEN,Kelantan,0,0,0,Venezuela
25457,3/1/2021,VEN,Melaka,0,0,0,Venezuela
25458,3/1/2021,VEN,Perak,0,0,0,Venezuela
25459,3/1/2021,VEN,Perlis,0,0,0,Venezuela
25460,3/1/2021,VEN,Pulau Pinang,0,0,0,Venezuela
25461,3/1/2021,VEN,Sabah,0,0,0,Venezuela
25462,3/1/2021,VEN,Sarawak,0,0,0,Venezuela
25463,3/1/2021,VEN,Selangor,2,2,0,Venezuela
25464,3/1/2021,VEN,W.P. Labuan,0,0,0,Venezuela
25465,3/1/2021,VNM,Johor,1,0,1,Vietnam
25466,3/1/2021,VNM,Kedah,0,0,0,Vietnam
25467,3/1/2021,VNM,Kelantan,0,0,0,Vietnam
25468,3/1/2021,VNM,Melaka,0,0,0,Vietnam
25469,3/1/2021,VNM,Negeri Sembilan,0,0,0,Vietnam
25470,3/1/2021,VNM,Pahang,0,0,0,Vietnam
25471,3/1/2021,VNM,Perak,0,0,0,Vietnam
25472,3/1/2021,VNM,Perlis,0,0,0,Vietnam
25473,3/1/2021,VNM,Pulau Pinang,1,0,1,Vietnam
25474,3/1/2021,VNM,Sabah,0,0,0,Vietnam
25475,3/1/2021,VNM,Sarawak,0,0,0,Vietnam
25476,3/1/2021,VNM,Selangor,113,34,79,Vietnam
25477,3/1/2021,VNM,Terengganu,18,18,0,Vietnam
25478,3/1/2021,VNM,W.P. Labuan,0,0,0,Vietnam
25479,3/1/2021,VUT,Johor,0,0,0,Vanuatu
25480,3/1/2021,VUT,Kedah,0,0,0,Vanuatu
25481,3/1/2021,VUT,Pulau Pinang,0,0,0,Vanuatu
25482,3/1/2021,VUT,Sabah,0,0,0,Vanuatu
25483,3/1/2021,VUT,Sarawak,0,0,0,Vanuatu
25484,3/1/2021,VUT,Selangor,1,1,0,Vanuatu
25485,3/1/2021,WSM,Johor,0,0,0,Samoa
25486,3/1/2021,WSM,Sarawak,0,0,0,Samoa
25487,3/1/2021,WSM,Selangor,0,0,0,Samoa
25488,3/1/2021,YEM,Johor,0,0,0,Yemen
25489,3/1/2021,YEM,Kedah,0,0,0,Yemen
25490,3/1/2021,YEM,Kelantan,0,0,0,Yemen
25491,3/1/2021,YEM,Melaka,0,0,0,Yemen
25492,3/1/2021,YEM,Pahang,0,0,0,Yemen
25493,3/1/2021,YEM,Perak,0,0,0,Yemen
25494,3/1/2021,YEM,Perlis,0,0,0,Yemen
25495,3/1/2021,YEM,Pulau Pinang,0,0,0,Yemen
25496,3/1/2021,YEM,Sabah,0,0,0,Yemen
25497,3/1/2021,YEM,Sarawak,0,0,0,Yemen
25498,3/1/2021,YEM,Selangor,83,70,13,Yemen
25499,3/1/2021,YEM,W.P. Labuan,0,0,0,Yemen
25500,3/1/2021,ZAF,Johor,3,3,0,South Africa
25501,3/1/2021,ZAF,Kedah,0,0,0,South Africa
25502,3/1/2021,ZAF,Kelantan,0,0,0,South Africa
25503,3/1/2021,ZAF,Melaka,0,0,0,South Africa
25504,3/1/2021,ZAF,Pahang,0,0,0,South Africa
25505,3/1/2021,ZAF,Perak,0,0,0,South Africa
25506,3/1/2021,ZAF,Perlis,0,0,0,South Africa
25507,3/1/2021,ZAF,Pulau Pinang,0,0,0,South Africa
25508,3/1/2021,ZAF,Sabah,0,0,0,South Africa
25509,3/1/2021,ZAF,Sarawak,0,0,0,South Africa
25510,3/1/2021,ZAF,Selangor,68,50,18,South Africa
25511,3/1/2021,ZAF,Terengganu,0,0,0,South Africa
25512,3/1/2021,ZAF,W.P. Labuan,0,0,0,South Africa
25513,3/1/2021,ZMB,Johor,0,0,0,Zambia
25514,3/1/2021,ZMB,Kedah,0,0,0,Zambia
25515,3/1/2021,ZMB,Perak,0,0,0,Zambia
25516,3/1/2021,ZMB,Perlis,0,0,0,Zambia
25517,3/1/2021,ZMB,Pulau Pinang,0,0,0,Zambia
25518,3/1/2021,ZMB,Sabah,0,0,0,Zambia
25519,3/1/2021,ZMB,Sarawak,0,0,0,Zambia
25520,3/1/2021,ZMB,Selangor,24,13,11,Zambia
25521,3/1/2021,ZWE,Johor,0,0,0,Zimbabwe
25522,3/1/2021,ZWE,Kedah,0,0,0,Zimbabwe
25523,3/1/2021,ZWE,Kelantan,0,0,0,Zimbabwe
25524,3/1/2021,ZWE,Perak,0,0,0,Zimbabwe
25525,3/1/2021,ZWE,Perlis,0,0,0,Zimbabwe
25526,3/1/2021,ZWE,Pulau Pinang,0,0,0,Zimbabwe
25527,3/1/2021,ZWE,Sabah,0,0,0,Zimbabwe
25528,3/1/2021,ZWE,Sarawak,0,0,0,Zimbabwe
25529,3/1/2021,ZWE,Selangor,11,5,6,Zimbabwe
25530,4/1/2021,ABW,Kedah,0,0,0,Aruba
25531,4/1/2021,ABW,Pulau Pinang,0,0,0,Aruba
25532,4/1/2021,AFG,Johor,0,0,0,Afghanistan
25533,4/1/2021,AFG,Kedah,0,0,0,Afghanistan
25534,4/1/2021,AFG,Perlis,0,0,0,Afghanistan
25535,4/1/2021,AFG,Pulau Pinang,0,0,0,Afghanistan
25536,4/1/2021,AFG,Sarawak,0,0,0,Afghanistan
25537,4/1/2021,AFG,Selangor,30,26,4,Afghanistan
25538,4/1/2021,AGO,Johor,0,0,0,Angola
25539,4/1/2021,AGO,Kedah,0,0,0,Angola
25540,4/1/2021,AGO,Sabah,0,0,0,Angola
25541,4/1/2021,AGO,Selangor,0,0,0,Angola
25542,4/1/2021,AIA,Selangor,0,0,0,Anguilla
25543,4/1/2021,ALB,Johor,0,0,0,Albania
25544,4/1/2021,ALB,Kedah,0,0,0,Albania
25545,4/1/2021,ALB,Perak,0,0,0,Albania
25546,4/1/2021,ALB,Perlis,0,0,0,Albania
25547,4/1/2021,ALB,Pulau Pinang,0,0,0,Albania
25548,4/1/2021,ALB,Sabah,0,0,0,Albania
25549,4/1/2021,ALB,Sarawak,0,0,0,Albania
25550,4/1/2021,ALB,Selangor,4,3,1,Albania
25551,4/1/2021,AND,Johor,0,0,0,Andorra
25552,4/1/2021,AND,Kedah,0,0,0,Andorra
25553,4/1/2021,AND,Perlis,0,0,0,Andorra
25554,4/1/2021,AND,Pulau Pinang,0,0,0,Andorra
25555,4/1/2021,AND,Selangor,0,0,0,Andorra
25556,4/1/2021,ANT,Selangor,0,0,0,Netherlands Antilles
25557,4/1/2021,ARE,Johor,0,0,0,United Arab Emirates
25558,4/1/2021,ARE,Kedah,0,0,0,United Arab Emirates
25559,4/1/2021,ARE,Kelantan,0,0,0,United Arab Emirates
25560,4/1/2021,ARE,Perak,0,0,0,United Arab Emirates
25561,4/1/2021,ARE,Perlis,0,0,0,United Arab Emirates
25562,4/1/2021,ARE,Pulau Pinang,0,0,0,United Arab Emirates
25563,4/1/2021,ARE,Sabah,0,0,0,United Arab Emirates
25564,4/1/2021,ARE,Sarawak,0,0,0,United Arab Emirates
25565,4/1/2021,ARE,Selangor,5,4,1,United Arab Emirates
25566,4/1/2021,ARG,Johor,0,0,0,Argentina
25567,4/1/2021,ARG,Kedah,0,0,0,Argentina
25568,4/1/2021,ARG,Kelantan,0,0,0,Argentina
25569,4/1/2021,ARG,Melaka,0,0,0,Argentina
25570,4/1/2021,ARG,Perak,0,0,0,Argentina
25571,4/1/2021,ARG,Perlis,0,0,0,Argentina
25572,4/1/2021,ARG,Pulau Pinang,0,0,0,Argentina
25573,4/1/2021,ARG,Sabah,0,0,0,Argentina
25574,4/1/2021,ARG,Sarawak,0,0,0,Argentina
25575,4/1/2021,ARG,Selangor,2,1,1,Argentina
25576,4/1/2021,ARG,W.P. Labuan,0,0,0,Argentina
25577,4/1/2021,ARM,Johor,0,0,0,Armenia
25578,4/1/2021,ARM,Kedah,0,0,0,Armenia
25579,4/1/2021,ARM,Kelantan,0,0,0,Armenia
25580,4/1/2021,ARM,Perak,0,0,0,Armenia
25581,4/1/2021,ARM,Perlis,0,0,0,Armenia
25582,4/1/2021,ARM,Pulau Pinang,0,0,0,Armenia
25583,4/1/2021,ARM,Sabah,0,0,0,Armenia
25584,4/1/2021,ARM,Sarawak,0,0,0,Armenia
25585,4/1/2021,ARM,Selangor,1,1,0,Armenia
25586,4/1/2021,ATA,Selangor,0,0,0,Antarctica
25587,4/1/2021,ATG,Johor,0,0,0,Antigua and Barbuda
25588,4/1/2021,ATG,Kedah,0,0,0,Antigua and Barbuda
25589,4/1/2021,ATG,Pulau Pinang,0,0,0,Antigua and Barbuda
25590,4/1/2021,ATG,Sarawak,0,0,0,Antigua and Barbuda
25591,4/1/2021,ATG,Selangor,0,0,0,Antigua and Barbuda
25592,4/1/2021,AUS,Johor,1,1,0,Australia
25593,4/1/2021,AUS,Kedah,0,0,0,Australia
25594,4/1/2021,AUS,Kelantan,0,0,0,Australia
25595,4/1/2021,AUS,Melaka,0,0,0,Australia
25596,4/1/2021,AUS,Negeri Sembilan,0,0,0,Australia
25597,4/1/2021,AUS,Pahang,0,0,0,Australia
25598,4/1/2021,AUS,Perak,0,0,0,Australia
25599,4/1/2021,AUS,Perlis,0,0,0,Australia
25600,4/1/2021,AUS,Pulau Pinang,9,5,4,Australia
25601,4/1/2021,AUS,Sabah,0,0,0,Australia
25602,4/1/2021,AUS,Sarawak,1,1,0,Australia
25603,4/1/2021,AUS,Selangor,102,68,34,Australia
25604,4/1/2021,AUS,Terengganu,0,0,0,Australia
25605,4/1/2021,AUS,W.P. Labuan,0,0,0,Australia
25606,4/1/2021,AUT,Johor,0,0,0,Austria
25607,4/1/2021,AUT,Kedah,0,0,0,Austria
25608,4/1/2021,AUT,Kelantan,0,0,0,Austria
25609,4/1/2021,AUT,Melaka,0,0,0,Austria
25610,4/1/2021,AUT,Negeri Sembilan,0,0,0,Austria
25611,4/1/2021,AUT,Pahang,0,0,0,Austria
25612,4/1/2021,AUT,Perak,0,0,0,Austria
25613,4/1/2021,AUT,Perlis,0,0,0,Austria
25614,4/1/2021,AUT,Pulau Pinang,0,0,0,Austria
25615,4/1/2021,AUT,Sabah,0,0,0,Austria
25616,4/1/2021,AUT,Sarawak,0,0,0,Austria
25617,4/1/2021,AUT,Selangor,17,13,4,Austria
25618,4/1/2021,AUT,Terengganu,0,0,0,Austria
25619,4/1/2021,AUT,W.P. Labuan,0,0,0,Austria
25620,4/1/2021,AZE,Johor,0,0,0,Azerbaijan
25621,4/1/2021,AZE,Kedah,0,0,0,Azerbaijan
25622,4/1/2021,AZE,Kelantan,0,0,0,Azerbaijan
25623,4/1/2021,AZE,Melaka,0,0,0,Azerbaijan
25624,4/1/2021,AZE,Perlis,0,0,0,Azerbaijan
25625,4/1/2021,AZE,Pulau Pinang,0,0,0,Azerbaijan
25626,4/1/2021,AZE,Sabah,0,0,0,Azerbaijan
25627,4/1/2021,AZE,Sarawak,0,0,0,Azerbaijan
25628,4/1/2021,AZE,Selangor,1,1,0,Azerbaijan
25629,4/1/2021,AZE,W.P. Labuan,0,0,0,Azerbaijan
25630,4/1/2021,BDI,Pulau Pinang,0,0,0,Burundi
25631,4/1/2021,BDI,Sarawak,0,0,0,Burundi
25632,4/1/2021,BDI,Selangor,3,1,2,Burundi
25633,4/1/2021,BEL,Johor,1,1,0,Belgium
25634,4/1/2021,BEL,Kedah,0,0,0,Belgium
25635,4/1/2021,BEL,Kelantan,0,0,0,Belgium
25636,4/1/2021,BEL,Melaka,0,0,0,Belgium
25637,4/1/2021,BEL,Negeri Sembilan,0,0,0,Belgium
25638,4/1/2021,BEL,Pahang,0,0,0,Belgium
25639,4/1/2021,BEL,Perak,0,0,0,Belgium
25640,4/1/2021,BEL,Perlis,0,0,0,Belgium
25641,4/1/2021,BEL,Pulau Pinang,0,0,0,Belgium
25642,4/1/2021,BEL,Sabah,0,0,0,Belgium
25643,4/1/2021,BEL,Sarawak,0,0,0,Belgium
25644,4/1/2021,BEL,Selangor,9,6,3,Belgium
25645,4/1/2021,BEL,W.P. Labuan,0,0,0,Belgium
25646,4/1/2021,BEN,Johor,0,0,0,Benin
25647,4/1/2021,BEN,Kedah,0,0,0,Benin
25648,4/1/2021,BEN,Perak,0,0,0,Benin
25649,4/1/2021,BEN,Pulau Pinang,0,0,0,Benin
25650,4/1/2021,BEN,Sabah,0,0,0,Benin
25651,4/1/2021,BEN,Sarawak,0,0,0,Benin
25652,4/1/2021,BEN,Selangor,1,1,0,Benin
25653,4/1/2021,BFA,Perak,0,0,0,Burkina Faso
25654,4/1/2021,BFA,Pulau Pinang,0,0,0,Burkina Faso
25655,4/1/2021,BFA,Selangor,0,0,0,Burkina Faso
25656,4/1/2021,BGD,Johor,6,6,0,Bangladesh
25657,4/1/2021,BGD,Kedah,0,0,0,Bangladesh
25658,4/1/2021,BGD,Kelantan,0,0,0,Bangladesh
25659,4/1/2021,BGD,Melaka,0,0,0,Bangladesh
25660,4/1/2021,BGD,Negeri Sembilan,0,0,0,Bangladesh
25661,4/1/2021,BGD,Pahang,0,0,0,Bangladesh
25662,4/1/2021,BGD,Perak,0,0,0,Bangladesh
25663,4/1/2021,BGD,Perlis,0,0,0,Bangladesh
25664,4/1/2021,BGD,Pulau Pinang,0,0,0,Bangladesh
25665,4/1/2021,BGD,Sabah,0,0,0,Bangladesh
25666,4/1/2021,BGD,Sarawak,0,0,0,Bangladesh
25667,4/1/2021,BGD,Selangor,265,235,30,Bangladesh
25668,4/1/2021,BGD,W.P. Labuan,0,0,0,Bangladesh
25669,4/1/2021,BGR,Johor,0,0,0,Bulgaria
25670,4/1/2021,BGR,Kedah,0,0,0,Bulgaria
25671,4/1/2021,BGR,Kelantan,0,0,0,Bulgaria
25672,4/1/2021,BGR,Pahang,0,0,0,Bulgaria
25673,4/1/2021,BGR,Perak,0,0,0,Bulgaria
25674,4/1/2021,BGR,Perlis,0,0,0,Bulgaria
25675,4/1/2021,BGR,Pulau Pinang,0,0,0,Bulgaria
25676,4/1/2021,BGR,Sabah,0,0,0,Bulgaria
25677,4/1/2021,BGR,Sarawak,0,0,0,Bulgaria
25678,4/1/2021,BGR,Selangor,10,9,1,Bulgaria
25679,4/1/2021,BGR,W.P. Labuan,0,0,0,Bulgaria
25680,4/1/2021,BHR,Johor,0,0,0,Bahrain
25681,4/1/2021,BHR,Kedah,0,0,0,Bahrain
25682,4/1/2021,BHR,Kelantan,0,0,0,Bahrain
25683,4/1/2021,BHR,Perlis,0,0,0,Bahrain
25684,4/1/2021,BHR,Pulau Pinang,0,0,0,Bahrain
25685,4/1/2021,BHR,Sabah,0,0,0,Bahrain
25686,4/1/2021,BHR,Sarawak,0,0,0,Bahrain
25687,4/1/2021,BHR,Selangor,1,0,1,Bahrain
25688,4/1/2021,BHS,Johor,0,0,0,Bahamas
25689,4/1/2021,BHS,Kedah,0,0,0,Bahamas
25690,4/1/2021,BHS,Perak,0,0,0,Bahamas
25691,4/1/2021,BHS,Sabah,0,0,0,Bahamas
25692,4/1/2021,BHS,Sarawak,0,0,0,Bahamas
25693,4/1/2021,BHS,Selangor,0,0,0,Bahamas
25694,4/1/2021,BIH,Johor,0,0,0,Bosnia and Herzegovina
25695,4/1/2021,BIH,Kedah,0,0,0,Bosnia and Herzegovina
25696,4/1/2021,BIH,Perlis,0,0,0,Bosnia and Herzegovina
25697,4/1/2021,BIH,Pulau Pinang,0,0,0,Bosnia and Herzegovina
25698,4/1/2021,BIH,Sabah,0,0,0,Bosnia and Herzegovina
25699,4/1/2021,BIH,Sarawak,0,0,0,Bosnia and Herzegovina
25700,4/1/2021,BIH,Selangor,3,2,1,Bosnia and Herzegovina
25701,4/1/2021,BLR,Johor,0,0,0,Belarus
25702,4/1/2021,BLR,Kedah,0,0,0,Belarus
25703,4/1/2021,BLR,Kelantan,0,0,0,Belarus
25704,4/1/2021,BLR,Pahang,0,0,0,Belarus
25705,4/1/2021,BLR,Perak,0,0,0,Belarus
25706,4/1/2021,BLR,Perlis,0,0,0,Belarus
25707,4/1/2021,BLR,Pulau Pinang,0,0,0,Belarus
25708,4/1/2021,BLR,Sabah,0,0,0,Belarus
25709,4/1/2021,BLR,Sarawak,0,0,0,Belarus
25710,4/1/2021,BLR,Selangor,1,1,0,Belarus
25711,4/1/2021,BLR,W.P. Labuan,0,0,0,Belarus
25712,4/1/2021,BLZ,Johor,0,0,0,Belize
25713,4/1/2021,BLZ,Pulau Pinang,0,0,0,Belize
25714,4/1/2021,BLZ,Sarawak,0,0,0,Belize
25715,4/1/2021,BLZ,Selangor,0,0,0,Belize
25716,4/1/2021,BMU,Selangor,0,0,0,Bermuda
25717,4/1/2021,BOL,Johor,0,0,0,Bolivia
25718,4/1/2021,BOL,Kedah,0,0,0,Bolivia
25719,4/1/2021,BOL,Melaka,0,0,0,Bolivia
25720,4/1/2021,BOL,Perak,0,0,0,Bolivia
25721,4/1/2021,BOL,Perlis,0,0,0,Bolivia
25722,4/1/2021,BOL,Pulau Pinang,0,0,0,Bolivia
25723,4/1/2021,BOL,Sabah,0,0,0,Bolivia
25724,4/1/2021,BOL,Sarawak,0,0,0,Bolivia
25725,4/1/2021,BOL,Selangor,0,0,0,Bolivia
25726,4/1/2021,BRA,Johor,0,0,0,Brazil
25727,4/1/2021,BRA,Kedah,0,0,0,Brazil
25728,4/1/2021,BRA,Kelantan,0,0,0,Brazil
25729,4/1/2021,BRA,Melaka,0,0,0,Brazil
25730,4/1/2021,BRA,Pahang,0,0,0,Brazil
25731,4/1/2021,BRA,Perak,0,0,0,Brazil
25732,4/1/2021,BRA,Perlis,0,0,0,Brazil
25733,4/1/2021,BRA,Pulau Pinang,0,0,0,Brazil
25734,4/1/2021,BRA,Sabah,0,0,0,Brazil
25735,4/1/2021,BRA,Sarawak,0,0,0,Brazil
25736,4/1/2021,BRA,Selangor,27,13,14,Brazil
25737,4/1/2021,BRA,W.P. Labuan,0,0,0,Brazil
25738,4/1/2021,BRB,Johor,0,0,0,Barbados
25739,4/1/2021,BRB,Kedah,0,0,0,Barbados
25740,4/1/2021,BRB,Perlis,0,0,0,Barbados
25741,4/1/2021,BRB,Pulau Pinang,0,0,0,Barbados
25742,4/1/2021,BRB,Selangor,0,0,0,Barbados
25743,4/1/2021,BRN,Johor,0,0,0,Brunei Darussalam
25744,4/1/2021,BRN,Kedah,0,0,0,Brunei Darussalam
25745,4/1/2021,BRN,Kelantan,0,0,0,Brunei Darussalam
25746,4/1/2021,BRN,Melaka,0,0,0,Brunei Darussalam
25747,4/1/2021,BRN,Pahang,0,0,0,Brunei Darussalam
25748,4/1/2021,BRN,Perak,0,0,0,Brunei Darussalam
25749,4/1/2021,BRN,Perlis,0,0,0,Brunei Darussalam
25750,4/1/2021,BRN,Pulau Pinang,0,0,0,Brunei Darussalam
25751,4/1/2021,BRN,Sabah,0,0,0,Brunei Darussalam
25752,4/1/2021,BRN,Sarawak,385,368,17,Brunei Darussalam
25753,4/1/2021,BRN,Selangor,22,8,14,Brunei Darussalam
25754,4/1/2021,BRN,W.P. Labuan,4,4,0,Brunei Darussalam
25755,4/1/2021,BTN,Johor,0,0,0,Bhutan
25756,4/1/2021,BTN,Kedah,0,0,0,Bhutan
25757,4/1/2021,BTN,Perak,0,0,0,Bhutan
25758,4/1/2021,BTN,Perlis,0,0,0,Bhutan
25759,4/1/2021,BTN,Pulau Pinang,0,0,0,Bhutan
25760,4/1/2021,BTN,Sabah,0,0,0,Bhutan
25761,4/1/2021,BTN,Sarawak,0,0,0,Bhutan
25762,4/1/2021,BTN,Selangor,0,0,0,Bhutan
25763,4/1/2021,BWA,Johor,0,0,0,Botswana
25764,4/1/2021,BWA,Kedah,0,0,0,Botswana
25765,4/1/2021,BWA,Perlis,0,0,0,Botswana
25766,4/1/2021,BWA,Pulau Pinang,0,0,0,Botswana
25767,4/1/2021,BWA,Sabah,0,0,0,Botswana
25768,4/1/2021,BWA,Sarawak,0,0,0,Botswana
25769,4/1/2021,BWA,Selangor,0,0,0,Botswana
25770,4/1/2021,CAF,Kedah,0,0,0,Central African Republic
25771,4/1/2021,CAF,Selangor,0,0,0,Central African Republic
25772,4/1/2021,CAN,Johor,0,0,0,Canada
25773,4/1/2021,CAN,Kedah,0,0,0,Canada
25774,4/1/2021,CAN,Kelantan,0,0,0,Canada
25775,4/1/2021,CAN,Melaka,0,0,0,Canada
25776,4/1/2021,CAN,Negeri Sembilan,0,0,0,Canada
25777,4/1/2021,CAN,Pahang,0,0,0,Canada
25778,4/1/2021,CAN,Perak,0,0,0,Canada
25779,4/1/2021,CAN,Perlis,0,0,0,Canada
25780,4/1/2021,CAN,Pulau Pinang,0,0,0,Canada
25781,4/1/2021,CAN,Sabah,0,0,0,Canada
25782,4/1/2021,CAN,Sarawak,0,0,0,Canada
25783,4/1/2021,CAN,Selangor,36,29,7,Canada
25784,4/1/2021,CAN,Terengganu,0,0,0,Canada
25785,4/1/2021,CAN,W.P. Labuan,0,0,0,Canada
25786,4/1/2021,CCK,Selangor,0,0,0,Cocos (Keeling) Islands
25787,4/1/2021,CHE,Johor,0,0,0,Switzerland
25788,4/1/2021,CHE,Kedah,0,0,0,Switzerland
25789,4/1/2021,CHE,Kelantan,0,0,0,Switzerland
25790,4/1/2021,CHE,Melaka,0,0,0,Switzerland
25791,4/1/2021,CHE,Negeri Sembilan,0,0,0,Switzerland
25792,4/1/2021,CHE,Pahang,0,0,0,Switzerland
25793,4/1/2021,CHE,Perak,0,0,0,Switzerland
25794,4/1/2021,CHE,Perlis,0,0,0,Switzerland
25795,4/1/2021,CHE,Pulau Pinang,0,0,0,Switzerland
25796,4/1/2021,CHE,Sabah,0,0,0,Switzerland
25797,4/1/2021,CHE,Sarawak,0,0,0,Switzerland
25798,4/1/2021,CHE,Selangor,21,17,4,Switzerland
25799,4/1/2021,CHE,W.P. Labuan,0,0,0,Switzerland
25800,4/1/2021,CHL,Johor,0,0,0,Chile
25801,4/1/2021,CHL,Kedah,0,0,0,Chile
25802,4/1/2021,CHL,Kelantan,0,0,0,Chile
25803,4/1/2021,CHL,Melaka,0,0,0,Chile
25804,4/1/2021,CHL,Pahang,0,0,0,Chile
25805,4/1/2021,CHL,Perak,0,0,0,Chile
25806,4/1/2021,CHL,Perlis,0,0,0,Chile
25807,4/1/2021,CHL,Pulau Pinang,0,0,0,Chile
25808,4/1/2021,CHL,Sabah,0,0,0,Chile
25809,4/1/2021,CHL,Sarawak,0,0,0,Chile
25810,4/1/2021,CHL,Selangor,1,0,1,Chile
25811,4/1/2021,CHN,Johor,35,34,1,China
25812,4/1/2021,CHN,Kedah,0,0,0,China
25813,4/1/2021,CHN,Kelantan,0,0,0,China
25814,4/1/2021,CHN,Melaka,0,0,0,China
25815,4/1/2021,CHN,Pahang,1,1,0,China
25816,4/1/2021,CHN,Perak,0,0,0,China
25817,4/1/2021,CHN,Perlis,0,0,0,China
25818,4/1/2021,CHN,Pulau Pinang,2,2,0,China
25819,4/1/2021,CHN,Sabah,0,0,0,China
25820,4/1/2021,CHN,Sarawak,67,60,7,China
25821,4/1/2021,CHN,Selangor,1570,1181,389,China
25822,4/1/2021,CHN,Terengganu,0,0,0,China
25823,4/1/2021,CHN,W.P. Labuan,0,0,0,China
25824,4/1/2021,CIV,Johor,0,0,0,C��te d'Iv
25825,4/1/2021,CIV,Kedah,0,0,0,C��te d'Iv
25826,4/1/2021,CIV,Pulau Pinang,0,0,0,C��te d'Iv
25827,4/1/2021,CIV,Sabah,0,0,0,C��te d'Iv
25828,4/1/2021,CIV,Sarawak,0,0,0,C��te d'Iv
25829,4/1/2021,CIV,Selangor,0,0,0,C��te d'Iv
25830,4/1/2021,CMR,Johor,0,0,0,Cameroon
25831,4/1/2021,CMR,Kedah,0,0,0,Cameroon
25832,4/1/2021,CMR,Pulau Pinang,0,0,0,Cameroon
25833,4/1/2021,CMR,Sabah,0,0,0,Cameroon
25834,4/1/2021,CMR,Sarawak,0,0,0,Cameroon
25835,4/1/2021,CMR,Selangor,3,1,2,Cameroon
25836,4/1/2021,COD,Johor,0,0,0,"Congo, the Democratic Republic of the"
25837,4/1/2021,COD,Pulau Pinang,0,0,0,"Congo, the Democratic Republic of the"
25838,4/1/2021,COD,Sarawak,0,0,0,"Congo, the Democratic Republic of the"
25839,4/1/2021,COD,Selangor,4,3,1,"Congo, the Democratic Republic of the"
25840,4/1/2021,COG,Johor,0,0,0,Congo
25841,4/1/2021,COG,Kedah,0,0,0,Congo
25842,4/1/2021,COG,Selangor,0,0,0,Congo
25843,4/1/2021,COK,Selangor,0,0,0,Cook Islands
25844,4/1/2021,COL,Johor,0,0,0,Colombia
25845,4/1/2021,COL,Kedah,0,0,0,Colombia
25846,4/1/2021,COL,Perak,0,0,0,Colombia
25847,4/1/2021,COL,Pulau Pinang,0,0,0,Colombia
25848,4/1/2021,COL,Sabah,0,0,0,Colombia
25849,4/1/2021,COL,Sarawak,0,0,0,Colombia
25850,4/1/2021,COL,Selangor,7,3,4,Colombia
25851,4/1/2021,COL,W.P. Labuan,0,0,0,Colombia
25852,4/1/2021,COM,Johor,0,0,0,Comoros
25853,4/1/2021,COM,Kedah,0,0,0,Comoros
25854,4/1/2021,COM,Selangor,2,1,1,Comoros
25855,4/1/2021,CPV,Johor,0,0,0,Cape Verde
25856,4/1/2021,CPV,Kedah,0,0,0,Cape Verde
25857,4/1/2021,CPV,Pulau Pinang,0,0,0,Cape Verde
25858,4/1/2021,CPV,Sabah,0,0,0,Cape Verde
25859,4/1/2021,CPV,Selangor,0,0,0,Cape Verde
25860,4/1/2021,CRI,Johor,0,0,0,Costa Rica
25861,4/1/2021,CRI,Kedah,0,0,0,Costa Rica
25862,4/1/2021,CRI,Perak,0,0,0,Costa Rica
25863,4/1/2021,CRI,Perlis,0,0,0,Costa Rica
25864,4/1/2021,CRI,Pulau Pinang,0,0,0,Costa Rica
25865,4/1/2021,CRI,Sabah,0,0,0,Costa Rica
25866,4/1/2021,CRI,Sarawak,0,0,0,Costa Rica
25867,4/1/2021,CRI,Selangor,1,0,1,Costa Rica
25868,4/1/2021,CUB,Johor,0,0,0,Cuba
25869,4/1/2021,CUB,Kedah,0,0,0,Cuba
25870,4/1/2021,CUB,Perlis,0,0,0,Cuba
25871,4/1/2021,CUB,Pulau Pinang,0,0,0,Cuba
25872,4/1/2021,CUB,Sabah,0,0,0,Cuba
25873,4/1/2021,CUB,Sarawak,0,0,0,Cuba
25874,4/1/2021,CUB,Selangor,0,0,0,Cuba
25875,4/1/2021,CYP,Johor,0,0,0,Cyprus
25876,4/1/2021,CYP,Kedah,0,0,0,Cyprus
25877,4/1/2021,CYP,Perak,0,0,0,Cyprus
25878,4/1/2021,CYP,Perlis,0,0,0,Cyprus
25879,4/1/2021,CYP,Pulau Pinang,0,0,0,Cyprus
25880,4/1/2021,CYP,Sabah,0,0,0,Cyprus
25881,4/1/2021,CYP,Sarawak,0,0,0,Cyprus
25882,4/1/2021,CYP,Selangor,1,1,0,Cyprus
25883,4/1/2021,CZE,Johor,0,0,0,Czech Republic
25884,4/1/2021,CZE,Kedah,0,0,0,Czech Republic
25885,4/1/2021,CZE,Kelantan,0,0,0,Czech Republic
25886,4/1/2021,CZE,Melaka,0,0,0,Czech Republic
25887,4/1/2021,CZE,Negeri Sembilan,0,0,0,Czech Republic
25888,4/1/2021,CZE,Perak,0,0,0,Czech Republic
25889,4/1/2021,CZE,Perlis,0,0,0,Czech Republic
25890,4/1/2021,CZE,Pulau Pinang,0,0,0,Czech Republic
25891,4/1/2021,CZE,Sabah,0,0,0,Czech Republic
25892,4/1/2021,CZE,Sarawak,0,0,0,Czech Republic
25893,4/1/2021,CZE,Selangor,9,8,1,Czech Republic
25894,4/1/2021,CZE,W.P. Labuan,0,0,0,Czech Republic
25895,4/1/2021,DEU,Johor,2,2,0,Germany
25896,4/1/2021,DEU,Kedah,0,0,0,Germany
25897,4/1/2021,DEU,Kelantan,0,0,0,Germany
25898,4/1/2021,DEU,Melaka,0,0,0,Germany
25899,4/1/2021,DEU,Negeri Sembilan,0,0,0,Germany
25900,4/1/2021,DEU,Pahang,0,0,0,Germany
25901,4/1/2021,DEU,Perak,0,0,0,Germany
25902,4/1/2021,DEU,Perlis,0,0,0,Germany
25903,4/1/2021,DEU,Pulau Pinang,1,1,0,Germany
25904,4/1/2021,DEU,Sabah,0,0,0,Germany
25905,4/1/2021,DEU,Sarawak,0,0,0,Germany
25906,4/1/2021,DEU,Selangor,101,92,9,Germany
25907,4/1/2021,DEU,Terengganu,0,0,0,Germany
25908,4/1/2021,DEU,W.P. Labuan,0,0,0,Germany
25909,4/1/2021,DJI,Johor,0,0,0,Djibouti
25910,4/1/2021,DJI,Selangor,24,15,9,Djibouti
25911,4/1/2021,DMA,Johor,0,0,0,Dominica
25912,4/1/2021,DMA,Kedah,0,0,0,Dominica
25913,4/1/2021,DMA,Pulau Pinang,0,0,0,Dominica
25914,4/1/2021,DMA,Sabah,0,0,0,Dominica
25915,4/1/2021,DMA,Sarawak,0,0,0,Dominica
25916,4/1/2021,DMA,Selangor,0,0,0,Dominica
25917,4/1/2021,DMA,W.P. Labuan,0,0,0,Dominica
25918,4/1/2021,DNK,Johor,9,7,2,Denmark
25919,4/1/2021,DNK,Kedah,0,0,0,Denmark
25920,4/1/2021,DNK,Kelantan,0,0,0,Denmark
25921,4/1/2021,DNK,Melaka,0,0,0,Denmark
25922,4/1/2021,DNK,Negeri Sembilan,0,0,0,Denmark
25923,4/1/2021,DNK,Pahang,0,0,0,Denmark
25924,4/1/2021,DNK,Perak,0,0,0,Denmark
25925,4/1/2021,DNK,Perlis,0,0,0,Denmark
25926,4/1/2021,DNK,Pulau Pinang,2,1,1,Denmark
25927,4/1/2021,DNK,Sabah,0,0,0,Denmark
25928,4/1/2021,DNK,Sarawak,0,0,0,Denmark
25929,4/1/2021,DNK,Selangor,23,19,4,Denmark
25930,4/1/2021,DNK,W.P. Labuan,0,0,0,Denmark
25931,4/1/2021,DOM,Johor,0,0,0,Dominican Republic
25932,4/1/2021,DOM,Kedah,0,0,0,Dominican Republic
25933,4/1/2021,DOM,Perak,0,0,0,Dominican Republic
25934,4/1/2021,DOM,Perlis,0,0,0,Dominican Republic
25935,4/1/2021,DOM,Pulau Pinang,0,0,0,Dominican Republic
25936,4/1/2021,DOM,Sabah,0,0,0,Dominican Republic
25937,4/1/2021,DOM,Sarawak,0,0,0,Dominican Republic
25938,4/1/2021,DOM,Selangor,0,0,0,Dominican Republic
25939,4/1/2021,DZA,Johor,0,0,0,Algeria
25940,4/1/2021,DZA,Kedah,0,0,0,Algeria
25941,4/1/2021,DZA,Kelantan,0,0,0,Algeria
25942,4/1/2021,DZA,Melaka,0,0,0,Algeria
25943,4/1/2021,DZA,Perak,0,0,0,Algeria
25944,4/1/2021,DZA,Perlis,0,0,0,Algeria
25945,4/1/2021,DZA,Pulau Pinang,0,0,0,Algeria
25946,4/1/2021,DZA,Sabah,0,0,0,Algeria
25947,4/1/2021,DZA,Sarawak,0,0,0,Algeria
25948,4/1/2021,DZA,Selangor,3,2,1,Algeria
25949,4/1/2021,DZA,W.P. Labuan,0,0,0,Algeria
25950,4/1/2021,ECU,Johor,0,0,0,Ecuador
25951,4/1/2021,ECU,Kedah,0,0,0,Ecuador
25952,4/1/2021,ECU,Perak,0,0,0,Ecuador
25953,4/1/2021,ECU,Perlis,0,0,0,Ecuador
25954,4/1/2021,ECU,Pulau Pinang,0,0,0,Ecuador
25955,4/1/2021,ECU,Sabah,0,0,0,Ecuador
25956,4/1/2021,ECU,Sarawak,0,0,0,Ecuador
25957,4/1/2021,ECU,Selangor,1,1,0,Ecuador
25958,4/1/2021,EGY,Johor,0,0,0,Egypt
25959,4/1/2021,EGY,Kedah,0,0,0,Egypt
25960,4/1/2021,EGY,Kelantan,0,0,0,Egypt
25961,4/1/2021,EGY,Melaka,0,0,0,Egypt
25962,4/1/2021,EGY,Pahang,0,0,0,Egypt
25963,4/1/2021,EGY,Perak,0,0,0,Egypt
25964,4/1/2021,EGY,Perlis,0,0,0,Egypt
25965,4/1/2021,EGY,Pulau Pinang,0,0,0,Egypt
25966,4/1/2021,EGY,Sabah,0,0,0,Egypt
25967,4/1/2021,EGY,Sarawak,0,0,0,Egypt
25968,4/1/2021,EGY,Selangor,98,75,23,Egypt
25969,4/1/2021,EGY,Terengganu,0,0,0,Egypt
25970,4/1/2021,EGY,W.P. Labuan,0,0,0,Egypt
25971,4/1/2021,ERI,Johor,0,0,0,Eritrea
25972,4/1/2021,ERI,Pulau Pinang,0,0,0,Eritrea
25973,4/1/2021,ERI,Sabah,0,0,0,Eritrea
25974,4/1/2021,ERI,Selangor,1,1,0,Eritrea
25975,4/1/2021,ESP,Johor,0,0,0,Spain
25976,4/1/2021,ESP,Kedah,0,0,0,Spain
25977,4/1/2021,ESP,Kelantan,0,0,0,Spain
25978,4/1/2021,ESP,Melaka,0,0,0,Spain
25979,4/1/2021,ESP,Negeri Sembilan,0,0,0,Spain
25980,4/1/2021,ESP,Pahang,0,0,0,Spain
25981,4/1/2021,ESP,Perak,0,0,0,Spain
25982,4/1/2021,ESP,Perlis,0,0,0,Spain
25983,4/1/2021,ESP,Pulau Pinang,0,0,0,Spain
25984,4/1/2021,ESP,Sabah,0,0,0,Spain
25985,4/1/2021,ESP,Sarawak,0,0,0,Spain
25986,4/1/2021,ESP,Selangor,21,16,5,Spain
25987,4/1/2021,ESP,W.P. Labuan,0,0,0,Spain
25988,4/1/2021,EST,Johor,0,0,0,Estonia
25989,4/1/2021,EST,Kedah,0,0,0,Estonia
25990,4/1/2021,EST,Kelantan,0,0,0,Estonia
25991,4/1/2021,EST,Pahang,0,0,0,Estonia
25992,4/1/2021,EST,Perak,0,0,0,Estonia
25993,4/1/2021,EST,Perlis,0,0,0,Estonia
25994,4/1/2021,EST,Pulau Pinang,0,0,0,Estonia
25995,4/1/2021,EST,Sabah,0,0,0,Estonia
25996,4/1/2021,EST,Sarawak,0,0,0,Estonia
25997,4/1/2021,EST,Selangor,3,3,0,Estonia
25998,4/1/2021,EST,W.P. Labuan,0,0,0,Estonia
25999,4/1/2021,ETH,Johor,0,0,0,Ethiopia
26000,4/1/2021,ETH,Kedah,0,0,0,Ethiopia
26001,4/1/2021,ETH,Pulau Pinang,0,0,0,Ethiopia
26002,4/1/2021,ETH,Sarawak,0,0,0,Ethiopia
26003,4/1/2021,ETH,Selangor,4,2,2,Ethiopia
26004,4/1/2021,FIN,Johor,0,0,0,Finland
26005,4/1/2021,FIN,Kedah,0,0,0,Finland
26006,4/1/2021,FIN,Kelantan,0,0,0,Finland
26007,4/1/2021,FIN,Melaka,0,0,0,Finland
26008,4/1/2021,FIN,Negeri Sembilan,0,0,0,Finland
26009,4/1/2021,FIN,Pahang,0,0,0,Finland
26010,4/1/2021,FIN,Perak,0,0,0,Finland
26011,4/1/2021,FIN,Perlis,0,0,0,Finland
26012,4/1/2021,FIN,Pulau Pinang,0,0,0,Finland
26013,4/1/2021,FIN,Sabah,0,0,0,Finland
26014,4/1/2021,FIN,Sarawak,0,0,0,Finland
26015,4/1/2021,FIN,Selangor,6,4,2,Finland
26016,4/1/2021,FIN,W.P. Labuan,0,0,0,Finland
26017,4/1/2021,FJI,Johor,0,0,0,Fiji
26018,4/1/2021,FJI,Kedah,0,0,0,Fiji
26019,4/1/2021,FJI,Kelantan,0,0,0,Fiji
26020,4/1/2021,FJI,Perak,0,0,0,Fiji
26021,4/1/2021,FJI,Perlis,0,0,0,Fiji
26022,4/1/2021,FJI,Pulau Pinang,0,0,0,Fiji
26023,4/1/2021,FJI,Sabah,0,0,0,Fiji
26024,4/1/2021,FJI,Sarawak,0,0,0,Fiji
26025,4/1/2021,FJI,Selangor,1,1,0,Fiji
26026,4/1/2021,FRA,Johor,3,3,0,France
26027,4/1/2021,FRA,Kedah,0,0,0,France
26028,4/1/2021,FRA,Kelantan,0,0,0,France
26029,4/1/2021,FRA,Melaka,0,0,0,France
26030,4/1/2021,FRA,Negeri Sembilan,0,0,0,France
26031,4/1/2021,FRA,Pahang,0,0,0,France
26032,4/1/2021,FRA,Perak,0,0,0,France
26033,4/1/2021,FRA,Perlis,0,0,0,France
26034,4/1/2021,FRA,Pulau Pinang,0,0,0,France
26035,4/1/2021,FRA,Sabah,0,0,0,France
26036,4/1/2021,FRA,Sarawak,0,0,0,France
26037,4/1/2021,FRA,Selangor,65,51,14,France
26038,4/1/2021,FRA,Terengganu,0,0,0,France
26039,4/1/2021,FRA,W.P. Labuan,0,0,0,France
26040,4/1/2021,FSM,Johor,0,0,0,"Micronesia, Federated States of"
26041,4/1/2021,FSM,Pulau Pinang,0,0,0,"Micronesia, Federated States of"
26042,4/1/2021,FSM,Selangor,0,0,0,"Micronesia, Federated States of"
26043,4/1/2021,GAB,Johor,0,0,0,Gabon
26044,4/1/2021,GAB,Pulau Pinang,0,0,0,Gabon
26045,4/1/2021,GAB,Sarawak,0,0,0,Gabon
26046,4/1/2021,GAB,Selangor,1,1,0,Gabon
26047,4/1/2021,GBR,Johor,4,4,0,United Kingdom
26048,4/1/2021,GBR,Kedah,0,0,0,United Kingdom
26049,4/1/2021,GBR,Kelantan,0,0,0,United Kingdom
26050,4/1/2021,GBR,Melaka,0,0,0,United Kingdom
26051,4/1/2021,GBR,Negeri Sembilan,0,0,0,United Kingdom
26052,4/1/2021,GBR,Pahang,0,0,0,United Kingdom
26053,4/1/2021,GBR,Perak,1,0,1,United Kingdom
26054,4/1/2021,GBR,Perlis,0,0,0,United Kingdom
26055,4/1/2021,GBR,Pulau Pinang,3,3,0,United Kingdom
26056,4/1/2021,GBR,Sabah,1,0,1,United Kingdom
26057,4/1/2021,GBR,Sarawak,0,0,0,United Kingdom
26058,4/1/2021,GBR,Selangor,221,187,34,United Kingdom
26059,4/1/2021,GBR,Terengganu,0,0,0,United Kingdom
26060,4/1/2021,GBR,W.P. Labuan,0,0,0,United Kingdom
26061,4/1/2021,GEO,Johor,0,0,0,Georgia
26062,4/1/2021,GEO,Kedah,0,0,0,Georgia
26063,4/1/2021,GEO,Melaka,0,0,0,Georgia
26064,4/1/2021,GEO,Perak,0,0,0,Georgia
26065,4/1/2021,GEO,Perlis,0,0,0,Georgia
26066,4/1/2021,GEO,Pulau Pinang,0,0,0,Georgia
26067,4/1/2021,GEO,Sabah,0,0,0,Georgia
26068,4/1/2021,GEO,Sarawak,0,0,0,Georgia
26069,4/1/2021,GEO,Selangor,2,2,0,Georgia
26070,4/1/2021,GHA,Johor,0,0,0,Ghana
26071,4/1/2021,GHA,Kedah,0,0,0,Ghana
26072,4/1/2021,GHA,Kelantan,0,0,0,Ghana
26073,4/1/2021,GHA,Pulau Pinang,0,0,0,Ghana
26074,4/1/2021,GHA,Sabah,0,0,0,Ghana
26075,4/1/2021,GHA,Sarawak,0,0,0,Ghana
26076,4/1/2021,GHA,Selangor,10,8,2,Ghana
26077,4/1/2021,GIB,Johor,0,0,0,Gibraltar
26078,4/1/2021,GIB,Sarawak,0,0,0,Gibraltar
26079,4/1/2021,GIN,Johor,0,0,0,Guinea
26080,4/1/2021,GIN,Kedah,0,0,0,Guinea
26081,4/1/2021,GIN,Kelantan,0,0,0,Guinea
26082,4/1/2021,GIN,Perlis,0,0,0,Guinea
26083,4/1/2021,GIN,Pulau Pinang,0,0,0,Guinea
26084,4/1/2021,GIN,Sabah,0,0,0,Guinea
26085,4/1/2021,GIN,Sarawak,0,0,0,Guinea
26086,4/1/2021,GIN,Selangor,24,10,14,Guinea
26087,4/1/2021,GLP,Selangor,0,0,0,Guadeloupe
26088,4/1/2021,GMB,Johor,0,0,0,Gambia
26089,4/1/2021,GMB,Kedah,0,0,0,Gambia
26090,4/1/2021,GMB,Kelantan,0,0,0,Gambia
26091,4/1/2021,GMB,Pulau Pinang,0,0,0,Gambia
26092,4/1/2021,GMB,Sabah,0,0,0,Gambia
26093,4/1/2021,GMB,Sarawak,0,0,0,Gambia
26094,4/1/2021,GMB,Selangor,1,1,0,Gambia
26095,4/1/2021,GNB,Johor,0,0,0,Guinea-Bissau
26096,4/1/2021,GNB,Selangor,0,0,0,Guinea-Bissau
26097,4/1/2021,GNQ,Johor,0,0,0,Equatorial Guinea
26098,4/1/2021,GNQ,Selangor,2,1,1,Equatorial Guinea
26099,4/1/2021,GRC,Johor,6,5,1,Greece
26100,4/1/2021,GRC,Kedah,0,0,0,Greece
26101,4/1/2021,GRC,Kelantan,0,0,0,Greece
26102,4/1/2021,GRC,Melaka,0,0,0,Greece
26103,4/1/2021,GRC,Negeri Sembilan,0,0,0,Greece
26104,4/1/2021,GRC,Pahang,0,0,0,Greece
26105,4/1/2021,GRC,Perak,0,0,0,Greece
26106,4/1/2021,GRC,Perlis,0,0,0,Greece
26107,4/1/2021,GRC,Pulau Pinang,0,0,0,Greece
26108,4/1/2021,GRC,Sabah,0,0,0,Greece
26109,4/1/2021,GRC,Sarawak,0,0,0,Greece
26110,4/1/2021,GRC,Selangor,3,3,0,Greece
26111,4/1/2021,GRD,Johor,0,0,0,Grenada
26112,4/1/2021,GRD,Kedah,0,0,0,Grenada
26113,4/1/2021,GRD,Pulau Pinang,0,0,0,Grenada
26114,4/1/2021,GRD,Sabah,0,0,0,Grenada
26115,4/1/2021,GRD,Sarawak,0,0,0,Grenada
26116,4/1/2021,GRD,Selangor,0,0,0,Grenada
26117,4/1/2021,GRL,Johor,0,0,0,Greenland
26118,4/1/2021,GRL,Selangor,0,0,0,Greenland
26119,4/1/2021,GTM,Johor,0,0,0,Guatemala
26120,4/1/2021,GTM,Kedah,0,0,0,Guatemala
26121,4/1/2021,GTM,Pahang,0,0,0,Guatemala
26122,4/1/2021,GTM,Perak,0,0,0,Guatemala
26123,4/1/2021,GTM,Pulau Pinang,0,0,0,Guatemala
26124,4/1/2021,GTM,Sabah,0,0,0,Guatemala
26125,4/1/2021,GTM,Sarawak,0,0,0,Guatemala
26126,4/1/2021,GTM,Selangor,0,0,0,Guatemala
26127,4/1/2021,GTM,W.P. Labuan,0,0,0,Guatemala
26128,4/1/2021,GUY,Johor,0,0,0,Guyana
26129,4/1/2021,GUY,Kedah,0,0,0,Guyana
26130,4/1/2021,GUY,Pulau Pinang,0,0,0,Guyana
26131,4/1/2021,GUY,Sarawak,0,0,0,Guyana
26132,4/1/2021,GUY,Selangor,0,0,0,Guyana
26133,4/1/2021,HKG,Johor,0,0,0,Hong Kong
26134,4/1/2021,HKG,Kedah,0,0,0,Hong Kong
26135,4/1/2021,HKG,Kelantan,0,0,0,Hong Kong
26136,4/1/2021,HKG,Pahang,0,0,0,Hong Kong
26137,4/1/2021,HKG,Perak,0,0,0,Hong Kong
26138,4/1/2021,HKG,Perlis,0,0,0,Hong Kong
26139,4/1/2021,HKG,Pulau Pinang,1,1,0,Hong Kong
26140,4/1/2021,HKG,Sabah,0,0,0,Hong Kong
26141,4/1/2021,HKG,Sarawak,0,0,0,Hong Kong
26142,4/1/2021,HKG,Selangor,0,0,0,Hong Kong
26143,4/1/2021,HKG,Terengganu,0,0,0,Hong Kong
26144,4/1/2021,HMD,Johor,0,0,0,Heard Island and McDonald Islands
26145,4/1/2021,HND,Johor,0,0,0,Honduras
26146,4/1/2021,HND,Kedah,0,0,0,Honduras
26147,4/1/2021,HND,Perak,0,0,0,Honduras
26148,4/1/2021,HND,Pulau Pinang,0,0,0,Honduras
26149,4/1/2021,HND,Sabah,0,0,0,Honduras
26150,4/1/2021,HND,Sarawak,0,0,0,Honduras
26151,4/1/2021,HND,Selangor,5,5,0,Honduras
26152,4/1/2021,HRV,Johor,0,0,0,Croatia
26153,4/1/2021,HRV,Kedah,0,0,0,Croatia
26154,4/1/2021,HRV,Kelantan,0,0,0,Croatia
26155,4/1/2021,HRV,Melaka,0,0,0,Croatia
26156,4/1/2021,HRV,Pahang,0,0,0,Croatia
26157,4/1/2021,HRV,Perak,0,0,0,Croatia
26158,4/1/2021,HRV,Perlis,0,0,0,Croatia
26159,4/1/2021,HRV,Pulau Pinang,0,0,0,Croatia
26160,4/1/2021,HRV,Sabah,0,0,0,Croatia
26161,4/1/2021,HRV,Sarawak,0,0,0,Croatia
26162,4/1/2021,HRV,Selangor,15,13,2,Croatia
26163,4/1/2021,HTI,Johor,0,0,0,Haiti
26164,4/1/2021,HTI,Kedah,0,0,0,Haiti
26165,4/1/2021,HTI,Kelantan,0,0,0,Haiti
26166,4/1/2021,HTI,Perak,0,0,0,Haiti
26167,4/1/2021,HTI,Pulau Pinang,0,0,0,Haiti
26168,4/1/2021,HTI,Sabah,0,0,0,Haiti
26169,4/1/2021,HTI,Selangor,0,0,0,Haiti
26170,4/1/2021,HUN,Johor,0,0,0,Hungary
26171,4/1/2021,HUN,Kedah,0,0,0,Hungary
26172,4/1/2021,HUN,Kelantan,0,0,0,Hungary
26173,4/1/2021,HUN,Pahang,0,0,0,Hungary
26174,4/1/2021,HUN,Perak,0,0,0,Hungary
26175,4/1/2021,HUN,Perlis,0,0,0,Hungary
26176,4/1/2021,HUN,Pulau Pinang,0,0,0,Hungary
26177,4/1/2021,HUN,Sabah,0,0,0,Hungary
26178,4/1/2021,HUN,Sarawak,0,0,0,Hungary
26179,4/1/2021,HUN,Selangor,9,5,4,Hungary
26180,4/1/2021,HUN,W.P. Labuan,0,0,0,Hungary
26181,4/1/2021,IDN,Johor,210,152,58,Indonesia
26182,4/1/2021,IDN,Kedah,3,3,0,Indonesia
26183,4/1/2021,IDN,Kelantan,0,0,0,Indonesia
26184,4/1/2021,IDN,Melaka,0,0,0,Indonesia
26185,4/1/2021,IDN,Negeri Sembilan,0,0,0,Indonesia
26186,4/1/2021,IDN,Pahang,0,0,0,Indonesia
26187,4/1/2021,IDN,Perak,0,0,0,Indonesia
26188,4/1/2021,IDN,Perlis,5,5,0,Indonesia
26189,4/1/2021,IDN,Pulau Pinang,17,1,16,Indonesia
26190,4/1/2021,IDN,Sabah,1,1,0,Indonesia
26191,4/1/2021,IDN,Sarawak,424,423,1,Indonesia
26192,4/1/2021,IDN,Selangor,1117,740,377,Indonesia
26193,4/1/2021,IDN,Terengganu,0,0,0,Indonesia
26194,4/1/2021,IDN,W.P. Labuan,4,4,0,Indonesia
26195,4/1/2021,IND,Johor,101,101,0,India
26196,4/1/2021,IND,Kedah,0,0,0,India
26197,4/1/2021,IND,Kelantan,0,0,0,India
26198,4/1/2021,IND,Melaka,0,0,0,India
26199,4/1/2021,IND,Negeri Sembilan,0,0,0,India
26200,4/1/2021,IND,Pahang,2,2,0,India
26201,4/1/2021,IND,Perak,0,0,0,India
26202,4/1/2021,IND,Perlis,0,0,0,India
26203,4/1/2021,IND,Pulau Pinang,3,3,0,India
26204,4/1/2021,IND,Sabah,2,2,0,India
26205,4/1/2021,IND,Sarawak,0,0,0,India
26206,4/1/2021,IND,Selangor,1359,963,396,India
26207,4/1/2021,IND,Terengganu,0,0,0,India
26208,4/1/2021,IND,W.P. Labuan,0,0,0,India
26209,4/1/2021,IOT,Pulau Pinang,0,0,0,British Indian Ocean Territory
26210,4/1/2021,IOT,Selangor,0,0,0,British Indian Ocean Territory
26211,4/1/2021,IRL,Johor,0,0,0,Ireland
26212,4/1/2021,IRL,Kedah,0,0,0,Ireland
26213,4/1/2021,IRL,Kelantan,0,0,0,Ireland
26214,4/1/2021,IRL,Negeri Sembilan,0,0,0,Ireland
26215,4/1/2021,IRL,Pahang,0,0,0,Ireland
26216,4/1/2021,IRL,Perak,0,0,0,Ireland
26217,4/1/2021,IRL,Perlis,0,0,0,Ireland
26218,4/1/2021,IRL,Pulau Pinang,0,0,0,Ireland
26219,4/1/2021,IRL,Sabah,0,0,0,Ireland
26220,4/1/2021,IRL,Sarawak,0,0,0,Ireland
26221,4/1/2021,IRL,Selangor,10,6,4,Ireland
26222,4/1/2021,IRL,Terengganu,0,0,0,Ireland
26223,4/1/2021,IRL,W.P. Labuan,0,0,0,Ireland
26224,4/1/2021,IRN,Johor,0,0,0,Iran
26225,4/1/2021,IRN,Kedah,0,0,0,Iran
26226,4/1/2021,IRN,Kelantan,0,0,0,Iran
26227,4/1/2021,IRN,Perak,0,0,0,Iran
26228,4/1/2021,IRN,Perlis,0,0,0,Iran
26229,4/1/2021,IRN,Pulau Pinang,0,0,0,Iran
26230,4/1/2021,IRN,Sabah,0,0,0,Iran
26231,4/1/2021,IRN,Sarawak,0,0,0,Iran
26232,4/1/2021,IRN,Selangor,46,30,16,Iran
26233,4/1/2021,IRN,W.P. Labuan,0,0,0,Iran
26234,4/1/2021,IRQ,Johor,0,0,0,Iraq
26235,4/1/2021,IRQ,Kedah,0,0,0,Iraq
26236,4/1/2021,IRQ,Kelantan,0,0,0,Iraq
26237,4/1/2021,IRQ,Melaka,0,0,0,Iraq
26238,4/1/2021,IRQ,Pahang,0,0,0,Iraq
26239,4/1/2021,IRQ,Perak,0,0,0,Iraq
26240,4/1/2021,IRQ,Perlis,0,0,0,Iraq
26241,4/1/2021,IRQ,Pulau Pinang,0,0,0,Iraq
26242,4/1/2021,IRQ,Sabah,0,0,0,Iraq
26243,4/1/2021,IRQ,Sarawak,0,0,0,Iraq
26244,4/1/2021,IRQ,Selangor,39,24,15,Iraq
26245,4/1/2021,ISL,Johor,0,0,0,Iceland
26246,4/1/2021,ISL,Kedah,0,0,0,Iceland
26247,4/1/2021,ISL,Kelantan,0,0,0,Iceland
26248,4/1/2021,ISL,Perak,0,0,0,Iceland
26249,4/1/2021,ISL,Perlis,0,0,0,Iceland
26250,4/1/2021,ISL,Pulau Pinang,0,0,0,Iceland
26251,4/1/2021,ISL,Sabah,0,0,0,Iceland
26252,4/1/2021,ISL,Sarawak,0,0,0,Iceland
26253,4/1/2021,ISL,Selangor,0,0,0,Iceland
26254,4/1/2021,ISL,W.P. Labuan,0,0,0,Iceland
26255,4/1/2021,ISR,Pulau Pinang,0,0,0,Israel
26256,4/1/2021,ITA,Johor,0,0,0,Italy
26257,4/1/2021,ITA,Kedah,0,0,0,Italy
26258,4/1/2021,ITA,Kelantan,0,0,0,Italy
26259,4/1/2021,ITA,Melaka,0,0,0,Italy
26260,4/1/2021,ITA,Negeri Sembilan,0,0,0,Italy
26261,4/1/2021,ITA,Pahang,0,0,0,Italy
26262,4/1/2021,ITA,Perak,0,0,0,Italy
26263,4/1/2021,ITA,Perlis,0,0,0,Italy
26264,4/1/2021,ITA,Pulau Pinang,1,1,0,Italy
26265,4/1/2021,ITA,Sabah,0,0,0,Italy
26266,4/1/2021,ITA,Sarawak,0,0,0,Italy
26267,4/1/2021,ITA,Selangor,67,61,6,Italy
26268,4/1/2021,ITA,W.P. Labuan,0,0,0,Italy
26269,4/1/2021,JAM,Johor,0,0,0,Jamaica
26270,4/1/2021,JAM,Kedah,0,0,0,Jamaica
26271,4/1/2021,JAM,Perak,0,0,0,Jamaica
26272,4/1/2021,JAM,Pulau Pinang,0,0,0,Jamaica
26273,4/1/2021,JAM,Sabah,0,0,0,Jamaica
26274,4/1/2021,JAM,Sarawak,0,0,0,Jamaica
26275,4/1/2021,JAM,Selangor,1,0,1,Jamaica
26276,4/1/2021,JAM,W.P. Labuan,0,0,0,Jamaica
26277,4/1/2021,JOR,Johor,0,0,0,Jordan
26278,4/1/2021,JOR,Kedah,0,0,0,Jordan
26279,4/1/2021,JOR,Kelantan,0,0,0,Jordan
26280,4/1/2021,JOR,Melaka,0,0,0,Jordan
26281,4/1/2021,JOR,Perlis,0,0,0,Jordan
26282,4/1/2021,JOR,Pulau Pinang,0,0,0,Jordan
26283,4/1/2021,JOR,Sabah,0,0,0,Jordan
26284,4/1/2021,JOR,Sarawak,0,0,0,Jordan
26285,4/1/2021,JOR,Selangor,25,18,7,Jordan
26286,4/1/2021,JOR,W.P. Labuan,0,0,0,Jordan
26287,4/1/2021,JPN,Johor,2,1,1,Japan
26288,4/1/2021,JPN,Kedah,0,0,0,Japan
26289,4/1/2021,JPN,Kelantan,0,0,0,Japan
26290,4/1/2021,JPN,Melaka,0,0,0,Japan
26291,4/1/2021,JPN,Negeri Sembilan,0,0,0,Japan
26292,4/1/2021,JPN,Pahang,0,0,0,Japan
26293,4/1/2021,JPN,Perak,0,0,0,Japan
26294,4/1/2021,JPN,Perlis,0,0,0,Japan
26295,4/1/2021,JPN,Pulau Pinang,24,18,6,Japan
26296,4/1/2021,JPN,Sabah,1,0,1,Japan
26297,4/1/2021,JPN,Sarawak,4,4,0,Japan
26298,4/1/2021,JPN,Selangor,600,409,191,Japan
26299,4/1/2021,JPN,W.P. Labuan,0,0,0,Japan
26300,4/1/2021,KAZ,Johor,0,0,0,Kazakhstan
26301,4/1/2021,KAZ,Kedah,0,0,0,Kazakhstan
26302,4/1/2021,KAZ,Kelantan,0,0,0,Kazakhstan
26303,4/1/2021,KAZ,Melaka,0,0,0,Kazakhstan
26304,4/1/2021,KAZ,Perak,0,0,0,Kazakhstan
26305,4/1/2021,KAZ,Perlis,0,0,0,Kazakhstan
26306,4/1/2021,KAZ,Pulau Pinang,0,0,0,Kazakhstan
26307,4/1/2021,KAZ,Sabah,0,0,0,Kazakhstan
26308,4/1/2021,KAZ,Sarawak,0,0,0,Kazakhstan
26309,4/1/2021,KAZ,Selangor,21,6,15,Kazakhstan
26310,4/1/2021,KAZ,W.P. Labuan,0,0,0,Kazakhstan
26311,4/1/2021,KEN,Johor,0,0,0,Kenya
26312,4/1/2021,KEN,Kedah,0,0,0,Kenya
26313,4/1/2021,KEN,Kelantan,0,0,0,Kenya
26314,4/1/2021,KEN,Perak,0,0,0,Kenya
26315,4/1/2021,KEN,Perlis,0,0,0,Kenya
26316,4/1/2021,KEN,Pulau Pinang,0,0,0,Kenya
26317,4/1/2021,KEN,Sabah,0,0,0,Kenya
26318,4/1/2021,KEN,Sarawak,0,0,0,Kenya
26319,4/1/2021,KEN,Selangor,18,9,9,Kenya
26320,4/1/2021,KGZ,Johor,0,0,0,Kyrgyzstan
26321,4/1/2021,KGZ,Kedah,0,0,0,Kyrgyzstan
26322,4/1/2021,KGZ,Kelantan,0,0,0,Kyrgyzstan
26323,4/1/2021,KGZ,Perak,0,0,0,Kyrgyzstan
26324,4/1/2021,KGZ,Perlis,0,0,0,Kyrgyzstan
26325,4/1/2021,KGZ,Pulau Pinang,0,0,0,Kyrgyzstan
26326,4/1/2021,KGZ,Sabah,0,0,0,Kyrgyzstan
26327,4/1/2021,KGZ,Sarawak,0,0,0,Kyrgyzstan
26328,4/1/2021,KGZ,Selangor,6,4,2,Kyrgyzstan
26329,4/1/2021,KHM,Johor,0,0,0,Cambodia
26330,4/1/2021,KHM,Kedah,0,0,0,Cambodia
26331,4/1/2021,KHM,Kelantan,0,0,0,Cambodia
26332,4/1/2021,KHM,Melaka,0,0,0,Cambodia
26333,4/1/2021,KHM,Negeri Sembilan,0,0,0,Cambodia
26334,4/1/2021,KHM,Pahang,0,0,0,Cambodia
26335,4/1/2021,KHM,Perak,0,0,0,Cambodia
26336,4/1/2021,KHM,Perlis,0,0,0,Cambodia
26337,4/1/2021,KHM,Pulau Pinang,0,0,0,Cambodia
26338,4/1/2021,KHM,Sabah,0,0,0,Cambodia
26339,4/1/2021,KHM,Sarawak,0,0,0,Cambodia
26340,4/1/2021,KHM,Selangor,9,1,8,Cambodia
26341,4/1/2021,KHM,W.P. Labuan,0,0,0,Cambodia
26342,4/1/2021,KIR,Johor,0,0,0,Kiribati
26343,4/1/2021,KIR,Sabah,0,0,0,Kiribati
26344,4/1/2021,KIR,Selangor,0,0,0,Kiribati
26345,4/1/2021,KNA,Johor,0,0,0,Saint Kitts and Nevis
26346,4/1/2021,KNA,Kedah,0,0,0,Saint Kitts and Nevis
26347,4/1/2021,KNA,Perlis,0,0,0,Saint Kitts and Nevis
26348,4/1/2021,KNA,Pulau Pinang,0,0,0,Saint Kitts and Nevis
26349,4/1/2021,KNA,Sabah,0,0,0,Saint Kitts and Nevis
26350,4/1/2021,KNA,Selangor,0,0,0,Saint Kitts and Nevis
26351,4/1/2021,KNA,W.P. Labuan,0,0,0,Saint Kitts and Nevis
26352,4/1/2021,KOR,Johor,0,0,0,"Korea, Republic of (South Korea)"
26353,4/1/2021,KOR,Kedah,0,0,0,"Korea, Republic of (South Korea)"
26354,4/1/2021,KOR,Kelantan,0,0,0,"Korea, Republic of (South Korea)"
26355,4/1/2021,KOR,Melaka,0,0,0,"Korea, Republic of (South Korea)"
26356,4/1/2021,KOR,Negeri Sembilan,0,0,0,"Korea, Republic of (South Korea)"
26357,4/1/2021,KOR,Pahang,0,0,0,"Korea, Republic of (South Korea)"
26358,4/1/2021,KOR,Perak,1,1,0,"Korea, Republic of (South Korea)"
26359,4/1/2021,KOR,Perlis,0,0,0,"Korea, Republic of (South Korea)"
26360,4/1/2021,KOR,Pulau Pinang,2,1,1,"Korea, Republic of (South Korea)"
26361,4/1/2021,KOR,Sabah,0,0,0,"Korea, Republic of (South Korea)"
26362,4/1/2021,KOR,Sarawak,4,3,1,"Korea, Republic of (South Korea)"
26363,4/1/2021,KOR,Selangor,332,235,97,"Korea, Republic of (South Korea)"
26364,4/1/2021,KOR,Terengganu,0,0,0,"Korea, Republic of (South Korea)"
26365,4/1/2021,KOR,W.P. Labuan,0,0,0,"Korea, Republic of (South Korea)"
26366,4/1/2021,KWT,Johor,0,0,0,Kuwait
26367,4/1/2021,KWT,Kedah,0,0,0,Kuwait
26368,4/1/2021,KWT,Kelantan,0,0,0,Kuwait
26369,4/1/2021,KWT,Perak,0,0,0,Kuwait
26370,4/1/2021,KWT,Perlis,0,0,0,Kuwait
26371,4/1/2021,KWT,Pulau Pinang,0,0,0,Kuwait
26372,4/1/2021,KWT,Sabah,0,0,0,Kuwait
26373,4/1/2021,KWT,Sarawak,0,0,0,Kuwait
26374,4/1/2021,KWT,Selangor,0,0,0,Kuwait
26375,4/1/2021,KWT,W.P. Labuan,0,0,0,Kuwait
26376,4/1/2021,LAO,Johor,0,0,0,Lao People's Democratic Republic
26377,4/1/2021,LAO,Kedah,0,0,0,Lao People's Democratic Republic
26378,4/1/2021,LAO,Kelantan,0,0,0,Lao People's Democratic Republic
26379,4/1/2021,LAO,Melaka,0,0,0,Lao People's Democratic Republic
26380,4/1/2021,LAO,Perak,0,0,0,Lao People's Democratic Republic
26381,4/1/2021,LAO,Perlis,0,0,0,Lao People's Democratic Republic
26382,4/1/2021,LAO,Pulau Pinang,0,0,0,Lao People's Democratic Republic
26383,4/1/2021,LAO,Sabah,0,0,0,Lao People's Democratic Republic
26384,4/1/2021,LAO,Sarawak,0,0,0,Lao People's Democratic Republic
26385,4/1/2021,LAO,Selangor,46,42,4,Lao People's Democratic Republic
26386,4/1/2021,LAO,W.P. Labuan,0,0,0,Lao People's Democratic Republic
26387,4/1/2021,LBN,Johor,0,0,0,Lebanon
26388,4/1/2021,LBN,Kedah,0,0,0,Lebanon
26389,4/1/2021,LBN,Kelantan,0,0,0,Lebanon
26390,4/1/2021,LBN,Pahang,0,0,0,Lebanon
26391,4/1/2021,LBN,Perak,0,0,0,Lebanon
26392,4/1/2021,LBN,Perlis,0,0,0,Lebanon
26393,4/1/2021,LBN,Pulau Pinang,0,0,0,Lebanon
26394,4/1/2021,LBN,Sabah,0,0,0,Lebanon
26395,4/1/2021,LBN,Sarawak,0,0,0,Lebanon
26396,4/1/2021,LBN,Selangor,5,5,0,Lebanon
26397,4/1/2021,LBN,W.P. Labuan,0,0,0,Lebanon
26398,4/1/2021,LBR,Johor,0,0,0,Liberia
26399,4/1/2021,LBR,Kedah,0,0,0,Liberia
26400,4/1/2021,LBR,Sabah,0,0,0,Liberia
26401,4/1/2021,LBR,Sarawak,0,0,0,Liberia
26402,4/1/2021,LBR,Selangor,4,4,0,Liberia
26403,4/1/2021,LBY,Johor,0,0,0,Libyan Arab Jamahiriya
26404,4/1/2021,LBY,Kedah,0,0,0,Libyan Arab Jamahiriya
26405,4/1/2021,LBY,Perlis,0,0,0,Libyan Arab Jamahiriya
26406,4/1/2021,LBY,Pulau Pinang,0,0,0,Libyan Arab Jamahiriya
26407,4/1/2021,LBY,Sabah,0,0,0,Libyan Arab Jamahiriya
26408,4/1/2021,LBY,Sarawak,0,0,0,Libyan Arab Jamahiriya
26409,4/1/2021,LBY,Selangor,50,36,14,Libyan Arab Jamahiriya
26410,4/1/2021,LCA,Johor,0,0,0,Saint Lucia
26411,4/1/2021,LCA,Kedah,0,0,0,Saint Lucia
26412,4/1/2021,LCA,Pulau Pinang,0,0,0,Saint Lucia
26413,4/1/2021,LCA,Sarawak,0,0,0,Saint Lucia
26414,4/1/2021,LCA,Selangor,0,0,0,Saint Lucia
26415,4/1/2021,LIE,Johor,0,0,0,Liechtenstein
26416,4/1/2021,LIE,Kedah,0,0,0,Liechtenstein
26417,4/1/2021,LIE,Perlis,0,0,0,Liechtenstein
26418,4/1/2021,LIE,Pulau Pinang,0,0,0,Liechtenstein
26419,4/1/2021,LIE,Sabah,0,0,0,Liechtenstein
26420,4/1/2021,LIE,Sarawak,0,0,0,Liechtenstein
26421,4/1/2021,LIE,Selangor,1,1,0,Liechtenstein
26422,4/1/2021,LKA,Johor,3,3,0,Sri Lanka
26423,4/1/2021,LKA,Kedah,0,0,0,Sri Lanka
26424,4/1/2021,LKA,Kelantan,0,0,0,Sri Lanka
26425,4/1/2021,LKA,Melaka,0,0,0,Sri Lanka
26426,4/1/2021,LKA,Pahang,0,0,0,Sri Lanka
26427,4/1/2021,LKA,Perak,0,0,0,Sri Lanka
26428,4/1/2021,LKA,Perlis,0,0,0,Sri Lanka
26429,4/1/2021,LKA,Pulau Pinang,0,0,0,Sri Lanka
26430,4/1/2021,LKA,Sabah,0,0,0,Sri Lanka
26431,4/1/2021,LKA,Sarawak,0,0,0,Sri Lanka
26432,4/1/2021,LKA,Selangor,118,67,51,Sri Lanka
26433,4/1/2021,LKA,W.P. Labuan,0,0,0,Sri Lanka
26434,4/1/2021,LSO,Johor,0,0,0,Lesotho
26435,4/1/2021,LSO,Kedah,0,0,0,Lesotho
26436,4/1/2021,LSO,Pulau Pinang,0,0,0,Lesotho
26437,4/1/2021,LSO,Sarawak,0,0,0,Lesotho
26438,4/1/2021,LSO,Selangor,0,0,0,Lesotho
26439,4/1/2021,LTU,Johor,1,1,0,Lithuania
26440,4/1/2021,LTU,Kedah,0,0,0,Lithuania
26441,4/1/2021,LTU,Kelantan,0,0,0,Lithuania
26442,4/1/2021,LTU,Pahang,0,0,0,Lithuania
26443,4/1/2021,LTU,Perak,0,0,0,Lithuania
26444,4/1/2021,LTU,Perlis,0,0,0,Lithuania
26445,4/1/2021,LTU,Pulau Pinang,0,0,0,Lithuania
26446,4/1/2021,LTU,Sabah,0,0,0,Lithuania
26447,4/1/2021,LTU,Sarawak,0,0,0,Lithuania
26448,4/1/2021,LTU,Selangor,3,1,2,Lithuania
26449,4/1/2021,LTU,W.P. Labuan,0,0,0,Lithuania
26450,4/1/2021,LUX,Johor,0,0,0,Luxembourg
26451,4/1/2021,LUX,Kedah,0,0,0,Luxembourg
26452,4/1/2021,LUX,Kelantan,0,0,0,Luxembourg
26453,4/1/2021,LUX,Perak,0,0,0,Luxembourg
26454,4/1/2021,LUX,Perlis,0,0,0,Luxembourg
26455,4/1/2021,LUX,Pulau Pinang,0,0,0,Luxembourg
26456,4/1/2021,LUX,Sabah,0,0,0,Luxembourg
26457,4/1/2021,LUX,Sarawak,0,0,0,Luxembourg
26458,4/1/2021,LUX,Selangor,2,1,1,Luxembourg
26459,4/1/2021,LVA,Johor,0,0,0,Latvia
26460,4/1/2021,LVA,Kedah,0,0,0,Latvia
26461,4/1/2021,LVA,Kelantan,0,0,0,Latvia
26462,4/1/2021,LVA,Pahang,0,0,0,Latvia
26463,4/1/2021,LVA,Perak,0,0,0,Latvia
26464,4/1/2021,LVA,Perlis,0,0,0,Latvia
26465,4/1/2021,LVA,Pulau Pinang,0,0,0,Latvia
26466,4/1/2021,LVA,Sabah,0,0,0,Latvia
26467,4/1/2021,LVA,Sarawak,0,0,0,Latvia
26468,4/1/2021,LVA,Selangor,2,2,0,Latvia
26469,4/1/2021,LVA,W.P. Labuan,0,0,0,Latvia
26470,4/1/2021,MAC,Johor,0,0,0,Macao
26471,4/1/2021,MAC,Pahang,0,0,0,Macao
26472,4/1/2021,MAC,Perak,0,0,0,Macao
26473,4/1/2021,MAC,Selangor,0,0,0,Macao
26474,4/1/2021,MAC,W.P. Labuan,0,0,0,Macao
26475,4/1/2021,MAR,Johor,0,0,0,Morocco
26476,4/1/2021,MAR,Kedah,0,0,0,Morocco
26477,4/1/2021,MAR,Kelantan,0,0,0,Morocco
26478,4/1/2021,MAR,Melaka,0,0,0,Morocco
26479,4/1/2021,MAR,Pahang,0,0,0,Morocco
26480,4/1/2021,MAR,Perak,0,0,0,Morocco
26481,4/1/2021,MAR,Perlis,0,0,0,Morocco
26482,4/1/2021,MAR,Pulau Pinang,0,0,0,Morocco
26483,4/1/2021,MAR,Sabah,0,0,0,Morocco
26484,4/1/2021,MAR,Sarawak,0,0,0,Morocco
26485,4/1/2021,MAR,Selangor,12,6,6,Morocco
26486,4/1/2021,MAR,W.P. Labuan,0,0,0,Morocco
26487,4/1/2021,MCO,Johor,0,0,0,Monaco
26488,4/1/2021,MCO,Kedah,0,0,0,Monaco
26489,4/1/2021,MCO,Sabah,0,0,0,Monaco
26490,4/1/2021,MCO,Selangor,0,0,0,Monaco
26491,4/1/2021,MDA,Johor,0,0,0,"Moldova, Republic of"
26492,4/1/2021,MDA,Kedah,0,0,0,"Moldova, Republic of"
26493,4/1/2021,MDA,Kelantan,0,0,0,"Moldova, Republic of"
26494,4/1/2021,MDA,Negeri Sembilan,0,0,0,"Moldova, Republic of"
26495,4/1/2021,MDA,Perlis,0,0,0,"Moldova, Republic of"
26496,4/1/2021,MDA,Pulau Pinang,0,0,0,"Moldova, Republic of"
26497,4/1/2021,MDA,Sabah,0,0,0,"Moldova, Republic of"
26498,4/1/2021,MDA,Sarawak,0,0,0,"Moldova, Republic of"
26499,4/1/2021,MDA,Selangor,1,0,1,"Moldova, Republic of"
26500,4/1/2021,MDG,Johor,0,0,0,Madagascar
26501,4/1/2021,MDG,Kedah,0,0,0,Madagascar
26502,4/1/2021,MDG,Perak,0,0,0,Madagascar
26503,4/1/2021,MDG,Perlis,0,0,0,Madagascar
26504,4/1/2021,MDG,Pulau Pinang,0,0,0,Madagascar
26505,4/1/2021,MDG,Sabah,0,0,0,Madagascar
26506,4/1/2021,MDG,Sarawak,0,0,0,Madagascar
26507,4/1/2021,MDG,Selangor,1,1,0,Madagascar
26508,4/1/2021,MDV,Johor,0,0,0,Maldives
26509,4/1/2021,MDV,Kedah,0,0,0,Maldives
26510,4/1/2021,MDV,Kelantan,0,0,0,Maldives
26511,4/1/2021,MDV,Perak,0,0,0,Maldives
26512,4/1/2021,MDV,Perlis,0,0,0,Maldives
26513,4/1/2021,MDV,Pulau Pinang,0,0,0,Maldives
26514,4/1/2021,MDV,Sabah,0,0,0,Maldives
26515,4/1/2021,MDV,Sarawak,0,0,0,Maldives
26516,4/1/2021,MDV,Selangor,97,42,55,Maldives
26517,4/1/2021,MEX,Johor,0,0,0,Mexico
26518,4/1/2021,MEX,Kedah,0,0,0,Mexico
26519,4/1/2021,MEX,Kelantan,0,0,0,Mexico
26520,4/1/2021,MEX,Pahang,0,0,0,Mexico
26521,4/1/2021,MEX,Perak,0,0,0,Mexico
26522,4/1/2021,MEX,Perlis,0,0,0,Mexico
26523,4/1/2021,MEX,Pulau Pinang,0,0,0,Mexico
26524,4/1/2021,MEX,Sabah,0,0,0,Mexico
26525,4/1/2021,MEX,Sarawak,0,0,0,Mexico
26526,4/1/2021,MEX,Selangor,11,7,4,Mexico
26527,4/1/2021,MEX,W.P. Labuan,0,0,0,Mexico
26528,4/1/2021,MHL,Johor,0,0,0,Marshall Islands
26529,4/1/2021,MHL,Kedah,0,0,0,Marshall Islands
26530,4/1/2021,MHL,Perak,0,0,0,Marshall Islands
26531,4/1/2021,MHL,Pulau Pinang,0,0,0,Marshall Islands
26532,4/1/2021,MHL,Sabah,0,0,0,Marshall Islands
26533,4/1/2021,MHL,Selangor,1,1,0,Marshall Islands
26534,4/1/2021,MKD,Johor,0,0,0,"Macedonia, the former Yugoslav Republic of"
26535,4/1/2021,MKD,Kedah,0,0,0,"Macedonia, the former Yugoslav Republic of"
26536,4/1/2021,MKD,Perak,0,0,0,"Macedonia, the former Yugoslav Republic of"
26537,4/1/2021,MKD,Pulau Pinang,0,0,0,"Macedonia, the former Yugoslav Republic of"
26538,4/1/2021,MKD,Sabah,0,0,0,"Macedonia, the former Yugoslav Republic of"
26539,4/1/2021,MKD,Sarawak,0,0,0,"Macedonia, the former Yugoslav Republic of"
26540,4/1/2021,MKD,Selangor,2,2,0,"Macedonia, the former Yugoslav Republic of"
26541,4/1/2021,MLI,Johor,0,0,0,Mali
26542,4/1/2021,MLI,Sabah,0,0,0,Mali
26543,4/1/2021,MLI,Selangor,6,4,2,Mali
26544,4/1/2021,MLT,Johor,0,0,0,Malta
26545,4/1/2021,MLT,Kedah,0,0,0,Malta
26546,4/1/2021,MLT,Kelantan,0,0,0,Malta
26547,4/1/2021,MLT,Perak,0,0,0,Malta
26548,4/1/2021,MLT,Perlis,0,0,0,Malta
26549,4/1/2021,MLT,Pulau Pinang,0,0,0,Malta
26550,4/1/2021,MLT,Sabah,0,0,0,Malta
26551,4/1/2021,MLT,Sarawak,0,0,0,Malta
26552,4/1/2021,MLT,Selangor,1,1,0,Malta
26553,4/1/2021,MLT,W.P. Labuan,0,0,0,Malta
26554,4/1/2021,MMR,Johor,6,5,1,Myanmar
26555,4/1/2021,MMR,Kedah,0,0,0,Myanmar
26556,4/1/2021,MMR,Kelantan,0,0,0,Myanmar
26557,4/1/2021,MMR,Negeri Sembilan,0,0,0,Myanmar
26558,4/1/2021,MMR,Pahang,0,0,0,Myanmar
26559,4/1/2021,MMR,Perak,0,0,0,Myanmar
26560,4/1/2021,MMR,Perlis,0,0,0,Myanmar
26561,4/1/2021,MMR,Pulau Pinang,0,0,0,Myanmar
26562,4/1/2021,MMR,Sabah,0,0,0,Myanmar
26563,4/1/2021,MMR,Sarawak,0,0,0,Myanmar
26564,4/1/2021,MMR,Selangor,103,90,13,Myanmar
26565,4/1/2021,MMR,Terengganu,0,0,0,Myanmar
26566,4/1/2021,MMR,W.P. Labuan,0,0,0,Myanmar
26567,4/1/2021,MNE,Johor,0,0,0,Montenegro
26568,4/1/2021,MNE,Kedah,0,0,0,Montenegro
26569,4/1/2021,MNE,Pulau Pinang,0,0,0,Montenegro
26570,4/1/2021,MNE,Sabah,0,0,0,Montenegro
26571,4/1/2021,MNE,Sarawak,0,0,0,Montenegro
26572,4/1/2021,MNE,Selangor,6,6,0,Montenegro
26573,4/1/2021,MNG,Johor,0,0,0,Mongolia
26574,4/1/2021,MNG,Kedah,0,0,0,Mongolia
26575,4/1/2021,MNG,Kelantan,0,0,0,Mongolia
26576,4/1/2021,MNG,Perak,0,0,0,Mongolia
26577,4/1/2021,MNG,Perlis,0,0,0,Mongolia
26578,4/1/2021,MNG,Pulau Pinang,0,0,0,Mongolia
26579,4/1/2021,MNG,Sabah,0,0,0,Mongolia
26580,4/1/2021,MNG,Sarawak,0,0,0,Mongolia
26581,4/1/2021,MNG,Selangor,0,0,0,Mongolia
26582,4/1/2021,MNP,Selangor,0,0,0,Northern Mariana Islands
26583,4/1/2021,MOZ,Johor,0,0,0,Mozambique
26584,4/1/2021,MOZ,Kedah,0,0,0,Mozambique
26585,4/1/2021,MOZ,Perak,0,0,0,Mozambique
26586,4/1/2021,MOZ,Pulau Pinang,0,0,0,Mozambique
26587,4/1/2021,MOZ,Sabah,0,0,0,Mozambique
26588,4/1/2021,MOZ,Sarawak,0,0,0,Mozambique
26589,4/1/2021,MOZ,Selangor,4,4,0,Mozambique
26590,4/1/2021,MRT,Johor,0,0,0,Mauritania
26591,4/1/2021,MRT,Kedah,0,0,0,Mauritania
26592,4/1/2021,MRT,Pulau Pinang,0,0,0,Mauritania
26593,4/1/2021,MRT,Sabah,0,0,0,Mauritania
26594,4/1/2021,MRT,Sarawak,0,0,0,Mauritania
26595,4/1/2021,MRT,Selangor,2,1,1,Mauritania
26596,4/1/2021,MUS,Johor,0,0,0,Mauritius
26597,4/1/2021,MUS,Kedah,0,0,0,Mauritius
26598,4/1/2021,MUS,Kelantan,0,0,0,Mauritius
26599,4/1/2021,MUS,Pahang,0,0,0,Mauritius
26600,4/1/2021,MUS,Perak,0,0,0,Mauritius
26601,4/1/2021,MUS,Perlis,0,0,0,Mauritius
26602,4/1/2021,MUS,Pulau Pinang,0,0,0,Mauritius
26603,4/1/2021,MUS,Sabah,0,0,0,Mauritius
26604,4/1/2021,MUS,Sarawak,0,0,0,Mauritius
26605,4/1/2021,MUS,Selangor,8,4,4,Mauritius
26606,4/1/2021,MWI,Johor,0,0,0,Malawi
26607,4/1/2021,MWI,Pulau Pinang,0,0,0,Malawi
26608,4/1/2021,MWI,Sabah,0,0,0,Malawi
26609,4/1/2021,MWI,Sarawak,0,0,0,Malawi
26610,4/1/2021,MWI,Selangor,7,5,2,Malawi
26611,4/1/2021,MYT,Selangor,0,0,0,Mayotte
26612,4/1/2021,NAM,Johor,0,0,0,Namibia
26613,4/1/2021,NAM,Kedah,0,0,0,Namibia
26614,4/1/2021,NAM,Perak,0,0,0,Namibia
26615,4/1/2021,NAM,Perlis,0,0,0,Namibia
26616,4/1/2021,NAM,Pulau Pinang,0,0,0,Namibia
26617,4/1/2021,NAM,Sabah,0,0,0,Namibia
26618,4/1/2021,NAM,Sarawak,0,0,0,Namibia
26619,4/1/2021,NAM,Selangor,4,3,1,Namibia
26620,4/1/2021,NCL,Selangor,0,0,0,New Caledonia
26621,4/1/2021,NER,Johor,0,0,0,Niger
26622,4/1/2021,NER,Sabah,0,0,0,Niger
26623,4/1/2021,NER,Selangor,0,0,0,Niger
26624,4/1/2021,NGA,Johor,0,0,0,Nigeria
26625,4/1/2021,NGA,Kedah,0,0,0,Nigeria
26626,4/1/2021,NGA,Perlis,0,0,0,Nigeria
26627,4/1/2021,NGA,Pulau Pinang,0,0,0,Nigeria
26628,4/1/2021,NGA,Sabah,0,0,0,Nigeria
26629,4/1/2021,NGA,Sarawak,0,0,0,Nigeria
26630,4/1/2021,NGA,Selangor,164,155,9,Nigeria
26631,4/1/2021,NIC,Johor,0,0,0,Nicaragua
26632,4/1/2021,NIC,Kedah,0,0,0,Nicaragua
26633,4/1/2021,NIC,Pulau Pinang,0,0,0,Nicaragua
26634,4/1/2021,NIC,Sabah,0,0,0,Nicaragua
26635,4/1/2021,NIC,Selangor,5,5,0,Nicaragua
26636,4/1/2021,NLD,Johor,4,4,0,Netherlands
26637,4/1/2021,NLD,Kedah,0,0,0,Netherlands
26638,4/1/2021,NLD,Kelantan,0,0,0,Netherlands
26639,4/1/2021,NLD,Melaka,0,0,0,Netherlands
26640,4/1/2021,NLD,Negeri Sembilan,0,0,0,Netherlands
26641,4/1/2021,NLD,Pahang,0,0,0,Netherlands
26642,4/1/2021,NLD,Perak,0,0,0,Netherlands
26643,4/1/2021,NLD,Perlis,0,0,0,Netherlands
26644,4/1/2021,NLD,Pulau Pinang,0,0,0,Netherlands
26645,4/1/2021,NLD,Sabah,0,0,0,Netherlands
26646,4/1/2021,NLD,Sarawak,0,0,0,Netherlands
26647,4/1/2021,NLD,Selangor,61,50,11,Netherlands
26648,4/1/2021,NLD,Terengganu,0,0,0,Netherlands
26649,4/1/2021,NLD,W.P. Labuan,0,0,0,Netherlands
26650,4/1/2021,NOR,Johor,1,1,0,Norway
26651,4/1/2021,NOR,Kedah,0,0,0,Norway
26652,4/1/2021,NOR,Kelantan,0,0,0,Norway
26653,4/1/2021,NOR,Melaka,0,0,0,Norway
26654,4/1/2021,NOR,Pahang,0,0,0,Norway
26655,4/1/2021,NOR,Perak,0,0,0,Norway
26656,4/1/2021,NOR,Perlis,0,0,0,Norway
26657,4/1/2021,NOR,Pulau Pinang,0,0,0,Norway
26658,4/1/2021,NOR,Sabah,0,0,0,Norway
26659,4/1/2021,NOR,Sarawak,0,0,0,Norway
26660,4/1/2021,NOR,Selangor,12,10,2,Norway
26661,4/1/2021,NOR,W.P. Labuan,0,0,0,Norway
26662,4/1/2021,NPL,Johor,0,0,0,Nepal
26663,4/1/2021,NPL,Kedah,0,0,0,Nepal
26664,4/1/2021,NPL,Pahang,0,0,0,Nepal
26665,4/1/2021,NPL,Perak,0,0,0,Nepal
26666,4/1/2021,NPL,Perlis,0,0,0,Nepal
26667,4/1/2021,NPL,Pulau Pinang,0,0,0,Nepal
26668,4/1/2021,NPL,Sabah,0,0,0,Nepal
26669,4/1/2021,NPL,Sarawak,0,0,0,Nepal
26670,4/1/2021,NPL,Selangor,182,178,4,Nepal
26671,4/1/2021,NPL,W.P. Labuan,0,0,0,Nepal
26672,4/1/2021,NRU,Johor,0,0,0,Nauru
26673,4/1/2021,NRU,Pulau Pinang,0,0,0,Nauru
26674,4/1/2021,NRU,Selangor,0,0,0,Nauru
26675,4/1/2021,NZL,Johor,0,0,0,New Zealand
26676,4/1/2021,NZL,Kedah,0,0,0,New Zealand
26677,4/1/2021,NZL,Kelantan,0,0,0,New Zealand
26678,4/1/2021,NZL,Melaka,0,0,0,New Zealand
26679,4/1/2021,NZL,Negeri Sembilan,0,0,0,New Zealand
26680,4/1/2021,NZL,Pahang,0,0,0,New Zealand
26681,4/1/2021,NZL,Perak,0,0,0,New Zealand
26682,4/1/2021,NZL,Perlis,0,0,0,New Zealand
26683,4/1/2021,NZL,Pulau Pinang,0,0,0,New Zealand
26684,4/1/2021,NZL,Sabah,0,0,0,New Zealand
26685,4/1/2021,NZL,Sarawak,0,0,0,New Zealand
26686,4/1/2021,NZL,Selangor,26,17,9,New Zealand
26687,4/1/2021,NZL,Terengganu,0,0,0,New Zealand
26688,4/1/2021,NZL,W.P. Labuan,0,0,0,New Zealand
26689,4/1/2021,OMN,Johor,0,0,0,Oman
26690,4/1/2021,OMN,Kedah,0,0,0,Oman
26691,4/1/2021,OMN,Kelantan,0,0,0,Oman
26692,4/1/2021,OMN,Melaka,0,0,0,Oman
26693,4/1/2021,OMN,Perak,0,0,0,Oman
26694,4/1/2021,OMN,Perlis,0,0,0,Oman
26695,4/1/2021,OMN,Pulau Pinang,0,0,0,Oman
26696,4/1/2021,OMN,Sabah,0,0,0,Oman
26697,4/1/2021,OMN,Sarawak,0,0,0,Oman
26698,4/1/2021,OMN,Selangor,10,6,4,Oman
26699,4/1/2021,PAK,Johor,13,13,0,Pakistan
26700,4/1/2021,PAK,Kedah,0,0,0,Pakistan
26701,4/1/2021,PAK,Kelantan,0,0,0,Pakistan
26702,4/1/2021,PAK,Melaka,0,0,0,Pakistan
26703,4/1/2021,PAK,Negeri Sembilan,0,0,0,Pakistan
26704,4/1/2021,PAK,Pahang,0,0,0,Pakistan
26705,4/1/2021,PAK,Perak,0,0,0,Pakistan
26706,4/1/2021,PAK,Perlis,0,0,0,Pakistan
26707,4/1/2021,PAK,Pulau Pinang,0,0,0,Pakistan
26708,4/1/2021,PAK,Sabah,1,1,0,Pakistan
26709,4/1/2021,PAK,Sarawak,0,0,0,Pakistan
26710,4/1/2021,PAK,Selangor,298,232,66,Pakistan
26711,4/1/2021,PAK,W.P. Labuan,0,0,0,Pakistan
26712,4/1/2021,PAN,Johor,0,0,0,Panama
26713,4/1/2021,PAN,Kedah,0,0,0,Panama
26714,4/1/2021,PAN,Perak,0,0,0,Panama
26715,4/1/2021,PAN,Perlis,0,0,0,Panama
26716,4/1/2021,PAN,Pulau Pinang,0,0,0,Panama
26717,4/1/2021,PAN,Sabah,0,0,0,Panama
26718,4/1/2021,PAN,Sarawak,0,0,0,Panama
26719,4/1/2021,PAN,Selangor,1,1,0,Panama
26720,4/1/2021,PER,Johor,0,0,0,Peru
26721,4/1/2021,PER,Kedah,0,0,0,Peru
26722,4/1/2021,PER,Kelantan,0,0,0,Peru
26723,4/1/2021,PER,Pahang,0,0,0,Peru
26724,4/1/2021,PER,Perak,0,0,0,Peru
26725,4/1/2021,PER,Perlis,0,0,0,Peru
26726,4/1/2021,PER,Pulau Pinang,0,0,0,Peru
26727,4/1/2021,PER,Sabah,0,0,0,Peru
26728,4/1/2021,PER,Sarawak,0,0,0,Peru
26729,4/1/2021,PER,Selangor,2,1,1,Peru
26730,4/1/2021,PER,W.P. Labuan,0,0,0,Peru
26731,4/1/2021,PHL,Johor,158,156,2,Philippines
26732,4/1/2021,PHL,Kedah,0,0,0,Philippines
26733,4/1/2021,PHL,Kelantan,0,0,0,Philippines
26734,4/1/2021,PHL,Melaka,0,0,0,Philippines
26735,4/1/2021,PHL,Negeri Sembilan,0,0,0,Philippines
26736,4/1/2021,PHL,Pahang,0,0,0,Philippines
26737,4/1/2021,PHL,Perak,0,0,0,Philippines
26738,4/1/2021,PHL,Perlis,0,0,0,Philippines
26739,4/1/2021,PHL,Pulau Pinang,1,1,0,Philippines
26740,4/1/2021,PHL,Sabah,0,0,0,Philippines
26741,4/1/2021,PHL,Sarawak,72,72,0,Philippines
26742,4/1/2021,PHL,Selangor,622,512,110,Philippines
26743,4/1/2021,PHL,Terengganu,0,0,0,Philippines
26744,4/1/2021,PHL,W.P. Labuan,2,2,0,Philippines
26745,4/1/2021,PLW,Johor,0,0,0,Palau
26746,4/1/2021,PLW,Pulau Pinang,0,0,0,Palau
26747,4/1/2021,PLW,Selangor,0,0,0,Palau
26748,4/1/2021,PNG,Johor,0,0,0,Papua New Guinea
26749,4/1/2021,PNG,Kedah,0,0,0,Papua New Guinea
26750,4/1/2021,PNG,Kelantan,0,0,0,Papua New Guinea
26751,4/1/2021,PNG,Perak,0,0,0,Papua New Guinea
26752,4/1/2021,PNG,Pulau Pinang,0,0,0,Papua New Guinea
26753,4/1/2021,PNG,Sabah,0,0,0,Papua New Guinea
26754,4/1/2021,PNG,Sarawak,0,0,0,Papua New Guinea
26755,4/1/2021,PNG,Selangor,1,0,1,Papua New Guinea
26756,4/1/2021,POL,Johor,4,4,0,Poland
26757,4/1/2021,POL,Kedah,0,0,0,Poland
26758,4/1/2021,POL,Kelantan,0,0,0,Poland
26759,4/1/2021,POL,Melaka,0,0,0,Poland
26760,4/1/2021,POL,Negeri Sembilan,0,0,0,Poland
26761,4/1/2021,POL,Pahang,0,0,0,Poland
26762,4/1/2021,POL,Perak,0,0,0,Poland
26763,4/1/2021,POL,Perlis,0,0,0,Poland
26764,4/1/2021,POL,Pulau Pinang,0,0,0,Poland
26765,4/1/2021,POL,Sabah,0,0,0,Poland
26766,4/1/2021,POL,Sarawak,0,0,0,Poland
26767,4/1/2021,POL,Selangor,26,26,0,Poland
26768,4/1/2021,POL,Terengganu,0,0,0,Poland
26769,4/1/2021,POL,W.P. Labuan,0,0,0,Poland
26770,4/1/2021,PRK,Selangor,0,0,0,"Korea, Democratic People's Republic of"
26771,4/1/2021,PRT,Johor,0,0,0,Portugal
26772,4/1/2021,PRT,Kedah,0,0,0,Portugal
26773,4/1/2021,PRT,Kelantan,0,0,0,Portugal
26774,4/1/2021,PRT,Melaka,0,0,0,Portugal
26775,4/1/2021,PRT,Pahang,0,0,0,Portugal
26776,4/1/2021,PRT,Perak,0,0,0,Portugal
26777,4/1/2021,PRT,Perlis,0,0,0,Portugal
26778,4/1/2021,PRT,Pulau Pinang,0,0,0,Portugal
26779,4/1/2021,PRT,Sabah,0,0,0,Portugal
26780,4/1/2021,PRT,Sarawak,0,0,0,Portugal
26781,4/1/2021,PRT,Selangor,7,4,3,Portugal
26782,4/1/2021,PRT,W.P. Labuan,0,0,0,Portugal
26783,4/1/2021,PRY,Johor,0,0,0,Paraguay
26784,4/1/2021,PRY,Kedah,0,0,0,Paraguay
26785,4/1/2021,PRY,Perak,0,0,0,Paraguay
26786,4/1/2021,PRY,Perlis,0,0,0,Paraguay
26787,4/1/2021,PRY,Pulau Pinang,0,0,0,Paraguay
26788,4/1/2021,PRY,Sabah,0,0,0,Paraguay
26789,4/1/2021,PRY,Sarawak,0,0,0,Paraguay
26790,4/1/2021,PRY,Selangor,0,0,0,Paraguay
26791,4/1/2021,PSE,Johor,0,0,0,"Palestinian Territory, Occupied"
26792,4/1/2021,PSE,Kedah,0,0,0,"Palestinian Territory, Occupied"
26793,4/1/2021,PSE,Kelantan,0,0,0,"Palestinian Territory, Occupied"
26794,4/1/2021,PSE,Melaka,0,0,0,"Palestinian Territory, Occupied"
26795,4/1/2021,PSE,Perak,0,0,0,"Palestinian Territory, Occupied"
26796,4/1/2021,PSE,Perlis,0,0,0,"Palestinian Territory, Occupied"
26797,4/1/2021,PSE,Pulau Pinang,0,0,0,"Palestinian Territory, Occupied"
26798,4/1/2021,PSE,Sabah,0,0,0,"Palestinian Territory, Occupied"
26799,4/1/2021,PSE,Sarawak,0,0,0,"Palestinian Territory, Occupied"
26800,4/1/2021,PSE,Selangor,15,14,1,"Palestinian Territory, Occupied"
26801,4/1/2021,QAT,Johor,0,0,0,Qatar
26802,4/1/2021,QAT,Kedah,0,0,0,Qatar
26803,4/1/2021,QAT,Perlis,0,0,0,Qatar
26804,4/1/2021,QAT,Pulau Pinang,0,0,0,Qatar
26805,4/1/2021,QAT,Sabah,0,0,0,Qatar
26806,4/1/2021,QAT,Sarawak,0,0,0,Qatar
26807,4/1/2021,QAT,Selangor,8,4,4,Qatar
26808,4/1/2021,REU,Johor,0,0,0,Reunion
26809,4/1/2021,REU,Sarawak,0,0,0,Reunion
26810,4/1/2021,ROU,Johor,0,0,0,Romania
26811,4/1/2021,ROU,Kedah,0,0,0,Romania
26812,4/1/2021,ROU,Kelantan,0,0,0,Romania
26813,4/1/2021,ROU,Negeri Sembilan,0,0,0,Romania
26814,4/1/2021,ROU,Pahang,0,0,0,Romania
26815,4/1/2021,ROU,Perak,0,0,0,Romania
26816,4/1/2021,ROU,Perlis,0,0,0,Romania
26817,4/1/2021,ROU,Pulau Pinang,0,0,0,Romania
26818,4/1/2021,ROU,Sabah,0,0,0,Romania
26819,4/1/2021,ROU,Sarawak,0,0,0,Romania
26820,4/1/2021,ROU,Selangor,22,19,3,Romania
26821,4/1/2021,ROU,W.P. Labuan,0,0,0,Romania
26822,4/1/2021,RUS,Johor,5,5,0,Russia
26823,4/1/2021,RUS,Kedah,3,3,0,Russia
26824,4/1/2021,RUS,Kelantan,0,0,0,Russia
26825,4/1/2021,RUS,Melaka,0,0,0,Russia
26826,4/1/2021,RUS,Negeri Sembilan,0,0,0,Russia
26827,4/1/2021,RUS,Pahang,0,0,0,Russia
26828,4/1/2021,RUS,Perak,0,0,0,Russia
26829,4/1/2021,RUS,Perlis,0,0,0,Russia
26830,4/1/2021,RUS,Pulau Pinang,0,0,0,Russia
26831,4/1/2021,RUS,Sabah,0,0,0,Russia
26832,4/1/2021,RUS,Sarawak,0,0,0,Russia
26833,4/1/2021,RUS,Selangor,101,84,17,Russia
26834,4/1/2021,RUS,W.P. Labuan,0,0,0,Russia
26835,4/1/2021,RWA,Johor,0,0,0,Rwanda
26836,4/1/2021,RWA,Kedah,0,0,0,Rwanda
26837,4/1/2021,RWA,Pulau Pinang,0,0,0,Rwanda
26838,4/1/2021,RWA,Selangor,4,3,1,Rwanda
26839,4/1/2021,SAU,Johor,0,0,0,Saudi Arabia
26840,4/1/2021,SAU,Kedah,0,0,0,Saudi Arabia
26841,4/1/2021,SAU,Kelantan,0,0,0,Saudi Arabia
26842,4/1/2021,SAU,Melaka,0,0,0,Saudi Arabia
26843,4/1/2021,SAU,Perak,0,0,0,Saudi Arabia
26844,4/1/2021,SAU,Perlis,0,0,0,Saudi Arabia
26845,4/1/2021,SAU,Pulau Pinang,0,0,0,Saudi Arabia
26846,4/1/2021,SAU,Sabah,0,0,0,Saudi Arabia
26847,4/1/2021,SAU,Sarawak,0,0,0,Saudi Arabia
26848,4/1/2021,SAU,Selangor,64,36,28,Saudi Arabia
26849,4/1/2021,SAU,W.P. Labuan,0,0,0,Saudi Arabia
26850,4/1/2021,SDN,Johor,0,0,0,Sudan
26851,4/1/2021,SDN,Kedah,0,0,0,Sudan
26852,4/1/2021,SDN,Kelantan,0,0,0,Sudan
26853,4/1/2021,SDN,Perlis,0,0,0,Sudan
26854,4/1/2021,SDN,Pulau Pinang,0,0,0,Sudan
26855,4/1/2021,SDN,Sabah,0,0,0,Sudan
26856,4/1/2021,SDN,Sarawak,0,0,0,Sudan
26857,4/1/2021,SDN,Selangor,67,40,27,Sudan
26858,4/1/2021,SDN,W.P. Labuan,0,0,0,Sudan
26859,4/1/2021,SEN,Johor,0,0,0,Senegal
26860,4/1/2021,SEN,Kedah,0,0,0,Senegal
26861,4/1/2021,SEN,Kelantan,0,0,0,Senegal
26862,4/1/2021,SEN,Perak,0,0,0,Senegal
26863,4/1/2021,SEN,Perlis,0,0,0,Senegal
26864,4/1/2021,SEN,Pulau Pinang,0,0,0,Senegal
26865,4/1/2021,SEN,Sabah,0,0,0,Senegal
26866,4/1/2021,SEN,Sarawak,0,0,0,Senegal
26867,4/1/2021,SEN,Selangor,2,2,0,Senegal
26868,4/1/2021,SGP,Johor,244,217,27,Singapore
26869,4/1/2021,SGP,Kedah,0,0,0,Singapore
26870,4/1/2021,SGP,Kelantan,0,0,0,Singapore
26871,4/1/2021,SGP,Melaka,0,0,0,Singapore
26872,4/1/2021,SGP,Negeri Sembilan,0,0,0,Singapore
26873,4/1/2021,SGP,Pahang,0,0,0,Singapore
26874,4/1/2021,SGP,Perak,8,3,5,Singapore
26875,4/1/2021,SGP,Perlis,1,0,1,Singapore
26876,4/1/2021,SGP,Pulau Pinang,20,14,6,Singapore
26877,4/1/2021,SGP,Sabah,1,1,0,Singapore
26878,4/1/2021,SGP,Sarawak,6,4,2,Singapore
26879,4/1/2021,SGP,Selangor,162,104,58,Singapore
26880,4/1/2021,SGP,Terengganu,0,0,0,Singapore
26881,4/1/2021,SGP,W.P. Labuan,0,0,0,Singapore
26882,4/1/2021,SGS,Johor,0,0,0,South Georgia and the South Sandwich Islands
26883,4/1/2021,SGS,Sabah,0,0,0,South Georgia and the South Sandwich Islands
26884,4/1/2021,SGS,Selangor,0,0,0,South Georgia and the South Sandwich Islands
26885,4/1/2021,SHN,Sarawak,0,0,0,"Saint Helena, Ascension and Tristan da Cunha"
26886,4/1/2021,SLB,Johor,0,0,0,Solomon Islands
26887,4/1/2021,SLB,Perlis,0,0,0,Solomon Islands
26888,4/1/2021,SLB,Pulau Pinang,0,0,0,Solomon Islands
26889,4/1/2021,SLB,Sabah,0,0,0,Solomon Islands
26890,4/1/2021,SLB,Sarawak,0,0,0,Solomon Islands
26891,4/1/2021,SLB,Selangor,0,0,0,Solomon Islands
26892,4/1/2021,SLB,W.P. Labuan,0,0,0,Solomon Islands
26893,4/1/2021,SLE,Johor,0,0,0,Sierra Leone
26894,4/1/2021,SLE,Kedah,0,0,0,Sierra Leone
26895,4/1/2021,SLE,Perak,0,0,0,Sierra Leone
26896,4/1/2021,SLE,Pulau Pinang,0,0,0,Sierra Leone
26897,4/1/2021,SLE,Sabah,0,0,0,Sierra Leone
26898,4/1/2021,SLE,Selangor,2,2,0,Sierra Leone
26899,4/1/2021,SLV,Johor,0,0,0,El Salvador
26900,4/1/2021,SLV,Kedah,0,0,0,El Salvador
26901,4/1/2021,SLV,Perak,0,0,0,El Salvador
26902,4/1/2021,SLV,Perlis,0,0,0,El Salvador
26903,4/1/2021,SLV,Pulau Pinang,0,0,0,El Salvador
26904,4/1/2021,SLV,Sabah,0,0,0,El Salvador
26905,4/1/2021,SLV,Selangor,0,0,0,El Salvador
26906,4/1/2021,SLV,W.P. Labuan,0,0,0,El Salvador
26907,4/1/2021,SMR,Johor,0,0,0,San Marino
26908,4/1/2021,SMR,Selangor,0,0,0,San Marino
26909,4/1/2021,SOM,Johor,0,0,0,Somalia
26910,4/1/2021,SOM,Kedah,0,0,0,Somalia
26911,4/1/2021,SOM,Kelantan,0,0,0,Somalia
26912,4/1/2021,SOM,Perlis,0,0,0,Somalia
26913,4/1/2021,SOM,Sabah,0,0,0,Somalia
26914,4/1/2021,SOM,Sarawak,0,0,0,Somalia
26915,4/1/2021,SOM,Selangor,48,38,10,Somalia
26916,4/1/2021,SRB,Johor,0,0,0,Serbia
26917,4/1/2021,SRB,Kedah,0,0,0,Serbia
26918,4/1/2021,SRB,Kelantan,0,0,0,Serbia
26919,4/1/2021,SRB,Pahang,0,0,0,Serbia
26920,4/1/2021,SRB,Perak,0,0,0,Serbia
26921,4/1/2021,SRB,Perlis,0,0,0,Serbia
26922,4/1/2021,SRB,Pulau Pinang,0,0,0,Serbia
26923,4/1/2021,SRB,Sabah,0,0,0,Serbia
26924,4/1/2021,SRB,Sarawak,0,0,0,Serbia
26925,4/1/2021,SRB,Selangor,2,1,1,Serbia
26926,4/1/2021,STP,Selangor,0,0,0,Sao Tome and Principe
26927,4/1/2021,SUR,Johor,0,0,0,Suriname
26928,4/1/2021,SUR,Kedah,0,0,0,Suriname
26929,4/1/2021,SUR,Kelantan,0,0,0,Suriname
26930,4/1/2021,SUR,Perak,0,0,0,Suriname
26931,4/1/2021,SUR,Perlis,0,0,0,Suriname
26932,4/1/2021,SUR,Pulau Pinang,0,0,0,Suriname
26933,4/1/2021,SUR,Sabah,0,0,0,Suriname
26934,4/1/2021,SUR,Sarawak,0,0,0,Suriname
26935,4/1/2021,SUR,Selangor,0,0,0,Suriname
26936,4/1/2021,SVK,Johor,0,0,0,Slovakia
26937,4/1/2021,SVK,Kedah,0,0,0,Slovakia
26938,4/1/2021,SVK,Kelantan,0,0,0,Slovakia
26939,4/1/2021,SVK,Negeri Sembilan,0,0,0,Slovakia
26940,4/1/2021,SVK,Pahang,0,0,0,Slovakia
26941,4/1/2021,SVK,Perak,0,0,0,Slovakia
26942,4/1/2021,SVK,Perlis,0,0,0,Slovakia
26943,4/1/2021,SVK,Pulau Pinang,0,0,0,Slovakia
26944,4/1/2021,SVK,Sabah,0,0,0,Slovakia
26945,4/1/2021,SVK,Sarawak,0,0,0,Slovakia
26946,4/1/2021,SVK,Selangor,11,8,3,Slovakia
26947,4/1/2021,SVK,W.P. Labuan,0,0,0,Slovakia
26948,4/1/2021,SVN,Johor,0,0,0,Slovenia
26949,4/1/2021,SVN,Kedah,0,0,0,Slovenia
26950,4/1/2021,SVN,Kelantan,0,0,0,Slovenia
26951,4/1/2021,SVN,Perak,0,0,0,Slovenia
26952,4/1/2021,SVN,Perlis,0,0,0,Slovenia
26953,4/1/2021,SVN,Pulau Pinang,0,0,0,Slovenia
26954,4/1/2021,SVN,Sabah,0,0,0,Slovenia
26955,4/1/2021,SVN,Sarawak,0,0,0,Slovenia
26956,4/1/2021,SVN,Selangor,1,1,0,Slovenia
26957,4/1/2021,SVN,W.P. Labuan,0,0,0,Slovenia
26958,4/1/2021,SWE,Johor,2,2,0,Sweden
26959,4/1/2021,SWE,Kedah,0,0,0,Sweden
26960,4/1/2021,SWE,Kelantan,0,0,0,Sweden
26961,4/1/2021,SWE,Melaka,0,0,0,Sweden
26962,4/1/2021,SWE,Negeri Sembilan,0,0,0,Sweden
26963,4/1/2021,SWE,Pahang,0,0,0,Sweden
26964,4/1/2021,SWE,Perak,0,0,0,Sweden
26965,4/1/2021,SWE,Perlis,0,0,0,Sweden
26966,4/1/2021,SWE,Pulau Pinang,0,0,0,Sweden
26967,4/1/2021,SWE,Sabah,0,0,0,Sweden
26968,4/1/2021,SWE,Sarawak,0,0,0,Sweden
26969,4/1/2021,SWE,Selangor,32,27,5,Sweden
26970,4/1/2021,SWE,W.P. Labuan,0,0,0,Sweden
26971,4/1/2021,SWZ,Johor,0,0,0,Swaziland
26972,4/1/2021,SWZ,Kedah,0,0,0,Swaziland
26973,4/1/2021,SWZ,Pulau Pinang,0,0,0,Swaziland
26974,4/1/2021,SWZ,Sabah,0,0,0,Swaziland
26975,4/1/2021,SWZ,Selangor,1,1,0,Swaziland
26976,4/1/2021,SYC,Johor,0,0,0,Seychelles
26977,4/1/2021,SYC,Kedah,0,0,0,Seychelles
26978,4/1/2021,SYC,Pulau Pinang,0,0,0,Seychelles
26979,4/1/2021,SYC,Sabah,0,0,0,Seychelles
26980,4/1/2021,SYC,Sarawak,0,0,0,Seychelles
26981,4/1/2021,SYC,Selangor,6,1,5,Seychelles
26982,4/1/2021,SYR,Johor,0,0,0,Syrian Arab Republic
26983,4/1/2021,SYR,Kedah,0,0,0,Syrian Arab Republic
26984,4/1/2021,SYR,Kelantan,0,0,0,Syrian Arab Republic
26985,4/1/2021,SYR,Pahang,0,0,0,Syrian Arab Republic
26986,4/1/2021,SYR,Perlis,0,0,0,Syrian Arab Republic
26987,4/1/2021,SYR,Pulau Pinang,0,0,0,Syrian Arab Republic
26988,4/1/2021,SYR,Sabah,0,0,0,Syrian Arab Republic
26989,4/1/2021,SYR,Sarawak,0,0,0,Syrian Arab Republic
26990,4/1/2021,SYR,Selangor,33,22,11,Syrian Arab Republic
26991,4/1/2021,SYR,W.P. Labuan,0,0,0,Syrian Arab Republic
26992,4/1/2021,TCA,Perlis,0,0,0,Turks and Caicos
26993,4/1/2021,TCD,Johor,0,0,0,Chad
26994,4/1/2021,TCD,Kedah,0,0,0,Chad
26995,4/1/2021,TCD,Perlis,0,0,0,Chad
26996,4/1/2021,TCD,Selangor,3,3,0,Chad
26997,4/1/2021,TGO,Johor,0,0,0,Togo
26998,4/1/2021,TGO,Perak,0,0,0,Togo
26999,4/1/2021,TGO,Pulau Pinang,0,0,0,Togo
27000,4/1/2021,TGO,Selangor,1,1,0,Togo
27001,4/1/2021,THA,Johor,7,7,0,Thailand
27002,4/1/2021,THA,Kedah,17845,17805,40,Thailand
27003,4/1/2021,THA,Kelantan,5,2,3,Thailand
27004,4/1/2021,THA,Melaka,0,0,0,Thailand
27005,4/1/2021,THA,Negeri Sembilan,0,0,0,Thailand
27006,4/1/2021,THA,Pahang,0,0,0,Thailand
27007,4/1/2021,THA,Perak,0,0,0,Thailand
27008,4/1/2021,THA,Perlis,8154,7874,280,Thailand
27009,4/1/2021,THA,Pulau Pinang,2,1,1,Thailand
27010,4/1/2021,THA,Sabah,0,0,0,Thailand
27011,4/1/2021,THA,Sarawak,14,14,0,Thailand
27012,4/1/2021,THA,Selangor,243,144,99,Thailand
27013,4/1/2021,THA,Terengganu,0,0,0,Thailand
27014,4/1/2021,THA,W.P. Labuan,0,0,0,Thailand
27015,4/1/2021,TJK,Johor,0,0,0,Tajikistan
27016,4/1/2021,TJK,Kedah,0,0,0,Tajikistan
27017,4/1/2021,TJK,Perlis,0,0,0,Tajikistan
27018,4/1/2021,TJK,Pulau Pinang,0,0,0,Tajikistan
27019,4/1/2021,TJK,Sabah,0,0,0,Tajikistan
27020,4/1/2021,TJK,Selangor,3,3,0,Tajikistan
27021,4/1/2021,TKL,Selangor,0,0,0,Tokelau
27022,4/1/2021,TKM,Johor,0,0,0,Turkmenistan
27023,4/1/2021,TKM,Kedah,0,0,0,Turkmenistan
27024,4/1/2021,TKM,Kelantan,0,0,0,Turkmenistan
27025,4/1/2021,TKM,Perlis,0,0,0,Turkmenistan
27026,4/1/2021,TKM,Pulau Pinang,0,0,0,Turkmenistan
27027,4/1/2021,TKM,Sabah,0,0,0,Turkmenistan
27028,4/1/2021,TKM,Sarawak,0,0,0,Turkmenistan
27029,4/1/2021,TKM,Selangor,1,0,1,Turkmenistan
27030,4/1/2021,TLS,Johor,0,0,0,Timor-Leste
27031,4/1/2021,TLS,Kedah,0,0,0,Timor-Leste
27032,4/1/2021,TLS,Perlis,0,0,0,Timor-Leste
27033,4/1/2021,TLS,Pulau Pinang,0,0,0,Timor-Leste
27034,4/1/2021,TLS,Sabah,0,0,0,Timor-Leste
27035,4/1/2021,TLS,Sarawak,0,0,0,Timor-Leste
27036,4/1/2021,TLS,Selangor,2,1,1,Timor-Leste
27037,4/1/2021,TON,Johor,0,0,0,Tonga
27038,4/1/2021,TON,Pulau Pinang,0,0,0,Tonga
27039,4/1/2021,TON,Sarawak,0,0,0,Tonga
27040,4/1/2021,TON,Selangor,0,0,0,Tonga
27041,4/1/2021,TTO,Johor,0,0,0,Trinidad and Tobago
27042,4/1/2021,TTO,Kedah,0,0,0,Trinidad and Tobago
27043,4/1/2021,TTO,Pahang,0,0,0,Trinidad and Tobago
27044,4/1/2021,TTO,Pulau Pinang,0,0,0,Trinidad and Tobago
27045,4/1/2021,TTO,Sabah,0,0,0,Trinidad and Tobago
27046,4/1/2021,TTO,Sarawak,0,0,0,Trinidad and Tobago
27047,4/1/2021,TTO,Selangor,1,0,1,Trinidad and Tobago
27048,4/1/2021,TUN,Johor,0,0,0,Tunisia
27049,4/1/2021,TUN,Kedah,0,0,0,Tunisia
27050,4/1/2021,TUN,Kelantan,0,0,0,Tunisia
27051,4/1/2021,TUN,Melaka,0,0,0,Tunisia
27052,4/1/2021,TUN,Perak,0,0,0,Tunisia
27053,4/1/2021,TUN,Perlis,0,0,0,Tunisia
27054,4/1/2021,TUN,Pulau Pinang,0,0,0,Tunisia
27055,4/1/2021,TUN,Sabah,0,0,0,Tunisia
27056,4/1/2021,TUN,Sarawak,0,0,0,Tunisia
27057,4/1/2021,TUN,Selangor,6,3,3,Tunisia
27058,4/1/2021,TUN,W.P. Labuan,0,0,0,Tunisia
27059,4/1/2021,TUR,Johor,1,1,0,Turkey
27060,4/1/2021,TUR,Kedah,0,0,0,Turkey
27061,4/1/2021,TUR,Kelantan,0,0,0,Turkey
27062,4/1/2021,TUR,Melaka,0,0,0,Turkey
27063,4/1/2021,TUR,Negeri Sembilan,0,0,0,Turkey
27064,4/1/2021,TUR,Pahang,0,0,0,Turkey
27065,4/1/2021,TUR,Perak,0,0,0,Turkey
27066,4/1/2021,TUR,Perlis,0,0,0,Turkey
27067,4/1/2021,TUR,Pulau Pinang,0,0,0,Turkey
27068,4/1/2021,TUR,Sabah,0,0,0,Turkey
27069,4/1/2021,TUR,Sarawak,0,0,0,Turkey
27070,4/1/2021,TUR,Selangor,27,22,5,Turkey
27071,4/1/2021,TUR,W.P. Labuan,0,0,0,Turkey
27072,4/1/2021,TUV,Selangor,0,0,0,Tuvalu
27073,4/1/2021,TWN,Johor,2,2,0,Taiwan
27074,4/1/2021,TWN,Kedah,0,0,0,Taiwan
27075,4/1/2021,TWN,Kelantan,0,0,0,Taiwan
27076,4/1/2021,TWN,Melaka,0,0,0,Taiwan
27077,4/1/2021,TWN,Negeri Sembilan,0,0,0,Taiwan
27078,4/1/2021,TWN,Pahang,0,0,0,Taiwan
27079,4/1/2021,TWN,Perak,0,0,0,Taiwan
27080,4/1/2021,TWN,Perlis,0,0,0,Taiwan
27081,4/1/2021,TWN,Pulau Pinang,15,10,5,Taiwan
27082,4/1/2021,TWN,Sabah,0,0,0,Taiwan
27083,4/1/2021,TWN,Sarawak,2,2,0,Taiwan
27084,4/1/2021,TWN,Selangor,89,65,24,Taiwan
27085,4/1/2021,TWN,W.P. Labuan,0,0,0,Taiwan
27086,4/1/2021,TZA,Johor,0,0,0,"Tanzania, United Republic of"
27087,4/1/2021,TZA,Kedah,0,0,0,"Tanzania, United Republic of"
27088,4/1/2021,TZA,Perak,0,0,0,"Tanzania, United Republic of"
27089,4/1/2021,TZA,Perlis,0,0,0,"Tanzania, United Republic of"
27090,4/1/2021,TZA,Pulau Pinang,0,0,0,"Tanzania, United Republic of"
27091,4/1/2021,TZA,Sabah,0,0,0,"Tanzania, United Republic of"
27092,4/1/2021,TZA,Sarawak,0,0,0,"Tanzania, United Republic of"
27093,4/1/2021,TZA,Selangor,32,14,18,"Tanzania, United Republic of"
27094,4/1/2021,UGA,Johor,0,0,0,Uganda
27095,4/1/2021,UGA,Kedah,0,0,0,Uganda
27096,4/1/2021,UGA,Perak,0,0,0,Uganda
27097,4/1/2021,UGA,Perlis,0,0,0,Uganda
27098,4/1/2021,UGA,Pulau Pinang,0,0,0,Uganda
27099,4/1/2021,UGA,Sabah,0,0,0,Uganda
27100,4/1/2021,UGA,Sarawak,0,0,0,Uganda
27101,4/1/2021,UGA,Selangor,9,3,6,Uganda
27102,4/1/2021,UKR,Johor,8,8,0,Ukraine
27103,4/1/2021,UKR,Kedah,0,0,0,Ukraine
27104,4/1/2021,UKR,Kelantan,0,0,0,Ukraine
27105,4/1/2021,UKR,Melaka,0,0,0,Ukraine
27106,4/1/2021,UKR,Negeri Sembilan,0,0,0,Ukraine
27107,4/1/2021,UKR,Pahang,0,0,0,Ukraine
27108,4/1/2021,UKR,Perak,0,0,0,Ukraine
27109,4/1/2021,UKR,Perlis,0,0,0,Ukraine
27110,4/1/2021,UKR,Pulau Pinang,0,0,0,Ukraine
27111,4/1/2021,UKR,Sabah,0,0,0,Ukraine
27112,4/1/2021,UKR,Sarawak,0,0,0,Ukraine
27113,4/1/2021,UKR,Selangor,63,62,1,Ukraine
27114,4/1/2021,UKR,W.P. Labuan,0,0,0,Ukraine
27115,4/1/2021,URY,Johor,0,0,0,Uruguay
27116,4/1/2021,URY,Kedah,0,0,0,Uruguay
27117,4/1/2021,URY,Kelantan,0,0,0,Uruguay
27118,4/1/2021,URY,Perak,0,0,0,Uruguay
27119,4/1/2021,URY,Perlis,0,0,0,Uruguay
27120,4/1/2021,URY,Pulau Pinang,0,0,0,Uruguay
27121,4/1/2021,URY,Sabah,0,0,0,Uruguay
27122,4/1/2021,URY,Sarawak,0,0,0,Uruguay
27123,4/1/2021,URY,Selangor,0,0,0,Uruguay
27124,4/1/2021,URY,W.P. Labuan,0,0,0,Uruguay
27125,4/1/2021,USA,Johor,0,0,0,United States Of America
27126,4/1/2021,USA,Kedah,0,0,0,United States Of America
27127,4/1/2021,USA,Kelantan,0,0,0,United States Of America
27128,4/1/2021,USA,Melaka,0,0,0,United States Of America
27129,4/1/2021,USA,Negeri Sembilan,0,0,0,United States Of America
27130,4/1/2021,USA,Pahang,0,0,0,United States Of America
27131,4/1/2021,USA,Perak,0,0,0,United States Of America
27132,4/1/2021,USA,Perlis,0,0,0,United States Of America
27133,4/1/2021,USA,Pulau Pinang,4,0,4,United States Of America
27134,4/1/2021,USA,Sabah,0,0,0,United States Of America
27135,4/1/2021,USA,Sarawak,2,1,1,United States Of America
27136,4/1/2021,USA,Selangor,164,119,45,United States Of America
27137,4/1/2021,USA,Terengganu,0,0,0,United States Of America
27138,4/1/2021,USA,W.P. Labuan,0,0,0,United States Of America
27139,4/1/2021,UZB,Johor,0,0,0,Uzbekistan
27140,4/1/2021,UZB,Kedah,0,0,0,Uzbekistan
27141,4/1/2021,UZB,Kelantan,0,0,0,Uzbekistan
27142,4/1/2021,UZB,Perak,0,0,0,Uzbekistan
27143,4/1/2021,UZB,Perlis,0,0,0,Uzbekistan
27144,4/1/2021,UZB,Pulau Pinang,0,0,0,Uzbekistan
27145,4/1/2021,UZB,Sabah,0,0,0,Uzbekistan
27146,4/1/2021,UZB,Sarawak,0,0,0,Uzbekistan
27147,4/1/2021,UZB,Selangor,13,12,1,Uzbekistan
27148,4/1/2021,VAT,Johor,0,0,0,Holy See (Vatican City State)
27149,4/1/2021,VAT,Sarawak,0,0,0,Holy See (Vatican City State)
27150,4/1/2021,VAT,Selangor,0,0,0,Holy See (Vatican City State)
27151,4/1/2021,VCT,Johor,0,0,0,Saint Vincent and the Grenadines
27152,4/1/2021,VCT,Kedah,0,0,0,Saint Vincent and the Grenadines
27153,4/1/2021,VCT,Pulau Pinang,0,0,0,Saint Vincent and the Grenadines
27154,4/1/2021,VCT,Sarawak,0,0,0,Saint Vincent and the Grenadines
27155,4/1/2021,VCT,Selangor,0,0,0,Saint Vincent and the Grenadines
27156,4/1/2021,VEN,Johor,0,0,0,Venezuela
27157,4/1/2021,VEN,Kedah,0,0,0,Venezuela
27158,4/1/2021,VEN,Kelantan,0,0,0,Venezuela
27159,4/1/2021,VEN,Melaka,0,0,0,Venezuela
27160,4/1/2021,VEN,Perak,0,0,0,Venezuela
27161,4/1/2021,VEN,Perlis,0,0,0,Venezuela
27162,4/1/2021,VEN,Pulau Pinang,0,0,0,Venezuela
27163,4/1/2021,VEN,Sabah,0,0,0,Venezuela
27164,4/1/2021,VEN,Sarawak,0,0,0,Venezuela
27165,4/1/2021,VEN,Selangor,2,2,0,Venezuela
27166,4/1/2021,VEN,W.P. Labuan,0,0,0,Venezuela
27167,4/1/2021,VNM,Johor,1,0,1,Vietnam
27168,4/1/2021,VNM,Kedah,0,0,0,Vietnam
27169,4/1/2021,VNM,Kelantan,0,0,0,Vietnam
27170,4/1/2021,VNM,Melaka,0,0,0,Vietnam
27171,4/1/2021,VNM,Negeri Sembilan,0,0,0,Vietnam
27172,4/1/2021,VNM,Pahang,0,0,0,Vietnam
27173,4/1/2021,VNM,Perak,0,0,0,Vietnam
27174,4/1/2021,VNM,Perlis,0,0,0,Vietnam
27175,4/1/2021,VNM,Pulau Pinang,1,0,1,Vietnam
27176,4/1/2021,VNM,Sabah,0,0,0,Vietnam
27177,4/1/2021,VNM,Sarawak,0,0,0,Vietnam
27178,4/1/2021,VNM,Selangor,118,31,87,Vietnam
27179,4/1/2021,VNM,Terengganu,0,0,0,Vietnam
27180,4/1/2021,VNM,W.P. Labuan,0,0,0,Vietnam
27181,4/1/2021,VUT,Johor,0,0,0,Vanuatu
27182,4/1/2021,VUT,Kedah,0,0,0,Vanuatu
27183,4/1/2021,VUT,Pulau Pinang,0,0,0,Vanuatu
27184,4/1/2021,VUT,Sabah,0,0,0,Vanuatu
27185,4/1/2021,VUT,Sarawak,0,0,0,Vanuatu
27186,4/1/2021,VUT,Selangor,0,0,0,Vanuatu
27187,4/1/2021,WSM,Johor,0,0,0,Samoa
27188,4/1/2021,WSM,Sarawak,0,0,0,Samoa
27189,4/1/2021,WSM,Selangor,0,0,0,Samoa
27190,4/1/2021,YEM,Johor,0,0,0,Yemen
27191,4/1/2021,YEM,Kedah,0,0,0,Yemen
27192,4/1/2021,YEM,Kelantan,0,0,0,Yemen
27193,4/1/2021,YEM,Melaka,0,0,0,Yemen
27194,4/1/2021,YEM,Pahang,0,0,0,Yemen
27195,4/1/2021,YEM,Perak,0,0,0,Yemen
27196,4/1/2021,YEM,Perlis,0,0,0,Yemen
27197,4/1/2021,YEM,Pulau Pinang,0,0,0,Yemen
27198,4/1/2021,YEM,Sabah,0,0,0,Yemen
27199,4/1/2021,YEM,Sarawak,0,0,0,Yemen
27200,4/1/2021,YEM,Selangor,96,77,19,Yemen
27201,4/1/2021,YEM,W.P. Labuan,0,0,0,Yemen
27202,4/1/2021,ZAF,Johor,2,2,0,South Africa
27203,4/1/2021,ZAF,Kedah,0,0,0,South Africa
27204,4/1/2021,ZAF,Kelantan,0,0,0,South Africa
27205,4/1/2021,ZAF,Melaka,0,0,0,South Africa
27206,4/1/2021,ZAF,Pahang,0,0,0,South Africa
27207,4/1/2021,ZAF,Perak,0,0,0,South Africa
27208,4/1/2021,ZAF,Perlis,0,0,0,South Africa
27209,4/1/2021,ZAF,Pulau Pinang,0,0,0,South Africa
27210,4/1/2021,ZAF,Sabah,0,0,0,South Africa
27211,4/1/2021,ZAF,Sarawak,0,0,0,South Africa
27212,4/1/2021,ZAF,Selangor,41,32,9,South Africa
27213,4/1/2021,ZAF,Terengganu,0,0,0,South Africa
27214,4/1/2021,ZAF,W.P. Labuan,0,0,0,South Africa
27215,4/1/2021,ZMB,Johor,0,0,0,Zambia
27216,4/1/2021,ZMB,Kedah,0,0,0,Zambia
27217,4/1/2021,ZMB,Perak,0,0,0,Zambia
27218,4/1/2021,ZMB,Perlis,0,0,0,Zambia
27219,4/1/2021,ZMB,Pulau Pinang,0,0,0,Zambia
27220,4/1/2021,ZMB,Sabah,0,0,0,Zambia
27221,4/1/2021,ZMB,Sarawak,0,0,0,Zambia
27222,4/1/2021,ZMB,Selangor,15,4,11,Zambia
27223,4/1/2021,ZWE,Johor,0,0,0,Zimbabwe
27224,4/1/2021,ZWE,Kedah,0,0,0,Zimbabwe
27225,4/1/2021,ZWE,Kelantan,0,0,0,Zimbabwe
27226,4/1/2021,ZWE,Perak,0,0,0,Zimbabwe
27227,4/1/2021,ZWE,Perlis,0,0,0,Zimbabwe
27228,4/1/2021,ZWE,Pulau Pinang,0,0,0,Zimbabwe
27229,4/1/2021,ZWE,Sabah,0,0,0,Zimbabwe
27230,4/1/2021,ZWE,Sarawak,0,0,0,Zimbabwe
27231,4/1/2021,ZWE,Selangor,12,6,6,Zimbabwe
27232,5/1/2021,ABW,Kedah,0,0,0,Aruba
27233,5/1/2021,ABW,Pulau Pinang,0,0,0,Aruba
27234,5/1/2021,AFG,Johor,0,0,0,Afghanistan
27235,5/1/2021,AFG,Kedah,0,0,0,Afghanistan
27236,5/1/2021,AFG,Perlis,0,0,0,Afghanistan
27237,5/1/2021,AFG,Pulau Pinang,0,0,0,Afghanistan
27238,5/1/2021,AFG,Sarawak,0,0,0,Afghanistan
27239,5/1/2021,AFG,Selangor,26,18,8,Afghanistan
27240,5/1/2021,AGO,Johor,0,0,0,Angola
27241,5/1/2021,AGO,Kedah,0,0,0,Angola
27242,5/1/2021,AGO,Sabah,0,0,0,Angola
27243,5/1/2021,AGO,Selangor,0,0,0,Angola
27244,5/1/2021,AIA,Selangor,0,0,0,Anguilla
27245,5/1/2021,ALB,Johor,0,0,0,Albania
27246,5/1/2021,ALB,Kedah,0,0,0,Albania
27247,5/1/2021,ALB,Perak,0,0,0,Albania
27248,5/1/2021,ALB,Perlis,0,0,0,Albania
27249,5/1/2021,ALB,Pulau Pinang,0,0,0,Albania
27250,5/1/2021,ALB,Sabah,0,0,0,Albania
27251,5/1/2021,ALB,Sarawak,0,0,0,Albania
27252,5/1/2021,ALB,Selangor,1,0,1,Albania
27253,5/1/2021,AND,Johor,0,0,0,Andorra
27254,5/1/2021,AND,Kedah,0,0,0,Andorra
27255,5/1/2021,AND,Perlis,0,0,0,Andorra
27256,5/1/2021,AND,Pulau Pinang,0,0,0,Andorra
27257,5/1/2021,AND,Selangor,0,0,0,Andorra
27258,5/1/2021,ANT,Selangor,0,0,0,Netherlands Antilles
27259,5/1/2021,ARE,Johor,0,0,0,United Arab Emirates
27260,5/1/2021,ARE,Kedah,0,0,0,United Arab Emirates
27261,5/1/2021,ARE,Kelantan,0,0,0,United Arab Emirates
27262,5/1/2021,ARE,Perak,0,0,0,United Arab Emirates
27263,5/1/2021,ARE,Perlis,0,0,0,United Arab Emirates
27264,5/1/2021,ARE,Pulau Pinang,0,0,0,United Arab Emirates
27265,5/1/2021,ARE,Sabah,0,0,0,United Arab Emirates
27266,5/1/2021,ARE,Sarawak,0,0,0,United Arab Emirates
27267,5/1/2021,ARE,Selangor,11,6,5,United Arab Emirates
27268,5/1/2021,ARG,Johor,0,0,0,Argentina
27269,5/1/2021,ARG,Kedah,0,0,0,Argentina
27270,5/1/2021,ARG,Kelantan,0,0,0,Argentina
27271,5/1/2021,ARG,Melaka,0,0,0,Argentina
27272,5/1/2021,ARG,Perak,0,0,0,Argentina
27273,5/1/2021,ARG,Perlis,0,0,0,Argentina
27274,5/1/2021,ARG,Pulau Pinang,0,0,0,Argentina
27275,5/1/2021,ARG,Sabah,0,0,0,Argentina
27276,5/1/2021,ARG,Sarawak,0,0,0,Argentina
27277,5/1/2021,ARG,Selangor,6,6,0,Argentina
27278,5/1/2021,ARG,W.P. Labuan,0,0,0,Argentina
27279,5/1/2021,ARM,Johor,0,0,0,Armenia
27280,5/1/2021,ARM,Kedah,0,0,0,Armenia
27281,5/1/2021,ARM,Kelantan,0,0,0,Armenia
27282,5/1/2021,ARM,Perak,0,0,0,Armenia
27283,5/1/2021,ARM,Perlis,0,0,0,Armenia
27284,5/1/2021,ARM,Pulau Pinang,0,0,0,Armenia
27285,5/1/2021,ARM,Sabah,0,0,0,Armenia
27286,5/1/2021,ARM,Sarawak,0,0,0,Armenia
27287,5/1/2021,ARM,Selangor,1,0,1,Armenia
27288,5/1/2021,ATA,Selangor,0,0,0,Antarctica
27289,5/1/2021,ATG,Johor,0,0,0,Antigua and Barbuda
27290,5/1/2021,ATG,Kedah,0,0,0,Antigua and Barbuda
27291,5/1/2021,ATG,Pulau Pinang,0,0,0,Antigua and Barbuda
27292,5/1/2021,ATG,Sarawak,0,0,0,Antigua and Barbuda
27293,5/1/2021,ATG,Selangor,0,0,0,Antigua and Barbuda
27294,5/1/2021,AUS,Johor,0,0,0,Australia
27295,5/1/2021,AUS,Kedah,0,0,0,Australia
27296,5/1/2021,AUS,Kelantan,0,0,0,Australia
27297,5/1/2021,AUS,Melaka,0,0,0,Australia
27298,5/1/2021,AUS,Negeri Sembilan,0,0,0,Australia
27299,5/1/2021,AUS,Pahang,0,0,0,Australia
27300,5/1/2021,AUS,Perak,0,0,0,Australia
27301,5/1/2021,AUS,Perlis,0,0,0,Australia
27302,5/1/2021,AUS,Pulau Pinang,1,1,0,Australia
27303,5/1/2021,AUS,Sabah,0,0,0,Australia
27304,5/1/2021,AUS,Sarawak,0,0,0,Australia
27305,5/1/2021,AUS,Selangor,77,55,22,Australia
27306,5/1/2021,AUS,Terengganu,0,0,0,Australia
27307,5/1/2021,AUS,W.P. Labuan,0,0,0,Australia
27308,5/1/2021,AUT,Johor,0,0,0,Austria
27309,5/1/2021,AUT,Kedah,0,0,0,Austria
27310,5/1/2021,AUT,Kelantan,0,0,0,Austria
27311,5/1/2021,AUT,Melaka,0,0,0,Austria
27312,5/1/2021,AUT,Negeri Sembilan,0,0,0,Austria
27313,5/1/2021,AUT,Pahang,0,0,0,Austria
27314,5/1/2021,AUT,Perak,0,0,0,Austria
27315,5/1/2021,AUT,Perlis,0,0,0,Austria
27316,5/1/2021,AUT,Pulau Pinang,0,0,0,Austria
27317,5/1/2021,AUT,Sabah,0,0,0,Austria
27318,5/1/2021,AUT,Sarawak,1,1,0,Austria
27319,5/1/2021,AUT,Selangor,10,9,1,Austria
27320,5/1/2021,AUT,Terengganu,0,0,0,Austria
27321,5/1/2021,AUT,W.P. Labuan,0,0,0,Austria
27322,5/1/2021,AZE,Johor,0,0,0,Azerbaijan
27323,5/1/2021,AZE,Kedah,0,0,0,Azerbaijan
27324,5/1/2021,AZE,Kelantan,0,0,0,Azerbaijan
27325,5/1/2021,AZE,Melaka,0,0,0,Azerbaijan
27326,5/1/2021,AZE,Perlis,0,0,0,Azerbaijan
27327,5/1/2021,AZE,Pulau Pinang,0,0,0,Azerbaijan
27328,5/1/2021,AZE,Sabah,0,0,0,Azerbaijan
27329,5/1/2021,AZE,Sarawak,0,0,0,Azerbaijan
27330,5/1/2021,AZE,Selangor,4,3,1,Azerbaijan
27331,5/1/2021,AZE,W.P. Labuan,0,0,0,Azerbaijan
27332,5/1/2021,BDI,Pulau Pinang,0,0,0,Burundi
27333,5/1/2021,BDI,Sarawak,0,0,0,Burundi
27334,5/1/2021,BDI,Selangor,5,2,3,Burundi
27335,5/1/2021,BEL,Johor,0,0,0,Belgium
27336,5/1/2021,BEL,Kedah,0,0,0,Belgium
27337,5/1/2021,BEL,Kelantan,0,0,0,Belgium
27338,5/1/2021,BEL,Melaka,0,0,0,Belgium
27339,5/1/2021,BEL,Negeri Sembilan,0,0,0,Belgium
27340,5/1/2021,BEL,Pahang,0,0,0,Belgium
27341,5/1/2021,BEL,Perak,0,0,0,Belgium
27342,5/1/2021,BEL,Perlis,0,0,0,Belgium
27343,5/1/2021,BEL,Pulau Pinang,0,0,0,Belgium
27344,5/1/2021,BEL,Sabah,0,0,0,Belgium
27345,5/1/2021,BEL,Sarawak,0,0,0,Belgium
27346,5/1/2021,BEL,Selangor,7,4,3,Belgium
27347,5/1/2021,BEL,W.P. Labuan,0,0,0,Belgium
27348,5/1/2021,BEN,Johor,0,0,0,Benin
27349,5/1/2021,BEN,Kedah,0,0,0,Benin
27350,5/1/2021,BEN,Perak,0,0,0,Benin
27351,5/1/2021,BEN,Pulau Pinang,0,0,0,Benin
27352,5/1/2021,BEN,Sabah,0,0,0,Benin
27353,5/1/2021,BEN,Sarawak,0,0,0,Benin
27354,5/1/2021,BEN,Selangor,0,0,0,Benin
27355,5/1/2021,BFA,Perak,0,0,0,Burkina Faso
27356,5/1/2021,BFA,Pulau Pinang,0,0,0,Burkina Faso
27357,5/1/2021,BFA,Selangor,0,0,0,Burkina Faso
27358,5/1/2021,BGD,Johor,2,2,0,Bangladesh
27359,5/1/2021,BGD,Kedah,0,0,0,Bangladesh
27360,5/1/2021,BGD,Kelantan,0,0,0,Bangladesh
27361,5/1/2021,BGD,Melaka,0,0,0,Bangladesh
27362,5/1/2021,BGD,Negeri Sembilan,0,0,0,Bangladesh
27363,5/1/2021,BGD,Pahang,0,0,0,Bangladesh
27364,5/1/2021,BGD,Perak,0,0,0,Bangladesh
27365,5/1/2021,BGD,Perlis,0,0,0,Bangladesh
27366,5/1/2021,BGD,Pulau Pinang,0,0,0,Bangladesh
27367,5/1/2021,BGD,Sabah,0,0,0,Bangladesh
27368,5/1/2021,BGD,Sarawak,0,0,0,Bangladesh
27369,5/1/2021,BGD,Selangor,98,78,20,Bangladesh
27370,5/1/2021,BGD,W.P. Labuan,0,0,0,Bangladesh
27371,5/1/2021,BGR,Johor,0,0,0,Bulgaria
27372,5/1/2021,BGR,Kedah,0,0,0,Bulgaria
27373,5/1/2021,BGR,Kelantan,0,0,0,Bulgaria
27374,5/1/2021,BGR,Pahang,0,0,0,Bulgaria
27375,5/1/2021,BGR,Perak,0,0,0,Bulgaria
27376,5/1/2021,BGR,Perlis,0,0,0,Bulgaria
27377,5/1/2021,BGR,Pulau Pinang,0,0,0,Bulgaria
27378,5/1/2021,BGR,Sabah,0,0,0,Bulgaria
27379,5/1/2021,BGR,Sarawak,0,0,0,Bulgaria
27380,5/1/2021,BGR,Selangor,17,17,0,Bulgaria
27381,5/1/2021,BGR,W.P. Labuan,0,0,0,Bulgaria
27382,5/1/2021,BHR,Johor,0,0,0,Bahrain
27383,5/1/2021,BHR,Kedah,0,0,0,Bahrain
27384,5/1/2021,BHR,Kelantan,0,0,0,Bahrain
27385,5/1/2021,BHR,Perlis,0,0,0,Bahrain
27386,5/1/2021,BHR,Pulau Pinang,0,0,0,Bahrain
27387,5/1/2021,BHR,Sabah,0,0,0,Bahrain
27388,5/1/2021,BHR,Sarawak,0,0,0,Bahrain
27389,5/1/2021,BHR,Selangor,2,1,1,Bahrain
27390,5/1/2021,BHS,Johor,0,0,0,Bahamas
27391,5/1/2021,BHS,Kedah,0,0,0,Bahamas
27392,5/1/2021,BHS,Perak,0,0,0,Bahamas
27393,5/1/2021,BHS,Sabah,0,0,0,Bahamas
27394,5/1/2021,BHS,Sarawak,0,0,0,Bahamas
27395,5/1/2021,BHS,Selangor,0,0,0,Bahamas
27396,5/1/2021,BIH,Johor,0,0,0,Bosnia and Herzegovina
27397,5/1/2021,BIH,Kedah,0,0,0,Bosnia and Herzegovina
27398,5/1/2021,BIH,Perlis,0,0,0,Bosnia and Herzegovina
27399,5/1/2021,BIH,Pulau Pinang,0,0,0,Bosnia and Herzegovina
27400,5/1/2021,BIH,Sabah,0,0,0,Bosnia and Herzegovina
27401,5/1/2021,BIH,Sarawak,0,0,0,Bosnia and Herzegovina
27402,5/1/2021,BIH,Selangor,2,1,1,Bosnia and Herzegovina
27403,5/1/2021,BLR,Johor,0,0,0,Belarus
27404,5/1/2021,BLR,Kedah,0,0,0,Belarus
27405,5/1/2021,BLR,Kelantan,0,0,0,Belarus
27406,5/1/2021,BLR,Pahang,0,0,0,Belarus
27407,5/1/2021,BLR,Perak,0,0,0,Belarus
27408,5/1/2021,BLR,Perlis,0,0,0,Belarus
27409,5/1/2021,BLR,Pulau Pinang,0,0,0,Belarus
27410,5/1/2021,BLR,Sabah,0,0,0,Belarus
27411,5/1/2021,BLR,Sarawak,0,0,0,Belarus
27412,5/1/2021,BLR,Selangor,1,1,0,Belarus
27413,5/1/2021,BLR,W.P. Labuan,0,0,0,Belarus
27414,5/1/2021,BLZ,Johor,0,0,0,Belize
27415,5/1/2021,BLZ,Pulau Pinang,0,0,0,Belize
27416,5/1/2021,BLZ,Sarawak,0,0,0,Belize
27417,5/1/2021,BLZ,Selangor,0,0,0,Belize
27418,5/1/2021,BMU,Selangor,0,0,0,Bermuda
27419,5/1/2021,BOL,Johor,0,0,0,Bolivia
27420,5/1/2021,BOL,Kedah,0,0,0,Bolivia
27421,5/1/2021,BOL,Melaka,0,0,0,Bolivia
27422,5/1/2021,BOL,Perak,0,0,0,Bolivia
27423,5/1/2021,BOL,Perlis,0,0,0,Bolivia
27424,5/1/2021,BOL,Pulau Pinang,0,0,0,Bolivia
27425,5/1/2021,BOL,Sabah,0,0,0,Bolivia
27426,5/1/2021,BOL,Sarawak,0,0,0,Bolivia
27427,5/1/2021,BOL,Selangor,0,0,0,Bolivia
27428,5/1/2021,BRA,Johor,0,0,0,Brazil
27429,5/1/2021,BRA,Kedah,0,0,0,Brazil
27430,5/1/2021,BRA,Kelantan,0,0,0,Brazil
27431,5/1/2021,BRA,Melaka,0,0,0,Brazil
27432,5/1/2021,BRA,Pahang,0,0,0,Brazil
27433,5/1/2021,BRA,Perak,0,0,0,Brazil
27434,5/1/2021,BRA,Perlis,0,0,0,Brazil
27435,5/1/2021,BRA,Pulau Pinang,0,0,0,Brazil
27436,5/1/2021,BRA,Sabah,0,0,0,Brazil
27437,5/1/2021,BRA,Sarawak,0,0,0,Brazil
27438,5/1/2021,BRA,Selangor,20,19,1,Brazil
27439,5/1/2021,BRA,W.P. Labuan,0,0,0,Brazil
27440,5/1/2021,BRB,Johor,0,0,0,Barbados
27441,5/1/2021,BRB,Kedah,0,0,0,Barbados
27442,5/1/2021,BRB,Perlis,0,0,0,Barbados
27443,5/1/2021,BRB,Pulau Pinang,0,0,0,Barbados
27444,5/1/2021,BRB,Selangor,0,0,0,Barbados
27445,5/1/2021,BRN,Johor,0,0,0,Brunei Darussalam
27446,5/1/2021,BRN,Kedah,0,0,0,Brunei Darussalam
27447,5/1/2021,BRN,Kelantan,0,0,0,Brunei Darussalam
27448,5/1/2021,BRN,Melaka,0,0,0,Brunei Darussalam
27449,5/1/2021,BRN,Pahang,0,0,0,Brunei Darussalam
27450,5/1/2021,BRN,Perak,0,0,0,Brunei Darussalam
27451,5/1/2021,BRN,Perlis,0,0,0,Brunei Darussalam
27452,5/1/2021,BRN,Pulau Pinang,0,0,0,Brunei Darussalam
27453,5/1/2021,BRN,Sabah,0,0,0,Brunei Darussalam
27454,5/1/2021,BRN,Sarawak,265,261,4,Brunei Darussalam
27455,5/1/2021,BRN,Selangor,24,10,14,Brunei Darussalam
27456,5/1/2021,BRN,W.P. Labuan,1,1,0,Brunei Darussalam
27457,5/1/2021,BTN,Johor,0,0,0,Bhutan
27458,5/1/2021,BTN,Kedah,0,0,0,Bhutan
27459,5/1/2021,BTN,Perak,0,0,0,Bhutan
27460,5/1/2021,BTN,Perlis,0,0,0,Bhutan
27461,5/1/2021,BTN,Pulau Pinang,0,0,0,Bhutan
27462,5/1/2021,BTN,Sabah,0,0,0,Bhutan
27463,5/1/2021,BTN,Sarawak,0,0,0,Bhutan
27464,5/1/2021,BTN,Selangor,0,0,0,Bhutan
27465,5/1/2021,BWA,Johor,0,0,0,Botswana
27466,5/1/2021,BWA,Kedah,0,0,0,Botswana
27467,5/1/2021,BWA,Perlis,0,0,0,Botswana
27468,5/1/2021,BWA,Pulau Pinang,0,0,0,Botswana
27469,5/1/2021,BWA,Sabah,0,0,0,Botswana
27470,5/1/2021,BWA,Sarawak,0,0,0,Botswana
27471,5/1/2021,BWA,Selangor,2,1,1,Botswana
27472,5/1/2021,CAF,Kedah,0,0,0,Central African Republic
27473,5/1/2021,CAF,Selangor,1,1,0,Central African Republic
27474,5/1/2021,CAN,Johor,0,0,0,Canada
27475,5/1/2021,CAN,Kedah,0,0,0,Canada
27476,5/1/2021,CAN,Kelantan,0,0,0,Canada
27477,5/1/2021,CAN,Melaka,0,0,0,Canada
27478,5/1/2021,CAN,Negeri Sembilan,0,0,0,Canada
27479,5/1/2021,CAN,Pahang,0,0,0,Canada
27480,5/1/2021,CAN,Perak,0,0,0,Canada
27481,5/1/2021,CAN,Perlis,0,0,0,Canada
27482,5/1/2021,CAN,Pulau Pinang,0,0,0,Canada
27483,5/1/2021,CAN,Sabah,0,0,0,Canada
27484,5/1/2021,CAN,Sarawak,0,0,0,Canada
27485,5/1/2021,CAN,Selangor,28,20,8,Canada
27486,5/1/2021,CAN,Terengganu,0,0,0,Canada
27487,5/1/2021,CAN,W.P. Labuan,0,0,0,Canada
27488,5/1/2021,CCK,Selangor,0,0,0,Cocos (Keeling) Islands
27489,5/1/2021,CHE,Johor,0,0,0,Switzerland
27490,5/1/2021,CHE,Kedah,0,0,0,Switzerland
27491,5/1/2021,CHE,Kelantan,0,0,0,Switzerland
27492,5/1/2021,CHE,Melaka,0,0,0,Switzerland
27493,5/1/2021,CHE,Negeri Sembilan,0,0,0,Switzerland
27494,5/1/2021,CHE,Pahang,0,0,0,Switzerland
27495,5/1/2021,CHE,Perak,0,0,0,Switzerland
27496,5/1/2021,CHE,Perlis,0,0,0,Switzerland
27497,5/1/2021,CHE,Pulau Pinang,0,0,0,Switzerland
27498,5/1/2021,CHE,Sabah,0,0,0,Switzerland
27499,5/1/2021,CHE,Sarawak,0,0,0,Switzerland
27500,5/1/2021,CHE,Selangor,11,10,1,Switzerland
27501,5/1/2021,CHE,W.P. Labuan,0,0,0,Switzerland
27502,5/1/2021,CHL,Johor,0,0,0,Chile
27503,5/1/2021,CHL,Kedah,0,0,0,Chile
27504,5/1/2021,CHL,Kelantan,0,0,0,Chile
27505,5/1/2021,CHL,Melaka,0,0,0,Chile
27506,5/1/2021,CHL,Pahang,0,0,0,Chile
27507,5/1/2021,CHL,Perak,0,0,0,Chile
27508,5/1/2021,CHL,Perlis,0,0,0,Chile
27509,5/1/2021,CHL,Pulau Pinang,0,0,0,Chile
27510,5/1/2021,CHL,Sabah,0,0,0,Chile
27511,5/1/2021,CHL,Sarawak,0,0,0,Chile
27512,5/1/2021,CHL,Selangor,1,0,1,Chile
27513,5/1/2021,CHN,Johor,29,28,1,China
27514,5/1/2021,CHN,Kedah,0,0,0,China
27515,5/1/2021,CHN,Kelantan,0,0,0,China
27516,5/1/2021,CHN,Melaka,0,0,0,China
27517,5/1/2021,CHN,Pahang,0,0,0,China
27518,5/1/2021,CHN,Perak,0,0,0,China
27519,5/1/2021,CHN,Perlis,0,0,0,China
27520,5/1/2021,CHN,Pulau Pinang,2,1,1,China
27521,5/1/2021,CHN,Sabah,3,0,3,China
27522,5/1/2021,CHN,Sarawak,206,199,7,China
27523,5/1/2021,CHN,Selangor,1261,1018,243,China
27524,5/1/2021,CHN,Terengganu,0,0,0,China
27525,5/1/2021,CHN,W.P. Labuan,0,0,0,China
27526,5/1/2021,CIV,Johor,0,0,0,C��te d'Iv
27527,5/1/2021,CIV,Kedah,0,0,0,C��te d'Iv
27528,5/1/2021,CIV,Pulau Pinang,0,0,0,C��te d'Iv
27529,5/1/2021,CIV,Sabah,0,0,0,C��te d'Iv
27530,5/1/2021,CIV,Sarawak,0,0,0,C��te d'Iv
27531,5/1/2021,CIV,Selangor,2,2,0,C��te d'Iv
27532,5/1/2021,CMR,Johor,0,0,0,Cameroon
27533,5/1/2021,CMR,Kedah,0,0,0,Cameroon
27534,5/1/2021,CMR,Pulau Pinang,0,0,0,Cameroon
27535,5/1/2021,CMR,Sabah,0,0,0,Cameroon
27536,5/1/2021,CMR,Sarawak,0,0,0,Cameroon
27537,5/1/2021,CMR,Selangor,1,1,0,Cameroon
27538,5/1/2021,COD,Johor,0,0,0,"Congo, the Democratic Republic of the"
27539,5/1/2021,COD,Pulau Pinang,0,0,0,"Congo, the Democratic Republic of the"
27540,5/1/2021,COD,Sarawak,0,0,0,"Congo, the Democratic Republic of the"
27541,5/1/2021,COD,Selangor,1,1,0,"Congo, the Democratic Republic of the"
27542,5/1/2021,COG,Johor,0,0,0,Congo
27543,5/1/2021,COG,Kedah,0,0,0,Congo
27544,5/1/2021,COG,Selangor,0,0,0,Congo
27545,5/1/2021,COK,Selangor,0,0,0,Cook Islands
27546,5/1/2021,COL,Johor,0,0,0,Colombia
27547,5/1/2021,COL,Kedah,0,0,0,Colombia
27548,5/1/2021,COL,Perak,0,0,0,Colombia
27549,5/1/2021,COL,Pulau Pinang,0,0,0,Colombia
27550,5/1/2021,COL,Sabah,0,0,0,Colombia
27551,5/1/2021,COL,Sarawak,0,0,0,Colombia
27552,5/1/2021,COL,Selangor,4,3,1,Colombia
27553,5/1/2021,COL,W.P. Labuan,0,0,0,Colombia
27554,5/1/2021,COM,Johor,0,0,0,Comoros
27555,5/1/2021,COM,Kedah,0,0,0,Comoros
27556,5/1/2021,COM,Selangor,4,2,2,Comoros
27557,5/1/2021,CPV,Johor,0,0,0,Cape Verde
27558,5/1/2021,CPV,Kedah,0,0,0,Cape Verde
27559,5/1/2021,CPV,Pulau Pinang,0,0,0,Cape Verde
27560,5/1/2021,CPV,Sabah,0,0,0,Cape Verde
27561,5/1/2021,CPV,Selangor,0,0,0,Cape Verde
27562,5/1/2021,CRI,Johor,0,0,0,Costa Rica
27563,5/1/2021,CRI,Kedah,0,0,0,Costa Rica
27564,5/1/2021,CRI,Perak,0,0,0,Costa Rica
27565,5/1/2021,CRI,Perlis,0,0,0,Costa Rica
27566,5/1/2021,CRI,Pulau Pinang,0,0,0,Costa Rica
27567,5/1/2021,CRI,Sabah,0,0,0,Costa Rica
27568,5/1/2021,CRI,Sarawak,0,0,0,Costa Rica
27569,5/1/2021,CRI,Selangor,37,30,7,Costa Rica
27570,5/1/2021,CUB,Johor,0,0,0,Cuba
27571,5/1/2021,CUB,Kedah,0,0,0,Cuba
27572,5/1/2021,CUB,Perlis,0,0,0,Cuba
27573,5/1/2021,CUB,Pulau Pinang,0,0,0,Cuba
27574,5/1/2021,CUB,Sabah,0,0,0,Cuba
27575,5/1/2021,CUB,Sarawak,0,0,0,Cuba
27576,5/1/2021,CUB,Selangor,0,0,0,Cuba
27577,5/1/2021,CYP,Johor,0,0,0,Cyprus
27578,5/1/2021,CYP,Kedah,0,0,0,Cyprus
27579,5/1/2021,CYP,Perak,0,0,0,Cyprus
27580,5/1/2021,CYP,Perlis,0,0,0,Cyprus
27581,5/1/2021,CYP,Pulau Pinang,0,0,0,Cyprus
27582,5/1/2021,CYP,Sabah,0,0,0,Cyprus
27583,5/1/2021,CYP,Sarawak,0,0,0,Cyprus
27584,5/1/2021,CYP,Selangor,3,2,1,Cyprus
27585,5/1/2021,CZE,Johor,0,0,0,Czech Republic
27586,5/1/2021,CZE,Kedah,0,0,0,Czech Republic
27587,5/1/2021,CZE,Kelantan,0,0,0,Czech Republic
27588,5/1/2021,CZE,Melaka,0,0,0,Czech Republic
27589,5/1/2021,CZE,Negeri Sembilan,0,0,0,Czech Republic
27590,5/1/2021,CZE,Perak,0,0,0,Czech Republic
27591,5/1/2021,CZE,Perlis,0,0,0,Czech Republic
27592,5/1/2021,CZE,Pulau Pinang,0,0,0,Czech Republic
27593,5/1/2021,CZE,Sabah,0,0,0,Czech Republic
27594,5/1/2021,CZE,Sarawak,0,0,0,Czech Republic
27595,5/1/2021,CZE,Selangor,6,6,0,Czech Republic
27596,5/1/2021,CZE,W.P. Labuan,0,0,0,Czech Republic
27597,5/1/2021,DEU,Johor,0,0,0,Germany
27598,5/1/2021,DEU,Kedah,0,0,0,Germany
27599,5/1/2021,DEU,Kelantan,0,0,0,Germany
27600,5/1/2021,DEU,Melaka,0,0,0,Germany
27601,5/1/2021,DEU,Negeri Sembilan,0,0,0,Germany
27602,5/1/2021,DEU,Pahang,0,0,0,Germany
27603,5/1/2021,DEU,Perak,0,0,0,Germany
27604,5/1/2021,DEU,Perlis,0,0,0,Germany
27605,5/1/2021,DEU,Pulau Pinang,1,1,0,Germany
27606,5/1/2021,DEU,Sabah,0,0,0,Germany
27607,5/1/2021,DEU,Sarawak,0,0,0,Germany
27608,5/1/2021,DEU,Selangor,67,54,13,Germany
27609,5/1/2021,DEU,Terengganu,0,0,0,Germany
27610,5/1/2021,DEU,W.P. Labuan,0,0,0,Germany
27611,5/1/2021,DJI,Johor,0,0,0,Djibouti
27612,5/1/2021,DJI,Selangor,1,0,1,Djibouti
27613,5/1/2021,DMA,Johor,0,0,0,Dominica
27614,5/1/2021,DMA,Kedah,0,0,0,Dominica
27615,5/1/2021,DMA,Pulau Pinang,0,0,0,Dominica
27616,5/1/2021,DMA,Sabah,0,0,0,Dominica
27617,5/1/2021,DMA,Sarawak,0,0,0,Dominica
27618,5/1/2021,DMA,Selangor,0,0,0,Dominica
27619,5/1/2021,DMA,W.P. Labuan,0,0,0,Dominica
27620,5/1/2021,DNK,Johor,0,0,0,Denmark
27621,5/1/2021,DNK,Kedah,0,0,0,Denmark
27622,5/1/2021,DNK,Kelantan,0,0,0,Denmark
27623,5/1/2021,DNK,Melaka,0,0,0,Denmark
27624,5/1/2021,DNK,Negeri Sembilan,0,0,0,Denmark
27625,5/1/2021,DNK,Pahang,0,0,0,Denmark
27626,5/1/2021,DNK,Perak,0,0,0,Denmark
27627,5/1/2021,DNK,Perlis,0,0,0,Denmark
27628,5/1/2021,DNK,Pulau Pinang,0,0,0,Denmark
27629,5/1/2021,DNK,Sabah,0,0,0,Denmark
27630,5/1/2021,DNK,Sarawak,1,1,0,Denmark
27631,5/1/2021,DNK,Selangor,10,9,1,Denmark
27632,5/1/2021,DNK,W.P. Labuan,0,0,0,Denmark
27633,5/1/2021,DOM,Johor,0,0,0,Dominican Republic
27634,5/1/2021,DOM,Kedah,0,0,0,Dominican Republic
27635,5/1/2021,DOM,Perak,0,0,0,Dominican Republic
27636,5/1/2021,DOM,Perlis,0,0,0,Dominican Republic
27637,5/1/2021,DOM,Pulau Pinang,0,0,0,Dominican Republic
27638,5/1/2021,DOM,Sabah,0,0,0,Dominican Republic
27639,5/1/2021,DOM,Sarawak,0,0,0,Dominican Republic
27640,5/1/2021,DOM,Selangor,0,0,0,Dominican Republic
27641,5/1/2021,DZA,Johor,0,0,0,Algeria
27642,5/1/2021,DZA,Kedah,0,0,0,Algeria
27643,5/1/2021,DZA,Kelantan,0,0,0,Algeria
27644,5/1/2021,DZA,Melaka,0,0,0,Algeria
27645,5/1/2021,DZA,Perak,0,0,0,Algeria
27646,5/1/2021,DZA,Perlis,0,0,0,Algeria
27647,5/1/2021,DZA,Pulau Pinang,0,0,0,Algeria
27648,5/1/2021,DZA,Sabah,0,0,0,Algeria
27649,5/1/2021,DZA,Sarawak,0,0,0,Algeria
27650,5/1/2021,DZA,Selangor,4,4,0,Algeria
27651,5/1/2021,DZA,W.P. Labuan,0,0,0,Algeria
27652,5/1/2021,ECU,Johor,0,0,0,Ecuador
27653,5/1/2021,ECU,Kedah,0,0,0,Ecuador
27654,5/1/2021,ECU,Perak,0,0,0,Ecuador
27655,5/1/2021,ECU,Perlis,0,0,0,Ecuador
27656,5/1/2021,ECU,Pulau Pinang,0,0,0,Ecuador
27657,5/1/2021,ECU,Sabah,0,0,0,Ecuador
27658,5/1/2021,ECU,Sarawak,0,0,0,Ecuador
27659,5/1/2021,ECU,Selangor,2,2,0,Ecuador
27660,5/1/2021,EGY,Johor,0,0,0,Egypt
27661,5/1/2021,EGY,Kedah,0,0,0,Egypt
27662,5/1/2021,EGY,Kelantan,0,0,0,Egypt
27663,5/1/2021,EGY,Melaka,0,0,0,Egypt
27664,5/1/2021,EGY,Pahang,0,0,0,Egypt
27665,5/1/2021,EGY,Perak,0,0,0,Egypt
27666,5/1/2021,EGY,Perlis,0,0,0,Egypt
27667,5/1/2021,EGY,Pulau Pinang,0,0,0,Egypt
27668,5/1/2021,EGY,Sabah,1,1,0,Egypt
27669,5/1/2021,EGY,Sarawak,0,0,0,Egypt
27670,5/1/2021,EGY,Selangor,75,58,17,Egypt
27671,5/1/2021,EGY,Terengganu,0,0,0,Egypt
27672,5/1/2021,EGY,W.P. Labuan,0,0,0,Egypt
27673,5/1/2021,ERI,Johor,0,0,0,Eritrea
27674,5/1/2021,ERI,Pulau Pinang,0,0,0,Eritrea
27675,5/1/2021,ERI,Sabah,0,0,0,Eritrea
27676,5/1/2021,ERI,Selangor,2,1,1,Eritrea
27677,5/1/2021,ESP,Johor,0,0,0,Spain
27678,5/1/2021,ESP,Kedah,0,0,0,Spain
27679,5/1/2021,ESP,Kelantan,0,0,0,Spain
27680,5/1/2021,ESP,Melaka,0,0,0,Spain
27681,5/1/2021,ESP,Negeri Sembilan,0,0,0,Spain
27682,5/1/2021,ESP,Pahang,0,0,0,Spain
27683,5/1/2021,ESP,Perak,0,0,0,Spain
27684,5/1/2021,ESP,Perlis,0,0,0,Spain
27685,5/1/2021,ESP,Pulau Pinang,0,0,0,Spain
27686,5/1/2021,ESP,Sabah,0,0,0,Spain
27687,5/1/2021,ESP,Sarawak,0,0,0,Spain
27688,5/1/2021,ESP,Selangor,27,23,4,Spain
27689,5/1/2021,ESP,W.P. Labuan,0,0,0,Spain
27690,5/1/2021,EST,Johor,0,0,0,Estonia
27691,5/1/2021,EST,Kedah,0,0,0,Estonia
27692,5/1/2021,EST,Kelantan,0,0,0,Estonia
27693,5/1/2021,EST,Pahang,0,0,0,Estonia
27694,5/1/2021,EST,Perak,0,0,0,Estonia
27695,5/1/2021,EST,Perlis,0,0,0,Estonia
27696,5/1/2021,EST,Pulau Pinang,0,0,0,Estonia
27697,5/1/2021,EST,Sabah,0,0,0,Estonia
27698,5/1/2021,EST,Sarawak,0,0,0,Estonia
27699,5/1/2021,EST,Selangor,4,3,1,Estonia
27700,5/1/2021,EST,W.P. Labuan,0,0,0,Estonia
27701,5/1/2021,ETH,Johor,0,0,0,Ethiopia
27702,5/1/2021,ETH,Kedah,0,0,0,Ethiopia
27703,5/1/2021,ETH,Pulau Pinang,0,0,0,Ethiopia
27704,5/1/2021,ETH,Sarawak,0,0,0,Ethiopia
27705,5/1/2021,ETH,Selangor,8,4,4,Ethiopia
27706,5/1/2021,FIN,Johor,2,2,0,Finland
27707,5/1/2021,FIN,Kedah,0,0,0,Finland
27708,5/1/2021,FIN,Kelantan,0,0,0,Finland
27709,5/1/2021,FIN,Melaka,0,0,0,Finland
27710,5/1/2021,FIN,Negeri Sembilan,0,0,0,Finland
27711,5/1/2021,FIN,Pahang,0,0,0,Finland
27712,5/1/2021,FIN,Perak,0,0,0,Finland
27713,5/1/2021,FIN,Perlis,0,0,0,Finland
27714,5/1/2021,FIN,Pulau Pinang,0,0,0,Finland
27715,5/1/2021,FIN,Sabah,0,0,0,Finland
27716,5/1/2021,FIN,Sarawak,0,0,0,Finland
27717,5/1/2021,FIN,Selangor,9,9,0,Finland
27718,5/1/2021,FIN,W.P. Labuan,0,0,0,Finland
27719,5/1/2021,FJI,Johor,0,0,0,Fiji
27720,5/1/2021,FJI,Kedah,0,0,0,Fiji
27721,5/1/2021,FJI,Kelantan,0,0,0,Fiji
27722,5/1/2021,FJI,Perak,0,0,0,Fiji
27723,5/1/2021,FJI,Perlis,0,0,0,Fiji
27724,5/1/2021,FJI,Pulau Pinang,0,0,0,Fiji
27725,5/1/2021,FJI,Sabah,0,0,0,Fiji
27726,5/1/2021,FJI,Sarawak,0,0,0,Fiji
27727,5/1/2021,FJI,Selangor,0,0,0,Fiji
27728,5/1/2021,FRA,Johor,0,0,0,France
27729,5/1/2021,FRA,Kedah,0,0,0,France
27730,5/1/2021,FRA,Kelantan,0,0,0,France
27731,5/1/2021,FRA,Melaka,0,0,0,France
27732,5/1/2021,FRA,Negeri Sembilan,0,0,0,France
27733,5/1/2021,FRA,Pahang,0,0,0,France
27734,5/1/2021,FRA,Perak,0,0,0,France
27735,5/1/2021,FRA,Perlis,0,0,0,France
27736,5/1/2021,FRA,Pulau Pinang,0,0,0,France
27737,5/1/2021,FRA,Sabah,0,0,0,France
27738,5/1/2021,FRA,Sarawak,0,0,0,France
27739,5/1/2021,FRA,Selangor,80,60,20,France
27740,5/1/2021,FRA,Terengganu,0,0,0,France
27741,5/1/2021,FRA,W.P. Labuan,0,0,0,France
27742,5/1/2021,FSM,Johor,0,0,0,"Micronesia, Federated States of"
27743,5/1/2021,FSM,Pulau Pinang,0,0,0,"Micronesia, Federated States of"
27744,5/1/2021,FSM,Selangor,0,0,0,"Micronesia, Federated States of"
27745,5/1/2021,GAB,Johor,0,0,0,Gabon
27746,5/1/2021,GAB,Pulau Pinang,0,0,0,Gabon
27747,5/1/2021,GAB,Sarawak,0,0,0,Gabon
27748,5/1/2021,GAB,Selangor,0,0,0,Gabon
27749,5/1/2021,GBR,Johor,25,23,2,United Kingdom
27750,5/1/2021,GBR,Kedah,0,0,0,United Kingdom
27751,5/1/2021,GBR,Kelantan,0,0,0,United Kingdom
27752,5/1/2021,GBR,Melaka,0,0,0,United Kingdom
27753,5/1/2021,GBR,Negeri Sembilan,0,0,0,United Kingdom
27754,5/1/2021,GBR,Pahang,0,0,0,United Kingdom
27755,5/1/2021,GBR,Perak,0,0,0,United Kingdom
27756,5/1/2021,GBR,Perlis,0,0,0,United Kingdom
27757,5/1/2021,GBR,Pulau Pinang,3,2,1,United Kingdom
27758,5/1/2021,GBR,Sabah,0,0,0,United Kingdom
27759,5/1/2021,GBR,Sarawak,0,0,0,United Kingdom
27760,5/1/2021,GBR,Selangor,218,189,29,United Kingdom
27761,5/1/2021,GBR,Terengganu,0,0,0,United Kingdom
27762,5/1/2021,GBR,W.P. Labuan,0,0,0,United Kingdom
27763,5/1/2021,GEO,Johor,0,0,0,Georgia
27764,5/1/2021,GEO,Kedah,0,0,0,Georgia
27765,5/1/2021,GEO,Melaka,0,0,0,Georgia
27766,5/1/2021,GEO,Perak,0,0,0,Georgia
27767,5/1/2021,GEO,Perlis,0,0,0,Georgia
27768,5/1/2021,GEO,Pulau Pinang,0,0,0,Georgia
27769,5/1/2021,GEO,Sabah,0,0,0,Georgia
27770,5/1/2021,GEO,Sarawak,0,0,0,Georgia
27771,5/1/2021,GEO,Selangor,0,0,0,Georgia
27772,5/1/2021,GHA,Johor,0,0,0,Ghana
27773,5/1/2021,GHA,Kedah,0,0,0,Ghana
27774,5/1/2021,GHA,Kelantan,0,0,0,Ghana
27775,5/1/2021,GHA,Pulau Pinang,0,0,0,Ghana
27776,5/1/2021,GHA,Sabah,0,0,0,Ghana
27777,5/1/2021,GHA,Sarawak,0,0,0,Ghana
27778,5/1/2021,GHA,Selangor,8,6,2,Ghana
27779,5/1/2021,GIB,Johor,0,0,0,Gibraltar
27780,5/1/2021,GIB,Sarawak,0,0,0,Gibraltar
27781,5/1/2021,GIN,Johor,0,0,0,Guinea
27782,5/1/2021,GIN,Kedah,0,0,0,Guinea
27783,5/1/2021,GIN,Kelantan,0,0,0,Guinea
27784,5/1/2021,GIN,Perlis,0,0,0,Guinea
27785,5/1/2021,GIN,Pulau Pinang,0,0,0,Guinea
27786,5/1/2021,GIN,Sabah,0,0,0,Guinea
27787,5/1/2021,GIN,Sarawak,0,0,0,Guinea
27788,5/1/2021,GIN,Selangor,6,4,2,Guinea
27789,5/1/2021,GLP,Selangor,0,0,0,Guadeloupe
27790,5/1/2021,GMB,Johor,0,0,0,Gambia
27791,5/1/2021,GMB,Kedah,0,0,0,Gambia
27792,5/1/2021,GMB,Kelantan,0,0,0,Gambia
27793,5/1/2021,GMB,Pulau Pinang,0,0,0,Gambia
27794,5/1/2021,GMB,Sabah,0,0,0,Gambia
27795,5/1/2021,GMB,Sarawak,0,0,0,Gambia
27796,5/1/2021,GMB,Selangor,2,1,1,Gambia
27797,5/1/2021,GNB,Johor,0,0,0,Guinea-Bissau
27798,5/1/2021,GNB,Selangor,0,0,0,Guinea-Bissau
27799,5/1/2021,GNQ,Johor,0,0,0,Equatorial Guinea
27800,5/1/2021,GNQ,Selangor,1,0,1,Equatorial Guinea
27801,5/1/2021,GRC,Johor,2,2,0,Greece
27802,5/1/2021,GRC,Kedah,0,0,0,Greece
27803,5/1/2021,GRC,Kelantan,0,0,0,Greece
27804,5/1/2021,GRC,Melaka,0,0,0,Greece
27805,5/1/2021,GRC,Negeri Sembilan,0,0,0,Greece
27806,5/1/2021,GRC,Pahang,0,0,0,Greece
27807,5/1/2021,GRC,Perak,0,0,0,Greece
27808,5/1/2021,GRC,Perlis,0,0,0,Greece
27809,5/1/2021,GRC,Pulau Pinang,0,0,0,Greece
27810,5/1/2021,GRC,Sabah,0,0,0,Greece
27811,5/1/2021,GRC,Sarawak,0,0,0,Greece
27812,5/1/2021,GRC,Selangor,13,13,0,Greece
27813,5/1/2021,GRD,Johor,0,0,0,Grenada
27814,5/1/2021,GRD,Kedah,0,0,0,Grenada
27815,5/1/2021,GRD,Pulau Pinang,0,0,0,Grenada
27816,5/1/2021,GRD,Sabah,0,0,0,Grenada
27817,5/1/2021,GRD,Sarawak,0,0,0,Grenada
27818,5/1/2021,GRD,Selangor,0,0,0,Grenada
27819,5/1/2021,GRL,Johor,0,0,0,Greenland
27820,5/1/2021,GRL,Selangor,0,0,0,Greenland
27821,5/1/2021,GTM,Johor,0,0,0,Guatemala
27822,5/1/2021,GTM,Kedah,0,0,0,Guatemala
27823,5/1/2021,GTM,Pahang,0,0,0,Guatemala
27824,5/1/2021,GTM,Perak,0,0,0,Guatemala
27825,5/1/2021,GTM,Pulau Pinang,0,0,0,Guatemala
27826,5/1/2021,GTM,Sabah,0,0,0,Guatemala
27827,5/1/2021,GTM,Sarawak,0,0,0,Guatemala
27828,5/1/2021,GTM,Selangor,0,0,0,Guatemala
27829,5/1/2021,GTM,W.P. Labuan,0,0,0,Guatemala
27830,5/1/2021,GUY,Johor,0,0,0,Guyana
27831,5/1/2021,GUY,Kedah,0,0,0,Guyana
27832,5/1/2021,GUY,Pulau Pinang,0,0,0,Guyana
27833,5/1/2021,GUY,Sarawak,0,0,0,Guyana
27834,5/1/2021,GUY,Selangor,0,0,0,Guyana
27835,5/1/2021,HKG,Johor,0,0,0,Hong Kong
27836,5/1/2021,HKG,Kedah,0,0,0,Hong Kong
27837,5/1/2021,HKG,Kelantan,0,0,0,Hong Kong
27838,5/1/2021,HKG,Pahang,0,0,0,Hong Kong
27839,5/1/2021,HKG,Perak,0,0,0,Hong Kong
27840,5/1/2021,HKG,Perlis,0,0,0,Hong Kong
27841,5/1/2021,HKG,Pulau Pinang,1,1,0,Hong Kong
27842,5/1/2021,HKG,Sabah,0,0,0,Hong Kong
27843,5/1/2021,HKG,Sarawak,0,0,0,Hong Kong
27844,5/1/2021,HKG,Selangor,0,0,0,Hong Kong
27845,5/1/2021,HKG,Terengganu,0,0,0,Hong Kong
27846,5/1/2021,HMD,Johor,0,0,0,Heard Island and McDonald Islands
27847,5/1/2021,HND,Johor,0,0,0,Honduras
27848,5/1/2021,HND,Kedah,0,0,0,Honduras
27849,5/1/2021,HND,Perak,0,0,0,Honduras
27850,5/1/2021,HND,Pulau Pinang,0,0,0,Honduras
27851,5/1/2021,HND,Sabah,0,0,0,Honduras
27852,5/1/2021,HND,Sarawak,0,0,0,Honduras
27853,5/1/2021,HND,Selangor,0,0,0,Honduras
27854,5/1/2021,HRV,Johor,0,0,0,Croatia
27855,5/1/2021,HRV,Kedah,0,0,0,Croatia
27856,5/1/2021,HRV,Kelantan,0,0,0,Croatia
27857,5/1/2021,HRV,Melaka,0,0,0,Croatia
27858,5/1/2021,HRV,Pahang,0,0,0,Croatia
27859,5/1/2021,HRV,Perak,0,0,0,Croatia
27860,5/1/2021,HRV,Perlis,0,0,0,Croatia
27861,5/1/2021,HRV,Pulau Pinang,0,0,0,Croatia
27862,5/1/2021,HRV,Sabah,0,0,0,Croatia
27863,5/1/2021,HRV,Sarawak,0,0,0,Croatia
27864,5/1/2021,HRV,Selangor,43,41,2,Croatia
27865,5/1/2021,HTI,Johor,0,0,0,Haiti
27866,5/1/2021,HTI,Kedah,0,0,0,Haiti
27867,5/1/2021,HTI,Kelantan,0,0,0,Haiti
27868,5/1/2021,HTI,Perak,0,0,0,Haiti
27869,5/1/2021,HTI,Pulau Pinang,0,0,0,Haiti
27870,5/1/2021,HTI,Sabah,0,0,0,Haiti
27871,5/1/2021,HTI,Selangor,0,0,0,Haiti
27872,5/1/2021,HUN,Johor,0,0,0,Hungary
27873,5/1/2021,HUN,Kedah,0,0,0,Hungary
27874,5/1/2021,HUN,Kelantan,0,0,0,Hungary
27875,5/1/2021,HUN,Pahang,0,0,0,Hungary
27876,5/1/2021,HUN,Perak,0,0,0,Hungary
27877,5/1/2021,HUN,Perlis,0,0,0,Hungary
27878,5/1/2021,HUN,Pulau Pinang,0,0,0,Hungary
27879,5/1/2021,HUN,Sabah,0,0,0,Hungary
27880,5/1/2021,HUN,Sarawak,0,0,0,Hungary
27881,5/1/2021,HUN,Selangor,4,4,0,Hungary
27882,5/1/2021,HUN,W.P. Labuan,0,0,0,Hungary
27883,5/1/2021,IDN,Johor,131,109,22,Indonesia
27884,5/1/2021,IDN,Kedah,6,6,0,Indonesia
27885,5/1/2021,IDN,Kelantan,0,0,0,Indonesia
27886,5/1/2021,IDN,Melaka,0,0,0,Indonesia
27887,5/1/2021,IDN,Negeri Sembilan,0,0,0,Indonesia
27888,5/1/2021,IDN,Pahang,0,0,0,Indonesia
27889,5/1/2021,IDN,Perak,0,0,0,Indonesia
27890,5/1/2021,IDN,Perlis,5,5,0,Indonesia
27891,5/1/2021,IDN,Pulau Pinang,35,11,24,Indonesia
27892,5/1/2021,IDN,Sabah,2,1,1,Indonesia
27893,5/1/2021,IDN,Sarawak,336,332,4,Indonesia
27894,5/1/2021,IDN,Selangor,806,532,274,Indonesia
27895,5/1/2021,IDN,Terengganu,4,4,0,Indonesia
27896,5/1/2021,IDN,W.P. Labuan,6,6,0,Indonesia
27897,5/1/2021,IND,Johor,3,3,0,India
27898,5/1/2021,IND,Kedah,0,0,0,India
27899,5/1/2021,IND,Kelantan,0,0,0,India
27900,5/1/2021,IND,Melaka,0,0,0,India
27901,5/1/2021,IND,Negeri Sembilan,0,0,0,India
27902,5/1/2021,IND,Pahang,0,0,0,India
27903,5/1/2021,IND,Perak,0,0,0,India
27904,5/1/2021,IND,Perlis,0,0,0,India
27905,5/1/2021,IND,Pulau Pinang,0,0,0,India
27906,5/1/2021,IND,Sabah,0,0,0,India
27907,5/1/2021,IND,Sarawak,0,0,0,India
27908,5/1/2021,IND,Selangor,36,21,15,India
27909,5/1/2021,IND,Terengganu,0,0,0,India
27910,5/1/2021,IND,W.P. Labuan,0,0,0,India
27911,5/1/2021,IOT,Pulau Pinang,0,0,0,British Indian Ocean Territory
27912,5/1/2021,IOT,Selangor,0,0,0,British Indian Ocean Territory
27913,5/1/2021,IRL,Johor,0,0,0,Ireland
27914,5/1/2021,IRL,Kedah,0,0,0,Ireland
27915,5/1/2021,IRL,Kelantan,0,0,0,Ireland
27916,5/1/2021,IRL,Negeri Sembilan,0,0,0,Ireland
27917,5/1/2021,IRL,Pahang,0,0,0,Ireland
27918,5/1/2021,IRL,Perak,0,0,0,Ireland
27919,5/1/2021,IRL,Perlis,0,0,0,Ireland
27920,5/1/2021,IRL,Pulau Pinang,0,0,0,Ireland
27921,5/1/2021,IRL,Sabah,0,0,0,Ireland
27922,5/1/2021,IRL,Sarawak,0,0,0,Ireland
27923,5/1/2021,IRL,Selangor,12,12,0,Ireland
27924,5/1/2021,IRL,Terengganu,0,0,0,Ireland
27925,5/1/2021,IRL,W.P. Labuan,0,0,0,Ireland
27926,5/1/2021,IRN,Johor,2,2,0,Iran
27927,5/1/2021,IRN,Kedah,0,0,0,Iran
27928,5/1/2021,IRN,Kelantan,0,0,0,Iran
27929,5/1/2021,IRN,Perak,0,0,0,Iran
27930,5/1/2021,IRN,Perlis,0,0,0,Iran
27931,5/1/2021,IRN,Pulau Pinang,0,0,0,Iran
27932,5/1/2021,IRN,Sabah,0,0,0,Iran
27933,5/1/2021,IRN,Sarawak,0,0,0,Iran
27934,5/1/2021,IRN,Selangor,40,21,19,Iran
27935,5/1/2021,IRN,W.P. Labuan,0,0,0,Iran
27936,5/1/2021,IRQ,Johor,0,0,0,Iraq
27937,5/1/2021,IRQ,Kedah,0,0,0,Iraq
27938,5/1/2021,IRQ,Kelantan,0,0,0,Iraq
27939,5/1/2021,IRQ,Melaka,0,0,0,Iraq
27940,5/1/2021,IRQ,Pahang,0,0,0,Iraq
27941,5/1/2021,IRQ,Perak,0,0,0,Iraq
27942,5/1/2021,IRQ,Perlis,0,0,0,Iraq
27943,5/1/2021,IRQ,Pulau Pinang,0,0,0,Iraq
27944,5/1/2021,IRQ,Sabah,0,0,0,Iraq
27945,5/1/2021,IRQ,Sarawak,0,0,0,Iraq
27946,5/1/2021,IRQ,Selangor,25,20,5,Iraq
27947,5/1/2021,ISL,Johor,0,0,0,Iceland
27948,5/1/2021,ISL,Kedah,0,0,0,Iceland
27949,5/1/2021,ISL,Kelantan,0,0,0,Iceland
27950,5/1/2021,ISL,Perak,0,0,0,Iceland
27951,5/1/2021,ISL,Perlis,0,0,0,Iceland
27952,5/1/2021,ISL,Pulau Pinang,0,0,0,Iceland
27953,5/1/2021,ISL,Sabah,0,0,0,Iceland
27954,5/1/2021,ISL,Sarawak,0,0,0,Iceland
27955,5/1/2021,ISL,Selangor,0,0,0,Iceland
27956,5/1/2021,ISL,W.P. Labuan,0,0,0,Iceland
27957,5/1/2021,ISR,Pulau Pinang,0,0,0,Israel
27958,5/1/2021,ITA,Johor,0,0,0,Italy
27959,5/1/2021,ITA,Kedah,2,2,0,Italy
27960,5/1/2021,ITA,Kelantan,0,0,0,Italy
27961,5/1/2021,ITA,Melaka,0,0,0,Italy
27962,5/1/2021,ITA,Negeri Sembilan,0,0,0,Italy
27963,5/1/2021,ITA,Pahang,0,0,0,Italy
27964,5/1/2021,ITA,Perak,0,0,0,Italy
27965,5/1/2021,ITA,Perlis,0,0,0,Italy
27966,5/1/2021,ITA,Pulau Pinang,0,0,0,Italy
27967,5/1/2021,ITA,Sabah,0,0,0,Italy
27968,5/1/2021,ITA,Sarawak,0,0,0,Italy
27969,5/1/2021,ITA,Selangor,49,41,8,Italy
27970,5/1/2021,ITA,W.P. Labuan,0,0,0,Italy
27971,5/1/2021,JAM,Johor,0,0,0,Jamaica
27972,5/1/2021,JAM,Kedah,0,0,0,Jamaica
27973,5/1/2021,JAM,Perak,0,0,0,Jamaica
27974,5/1/2021,JAM,Pulau Pinang,0,0,0,Jamaica
27975,5/1/2021,JAM,Sabah,0,0,0,Jamaica
27976,5/1/2021,JAM,Sarawak,0,0,0,Jamaica
27977,5/1/2021,JAM,Selangor,0,0,0,Jamaica
27978,5/1/2021,JAM,W.P. Labuan,0,0,0,Jamaica
27979,5/1/2021,JOR,Johor,0,0,0,Jordan
27980,5/1/2021,JOR,Kedah,0,0,0,Jordan
27981,5/1/2021,JOR,Kelantan,0,0,0,Jordan
27982,5/1/2021,JOR,Melaka,0,0,0,Jordan
27983,5/1/2021,JOR,Perlis,0,0,0,Jordan
27984,5/1/2021,JOR,Pulau Pinang,0,0,0,Jordan
27985,5/1/2021,JOR,Sabah,0,0,0,Jordan
27986,5/1/2021,JOR,Sarawak,0,0,0,Jordan
27987,5/1/2021,JOR,Selangor,45,35,10,Jordan
27988,5/1/2021,JOR,W.P. Labuan,0,0,0,Jordan
27989,5/1/2021,JPN,Johor,0,0,0,Japan
27990,5/1/2021,JPN,Kedah,0,0,0,Japan
27991,5/1/2021,JPN,Kelantan,0,0,0,Japan
27992,5/1/2021,JPN,Melaka,0,0,0,Japan
27993,5/1/2021,JPN,Negeri Sembilan,0,0,0,Japan
27994,5/1/2021,JPN,Pahang,0,0,0,Japan
27995,5/1/2021,JPN,Perak,0,0,0,Japan
27996,5/1/2021,JPN,Perlis,0,0,0,Japan
27997,5/1/2021,JPN,Pulau Pinang,15,14,1,Japan
27998,5/1/2021,JPN,Sabah,0,0,0,Japan
27999,5/1/2021,JPN,Sarawak,7,7,0,Japan
28000,5/1/2021,JPN,Selangor,459,318,141,Japan
28001,5/1/2021,JPN,W.P. Labuan,0,0,0,Japan
28002,5/1/2021,KAZ,Johor,0,0,0,Kazakhstan
28003,5/1/2021,KAZ,Kedah,0,0,0,Kazakhstan
28004,5/1/2021,KAZ,Kelantan,0,0,0,Kazakhstan
28005,5/1/2021,KAZ,Melaka,0,0,0,Kazakhstan
28006,5/1/2021,KAZ,Perak,0,0,0,Kazakhstan
28007,5/1/2021,KAZ,Perlis,0,0,0,Kazakhstan
28008,5/1/2021,KAZ,Pulau Pinang,0,0,0,Kazakhstan
28009,5/1/2021,KAZ,Sabah,0,0,0,Kazakhstan
28010,5/1/2021,KAZ,Sarawak,0,0,0,Kazakhstan
28011,5/1/2021,KAZ,Selangor,15,7,8,Kazakhstan
28012,5/1/2021,KAZ,W.P. Labuan,0,0,0,Kazakhstan
28013,5/1/2021,KEN,Johor,0,0,0,Kenya
28014,5/1/2021,KEN,Kedah,0,0,0,Kenya
28015,5/1/2021,KEN,Kelantan,0,0,0,Kenya
28016,5/1/2021,KEN,Perak,0,0,0,Kenya
28017,5/1/2021,KEN,Perlis,0,0,0,Kenya
28018,5/1/2021,KEN,Pulau Pinang,0,0,0,Kenya
28019,5/1/2021,KEN,Sabah,0,0,0,Kenya
28020,5/1/2021,KEN,Sarawak,0,0,0,Kenya
28021,5/1/2021,KEN,Selangor,37,26,11,Kenya
28022,5/1/2021,KGZ,Johor,0,0,0,Kyrgyzstan
28023,5/1/2021,KGZ,Kedah,0,0,0,Kyrgyzstan
28024,5/1/2021,KGZ,Kelantan,0,0,0,Kyrgyzstan
28025,5/1/2021,KGZ,Perak,0,0,0,Kyrgyzstan
28026,5/1/2021,KGZ,Perlis,0,0,0,Kyrgyzstan
28027,5/1/2021,KGZ,Pulau Pinang,0,0,0,Kyrgyzstan
28028,5/1/2021,KGZ,Sabah,0,0,0,Kyrgyzstan
28029,5/1/2021,KGZ,Sarawak,0,0,0,Kyrgyzstan
28030,5/1/2021,KGZ,Selangor,1,0,1,Kyrgyzstan
28031,5/1/2021,KHM,Johor,0,0,0,Cambodia
28032,5/1/2021,KHM,Kedah,0,0,0,Cambodia
28033,5/1/2021,KHM,Kelantan,0,0,0,Cambodia
28034,5/1/2021,KHM,Melaka,0,0,0,Cambodia
28035,5/1/2021,KHM,Negeri Sembilan,0,0,0,Cambodia
28036,5/1/2021,KHM,Pahang,0,0,0,Cambodia
28037,5/1/2021,KHM,Perak,1,0,1,Cambodia
28038,5/1/2021,KHM,Perlis,0,0,0,Cambodia
28039,5/1/2021,KHM,Pulau Pinang,2,1,1,Cambodia
28040,5/1/2021,KHM,Sabah,0,0,0,Cambodia
28041,5/1/2021,KHM,Sarawak,0,0,0,Cambodia
28042,5/1/2021,KHM,Selangor,9,5,4,Cambodia
28043,5/1/2021,KHM,W.P. Labuan,0,0,0,Cambodia
28044,5/1/2021,KIR,Johor,11,11,0,Kiribati
28045,5/1/2021,KIR,Sabah,0,0,0,Kiribati
28046,5/1/2021,KIR,Selangor,0,0,0,Kiribati
28047,5/1/2021,KNA,Johor,0,0,0,Saint Kitts and Nevis
28048,5/1/2021,KNA,Kedah,0,0,0,Saint Kitts and Nevis
28049,5/1/2021,KNA,Perlis,0,0,0,Saint Kitts and Nevis
28050,5/1/2021,KNA,Pulau Pinang,0,0,0,Saint Kitts and Nevis
28051,5/1/2021,KNA,Sabah,0,0,0,Saint Kitts and Nevis
28052,5/1/2021,KNA,Selangor,0,0,0,Saint Kitts and Nevis
28053,5/1/2021,KNA,W.P. Labuan,0,0,0,Saint Kitts and Nevis
28054,5/1/2021,KOR,Johor,2,2,0,"Korea, Republic of (South Korea)"
28055,5/1/2021,KOR,Kedah,0,0,0,"Korea, Republic of (South Korea)"
28056,5/1/2021,KOR,Kelantan,0,0,0,"Korea, Republic of (South Korea)"
28057,5/1/2021,KOR,Melaka,0,0,0,"Korea, Republic of (South Korea)"
28058,5/1/2021,KOR,Negeri Sembilan,0,0,0,"Korea, Republic of (South Korea)"
28059,5/1/2021,KOR,Pahang,0,0,0,"Korea, Republic of (South Korea)"
28060,5/1/2021,KOR,Perak,0,0,0,"Korea, Republic of (South Korea)"
28061,5/1/2021,KOR,Perlis,0,0,0,"Korea, Republic of (South Korea)"
28062,5/1/2021,KOR,Pulau Pinang,1,0,1,"Korea, Republic of (South Korea)"
28063,5/1/2021,KOR,Sabah,0,0,0,"Korea, Republic of (South Korea)"
28064,5/1/2021,KOR,Sarawak,12,11,1,"Korea, Republic of (South Korea)"
28065,5/1/2021,KOR,Selangor,291,221,70,"Korea, Republic of (South Korea)"
28066,5/1/2021,KOR,Terengganu,0,0,0,"Korea, Republic of (South Korea)"
28067,5/1/2021,KOR,W.P. Labuan,0,0,0,"Korea, Republic of (South Korea)"
28068,5/1/2021,KWT,Johor,0,0,0,Kuwait
28069,5/1/2021,KWT,Kedah,0,0,0,Kuwait
28070,5/1/2021,KWT,Kelantan,0,0,0,Kuwait
28071,5/1/2021,KWT,Perak,0,0,0,Kuwait
28072,5/1/2021,KWT,Perlis,0,0,0,Kuwait
28073,5/1/2021,KWT,Pulau Pinang,0,0,0,Kuwait
28074,5/1/2021,KWT,Sabah,0,0,0,Kuwait
28075,5/1/2021,KWT,Sarawak,0,0,0,Kuwait
28076,5/1/2021,KWT,Selangor,1,1,0,Kuwait
28077,5/1/2021,KWT,W.P. Labuan,0,0,0,Kuwait
28078,5/1/2021,LAO,Johor,0,0,0,Lao People's Democratic Republic
28079,5/1/2021,LAO,Kedah,0,0,0,Lao People's Democratic Republic
28080,5/1/2021,LAO,Kelantan,0,0,0,Lao People's Democratic Republic
28081,5/1/2021,LAO,Melaka,0,0,0,Lao People's Democratic Republic
28082,5/1/2021,LAO,Perak,0,0,0,Lao People's Democratic Republic
28083,5/1/2021,LAO,Perlis,0,0,0,Lao People's Democratic Republic
28084,5/1/2021,LAO,Pulau Pinang,0,0,0,Lao People's Democratic Republic
28085,5/1/2021,LAO,Sabah,0,0,0,Lao People's Democratic Republic
28086,5/1/2021,LAO,Sarawak,0,0,0,Lao People's Democratic Republic
28087,5/1/2021,LAO,Selangor,74,73,1,Lao People's Democratic Republic
28088,5/1/2021,LAO,W.P. Labuan,0,0,0,Lao People's Democratic Republic
28089,5/1/2021,LBN,Johor,0,0,0,Lebanon
28090,5/1/2021,LBN,Kedah,0,0,0,Lebanon
28091,5/1/2021,LBN,Kelantan,0,0,0,Lebanon
28092,5/1/2021,LBN,Pahang,0,0,0,Lebanon
28093,5/1/2021,LBN,Perak,0,0,0,Lebanon
28094,5/1/2021,LBN,Perlis,0,0,0,Lebanon
28095,5/1/2021,LBN,Pulau Pinang,0,0,0,Lebanon
28096,5/1/2021,LBN,Sabah,0,0,0,Lebanon
28097,5/1/2021,LBN,Sarawak,0,0,0,Lebanon
28098,5/1/2021,LBN,Selangor,4,1,3,Lebanon
28099,5/1/2021,LBN,W.P. Labuan,0,0,0,Lebanon
28100,5/1/2021,LBR,Johor,0,0,0,Liberia
28101,5/1/2021,LBR,Kedah,0,0,0,Liberia
28102,5/1/2021,LBR,Sabah,0,0,0,Liberia
28103,5/1/2021,LBR,Sarawak,0,0,0,Liberia
28104,5/1/2021,LBR,Selangor,4,2,2,Liberia
28105,5/1/2021,LBY,Johor,0,0,0,Libyan Arab Jamahiriya
28106,5/1/2021,LBY,Kedah,0,0,0,Libyan Arab Jamahiriya
28107,5/1/2021,LBY,Perlis,0,0,0,Libyan Arab Jamahiriya
28108,5/1/2021,LBY,Pulau Pinang,0,0,0,Libyan Arab Jamahiriya
28109,5/1/2021,LBY,Sabah,0,0,0,Libyan Arab Jamahiriya
28110,5/1/2021,LBY,Sarawak,0,0,0,Libyan Arab Jamahiriya
28111,5/1/2021,LBY,Selangor,35,32,3,Libyan Arab Jamahiriya
28112,5/1/2021,LCA,Johor,0,0,0,Saint Lucia
28113,5/1/2021,LCA,Kedah,0,0,0,Saint Lucia
28114,5/1/2021,LCA,Pulau Pinang,0,0,0,Saint Lucia
28115,5/1/2021,LCA,Sarawak,0,0,0,Saint Lucia
28116,5/1/2021,LCA,Selangor,0,0,0,Saint Lucia
28117,5/1/2021,LIE,Johor,0,0,0,Liechtenstein
28118,5/1/2021,LIE,Kedah,0,0,0,Liechtenstein
28119,5/1/2021,LIE,Perlis,0,0,0,Liechtenstein
28120,5/1/2021,LIE,Pulau Pinang,0,0,0,Liechtenstein
28121,5/1/2021,LIE,Sabah,0,0,0,Liechtenstein
28122,5/1/2021,LIE,Sarawak,0,0,0,Liechtenstein
28123,5/1/2021,LIE,Selangor,0,0,0,Liechtenstein
28124,5/1/2021,LKA,Johor,0,0,0,Sri Lanka
28125,5/1/2021,LKA,Kedah,0,0,0,Sri Lanka
28126,5/1/2021,LKA,Kelantan,0,0,0,Sri Lanka
28127,5/1/2021,LKA,Melaka,0,0,0,Sri Lanka
28128,5/1/2021,LKA,Pahang,0,0,0,Sri Lanka
28129,5/1/2021,LKA,Perak,0,0,0,Sri Lanka
28130,5/1/2021,LKA,Perlis,0,0,0,Sri Lanka
28131,5/1/2021,LKA,Pulau Pinang,0,0,0,Sri Lanka
28132,5/1/2021,LKA,Sabah,0,0,0,Sri Lanka
28133,5/1/2021,LKA,Sarawak,1,1,0,Sri Lanka
28134,5/1/2021,LKA,Selangor,43,33,10,Sri Lanka
28135,5/1/2021,LKA,W.P. Labuan,0,0,0,Sri Lanka
28136,5/1/2021,LSO,Johor,0,0,0,Lesotho
28137,5/1/2021,LSO,Kedah,0,0,0,Lesotho
28138,5/1/2021,LSO,Pulau Pinang,0,0,0,Lesotho
28139,5/1/2021,LSO,Sarawak,0,0,0,Lesotho
28140,5/1/2021,LSO,Selangor,2,1,1,Lesotho
28141,5/1/2021,LTU,Johor,0,0,0,Lithuania
28142,5/1/2021,LTU,Kedah,0,0,0,Lithuania
28143,5/1/2021,LTU,Kelantan,0,0,0,Lithuania
28144,5/1/2021,LTU,Pahang,0,0,0,Lithuania
28145,5/1/2021,LTU,Perak,0,0,0,Lithuania
28146,5/1/2021,LTU,Perlis,0,0,0,Lithuania
28147,5/1/2021,LTU,Pulau Pinang,0,0,0,Lithuania
28148,5/1/2021,LTU,Sabah,0,0,0,Lithuania
28149,5/1/2021,LTU,Sarawak,0,0,0,Lithuania
28150,5/1/2021,LTU,Selangor,9,9,0,Lithuania
28151,5/1/2021,LTU,W.P. Labuan,0,0,0,Lithuania
28152,5/1/2021,LUX,Johor,0,0,0,Luxembourg
28153,5/1/2021,LUX,Kedah,0,0,0,Luxembourg
28154,5/1/2021,LUX,Kelantan,0,0,0,Luxembourg
28155,5/1/2021,LUX,Perak,0,0,0,Luxembourg
28156,5/1/2021,LUX,Perlis,0,0,0,Luxembourg
28157,5/1/2021,LUX,Pulau Pinang,0,0,0,Luxembourg
28158,5/1/2021,LUX,Sabah,0,0,0,Luxembourg
28159,5/1/2021,LUX,Sarawak,0,0,0,Luxembourg
28160,5/1/2021,LUX,Selangor,0,0,0,Luxembourg
28161,5/1/2021,LVA,Johor,0,0,0,Latvia
28162,5/1/2021,LVA,Kedah,0,0,0,Latvia
28163,5/1/2021,LVA,Kelantan,0,0,0,Latvia
28164,5/1/2021,LVA,Pahang,0,0,0,Latvia
28165,5/1/2021,LVA,Perak,0,0,0,Latvia
28166,5/1/2021,LVA,Perlis,0,0,0,Latvia
28167,5/1/2021,LVA,Pulau Pinang,0,0,0,Latvia
28168,5/1/2021,LVA,Sabah,0,0,0,Latvia
28169,5/1/2021,LVA,Sarawak,0,0,0,Latvia
28170,5/1/2021,LVA,Selangor,3,3,0,Latvia
28171,5/1/2021,LVA,W.P. Labuan,0,0,0,Latvia
28172,5/1/2021,MAC,Johor,0,0,0,Macao
28173,5/1/2021,MAC,Pahang,0,0,0,Macao
28174,5/1/2021,MAC,Perak,0,0,0,Macao
28175,5/1/2021,MAC,Selangor,0,0,0,Macao
28176,5/1/2021,MAC,W.P. Labuan,0,0,0,Macao
28177,5/1/2021,MAR,Johor,0,0,0,Morocco
28178,5/1/2021,MAR,Kedah,0,0,0,Morocco
28179,5/1/2021,MAR,Kelantan,0,0,0,Morocco
28180,5/1/2021,MAR,Melaka,0,0,0,Morocco
28181,5/1/2021,MAR,Pahang,0,0,0,Morocco
28182,5/1/2021,MAR,Perak,0,0,0,Morocco
28183,5/1/2021,MAR,Perlis,0,0,0,Morocco
28184,5/1/2021,MAR,Pulau Pinang,0,0,0,Morocco
28185,5/1/2021,MAR,Sabah,0,0,0,Morocco
28186,5/1/2021,MAR,Sarawak,0,0,0,Morocco
28187,5/1/2021,MAR,Selangor,7,5,2,Morocco
28188,5/1/2021,MAR,W.P. Labuan,0,0,0,Morocco
28189,5/1/2021,MCO,Johor,0,0,0,Monaco
28190,5/1/2021,MCO,Kedah,0,0,0,Monaco
28191,5/1/2021,MCO,Sabah,0,0,0,Monaco
28192,5/1/2021,MCO,Selangor,0,0,0,Monaco
28193,5/1/2021,MDA,Johor,0,0,0,"Moldova, Republic of"
28194,5/1/2021,MDA,Kedah,0,0,0,"Moldova, Republic of"
28195,5/1/2021,MDA,Kelantan,0,0,0,"Moldova, Republic of"
28196,5/1/2021,MDA,Negeri Sembilan,0,0,0,"Moldova, Republic of"
28197,5/1/2021,MDA,Perlis,0,0,0,"Moldova, Republic of"
28198,5/1/2021,MDA,Pulau Pinang,0,0,0,"Moldova, Republic of"
28199,5/1/2021,MDA,Sabah,0,0,0,"Moldova, Republic of"
28200,5/1/2021,MDA,Sarawak,0,0,0,"Moldova, Republic of"
28201,5/1/2021,MDA,Selangor,0,0,0,"Moldova, Republic of"
28202,5/1/2021,MDG,Johor,0,0,0,Madagascar
28203,5/1/2021,MDG,Kedah,0,0,0,Madagascar
28204,5/1/2021,MDG,Perak,0,0,0,Madagascar
28205,5/1/2021,MDG,Perlis,0,0,0,Madagascar
28206,5/1/2021,MDG,Pulau Pinang,0,0,0,Madagascar
28207,5/1/2021,MDG,Sabah,0,0,0,Madagascar
28208,5/1/2021,MDG,Sarawak,0,0,0,Madagascar
28209,5/1/2021,MDG,Selangor,0,0,0,Madagascar
28210,5/1/2021,MDV,Johor,0,0,0,Maldives
28211,5/1/2021,MDV,Kedah,0,0,0,Maldives
28212,5/1/2021,MDV,Kelantan,0,0,0,Maldives
28213,5/1/2021,MDV,Perak,0,0,0,Maldives
28214,5/1/2021,MDV,Perlis,0,0,0,Maldives
28215,5/1/2021,MDV,Pulau Pinang,0,0,0,Maldives
28216,5/1/2021,MDV,Sabah,0,0,0,Maldives
28217,5/1/2021,MDV,Sarawak,0,0,0,Maldives
28218,5/1/2021,MDV,Selangor,103,32,71,Maldives
28219,5/1/2021,MEX,Johor,0,0,0,Mexico
28220,5/1/2021,MEX,Kedah,0,0,0,Mexico
28221,5/1/2021,MEX,Kelantan,0,0,0,Mexico
28222,5/1/2021,MEX,Pahang,0,0,0,Mexico
28223,5/1/2021,MEX,Perak,0,0,0,Mexico
28224,5/1/2021,MEX,Perlis,0,0,0,Mexico
28225,5/1/2021,MEX,Pulau Pinang,0,0,0,Mexico
28226,5/1/2021,MEX,Sabah,0,0,0,Mexico
28227,5/1/2021,MEX,Sarawak,0,0,0,Mexico
28228,5/1/2021,MEX,Selangor,11,8,3,Mexico
28229,5/1/2021,MEX,W.P. Labuan,0,0,0,Mexico
28230,5/1/2021,MHL,Johor,0,0,0,Marshall Islands
28231,5/1/2021,MHL,Kedah,0,0,0,Marshall Islands
28232,5/1/2021,MHL,Perak,0,0,0,Marshall Islands
28233,5/1/2021,MHL,Pulau Pinang,0,0,0,Marshall Islands
28234,5/1/2021,MHL,Sabah,0,0,0,Marshall Islands
28235,5/1/2021,MHL,Selangor,0,0,0,Marshall Islands
28236,5/1/2021,MKD,Johor,0,0,0,"Macedonia, the former Yugoslav Republic of"
28237,5/1/2021,MKD,Kedah,0,0,0,"Macedonia, the former Yugoslav Republic of"
28238,5/1/2021,MKD,Perak,0,0,0,"Macedonia, the former Yugoslav Republic of"
28239,5/1/2021,MKD,Pulau Pinang,0,0,0,"Macedonia, the former Yugoslav Republic of"
28240,5/1/2021,MKD,Sabah,0,0,0,"Macedonia, the former Yugoslav Republic of"
28241,5/1/2021,MKD,Sarawak,0,0,0,"Macedonia, the former Yugoslav Republic of"
28242,5/1/2021,MKD,Selangor,2,2,0,"Macedonia, the former Yugoslav Republic of"
28243,5/1/2021,MLI,Johor,0,0,0,Mali
28244,5/1/2021,MLI,Sabah,0,0,0,Mali
28245,5/1/2021,MLI,Selangor,1,1,0,Mali
28246,5/1/2021,MLT,Johor,0,0,0,Malta
28247,5/1/2021,MLT,Kedah,0,0,0,Malta
28248,5/1/2021,MLT,Kelantan,0,0,0,Malta
28249,5/1/2021,MLT,Perak,0,0,0,Malta
28250,5/1/2021,MLT,Perlis,0,0,0,Malta
28251,5/1/2021,MLT,Pulau Pinang,0,0,0,Malta
28252,5/1/2021,MLT,Sabah,0,0,0,Malta
28253,5/1/2021,MLT,Sarawak,0,0,0,Malta
28254,5/1/2021,MLT,Selangor,2,2,0,Malta
28255,5/1/2021,MLT,W.P. Labuan,0,0,0,Malta
28256,5/1/2021,MMR,Johor,9,9,0,Myanmar
28257,5/1/2021,MMR,Kedah,0,0,0,Myanmar
28258,5/1/2021,MMR,Kelantan,0,0,0,Myanmar
28259,5/1/2021,MMR,Negeri Sembilan,0,0,0,Myanmar
28260,5/1/2021,MMR,Pahang,0,0,0,Myanmar
28261,5/1/2021,MMR,Perak,0,0,0,Myanmar
28262,5/1/2021,MMR,Perlis,0,0,0,Myanmar
28263,5/1/2021,MMR,Pulau Pinang,0,0,0,Myanmar
28264,5/1/2021,MMR,Sabah,0,0,0,Myanmar
28265,5/1/2021,MMR,Sarawak,0,0,0,Myanmar
28266,5/1/2021,MMR,Selangor,60,50,10,Myanmar
28267,5/1/2021,MMR,Terengganu,0,0,0,Myanmar
28268,5/1/2021,MMR,W.P. Labuan,0,0,0,Myanmar
28269,5/1/2021,MNE,Johor,0,0,0,Montenegro
28270,5/1/2021,MNE,Kedah,0,0,0,Montenegro
28271,5/1/2021,MNE,Pulau Pinang,0,0,0,Montenegro
28272,5/1/2021,MNE,Sabah,0,0,0,Montenegro
28273,5/1/2021,MNE,Sarawak,0,0,0,Montenegro
28274,5/1/2021,MNE,Selangor,3,3,0,Montenegro
28275,5/1/2021,MNG,Johor,0,0,0,Mongolia
28276,5/1/2021,MNG,Kedah,0,0,0,Mongolia
28277,5/1/2021,MNG,Kelantan,0,0,0,Mongolia
28278,5/1/2021,MNG,Perak,0,0,0,Mongolia
28279,5/1/2021,MNG,Perlis,0,0,0,Mongolia
28280,5/1/2021,MNG,Pulau Pinang,0,0,0,Mongolia
28281,5/1/2021,MNG,Sabah,0,0,0,Mongolia
28282,5/1/2021,MNG,Sarawak,0,0,0,Mongolia
28283,5/1/2021,MNG,Selangor,3,0,3,Mongolia
28284,5/1/2021,MNP,Selangor,0,0,0,Northern Mariana Islands
28285,5/1/2021,MOZ,Johor,0,0,0,Mozambique
28286,5/1/2021,MOZ,Kedah,0,0,0,Mozambique
28287,5/1/2021,MOZ,Perak,0,0,0,Mozambique
28288,5/1/2021,MOZ,Pulau Pinang,0,0,0,Mozambique
28289,5/1/2021,MOZ,Sabah,0,0,0,Mozambique
28290,5/1/2021,MOZ,Sarawak,0,0,0,Mozambique
28291,5/1/2021,MOZ,Selangor,8,3,5,Mozambique
28292,5/1/2021,MRT,Johor,0,0,0,Mauritania
28293,5/1/2021,MRT,Kedah,0,0,0,Mauritania
28294,5/1/2021,MRT,Pulau Pinang,0,0,0,Mauritania
28295,5/1/2021,MRT,Sabah,0,0,0,Mauritania
28296,5/1/2021,MRT,Sarawak,0,0,0,Mauritania
28297,5/1/2021,MRT,Selangor,3,3,0,Mauritania
28298,5/1/2021,MUS,Johor,0,0,0,Mauritius
28299,5/1/2021,MUS,Kedah,0,0,0,Mauritius
28300,5/1/2021,MUS,Kelantan,0,0,0,Mauritius
28301,5/1/2021,MUS,Pahang,0,0,0,Mauritius
28302,5/1/2021,MUS,Perak,0,0,0,Mauritius
28303,5/1/2021,MUS,Perlis,0,0,0,Mauritius
28304,5/1/2021,MUS,Pulau Pinang,0,0,0,Mauritius
28305,5/1/2021,MUS,Sabah,0,0,0,Mauritius
28306,5/1/2021,MUS,Sarawak,0,0,0,Mauritius
28307,5/1/2021,MUS,Selangor,13,4,9,Mauritius
28308,5/1/2021,MWI,Johor,0,0,0,Malawi
28309,5/1/2021,MWI,Pulau Pinang,0,0,0,Malawi
28310,5/1/2021,MWI,Sabah,0,0,0,Malawi
28311,5/1/2021,MWI,Sarawak,0,0,0,Malawi
28312,5/1/2021,MWI,Selangor,5,1,4,Malawi
28313,5/1/2021,MYT,Selangor,0,0,0,Mayotte
28314,5/1/2021,NAM,Johor,0,0,0,Namibia
28315,5/1/2021,NAM,Kedah,0,0,0,Namibia
28316,5/1/2021,NAM,Perak,0,0,0,Namibia
28317,5/1/2021,NAM,Perlis,0,0,0,Namibia
28318,5/1/2021,NAM,Pulau Pinang,0,0,0,Namibia
28319,5/1/2021,NAM,Sabah,0,0,0,Namibia
28320,5/1/2021,NAM,Sarawak,0,0,0,Namibia
28321,5/1/2021,NAM,Selangor,2,2,0,Namibia
28322,5/1/2021,NCL,Selangor,0,0,0,New Caledonia
28323,5/1/2021,NER,Johor,0,0,0,Niger
28324,5/1/2021,NER,Sabah,0,0,0,Niger
28325,5/1/2021,NER,Selangor,0,0,0,Niger
28326,5/1/2021,NGA,Johor,0,0,0,Nigeria
28327,5/1/2021,NGA,Kedah,0,0,0,Nigeria
28328,5/1/2021,NGA,Perlis,0,0,0,Nigeria
28329,5/1/2021,NGA,Pulau Pinang,0,0,0,Nigeria
28330,5/1/2021,NGA,Sabah,0,0,0,Nigeria
28331,5/1/2021,NGA,Sarawak,0,0,0,Nigeria
28332,5/1/2021,NGA,Selangor,132,111,21,Nigeria
28333,5/1/2021,NIC,Johor,0,0,0,Nicaragua
28334,5/1/2021,NIC,Kedah,0,0,0,Nicaragua
28335,5/1/2021,NIC,Pulau Pinang,0,0,0,Nicaragua
28336,5/1/2021,NIC,Sabah,0,0,0,Nicaragua
28337,5/1/2021,NIC,Selangor,0,0,0,Nicaragua
28338,5/1/2021,NLD,Johor,0,0,0,Netherlands
28339,5/1/2021,NLD,Kedah,0,0,0,Netherlands
28340,5/1/2021,NLD,Kelantan,0,0,0,Netherlands
28341,5/1/2021,NLD,Melaka,0,0,0,Netherlands
28342,5/1/2021,NLD,Negeri Sembilan,0,0,0,Netherlands
28343,5/1/2021,NLD,Pahang,0,0,0,Netherlands
28344,5/1/2021,NLD,Perak,0,0,0,Netherlands
28345,5/1/2021,NLD,Perlis,0,0,0,Netherlands
28346,5/1/2021,NLD,Pulau Pinang,1,0,1,Netherlands
28347,5/1/2021,NLD,Sabah,1,1,0,Netherlands
28348,5/1/2021,NLD,Sarawak,0,0,0,Netherlands
28349,5/1/2021,NLD,Selangor,38,32,6,Netherlands
28350,5/1/2021,NLD,Terengganu,0,0,0,Netherlands
28351,5/1/2021,NLD,W.P. Labuan,0,0,0,Netherlands
28352,5/1/2021,NOR,Johor,0,0,0,Norway
28353,5/1/2021,NOR,Kedah,0,0,0,Norway
28354,5/1/2021,NOR,Kelantan,0,0,0,Norway
28355,5/1/2021,NOR,Melaka,0,0,0,Norway
28356,5/1/2021,NOR,Pahang,0,0,0,Norway
28357,5/1/2021,NOR,Perak,0,0,0,Norway
28358,5/1/2021,NOR,Perlis,0,0,0,Norway
28359,5/1/2021,NOR,Pulau Pinang,0,0,0,Norway
28360,5/1/2021,NOR,Sabah,0,0,0,Norway
28361,5/1/2021,NOR,Sarawak,1,0,1,Norway
28362,5/1/2021,NOR,Selangor,14,14,0,Norway
28363,5/1/2021,NOR,W.P. Labuan,0,0,0,Norway
28364,5/1/2021,NPL,Johor,0,0,0,Nepal
28365,5/1/2021,NPL,Kedah,0,0,0,Nepal
28366,5/1/2021,NPL,Pahang,0,0,0,Nepal
28367,5/1/2021,NPL,Perak,0,0,0,Nepal
28368,5/1/2021,NPL,Perlis,0,0,0,Nepal
28369,5/1/2021,NPL,Pulau Pinang,0,0,0,Nepal
28370,5/1/2021,NPL,Sabah,0,0,0,Nepal
28371,5/1/2021,NPL,Sarawak,0,0,0,Nepal
28372,5/1/2021,NPL,Selangor,74,73,1,Nepal
28373,5/1/2021,NPL,W.P. Labuan,0,0,0,Nepal
28374,5/1/2021,NRU,Johor,0,0,0,Nauru
28375,5/1/2021,NRU,Pulau Pinang,0,0,0,Nauru
28376,5/1/2021,NRU,Selangor,0,0,0,Nauru
28377,5/1/2021,NZL,Johor,0,0,0,New Zealand
28378,5/1/2021,NZL,Kedah,0,0,0,New Zealand
28379,5/1/2021,NZL,Kelantan,0,0,0,New Zealand
28380,5/1/2021,NZL,Melaka,0,0,0,New Zealand
28381,5/1/2021,NZL,Negeri Sembilan,0,0,0,New Zealand
28382,5/1/2021,NZL,Pahang,0,0,0,New Zealand
28383,5/1/2021,NZL,Perak,0,0,0,New Zealand
28384,5/1/2021,NZL,Perlis,0,0,0,New Zealand
28385,5/1/2021,NZL,Pulau Pinang,1,1,0,New Zealand
28386,5/1/2021,NZL,Sabah,0,0,0,New Zealand
28387,5/1/2021,NZL,Sarawak,1,1,0,New Zealand
28388,5/1/2021,NZL,Selangor,6,5,1,New Zealand
28389,5/1/2021,NZL,Terengganu,0,0,0,New Zealand
28390,5/1/2021,NZL,W.P. Labuan,0,0,0,New Zealand
28391,5/1/2021,OMN,Johor,0,0,0,Oman
28392,5/1/2021,OMN,Kedah,0,0,0,Oman
28393,5/1/2021,OMN,Kelantan,0,0,0,Oman
28394,5/1/2021,OMN,Melaka,0,0,0,Oman
28395,5/1/2021,OMN,Perak,0,0,0,Oman
28396,5/1/2021,OMN,Perlis,0,0,0,Oman
28397,5/1/2021,OMN,Pulau Pinang,0,0,0,Oman
28398,5/1/2021,OMN,Sabah,0,0,0,Oman
28399,5/1/2021,OMN,Sarawak,0,0,0,Oman
28400,5/1/2021,OMN,Selangor,9,8,1,Oman
28401,5/1/2021,PAK,Johor,0,0,0,Pakistan
28402,5/1/2021,PAK,Kedah,0,0,0,Pakistan
28403,5/1/2021,PAK,Kelantan,0,0,0,Pakistan
28404,5/1/2021,PAK,Melaka,0,0,0,Pakistan
28405,5/1/2021,PAK,Negeri Sembilan,0,0,0,Pakistan
28406,5/1/2021,PAK,Pahang,0,0,0,Pakistan
28407,5/1/2021,PAK,Perak,0,0,0,Pakistan
28408,5/1/2021,PAK,Perlis,0,0,0,Pakistan
28409,5/1/2021,PAK,Pulau Pinang,1,1,0,Pakistan
28410,5/1/2021,PAK,Sabah,1,1,0,Pakistan
28411,5/1/2021,PAK,Sarawak,0,0,0,Pakistan
28412,5/1/2021,PAK,Selangor,57,40,17,Pakistan
28413,5/1/2021,PAK,W.P. Labuan,0,0,0,Pakistan
28414,5/1/2021,PAN,Johor,0,0,0,Panama
28415,5/1/2021,PAN,Kedah,0,0,0,Panama
28416,5/1/2021,PAN,Perak,0,0,0,Panama
28417,5/1/2021,PAN,Perlis,0,0,0,Panama
28418,5/1/2021,PAN,Pulau Pinang,0,0,0,Panama
28419,5/1/2021,PAN,Sabah,0,0,0,Panama
28420,5/1/2021,PAN,Sarawak,0,0,0,Panama
28421,5/1/2021,PAN,Selangor,1,1,0,Panama
28422,5/1/2021,PER,Johor,0,0,0,Peru
28423,5/1/2021,PER,Kedah,0,0,0,Peru
28424,5/1/2021,PER,Kelantan,0,0,0,Peru
28425,5/1/2021,PER,Pahang,0,0,0,Peru
28426,5/1/2021,PER,Perak,0,0,0,Peru
28427,5/1/2021,PER,Perlis,0,0,0,Peru
28428,5/1/2021,PER,Pulau Pinang,0,0,0,Peru
28429,5/1/2021,PER,Sabah,0,0,0,Peru
28430,5/1/2021,PER,Sarawak,0,0,0,Peru
28431,5/1/2021,PER,Selangor,1,1,0,Peru
28432,5/1/2021,PER,W.P. Labuan,0,0,0,Peru
28433,5/1/2021,PHL,Johor,78,77,1,Philippines
28434,5/1/2021,PHL,Kedah,0,0,0,Philippines
28435,5/1/2021,PHL,Kelantan,0,0,0,Philippines
28436,5/1/2021,PHL,Melaka,0,0,0,Philippines
28437,5/1/2021,PHL,Negeri Sembilan,0,0,0,Philippines
28438,5/1/2021,PHL,Pahang,1,1,0,Philippines
28439,5/1/2021,PHL,Perak,0,0,0,Philippines
28440,5/1/2021,PHL,Perlis,0,0,0,Philippines
28441,5/1/2021,PHL,Pulau Pinang,2,1,1,Philippines
28442,5/1/2021,PHL,Sabah,2,1,1,Philippines
28443,5/1/2021,PHL,Sarawak,47,46,1,Philippines
28444,5/1/2021,PHL,Selangor,775,647,128,Philippines
28445,5/1/2021,PHL,Terengganu,0,0,0,Philippines
28446,5/1/2021,PHL,W.P. Labuan,7,7,0,Philippines
28447,5/1/2021,PLW,Johor,0,0,0,Palau
28448,5/1/2021,PLW,Pulau Pinang,0,0,0,Palau
28449,5/1/2021,PLW,Selangor,0,0,0,Palau
28450,5/1/2021,PNG,Johor,0,0,0,Papua New Guinea
28451,5/1/2021,PNG,Kedah,0,0,0,Papua New Guinea
28452,5/1/2021,PNG,Kelantan,0,0,0,Papua New Guinea
28453,5/1/2021,PNG,Perak,0,0,0,Papua New Guinea
28454,5/1/2021,PNG,Pulau Pinang,0,0,0,Papua New Guinea
28455,5/1/2021,PNG,Sabah,0,0,0,Papua New Guinea
28456,5/1/2021,PNG,Sarawak,0,0,0,Papua New Guinea
28457,5/1/2021,PNG,Selangor,1,1,0,Papua New Guinea
28458,5/1/2021,POL,Johor,0,0,0,Poland
28459,5/1/2021,POL,Kedah,0,0,0,Poland
28460,5/1/2021,POL,Kelantan,0,0,0,Poland
28461,5/1/2021,POL,Melaka,0,0,0,Poland
28462,5/1/2021,POL,Negeri Sembilan,0,0,0,Poland
28463,5/1/2021,POL,Pahang,0,0,0,Poland
28464,5/1/2021,POL,Perak,0,0,0,Poland
28465,5/1/2021,POL,Perlis,0,0,0,Poland
28466,5/1/2021,POL,Pulau Pinang,0,0,0,Poland
28467,5/1/2021,POL,Sabah,0,0,0,Poland
28468,5/1/2021,POL,Sarawak,0,0,0,Poland
28469,5/1/2021,POL,Selangor,38,32,6,Poland
28470,5/1/2021,POL,Terengganu,0,0,0,Poland
28471,5/1/2021,POL,W.P. Labuan,0,0,0,Poland
28472,5/1/2021,PRK,Selangor,0,0,0,"Korea, Democratic People's Republic of"
28473,5/1/2021,PRT,Johor,0,0,0,Portugal
28474,5/1/2021,PRT,Kedah,0,0,0,Portugal
28475,5/1/2021,PRT,Kelantan,0,0,0,Portugal
28476,5/1/2021,PRT,Melaka,0,0,0,Portugal
28477,5/1/2021,PRT,Pahang,0,0,0,Portugal
28478,5/1/2021,PRT,Perak,0,0,0,Portugal
28479,5/1/2021,PRT,Perlis,0,0,0,Portugal
28480,5/1/2021,PRT,Pulau Pinang,0,0,0,Portugal
28481,5/1/2021,PRT,Sabah,0,0,0,Portugal
28482,5/1/2021,PRT,Sarawak,0,0,0,Portugal
28483,5/1/2021,PRT,Selangor,8,5,3,Portugal
28484,5/1/2021,PRT,W.P. Labuan,0,0,0,Portugal
28485,5/1/2021,PRY,Johor,0,0,0,Paraguay
28486,5/1/2021,PRY,Kedah,0,0,0,Paraguay
28487,5/1/2021,PRY,Perak,0,0,0,Paraguay
28488,5/1/2021,PRY,Perlis,0,0,0,Paraguay
28489,5/1/2021,PRY,Pulau Pinang,0,0,0,Paraguay
28490,5/1/2021,PRY,Sabah,0,0,0,Paraguay
28491,5/1/2021,PRY,Sarawak,0,0,0,Paraguay
28492,5/1/2021,PRY,Selangor,0,0,0,Paraguay
28493,5/1/2021,PSE,Johor,0,0,0,"Palestinian Territory, Occupied"
28494,5/1/2021,PSE,Kedah,0,0,0,"Palestinian Territory, Occupied"
28495,5/1/2021,PSE,Kelantan,0,0,0,"Palestinian Territory, Occupied"
28496,5/1/2021,PSE,Melaka,0,0,0,"Palestinian Territory, Occupied"
28497,5/1/2021,PSE,Perak,0,0,0,"Palestinian Territory, Occupied"
28498,5/1/2021,PSE,Perlis,0,0,0,"Palestinian Territory, Occupied"
28499,5/1/2021,PSE,Pulau Pinang,0,0,0,"Palestinian Territory, Occupied"
28500,5/1/2021,PSE,Sabah,0,0,0,"Palestinian Territory, Occupied"
28501,5/1/2021,PSE,Sarawak,0,0,0,"Palestinian Territory, Occupied"
28502,5/1/2021,PSE,Selangor,18,15,3,"Palestinian Territory, Occupied"
28503,5/1/2021,QAT,Johor,0,0,0,Qatar
28504,5/1/2021,QAT,Kedah,0,0,0,Qatar
28505,5/1/2021,QAT,Perlis,0,0,0,Qatar
28506,5/1/2021,QAT,Pulau Pinang,0,0,0,Qatar
28507,5/1/2021,QAT,Sabah,0,0,0,Qatar
28508,5/1/2021,QAT,Sarawak,0,0,0,Qatar
28509,5/1/2021,QAT,Selangor,3,3,0,Qatar
28510,5/1/2021,REU,Johor,0,0,0,Reunion
28511,5/1/2021,REU,Sarawak,0,0,0,Reunion
28512,5/1/2021,ROU,Johor,0,0,0,Romania
28513,5/1/2021,ROU,Kedah,0,0,0,Romania
28514,5/1/2021,ROU,Kelantan,0,0,0,Romania
28515,5/1/2021,ROU,Negeri Sembilan,0,0,0,Romania
28516,5/1/2021,ROU,Pahang,0,0,0,Romania
28517,5/1/2021,ROU,Perak,0,0,0,Romania
28518,5/1/2021,ROU,Perlis,0,0,0,Romania
28519,5/1/2021,ROU,Pulau Pinang,0,0,0,Romania
28520,5/1/2021,ROU,Sabah,0,0,0,Romania
28521,5/1/2021,ROU,Sarawak,0,0,0,Romania
28522,5/1/2021,ROU,Selangor,36,30,6,Romania
28523,5/1/2021,ROU,W.P. Labuan,0,0,0,Romania
28524,5/1/2021,RUS,Johor,3,3,0,Russia
28525,5/1/2021,RUS,Kedah,0,0,0,Russia
28526,5/1/2021,RUS,Kelantan,0,0,0,Russia
28527,5/1/2021,RUS,Melaka,0,0,0,Russia
28528,5/1/2021,RUS,Negeri Sembilan,0,0,0,Russia
28529,5/1/2021,RUS,Pahang,0,0,0,Russia
28530,5/1/2021,RUS,Perak,0,0,0,Russia
28531,5/1/2021,RUS,Perlis,0,0,0,Russia
28532,5/1/2021,RUS,Pulau Pinang,0,0,0,Russia
28533,5/1/2021,RUS,Sabah,0,0,0,Russia
28534,5/1/2021,RUS,Sarawak,0,0,0,Russia
28535,5/1/2021,RUS,Selangor,64,55,9,Russia
28536,5/1/2021,RUS,W.P. Labuan,0,0,0,Russia
28537,5/1/2021,RWA,Johor,0,0,0,Rwanda
28538,5/1/2021,RWA,Kedah,0,0,0,Rwanda
28539,5/1/2021,RWA,Pulau Pinang,0,0,0,Rwanda
28540,5/1/2021,RWA,Selangor,2,1,1,Rwanda
28541,5/1/2021,SAU,Johor,0,0,0,Saudi Arabia
28542,5/1/2021,SAU,Kedah,0,0,0,Saudi Arabia
28543,5/1/2021,SAU,Kelantan,0,0,0,Saudi Arabia
28544,5/1/2021,SAU,Melaka,0,0,0,Saudi Arabia
28545,5/1/2021,SAU,Perak,0,0,0,Saudi Arabia
28546,5/1/2021,SAU,Perlis,0,0,0,Saudi Arabia
28547,5/1/2021,SAU,Pulau Pinang,0,0,0,Saudi Arabia
28548,5/1/2021,SAU,Sabah,0,0,0,Saudi Arabia
28549,5/1/2021,SAU,Sarawak,0,0,0,Saudi Arabia
28550,5/1/2021,SAU,Selangor,61,46,15,Saudi Arabia
28551,5/1/2021,SAU,W.P. Labuan,0,0,0,Saudi Arabia
28552,5/1/2021,SDN,Johor,0,0,0,Sudan
28553,5/1/2021,SDN,Kedah,0,0,0,Sudan
28554,5/1/2021,SDN,Kelantan,0,0,0,Sudan
28555,5/1/2021,SDN,Perlis,0,0,0,Sudan
28556,5/1/2021,SDN,Pulau Pinang,0,0,0,Sudan
28557,5/1/2021,SDN,Sabah,0,0,0,Sudan
28558,5/1/2021,SDN,Sarawak,0,0,0,Sudan
28559,5/1/2021,SDN,Selangor,47,36,11,Sudan
28560,5/1/2021,SDN,W.P. Labuan,0,0,0,Sudan
28561,5/1/2021,SEN,Johor,0,0,0,Senegal
28562,5/1/2021,SEN,Kedah,0,0,0,Senegal
28563,5/1/2021,SEN,Kelantan,0,0,0,Senegal
28564,5/1/2021,SEN,Perak,0,0,0,Senegal
28565,5/1/2021,SEN,Perlis,0,0,0,Senegal
28566,5/1/2021,SEN,Pulau Pinang,0,0,0,Senegal
28567,5/1/2021,SEN,Sabah,0,0,0,Senegal
28568,5/1/2021,SEN,Sarawak,0,0,0,Senegal
28569,5/1/2021,SEN,Selangor,2,1,1,Senegal
28570,5/1/2021,SGP,Johor,139,129,10,Singapore
28571,5/1/2021,SGP,Kedah,1,1,0,Singapore
28572,5/1/2021,SGP,Kelantan,0,0,0,Singapore
28573,5/1/2021,SGP,Melaka,0,0,0,Singapore
28574,5/1/2021,SGP,Negeri Sembilan,0,0,0,Singapore
28575,5/1/2021,SGP,Pahang,2,2,0,Singapore
28576,5/1/2021,SGP,Perak,7,2,5,Singapore
28577,5/1/2021,SGP,Perlis,0,0,0,Singapore
28578,5/1/2021,SGP,Pulau Pinang,13,10,3,Singapore
28579,5/1/2021,SGP,Sabah,1,1,0,Singapore
28580,5/1/2021,SGP,Sarawak,7,5,2,Singapore
28581,5/1/2021,SGP,Selangor,103,71,32,Singapore
28582,5/1/2021,SGP,Terengganu,0,0,0,Singapore
28583,5/1/2021,SGP,W.P. Labuan,0,0,0,Singapore
28584,5/1/2021,SGS,Johor,0,0,0,South Georgia and the South Sandwich Islands
28585,5/1/2021,SGS,Sabah,0,0,0,South Georgia and the South Sandwich Islands
28586,5/1/2021,SGS,Selangor,0,0,0,South Georgia and the South Sandwich Islands
28587,5/1/2021,SHN,Sarawak,0,0,0,"Saint Helena, Ascension and Tristan da Cunha"
28588,5/1/2021,SLB,Johor,0,0,0,Solomon Islands
28589,5/1/2021,SLB,Perlis,0,0,0,Solomon Islands
28590,5/1/2021,SLB,Pulau Pinang,0,0,0,Solomon Islands
28591,5/1/2021,SLB,Sabah,0,0,0,Solomon Islands
28592,5/1/2021,SLB,Sarawak,0,0,0,Solomon Islands
28593,5/1/2021,SLB,Selangor,0,0,0,Solomon Islands
28594,5/1/2021,SLB,W.P. Labuan,0,0,0,Solomon Islands
28595,5/1/2021,SLE,Johor,0,0,0,Sierra Leone
28596,5/1/2021,SLE,Kedah,0,0,0,Sierra Leone
28597,5/1/2021,SLE,Perak,0,0,0,Sierra Leone
28598,5/1/2021,SLE,Pulau Pinang,0,0,0,Sierra Leone
28599,5/1/2021,SLE,Sabah,0,0,0,Sierra Leone
28600,5/1/2021,SLE,Selangor,3,3,0,Sierra Leone
28601,5/1/2021,SLV,Johor,0,0,0,El Salvador
28602,5/1/2021,SLV,Kedah,0,0,0,El Salvador
28603,5/1/2021,SLV,Perak,0,0,0,El Salvador
28604,5/1/2021,SLV,Perlis,0,0,0,El Salvador
28605,5/1/2021,SLV,Pulau Pinang,0,0,0,El Salvador
28606,5/1/2021,SLV,Sabah,0,0,0,El Salvador
28607,5/1/2021,SLV,Selangor,0,0,0,El Salvador
28608,5/1/2021,SLV,W.P. Labuan,0,0,0,El Salvador
28609,5/1/2021,SMR,Johor,0,0,0,San Marino
28610,5/1/2021,SMR,Selangor,0,0,0,San Marino
28611,5/1/2021,SOM,Johor,0,0,0,Somalia
28612,5/1/2021,SOM,Kedah,0,0,0,Somalia
28613,5/1/2021,SOM,Kelantan,0,0,0,Somalia
28614,5/1/2021,SOM,Perlis,0,0,0,Somalia
28615,5/1/2021,SOM,Sabah,0,0,0,Somalia
28616,5/1/2021,SOM,Sarawak,0,0,0,Somalia
28617,5/1/2021,SOM,Selangor,16,11,5,Somalia
28618,5/1/2021,SRB,Johor,0,0,0,Serbia
28619,5/1/2021,SRB,Kedah,0,0,0,Serbia
28620,5/1/2021,SRB,Kelantan,0,0,0,Serbia
28621,5/1/2021,SRB,Pahang,0,0,0,Serbia
28622,5/1/2021,SRB,Perak,0,0,0,Serbia
28623,5/1/2021,SRB,Perlis,0,0,0,Serbia
28624,5/1/2021,SRB,Pulau Pinang,0,0,0,Serbia
28625,5/1/2021,SRB,Sabah,0,0,0,Serbia
28626,5/1/2021,SRB,Sarawak,0,0,0,Serbia
28627,5/1/2021,SRB,Selangor,4,4,0,Serbia
28628,5/1/2021,STP,Selangor,0,0,0,Sao Tome and Principe
28629,5/1/2021,SUR,Johor,0,0,0,Suriname
28630,5/1/2021,SUR,Kedah,0,0,0,Suriname
28631,5/1/2021,SUR,Kelantan,0,0,0,Suriname
28632,5/1/2021,SUR,Perak,0,0,0,Suriname
28633,5/1/2021,SUR,Perlis,0,0,0,Suriname
28634,5/1/2021,SUR,Pulau Pinang,0,0,0,Suriname
28635,5/1/2021,SUR,Sabah,0,0,0,Suriname
28636,5/1/2021,SUR,Sarawak,0,0,0,Suriname
28637,5/1/2021,SUR,Selangor,0,0,0,Suriname
28638,5/1/2021,SVK,Johor,0,0,0,Slovakia
28639,5/1/2021,SVK,Kedah,0,0,0,Slovakia
28640,5/1/2021,SVK,Kelantan,0,0,0,Slovakia
28641,5/1/2021,SVK,Negeri Sembilan,0,0,0,Slovakia
28642,5/1/2021,SVK,Pahang,0,0,0,Slovakia
28643,5/1/2021,SVK,Perak,0,0,0,Slovakia
28644,5/1/2021,SVK,Perlis,0,0,0,Slovakia
28645,5/1/2021,SVK,Pulau Pinang,0,0,0,Slovakia
28646,5/1/2021,SVK,Sabah,0,0,0,Slovakia
28647,5/1/2021,SVK,Sarawak,0,0,0,Slovakia
28648,5/1/2021,SVK,Selangor,7,5,2,Slovakia
28649,5/1/2021,SVK,W.P. Labuan,0,0,0,Slovakia
28650,5/1/2021,SVN,Johor,0,0,0,Slovenia
28651,5/1/2021,SVN,Kedah,0,0,0,Slovenia
28652,5/1/2021,SVN,Kelantan,0,0,0,Slovenia
28653,5/1/2021,SVN,Perak,0,0,0,Slovenia
28654,5/1/2021,SVN,Perlis,0,0,0,Slovenia
28655,5/1/2021,SVN,Pulau Pinang,0,0,0,Slovenia
28656,5/1/2021,SVN,Sabah,0,0,0,Slovenia
28657,5/1/2021,SVN,Sarawak,1,1,0,Slovenia
28658,5/1/2021,SVN,Selangor,1,1,0,Slovenia
28659,5/1/2021,SVN,W.P. Labuan,0,0,0,Slovenia
28660,5/1/2021,SWE,Johor,0,0,0,Sweden
28661,5/1/2021,SWE,Kedah,0,0,0,Sweden
28662,5/1/2021,SWE,Kelantan,0,0,0,Sweden
28663,5/1/2021,SWE,Melaka,0,0,0,Sweden
28664,5/1/2021,SWE,Negeri Sembilan,0,0,0,Sweden
28665,5/1/2021,SWE,Pahang,0,0,0,Sweden
28666,5/1/2021,SWE,Perak,0,0,0,Sweden
28667,5/1/2021,SWE,Perlis,0,0,0,Sweden
28668,5/1/2021,SWE,Pulau Pinang,0,0,0,Sweden
28669,5/1/2021,SWE,Sabah,1,0,1,Sweden
28670,5/1/2021,SWE,Sarawak,0,0,0,Sweden
28671,5/1/2021,SWE,Selangor,38,33,5,Sweden
28672,5/1/2021,SWE,W.P. Labuan,0,0,0,Sweden
28673,5/1/2021,SWZ,Johor,0,0,0,Swaziland
28674,5/1/2021,SWZ,Kedah,0,0,0,Swaziland
28675,5/1/2021,SWZ,Pulau Pinang,0,0,0,Swaziland
28676,5/1/2021,SWZ,Sabah,0,0,0,Swaziland
28677,5/1/2021,SWZ,Selangor,0,0,0,Swaziland
28678,5/1/2021,SYC,Johor,0,0,0,Seychelles
28679,5/1/2021,SYC,Kedah,0,0,0,Seychelles
28680,5/1/2021,SYC,Pulau Pinang,0,0,0,Seychelles
28681,5/1/2021,SYC,Sabah,0,0,0,Seychelles
28682,5/1/2021,SYC,Sarawak,0,0,0,Seychelles
28683,5/1/2021,SYC,Selangor,12,6,6,Seychelles
28684,5/1/2021,SYR,Johor,0,0,0,Syrian Arab Republic
28685,5/1/2021,SYR,Kedah,0,0,0,Syrian Arab Republic
28686,5/1/2021,SYR,Kelantan,0,0,0,Syrian Arab Republic
28687,5/1/2021,SYR,Pahang,0,0,0,Syrian Arab Republic
28688,5/1/2021,SYR,Perlis,0,0,0,Syrian Arab Republic
28689,5/1/2021,SYR,Pulau Pinang,0,0,0,Syrian Arab Republic
28690,5/1/2021,SYR,Sabah,0,0,0,Syrian Arab Republic
28691,5/1/2021,SYR,Sarawak,0,0,0,Syrian Arab Republic
28692,5/1/2021,SYR,Selangor,29,19,10,Syrian Arab Republic
28693,5/1/2021,SYR,W.P. Labuan,0,0,0,Syrian Arab Republic
28694,5/1/2021,TCA,Perlis,0,0,0,Turks and Caicos
28695,5/1/2021,TCD,Johor,0,0,0,Chad
28696,5/1/2021,TCD,Kedah,0,0,0,Chad
28697,5/1/2021,TCD,Perlis,0,0,0,Chad
28698,5/1/2021,TCD,Selangor,3,3,0,Chad
28699,5/1/2021,TGO,Johor,0,0,0,Togo
28700,5/1/2021,TGO,Perak,0,0,0,Togo
28701,5/1/2021,TGO,Pulau Pinang,0,0,0,Togo
28702,5/1/2021,TGO,Selangor,1,1,0,Togo
28703,5/1/2021,THA,Johor,6,6,0,Thailand
28704,5/1/2021,THA,Kedah,18417,18374,43,Thailand
28705,5/1/2021,THA,Kelantan,1,1,0,Thailand
28706,5/1/2021,THA,Melaka,0,0,0,Thailand
28707,5/1/2021,THA,Negeri Sembilan,0,0,0,Thailand
28708,5/1/2021,THA,Pahang,0,0,0,Thailand
28709,5/1/2021,THA,Perak,1,0,1,Thailand
28710,5/1/2021,THA,Perlis,8612,8377,235,Thailand
28711,5/1/2021,THA,Pulau Pinang,37,32,5,Thailand
28712,5/1/2021,THA,Sabah,0,0,0,Thailand
28713,5/1/2021,THA,Sarawak,12,11,1,Thailand
28714,5/1/2021,THA,Selangor,211,93,118,Thailand
28715,5/1/2021,THA,Terengganu,0,0,0,Thailand
28716,5/1/2021,THA,W.P. Labuan,1,0,1,Thailand
28717,5/1/2021,TJK,Johor,0,0,0,Tajikistan
28718,5/1/2021,TJK,Kedah,0,0,0,Tajikistan
28719,5/1/2021,TJK,Perlis,0,0,0,Tajikistan
28720,5/1/2021,TJK,Pulau Pinang,0,0,0,Tajikistan
28721,5/1/2021,TJK,Sabah,0,0,0,Tajikistan
28722,5/1/2021,TJK,Selangor,0,0,0,Tajikistan
28723,5/1/2021,TKL,Selangor,0,0,0,Tokelau
28724,5/1/2021,TKM,Johor,0,0,0,Turkmenistan
28725,5/1/2021,TKM,Kedah,0,0,0,Turkmenistan
28726,5/1/2021,TKM,Kelantan,0,0,0,Turkmenistan
28727,5/1/2021,TKM,Perlis,0,0,0,Turkmenistan
28728,5/1/2021,TKM,Pulau Pinang,0,0,0,Turkmenistan
28729,5/1/2021,TKM,Sabah,0,0,0,Turkmenistan
28730,5/1/2021,TKM,Sarawak,0,0,0,Turkmenistan
28731,5/1/2021,TKM,Selangor,0,0,0,Turkmenistan
28732,5/1/2021,TLS,Johor,0,0,0,Timor-Leste
28733,5/1/2021,TLS,Kedah,0,0,0,Timor-Leste
28734,5/1/2021,TLS,Perlis,0,0,0,Timor-Leste
28735,5/1/2021,TLS,Pulau Pinang,0,0,0,Timor-Leste
28736,5/1/2021,TLS,Sabah,0,0,0,Timor-Leste
28737,5/1/2021,TLS,Sarawak,0,0,0,Timor-Leste
28738,5/1/2021,TLS,Selangor,1,1,0,Timor-Leste
28739,5/1/2021,TON,Johor,0,0,0,Tonga
28740,5/1/2021,TON,Pulau Pinang,0,0,0,Tonga
28741,5/1/2021,TON,Sarawak,0,0,0,Tonga
28742,5/1/2021,TON,Selangor,0,0,0,Tonga
28743,5/1/2021,TTO,Johor,0,0,0,Trinidad and Tobago
28744,5/1/2021,TTO,Kedah,0,0,0,Trinidad and Tobago
28745,5/1/2021,TTO,Pahang,0,0,0,Trinidad and Tobago
28746,5/1/2021,TTO,Pulau Pinang,0,0,0,Trinidad and Tobago
28747,5/1/2021,TTO,Sabah,0,0,0,Trinidad and Tobago
28748,5/1/2021,TTO,Sarawak,0,0,0,Trinidad and Tobago
28749,5/1/2021,TTO,Selangor,1,1,0,Trinidad and Tobago
28750,5/1/2021,TUN,Johor,0,0,0,Tunisia
28751,5/1/2021,TUN,Kedah,0,0,0,Tunisia
28752,5/1/2021,TUN,Kelantan,0,0,0,Tunisia
28753,5/1/2021,TUN,Melaka,0,0,0,Tunisia
28754,5/1/2021,TUN,Perak,0,0,0,Tunisia
28755,5/1/2021,TUN,Perlis,0,0,0,Tunisia
28756,5/1/2021,TUN,Pulau Pinang,0,0,0,Tunisia
28757,5/1/2021,TUN,Sabah,0,0,0,Tunisia
28758,5/1/2021,TUN,Sarawak,0,0,0,Tunisia
28759,5/1/2021,TUN,Selangor,9,7,2,Tunisia
28760,5/1/2021,TUN,W.P. Labuan,0,0,0,Tunisia
28761,5/1/2021,TUR,Johor,0,0,0,Turkey
28762,5/1/2021,TUR,Kedah,0,0,0,Turkey
28763,5/1/2021,TUR,Kelantan,0,0,0,Turkey
28764,5/1/2021,TUR,Melaka,0,0,0,Turkey
28765,5/1/2021,TUR,Negeri Sembilan,0,0,0,Turkey
28766,5/1/2021,TUR,Pahang,0,0,0,Turkey
28767,5/1/2021,TUR,Perak,0,0,0,Turkey
28768,5/1/2021,TUR,Perlis,0,0,0,Turkey
28769,5/1/2021,TUR,Pulau Pinang,0,0,0,Turkey
28770,5/1/2021,TUR,Sabah,0,0,0,Turkey
28771,5/1/2021,TUR,Sarawak,0,0,0,Turkey
28772,5/1/2021,TUR,Selangor,15,13,2,Turkey
28773,5/1/2021,TUR,W.P. Labuan,0,0,0,Turkey
28774,5/1/2021,TUV,Selangor,0,0,0,Tuvalu
28775,5/1/2021,TWN,Johor,1,0,1,Taiwan
28776,5/1/2021,TWN,Kedah,0,0,0,Taiwan
28777,5/1/2021,TWN,Kelantan,0,0,0,Taiwan
28778,5/1/2021,TWN,Melaka,0,0,0,Taiwan
28779,5/1/2021,TWN,Negeri Sembilan,0,0,0,Taiwan
28780,5/1/2021,TWN,Pahang,0,0,0,Taiwan
28781,5/1/2021,TWN,Perak,0,0,0,Taiwan
28782,5/1/2021,TWN,Perlis,0,0,0,Taiwan
28783,5/1/2021,TWN,Pulau Pinang,10,8,2,Taiwan
28784,5/1/2021,TWN,Sabah,0,0,0,Taiwan
28785,5/1/2021,TWN,Sarawak,0,0,0,Taiwan
28786,5/1/2021,TWN,Selangor,66,48,18,Taiwan
28787,5/1/2021,TWN,W.P. Labuan,0,0,0,Taiwan
28788,5/1/2021,TZA,Johor,0,0,0,"Tanzania, United Republic of"
28789,5/1/2021,TZA,Kedah,0,0,0,"Tanzania, United Republic of"
28790,5/1/2021,TZA,Perak,0,0,0,"Tanzania, United Republic of"
28791,5/1/2021,TZA,Perlis,0,0,0,"Tanzania, United Republic of"
28792,5/1/2021,TZA,Pulau Pinang,0,0,0,"Tanzania, United Republic of"
28793,5/1/2021,TZA,Sabah,0,0,0,"Tanzania, United Republic of"
28794,5/1/2021,TZA,Sarawak,0,0,0,"Tanzania, United Republic of"
28795,5/1/2021,TZA,Selangor,16,8,8,"Tanzania, United Republic of"
28796,5/1/2021,UGA,Johor,0,0,0,Uganda
28797,5/1/2021,UGA,Kedah,0,0,0,Uganda
28798,5/1/2021,UGA,Perak,0,0,0,Uganda
28799,5/1/2021,UGA,Perlis,0,0,0,Uganda
28800,5/1/2021,UGA,Pulau Pinang,0,0,0,Uganda
28801,5/1/2021,UGA,Sabah,0,0,0,Uganda
28802,5/1/2021,UGA,Sarawak,0,0,0,Uganda
28803,5/1/2021,UGA,Selangor,4,1,3,Uganda
28804,5/1/2021,UKR,Johor,2,2,0,Ukraine
28805,5/1/2021,UKR,Kedah,0,0,0,Ukraine
28806,5/1/2021,UKR,Kelantan,0,0,0,Ukraine
28807,5/1/2021,UKR,Melaka,0,0,0,Ukraine
28808,5/1/2021,UKR,Negeri Sembilan,0,0,0,Ukraine
28809,5/1/2021,UKR,Pahang,0,0,0,Ukraine
28810,5/1/2021,UKR,Perak,0,0,0,Ukraine
28811,5/1/2021,UKR,Perlis,0,0,0,Ukraine
28812,5/1/2021,UKR,Pulau Pinang,0,0,0,Ukraine
28813,5/1/2021,UKR,Sabah,0,0,0,Ukraine
28814,5/1/2021,UKR,Sarawak,0,0,0,Ukraine
28815,5/1/2021,UKR,Selangor,61,57,4,Ukraine
28816,5/1/2021,UKR,W.P. Labuan,0,0,0,Ukraine
28817,5/1/2021,URY,Johor,0,0,0,Uruguay
28818,5/1/2021,URY,Kedah,0,0,0,Uruguay
28819,5/1/2021,URY,Kelantan,0,0,0,Uruguay
28820,5/1/2021,URY,Perak,0,0,0,Uruguay
28821,5/1/2021,URY,Perlis,0,0,0,Uruguay
28822,5/1/2021,URY,Pulau Pinang,0,0,0,Uruguay
28823,5/1/2021,URY,Sabah,0,0,0,Uruguay
28824,5/1/2021,URY,Sarawak,0,0,0,Uruguay
28825,5/1/2021,URY,Selangor,0,0,0,Uruguay
28826,5/1/2021,URY,W.P. Labuan,0,0,0,Uruguay
28827,5/1/2021,USA,Johor,0,0,0,United States Of America
28828,5/1/2021,USA,Kedah,0,0,0,United States Of America
28829,5/1/2021,USA,Kelantan,0,0,0,United States Of America
28830,5/1/2021,USA,Melaka,0,0,0,United States Of America
28831,5/1/2021,USA,Negeri Sembilan,0,0,0,United States Of America
28832,5/1/2021,USA,Pahang,0,0,0,United States Of America
28833,5/1/2021,USA,Perak,0,0,0,United States Of America
28834,5/1/2021,USA,Perlis,0,0,0,United States Of America
28835,5/1/2021,USA,Pulau Pinang,6,4,2,United States Of America
28836,5/1/2021,USA,Sabah,0,0,0,United States Of America
28837,5/1/2021,USA,Sarawak,1,1,0,United States Of America
28838,5/1/2021,USA,Selangor,152,103,49,United States Of America
28839,5/1/2021,USA,Terengganu,0,0,0,United States Of America
28840,5/1/2021,USA,W.P. Labuan,0,0,0,United States Of America
28841,5/1/2021,UZB,Johor,0,0,0,Uzbekistan
28842,5/1/2021,UZB,Kedah,0,0,0,Uzbekistan
28843,5/1/2021,UZB,Kelantan,0,0,0,Uzbekistan
28844,5/1/2021,UZB,Perak,0,0,0,Uzbekistan
28845,5/1/2021,UZB,Perlis,0,0,0,Uzbekistan
28846,5/1/2021,UZB,Pulau Pinang,0,0,0,Uzbekistan
28847,5/1/2021,UZB,Sabah,0,0,0,Uzbekistan
28848,5/1/2021,UZB,Sarawak,0,0,0,Uzbekistan
28849,5/1/2021,UZB,Selangor,15,14,1,Uzbekistan
28850,5/1/2021,VAT,Johor,0,0,0,Holy See (Vatican City State)
28851,5/1/2021,VAT,Sarawak,0,0,0,Holy See (Vatican City State)
28852,5/1/2021,VAT,Selangor,0,0,0,Holy See (Vatican City State)
28853,5/1/2021,VCT,Johor,0,0,0,Saint Vincent and the Grenadines
28854,5/1/2021,VCT,Kedah,0,0,0,Saint Vincent and the Grenadines
28855,5/1/2021,VCT,Pulau Pinang,0,0,0,Saint Vincent and the Grenadines
28856,5/1/2021,VCT,Sarawak,0,0,0,Saint Vincent and the Grenadines
28857,5/1/2021,VCT,Selangor,0,0,0,Saint Vincent and the Grenadines
28858,5/1/2021,VEN,Johor,0,0,0,Venezuela
28859,5/1/2021,VEN,Kedah,0,0,0,Venezuela
28860,5/1/2021,VEN,Kelantan,0,0,0,Venezuela
28861,5/1/2021,VEN,Melaka,0,0,0,Venezuela
28862,5/1/2021,VEN,Perak,0,0,0,Venezuela
28863,5/1/2021,VEN,Perlis,0,0,0,Venezuela
28864,5/1/2021,VEN,Pulau Pinang,0,0,0,Venezuela
28865,5/1/2021,VEN,Sabah,0,0,0,Venezuela
28866,5/1/2021,VEN,Sarawak,0,0,0,Venezuela
28867,5/1/2021,VEN,Selangor,4,4,0,Venezuela
28868,5/1/2021,VEN,W.P. Labuan,0,0,0,Venezuela
28869,5/1/2021,VNM,Johor,0,0,0,Vietnam
28870,5/1/2021,VNM,Kedah,0,0,0,Vietnam
28871,5/1/2021,VNM,Kelantan,0,0,0,Vietnam
28872,5/1/2021,VNM,Melaka,0,0,0,Vietnam
28873,5/1/2021,VNM,Negeri Sembilan,0,0,0,Vietnam
28874,5/1/2021,VNM,Pahang,0,0,0,Vietnam
28875,5/1/2021,VNM,Perak,0,0,0,Vietnam
28876,5/1/2021,VNM,Perlis,0,0,0,Vietnam
28877,5/1/2021,VNM,Pulau Pinang,2,1,1,Vietnam
28878,5/1/2021,VNM,Sabah,0,0,0,Vietnam
28879,5/1/2021,VNM,Sarawak,0,0,0,Vietnam
28880,5/1/2021,VNM,Selangor,107,43,64,Vietnam
28881,5/1/2021,VNM,Terengganu,0,0,0,Vietnam
28882,5/1/2021,VNM,W.P. Labuan,0,0,0,Vietnam
28883,5/1/2021,VUT,Johor,0,0,0,Vanuatu
28884,5/1/2021,VUT,Kedah,0,0,0,Vanuatu
28885,5/1/2021,VUT,Pulau Pinang,0,0,0,Vanuatu
28886,5/1/2021,VUT,Sabah,0,0,0,Vanuatu
28887,5/1/2021,VUT,Sarawak,0,0,0,Vanuatu
28888,5/1/2021,VUT,Selangor,0,0,0,Vanuatu
28889,5/1/2021,WSM,Johor,0,0,0,Samoa
28890,5/1/2021,WSM,Sarawak,0,0,0,Samoa
28891,5/1/2021,WSM,Selangor,0,0,0,Samoa
28892,5/1/2021,YEM,Johor,0,0,0,Yemen
28893,5/1/2021,YEM,Kedah,0,0,0,Yemen
28894,5/1/2021,YEM,Kelantan,0,0,0,Yemen
28895,5/1/2021,YEM,Melaka,0,0,0,Yemen
28896,5/1/2021,YEM,Pahang,0,0,0,Yemen
28897,5/1/2021,YEM,Perak,0,0,0,Yemen
28898,5/1/2021,YEM,Perlis,0,0,0,Yemen
28899,5/1/2021,YEM,Pulau Pinang,0,0,0,Yemen
28900,5/1/2021,YEM,Sabah,0,0,0,Yemen
28901,5/1/2021,YEM,Sarawak,0,0,0,Yemen
28902,5/1/2021,YEM,Selangor,52,38,14,Yemen
28903,5/1/2021,YEM,W.P. Labuan,0,0,0,Yemen
28904,5/1/2021,ZAF,Johor,0,0,0,South Africa
28905,5/1/2021,ZAF,Kedah,0,0,0,South Africa
28906,5/1/2021,ZAF,Kelantan,0,0,0,South Africa
28907,5/1/2021,ZAF,Melaka,0,0,0,South Africa
28908,5/1/2021,ZAF,Pahang,0,0,0,South Africa
28909,5/1/2021,ZAF,Perak,0,0,0,South Africa
28910,5/1/2021,ZAF,Perlis,0,0,0,South Africa
28911,5/1/2021,ZAF,Pulau Pinang,0,0,0,South Africa
28912,5/1/2021,ZAF,Sabah,0,0,0,South Africa
28913,5/1/2021,ZAF,Sarawak,0,0,0,South Africa
28914,5/1/2021,ZAF,Selangor,33,25,8,South Africa
28915,5/1/2021,ZAF,Terengganu,0,0,0,South Africa
28916,5/1/2021,ZAF,W.P. Labuan,0,0,0,South Africa
28917,5/1/2021,ZMB,Johor,0,0,0,Zambia
28918,5/1/2021,ZMB,Kedah,0,0,0,Zambia
28919,5/1/2021,ZMB,Perak,0,0,0,Zambia
28920,5/1/2021,ZMB,Perlis,0,0,0,Zambia
28921,5/1/2021,ZMB,Pulau Pinang,0,0,0,Zambia
28922,5/1/2021,ZMB,Sabah,0,0,0,Zambia
28923,5/1/2021,ZMB,Sarawak,0,0,0,Zambia
28924,5/1/2021,ZMB,Selangor,11,4,7,Zambia
28925,5/1/2021,ZWE,Johor,0,0,0,Zimbabwe
28926,5/1/2021,ZWE,Kedah,0,0,0,Zimbabwe
28927,5/1/2021,ZWE,Kelantan,0,0,0,Zimbabwe
28928,5/1/2021,ZWE,Perak,0,0,0,Zimbabwe
28929,5/1/2021,ZWE,Perlis,0,0,0,Zimbabwe
28930,5/1/2021,ZWE,Pulau Pinang,0,0,0,Zimbabwe
28931,5/1/2021,ZWE,Sabah,0,0,0,Zimbabwe
28932,5/1/2021,ZWE,Sarawak,0,0,0,Zimbabwe
28933,5/1/2021,ZWE,Selangor,11,8,3,Zimbabwe
28934,6/1/2021,ABW,Kedah,0,0,0,Aruba
28935,6/1/2021,ABW,Pulau Pinang,0,0,0,Aruba
28936,6/1/2021,AFG,Johor,0,0,0,Afghanistan
28937,6/1/2021,AFG,Kedah,0,0,0,Afghanistan
28938,6/1/2021,AFG,Perlis,0,0,0,Afghanistan
28939,6/1/2021,AFG,Pulau Pinang,0,0,0,Afghanistan
28940,6/1/2021,AFG,Sarawak,0,0,0,Afghanistan
28941,6/1/2021,AFG,Selangor,6,3,3,Afghanistan
28942,6/1/2021,AGO,Johor,0,0,0,Angola
28943,6/1/2021,AGO,Kedah,0,0,0,Angola
28944,6/1/2021,AGO,Sabah,0,0,0,Angola
28945,6/1/2021,AGO,Selangor,0,0,0,Angola
28946,6/1/2021,AIA,Selangor,0,0,0,Anguilla
28947,6/1/2021,ALB,Johor,0,0,0,Albania
28948,6/1/2021,ALB,Kedah,0,0,0,Albania
28949,6/1/2021,ALB,Perak,0,0,0,Albania
28950,6/1/2021,ALB,Perlis,0,0,0,Albania
28951,6/1/2021,ALB,Pulau Pinang,0,0,0,Albania
28952,6/1/2021,ALB,Sabah,0,0,0,Albania
28953,6/1/2021,ALB,Sarawak,0,0,0,Albania
28954,6/1/2021,ALB,Selangor,1,0,1,Albania
28955,6/1/2021,AND,Johor,0,0,0,Andorra
28956,6/1/2021,AND,Kedah,0,0,0,Andorra
28957,6/1/2021,AND,Perlis,0,0,0,Andorra
28958,6/1/2021,AND,Pulau Pinang,0,0,0,Andorra
28959,6/1/2021,AND,Selangor,0,0,0,Andorra
28960,6/1/2021,ANT,Selangor,0,0,0,Netherlands Antilles
28961,6/1/2021,ARE,Johor,0,0,0,United Arab Emirates
28962,6/1/2021,ARE,Kedah,0,0,0,United Arab Emirates
28963,6/1/2021,ARE,Kelantan,0,0,0,United Arab Emirates
28964,6/1/2021,ARE,Perak,0,0,0,United Arab Emirates
28965,6/1/2021,ARE,Perlis,0,0,0,United Arab Emirates
28966,6/1/2021,ARE,Pulau Pinang,0,0,0,United Arab Emirates
28967,6/1/2021,ARE,Sabah,0,0,0,United Arab Emirates
28968,6/1/2021,ARE,Sarawak,0,0,0,United Arab Emirates
28969,6/1/2021,ARE,Selangor,1,0,1,United Arab Emirates
28970,6/1/2021,ARG,Johor,0,0,0,Argentina
28971,6/1/2021,ARG,Kedah,0,0,0,Argentina
28972,6/1/2021,ARG,Kelantan,0,0,0,Argentina
28973,6/1/2021,ARG,Melaka,0,0,0,Argentina
28974,6/1/2021,ARG,Perak,0,0,0,Argentina
28975,6/1/2021,ARG,Perlis,0,0,0,Argentina
28976,6/1/2021,ARG,Pulau Pinang,0,0,0,Argentina
28977,6/1/2021,ARG,Sabah,0,0,0,Argentina
28978,6/1/2021,ARG,Sarawak,0,0,0,Argentina
28979,6/1/2021,ARG,Selangor,7,4,3,Argentina
28980,6/1/2021,ARG,W.P. Labuan,0,0,0,Argentina
28981,6/1/2021,ARM,Johor,0,0,0,Armenia
28982,6/1/2021,ARM,Kedah,0,0,0,Armenia
28983,6/1/2021,ARM,Kelantan,0,0,0,Armenia
28984,6/1/2021,ARM,Perak,0,0,0,Armenia
28985,6/1/2021,ARM,Perlis,0,0,0,Armenia
28986,6/1/2021,ARM,Pulau Pinang,0,0,0,Armenia
28987,6/1/2021,ARM,Sabah,0,0,0,Armenia
28988,6/1/2021,ARM,Sarawak,0,0,0,Armenia
28989,6/1/2021,ARM,Selangor,0,0,0,Armenia
28990,6/1/2021,ATA,Selangor,0,0,0,Antarctica
28991,6/1/2021,ATG,Johor,0,0,0,Antigua and Barbuda
28992,6/1/2021,ATG,Kedah,0,0,0,Antigua and Barbuda
28993,6/1/2021,ATG,Pulau Pinang,0,0,0,Antigua and Barbuda
28994,6/1/2021,ATG,Sarawak,0,0,0,Antigua and Barbuda
28995,6/1/2021,ATG,Selangor,0,0,0,Antigua and Barbuda
28996,6/1/2021,AUS,Johor,2,1,1,Australia
28997,6/1/2021,AUS,Kedah,0,0,0,Australia
28998,6/1/2021,AUS,Kelantan,0,0,0,Australia
28999,6/1/2021,AUS,Melaka,0,0,0,Australia
29000,6/1/2021,AUS,Negeri Sembilan,0,0,0,Australia
29001,6/1/2021,AUS,Pahang,0,0,0,Australia
29002,6/1/2021,AUS,Perak,0,0,0,Australia
29003,6/1/2021,AUS,Perlis,0,0,0,Australia
29004,6/1/2021,AUS,Pulau Pinang,6,3,3,Australia
29005,6/1/2021,AUS,Sabah,0,0,0,Australia
29006,6/1/2021,AUS,Sarawak,1,1,0,Australia
29007,6/1/2021,AUS,Selangor,46,37,9,Australia
29008,6/1/2021,AUS,Terengganu,0,0,0,Australia
29009,6/1/2021,AUS,W.P. Labuan,0,0,0,Australia
29010,6/1/2021,AUT,Johor,0,0,0,Austria
29011,6/1/2021,AUT,Kedah,0,0,0,Austria
29012,6/1/2021,AUT,Kelantan,0,0,0,Austria
29013,6/1/2021,AUT,Melaka,0,0,0,Austria
29014,6/1/2021,AUT,Negeri Sembilan,0,0,0,Austria
29015,6/1/2021,AUT,Pahang,0,0,0,Austria
29016,6/1/2021,AUT,Perak,0,0,0,Austria
29017,6/1/2021,AUT,Perlis,0,0,0,Austria
29018,6/1/2021,AUT,Pulau Pinang,0,0,0,Austria
29019,6/1/2021,AUT,Sabah,0,0,0,Austria
29020,6/1/2021,AUT,Sarawak,0,0,0,Austria
29021,6/1/2021,AUT,Selangor,8,8,0,Austria
29022,6/1/2021,AUT,Terengganu,0,0,0,Austria
29023,6/1/2021,AUT,W.P. Labuan,0,0,0,Austria
29024,6/1/2021,AZE,Johor,0,0,0,Azerbaijan
29025,6/1/2021,AZE,Kedah,0,0,0,Azerbaijan
29026,6/1/2021,AZE,Kelantan,0,0,0,Azerbaijan
29027,6/1/2021,AZE,Melaka,0,0,0,Azerbaijan
29028,6/1/2021,AZE,Perlis,0,0,0,Azerbaijan
29029,6/1/2021,AZE,Pulau Pinang,0,0,0,Azerbaijan
29030,6/1/2021,AZE,Sabah,0,0,0,Azerbaijan
29031,6/1/2021,AZE,Sarawak,0,0,0,Azerbaijan
29032,6/1/2021,AZE,Selangor,1,1,0,Azerbaijan
29033,6/1/2021,AZE,W.P. Labuan,0,0,0,Azerbaijan
29034,6/1/2021,BDI,Pulau Pinang,0,0,0,Burundi
29035,6/1/2021,BDI,Sarawak,0,0,0,Burundi
29036,6/1/2021,BDI,Selangor,0,0,0,Burundi
29037,6/1/2021,BEL,Johor,0,0,0,Belgium
29038,6/1/2021,BEL,Kedah,0,0,0,Belgium
29039,6/1/2021,BEL,Kelantan,0,0,0,Belgium
29040,6/1/2021,BEL,Melaka,0,0,0,Belgium
29041,6/1/2021,BEL,Negeri Sembilan,0,0,0,Belgium
29042,6/1/2021,BEL,Pahang,0,0,0,Belgium
29043,6/1/2021,BEL,Perak,0,0,0,Belgium
29044,6/1/2021,BEL,Perlis,0,0,0,Belgium
29045,6/1/2021,BEL,Pulau Pinang,0,0,0,Belgium
29046,6/1/2021,BEL,Sabah,0,0,0,Belgium
29047,6/1/2021,BEL,Sarawak,0,0,0,Belgium
29048,6/1/2021,BEL,Selangor,5,3,2,Belgium
29049,6/1/2021,BEL,W.P. Labuan,0,0,0,Belgium
29050,6/1/2021,BEN,Johor,0,0,0,Benin
29051,6/1/2021,BEN,Kedah,0,0,0,Benin
29052,6/1/2021,BEN,Perak,0,0,0,Benin
29053,6/1/2021,BEN,Pulau Pinang,0,0,0,Benin
29054,6/1/2021,BEN,Sabah,0,0,0,Benin
29055,6/1/2021,BEN,Sarawak,0,0,0,Benin
29056,6/1/2021,BEN,Selangor,0,0,0,Benin
29057,6/1/2021,BFA,Perak,0,0,0,Burkina Faso
29058,6/1/2021,BFA,Pulau Pinang,0,0,0,Burkina Faso
29059,6/1/2021,BFA,Selangor,0,0,0,Burkina Faso
29060,6/1/2021,BGD,Johor,0,0,0,Bangladesh
29061,6/1/2021,BGD,Kedah,0,0,0,Bangladesh
29062,6/1/2021,BGD,Kelantan,0,0,0,Bangladesh
29063,6/1/2021,BGD,Melaka,0,0,0,Bangladesh
29064,6/1/2021,BGD,Negeri Sembilan,0,0,0,Bangladesh
29065,6/1/2021,BGD,Pahang,0,0,0,Bangladesh
29066,6/1/2021,BGD,Perak,0,0,0,Bangladesh
29067,6/1/2021,BGD,Perlis,0,0,0,Bangladesh
29068,6/1/2021,BGD,Pulau Pinang,0,0,0,Bangladesh
29069,6/1/2021,BGD,Sabah,0,0,0,Bangladesh
29070,6/1/2021,BGD,Sarawak,0,0,0,Bangladesh
29071,6/1/2021,BGD,Selangor,3,1,2,Bangladesh
29072,6/1/2021,BGD,W.P. Labuan,0,0,0,Bangladesh
29073,6/1/2021,BGR,Johor,0,0,0,Bulgaria
29074,6/1/2021,BGR,Kedah,0,0,0,Bulgaria
29075,6/1/2021,BGR,Kelantan,0,0,0,Bulgaria
29076,6/1/2021,BGR,Pahang,0,0,0,Bulgaria
29077,6/1/2021,BGR,Perak,0,0,0,Bulgaria
29078,6/1/2021,BGR,Perlis,0,0,0,Bulgaria
29079,6/1/2021,BGR,Pulau Pinang,0,0,0,Bulgaria
29080,6/1/2021,BGR,Sabah,0,0,0,Bulgaria
29081,6/1/2021,BGR,Sarawak,0,0,0,Bulgaria
29082,6/1/2021,BGR,Selangor,8,8,0,Bulgaria
29083,6/1/2021,BGR,W.P. Labuan,0,0,0,Bulgaria
29084,6/1/2021,BHR,Johor,0,0,0,Bahrain
29085,6/1/2021,BHR,Kedah,0,0,0,Bahrain
29086,6/1/2021,BHR,Kelantan,0,0,0,Bahrain
29087,6/1/2021,BHR,Perlis,0,0,0,Bahrain
29088,6/1/2021,BHR,Pulau Pinang,0,0,0,Bahrain
29089,6/1/2021,BHR,Sabah,0,0,0,Bahrain
29090,6/1/2021,BHR,Sarawak,0,0,0,Bahrain
29091,6/1/2021,BHR,Selangor,1,1,0,Bahrain
29092,6/1/2021,BHS,Johor,0,0,0,Bahamas
29093,6/1/2021,BHS,Kedah,0,0,0,Bahamas
29094,6/1/2021,BHS,Perak,0,0,0,Bahamas
29095,6/1/2021,BHS,Sabah,0,0,0,Bahamas
29096,6/1/2021,BHS,Sarawak,0,0,0,Bahamas
29097,6/1/2021,BHS,Selangor,0,0,0,Bahamas
29098,6/1/2021,BIH,Johor,0,0,0,Bosnia and Herzegovina
29099,6/1/2021,BIH,Kedah,0,0,0,Bosnia and Herzegovina
29100,6/1/2021,BIH,Perlis,0,0,0,Bosnia and Herzegovina
29101,6/1/2021,BIH,Pulau Pinang,0,0,0,Bosnia and Herzegovina
29102,6/1/2021,BIH,Sabah,0,0,0,Bosnia and Herzegovina
29103,6/1/2021,BIH,Sarawak,0,0,0,Bosnia and Herzegovina
29104,6/1/2021,BIH,Selangor,2,1,1,Bosnia and Herzegovina
29105,6/1/2021,BLR,Johor,0,0,0,Belarus
29106,6/1/2021,BLR,Kedah,0,0,0,Belarus
29107,6/1/2021,BLR,Kelantan,0,0,0,Belarus
29108,6/1/2021,BLR,Pahang,0,0,0,Belarus
29109,6/1/2021,BLR,Perak,0,0,0,Belarus
29110,6/1/2021,BLR,Perlis,0,0,0,Belarus
29111,6/1/2021,BLR,Pulau Pinang,0,0,0,Belarus
29112,6/1/2021,BLR,Sabah,0,0,0,Belarus
29113,6/1/2021,BLR,Sarawak,0,0,0,Belarus
29114,6/1/2021,BLR,Selangor,0,0,0,Belarus
29115,6/1/2021,BLR,W.P. Labuan,0,0,0,Belarus
29116,6/1/2021,BLZ,Johor,0,0,0,Belize
29117,6/1/2021,BLZ,Pulau Pinang,0,0,0,Belize
29118,6/1/2021,BLZ,Sarawak,0,0,0,Belize
29119,6/1/2021,BLZ,Selangor,0,0,0,Belize
29120,6/1/2021,BMU,Selangor,0,0,0,Bermuda
29121,6/1/2021,BOL,Johor,0,0,0,Bolivia
29122,6/1/2021,BOL,Kedah,0,0,0,Bolivia
29123,6/1/2021,BOL,Melaka,0,0,0,Bolivia
29124,6/1/2021,BOL,Perak,0,0,0,Bolivia
29125,6/1/2021,BOL,Perlis,0,0,0,Bolivia
29126,6/1/2021,BOL,Pulau Pinang,0,0,0,Bolivia
29127,6/1/2021,BOL,Sabah,0,0,0,Bolivia
29128,6/1/2021,BOL,Sarawak,0,0,0,Bolivia
29129,6/1/2021,BOL,Selangor,0,0,0,Bolivia
29130,6/1/2021,BRA,Johor,0,0,0,Brazil
29131,6/1/2021,BRA,Kedah,0,0,0,Brazil
29132,6/1/2021,BRA,Kelantan,0,0,0,Brazil
29133,6/1/2021,BRA,Melaka,0,0,0,Brazil
29134,6/1/2021,BRA,Pahang,0,0,0,Brazil
29135,6/1/2021,BRA,Perak,0,0,0,Brazil
29136,6/1/2021,BRA,Perlis,0,0,0,Brazil
29137,6/1/2021,BRA,Pulau Pinang,0,0,0,Brazil
29138,6/1/2021,BRA,Sabah,0,0,0,Brazil
29139,6/1/2021,BRA,Sarawak,0,0,0,Brazil
29140,6/1/2021,BRA,Selangor,15,12,3,Brazil
29141,6/1/2021,BRA,W.P. Labuan,0,0,0,Brazil
29142,6/1/2021,BRB,Johor,0,0,0,Barbados
29143,6/1/2021,BRB,Kedah,0,0,0,Barbados
29144,6/1/2021,BRB,Perlis,0,0,0,Barbados
29145,6/1/2021,BRB,Pulau Pinang,0,0,0,Barbados
29146,6/1/2021,BRB,Selangor,0,0,0,Barbados
29147,6/1/2021,BRN,Johor,0,0,0,Brunei Darussalam
29148,6/1/2021,BRN,Kedah,0,0,0,Brunei Darussalam
29149,6/1/2021,BRN,Kelantan,0,0,0,Brunei Darussalam
29150,6/1/2021,BRN,Melaka,0,0,0,Brunei Darussalam
29151,6/1/2021,BRN,Pahang,0,0,0,Brunei Darussalam
29152,6/1/2021,BRN,Perak,0,0,0,Brunei Darussalam
29153,6/1/2021,BRN,Perlis,0,0,0,Brunei Darussalam
29154,6/1/2021,BRN,Pulau Pinang,0,0,0,Brunei Darussalam
29155,6/1/2021,BRN,Sabah,0,0,0,Brunei Darussalam
29156,6/1/2021,BRN,Sarawak,308,306,2,Brunei Darussalam
29157,6/1/2021,BRN,Selangor,8,2,6,Brunei Darussalam
29158,6/1/2021,BRN,W.P. Labuan,0,0,0,Brunei Darussalam
29159,6/1/2021,BTN,Johor,0,0,0,Bhutan
29160,6/1/2021,BTN,Kedah,0,0,0,Bhutan
29161,6/1/2021,BTN,Perak,0,0,0,Bhutan
29162,6/1/2021,BTN,Perlis,0,0,0,Bhutan
29163,6/1/2021,BTN,Pulau Pinang,0,0,0,Bhutan
29164,6/1/2021,BTN,Sabah,0,0,0,Bhutan
29165,6/1/2021,BTN,Sarawak,0,0,0,Bhutan
29166,6/1/2021,BTN,Selangor,0,0,0,Bhutan
29167,6/1/2021,BWA,Johor,0,0,0,Botswana
29168,6/1/2021,BWA,Kedah,0,0,0,Botswana
29169,6/1/2021,BWA,Perlis,0,0,0,Botswana
29170,6/1/2021,BWA,Pulau Pinang,0,0,0,Botswana
29171,6/1/2021,BWA,Sabah,0,0,0,Botswana
29172,6/1/2021,BWA,Sarawak,0,0,0,Botswana
29173,6/1/2021,BWA,Selangor,0,0,0,Botswana
29174,6/1/2021,CAF,Kedah,0,0,0,Central African Republic
29175,6/1/2021,CAF,Selangor,0,0,0,Central African Republic
29176,6/1/2021,CAN,Johor,0,0,0,Canada
29177,6/1/2021,CAN,Kedah,0,0,0,Canada
29178,6/1/2021,CAN,Kelantan,0,0,0,Canada
29179,6/1/2021,CAN,Melaka,0,0,0,Canada
29180,6/1/2021,CAN,Negeri Sembilan,0,0,0,Canada
29181,6/1/2021,CAN,Pahang,0,0,0,Canada
29182,6/1/2021,CAN,Perak,0,0,0,Canada
29183,6/1/2021,CAN,Perlis,0,0,0,Canada
29184,6/1/2021,CAN,Pulau Pinang,0,0,0,Canada
29185,6/1/2021,CAN,Sabah,0,0,0,Canada
29186,6/1/2021,CAN,Sarawak,0,0,0,Canada
29187,6/1/2021,CAN,Selangor,29,19,10,Canada
29188,6/1/2021,CAN,Terengganu,0,0,0,Canada
29189,6/1/2021,CAN,W.P. Labuan,0,0,0,Canada
29190,6/1/2021,CCK,Selangor,0,0,0,Cocos (Keeling) Islands
29191,6/1/2021,CHE,Johor,0,0,0,Switzerland
29192,6/1/2021,CHE,Kedah,0,0,0,Switzerland
29193,6/1/2021,CHE,Kelantan,0,0,0,Switzerland
29194,6/1/2021,CHE,Melaka,0,0,0,Switzerland
29195,6/1/2021,CHE,Negeri Sembilan,0,0,0,Switzerland
29196,6/1/2021,CHE,Pahang,0,0,0,Switzerland
29197,6/1/2021,CHE,Perak,0,0,0,Switzerland
29198,6/1/2021,CHE,Perlis,0,0,0,Switzerland
29199,6/1/2021,CHE,Pulau Pinang,0,0,0,Switzerland
29200,6/1/2021,CHE,Sabah,0,0,0,Switzerland
29201,6/1/2021,CHE,Sarawak,0,0,0,Switzerland
29202,6/1/2021,CHE,Selangor,12,9,3,Switzerland
29203,6/1/2021,CHE,W.P. Labuan,0,0,0,Switzerland
29204,6/1/2021,CHL,Johor,0,0,0,Chile
29205,6/1/2021,CHL,Kedah,0,0,0,Chile
29206,6/1/2021,CHL,Kelantan,0,0,0,Chile
29207,6/1/2021,CHL,Melaka,0,0,0,Chile
29208,6/1/2021,CHL,Pahang,0,0,0,Chile
29209,6/1/2021,CHL,Perak,0,0,0,Chile
29210,6/1/2021,CHL,Perlis,0,0,0,Chile
29211,6/1/2021,CHL,Pulau Pinang,0,0,0,Chile
29212,6/1/2021,CHL,Sabah,0,0,0,Chile
29213,6/1/2021,CHL,Sarawak,0,0,0,Chile
29214,6/1/2021,CHL,Selangor,0,0,0,Chile
29215,6/1/2021,CHN,Johor,6,5,1,China
29216,6/1/2021,CHN,Kedah,0,0,0,China
29217,6/1/2021,CHN,Kelantan,0,0,0,China
29218,6/1/2021,CHN,Melaka,0,0,0,China
29219,6/1/2021,CHN,Pahang,0,0,0,China
29220,6/1/2021,CHN,Perak,0,0,0,China
29221,6/1/2021,CHN,Perlis,0,0,0,China
29222,6/1/2021,CHN,Pulau Pinang,2,1,1,China
29223,6/1/2021,CHN,Sabah,0,0,0,China
29224,6/1/2021,CHN,Sarawak,77,67,10,China
29225,6/1/2021,CHN,Selangor,727,622,105,China
29226,6/1/2021,CHN,Terengganu,0,0,0,China
29227,6/1/2021,CHN,W.P. Labuan,0,0,0,China
29228,6/1/2021,CIV,Johor,0,0,0,C��te d'Iv
29229,6/1/2021,CIV,Kedah,0,0,0,C��te d'Iv
29230,6/1/2021,CIV,Pulau Pinang,0,0,0,C��te d'Iv
29231,6/1/2021,CIV,Sabah,0,0,0,C��te d'Iv
29232,6/1/2021,CIV,Sarawak,0,0,0,C��te d'Iv
29233,6/1/2021,CIV,Selangor,1,0,1,C��te d'Iv
29234,6/1/2021,CMR,Johor,0,0,0,Cameroon
29235,6/1/2021,CMR,Kedah,0,0,0,Cameroon
29236,6/1/2021,CMR,Pulau Pinang,0,0,0,Cameroon
29237,6/1/2021,CMR,Sabah,0,0,0,Cameroon
29238,6/1/2021,CMR,Sarawak,0,0,0,Cameroon
29239,6/1/2021,CMR,Selangor,0,0,0,Cameroon
29240,6/1/2021,COD,Johor,0,0,0,"Congo, the Democratic Republic of the"
29241,6/1/2021,COD,Pulau Pinang,0,0,0,"Congo, the Democratic Republic of the"
29242,6/1/2021,COD,Sarawak,0,0,0,"Congo, the Democratic Republic of the"
29243,6/1/2021,COD,Selangor,0,0,0,"Congo, the Democratic Republic of the"
29244,6/1/2021,COG,Johor,0,0,0,Congo
29245,6/1/2021,COG,Kedah,0,0,0,Congo
29246,6/1/2021,COG,Selangor,0,0,0,Congo
29247,6/1/2021,COK,Selangor,0,0,0,Cook Islands
29248,6/1/2021,COL,Johor,0,0,0,Colombia
29249,6/1/2021,COL,Kedah,0,0,0,Colombia
29250,6/1/2021,COL,Perak,0,0,0,Colombia
29251,6/1/2021,COL,Pulau Pinang,0,0,0,Colombia
29252,6/1/2021,COL,Sabah,0,0,0,Colombia
29253,6/1/2021,COL,Sarawak,0,0,0,Colombia
29254,6/1/2021,COL,Selangor,1,1,0,Colombia
29255,6/1/2021,COL,W.P. Labuan,0,0,0,Colombia
29256,6/1/2021,COM,Johor,0,0,0,Comoros
29257,6/1/2021,COM,Kedah,0,0,0,Comoros
29258,6/1/2021,COM,Selangor,0,0,0,Comoros
29259,6/1/2021,CPV,Johor,0,0,0,Cape Verde
29260,6/1/2021,CPV,Kedah,0,0,0,Cape Verde
29261,6/1/2021,CPV,Pulau Pinang,0,0,0,Cape Verde
29262,6/1/2021,CPV,Sabah,0,0,0,Cape Verde
29263,6/1/2021,CPV,Selangor,0,0,0,Cape Verde
29264,6/1/2021,CRI,Johor,0,0,0,Costa Rica
29265,6/1/2021,CRI,Kedah,0,0,0,Costa Rica
29266,6/1/2021,CRI,Perak,0,0,0,Costa Rica
29267,6/1/2021,CRI,Perlis,0,0,0,Costa Rica
29268,6/1/2021,CRI,Pulau Pinang,0,0,0,Costa Rica
29269,6/1/2021,CRI,Sabah,0,0,0,Costa Rica
29270,6/1/2021,CRI,Sarawak,0,0,0,Costa Rica
29271,6/1/2021,CRI,Selangor,1,1,0,Costa Rica
29272,6/1/2021,CUB,Johor,0,0,0,Cuba
29273,6/1/2021,CUB,Kedah,0,0,0,Cuba
29274,6/1/2021,CUB,Perlis,0,0,0,Cuba
29275,6/1/2021,CUB,Pulau Pinang,0,0,0,Cuba
29276,6/1/2021,CUB,Sabah,0,0,0,Cuba
29277,6/1/2021,CUB,Sarawak,0,0,0,Cuba
29278,6/1/2021,CUB,Selangor,0,0,0,Cuba
29279,6/1/2021,CYP,Johor,0,0,0,Cyprus
29280,6/1/2021,CYP,Kedah,0,0,0,Cyprus
29281,6/1/2021,CYP,Perak,0,0,0,Cyprus
29282,6/1/2021,CYP,Perlis,0,0,0,Cyprus
29283,6/1/2021,CYP,Pulau Pinang,0,0,0,Cyprus
29284,6/1/2021,CYP,Sabah,0,0,0,Cyprus
29285,6/1/2021,CYP,Sarawak,0,0,0,Cyprus
29286,6/1/2021,CYP,Selangor,0,0,0,Cyprus
29287,6/1/2021,CZE,Johor,0,0,0,Czech Republic
29288,6/1/2021,CZE,Kedah,0,0,0,Czech Republic
29289,6/1/2021,CZE,Kelantan,0,0,0,Czech Republic
29290,6/1/2021,CZE,Melaka,0,0,0,Czech Republic
29291,6/1/2021,CZE,Negeri Sembilan,0,0,0,Czech Republic
29292,6/1/2021,CZE,Perak,0,0,0,Czech Republic
29293,6/1/2021,CZE,Perlis,0,0,0,Czech Republic
29294,6/1/2021,CZE,Pulau Pinang,0,0,0,Czech Republic
29295,6/1/2021,CZE,Sabah,0,0,0,Czech Republic
29296,6/1/2021,CZE,Sarawak,0,0,0,Czech Republic
29297,6/1/2021,CZE,Selangor,2,2,0,Czech Republic
29298,6/1/2021,CZE,W.P. Labuan,0,0,0,Czech Republic
29299,6/1/2021,DEU,Johor,0,0,0,Germany
29300,6/1/2021,DEU,Kedah,0,0,0,Germany
29301,6/1/2021,DEU,Kelantan,0,0,0,Germany
29302,6/1/2021,DEU,Melaka,0,0,0,Germany
29303,6/1/2021,DEU,Negeri Sembilan,0,0,0,Germany
29304,6/1/2021,DEU,Pahang,0,0,0,Germany
29305,6/1/2021,DEU,Perak,0,0,0,Germany
29306,6/1/2021,DEU,Perlis,0,0,0,Germany
29307,6/1/2021,DEU,Pulau Pinang,1,1,0,Germany
29308,6/1/2021,DEU,Sabah,0,0,0,Germany
29309,6/1/2021,DEU,Sarawak,0,0,0,Germany
29310,6/1/2021,DEU,Selangor,50,45,5,Germany
29311,6/1/2021,DEU,Terengganu,0,0,0,Germany
29312,6/1/2021,DEU,W.P. Labuan,0,0,0,Germany
29313,6/1/2021,DJI,Johor,0,0,0,Djibouti
29314,6/1/2021,DJI,Selangor,1,0,1,Djibouti
29315,6/1/2021,DMA,Johor,0,0,0,Dominica
29316,6/1/2021,DMA,Kedah,0,0,0,Dominica
29317,6/1/2021,DMA,Pulau Pinang,0,0,0,Dominica
29318,6/1/2021,DMA,Sabah,0,0,0,Dominica
29319,6/1/2021,DMA,Sarawak,0,0,0,Dominica
29320,6/1/2021,DMA,Selangor,0,0,0,Dominica
29321,6/1/2021,DMA,W.P. Labuan,0,0,0,Dominica
29322,6/1/2021,DNK,Johor,0,0,0,Denmark
29323,6/1/2021,DNK,Kedah,0,0,0,Denmark
29324,6/1/2021,DNK,Kelantan,0,0,0,Denmark
29325,6/1/2021,DNK,Melaka,0,0,0,Denmark
29326,6/1/2021,DNK,Negeri Sembilan,0,0,0,Denmark
29327,6/1/2021,DNK,Pahang,0,0,0,Denmark
29328,6/1/2021,DNK,Perak,0,0,0,Denmark
29329,6/1/2021,DNK,Perlis,0,0,0,Denmark
29330,6/1/2021,DNK,Pulau Pinang,0,0,0,Denmark
29331,6/1/2021,DNK,Sabah,0,0,0,Denmark
29332,6/1/2021,DNK,Sarawak,0,0,0,Denmark
29333,6/1/2021,DNK,Selangor,10,9,1,Denmark
29334,6/1/2021,DNK,W.P. Labuan,0,0,0,Denmark
29335,6/1/2021,DOM,Johor,0,0,0,Dominican Republic
29336,6/1/2021,DOM,Kedah,0,0,0,Dominican Republic
29337,6/1/2021,DOM,Perak,0,0,0,Dominican Republic
29338,6/1/2021,DOM,Perlis,0,0,0,Dominican Republic
29339,6/1/2021,DOM,Pulau Pinang,0,0,0,Dominican Republic
29340,6/1/2021,DOM,Sabah,0,0,0,Dominican Republic
29341,6/1/2021,DOM,Sarawak,0,0,0,Dominican Republic
29342,6/1/2021,DOM,Selangor,0,0,0,Dominican Republic
29343,6/1/2021,DZA,Johor,0,0,0,Algeria
29344,6/1/2021,DZA,Kedah,0,0,0,Algeria
29345,6/1/2021,DZA,Kelantan,0,0,0,Algeria
29346,6/1/2021,DZA,Melaka,0,0,0,Algeria
29347,6/1/2021,DZA,Perak,0,0,0,Algeria
29348,6/1/2021,DZA,Perlis,0,0,0,Algeria
29349,6/1/2021,DZA,Pulau Pinang,0,0,0,Algeria
29350,6/1/2021,DZA,Sabah,0,0,0,Algeria
29351,6/1/2021,DZA,Sarawak,0,0,0,Algeria
29352,6/1/2021,DZA,Selangor,11,7,4,Algeria
29353,6/1/2021,DZA,W.P. Labuan,0,0,0,Algeria
29354,6/1/2021,ECU,Johor,0,0,0,Ecuador
29355,6/1/2021,ECU,Kedah,0,0,0,Ecuador
29356,6/1/2021,ECU,Perak,0,0,0,Ecuador
29357,6/1/2021,ECU,Perlis,0,0,0,Ecuador
29358,6/1/2021,ECU,Pulau Pinang,0,0,0,Ecuador
29359,6/1/2021,ECU,Sabah,0,0,0,Ecuador
29360,6/1/2021,ECU,Sarawak,0,0,0,Ecuador
29361,6/1/2021,ECU,Selangor,0,0,0,Ecuador
29362,6/1/2021,EGY,Johor,0,0,0,Egypt
29363,6/1/2021,EGY,Kedah,0,0,0,Egypt
29364,6/1/2021,EGY,Kelantan,0,0,0,Egypt
29365,6/1/2021,EGY,Melaka,0,0,0,Egypt
29366,6/1/2021,EGY,Pahang,0,0,0,Egypt
29367,6/1/2021,EGY,Perak,0,0,0,Egypt
29368,6/1/2021,EGY,Perlis,0,0,0,Egypt
29369,6/1/2021,EGY,Pulau Pinang,0,0,0,Egypt
29370,6/1/2021,EGY,Sabah,0,0,0,Egypt
29371,6/1/2021,EGY,Sarawak,0,0,0,Egypt
29372,6/1/2021,EGY,Selangor,50,36,14,Egypt
29373,6/1/2021,EGY,Terengganu,0,0,0,Egypt
29374,6/1/2021,EGY,W.P. Labuan,0,0,0,Egypt
29375,6/1/2021,ERI,Johor,0,0,0,Eritrea
29376,6/1/2021,ERI,Pulau Pinang,0,0,0,Eritrea
29377,6/1/2021,ERI,Sabah,0,0,0,Eritrea
29378,6/1/2021,ERI,Selangor,0,0,0,Eritrea
29379,6/1/2021,ESP,Johor,0,0,0,Spain
29380,6/1/2021,ESP,Kedah,0,0,0,Spain
29381,6/1/2021,ESP,Kelantan,0,0,0,Spain
29382,6/1/2021,ESP,Melaka,0,0,0,Spain
29383,6/1/2021,ESP,Negeri Sembilan,0,0,0,Spain
29384,6/1/2021,ESP,Pahang,0,0,0,Spain
29385,6/1/2021,ESP,Perak,0,0,0,Spain
29386,6/1/2021,ESP,Perlis,0,0,0,Spain
29387,6/1/2021,ESP,Pulau Pinang,0,0,0,Spain
29388,6/1/2021,ESP,Sabah,0,0,0,Spain
29389,6/1/2021,ESP,Sarawak,0,0,0,Spain
29390,6/1/2021,ESP,Selangor,14,12,2,Spain
29391,6/1/2021,ESP,W.P. Labuan,0,0,0,Spain
29392,6/1/2021,EST,Johor,0,0,0,Estonia
29393,6/1/2021,EST,Kedah,0,0,0,Estonia
29394,6/1/2021,EST,Kelantan,0,0,0,Estonia
29395,6/1/2021,EST,Pahang,0,0,0,Estonia
29396,6/1/2021,EST,Perak,0,0,0,Estonia
29397,6/1/2021,EST,Perlis,0,0,0,Estonia
29398,6/1/2021,EST,Pulau Pinang,0,0,0,Estonia
29399,6/1/2021,EST,Sabah,0,0,0,Estonia
29400,6/1/2021,EST,Sarawak,0,0,0,Estonia
29401,6/1/2021,EST,Selangor,1,1,0,Estonia
29402,6/1/2021,EST,W.P. Labuan,0,0,0,Estonia
29403,6/1/2021,ETH,Johor,0,0,0,Ethiopia
29404,6/1/2021,ETH,Kedah,0,0,0,Ethiopia
29405,6/1/2021,ETH,Pulau Pinang,0,0,0,Ethiopia
29406,6/1/2021,ETH,Sarawak,0,0,0,Ethiopia
29407,6/1/2021,ETH,Selangor,4,2,2,Ethiopia
29408,6/1/2021,FIN,Johor,0,0,0,Finland
29409,6/1/2021,FIN,Kedah,0,0,0,Finland
29410,6/1/2021,FIN,Kelantan,0,0,0,Finland
29411,6/1/2021,FIN,Melaka,0,0,0,Finland
29412,6/1/2021,FIN,Negeri Sembilan,0,0,0,Finland
29413,6/1/2021,FIN,Pahang,0,0,0,Finland
29414,6/1/2021,FIN,Perak,0,0,0,Finland
29415,6/1/2021,FIN,Perlis,0,0,0,Finland
29416,6/1/2021,FIN,Pulau Pinang,0,0,0,Finland
29417,6/1/2021,FIN,Sabah,0,0,0,Finland
29418,6/1/2021,FIN,Sarawak,0,0,0,Finland
29419,6/1/2021,FIN,Selangor,7,5,2,Finland
29420,6/1/2021,FIN,W.P. Labuan,0,0,0,Finland
29421,6/1/2021,FJI,Johor,0,0,0,Fiji
29422,6/1/2021,FJI,Kedah,0,0,0,Fiji
29423,6/1/2021,FJI,Kelantan,0,0,0,Fiji
29424,6/1/2021,FJI,Perak,0,0,0,Fiji
29425,6/1/2021,FJI,Perlis,0,0,0,Fiji
29426,6/1/2021,FJI,Pulau Pinang,0,0,0,Fiji
29427,6/1/2021,FJI,Sabah,0,0,0,Fiji
29428,6/1/2021,FJI,Sarawak,0,0,0,Fiji
29429,6/1/2021,FJI,Selangor,0,0,0,Fiji
29430,6/1/2021,FRA,Johor,0,0,0,France
29431,6/1/2021,FRA,Kedah,0,0,0,France
29432,6/1/2021,FRA,Kelantan,0,0,0,France
29433,6/1/2021,FRA,Melaka,0,0,0,France
29434,6/1/2021,FRA,Negeri Sembilan,0,0,0,France
29435,6/1/2021,FRA,Pahang,0,0,0,France
29436,6/1/2021,FRA,Perak,0,0,0,France
29437,6/1/2021,FRA,Perlis,0,0,0,France
29438,6/1/2021,FRA,Pulau Pinang,0,0,0,France
29439,6/1/2021,FRA,Sabah,0,0,0,France
29440,6/1/2021,FRA,Sarawak,0,0,0,France
29441,6/1/2021,FRA,Selangor,50,41,9,France
29442,6/1/2021,FRA,Terengganu,0,0,0,France
29443,6/1/2021,FRA,W.P. Labuan,0,0,0,France
29444,6/1/2021,FSM,Johor,0,0,0,"Micronesia, Federated States of"
29445,6/1/2021,FSM,Pulau Pinang,0,0,0,"Micronesia, Federated States of"
29446,6/1/2021,FSM,Selangor,0,0,0,"Micronesia, Federated States of"
29447,6/1/2021,GAB,Johor,0,0,0,Gabon
29448,6/1/2021,GAB,Pulau Pinang,0,0,0,Gabon
29449,6/1/2021,GAB,Sarawak,0,0,0,Gabon
29450,6/1/2021,GAB,Selangor,0,0,0,Gabon
29451,6/1/2021,GBR,Johor,3,3,0,United Kingdom
29452,6/1/2021,GBR,Kedah,2,1,1,United Kingdom
29453,6/1/2021,GBR,Kelantan,0,0,0,United Kingdom
29454,6/1/2021,GBR,Melaka,0,0,0,United Kingdom
29455,6/1/2021,GBR,Negeri Sembilan,0,0,0,United Kingdom
29456,6/1/2021,GBR,Pahang,0,0,0,United Kingdom
29457,6/1/2021,GBR,Perak,0,0,0,United Kingdom
29458,6/1/2021,GBR,Perlis,0,0,0,United Kingdom
29459,6/1/2021,GBR,Pulau Pinang,0,0,0,United Kingdom
29460,6/1/2021,GBR,Sabah,0,0,0,United Kingdom
29461,6/1/2021,GBR,Sarawak,2,2,0,United Kingdom
29462,6/1/2021,GBR,Selangor,142,112,30,United Kingdom
29463,6/1/2021,GBR,Terengganu,0,0,0,United Kingdom
29464,6/1/2021,GBR,W.P. Labuan,0,0,0,United Kingdom
29465,6/1/2021,GEO,Johor,0,0,0,Georgia
29466,6/1/2021,GEO,Kedah,0,0,0,Georgia
29467,6/1/2021,GEO,Melaka,0,0,0,Georgia
29468,6/1/2021,GEO,Perak,0,0,0,Georgia
29469,6/1/2021,GEO,Perlis,0,0,0,Georgia
29470,6/1/2021,GEO,Pulau Pinang,0,0,0,Georgia
29471,6/1/2021,GEO,Sabah,0,0,0,Georgia
29472,6/1/2021,GEO,Sarawak,0,0,0,Georgia
29473,6/1/2021,GEO,Selangor,5,5,0,Georgia
29474,6/1/2021,GHA,Johor,0,0,0,Ghana
29475,6/1/2021,GHA,Kedah,0,0,0,Ghana
29476,6/1/2021,GHA,Kelantan,0,0,0,Ghana
29477,6/1/2021,GHA,Pulau Pinang,0,0,0,Ghana
29478,6/1/2021,GHA,Sabah,0,0,0,Ghana
29479,6/1/2021,GHA,Sarawak,0,0,0,Ghana
29480,6/1/2021,GHA,Selangor,7,6,1,Ghana
29481,6/1/2021,GIB,Johor,0,0,0,Gibraltar
29482,6/1/2021,GIB,Sarawak,0,0,0,Gibraltar
29483,6/1/2021,GIN,Johor,0,0,0,Guinea
29484,6/1/2021,GIN,Kedah,0,0,0,Guinea
29485,6/1/2021,GIN,Kelantan,0,0,0,Guinea
29486,6/1/2021,GIN,Perlis,0,0,0,Guinea
29487,6/1/2021,GIN,Pulau Pinang,0,0,0,Guinea
29488,6/1/2021,GIN,Sabah,0,0,0,Guinea
29489,6/1/2021,GIN,Sarawak,0,0,0,Guinea
29490,6/1/2021,GIN,Selangor,5,4,1,Guinea
29491,6/1/2021,GLP,Selangor,0,0,0,Guadeloupe
29492,6/1/2021,GMB,Johor,0,0,0,Gambia
29493,6/1/2021,GMB,Kedah,0,0,0,Gambia
29494,6/1/2021,GMB,Kelantan,0,0,0,Gambia
29495,6/1/2021,GMB,Pulau Pinang,0,0,0,Gambia
29496,6/1/2021,GMB,Sabah,0,0,0,Gambia
29497,6/1/2021,GMB,Sarawak,0,0,0,Gambia
29498,6/1/2021,GMB,Selangor,1,1,0,Gambia
29499,6/1/2021,GNB,Johor,0,0,0,Guinea-Bissau
29500,6/1/2021,GNB,Selangor,0,0,0,Guinea-Bissau
29501,6/1/2021,GNQ,Johor,0,0,0,Equatorial Guinea
29502,6/1/2021,GNQ,Selangor,1,0,1,Equatorial Guinea
29503,6/1/2021,GRC,Johor,0,0,0,Greece
29504,6/1/2021,GRC,Kedah,0,0,0,Greece
29505,6/1/2021,GRC,Kelantan,0,0,0,Greece
29506,6/1/2021,GRC,Melaka,0,0,0,Greece
29507,6/1/2021,GRC,Negeri Sembilan,0,0,0,Greece
29508,6/1/2021,GRC,Pahang,0,0,0,Greece
29509,6/1/2021,GRC,Perak,0,0,0,Greece
29510,6/1/2021,GRC,Perlis,0,0,0,Greece
29511,6/1/2021,GRC,Pulau Pinang,0,0,0,Greece
29512,6/1/2021,GRC,Sabah,0,0,0,Greece
29513,6/1/2021,GRC,Sarawak,0,0,0,Greece
29514,6/1/2021,GRC,Selangor,5,4,1,Greece
29515,6/1/2021,GRD,Johor,0,0,0,Grenada
29516,6/1/2021,GRD,Kedah,0,0,0,Grenada
29517,6/1/2021,GRD,Pulau Pinang,0,0,0,Grenada
29518,6/1/2021,GRD,Sabah,0,0,0,Grenada
29519,6/1/2021,GRD,Sarawak,0,0,0,Grenada
29520,6/1/2021,GRD,Selangor,1,1,0,Grenada
29521,6/1/2021,GRL,Johor,0,0,0,Greenland
29522,6/1/2021,GRL,Selangor,0,0,0,Greenland
29523,6/1/2021,GTM,Johor,0,0,0,Guatemala
29524,6/1/2021,GTM,Kedah,0,0,0,Guatemala
29525,6/1/2021,GTM,Pahang,0,0,0,Guatemala
29526,6/1/2021,GTM,Perak,0,0,0,Guatemala
29527,6/1/2021,GTM,Pulau Pinang,0,0,0,Guatemala
29528,6/1/2021,GTM,Sabah,0,0,0,Guatemala
29529,6/1/2021,GTM,Sarawak,0,0,0,Guatemala
29530,6/1/2021,GTM,Selangor,1,1,0,Guatemala
29531,6/1/2021,GTM,W.P. Labuan,0,0,0,Guatemala
29532,6/1/2021,GUY,Johor,0,0,0,Guyana
29533,6/1/2021,GUY,Kedah,0,0,0,Guyana
29534,6/1/2021,GUY,Pulau Pinang,0,0,0,Guyana
29535,6/1/2021,GUY,Sarawak,0,0,0,Guyana
29536,6/1/2021,GUY,Selangor,0,0,0,Guyana
29537,6/1/2021,HKG,Johor,0,0,0,Hong Kong
29538,6/1/2021,HKG,Kedah,0,0,0,Hong Kong
29539,6/1/2021,HKG,Kelantan,0,0,0,Hong Kong
29540,6/1/2021,HKG,Pahang,0,0,0,Hong Kong
29541,6/1/2021,HKG,Perak,0,0,0,Hong Kong
29542,6/1/2021,HKG,Perlis,0,0,0,Hong Kong
29543,6/1/2021,HKG,Pulau Pinang,0,0,0,Hong Kong
29544,6/1/2021,HKG,Sabah,0,0,0,Hong Kong
29545,6/1/2021,HKG,Sarawak,0,0,0,Hong Kong
29546,6/1/2021,HKG,Selangor,0,0,0,Hong Kong
29547,6/1/2021,HKG,Terengganu,0,0,0,Hong Kong
29548,6/1/2021,HMD,Johor,0,0,0,Heard Island and McDonald Islands
29549,6/1/2021,HND,Johor,0,0,0,Honduras
29550,6/1/2021,HND,Kedah,0,0,0,Honduras
29551,6/1/2021,HND,Perak,0,0,0,Honduras
29552,6/1/2021,HND,Pulau Pinang,0,0,0,Honduras
29553,6/1/2021,HND,Sabah,0,0,0,Honduras
29554,6/1/2021,HND,Sarawak,0,0,0,Honduras
29555,6/1/2021,HND,Selangor,2,2,0,Honduras
29556,6/1/2021,HRV,Johor,0,0,0,Croatia
29557,6/1/2021,HRV,Kedah,0,0,0,Croatia
29558,6/1/2021,HRV,Kelantan,0,0,0,Croatia
29559,6/1/2021,HRV,Melaka,0,0,0,Croatia
29560,6/1/2021,HRV,Pahang,0,0,0,Croatia
29561,6/1/2021,HRV,Perak,0,0,0,Croatia
29562,6/1/2021,HRV,Perlis,0,0,0,Croatia
29563,6/1/2021,HRV,Pulau Pinang,0,0,0,Croatia
29564,6/1/2021,HRV,Sabah,0,0,0,Croatia
29565,6/1/2021,HRV,Sarawak,0,0,0,Croatia
29566,6/1/2021,HRV,Selangor,21,21,0,Croatia
29567,6/1/2021,HTI,Johor,0,0,0,Haiti
29568,6/1/2021,HTI,Kedah,0,0,0,Haiti
29569,6/1/2021,HTI,Kelantan,0,0,0,Haiti
29570,6/1/2021,HTI,Perak,0,0,0,Haiti
29571,6/1/2021,HTI,Pulau Pinang,0,0,0,Haiti
29572,6/1/2021,HTI,Sabah,0,0,0,Haiti
29573,6/1/2021,HTI,Selangor,0,0,0,Haiti
29574,6/1/2021,HUN,Johor,0,0,0,Hungary
29575,6/1/2021,HUN,Kedah,0,0,0,Hungary
29576,6/1/2021,HUN,Kelantan,0,0,0,Hungary
29577,6/1/2021,HUN,Pahang,0,0,0,Hungary
29578,6/1/2021,HUN,Perak,0,0,0,Hungary
29579,6/1/2021,HUN,Perlis,0,0,0,Hungary
29580,6/1/2021,HUN,Pulau Pinang,0,0,0,Hungary
29581,6/1/2021,HUN,Sabah,0,0,0,Hungary
29582,6/1/2021,HUN,Sarawak,0,0,0,Hungary
29583,6/1/2021,HUN,Selangor,4,3,1,Hungary
29584,6/1/2021,HUN,W.P. Labuan,0,0,0,Hungary
29585,6/1/2021,IDN,Johor,39,33,6,Indonesia
29586,6/1/2021,IDN,Kedah,4,4,0,Indonesia
29587,6/1/2021,IDN,Kelantan,0,0,0,Indonesia
29588,6/1/2021,IDN,Melaka,0,0,0,Indonesia
29589,6/1/2021,IDN,Negeri Sembilan,0,0,0,Indonesia
29590,6/1/2021,IDN,Pahang,0,0,0,Indonesia
29591,6/1/2021,IDN,Perak,0,0,0,Indonesia
29592,6/1/2021,IDN,Perlis,2,2,0,Indonesia
29593,6/1/2021,IDN,Pulau Pinang,7,5,2,Indonesia
29594,6/1/2021,IDN,Sabah,1,1,0,Indonesia
29595,6/1/2021,IDN,Sarawak,334,330,4,Indonesia
29596,6/1/2021,IDN,Selangor,518,377,141,Indonesia
29597,6/1/2021,IDN,Terengganu,0,0,0,Indonesia
29598,6/1/2021,IDN,W.P. Labuan,0,0,0,Indonesia
29599,6/1/2021,IND,Johor,0,0,0,India
29600,6/1/2021,IND,Kedah,0,0,0,India
29601,6/1/2021,IND,Kelantan,0,0,0,India
29602,6/1/2021,IND,Melaka,0,0,0,India
29603,6/1/2021,IND,Negeri Sembilan,0,0,0,India
29604,6/1/2021,IND,Pahang,0,0,0,India
29605,6/1/2021,IND,Perak,0,0,0,India
29606,6/1/2021,IND,Perlis,0,0,0,India
29607,6/1/2021,IND,Pulau Pinang,0,0,0,India
29608,6/1/2021,IND,Sabah,0,0,0,India
29609,6/1/2021,IND,Sarawak,0,0,0,India
29610,6/1/2021,IND,Selangor,29,19,10,India
29611,6/1/2021,IND,Terengganu,0,0,0,India
29612,6/1/2021,IND,W.P. Labuan,0,0,0,India
29613,6/1/2021,IOT,Pulau Pinang,0,0,0,British Indian Ocean Territory
29614,6/1/2021,IOT,Selangor,0,0,0,British Indian Ocean Territory
29615,6/1/2021,IRL,Johor,0,0,0,Ireland
29616,6/1/2021,IRL,Kedah,0,0,0,Ireland
29617,6/1/2021,IRL,Kelantan,0,0,0,Ireland
29618,6/1/2021,IRL,Negeri Sembilan,0,0,0,Ireland
29619,6/1/2021,IRL,Pahang,0,0,0,Ireland
29620,6/1/2021,IRL,Perak,0,0,0,Ireland
29621,6/1/2021,IRL,Perlis,0,0,0,Ireland
29622,6/1/2021,IRL,Pulau Pinang,0,0,0,Ireland
29623,6/1/2021,IRL,Sabah,0,0,0,Ireland
29624,6/1/2021,IRL,Sarawak,0,0,0,Ireland
29625,6/1/2021,IRL,Selangor,6,4,2,Ireland
29626,6/1/2021,IRL,Terengganu,0,0,0,Ireland
29627,6/1/2021,IRL,W.P. Labuan,0,0,0,Ireland
29628,6/1/2021,IRN,Johor,0,0,0,Iran
29629,6/1/2021,IRN,Kedah,0,0,0,Iran
29630,6/1/2021,IRN,Kelantan,0,0,0,Iran
29631,6/1/2021,IRN,Perak,0,0,0,Iran
29632,6/1/2021,IRN,Perlis,0,0,0,Iran
29633,6/1/2021,IRN,Pulau Pinang,0,0,0,Iran
29634,6/1/2021,IRN,Sabah,0,0,0,Iran
29635,6/1/2021,IRN,Sarawak,0,0,0,Iran
29636,6/1/2021,IRN,Selangor,15,10,5,Iran
29637,6/1/2021,IRN,W.P. Labuan,0,0,0,Iran
29638,6/1/2021,IRQ,Johor,0,0,0,Iraq
29639,6/1/2021,IRQ,Kedah,0,0,0,Iraq
29640,6/1/2021,IRQ,Kelantan,0,0,0,Iraq
29641,6/1/2021,IRQ,Melaka,0,0,0,Iraq
29642,6/1/2021,IRQ,Pahang,0,0,0,Iraq
29643,6/1/2021,IRQ,Perak,0,0,0,Iraq
29644,6/1/2021,IRQ,Perlis,0,0,0,Iraq
29645,6/1/2021,IRQ,Pulau Pinang,0,0,0,Iraq
29646,6/1/2021,IRQ,Sabah,0,0,0,Iraq
29647,6/1/2021,IRQ,Sarawak,0,0,0,Iraq
29648,6/1/2021,IRQ,Selangor,25,15,10,Iraq
29649,6/1/2021,ISL,Johor,0,0,0,Iceland
29650,6/1/2021,ISL,Kedah,0,0,0,Iceland
29651,6/1/2021,ISL,Kelantan,0,0,0,Iceland
29652,6/1/2021,ISL,Perak,0,0,0,Iceland
29653,6/1/2021,ISL,Perlis,0,0,0,Iceland
29654,6/1/2021,ISL,Pulau Pinang,0,0,0,Iceland
29655,6/1/2021,ISL,Sabah,0,0,0,Iceland
29656,6/1/2021,ISL,Sarawak,0,0,0,Iceland
29657,6/1/2021,ISL,Selangor,0,0,0,Iceland
29658,6/1/2021,ISL,W.P. Labuan,0,0,0,Iceland
29659,6/1/2021,ISR,Pulau Pinang,0,0,0,Israel
29660,6/1/2021,ITA,Johor,0,0,0,Italy
29661,6/1/2021,ITA,Kedah,0,0,0,Italy
29662,6/1/2021,ITA,Kelantan,0,0,0,Italy
29663,6/1/2021,ITA,Melaka,0,0,0,Italy
29664,6/1/2021,ITA,Negeri Sembilan,0,0,0,Italy
29665,6/1/2021,ITA,Pahang,0,0,0,Italy
29666,6/1/2021,ITA,Perak,0,0,0,Italy
29667,6/1/2021,ITA,Perlis,0,0,0,Italy
29668,6/1/2021,ITA,Pulau Pinang,0,0,0,Italy
29669,6/1/2021,ITA,Sabah,0,0,0,Italy
29670,6/1/2021,ITA,Sarawak,0,0,0,Italy
29671,6/1/2021,ITA,Selangor,31,29,2,Italy
29672,6/1/2021,ITA,W.P. Labuan,0,0,0,Italy
29673,6/1/2021,JAM,Johor,0,0,0,Jamaica
29674,6/1/2021,JAM,Kedah,0,0,0,Jamaica
29675,6/1/2021,JAM,Perak,0,0,0,Jamaica
29676,6/1/2021,JAM,Pulau Pinang,0,0,0,Jamaica
29677,6/1/2021,JAM,Sabah,0,0,0,Jamaica
29678,6/1/2021,JAM,Sarawak,0,0,0,Jamaica
29679,6/1/2021,JAM,Selangor,0,0,0,Jamaica
29680,6/1/2021,JAM,W.P. Labuan,0,0,0,Jamaica
29681,6/1/2021,JOR,Johor,0,0,0,Jordan
29682,6/1/2021,JOR,Kedah,0,0,0,Jordan
29683,6/1/2021,JOR,Kelantan,0,0,0,Jordan
29684,6/1/2021,JOR,Melaka,0,0,0,Jordan
29685,6/1/2021,JOR,Perlis,0,0,0,Jordan
29686,6/1/2021,JOR,Pulau Pinang,0,0,0,Jordan
29687,6/1/2021,JOR,Sabah,0,0,0,Jordan
29688,6/1/2021,JOR,Sarawak,0,0,0,Jordan
29689,6/1/2021,JOR,Selangor,13,11,2,Jordan
29690,6/1/2021,JOR,W.P. Labuan,0,0,0,Jordan
29691,6/1/2021,JPN,Johor,0,0,0,Japan
29692,6/1/2021,JPN,Kedah,0,0,0,Japan
29693,6/1/2021,JPN,Kelantan,0,0,0,Japan
29694,6/1/2021,JPN,Melaka,0,0,0,Japan
29695,6/1/2021,JPN,Negeri Sembilan,0,0,0,Japan
29696,6/1/2021,JPN,Pahang,0,0,0,Japan
29697,6/1/2021,JPN,Perak,0,0,0,Japan
29698,6/1/2021,JPN,Perlis,0,0,0,Japan
29699,6/1/2021,JPN,Pulau Pinang,13,12,1,Japan
29700,6/1/2021,JPN,Sabah,0,0,0,Japan
29701,6/1/2021,JPN,Sarawak,2,1,1,Japan
29702,6/1/2021,JPN,Selangor,297,195,102,Japan
29703,6/1/2021,JPN,W.P. Labuan,0,0,0,Japan
29704,6/1/2021,KAZ,Johor,0,0,0,Kazakhstan
29705,6/1/2021,KAZ,Kedah,0,0,0,Kazakhstan
29706,6/1/2021,KAZ,Kelantan,0,0,0,Kazakhstan
29707,6/1/2021,KAZ,Melaka,0,0,0,Kazakhstan
29708,6/1/2021,KAZ,Perak,0,0,0,Kazakhstan
29709,6/1/2021,KAZ,Perlis,0,0,0,Kazakhstan
29710,6/1/2021,KAZ,Pulau Pinang,0,0,0,Kazakhstan
29711,6/1/2021,KAZ,Sabah,0,0,0,Kazakhstan
29712,6/1/2021,KAZ,Sarawak,0,0,0,Kazakhstan
29713,6/1/2021,KAZ,Selangor,28,21,7,Kazakhstan
29714,6/1/2021,KAZ,W.P. Labuan,0,0,0,Kazakhstan
29715,6/1/2021,KEN,Johor,0,0,0,Kenya
29716,6/1/2021,KEN,Kedah,0,0,0,Kenya
29717,6/1/2021,KEN,Kelantan,0,0,0,Kenya
29718,6/1/2021,KEN,Perak,0,0,0,Kenya
29719,6/1/2021,KEN,Perlis,0,0,0,Kenya
29720,6/1/2021,KEN,Pulau Pinang,0,0,0,Kenya
29721,6/1/2021,KEN,Sabah,0,0,0,Kenya
29722,6/1/2021,KEN,Sarawak,0,0,0,Kenya
29723,6/1/2021,KEN,Selangor,6,4,2,Kenya
29724,6/1/2021,KGZ,Johor,0,0,0,Kyrgyzstan
29725,6/1/2021,KGZ,Kedah,0,0,0,Kyrgyzstan
29726,6/1/2021,KGZ,Kelantan,0,0,0,Kyrgyzstan
29727,6/1/2021,KGZ,Perak,0,0,0,Kyrgyzstan
29728,6/1/2021,KGZ,Perlis,0,0,0,Kyrgyzstan
29729,6/1/2021,KGZ,Pulau Pinang,0,0,0,Kyrgyzstan
29730,6/1/2021,KGZ,Sabah,0,0,0,Kyrgyzstan
29731,6/1/2021,KGZ,Sarawak,0,0,0,Kyrgyzstan
29732,6/1/2021,KGZ,Selangor,3,2,1,Kyrgyzstan
29733,6/1/2021,KHM,Johor,0,0,0,Cambodia
29734,6/1/2021,KHM,Kedah,0,0,0,Cambodia
29735,6/1/2021,KHM,Kelantan,0,0,0,Cambodia
29736,6/1/2021,KHM,Melaka,0,0,0,Cambodia
29737,6/1/2021,KHM,Negeri Sembilan,0,0,0,Cambodia
29738,6/1/2021,KHM,Pahang,0,0,0,Cambodia
29739,6/1/2021,KHM,Perak,0,0,0,Cambodia
29740,6/1/2021,KHM,Perlis,0,0,0,Cambodia
29741,6/1/2021,KHM,Pulau Pinang,0,0,0,Cambodia
29742,6/1/2021,KHM,Sabah,0,0,0,Cambodia
29743,6/1/2021,KHM,Sarawak,0,0,0,Cambodia
29744,6/1/2021,KHM,Selangor,9,9,0,Cambodia
29745,6/1/2021,KHM,W.P. Labuan,0,0,0,Cambodia
29746,6/1/2021,KIR,Johor,0,0,0,Kiribati
29747,6/1/2021,KIR,Sabah,0,0,0,Kiribati
29748,6/1/2021,KIR,Selangor,5,5,0,Kiribati
29749,6/1/2021,KNA,Johor,0,0,0,Saint Kitts and Nevis
29750,6/1/2021,KNA,Kedah,0,0,0,Saint Kitts and Nevis
29751,6/1/2021,KNA,Perlis,0,0,0,Saint Kitts and Nevis
29752,6/1/2021,KNA,Pulau Pinang,0,0,0,Saint Kitts and Nevis
29753,6/1/2021,KNA,Sabah,0,0,0,Saint Kitts and Nevis
29754,6/1/2021,KNA,Selangor,0,0,0,Saint Kitts and Nevis
29755,6/1/2021,KNA,W.P. Labuan,0,0,0,Saint Kitts and Nevis
29756,6/1/2021,KOR,Johor,0,0,0,"Korea, Republic of (South Korea)"
29757,6/1/2021,KOR,Kedah,0,0,0,"Korea, Republic of (South Korea)"
29758,6/1/2021,KOR,Kelantan,0,0,0,"Korea, Republic of (South Korea)"
29759,6/1/2021,KOR,Melaka,0,0,0,"Korea, Republic of (South Korea)"
29760,6/1/2021,KOR,Negeri Sembilan,0,0,0,"Korea, Republic of (South Korea)"
29761,6/1/2021,KOR,Pahang,0,0,0,"Korea, Republic of (South Korea)"
29762,6/1/2021,KOR,Perak,0,0,0,"Korea, Republic of (South Korea)"
29763,6/1/2021,KOR,Perlis,0,0,0,"Korea, Republic of (South Korea)"
29764,6/1/2021,KOR,Pulau Pinang,0,0,0,"Korea, Republic of (South Korea)"
29765,6/1/2021,KOR,Sabah,0,0,0,"Korea, Republic of (South Korea)"
29766,6/1/2021,KOR,Sarawak,15,12,3,"Korea, Republic of (South Korea)"
29767,6/1/2021,KOR,Selangor,199,151,48,"Korea, Republic of (South Korea)"
29768,6/1/2021,KOR,Terengganu,0,0,0,"Korea, Republic of (South Korea)"
29769,6/1/2021,KOR,W.P. Labuan,0,0,0,"Korea, Republic of (South Korea)"
29770,6/1/2021,KWT,Johor,0,0,0,Kuwait
29771,6/1/2021,KWT,Kedah,0,0,0,Kuwait
29772,6/1/2021,KWT,Kelantan,0,0,0,Kuwait
29773,6/1/2021,KWT,Perak,0,0,0,Kuwait
29774,6/1/2021,KWT,Perlis,0,0,0,Kuwait
29775,6/1/2021,KWT,Pulau Pinang,0,0,0,Kuwait
29776,6/1/2021,KWT,Sabah,0,0,0,Kuwait
29777,6/1/2021,KWT,Sarawak,0,0,0,Kuwait
29778,6/1/2021,KWT,Selangor,2,2,0,Kuwait
29779,6/1/2021,KWT,W.P. Labuan,0,0,0,Kuwait
29780,6/1/2021,LAO,Johor,0,0,0,Lao People's Democratic Republic
29781,6/1/2021,LAO,Kedah,0,0,0,Lao People's Democratic Republic
29782,6/1/2021,LAO,Kelantan,0,0,0,Lao People's Democratic Republic
29783,6/1/2021,LAO,Melaka,0,0,0,Lao People's Democratic Republic
29784,6/1/2021,LAO,Perak,0,0,0,Lao People's Democratic Republic
29785,6/1/2021,LAO,Perlis,0,0,0,Lao People's Democratic Republic
29786,6/1/2021,LAO,Pulau Pinang,0,0,0,Lao People's Democratic Republic
29787,6/1/2021,LAO,Sabah,0,0,0,Lao People's Democratic Republic
29788,6/1/2021,LAO,Sarawak,0,0,0,Lao People's Democratic Republic
29789,6/1/2021,LAO,Selangor,86,85,1,Lao People's Democratic Republic
29790,6/1/2021,LAO,W.P. Labuan,0,0,0,Lao People's Democratic Republic
29791,6/1/2021,LBN,Johor,0,0,0,Lebanon
29792,6/1/2021,LBN,Kedah,0,0,0,Lebanon
29793,6/1/2021,LBN,Kelantan,0,0,0,Lebanon
29794,6/1/2021,LBN,Pahang,0,0,0,Lebanon
29795,6/1/2021,LBN,Perak,0,0,0,Lebanon
29796,6/1/2021,LBN,Perlis,0,0,0,Lebanon
29797,6/1/2021,LBN,Pulau Pinang,0,0,0,Lebanon
29798,6/1/2021,LBN,Sabah,0,0,0,Lebanon
29799,6/1/2021,LBN,Sarawak,0,0,0,Lebanon
29800,6/1/2021,LBN,Selangor,4,2,2,Lebanon
29801,6/1/2021,LBN,W.P. Labuan,0,0,0,Lebanon
29802,6/1/2021,LBR,Johor,0,0,0,Liberia
29803,6/1/2021,LBR,Kedah,0,0,0,Liberia
29804,6/1/2021,LBR,Sabah,0,0,0,Liberia
29805,6/1/2021,LBR,Sarawak,0,0,0,Liberia
29806,6/1/2021,LBR,Selangor,0,0,0,Liberia
29807,6/1/2021,LBY,Johor,0,0,0,Libyan Arab Jamahiriya
29808,6/1/2021,LBY,Kedah,0,0,0,Libyan Arab Jamahiriya
29809,6/1/2021,LBY,Perlis,0,0,0,Libyan Arab Jamahiriya
29810,6/1/2021,LBY,Pulau Pinang,0,0,0,Libyan Arab Jamahiriya
29811,6/1/2021,LBY,Sabah,0,0,0,Libyan Arab Jamahiriya
29812,6/1/2021,LBY,Sarawak,0,0,0,Libyan Arab Jamahiriya
29813,6/1/2021,LBY,Selangor,26,18,8,Libyan Arab Jamahiriya
29814,6/1/2021,LCA,Johor,0,0,0,Saint Lucia
29815,6/1/2021,LCA,Kedah,0,0,0,Saint Lucia
29816,6/1/2021,LCA,Pulau Pinang,0,0,0,Saint Lucia
29817,6/1/2021,LCA,Sarawak,0,0,0,Saint Lucia
29818,6/1/2021,LCA,Selangor,0,0,0,Saint Lucia
29819,6/1/2021,LIE,Johor,0,0,0,Liechtenstein
29820,6/1/2021,LIE,Kedah,0,0,0,Liechtenstein
29821,6/1/2021,LIE,Perlis,0,0,0,Liechtenstein
29822,6/1/2021,LIE,Pulau Pinang,0,0,0,Liechtenstein
29823,6/1/2021,LIE,Sabah,0,0,0,Liechtenstein
29824,6/1/2021,LIE,Sarawak,0,0,0,Liechtenstein
29825,6/1/2021,LIE,Selangor,0,0,0,Liechtenstein
29826,6/1/2021,LKA,Johor,0,0,0,Sri Lanka
29827,6/1/2021,LKA,Kedah,0,0,0,Sri Lanka
29828,6/1/2021,LKA,Kelantan,0,0,0,Sri Lanka
29829,6/1/2021,LKA,Melaka,0,0,0,Sri Lanka
29830,6/1/2021,LKA,Pahang,0,0,0,Sri Lanka
29831,6/1/2021,LKA,Perak,0,0,0,Sri Lanka
29832,6/1/2021,LKA,Perlis,0,0,0,Sri Lanka
29833,6/1/2021,LKA,Pulau Pinang,0,0,0,Sri Lanka
29834,6/1/2021,LKA,Sabah,0,0,0,Sri Lanka
29835,6/1/2021,LKA,Sarawak,0,0,0,Sri Lanka
29836,6/1/2021,LKA,Selangor,3,2,1,Sri Lanka
29837,6/1/2021,LKA,W.P. Labuan,0,0,0,Sri Lanka
29838,6/1/2021,LSO,Johor,0,0,0,Lesotho
29839,6/1/2021,LSO,Kedah,0,0,0,Lesotho
29840,6/1/2021,LSO,Pulau Pinang,0,0,0,Lesotho
29841,6/1/2021,LSO,Sarawak,0,0,0,Lesotho
29842,6/1/2021,LSO,Selangor,0,0,0,Lesotho
29843,6/1/2021,LTU,Johor,0,0,0,Lithuania
29844,6/1/2021,LTU,Kedah,0,0,0,Lithuania
29845,6/1/2021,LTU,Kelantan,0,0,0,Lithuania
29846,6/1/2021,LTU,Pahang,0,0,0,Lithuania
29847,6/1/2021,LTU,Perak,0,0,0,Lithuania
29848,6/1/2021,LTU,Perlis,0,0,0,Lithuania
29849,6/1/2021,LTU,Pulau Pinang,0,0,0,Lithuania
29850,6/1/2021,LTU,Sabah,0,0,0,Lithuania
29851,6/1/2021,LTU,Sarawak,0,0,0,Lithuania
29852,6/1/2021,LTU,Selangor,1,0,1,Lithuania
29853,6/1/2021,LTU,W.P. Labuan,0,0,0,Lithuania
29854,6/1/2021,LUX,Johor,0,0,0,Luxembourg
29855,6/1/2021,LUX,Kedah,0,0,0,Luxembourg
29856,6/1/2021,LUX,Kelantan,0,0,0,Luxembourg
29857,6/1/2021,LUX,Perak,0,0,0,Luxembourg
29858,6/1/2021,LUX,Perlis,0,0,0,Luxembourg
29859,6/1/2021,LUX,Pulau Pinang,0,0,0,Luxembourg
29860,6/1/2021,LUX,Sabah,0,0,0,Luxembourg
29861,6/1/2021,LUX,Sarawak,0,0,0,Luxembourg
29862,6/1/2021,LUX,Selangor,0,0,0,Luxembourg
29863,6/1/2021,LVA,Johor,0,0,0,Latvia
29864,6/1/2021,LVA,Kedah,0,0,0,Latvia
29865,6/1/2021,LVA,Kelantan,0,0,0,Latvia
29866,6/1/2021,LVA,Pahang,0,0,0,Latvia
29867,6/1/2021,LVA,Perak,0,0,0,Latvia
29868,6/1/2021,LVA,Perlis,0,0,0,Latvia
29869,6/1/2021,LVA,Pulau Pinang,0,0,0,Latvia
29870,6/1/2021,LVA,Sabah,0,0,0,Latvia
29871,6/1/2021,LVA,Sarawak,0,0,0,Latvia
29872,6/1/2021,LVA,Selangor,2,2,0,Latvia
29873,6/1/2021,LVA,W.P. Labuan,0,0,0,Latvia
29874,6/1/2021,MAC,Johor,0,0,0,Macao
29875,6/1/2021,MAC,Pahang,0,0,0,Macao
29876,6/1/2021,MAC,Perak,0,0,0,Macao
29877,6/1/2021,MAC,Selangor,0,0,0,Macao
29878,6/1/2021,MAC,W.P. Labuan,0,0,0,Macao
29879,6/1/2021,MAR,Johor,0,0,0,Morocco
29880,6/1/2021,MAR,Kedah,0,0,0,Morocco
29881,6/1/2021,MAR,Kelantan,0,0,0,Morocco
29882,6/1/2021,MAR,Melaka,0,0,0,Morocco
29883,6/1/2021,MAR,Pahang,0,0,0,Morocco
29884,6/1/2021,MAR,Perak,0,0,0,Morocco
29885,6/1/2021,MAR,Perlis,0,0,0,Morocco
29886,6/1/2021,MAR,Pulau Pinang,0,0,0,Morocco
29887,6/1/2021,MAR,Sabah,0,0,0,Morocco
29888,6/1/2021,MAR,Sarawak,0,0,0,Morocco
29889,6/1/2021,MAR,Selangor,6,3,3,Morocco
29890,6/1/2021,MAR,W.P. Labuan,0,0,0,Morocco
29891,6/1/2021,MCO,Johor,0,0,0,Monaco
29892,6/1/2021,MCO,Kedah,0,0,0,Monaco
29893,6/1/2021,MCO,Sabah,0,0,0,Monaco
29894,6/1/2021,MCO,Selangor,0,0,0,Monaco
29895,6/1/2021,MDA,Johor,0,0,0,"Moldova, Republic of"
29896,6/1/2021,MDA,Kedah,0,0,0,"Moldova, Republic of"
29897,6/1/2021,MDA,Kelantan,0,0,0,"Moldova, Republic of"
29898,6/1/2021,MDA,Negeri Sembilan,0,0,0,"Moldova, Republic of"
29899,6/1/2021,MDA,Perlis,0,0,0,"Moldova, Republic of"
29900,6/1/2021,MDA,Pulau Pinang,0,0,0,"Moldova, Republic of"
29901,6/1/2021,MDA,Sabah,0,0,0,"Moldova, Republic of"
29902,6/1/2021,MDA,Sarawak,0,0,0,"Moldova, Republic of"
29903,6/1/2021,MDA,Selangor,0,0,0,"Moldova, Republic of"
29904,6/1/2021,MDG,Johor,0,0,0,Madagascar
29905,6/1/2021,MDG,Kedah,0,0,0,Madagascar
29906,6/1/2021,MDG,Perak,0,0,0,Madagascar
29907,6/1/2021,MDG,Perlis,0,0,0,Madagascar
29908,6/1/2021,MDG,Pulau Pinang,0,0,0,Madagascar
29909,6/1/2021,MDG,Sabah,0,0,0,Madagascar
29910,6/1/2021,MDG,Sarawak,0,0,0,Madagascar
29911,6/1/2021,MDG,Selangor,0,0,0,Madagascar
29912,6/1/2021,MDV,Johor,0,0,0,Maldives
29913,6/1/2021,MDV,Kedah,0,0,0,Maldives
29914,6/1/2021,MDV,Kelantan,0,0,0,Maldives
29915,6/1/2021,MDV,Perak,0,0,0,Maldives
29916,6/1/2021,MDV,Perlis,0,0,0,Maldives
29917,6/1/2021,MDV,Pulau Pinang,0,0,0,Maldives
29918,6/1/2021,MDV,Sabah,0,0,0,Maldives
29919,6/1/2021,MDV,Sarawak,0,0,0,Maldives
29920,6/1/2021,MDV,Selangor,24,12,12,Maldives
29921,6/1/2021,MEX,Johor,0,0,0,Mexico
29922,6/1/2021,MEX,Kedah,0,0,0,Mexico
29923,6/1/2021,MEX,Kelantan,0,0,0,Mexico
29924,6/1/2021,MEX,Pahang,0,0,0,Mexico
29925,6/1/2021,MEX,Perak,0,0,0,Mexico
29926,6/1/2021,MEX,Perlis,0,0,0,Mexico
29927,6/1/2021,MEX,Pulau Pinang,0,0,0,Mexico
29928,6/1/2021,MEX,Sabah,0,0,0,Mexico
29929,6/1/2021,MEX,Sarawak,0,0,0,Mexico
29930,6/1/2021,MEX,Selangor,10,8,2,Mexico
29931,6/1/2021,MEX,W.P. Labuan,0,0,0,Mexico
29932,6/1/2021,MHL,Johor,0,0,0,Marshall Islands
29933,6/1/2021,MHL,Kedah,0,0,0,Marshall Islands
29934,6/1/2021,MHL,Perak,0,0,0,Marshall Islands
29935,6/1/2021,MHL,Pulau Pinang,0,0,0,Marshall Islands
29936,6/1/2021,MHL,Sabah,0,0,0,Marshall Islands
29937,6/1/2021,MHL,Selangor,0,0,0,Marshall Islands
29938,6/1/2021,MKD,Johor,0,0,0,"Macedonia, the former Yugoslav Republic of"
29939,6/1/2021,MKD,Kedah,0,0,0,"Macedonia, the former Yugoslav Republic of"
29940,6/1/2021,MKD,Perak,0,0,0,"Macedonia, the former Yugoslav Republic of"
29941,6/1/2021,MKD,Pulau Pinang,0,0,0,"Macedonia, the former Yugoslav Republic of"
29942,6/1/2021,MKD,Sabah,0,0,0,"Macedonia, the former Yugoslav Republic of"
29943,6/1/2021,MKD,Sarawak,0,0,0,"Macedonia, the former Yugoslav Republic of"
29944,6/1/2021,MKD,Selangor,0,0,0,"Macedonia, the former Yugoslav Republic of"
29945,6/1/2021,MLI,Johor,0,0,0,Mali
29946,6/1/2021,MLI,Sabah,0,0,0,Mali
29947,6/1/2021,MLI,Selangor,0,0,0,Mali
29948,6/1/2021,MLT,Johor,0,0,0,Malta
29949,6/1/2021,MLT,Kedah,0,0,0,Malta
29950,6/1/2021,MLT,Kelantan,0,0,0,Malta
29951,6/1/2021,MLT,Perak,0,0,0,Malta
29952,6/1/2021,MLT,Perlis,0,0,0,Malta
29953,6/1/2021,MLT,Pulau Pinang,0,0,0,Malta
29954,6/1/2021,MLT,Sabah,0,0,0,Malta
29955,6/1/2021,MLT,Sarawak,0,0,0,Malta
29956,6/1/2021,MLT,Selangor,1,1,0,Malta
29957,6/1/2021,MLT,W.P. Labuan,0,0,0,Malta
29958,6/1/2021,MMR,Johor,2,2,0,Myanmar
29959,6/1/2021,MMR,Kedah,0,0,0,Myanmar
29960,6/1/2021,MMR,Kelantan,0,0,0,Myanmar
29961,6/1/2021,MMR,Negeri Sembilan,0,0,0,Myanmar
29962,6/1/2021,MMR,Pahang,0,0,0,Myanmar
29963,6/1/2021,MMR,Perak,0,0,0,Myanmar
29964,6/1/2021,MMR,Perlis,0,0,0,Myanmar
29965,6/1/2021,MMR,Pulau Pinang,1,0,1,Myanmar
29966,6/1/2021,MMR,Sabah,0,0,0,Myanmar
29967,6/1/2021,MMR,Sarawak,0,0,0,Myanmar
29968,6/1/2021,MMR,Selangor,77,65,12,Myanmar
29969,6/1/2021,MMR,Terengganu,0,0,0,Myanmar
29970,6/1/2021,MMR,W.P. Labuan,0,0,0,Myanmar
29971,6/1/2021,MNE,Johor,0,0,0,Montenegro
29972,6/1/2021,MNE,Kedah,0,0,0,Montenegro
29973,6/1/2021,MNE,Pulau Pinang,0,0,0,Montenegro
29974,6/1/2021,MNE,Sabah,0,0,0,Montenegro
29975,6/1/2021,MNE,Sarawak,0,0,0,Montenegro
29976,6/1/2021,MNE,Selangor,3,3,0,Montenegro
29977,6/1/2021,MNG,Johor,0,0,0,Mongolia
29978,6/1/2021,MNG,Kedah,0,0,0,Mongolia
29979,6/1/2021,MNG,Kelantan,0,0,0,Mongolia
29980,6/1/2021,MNG,Perak,0,0,0,Mongolia
29981,6/1/2021,MNG,Perlis,0,0,0,Mongolia
29982,6/1/2021,MNG,Pulau Pinang,0,0,0,Mongolia
29983,6/1/2021,MNG,Sabah,0,0,0,Mongolia
29984,6/1/2021,MNG,Sarawak,0,0,0,Mongolia
29985,6/1/2021,MNG,Selangor,1,0,1,Mongolia
29986,6/1/2021,MNP,Selangor,0,0,0,Northern Mariana Islands
29987,6/1/2021,MOZ,Johor,0,0,0,Mozambique
29988,6/1/2021,MOZ,Kedah,0,0,0,Mozambique
29989,6/1/2021,MOZ,Perak,0,0,0,Mozambique
29990,6/1/2021,MOZ,Pulau Pinang,0,0,0,Mozambique
29991,6/1/2021,MOZ,Sabah,0,0,0,Mozambique
29992,6/1/2021,MOZ,Sarawak,0,0,0,Mozambique
29993,6/1/2021,MOZ,Selangor,6,3,3,Mozambique
29994,6/1/2021,MRT,Johor,0,0,0,Mauritania
29995,6/1/2021,MRT,Kedah,0,0,0,Mauritania
29996,6/1/2021,MRT,Pulau Pinang,0,0,0,Mauritania
29997,6/1/2021,MRT,Sabah,0,0,0,Mauritania
29998,6/1/2021,MRT,Sarawak,0,0,0,Mauritania
29999,6/1/2021,MRT,Selangor,0,0,0,Mauritania
30000,6/1/2021,MUS,Johor,0,0,0,Mauritius
30001,6/1/2021,MUS,Kedah,0,0,0,Mauritius
30002,6/1/2021,MUS,Kelantan,0,0,0,Mauritius
30003,6/1/2021,MUS,Pahang,0,0,0,Mauritius
30004,6/1/2021,MUS,Perak,0,0,0,Mauritius
30005,6/1/2021,MUS,Perlis,0,0,0,Mauritius
30006,6/1/2021,MUS,Pulau Pinang,0,0,0,Mauritius
30007,6/1/2021,MUS,Sabah,0,0,0,Mauritius
30008,6/1/2021,MUS,Sarawak,0,0,0,Mauritius
30009,6/1/2021,MUS,Selangor,7,3,4,Mauritius
30010,6/1/2021,MWI,Johor,0,0,0,Malawi
30011,6/1/2021,MWI,Pulau Pinang,0,0,0,Malawi
30012,6/1/2021,MWI,Sabah,0,0,0,Malawi
30013,6/1/2021,MWI,Sarawak,0,0,0,Malawi
30014,6/1/2021,MWI,Selangor,1,0,1,Malawi
30015,6/1/2021,MYT,Selangor,0,0,0,Mayotte
30016,6/1/2021,NAM,Johor,0,0,0,Namibia
30017,6/1/2021,NAM,Kedah,0,0,0,Namibia
30018,6/1/2021,NAM,Perak,0,0,0,Namibia
30019,6/1/2021,NAM,Perlis,0,0,0,Namibia
30020,6/1/2021,NAM,Pulau Pinang,0,0,0,Namibia
30021,6/1/2021,NAM,Sabah,0,0,0,Namibia
30022,6/1/2021,NAM,Sarawak,0,0,0,Namibia
30023,6/1/2021,NAM,Selangor,2,1,1,Namibia
30024,6/1/2021,NCL,Selangor,0,0,0,New Caledonia
30025,6/1/2021,NER,Johor,0,0,0,Niger
30026,6/1/2021,NER,Sabah,0,0,0,Niger
30027,6/1/2021,NER,Selangor,0,0,0,Niger
30028,6/1/2021,NGA,Johor,0,0,0,Nigeria
30029,6/1/2021,NGA,Kedah,0,0,0,Nigeria
30030,6/1/2021,NGA,Perlis,0,0,0,Nigeria
30031,6/1/2021,NGA,Pulau Pinang,0,0,0,Nigeria
30032,6/1/2021,NGA,Sabah,0,0,0,Nigeria
30033,6/1/2021,NGA,Sarawak,0,0,0,Nigeria
30034,6/1/2021,NGA,Selangor,93,81,12,Nigeria
30035,6/1/2021,NIC,Johor,0,0,0,Nicaragua
30036,6/1/2021,NIC,Kedah,0,0,0,Nicaragua
30037,6/1/2021,NIC,Pulau Pinang,0,0,0,Nicaragua
30038,6/1/2021,NIC,Sabah,0,0,0,Nicaragua
30039,6/1/2021,NIC,Selangor,0,0,0,Nicaragua
30040,6/1/2021,NLD,Johor,0,0,0,Netherlands
30041,6/1/2021,NLD,Kedah,0,0,0,Netherlands
30042,6/1/2021,NLD,Kelantan,0,0,0,Netherlands
30043,6/1/2021,NLD,Melaka,0,0,0,Netherlands
30044,6/1/2021,NLD,Negeri Sembilan,0,0,0,Netherlands
30045,6/1/2021,NLD,Pahang,0,0,0,Netherlands
30046,6/1/2021,NLD,Perak,0,0,0,Netherlands
30047,6/1/2021,NLD,Perlis,0,0,0,Netherlands
30048,6/1/2021,NLD,Pulau Pinang,2,2,0,Netherlands
30049,6/1/2021,NLD,Sabah,0,0,0,Netherlands
30050,6/1/2021,NLD,Sarawak,0,0,0,Netherlands
30051,6/1/2021,NLD,Selangor,24,20,4,Netherlands
30052,6/1/2021,NLD,Terengganu,0,0,0,Netherlands
30053,6/1/2021,NLD,W.P. Labuan,0,0,0,Netherlands
30054,6/1/2021,NOR,Johor,0,0,0,Norway
30055,6/1/2021,NOR,Kedah,0,0,0,Norway
30056,6/1/2021,NOR,Kelantan,0,0,0,Norway
30057,6/1/2021,NOR,Melaka,0,0,0,Norway
30058,6/1/2021,NOR,Pahang,0,0,0,Norway
30059,6/1/2021,NOR,Perak,0,0,0,Norway
30060,6/1/2021,NOR,Perlis,0,0,0,Norway
30061,6/1/2021,NOR,Pulau Pinang,0,0,0,Norway
30062,6/1/2021,NOR,Sabah,0,0,0,Norway
30063,6/1/2021,NOR,Sarawak,0,0,0,Norway
30064,6/1/2021,NOR,Selangor,8,8,0,Norway
30065,6/1/2021,NOR,W.P. Labuan,0,0,0,Norway
30066,6/1/2021,NPL,Johor,0,0,0,Nepal
30067,6/1/2021,NPL,Kedah,0,0,0,Nepal
30068,6/1/2021,NPL,Pahang,0,0,0,Nepal
30069,6/1/2021,NPL,Perak,0,0,0,Nepal
30070,6/1/2021,NPL,Perlis,0,0,0,Nepal
30071,6/1/2021,NPL,Pulau Pinang,0,0,0,Nepal
30072,6/1/2021,NPL,Sabah,0,0,0,Nepal
30073,6/1/2021,NPL,Sarawak,0,0,0,Nepal
30074,6/1/2021,NPL,Selangor,1,1,0,Nepal
30075,6/1/2021,NPL,W.P. Labuan,0,0,0,Nepal
30076,6/1/2021,NRU,Johor,0,0,0,Nauru
30077,6/1/2021,NRU,Pulau Pinang,0,0,0,Nauru
30078,6/1/2021,NRU,Selangor,0,0,0,Nauru
30079,6/1/2021,NZL,Johor,0,0,0,New Zealand
30080,6/1/2021,NZL,Kedah,0,0,0,New Zealand
30081,6/1/2021,NZL,Kelantan,0,0,0,New Zealand
30082,6/1/2021,NZL,Melaka,0,0,0,New Zealand
30083,6/1/2021,NZL,Negeri Sembilan,0,0,0,New Zealand
30084,6/1/2021,NZL,Pahang,0,0,0,New Zealand
30085,6/1/2021,NZL,Perak,0,0,0,New Zealand
30086,6/1/2021,NZL,Perlis,0,0,0,New Zealand
30087,6/1/2021,NZL,Pulau Pinang,0,0,0,New Zealand
30088,6/1/2021,NZL,Sabah,0,0,0,New Zealand
30089,6/1/2021,NZL,Sarawak,0,0,0,New Zealand
30090,6/1/2021,NZL,Selangor,20,11,9,New Zealand
30091,6/1/2021,NZL,Terengganu,0,0,0,New Zealand
30092,6/1/2021,NZL,W.P. Labuan,0,0,0,New Zealand
30093,6/1/2021,OMN,Johor,0,0,0,Oman
30094,6/1/2021,OMN,Kedah,0,0,0,Oman
30095,6/1/2021,OMN,Kelantan,0,0,0,Oman
30096,6/1/2021,OMN,Melaka,0,0,0,Oman
30097,6/1/2021,OMN,Perak,0,0,0,Oman
30098,6/1/2021,OMN,Perlis,0,0,0,Oman
30099,6/1/2021,OMN,Pulau Pinang,0,0,0,Oman
30100,6/1/2021,OMN,Sabah,0,0,0,Oman
30101,6/1/2021,OMN,Sarawak,0,0,0,Oman
30102,6/1/2021,OMN,Selangor,0,0,0,Oman
30103,6/1/2021,PAK,Johor,2,2,0,Pakistan
30104,6/1/2021,PAK,Kedah,0,0,0,Pakistan
30105,6/1/2021,PAK,Kelantan,0,0,0,Pakistan
30106,6/1/2021,PAK,Melaka,0,0,0,Pakistan
30107,6/1/2021,PAK,Negeri Sembilan,0,0,0,Pakistan
30108,6/1/2021,PAK,Pahang,0,0,0,Pakistan
30109,6/1/2021,PAK,Perak,0,0,0,Pakistan
30110,6/1/2021,PAK,Perlis,0,0,0,Pakistan
30111,6/1/2021,PAK,Pulau Pinang,0,0,0,Pakistan
30112,6/1/2021,PAK,Sabah,1,1,0,Pakistan
30113,6/1/2021,PAK,Sarawak,0,0,0,Pakistan
30114,6/1/2021,PAK,Selangor,14,8,6,Pakistan
30115,6/1/2021,PAK,W.P. Labuan,0,0,0,Pakistan
30116,6/1/2021,PAN,Johor,0,0,0,Panama
30117,6/1/2021,PAN,Kedah,0,0,0,Panama
30118,6/1/2021,PAN,Perak,0,0,0,Panama
30119,6/1/2021,PAN,Perlis,0,0,0,Panama
30120,6/1/2021,PAN,Pulau Pinang,0,0,0,Panama
30121,6/1/2021,PAN,Sabah,0,0,0,Panama
30122,6/1/2021,PAN,Sarawak,0,0,0,Panama
30123,6/1/2021,PAN,Selangor,0,0,0,Panama
30124,6/1/2021,PER,Johor,0,0,0,Peru
30125,6/1/2021,PER,Kedah,0,0,0,Peru
30126,6/1/2021,PER,Kelantan,0,0,0,Peru
30127,6/1/2021,PER,Pahang,0,0,0,Peru
30128,6/1/2021,PER,Perak,0,0,0,Peru
30129,6/1/2021,PER,Perlis,0,0,0,Peru
30130,6/1/2021,PER,Pulau Pinang,0,0,0,Peru
30131,6/1/2021,PER,Sabah,0,0,0,Peru
30132,6/1/2021,PER,Sarawak,0,0,0,Peru
30133,6/1/2021,PER,Selangor,0,0,0,Peru
30134,6/1/2021,PER,W.P. Labuan,0,0,0,Peru
30135,6/1/2021,PHL,Johor,7,6,1,Philippines
30136,6/1/2021,PHL,Kedah,0,0,0,Philippines
30137,6/1/2021,PHL,Kelantan,0,0,0,Philippines
30138,6/1/2021,PHL,Melaka,0,0,0,Philippines
30139,6/1/2021,PHL,Negeri Sembilan,0,0,0,Philippines
30140,6/1/2021,PHL,Pahang,0,0,0,Philippines
30141,6/1/2021,PHL,Perak,0,0,0,Philippines
30142,6/1/2021,PHL,Perlis,0,0,0,Philippines
30143,6/1/2021,PHL,Pulau Pinang,3,2,1,Philippines
30144,6/1/2021,PHL,Sabah,2,0,2,Philippines
30145,6/1/2021,PHL,Sarawak,52,51,1,Philippines
30146,6/1/2021,PHL,Selangor,337,274,63,Philippines
30147,6/1/2021,PHL,Terengganu,0,0,0,Philippines
30148,6/1/2021,PHL,W.P. Labuan,0,0,0,Philippines
30149,6/1/2021,PLW,Johor,0,0,0,Palau
30150,6/1/2021,PLW,Pulau Pinang,0,0,0,Palau
30151,6/1/2021,PLW,Selangor,0,0,0,Palau
30152,6/1/2021,PNG,Johor,0,0,0,Papua New Guinea
30153,6/1/2021,PNG,Kedah,0,0,0,Papua New Guinea
30154,6/1/2021,PNG,Kelantan,0,0,0,Papua New Guinea
30155,6/1/2021,PNG,Perak,0,0,0,Papua New Guinea
30156,6/1/2021,PNG,Pulau Pinang,0,0,0,Papua New Guinea
30157,6/1/2021,PNG,Sabah,0,0,0,Papua New Guinea
30158,6/1/2021,PNG,Sarawak,0,0,0,Papua New Guinea
30159,6/1/2021,PNG,Selangor,3,2,1,Papua New Guinea
30160,6/1/2021,POL,Johor,0,0,0,Poland
30161,6/1/2021,POL,Kedah,0,0,0,Poland
30162,6/1/2021,POL,Kelantan,0,0,0,Poland
30163,6/1/2021,POL,Melaka,0,0,0,Poland
30164,6/1/2021,POL,Negeri Sembilan,0,0,0,Poland
30165,6/1/2021,POL,Pahang,0,0,0,Poland
30166,6/1/2021,POL,Perak,0,0,0,Poland
30167,6/1/2021,POL,Perlis,0,0,0,Poland
30168,6/1/2021,POL,Pulau Pinang,0,0,0,Poland
30169,6/1/2021,POL,Sabah,0,0,0,Poland
30170,6/1/2021,POL,Sarawak,0,0,0,Poland
30171,6/1/2021,POL,Selangor,14,11,3,Poland
30172,6/1/2021,POL,Terengganu,0,0,0,Poland
30173,6/1/2021,POL,W.P. Labuan,0,0,0,Poland
30174,6/1/2021,PRK,Selangor,0,0,0,"Korea, Democratic People's Republic of"
30175,6/1/2021,PRT,Johor,0,0,0,Portugal
30176,6/1/2021,PRT,Kedah,0,0,0,Portugal
30177,6/1/2021,PRT,Kelantan,0,0,0,Portugal
30178,6/1/2021,PRT,Melaka,0,0,0,Portugal
30179,6/1/2021,PRT,Pahang,0,0,0,Portugal
30180,6/1/2021,PRT,Perak,0,0,0,Portugal
30181,6/1/2021,PRT,Perlis,0,0,0,Portugal
30182,6/1/2021,PRT,Pulau Pinang,0,0,0,Portugal
30183,6/1/2021,PRT,Sabah,0,0,0,Portugal
30184,6/1/2021,PRT,Sarawak,0,0,0,Portugal
30185,6/1/2021,PRT,Selangor,7,4,3,Portugal
30186,6/1/2021,PRT,W.P. Labuan,0,0,0,Portugal
30187,6/1/2021,PRY,Johor,0,0,0,Paraguay
30188,6/1/2021,PRY,Kedah,0,0,0,Paraguay
30189,6/1/2021,PRY,Perak,0,0,0,Paraguay
30190,6/1/2021,PRY,Perlis,0,0,0,Paraguay
30191,6/1/2021,PRY,Pulau Pinang,0,0,0,Paraguay
30192,6/1/2021,PRY,Sabah,0,0,0,Paraguay
30193,6/1/2021,PRY,Sarawak,0,0,0,Paraguay
30194,6/1/2021,PRY,Selangor,0,0,0,Paraguay
30195,6/1/2021,PSE,Johor,0,0,0,"Palestinian Territory, Occupied"
30196,6/1/2021,PSE,Kedah,0,0,0,"Palestinian Territory, Occupied"
30197,6/1/2021,PSE,Kelantan,0,0,0,"Palestinian Territory, Occupied"
30198,6/1/2021,PSE,Melaka,0,0,0,"Palestinian Territory, Occupied"
30199,6/1/2021,PSE,Perak,0,0,0,"Palestinian Territory, Occupied"
30200,6/1/2021,PSE,Perlis,0,0,0,"Palestinian Territory, Occupied"
30201,6/1/2021,PSE,Pulau Pinang,0,0,0,"Palestinian Territory, Occupied"
30202,6/1/2021,PSE,Sabah,0,0,0,"Palestinian Territory, Occupied"
30203,6/1/2021,PSE,Sarawak,0,0,0,"Palestinian Territory, Occupied"
30204,6/1/2021,PSE,Selangor,9,9,0,"Palestinian Territory, Occupied"
30205,6/1/2021,QAT,Johor,0,0,0,Qatar
30206,6/1/2021,QAT,Kedah,0,0,0,Qatar
30207,6/1/2021,QAT,Perlis,0,0,0,Qatar
30208,6/1/2021,QAT,Pulau Pinang,0,0,0,Qatar
30209,6/1/2021,QAT,Sabah,0,0,0,Qatar
30210,6/1/2021,QAT,Sarawak,0,0,0,Qatar
30211,6/1/2021,QAT,Selangor,0,0,0,Qatar
30212,6/1/2021,REU,Johor,0,0,0,Reunion
30213,6/1/2021,REU,Sarawak,0,0,0,Reunion
30214,6/1/2021,ROU,Johor,0,0,0,Romania
30215,6/1/2021,ROU,Kedah,0,0,0,Romania
30216,6/1/2021,ROU,Kelantan,0,0,0,Romania
30217,6/1/2021,ROU,Negeri Sembilan,0,0,0,Romania
30218,6/1/2021,ROU,Pahang,0,0,0,Romania
30219,6/1/2021,ROU,Perak,0,0,0,Romania
30220,6/1/2021,ROU,Perlis,0,0,0,Romania
30221,6/1/2021,ROU,Pulau Pinang,0,0,0,Romania
30222,6/1/2021,ROU,Sabah,0,0,0,Romania
30223,6/1/2021,ROU,Sarawak,0,0,0,Romania
30224,6/1/2021,ROU,Selangor,17,16,1,Romania
30225,6/1/2021,ROU,W.P. Labuan,0,0,0,Romania
30226,6/1/2021,RUS,Johor,0,0,0,Russia
30227,6/1/2021,RUS,Kedah,0,0,0,Russia
30228,6/1/2021,RUS,Kelantan,0,0,0,Russia
30229,6/1/2021,RUS,Melaka,0,0,0,Russia
30230,6/1/2021,RUS,Negeri Sembilan,0,0,0,Russia
30231,6/1/2021,RUS,Pahang,0,0,0,Russia
30232,6/1/2021,RUS,Perak,0,0,0,Russia
30233,6/1/2021,RUS,Perlis,0,0,0,Russia
30234,6/1/2021,RUS,Pulau Pinang,0,0,0,Russia
30235,6/1/2021,RUS,Sabah,0,0,0,Russia
30236,6/1/2021,RUS,Sarawak,0,0,0,Russia
30237,6/1/2021,RUS,Selangor,77,67,10,Russia
30238,6/1/2021,RUS,W.P. Labuan,0,0,0,Russia
30239,6/1/2021,RWA,Johor,0,0,0,Rwanda
30240,6/1/2021,RWA,Kedah,0,0,0,Rwanda
30241,6/1/2021,RWA,Pulau Pinang,0,0,0,Rwanda
30242,6/1/2021,RWA,Selangor,0,0,0,Rwanda
30243,6/1/2021,SAU,Johor,0,0,0,Saudi Arabia
30244,6/1/2021,SAU,Kedah,0,0,0,Saudi Arabia
30245,6/1/2021,SAU,Kelantan,0,0,0,Saudi Arabia
30246,6/1/2021,SAU,Melaka,0,0,0,Saudi Arabia
30247,6/1/2021,SAU,Perak,0,0,0,Saudi Arabia
30248,6/1/2021,SAU,Perlis,0,0,0,Saudi Arabia
30249,6/1/2021,SAU,Pulau Pinang,0,0,0,Saudi Arabia
30250,6/1/2021,SAU,Sabah,0,0,0,Saudi Arabia
30251,6/1/2021,SAU,Sarawak,0,0,0,Saudi Arabia
30252,6/1/2021,SAU,Selangor,47,33,14,Saudi Arabia
30253,6/1/2021,SAU,W.P. Labuan,0,0,0,Saudi Arabia
30254,6/1/2021,SDN,Johor,0,0,0,Sudan
30255,6/1/2021,SDN,Kedah,0,0,0,Sudan
30256,6/1/2021,SDN,Kelantan,0,0,0,Sudan
30257,6/1/2021,SDN,Perlis,0,0,0,Sudan
30258,6/1/2021,SDN,Pulau Pinang,0,0,0,Sudan
30259,6/1/2021,SDN,Sabah,0,0,0,Sudan
30260,6/1/2021,SDN,Sarawak,0,0,0,Sudan
30261,6/1/2021,SDN,Selangor,30,23,7,Sudan
30262,6/1/2021,SDN,W.P. Labuan,0,0,0,Sudan
30263,6/1/2021,SEN,Johor,0,0,0,Senegal
30264,6/1/2021,SEN,Kedah,0,0,0,Senegal
30265,6/1/2021,SEN,Kelantan,0,0,0,Senegal
30266,6/1/2021,SEN,Perak,0,0,0,Senegal
30267,6/1/2021,SEN,Perlis,0,0,0,Senegal
30268,6/1/2021,SEN,Pulau Pinang,0,0,0,Senegal
30269,6/1/2021,SEN,Sabah,0,0,0,Senegal
30270,6/1/2021,SEN,Sarawak,0,0,0,Senegal
30271,6/1/2021,SEN,Selangor,3,1,2,Senegal
30272,6/1/2021,SGP,Johor,72,61,11,Singapore
30273,6/1/2021,SGP,Kedah,1,1,0,Singapore
30274,6/1/2021,SGP,Kelantan,0,0,0,Singapore
30275,6/1/2021,SGP,Melaka,0,0,0,Singapore
30276,6/1/2021,SGP,Negeri Sembilan,0,0,0,Singapore
30277,6/1/2021,SGP,Pahang,0,0,0,Singapore
30278,6/1/2021,SGP,Perak,1,1,0,Singapore
30279,6/1/2021,SGP,Perlis,1,1,0,Singapore
30280,6/1/2021,SGP,Pulau Pinang,5,1,4,Singapore
30281,6/1/2021,SGP,Sabah,0,0,0,Singapore
30282,6/1/2021,SGP,Sarawak,5,4,1,Singapore
30283,6/1/2021,SGP,Selangor,82,54,28,Singapore
30284,6/1/2021,SGP,Terengganu,0,0,0,Singapore
30285,6/1/2021,SGP,W.P. Labuan,0,0,0,Singapore
30286,6/1/2021,SGS,Johor,0,0,0,South Georgia and the South Sandwich Islands
30287,6/1/2021,SGS,Sabah,0,0,0,South Georgia and the South Sandwich Islands
30288,6/1/2021,SGS,Selangor,0,0,0,South Georgia and the South Sandwich Islands
30289,6/1/2021,SHN,Sarawak,0,0,0,"Saint Helena, Ascension and Tristan da Cunha"
30290,6/1/2021,SLB,Johor,0,0,0,Solomon Islands
30291,6/1/2021,SLB,Perlis,0,0,0,Solomon Islands
30292,6/1/2021,SLB,Pulau Pinang,0,0,0,Solomon Islands
30293,6/1/2021,SLB,Sabah,0,0,0,Solomon Islands
30294,6/1/2021,SLB,Sarawak,0,0,0,Solomon Islands
30295,6/1/2021,SLB,Selangor,0,0,0,Solomon Islands
30296,6/1/2021,SLB,W.P. Labuan,0,0,0,Solomon Islands
30297,6/1/2021,SLE,Johor,0,0,0,Sierra Leone
30298,6/1/2021,SLE,Kedah,0,0,0,Sierra Leone
30299,6/1/2021,SLE,Perak,0,0,0,Sierra Leone
30300,6/1/2021,SLE,Pulau Pinang,0,0,0,Sierra Leone
30301,6/1/2021,SLE,Sabah,0,0,0,Sierra Leone
30302,6/1/2021,SLE,Selangor,0,0,0,Sierra Leone
30303,6/1/2021,SLV,Johor,0,0,0,El Salvador
30304,6/1/2021,SLV,Kedah,0,0,0,El Salvador
30305,6/1/2021,SLV,Perak,0,0,0,El Salvador
30306,6/1/2021,SLV,Perlis,0,0,0,El Salvador
30307,6/1/2021,SLV,Pulau Pinang,0,0,0,El Salvador
30308,6/1/2021,SLV,Sabah,0,0,0,El Salvador
30309,6/1/2021,SLV,Selangor,1,0,1,El Salvador
30310,6/1/2021,SLV,W.P. Labuan,0,0,0,El Salvador
30311,6/1/2021,SMR,Johor,0,0,0,San Marino
30312,6/1/2021,SMR,Selangor,0,0,0,San Marino
30313,6/1/2021,SOM,Johor,0,0,0,Somalia
30314,6/1/2021,SOM,Kedah,0,0,0,Somalia
30315,6/1/2021,SOM,Kelantan,0,0,0,Somalia
30316,6/1/2021,SOM,Perlis,0,0,0,Somalia
30317,6/1/2021,SOM,Sabah,0,0,0,Somalia
30318,6/1/2021,SOM,Sarawak,0,0,0,Somalia
30319,6/1/2021,SOM,Selangor,9,5,4,Somalia
30320,6/1/2021,SRB,Johor,0,0,0,Serbia
30321,6/1/2021,SRB,Kedah,0,0,0,Serbia
30322,6/1/2021,SRB,Kelantan,0,0,0,Serbia
30323,6/1/2021,SRB,Pahang,0,0,0,Serbia
30324,6/1/2021,SRB,Perak,0,0,0,Serbia
30325,6/1/2021,SRB,Perlis,0,0,0,Serbia
30326,6/1/2021,SRB,Pulau Pinang,0,0,0,Serbia
30327,6/1/2021,SRB,Sabah,0,0,0,Serbia
30328,6/1/2021,SRB,Sarawak,0,0,0,Serbia
30329,6/1/2021,SRB,Selangor,0,0,0,Serbia
30330,6/1/2021,STP,Selangor,0,0,0,Sao Tome and Principe
30331,6/1/2021,SUR,Johor,0,0,0,Suriname
30332,6/1/2021,SUR,Kedah,0,0,0,Suriname
30333,6/1/2021,SUR,Kelantan,0,0,0,Suriname
30334,6/1/2021,SUR,Perak,0,0,0,Suriname
30335,6/1/2021,SUR,Perlis,0,0,0,Suriname
30336,6/1/2021,SUR,Pulau Pinang,0,0,0,Suriname
30337,6/1/2021,SUR,Sabah,0,0,0,Suriname
30338,6/1/2021,SUR,Sarawak,0,0,0,Suriname
30339,6/1/2021,SUR,Selangor,0,0,0,Suriname
30340,6/1/2021,SVK,Johor,0,0,0,Slovakia
30341,6/1/2021,SVK,Kedah,0,0,0,Slovakia
30342,6/1/2021,SVK,Kelantan,0,0,0,Slovakia
30343,6/1/2021,SVK,Negeri Sembilan,0,0,0,Slovakia
30344,6/1/2021,SVK,Pahang,0,0,0,Slovakia
30345,6/1/2021,SVK,Perak,0,0,0,Slovakia
30346,6/1/2021,SVK,Perlis,0,0,0,Slovakia
30347,6/1/2021,SVK,Pulau Pinang,0,0,0,Slovakia
30348,6/1/2021,SVK,Sabah,0,0,0,Slovakia
30349,6/1/2021,SVK,Sarawak,0,0,0,Slovakia
30350,6/1/2021,SVK,Selangor,0,0,0,Slovakia
30351,6/1/2021,SVK,W.P. Labuan,0,0,0,Slovakia
30352,6/1/2021,SVN,Johor,0,0,0,Slovenia
30353,6/1/2021,SVN,Kedah,0,0,0,Slovenia
30354,6/1/2021,SVN,Kelantan,0,0,0,Slovenia
30355,6/1/2021,SVN,Perak,0,0,0,Slovenia
30356,6/1/2021,SVN,Perlis,0,0,0,Slovenia
30357,6/1/2021,SVN,Pulau Pinang,0,0,0,Slovenia
30358,6/1/2021,SVN,Sabah,0,0,0,Slovenia
30359,6/1/2021,SVN,Sarawak,0,0,0,Slovenia
30360,6/1/2021,SVN,Selangor,2,2,0,Slovenia
30361,6/1/2021,SVN,W.P. Labuan,0,0,0,Slovenia
30362,6/1/2021,SWE,Johor,0,0,0,Sweden
30363,6/1/2021,SWE,Kedah,0,0,0,Sweden
30364,6/1/2021,SWE,Kelantan,0,0,0,Sweden
30365,6/1/2021,SWE,Melaka,0,0,0,Sweden
30366,6/1/2021,SWE,Negeri Sembilan,0,0,0,Sweden
30367,6/1/2021,SWE,Pahang,0,0,0,Sweden
30368,6/1/2021,SWE,Perak,0,0,0,Sweden
30369,6/1/2021,SWE,Perlis,0,0,0,Sweden
30370,6/1/2021,SWE,Pulau Pinang,0,0,0,Sweden
30371,6/1/2021,SWE,Sabah,0,0,0,Sweden
30372,6/1/2021,SWE,Sarawak,0,0,0,Sweden
30373,6/1/2021,SWE,Selangor,11,10,1,Sweden
30374,6/1/2021,SWE,W.P. Labuan,0,0,0,Sweden
30375,6/1/2021,SWZ,Johor,0,0,0,Swaziland
30376,6/1/2021,SWZ,Kedah,0,0,0,Swaziland
30377,6/1/2021,SWZ,Pulau Pinang,0,0,0,Swaziland
30378,6/1/2021,SWZ,Sabah,0,0,0,Swaziland
30379,6/1/2021,SWZ,Selangor,0,0,0,Swaziland
30380,6/1/2021,SYC,Johor,0,0,0,Seychelles
30381,6/1/2021,SYC,Kedah,0,0,0,Seychelles
30382,6/1/2021,SYC,Pulau Pinang,0,0,0,Seychelles
30383,6/1/2021,SYC,Sabah,0,0,0,Seychelles
30384,6/1/2021,SYC,Sarawak,0,0,0,Seychelles
30385,6/1/2021,SYC,Selangor,1,1,0,Seychelles
30386,6/1/2021,SYR,Johor,0,0,0,Syrian Arab Republic
30387,6/1/2021,SYR,Kedah,0,0,0,Syrian Arab Republic
30388,6/1/2021,SYR,Kelantan,0,0,0,Syrian Arab Republic
30389,6/1/2021,SYR,Pahang,0,0,0,Syrian Arab Republic
30390,6/1/2021,SYR,Perlis,0,0,0,Syrian Arab Republic
30391,6/1/2021,SYR,Pulau Pinang,0,0,0,Syrian Arab Republic
30392,6/1/2021,SYR,Sabah,0,0,0,Syrian Arab Republic
30393,6/1/2021,SYR,Sarawak,1,1,0,Syrian Arab Republic
30394,6/1/2021,SYR,Selangor,14,10,4,Syrian Arab Republic
30395,6/1/2021,SYR,W.P. Labuan,0,0,0,Syrian Arab Republic
30396,6/1/2021,TCA,Perlis,0,0,0,Turks and Caicos
30397,6/1/2021,TCD,Johor,0,0,0,Chad
30398,6/1/2021,TCD,Kedah,0,0,0,Chad
30399,6/1/2021,TCD,Perlis,0,0,0,Chad
30400,6/1/2021,TCD,Selangor,0,0,0,Chad
30401,6/1/2021,TGO,Johor,0,0,0,Togo
30402,6/1/2021,TGO,Perak,0,0,0,Togo
30403,6/1/2021,TGO,Pulau Pinang,0,0,0,Togo
30404,6/1/2021,TGO,Selangor,0,0,0,Togo
30405,6/1/2021,THA,Johor,0,0,0,Thailand
30406,6/1/2021,THA,Kedah,16884,16840,44,Thailand
30407,6/1/2021,THA,Kelantan,1,0,1,Thailand
30408,6/1/2021,THA,Melaka,0,0,0,Thailand
30409,6/1/2021,THA,Negeri Sembilan,0,0,0,Thailand
30410,6/1/2021,THA,Pahang,0,0,0,Thailand
30411,6/1/2021,THA,Perak,0,0,0,Thailand
30412,6/1/2021,THA,Perlis,7245,7161,84,Thailand
30413,6/1/2021,THA,Pulau Pinang,282,280,2,Thailand
30414,6/1/2021,THA,Sabah,0,0,0,Thailand
30415,6/1/2021,THA,Sarawak,13,12,1,Thailand
30416,6/1/2021,THA,Selangor,197,127,70,Thailand
30417,6/1/2021,THA,Terengganu,0,0,0,Thailand
30418,6/1/2021,THA,W.P. Labuan,0,0,0,Thailand
30419,6/1/2021,TJK,Johor,0,0,0,Tajikistan
30420,6/1/2021,TJK,Kedah,0,0,0,Tajikistan
30421,6/1/2021,TJK,Perlis,0,0,0,Tajikistan
30422,6/1/2021,TJK,Pulau Pinang,0,0,0,Tajikistan
30423,6/1/2021,TJK,Sabah,0,0,0,Tajikistan
30424,6/1/2021,TJK,Selangor,2,2,0,Tajikistan
30425,6/1/2021,TKL,Selangor,0,0,0,Tokelau
30426,6/1/2021,TKM,Johor,0,0,0,Turkmenistan
30427,6/1/2021,TKM,Kedah,0,0,0,Turkmenistan
30428,6/1/2021,TKM,Kelantan,0,0,0,Turkmenistan
30429,6/1/2021,TKM,Perlis,0,0,0,Turkmenistan
30430,6/1/2021,TKM,Pulau Pinang,0,0,0,Turkmenistan
30431,6/1/2021,TKM,Sabah,0,0,0,Turkmenistan
30432,6/1/2021,TKM,Sarawak,0,0,0,Turkmenistan
30433,6/1/2021,TKM,Selangor,3,3,0,Turkmenistan
30434,6/1/2021,TLS,Johor,0,0,0,Timor-Leste
30435,6/1/2021,TLS,Kedah,0,0,0,Timor-Leste
30436,6/1/2021,TLS,Perlis,0,0,0,Timor-Leste
30437,6/1/2021,TLS,Pulau Pinang,0,0,0,Timor-Leste
30438,6/1/2021,TLS,Sabah,0,0,0,Timor-Leste
30439,6/1/2021,TLS,Sarawak,0,0,0,Timor-Leste
30440,6/1/2021,TLS,Selangor,2,0,2,Timor-Leste
30441,6/1/2021,TON,Johor,0,0,0,Tonga
30442,6/1/2021,TON,Pulau Pinang,0,0,0,Tonga
30443,6/1/2021,TON,Sarawak,0,0,0,Tonga
30444,6/1/2021,TON,Selangor,0,0,0,Tonga
30445,6/1/2021,TTO,Johor,0,0,0,Trinidad and Tobago
30446,6/1/2021,TTO,Kedah,0,0,0,Trinidad and Tobago
30447,6/1/2021,TTO,Pahang,0,0,0,Trinidad and Tobago
30448,6/1/2021,TTO,Pulau Pinang,0,0,0,Trinidad and Tobago
30449,6/1/2021,TTO,Sabah,0,0,0,Trinidad and Tobago
30450,6/1/2021,TTO,Sarawak,0,0,0,Trinidad and Tobago
30451,6/1/2021,TTO,Selangor,1,0,1,Trinidad and Tobago
30452,6/1/2021,TUN,Johor,0,0,0,Tunisia
30453,6/1/2021,TUN,Kedah,0,0,0,Tunisia
30454,6/1/2021,TUN,Kelantan,0,0,0,Tunisia
30455,6/1/2021,TUN,Melaka,0,0,0,Tunisia
30456,6/1/2021,TUN,Perak,0,0,0,Tunisia
30457,6/1/2021,TUN,Perlis,0,0,0,Tunisia
30458,6/1/2021,TUN,Pulau Pinang,0,0,0,Tunisia
30459,6/1/2021,TUN,Sabah,0,0,0,Tunisia
30460,6/1/2021,TUN,Sarawak,0,0,0,Tunisia
30461,6/1/2021,TUN,Selangor,1,1,0,Tunisia
30462,6/1/2021,TUN,W.P. Labuan,0,0,0,Tunisia
30463,6/1/2021,TUR,Johor,0,0,0,Turkey
30464,6/1/2021,TUR,Kedah,0,0,0,Turkey
30465,6/1/2021,TUR,Kelantan,0,0,0,Turkey
30466,6/1/2021,TUR,Melaka,0,0,0,Turkey
30467,6/1/2021,TUR,Negeri Sembilan,0,0,0,Turkey
30468,6/1/2021,TUR,Pahang,0,0,0,Turkey
30469,6/1/2021,TUR,Perak,0,0,0,Turkey
30470,6/1/2021,TUR,Perlis,0,0,0,Turkey
30471,6/1/2021,TUR,Pulau Pinang,0,0,0,Turkey
30472,6/1/2021,TUR,Sabah,0,0,0,Turkey
30473,6/1/2021,TUR,Sarawak,0,0,0,Turkey
30474,6/1/2021,TUR,Selangor,26,22,4,Turkey
30475,6/1/2021,TUR,W.P. Labuan,0,0,0,Turkey
30476,6/1/2021,TUV,Selangor,0,0,0,Tuvalu
30477,6/1/2021,TWN,Johor,0,0,0,Taiwan
30478,6/1/2021,TWN,Kedah,0,0,0,Taiwan
30479,6/1/2021,TWN,Kelantan,0,0,0,Taiwan
30480,6/1/2021,TWN,Melaka,0,0,0,Taiwan
30481,6/1/2021,TWN,Negeri Sembilan,0,0,0,Taiwan
30482,6/1/2021,TWN,Pahang,0,0,0,Taiwan
30483,6/1/2021,TWN,Perak,0,0,0,Taiwan
30484,6/1/2021,TWN,Perlis,0,0,0,Taiwan
30485,6/1/2021,TWN,Pulau Pinang,15,10,5,Taiwan
30486,6/1/2021,TWN,Sabah,0,0,0,Taiwan
30487,6/1/2021,TWN,Sarawak,1,1,0,Taiwan
30488,6/1/2021,TWN,Selangor,30,18,12,Taiwan
30489,6/1/2021,TWN,W.P. Labuan,0,0,0,Taiwan
30490,6/1/2021,TZA,Johor,0,0,0,"Tanzania, United Republic of"
30491,6/1/2021,TZA,Kedah,0,0,0,"Tanzania, United Republic of"
30492,6/1/2021,TZA,Perak,0,0,0,"Tanzania, United Republic of"
30493,6/1/2021,TZA,Perlis,0,0,0,"Tanzania, United Republic of"
30494,6/1/2021,TZA,Pulau Pinang,0,0,0,"Tanzania, United Republic of"
30495,6/1/2021,TZA,Sabah,0,0,0,"Tanzania, United Republic of"
30496,6/1/2021,TZA,Sarawak,0,0,0,"Tanzania, United Republic of"
30497,6/1/2021,TZA,Selangor,6,5,1,"Tanzania, United Republic of"
30498,6/1/2021,UGA,Johor,0,0,0,Uganda
30499,6/1/2021,UGA,Kedah,0,0,0,Uganda
30500,6/1/2021,UGA,Perak,0,0,0,Uganda
30501,6/1/2021,UGA,Perlis,0,0,0,Uganda
30502,6/1/2021,UGA,Pulau Pinang,0,0,0,Uganda
30503,6/1/2021,UGA,Sabah,0,0,0,Uganda
30504,6/1/2021,UGA,Sarawak,0,0,0,Uganda
30505,6/1/2021,UGA,Selangor,5,0,5,Uganda
30506,6/1/2021,UKR,Johor,0,0,0,Ukraine
30507,6/1/2021,UKR,Kedah,0,0,0,Ukraine
30508,6/1/2021,UKR,Kelantan,0,0,0,Ukraine
30509,6/1/2021,UKR,Melaka,0,0,0,Ukraine
30510,6/1/2021,UKR,Negeri Sembilan,0,0,0,Ukraine
30511,6/1/2021,UKR,Pahang,0,0,0,Ukraine
30512,6/1/2021,UKR,Perak,0,0,0,Ukraine
30513,6/1/2021,UKR,Perlis,0,0,0,Ukraine
30514,6/1/2021,UKR,Pulau Pinang,0,0,0,Ukraine
30515,6/1/2021,UKR,Sabah,0,0,0,Ukraine
30516,6/1/2021,UKR,Sarawak,0,0,0,Ukraine
30517,6/1/2021,UKR,Selangor,50,49,1,Ukraine
30518,6/1/2021,UKR,W.P. Labuan,0,0,0,Ukraine
30519,6/1/2021,URY,Johor,0,0,0,Uruguay
30520,6/1/2021,URY,Kedah,0,0,0,Uruguay
30521,6/1/2021,URY,Kelantan,0,0,0,Uruguay
30522,6/1/2021,URY,Perak,0,0,0,Uruguay
30523,6/1/2021,URY,Perlis,0,0,0,Uruguay
30524,6/1/2021,URY,Pulau Pinang,0,0,0,Uruguay
30525,6/1/2021,URY,Sabah,0,0,0,Uruguay
30526,6/1/2021,URY,Sarawak,0,0,0,Uruguay
30527,6/1/2021,URY,Selangor,0,0,0,Uruguay
30528,6/1/2021,URY,W.P. Labuan,0,0,0,Uruguay
30529,6/1/2021,USA,Johor,0,0,0,United States Of America
30530,6/1/2021,USA,Kedah,0,0,0,United States Of America
30531,6/1/2021,USA,Kelantan,0,0,0,United States Of America
30532,6/1/2021,USA,Melaka,0,0,0,United States Of America
30533,6/1/2021,USA,Negeri Sembilan,0,0,0,United States Of America
30534,6/1/2021,USA,Pahang,0,0,0,United States Of America
30535,6/1/2021,USA,Perak,0,0,0,United States Of America
30536,6/1/2021,USA,Perlis,0,0,0,United States Of America
30537,6/1/2021,USA,Pulau Pinang,7,5,2,United States Of America
30538,6/1/2021,USA,Sabah,0,0,0,United States Of America
30539,6/1/2021,USA,Sarawak,0,0,0,United States Of America
30540,6/1/2021,USA,Selangor,152,96,56,United States Of America
30541,6/1/2021,USA,Terengganu,0,0,0,United States Of America
30542,6/1/2021,USA,W.P. Labuan,0,0,0,United States Of America
30543,6/1/2021,UZB,Johor,0,0,0,Uzbekistan
30544,6/1/2021,UZB,Kedah,0,0,0,Uzbekistan
30545,6/1/2021,UZB,Kelantan,0,0,0,Uzbekistan
30546,6/1/2021,UZB,Perak,0,0,0,Uzbekistan
30547,6/1/2021,UZB,Perlis,0,0,0,Uzbekistan
30548,6/1/2021,UZB,Pulau Pinang,0,0,0,Uzbekistan
30549,6/1/2021,UZB,Sabah,0,0,0,Uzbekistan
30550,6/1/2021,UZB,Sarawak,0,0,0,Uzbekistan
30551,6/1/2021,UZB,Selangor,8,3,5,Uzbekistan
30552,6/1/2021,VAT,Johor,0,0,0,Holy See (Vatican City State)
30553,6/1/2021,VAT,Sarawak,0,0,0,Holy See (Vatican City State)
30554,6/1/2021,VAT,Selangor,1,1,0,Holy See (Vatican City State)
30555,6/1/2021,VCT,Johor,0,0,0,Saint Vincent and the Grenadines
30556,6/1/2021,VCT,Kedah,0,0,0,Saint Vincent and the Grenadines
30557,6/1/2021,VCT,Pulau Pinang,0,0,0,Saint Vincent and the Grenadines
30558,6/1/2021,VCT,Sarawak,0,0,0,Saint Vincent and the Grenadines
30559,6/1/2021,VCT,Selangor,0,0,0,Saint Vincent and the Grenadines
30560,6/1/2021,VEN,Johor,0,0,0,Venezuela
30561,6/1/2021,VEN,Kedah,0,0,0,Venezuela
30562,6/1/2021,VEN,Kelantan,0,0,0,Venezuela
30563,6/1/2021,VEN,Melaka,0,0,0,Venezuela
30564,6/1/2021,VEN,Perak,0,0,0,Venezuela
30565,6/1/2021,VEN,Perlis,0,0,0,Venezuela
30566,6/1/2021,VEN,Pulau Pinang,0,0,0,Venezuela
30567,6/1/2021,VEN,Sabah,0,0,0,Venezuela
30568,6/1/2021,VEN,Sarawak,0,0,0,Venezuela
30569,6/1/2021,VEN,Selangor,0,0,0,Venezuela
30570,6/1/2021,VEN,W.P. Labuan,0,0,0,Venezuela
30571,6/1/2021,VNM,Johor,0,0,0,Vietnam
30572,6/1/2021,VNM,Kedah,0,0,0,Vietnam
30573,6/1/2021,VNM,Kelantan,0,0,0,Vietnam
30574,6/1/2021,VNM,Melaka,0,0,0,Vietnam
30575,6/1/2021,VNM,Negeri Sembilan,0,0,0,Vietnam
30576,6/1/2021,VNM,Pahang,0,0,0,Vietnam
30577,6/1/2021,VNM,Perak,0,0,0,Vietnam
30578,6/1/2021,VNM,Perlis,0,0,0,Vietnam
30579,6/1/2021,VNM,Pulau Pinang,2,0,2,Vietnam
30580,6/1/2021,VNM,Sabah,0,0,0,Vietnam
30581,6/1/2021,VNM,Sarawak,0,0,0,Vietnam
30582,6/1/2021,VNM,Selangor,63,23,40,Vietnam
30583,6/1/2021,VNM,Terengganu,0,0,0,Vietnam
30584,6/1/2021,VNM,W.P. Labuan,0,0,0,Vietnam
30585,6/1/2021,VUT,Johor,0,0,0,Vanuatu
30586,6/1/2021,VUT,Kedah,0,0,0,Vanuatu
30587,6/1/2021,VUT,Pulau Pinang,0,0,0,Vanuatu
30588,6/1/2021,VUT,Sabah,0,0,0,Vanuatu
30589,6/1/2021,VUT,Sarawak,0,0,0,Vanuatu
30590,6/1/2021,VUT,Selangor,0,0,0,Vanuatu
30591,6/1/2021,WSM,Johor,0,0,0,Samoa
30592,6/1/2021,WSM,Sarawak,0,0,0,Samoa
30593,6/1/2021,WSM,Selangor,0,0,0,Samoa
30594,6/1/2021,YEM,Johor,0,0,0,Yemen
30595,6/1/2021,YEM,Kedah,0,0,0,Yemen
30596,6/1/2021,YEM,Kelantan,0,0,0,Yemen
30597,6/1/2021,YEM,Melaka,0,0,0,Yemen
30598,6/1/2021,YEM,Pahang,0,0,0,Yemen
30599,6/1/2021,YEM,Perak,0,0,0,Yemen
30600,6/1/2021,YEM,Perlis,0,0,0,Yemen
30601,6/1/2021,YEM,Pulau Pinang,0,0,0,Yemen
30602,6/1/2021,YEM,Sabah,0,0,0,Yemen
30603,6/1/2021,YEM,Sarawak,0,0,0,Yemen
30604,6/1/2021,YEM,Selangor,38,35,3,Yemen
30605,6/1/2021,YEM,W.P. Labuan,0,0,0,Yemen
30606,6/1/2021,ZAF,Johor,1,1,0,South Africa
30607,6/1/2021,ZAF,Kedah,0,0,0,South Africa
30608,6/1/2021,ZAF,Kelantan,0,0,0,South Africa
30609,6/1/2021,ZAF,Melaka,0,0,0,South Africa
30610,6/1/2021,ZAF,Pahang,0,0,0,South Africa
30611,6/1/2021,ZAF,Perak,0,0,0,South Africa
30612,6/1/2021,ZAF,Perlis,0,0,0,South Africa
30613,6/1/2021,ZAF,Pulau Pinang,0,0,0,South Africa
30614,6/1/2021,ZAF,Sabah,0,0,0,South Africa
30615,6/1/2021,ZAF,Sarawak,0,0,0,South Africa
30616,6/1/2021,ZAF,Selangor,23,14,9,South Africa
30617,6/1/2021,ZAF,Terengganu,0,0,0,South Africa
30618,6/1/2021,ZAF,W.P. Labuan,0,0,0,South Africa
30619,6/1/2021,ZMB,Johor,0,0,0,Zambia
30620,6/1/2021,ZMB,Kedah,0,0,0,Zambia
30621,6/1/2021,ZMB,Perak,0,0,0,Zambia
30622,6/1/2021,ZMB,Perlis,0,0,0,Zambia
30623,6/1/2021,ZMB,Pulau Pinang,0,0,0,Zambia
30624,6/1/2021,ZMB,Sabah,0,0,0,Zambia
30625,6/1/2021,ZMB,Sarawak,0,0,0,Zambia
30626,6/1/2021,ZMB,Selangor,4,2,2,Zambia
30627,6/1/2021,ZWE,Johor,0,0,0,Zimbabwe
30628,6/1/2021,ZWE,Kedah,0,0,0,Zimbabwe
30629,6/1/2021,ZWE,Kelantan,0,0,0,Zimbabwe
30630,6/1/2021,ZWE,Perak,0,0,0,Zimbabwe
30631,6/1/2021,ZWE,Perlis,0,0,0,Zimbabwe
30632,6/1/2021,ZWE,Pulau Pinang,1,1,0,Zimbabwe
30633,6/1/2021,ZWE,Sabah,0,0,0,Zimbabwe
30634,6/1/2021,ZWE,Sarawak,0,0,0,Zimbabwe
30635,6/1/2021,ZWE,Selangor,2,1,1,Zimbabwe
30636,7/1/2021,ABW,Kedah,0,0,0,Aruba
30637,7/1/2021,ABW,Pulau Pinang,0,0,0,Aruba
30638,7/1/2021,AFG,Johor,0,0,0,Afghanistan
30639,7/1/2021,AFG,Kedah,0,0,0,Afghanistan
30640,7/1/2021,AFG,Perlis,0,0,0,Afghanistan
30641,7/1/2021,AFG,Pulau Pinang,0,0,0,Afghanistan
30642,7/1/2021,AFG,Sarawak,0,0,0,Afghanistan
30643,7/1/2021,AFG,Selangor,10,7,3,Afghanistan
30644,7/1/2021,AGO,Johor,0,0,0,Angola
30645,7/1/2021,AGO,Kedah,0,0,0,Angola
30646,7/1/2021,AGO,Sabah,0,0,0,Angola
30647,7/1/2021,AGO,Selangor,0,0,0,Angola
30648,7/1/2021,AIA,Selangor,0,0,0,Anguilla
30649,7/1/2021,ALB,Johor,0,0,0,Albania
30650,7/1/2021,ALB,Kedah,0,0,0,Albania
30651,7/1/2021,ALB,Perak,0,0,0,Albania
30652,7/1/2021,ALB,Perlis,0,0,0,Albania
30653,7/1/2021,ALB,Pulau Pinang,0,0,0,Albania
30654,7/1/2021,ALB,Sabah,0,0,0,Albania
30655,7/1/2021,ALB,Sarawak,0,0,0,Albania
30656,7/1/2021,ALB,Selangor,0,0,0,Albania
30657,7/1/2021,AND,Johor,0,0,0,Andorra
30658,7/1/2021,AND,Kedah,0,0,0,Andorra
30659,7/1/2021,AND,Perlis,0,0,0,Andorra
30660,7/1/2021,AND,Pulau Pinang,0,0,0,Andorra
30661,7/1/2021,AND,Selangor,0,0,0,Andorra
30662,7/1/2021,ANT,Selangor,1,0,1,Netherlands Antilles
30663,7/1/2021,ARE,Johor,0,0,0,United Arab Emirates
30664,7/1/2021,ARE,Kedah,0,0,0,United Arab Emirates
30665,7/1/2021,ARE,Kelantan,0,0,0,United Arab Emirates
30666,7/1/2021,ARE,Perak,0,0,0,United Arab Emirates
30667,7/1/2021,ARE,Perlis,0,0,0,United Arab Emirates
30668,7/1/2021,ARE,Pulau Pinang,0,0,0,United Arab Emirates
30669,7/1/2021,ARE,Sabah,0,0,0,United Arab Emirates
30670,7/1/2021,ARE,Sarawak,0,0,0,United Arab Emirates
30671,7/1/2021,ARE,Selangor,1,1,0,United Arab Emirates
30672,7/1/2021,ARG,Johor,2,2,0,Argentina
30673,7/1/2021,ARG,Kedah,0,0,0,Argentina
30674,7/1/2021,ARG,Kelantan,0,0,0,Argentina
30675,7/1/2021,ARG,Melaka,0,0,0,Argentina
30676,7/1/2021,ARG,Perak,0,0,0,Argentina
30677,7/1/2021,ARG,Perlis,0,0,0,Argentina
30678,7/1/2021,ARG,Pulau Pinang,0,0,0,Argentina
30679,7/1/2021,ARG,Sabah,0,0,0,Argentina
30680,7/1/2021,ARG,Sarawak,0,0,0,Argentina
30681,7/1/2021,ARG,Selangor,8,6,2,Argentina
30682,7/1/2021,ARG,W.P. Labuan,0,0,0,Argentina
30683,7/1/2021,ARM,Johor,0,0,0,Armenia
30684,7/1/2021,ARM,Kedah,0,0,0,Armenia
30685,7/1/2021,ARM,Kelantan,0,0,0,Armenia
30686,7/1/2021,ARM,Perak,0,0,0,Armenia
30687,7/1/2021,ARM,Perlis,0,0,0,Armenia
30688,7/1/2021,ARM,Pulau Pinang,0,0,0,Armenia
30689,7/1/2021,ARM,Sabah,0,0,0,Armenia
30690,7/1/2021,ARM,Sarawak,0,0,0,Armenia
30691,7/1/2021,ARM,Selangor,3,2,1,Armenia
30692,7/1/2021,ATA,Selangor,0,0,0,Antarctica
30693,7/1/2021,ATG,Johor,0,0,0,Antigua and Barbuda
30694,7/1/2021,ATG,Kedah,0,0,0,Antigua and Barbuda
30695,7/1/2021,ATG,Pulau Pinang,0,0,0,Antigua and Barbuda
30696,7/1/2021,ATG,Sarawak,0,0,0,Antigua and Barbuda
30697,7/1/2021,ATG,Selangor,0,0,0,Antigua and Barbuda
30698,7/1/2021,AUS,Johor,2,2,0,Australia
30699,7/1/2021,AUS,Kedah,3,1,2,Australia
30700,7/1/2021,AUS,Kelantan,0,0,0,Australia
30701,7/1/2021,AUS,Melaka,0,0,0,Australia
30702,7/1/2021,AUS,Negeri Sembilan,0,0,0,Australia
30703,7/1/2021,AUS,Pahang,0,0,0,Australia
30704,7/1/2021,AUS,Perak,0,0,0,Australia
30705,7/1/2021,AUS,Perlis,0,0,0,Australia
30706,7/1/2021,AUS,Pulau Pinang,1,0,1,Australia
30707,7/1/2021,AUS,Sabah,1,1,0,Australia
30708,7/1/2021,AUS,Sarawak,1,0,1,Australia
30709,7/1/2021,AUS,Selangor,91,51,40,Australia
30710,7/1/2021,AUS,Terengganu,0,0,0,Australia
30711,7/1/2021,AUS,W.P. Labuan,0,0,0,Australia
30712,7/1/2021,AUT,Johor,0,0,0,Austria
30713,7/1/2021,AUT,Kedah,0,0,0,Austria
30714,7/1/2021,AUT,Kelantan,0,0,0,Austria
30715,7/1/2021,AUT,Melaka,0,0,0,Austria
30716,7/1/2021,AUT,Negeri Sembilan,0,0,0,Austria
30717,7/1/2021,AUT,Pahang,0,0,0,Austria
30718,7/1/2021,AUT,Perak,0,0,0,Austria
30719,7/1/2021,AUT,Perlis,0,0,0,Austria
30720,7/1/2021,AUT,Pulau Pinang,0,0,0,Austria
30721,7/1/2021,AUT,Sabah,0,0,0,Austria
30722,7/1/2021,AUT,Sarawak,0,0,0,Austria
30723,7/1/2021,AUT,Selangor,12,8,4,Austria
30724,7/1/2021,AUT,Terengganu,0,0,0,Austria
30725,7/1/2021,AUT,W.P. Labuan,0,0,0,Austria
30726,7/1/2021,AZE,Johor,0,0,0,Azerbaijan
30727,7/1/2021,AZE,Kedah,0,0,0,Azerbaijan
30728,7/1/2021,AZE,Kelantan,0,0,0,Azerbaijan
30729,7/1/2021,AZE,Melaka,0,0,0,Azerbaijan
30730,7/1/2021,AZE,Perlis,0,0,0,Azerbaijan
30731,7/1/2021,AZE,Pulau Pinang,0,0,0,Azerbaijan
30732,7/1/2021,AZE,Sabah,0,0,0,Azerbaijan
30733,7/1/2021,AZE,Sarawak,0,0,0,Azerbaijan
30734,7/1/2021,AZE,Selangor,5,3,2,Azerbaijan
30735,7/1/2021,AZE,W.P. Labuan,0,0,0,Azerbaijan
30736,7/1/2021,BDI,Pulau Pinang,0,0,0,Burundi
30737,7/1/2021,BDI,Sarawak,0,0,0,Burundi
30738,7/1/2021,BDI,Selangor,1,0,1,Burundi
30739,7/1/2021,BEL,Johor,0,0,0,Belgium
30740,7/1/2021,BEL,Kedah,0,0,0,Belgium
30741,7/1/2021,BEL,Kelantan,0,0,0,Belgium
30742,7/1/2021,BEL,Melaka,0,0,0,Belgium
30743,7/1/2021,BEL,Negeri Sembilan,0,0,0,Belgium
30744,7/1/2021,BEL,Pahang,0,0,0,Belgium
30745,7/1/2021,BEL,Perak,0,0,0,Belgium
30746,7/1/2021,BEL,Perlis,0,0,0,Belgium
30747,7/1/2021,BEL,Pulau Pinang,1,1,0,Belgium
30748,7/1/2021,BEL,Sabah,0,0,0,Belgium
30749,7/1/2021,BEL,Sarawak,0,0,0,Belgium
30750,7/1/2021,BEL,Selangor,16,12,4,Belgium
30751,7/1/2021,BEL,W.P. Labuan,0,0,0,Belgium
30752,7/1/2021,BEN,Johor,0,0,0,Benin
30753,7/1/2021,BEN,Kedah,0,0,0,Benin
30754,7/1/2021,BEN,Perak,0,0,0,Benin
30755,7/1/2021,BEN,Pulau Pinang,0,0,0,Benin
30756,7/1/2021,BEN,Sabah,0,0,0,Benin
30757,7/1/2021,BEN,Sarawak,0,0,0,Benin
30758,7/1/2021,BEN,Selangor,0,0,0,Benin
30759,7/1/2021,BFA,Perak,0,0,0,Burkina Faso
30760,7/1/2021,BFA,Pulau Pinang,0,0,0,Burkina Faso
30761,7/1/2021,BFA,Selangor,0,0,0,Burkina Faso
30762,7/1/2021,BGD,Johor,0,0,0,Bangladesh
30763,7/1/2021,BGD,Kedah,0,0,0,Bangladesh
30764,7/1/2021,BGD,Kelantan,0,0,0,Bangladesh
30765,7/1/2021,BGD,Melaka,0,0,0,Bangladesh
30766,7/1/2021,BGD,Negeri Sembilan,0,0,0,Bangladesh
30767,7/1/2021,BGD,Pahang,0,0,0,Bangladesh
30768,7/1/2021,BGD,Perak,0,0,0,Bangladesh
30769,7/1/2021,BGD,Perlis,0,0,0,Bangladesh
30770,7/1/2021,BGD,Pulau Pinang,0,0,0,Bangladesh
30771,7/1/2021,BGD,Sabah,0,0,0,Bangladesh
30772,7/1/2021,BGD,Sarawak,0,0,0,Bangladesh
30773,7/1/2021,BGD,Selangor,10,8,2,Bangladesh
30774,7/1/2021,BGD,W.P. Labuan,0,0,0,Bangladesh
30775,7/1/2021,BGR,Johor,0,0,0,Bulgaria
30776,7/1/2021,BGR,Kedah,0,0,0,Bulgaria
30777,7/1/2021,BGR,Kelantan,0,0,0,Bulgaria
30778,7/1/2021,BGR,Pahang,0,0,0,Bulgaria
30779,7/1/2021,BGR,Perak,0,0,0,Bulgaria
30780,7/1/2021,BGR,Perlis,0,0,0,Bulgaria
30781,7/1/2021,BGR,Pulau Pinang,0,0,0,Bulgaria
30782,7/1/2021,BGR,Sabah,0,0,0,Bulgaria
30783,7/1/2021,BGR,Sarawak,0,0,0,Bulgaria
30784,7/1/2021,BGR,Selangor,2,2,0,Bulgaria
30785,7/1/2021,BGR,W.P. Labuan,0,0,0,Bulgaria
30786,7/1/2021,BHR,Johor,0,0,0,Bahrain
30787,7/1/2021,BHR,Kedah,0,0,0,Bahrain
30788,7/1/2021,BHR,Kelantan,0,0,0,Bahrain
30789,7/1/2021,BHR,Perlis,0,0,0,Bahrain
30790,7/1/2021,BHR,Pulau Pinang,0,0,0,Bahrain
30791,7/1/2021,BHR,Sabah,0,0,0,Bahrain
30792,7/1/2021,BHR,Sarawak,0,0,0,Bahrain
30793,7/1/2021,BHR,Selangor,1,1,0,Bahrain
30794,7/1/2021,BHS,Johor,0,0,0,Bahamas
30795,7/1/2021,BHS,Kedah,0,0,0,Bahamas
30796,7/1/2021,BHS,Perak,0,0,0,Bahamas
30797,7/1/2021,BHS,Sabah,0,0,0,Bahamas
30798,7/1/2021,BHS,Sarawak,0,0,0,Bahamas
30799,7/1/2021,BHS,Selangor,0,0,0,Bahamas
30800,7/1/2021,BIH,Johor,0,0,0,Bosnia and Herzegovina
30801,7/1/2021,BIH,Kedah,0,0,0,Bosnia and Herzegovina
30802,7/1/2021,BIH,Perlis,0,0,0,Bosnia and Herzegovina
30803,7/1/2021,BIH,Pulau Pinang,0,0,0,Bosnia and Herzegovina
30804,7/1/2021,BIH,Sabah,0,0,0,Bosnia and Herzegovina
30805,7/1/2021,BIH,Sarawak,0,0,0,Bosnia and Herzegovina
30806,7/1/2021,BIH,Selangor,1,1,0,Bosnia and Herzegovina
30807,7/1/2021,BLR,Johor,0,0,0,Belarus
30808,7/1/2021,BLR,Kedah,0,0,0,Belarus
30809,7/1/2021,BLR,Kelantan,0,0,0,Belarus
30810,7/1/2021,BLR,Pahang,0,0,0,Belarus
30811,7/1/2021,BLR,Perak,0,0,0,Belarus
30812,7/1/2021,BLR,Perlis,0,0,0,Belarus
30813,7/1/2021,BLR,Pulau Pinang,0,0,0,Belarus
30814,7/1/2021,BLR,Sabah,0,0,0,Belarus
30815,7/1/2021,BLR,Sarawak,0,0,0,Belarus
30816,7/1/2021,BLR,Selangor,1,1,0,Belarus
30817,7/1/2021,BLR,W.P. Labuan,0,0,0,Belarus
30818,7/1/2021,BLZ,Johor,0,0,0,Belize
30819,7/1/2021,BLZ,Pulau Pinang,0,0,0,Belize
30820,7/1/2021,BLZ,Sarawak,0,0,0,Belize
30821,7/1/2021,BLZ,Selangor,0,0,0,Belize
30822,7/1/2021,BMU,Selangor,0,0,0,Bermuda
30823,7/1/2021,BOL,Johor,0,0,0,Bolivia
30824,7/1/2021,BOL,Kedah,0,0,0,Bolivia
30825,7/1/2021,BOL,Melaka,0,0,0,Bolivia
30826,7/1/2021,BOL,Perak,0,0,0,Bolivia
30827,7/1/2021,BOL,Perlis,0,0,0,Bolivia
30828,7/1/2021,BOL,Pulau Pinang,0,0,0,Bolivia
30829,7/1/2021,BOL,Sabah,0,0,0,Bolivia
30830,7/1/2021,BOL,Sarawak,0,0,0,Bolivia
30831,7/1/2021,BOL,Selangor,1,0,1,Bolivia
30832,7/1/2021,BRA,Johor,2,2,0,Brazil
30833,7/1/2021,BRA,Kedah,0,0,0,Brazil
30834,7/1/2021,BRA,Kelantan,0,0,0,Brazil
30835,7/1/2021,BRA,Melaka,0,0,0,Brazil
30836,7/1/2021,BRA,Pahang,0,0,0,Brazil
30837,7/1/2021,BRA,Perak,0,0,0,Brazil
30838,7/1/2021,BRA,Perlis,0,0,0,Brazil
30839,7/1/2021,BRA,Pulau Pinang,0,0,0,Brazil
30840,7/1/2021,BRA,Sabah,0,0,0,Brazil
30841,7/1/2021,BRA,Sarawak,0,0,0,Brazil
30842,7/1/2021,BRA,Selangor,19,11,8,Brazil
30843,7/1/2021,BRA,W.P. Labuan,0,0,0,Brazil
30844,7/1/2021,BRB,Johor,0,0,0,Barbados
30845,7/1/2021,BRB,Kedah,0,0,0,Barbados
30846,7/1/2021,BRB,Perlis,0,0,0,Barbados
30847,7/1/2021,BRB,Pulau Pinang,0,0,0,Barbados
30848,7/1/2021,BRB,Selangor,0,0,0,Barbados
30849,7/1/2021,BRN,Johor,0,0,0,Brunei Darussalam
30850,7/1/2021,BRN,Kedah,0,0,0,Brunei Darussalam
30851,7/1/2021,BRN,Kelantan,0,0,0,Brunei Darussalam
30852,7/1/2021,BRN,Melaka,0,0,0,Brunei Darussalam
30853,7/1/2021,BRN,Pahang,0,0,0,Brunei Darussalam
30854,7/1/2021,BRN,Perak,0,0,0,Brunei Darussalam
30855,7/1/2021,BRN,Perlis,0,0,0,Brunei Darussalam
30856,7/1/2021,BRN,Pulau Pinang,0,0,0,Brunei Darussalam
30857,7/1/2021,BRN,Sabah,0,0,0,Brunei Darussalam
30858,7/1/2021,BRN,Sarawak,405,398,7,Brunei Darussalam
30859,7/1/2021,BRN,Selangor,16,9,7,Brunei Darussalam
30860,7/1/2021,BRN,W.P. Labuan,0,0,0,Brunei Darussalam
30861,7/1/2021,BTN,Johor,0,0,0,Bhutan
30862,7/1/2021,BTN,Kedah,0,0,0,Bhutan
30863,7/1/2021,BTN,Perak,0,0,0,Bhutan
30864,7/1/2021,BTN,Perlis,0,0,0,Bhutan
30865,7/1/2021,BTN,Pulau Pinang,0,0,0,Bhutan
30866,7/1/2021,BTN,Sabah,0,0,0,Bhutan
30867,7/1/2021,BTN,Sarawak,0,0,0,Bhutan
30868,7/1/2021,BTN,Selangor,0,0,0,Bhutan
30869,7/1/2021,BWA,Johor,0,0,0,Botswana
30870,7/1/2021,BWA,Kedah,0,0,0,Botswana
30871,7/1/2021,BWA,Perlis,0,0,0,Botswana
30872,7/1/2021,BWA,Pulau Pinang,0,0,0,Botswana
30873,7/1/2021,BWA,Sabah,0,0,0,Botswana
30874,7/1/2021,BWA,Sarawak,0,0,0,Botswana
30875,7/1/2021,BWA,Selangor,0,0,0,Botswana
30876,7/1/2021,CAF,Kedah,0,0,0,Central African Republic
30877,7/1/2021,CAF,Selangor,0,0,0,Central African Republic
30878,7/1/2021,CAN,Johor,0,0,0,Canada
30879,7/1/2021,CAN,Kedah,0,0,0,Canada
30880,7/1/2021,CAN,Kelantan,0,0,0,Canada
30881,7/1/2021,CAN,Melaka,0,0,0,Canada
30882,7/1/2021,CAN,Negeri Sembilan,0,0,0,Canada
30883,7/1/2021,CAN,Pahang,0,0,0,Canada
30884,7/1/2021,CAN,Perak,0,0,0,Canada
30885,7/1/2021,CAN,Perlis,0,0,0,Canada
30886,7/1/2021,CAN,Pulau Pinang,0,0,0,Canada
30887,7/1/2021,CAN,Sabah,0,0,0,Canada
30888,7/1/2021,CAN,Sarawak,0,0,0,Canada
30889,7/1/2021,CAN,Selangor,81,47,34,Canada
30890,7/1/2021,CAN,Terengganu,0,0,0,Canada
30891,7/1/2021,CAN,W.P. Labuan,0,0,0,Canada
30892,7/1/2021,CCK,Selangor,0,0,0,Cocos (Keeling) Islands
30893,7/1/2021,CHE,Johor,0,0,0,Switzerland
30894,7/1/2021,CHE,Kedah,0,0,0,Switzerland
30895,7/1/2021,CHE,Kelantan,0,0,0,Switzerland
30896,7/1/2021,CHE,Melaka,0,0,0,Switzerland
30897,7/1/2021,CHE,Negeri Sembilan,0,0,0,Switzerland
30898,7/1/2021,CHE,Pahang,0,0,0,Switzerland
30899,7/1/2021,CHE,Perak,0,0,0,Switzerland
30900,7/1/2021,CHE,Perlis,0,0,0,Switzerland
30901,7/1/2021,CHE,Pulau Pinang,0,0,0,Switzerland
30902,7/1/2021,CHE,Sabah,0,0,0,Switzerland
30903,7/1/2021,CHE,Sarawak,0,0,0,Switzerland
30904,7/1/2021,CHE,Selangor,10,6,4,Switzerland
30905,7/1/2021,CHE,W.P. Labuan,0,0,0,Switzerland
30906,7/1/2021,CHL,Johor,0,0,0,Chile
30907,7/1/2021,CHL,Kedah,0,0,0,Chile
30908,7/1/2021,CHL,Kelantan,0,0,0,Chile
30909,7/1/2021,CHL,Melaka,0,0,0,Chile
30910,7/1/2021,CHL,Pahang,0,0,0,Chile
30911,7/1/2021,CHL,Perak,0,0,0,Chile
30912,7/1/2021,CHL,Perlis,0,0,0,Chile
30913,7/1/2021,CHL,Pulau Pinang,0,0,0,Chile
30914,7/1/2021,CHL,Sabah,0,0,0,Chile
30915,7/1/2021,CHL,Sarawak,0,0,0,Chile
30916,7/1/2021,CHL,Selangor,1,1,0,Chile
30917,7/1/2021,CHN,Johor,2,2,0,China
30918,7/1/2021,CHN,Kedah,1,1,0,China
30919,7/1/2021,CHN,Kelantan,0,0,0,China
30920,7/1/2021,CHN,Melaka,0,0,0,China
30921,7/1/2021,CHN,Pahang,0,0,0,China
30922,7/1/2021,CHN,Perak,0,0,0,China
30923,7/1/2021,CHN,Perlis,0,0,0,China
30924,7/1/2021,CHN,Pulau Pinang,1,1,0,China
30925,7/1/2021,CHN,Sabah,2,2,0,China
30926,7/1/2021,CHN,Sarawak,145,145,0,China
30927,7/1/2021,CHN,Selangor,722,580,142,China
30928,7/1/2021,CHN,Terengganu,0,0,0,China
30929,7/1/2021,CHN,W.P. Labuan,0,0,0,China
30930,7/1/2021,CIV,Johor,0,0,0,C��te d'Iv
30931,7/1/2021,CIV,Kedah,0,0,0,C��te d'Iv
30932,7/1/2021,CIV,Pulau Pinang,0,0,0,C��te d'Iv
30933,7/1/2021,CIV,Sabah,0,0,0,C��te d'Iv
30934,7/1/2021,CIV,Sarawak,0,0,0,C��te d'Iv
30935,7/1/2021,CIV,Selangor,3,3,0,C��te d'Iv
30936,7/1/2021,CMR,Johor,0,0,0,Cameroon
30937,7/1/2021,CMR,Kedah,0,0,0,Cameroon
30938,7/1/2021,CMR,Pulau Pinang,0,0,0,Cameroon
30939,7/1/2021,CMR,Sabah,0,0,0,Cameroon
30940,7/1/2021,CMR,Sarawak,0,0,0,Cameroon
30941,7/1/2021,CMR,Selangor,2,1,1,Cameroon
30942,7/1/2021,COD,Johor,0,0,0,"Congo, the Democratic Republic of the"
30943,7/1/2021,COD,Pulau Pinang,0,0,0,"Congo, the Democratic Republic of the"
30944,7/1/2021,COD,Sarawak,0,0,0,"Congo, the Democratic Republic of the"
30945,7/1/2021,COD,Selangor,1,1,0,"Congo, the Democratic Republic of the"
30946,7/1/2021,COG,Johor,0,0,0,Congo
30947,7/1/2021,COG,Kedah,0,0,0,Congo
30948,7/1/2021,COG,Selangor,0,0,0,Congo
30949,7/1/2021,COK,Selangor,0,0,0,Cook Islands
30950,7/1/2021,COL,Johor,0,0,0,Colombia
30951,7/1/2021,COL,Kedah,0,0,0,Colombia
30952,7/1/2021,COL,Perak,0,0,0,Colombia
30953,7/1/2021,COL,Pulau Pinang,0,0,0,Colombia
30954,7/1/2021,COL,Sabah,0,0,0,Colombia
30955,7/1/2021,COL,Sarawak,0,0,0,Colombia
30956,7/1/2021,COL,Selangor,5,2,3,Colombia
30957,7/1/2021,COL,W.P. Labuan,0,0,0,Colombia
30958,7/1/2021,COM,Johor,0,0,0,Comoros
30959,7/1/2021,COM,Kedah,0,0,0,Comoros
30960,7/1/2021,COM,Selangor,0,0,0,Comoros
30961,7/1/2021,CPV,Johor,0,0,0,Cape Verde
30962,7/1/2021,CPV,Kedah,0,0,0,Cape Verde
30963,7/1/2021,CPV,Pulau Pinang,0,0,0,Cape Verde
30964,7/1/2021,CPV,Sabah,0,0,0,Cape Verde
30965,7/1/2021,CPV,Selangor,0,0,0,Cape Verde
30966,7/1/2021,CRI,Johor,0,0,0,Costa Rica
30967,7/1/2021,CRI,Kedah,0,0,0,Costa Rica
30968,7/1/2021,CRI,Perak,0,0,0,Costa Rica
30969,7/1/2021,CRI,Perlis,0,0,0,Costa Rica
30970,7/1/2021,CRI,Pulau Pinang,0,0,0,Costa Rica
30971,7/1/2021,CRI,Sabah,0,0,0,Costa Rica
30972,7/1/2021,CRI,Sarawak,0,0,0,Costa Rica
30973,7/1/2021,CRI,Selangor,3,1,2,Costa Rica
30974,7/1/2021,CUB,Johor,0,0,0,Cuba
30975,7/1/2021,CUB,Kedah,0,0,0,Cuba
30976,7/1/2021,CUB,Perlis,0,0,0,Cuba
30977,7/1/2021,CUB,Pulau Pinang,0,0,0,Cuba
30978,7/1/2021,CUB,Sabah,0,0,0,Cuba
30979,7/1/2021,CUB,Sarawak,0,0,0,Cuba
30980,7/1/2021,CUB,Selangor,0,0,0,Cuba
30981,7/1/2021,CYP,Johor,0,0,0,Cyprus
30982,7/1/2021,CYP,Kedah,0,0,0,Cyprus
30983,7/1/2021,CYP,Perak,0,0,0,Cyprus
30984,7/1/2021,CYP,Perlis,0,0,0,Cyprus
30985,7/1/2021,CYP,Pulau Pinang,0,0,0,Cyprus
30986,7/1/2021,CYP,Sabah,0,0,0,Cyprus
30987,7/1/2021,CYP,Sarawak,0,0,0,Cyprus
30988,7/1/2021,CYP,Selangor,0,0,0,Cyprus
30989,7/1/2021,CZE,Johor,0,0,0,Czech Republic
30990,7/1/2021,CZE,Kedah,0,0,0,Czech Republic
30991,7/1/2021,CZE,Kelantan,0,0,0,Czech Republic
30992,7/1/2021,CZE,Melaka,0,0,0,Czech Republic
30993,7/1/2021,CZE,Negeri Sembilan,0,0,0,Czech Republic
30994,7/1/2021,CZE,Perak,0,0,0,Czech Republic
30995,7/1/2021,CZE,Perlis,0,0,0,Czech Republic
30996,7/1/2021,CZE,Pulau Pinang,0,0,0,Czech Republic
30997,7/1/2021,CZE,Sabah,0,0,0,Czech Republic
30998,7/1/2021,CZE,Sarawak,0,0,0,Czech Republic
30999,7/1/2021,CZE,Selangor,4,2,2,Czech Republic
31000,7/1/2021,CZE,W.P. Labuan,0,0,0,Czech Republic
31001,7/1/2021,DEU,Johor,0,0,0,Germany
31002,7/1/2021,DEU,Kedah,0,0,0,Germany
31003,7/1/2021,DEU,Kelantan,0,0,0,Germany
31004,7/1/2021,DEU,Melaka,0,0,0,Germany
31005,7/1/2021,DEU,Negeri Sembilan,0,0,0,Germany
31006,7/1/2021,DEU,Pahang,0,0,0,Germany
31007,7/1/2021,DEU,Perak,0,0,0,Germany
31008,7/1/2021,DEU,Perlis,0,0,0,Germany
31009,7/1/2021,DEU,Pulau Pinang,2,2,0,Germany
31010,7/1/2021,DEU,Sabah,1,1,0,Germany
31011,7/1/2021,DEU,Sarawak,1,1,0,Germany
31012,7/1/2021,DEU,Selangor,78,47,31,Germany
31013,7/1/2021,DEU,Terengganu,0,0,0,Germany
31014,7/1/2021,DEU,W.P. Labuan,0,0,0,Germany
31015,7/1/2021,DJI,Johor,0,0,0,Djibouti
31016,7/1/2021,DJI,Selangor,1,1,0,Djibouti
31017,7/1/2021,DMA,Johor,0,0,0,Dominica
31018,7/1/2021,DMA,Kedah,0,0,0,Dominica
31019,7/1/2021,DMA,Pulau Pinang,0,0,0,Dominica
31020,7/1/2021,DMA,Sabah,0,0,0,Dominica
31021,7/1/2021,DMA,Sarawak,0,0,0,Dominica
31022,7/1/2021,DMA,Selangor,0,0,0,Dominica
31023,7/1/2021,DMA,W.P. Labuan,0,0,0,Dominica
31024,7/1/2021,DNK,Johor,0,0,0,Denmark
31025,7/1/2021,DNK,Kedah,0,0,0,Denmark
31026,7/1/2021,DNK,Kelantan,0,0,0,Denmark
31027,7/1/2021,DNK,Melaka,0,0,0,Denmark
31028,7/1/2021,DNK,Negeri Sembilan,0,0,0,Denmark
31029,7/1/2021,DNK,Pahang,0,0,0,Denmark
31030,7/1/2021,DNK,Perak,0,0,0,Denmark
31031,7/1/2021,DNK,Perlis,0,0,0,Denmark
31032,7/1/2021,DNK,Pulau Pinang,0,0,0,Denmark
31033,7/1/2021,DNK,Sabah,0,0,0,Denmark
31034,7/1/2021,DNK,Sarawak,0,0,0,Denmark
31035,7/1/2021,DNK,Selangor,14,10,4,Denmark
31036,7/1/2021,DNK,W.P. Labuan,0,0,0,Denmark
31037,7/1/2021,DOM,Johor,0,0,0,Dominican Republic
31038,7/1/2021,DOM,Kedah,0,0,0,Dominican Republic
31039,7/1/2021,DOM,Perak,0,0,0,Dominican Republic
31040,7/1/2021,DOM,Perlis,0,0,0,Dominican Republic
31041,7/1/2021,DOM,Pulau Pinang,0,0,0,Dominican Republic
31042,7/1/2021,DOM,Sabah,0,0,0,Dominican Republic
31043,7/1/2021,DOM,Sarawak,0,0,0,Dominican Republic
31044,7/1/2021,DOM,Selangor,0,0,0,Dominican Republic
31045,7/1/2021,DZA,Johor,0,0,0,Algeria
31046,7/1/2021,DZA,Kedah,0,0,0,Algeria
31047,7/1/2021,DZA,Kelantan,0,0,0,Algeria
31048,7/1/2021,DZA,Melaka,0,0,0,Algeria
31049,7/1/2021,DZA,Perak,0,0,0,Algeria
31050,7/1/2021,DZA,Perlis,0,0,0,Algeria
31051,7/1/2021,DZA,Pulau Pinang,0,0,0,Algeria
31052,7/1/2021,DZA,Sabah,0,0,0,Algeria
31053,7/1/2021,DZA,Sarawak,0,0,0,Algeria
31054,7/1/2021,DZA,Selangor,3,1,2,Algeria
31055,7/1/2021,DZA,W.P. Labuan,0,0,0,Algeria
31056,7/1/2021,ECU,Johor,0,0,0,Ecuador
31057,7/1/2021,ECU,Kedah,0,0,0,Ecuador
31058,7/1/2021,ECU,Perak,0,0,0,Ecuador
31059,7/1/2021,ECU,Perlis,0,0,0,Ecuador
31060,7/1/2021,ECU,Pulau Pinang,0,0,0,Ecuador
31061,7/1/2021,ECU,Sabah,0,0,0,Ecuador
31062,7/1/2021,ECU,Sarawak,0,0,0,Ecuador
31063,7/1/2021,ECU,Selangor,0,0,0,Ecuador
31064,7/1/2021,EGY,Johor,0,0,0,Egypt
31065,7/1/2021,EGY,Kedah,0,0,0,Egypt
31066,7/1/2021,EGY,Kelantan,0,0,0,Egypt
31067,7/1/2021,EGY,Melaka,0,0,0,Egypt
31068,7/1/2021,EGY,Pahang,0,0,0,Egypt
31069,7/1/2021,EGY,Perak,0,0,0,Egypt
31070,7/1/2021,EGY,Perlis,0,0,0,Egypt
31071,7/1/2021,EGY,Pulau Pinang,0,0,0,Egypt
31072,7/1/2021,EGY,Sabah,0,0,0,Egypt
31073,7/1/2021,EGY,Sarawak,0,0,0,Egypt
31074,7/1/2021,EGY,Selangor,52,39,13,Egypt
31075,7/1/2021,EGY,Terengganu,0,0,0,Egypt
31076,7/1/2021,EGY,W.P. Labuan,0,0,0,Egypt
31077,7/1/2021,ERI,Johor,0,0,0,Eritrea
31078,7/1/2021,ERI,Pulau Pinang,0,0,0,Eritrea
31079,7/1/2021,ERI,Sabah,0,0,0,Eritrea
31080,7/1/2021,ERI,Selangor,0,0,0,Eritrea
31081,7/1/2021,ESP,Johor,2,2,0,Spain
31082,7/1/2021,ESP,Kedah,0,0,0,Spain
31083,7/1/2021,ESP,Kelantan,0,0,0,Spain
31084,7/1/2021,ESP,Melaka,0,0,0,Spain
31085,7/1/2021,ESP,Negeri Sembilan,0,0,0,Spain
31086,7/1/2021,ESP,Pahang,0,0,0,Spain
31087,7/1/2021,ESP,Perak,0,0,0,Spain
31088,7/1/2021,ESP,Perlis,0,0,0,Spain
31089,7/1/2021,ESP,Pulau Pinang,0,0,0,Spain
31090,7/1/2021,ESP,Sabah,0,0,0,Spain
31091,7/1/2021,ESP,Sarawak,0,0,0,Spain
31092,7/1/2021,ESP,Selangor,30,20,10,Spain
31093,7/1/2021,ESP,W.P. Labuan,0,0,0,Spain
31094,7/1/2021,EST,Johor,0,0,0,Estonia
31095,7/1/2021,EST,Kedah,0,0,0,Estonia
31096,7/1/2021,EST,Kelantan,0,0,0,Estonia
31097,7/1/2021,EST,Pahang,0,0,0,Estonia
31098,7/1/2021,EST,Perak,0,0,0,Estonia
31099,7/1/2021,EST,Perlis,0,0,0,Estonia
31100,7/1/2021,EST,Pulau Pinang,0,0,0,Estonia
31101,7/1/2021,EST,Sabah,0,0,0,Estonia
31102,7/1/2021,EST,Sarawak,0,0,0,Estonia
31103,7/1/2021,EST,Selangor,0,0,0,Estonia
31104,7/1/2021,EST,W.P. Labuan,0,0,0,Estonia
31105,7/1/2021,ETH,Johor,0,0,0,Ethiopia
31106,7/1/2021,ETH,Kedah,0,0,0,Ethiopia
31107,7/1/2021,ETH,Pulau Pinang,0,0,0,Ethiopia
31108,7/1/2021,ETH,Sarawak,1,0,1,Ethiopia
31109,7/1/2021,ETH,Selangor,2,1,1,Ethiopia
31110,7/1/2021,FIN,Johor,0,0,0,Finland
31111,7/1/2021,FIN,Kedah,0,0,0,Finland
31112,7/1/2021,FIN,Kelantan,0,0,0,Finland
31113,7/1/2021,FIN,Melaka,0,0,0,Finland
31114,7/1/2021,FIN,Negeri Sembilan,0,0,0,Finland
31115,7/1/2021,FIN,Pahang,0,0,0,Finland
31116,7/1/2021,FIN,Perak,0,0,0,Finland
31117,7/1/2021,FIN,Perlis,0,0,0,Finland
31118,7/1/2021,FIN,Pulau Pinang,0,0,0,Finland
31119,7/1/2021,FIN,Sabah,0,0,0,Finland
31120,7/1/2021,FIN,Sarawak,0,0,0,Finland
31121,7/1/2021,FIN,Selangor,16,13,3,Finland
31122,7/1/2021,FIN,W.P. Labuan,0,0,0,Finland
31123,7/1/2021,FJI,Johor,0,0,0,Fiji
31124,7/1/2021,FJI,Kedah,0,0,0,Fiji
31125,7/1/2021,FJI,Kelantan,0,0,0,Fiji
31126,7/1/2021,FJI,Perak,0,0,0,Fiji
31127,7/1/2021,FJI,Perlis,0,0,0,Fiji
31128,7/1/2021,FJI,Pulau Pinang,0,0,0,Fiji
31129,7/1/2021,FJI,Sabah,0,0,0,Fiji
31130,7/1/2021,FJI,Sarawak,0,0,0,Fiji
31131,7/1/2021,FJI,Selangor,0,0,0,Fiji
31132,7/1/2021,FRA,Johor,0,0,0,France
31133,7/1/2021,FRA,Kedah,0,0,0,France
31134,7/1/2021,FRA,Kelantan,0,0,0,France
31135,7/1/2021,FRA,Melaka,0,0,0,France
31136,7/1/2021,FRA,Negeri Sembilan,0,0,0,France
31137,7/1/2021,FRA,Pahang,0,0,0,France
31138,7/1/2021,FRA,Perak,0,0,0,France
31139,7/1/2021,FRA,Perlis,0,0,0,France
31140,7/1/2021,FRA,Pulau Pinang,1,1,0,France
31141,7/1/2021,FRA,Sabah,0,0,0,France
31142,7/1/2021,FRA,Sarawak,2,2,0,France
31143,7/1/2021,FRA,Selangor,99,72,27,France
31144,7/1/2021,FRA,Terengganu,0,0,0,France
31145,7/1/2021,FRA,W.P. Labuan,0,0,0,France
31146,7/1/2021,FSM,Johor,0,0,0,"Micronesia, Federated States of"
31147,7/1/2021,FSM,Pulau Pinang,0,0,0,"Micronesia, Federated States of"
31148,7/1/2021,FSM,Selangor,0,0,0,"Micronesia, Federated States of"
31149,7/1/2021,GAB,Johor,0,0,0,Gabon
31150,7/1/2021,GAB,Pulau Pinang,0,0,0,Gabon
31151,7/1/2021,GAB,Sarawak,0,0,0,Gabon
31152,7/1/2021,GAB,Selangor,0,0,0,Gabon
31153,7/1/2021,GBR,Johor,1,1,0,United Kingdom
31154,7/1/2021,GBR,Kedah,0,0,0,United Kingdom
31155,7/1/2021,GBR,Kelantan,0,0,0,United Kingdom
31156,7/1/2021,GBR,Melaka,0,0,0,United Kingdom
31157,7/1/2021,GBR,Negeri Sembilan,0,0,0,United Kingdom
31158,7/1/2021,GBR,Pahang,0,0,0,United Kingdom
31159,7/1/2021,GBR,Perak,0,0,0,United Kingdom
31160,7/1/2021,GBR,Perlis,0,0,0,United Kingdom
31161,7/1/2021,GBR,Pulau Pinang,7,4,3,United Kingdom
31162,7/1/2021,GBR,Sabah,0,0,0,United Kingdom
31163,7/1/2021,GBR,Sarawak,2,1,1,United Kingdom
31164,7/1/2021,GBR,Selangor,386,249,137,United Kingdom
31165,7/1/2021,GBR,Terengganu,0,0,0,United Kingdom
31166,7/1/2021,GBR,W.P. Labuan,0,0,0,United Kingdom
31167,7/1/2021,GEO,Johor,0,0,0,Georgia
31168,7/1/2021,GEO,Kedah,0,0,0,Georgia
31169,7/1/2021,GEO,Melaka,0,0,0,Georgia
31170,7/1/2021,GEO,Perak,0,0,0,Georgia
31171,7/1/2021,GEO,Perlis,0,0,0,Georgia
31172,7/1/2021,GEO,Pulau Pinang,0,0,0,Georgia
31173,7/1/2021,GEO,Sabah,0,0,0,Georgia
31174,7/1/2021,GEO,Sarawak,0,0,0,Georgia
31175,7/1/2021,GEO,Selangor,2,2,0,Georgia
31176,7/1/2021,GHA,Johor,0,0,0,Ghana
31177,7/1/2021,GHA,Kedah,0,0,0,Ghana
31178,7/1/2021,GHA,Kelantan,0,0,0,Ghana
31179,7/1/2021,GHA,Pulau Pinang,0,0,0,Ghana
31180,7/1/2021,GHA,Sabah,0,0,0,Ghana
31181,7/1/2021,GHA,Sarawak,0,0,0,Ghana
31182,7/1/2021,GHA,Selangor,2,2,0,Ghana
31183,7/1/2021,GIB,Johor,0,0,0,Gibraltar
31184,7/1/2021,GIB,Sarawak,0,0,0,Gibraltar
31185,7/1/2021,GIN,Johor,0,0,0,Guinea
31186,7/1/2021,GIN,Kedah,0,0,0,Guinea
31187,7/1/2021,GIN,Kelantan,0,0,0,Guinea
31188,7/1/2021,GIN,Perlis,0,0,0,Guinea
31189,7/1/2021,GIN,Pulau Pinang,0,0,0,Guinea
31190,7/1/2021,GIN,Sabah,0,0,0,Guinea
31191,7/1/2021,GIN,Sarawak,0,0,0,Guinea
31192,7/1/2021,GIN,Selangor,1,1,0,Guinea
31193,7/1/2021,GLP,Selangor,0,0,0,Guadeloupe
31194,7/1/2021,GMB,Johor,0,0,0,Gambia
31195,7/1/2021,GMB,Kedah,0,0,0,Gambia
31196,7/1/2021,GMB,Kelantan,0,0,0,Gambia
31197,7/1/2021,GMB,Pulau Pinang,0,0,0,Gambia
31198,7/1/2021,GMB,Sabah,0,0,0,Gambia
31199,7/1/2021,GMB,Sarawak,0,0,0,Gambia
31200,7/1/2021,GMB,Selangor,0,0,0,Gambia
31201,7/1/2021,GNB,Johor,0,0,0,Guinea-Bissau
31202,7/1/2021,GNB,Selangor,0,0,0,Guinea-Bissau
31203,7/1/2021,GNQ,Johor,0,0,0,Equatorial Guinea
31204,7/1/2021,GNQ,Selangor,0,0,0,Equatorial Guinea
31205,7/1/2021,GRC,Johor,1,1,0,Greece
31206,7/1/2021,GRC,Kedah,0,0,0,Greece
31207,7/1/2021,GRC,Kelantan,0,0,0,Greece
31208,7/1/2021,GRC,Melaka,0,0,0,Greece
31209,7/1/2021,GRC,Negeri Sembilan,0,0,0,Greece
31210,7/1/2021,GRC,Pahang,0,0,0,Greece
31211,7/1/2021,GRC,Perak,0,0,0,Greece
31212,7/1/2021,GRC,Perlis,0,0,0,Greece
31213,7/1/2021,GRC,Pulau Pinang,0,0,0,Greece
31214,7/1/2021,GRC,Sabah,0,0,0,Greece
31215,7/1/2021,GRC,Sarawak,0,0,0,Greece
31216,7/1/2021,GRC,Selangor,11,10,1,Greece
31217,7/1/2021,GRD,Johor,0,0,0,Grenada
31218,7/1/2021,GRD,Kedah,0,0,0,Grenada
31219,7/1/2021,GRD,Pulau Pinang,0,0,0,Grenada
31220,7/1/2021,GRD,Sabah,0,0,0,Grenada
31221,7/1/2021,GRD,Sarawak,0,0,0,Grenada
31222,7/1/2021,GRD,Selangor,0,0,0,Grenada
31223,7/1/2021,GRL,Johor,0,0,0,Greenland
31224,7/1/2021,GRL,Selangor,0,0,0,Greenland
31225,7/1/2021,GTM,Johor,0,0,0,Guatemala
31226,7/1/2021,GTM,Kedah,0,0,0,Guatemala
31227,7/1/2021,GTM,Pahang,0,0,0,Guatemala
31228,7/1/2021,GTM,Perak,0,0,0,Guatemala
31229,7/1/2021,GTM,Pulau Pinang,0,0,0,Guatemala
31230,7/1/2021,GTM,Sabah,0,0,0,Guatemala
31231,7/1/2021,GTM,Sarawak,0,0,0,Guatemala
31232,7/1/2021,GTM,Selangor,0,0,0,Guatemala
31233,7/1/2021,GTM,W.P. Labuan,0,0,0,Guatemala
31234,7/1/2021,GUY,Johor,0,0,0,Guyana
31235,7/1/2021,GUY,Kedah,0,0,0,Guyana
31236,7/1/2021,GUY,Pulau Pinang,0,0,0,Guyana
31237,7/1/2021,GUY,Sarawak,0,0,0,Guyana
31238,7/1/2021,GUY,Selangor,0,0,0,Guyana
31239,7/1/2021,HKG,Johor,0,0,0,Hong Kong
31240,7/1/2021,HKG,Kedah,0,0,0,Hong Kong
31241,7/1/2021,HKG,Kelantan,0,0,0,Hong Kong
31242,7/1/2021,HKG,Pahang,0,0,0,Hong Kong
31243,7/1/2021,HKG,Perak,0,0,0,Hong Kong
31244,7/1/2021,HKG,Perlis,0,0,0,Hong Kong
31245,7/1/2021,HKG,Pulau Pinang,2,1,1,Hong Kong
31246,7/1/2021,HKG,Sabah,0,0,0,Hong Kong
31247,7/1/2021,HKG,Sarawak,0,0,0,Hong Kong
31248,7/1/2021,HKG,Selangor,0,0,0,Hong Kong
31249,7/1/2021,HKG,Terengganu,0,0,0,Hong Kong
31250,7/1/2021,HMD,Johor,0,0,0,Heard Island and McDonald Islands
31251,7/1/2021,HND,Johor,0,0,0,Honduras
31252,7/1/2021,HND,Kedah,0,0,0,Honduras
31253,7/1/2021,HND,Perak,0,0,0,Honduras
31254,7/1/2021,HND,Pulau Pinang,0,0,0,Honduras
31255,7/1/2021,HND,Sabah,0,0,0,Honduras
31256,7/1/2021,HND,Sarawak,0,0,0,Honduras
31257,7/1/2021,HND,Selangor,0,0,0,Honduras
31258,7/1/2021,HRV,Johor,0,0,0,Croatia
31259,7/1/2021,HRV,Kedah,0,0,0,Croatia
31260,7/1/2021,HRV,Kelantan,0,0,0,Croatia
31261,7/1/2021,HRV,Melaka,0,0,0,Croatia
31262,7/1/2021,HRV,Pahang,0,0,0,Croatia
31263,7/1/2021,HRV,Perak,0,0,0,Croatia
31264,7/1/2021,HRV,Perlis,0,0,0,Croatia
31265,7/1/2021,HRV,Pulau Pinang,0,0,0,Croatia
31266,7/1/2021,HRV,Sabah,0,0,0,Croatia
31267,7/1/2021,HRV,Sarawak,0,0,0,Croatia
31268,7/1/2021,HRV,Selangor,13,13,0,Croatia
31269,7/1/2021,HTI,Johor,0,0,0,Haiti
31270,7/1/2021,HTI,Kedah,0,0,0,Haiti
31271,7/1/2021,HTI,Kelantan,0,0,0,Haiti
31272,7/1/2021,HTI,Perak,0,0,0,Haiti
31273,7/1/2021,HTI,Pulau Pinang,0,0,0,Haiti
31274,7/1/2021,HTI,Sabah,0,0,0,Haiti
31275,7/1/2021,HTI,Selangor,0,0,0,Haiti
31276,7/1/2021,HUN,Johor,0,0,0,Hungary
31277,7/1/2021,HUN,Kedah,0,0,0,Hungary
31278,7/1/2021,HUN,Kelantan,0,0,0,Hungary
31279,7/1/2021,HUN,Pahang,0,0,0,Hungary
31280,7/1/2021,HUN,Perak,0,0,0,Hungary
31281,7/1/2021,HUN,Perlis,0,0,0,Hungary
31282,7/1/2021,HUN,Pulau Pinang,0,0,0,Hungary
31283,7/1/2021,HUN,Sabah,0,0,0,Hungary
31284,7/1/2021,HUN,Sarawak,0,0,0,Hungary
31285,7/1/2021,HUN,Selangor,4,3,1,Hungary
31286,7/1/2021,HUN,W.P. Labuan,0,0,0,Hungary
31287,7/1/2021,IDN,Johor,59,49,10,Indonesia
31288,7/1/2021,IDN,Kedah,8,8,0,Indonesia
31289,7/1/2021,IDN,Kelantan,0,0,0,Indonesia
31290,7/1/2021,IDN,Melaka,2,1,1,Indonesia
31291,7/1/2021,IDN,Negeri Sembilan,0,0,0,Indonesia
31292,7/1/2021,IDN,Pahang,0,0,0,Indonesia
31293,7/1/2021,IDN,Perak,0,0,0,Indonesia
31294,7/1/2021,IDN,Perlis,3,3,0,Indonesia
31295,7/1/2021,IDN,Pulau Pinang,32,7,25,Indonesia
31296,7/1/2021,IDN,Sabah,0,0,0,Indonesia
31297,7/1/2021,IDN,Sarawak,347,343,4,Indonesia
31298,7/1/2021,IDN,Selangor,669,548,121,Indonesia
31299,7/1/2021,IDN,Terengganu,0,0,0,Indonesia
31300,7/1/2021,IDN,W.P. Labuan,6,6,0,Indonesia
31301,7/1/2021,IND,Johor,1,1,0,India
31302,7/1/2021,IND,Kedah,0,0,0,India
31303,7/1/2021,IND,Kelantan,0,0,0,India
31304,7/1/2021,IND,Melaka,0,0,0,India
31305,7/1/2021,IND,Negeri Sembilan,0,0,0,India
31306,7/1/2021,IND,Pahang,0,0,0,India
31307,7/1/2021,IND,Perak,0,0,0,India
31308,7/1/2021,IND,Perlis,0,0,0,India
31309,7/1/2021,IND,Pulau Pinang,0,0,0,India
31310,7/1/2021,IND,Sabah,0,0,0,India
31311,7/1/2021,IND,Sarawak,0,0,0,India
31312,7/1/2021,IND,Selangor,47,25,22,India
31313,7/1/2021,IND,Terengganu,0,0,0,India
31314,7/1/2021,IND,W.P. Labuan,0,0,0,India
31315,7/1/2021,IOT,Pulau Pinang,0,0,0,British Indian Ocean Territory
31316,7/1/2021,IOT,Selangor,0,0,0,British Indian Ocean Territory
31317,7/1/2021,IRL,Johor,0,0,0,Ireland
31318,7/1/2021,IRL,Kedah,0,0,0,Ireland
31319,7/1/2021,IRL,Kelantan,0,0,0,Ireland
31320,7/1/2021,IRL,Negeri Sembilan,0,0,0,Ireland
31321,7/1/2021,IRL,Pahang,0,0,0,Ireland
31322,7/1/2021,IRL,Perak,0,0,0,Ireland
31323,7/1/2021,IRL,Perlis,0,0,0,Ireland
31324,7/1/2021,IRL,Pulau Pinang,0,0,0,Ireland
31325,7/1/2021,IRL,Sabah,0,0,0,Ireland
31326,7/1/2021,IRL,Sarawak,0,0,0,Ireland
31327,7/1/2021,IRL,Selangor,20,12,8,Ireland
31328,7/1/2021,IRL,Terengganu,0,0,0,Ireland
31329,7/1/2021,IRL,W.P. Labuan,0,0,0,Ireland
31330,7/1/2021,IRN,Johor,0,0,0,Iran
31331,7/1/2021,IRN,Kedah,0,0,0,Iran
31332,7/1/2021,IRN,Kelantan,0,0,0,Iran
31333,7/1/2021,IRN,Perak,0,0,0,Iran
31334,7/1/2021,IRN,Perlis,0,0,0,Iran
31335,7/1/2021,IRN,Pulau Pinang,0,0,0,Iran
31336,7/1/2021,IRN,Sabah,0,0,0,Iran
31337,7/1/2021,IRN,Sarawak,0,0,0,Iran
31338,7/1/2021,IRN,Selangor,23,14,9,Iran
31339,7/1/2021,IRN,W.P. Labuan,0,0,0,Iran
31340,7/1/2021,IRQ,Johor,0,0,0,Iraq
31341,7/1/2021,IRQ,Kedah,0,0,0,Iraq
31342,7/1/2021,IRQ,Kelantan,0,0,0,Iraq
31343,7/1/2021,IRQ,Melaka,0,0,0,Iraq
31344,7/1/2021,IRQ,Pahang,0,0,0,Iraq
31345,7/1/2021,IRQ,Perak,0,0,0,Iraq
31346,7/1/2021,IRQ,Perlis,0,0,0,Iraq
31347,7/1/2021,IRQ,Pulau Pinang,0,0,0,Iraq
31348,7/1/2021,IRQ,Sabah,0,0,0,Iraq
31349,7/1/2021,IRQ,Sarawak,0,0,0,Iraq
31350,7/1/2021,IRQ,Selangor,16,12,4,Iraq
31351,7/1/2021,ISL,Johor,0,0,0,Iceland
31352,7/1/2021,ISL,Kedah,0,0,0,Iceland
31353,7/1/2021,ISL,Kelantan,0,0,0,Iceland
31354,7/1/2021,ISL,Perak,0,0,0,Iceland
31355,7/1/2021,ISL,Perlis,0,0,0,Iceland
31356,7/1/2021,ISL,Pulau Pinang,0,0,0,Iceland
31357,7/1/2021,ISL,Sabah,0,0,0,Iceland
31358,7/1/2021,ISL,Sarawak,0,0,0,Iceland
31359,7/1/2021,ISL,Selangor,0,0,0,Iceland
31360,7/1/2021,ISL,W.P. Labuan,0,0,0,Iceland
31361,7/1/2021,ISR,Pulau Pinang,0,0,0,Israel
31362,7/1/2021,ITA,Johor,0,0,0,Italy
31363,7/1/2021,ITA,Kedah,0,0,0,Italy
31364,7/1/2021,ITA,Kelantan,0,0,0,Italy
31365,7/1/2021,ITA,Melaka,0,0,0,Italy
31366,7/1/2021,ITA,Negeri Sembilan,0,0,0,Italy
31367,7/1/2021,ITA,Pahang,0,0,0,Italy
31368,7/1/2021,ITA,Perak,0,0,0,Italy
31369,7/1/2021,ITA,Perlis,0,0,0,Italy
31370,7/1/2021,ITA,Pulau Pinang,0,0,0,Italy
31371,7/1/2021,ITA,Sabah,0,0,0,Italy
31372,7/1/2021,ITA,Sarawak,0,0,0,Italy
31373,7/1/2021,ITA,Selangor,29,25,4,Italy
31374,7/1/2021,ITA,W.P. Labuan,0,0,0,Italy
31375,7/1/2021,JAM,Johor,0,0,0,Jamaica
31376,7/1/2021,JAM,Kedah,0,0,0,Jamaica
31377,7/1/2021,JAM,Perak,0,0,0,Jamaica
31378,7/1/2021,JAM,Pulau Pinang,0,0,0,Jamaica
31379,7/1/2021,JAM,Sabah,0,0,0,Jamaica
31380,7/1/2021,JAM,Sarawak,0,0,0,Jamaica
31381,7/1/2021,JAM,Selangor,0,0,0,Jamaica
31382,7/1/2021,JAM,W.P. Labuan,0,0,0,Jamaica
31383,7/1/2021,JOR,Johor,0,0,0,Jordan
31384,7/1/2021,JOR,Kedah,0,0,0,Jordan
31385,7/1/2021,JOR,Kelantan,0,0,0,Jordan
31386,7/1/2021,JOR,Melaka,0,0,0,Jordan
31387,7/1/2021,JOR,Perlis,0,0,0,Jordan
31388,7/1/2021,JOR,Pulau Pinang,0,0,0,Jordan
31389,7/1/2021,JOR,Sabah,0,0,0,Jordan
31390,7/1/2021,JOR,Sarawak,0,0,0,Jordan
31391,7/1/2021,JOR,Selangor,8,7,1,Jordan
31392,7/1/2021,JOR,W.P. Labuan,0,0,0,Jordan
31393,7/1/2021,JPN,Johor,0,0,0,Japan
31394,7/1/2021,JPN,Kedah,0,0,0,Japan
31395,7/1/2021,JPN,Kelantan,0,0,0,Japan
31396,7/1/2021,JPN,Melaka,0,0,0,Japan
31397,7/1/2021,JPN,Negeri Sembilan,0,0,0,Japan
31398,7/1/2021,JPN,Pahang,0,0,0,Japan
31399,7/1/2021,JPN,Perak,0,0,0,Japan
31400,7/1/2021,JPN,Perlis,0,0,0,Japan
31401,7/1/2021,JPN,Pulau Pinang,16,8,8,Japan
31402,7/1/2021,JPN,Sabah,0,0,0,Japan
31403,7/1/2021,JPN,Sarawak,8,8,0,Japan
31404,7/1/2021,JPN,Selangor,281,159,122,Japan
31405,7/1/2021,JPN,W.P. Labuan,0,0,0,Japan
31406,7/1/2021,KAZ,Johor,0,0,0,Kazakhstan
31407,7/1/2021,KAZ,Kedah,0,0,0,Kazakhstan
31408,7/1/2021,KAZ,Kelantan,0,0,0,Kazakhstan
31409,7/1/2021,KAZ,Melaka,0,0,0,Kazakhstan
31410,7/1/2021,KAZ,Perak,0,0,0,Kazakhstan
31411,7/1/2021,KAZ,Perlis,0,0,0,Kazakhstan
31412,7/1/2021,KAZ,Pulau Pinang,0,0,0,Kazakhstan
31413,7/1/2021,KAZ,Sabah,0,0,0,Kazakhstan
31414,7/1/2021,KAZ,Sarawak,0,0,0,Kazakhstan
31415,7/1/2021,KAZ,Selangor,7,5,2,Kazakhstan
31416,7/1/2021,KAZ,W.P. Labuan,0,0,0,Kazakhstan
31417,7/1/2021,KEN,Johor,0,0,0,Kenya
31418,7/1/2021,KEN,Kedah,0,0,0,Kenya
31419,7/1/2021,KEN,Kelantan,0,0,0,Kenya
31420,7/1/2021,KEN,Perak,0,0,0,Kenya
31421,7/1/2021,KEN,Perlis,0,0,0,Kenya
31422,7/1/2021,KEN,Pulau Pinang,0,0,0,Kenya
31423,7/1/2021,KEN,Sabah,0,0,0,Kenya
31424,7/1/2021,KEN,Sarawak,0,0,0,Kenya
31425,7/1/2021,KEN,Selangor,8,3,5,Kenya
31426,7/1/2021,KGZ,Johor,0,0,0,Kyrgyzstan
31427,7/1/2021,KGZ,Kedah,0,0,0,Kyrgyzstan
31428,7/1/2021,KGZ,Kelantan,0,0,0,Kyrgyzstan
31429,7/1/2021,KGZ,Perak,0,0,0,Kyrgyzstan
31430,7/1/2021,KGZ,Perlis,0,0,0,Kyrgyzstan
31431,7/1/2021,KGZ,Pulau Pinang,0,0,0,Kyrgyzstan
31432,7/1/2021,KGZ,Sabah,0,0,0,Kyrgyzstan
31433,7/1/2021,KGZ,Sarawak,0,0,0,Kyrgyzstan
31434,7/1/2021,KGZ,Selangor,6,2,4,Kyrgyzstan
31435,7/1/2021,KHM,Johor,0,0,0,Cambodia
31436,7/1/2021,KHM,Kedah,0,0,0,Cambodia
31437,7/1/2021,KHM,Kelantan,0,0,0,Cambodia
31438,7/1/2021,KHM,Melaka,0,0,0,Cambodia
31439,7/1/2021,KHM,Negeri Sembilan,0,0,0,Cambodia
31440,7/1/2021,KHM,Pahang,0,0,0,Cambodia
31441,7/1/2021,KHM,Perak,0,0,0,Cambodia
31442,7/1/2021,KHM,Perlis,0,0,0,Cambodia
31443,7/1/2021,KHM,Pulau Pinang,0,0,0,Cambodia
31444,7/1/2021,KHM,Sabah,0,0,0,Cambodia
31445,7/1/2021,KHM,Sarawak,0,0,0,Cambodia
31446,7/1/2021,KHM,Selangor,118,115,3,Cambodia
31447,7/1/2021,KHM,W.P. Labuan,0,0,0,Cambodia
31448,7/1/2021,KIR,Johor,0,0,0,Kiribati
31449,7/1/2021,KIR,Sabah,0,0,0,Kiribati
31450,7/1/2021,KIR,Selangor,4,4,0,Kiribati
31451,7/1/2021,KNA,Johor,0,0,0,Saint Kitts and Nevis
31452,7/1/2021,KNA,Kedah,0,0,0,Saint Kitts and Nevis
31453,7/1/2021,KNA,Perlis,0,0,0,Saint Kitts and Nevis
31454,7/1/2021,KNA,Pulau Pinang,0,0,0,Saint Kitts and Nevis
31455,7/1/2021,KNA,Sabah,0,0,0,Saint Kitts and Nevis
31456,7/1/2021,KNA,Selangor,0,0,0,Saint Kitts and Nevis
31457,7/1/2021,KNA,W.P. Labuan,0,0,0,Saint Kitts and Nevis
31458,7/1/2021,KOR,Johor,1,1,0,"Korea, Republic of (South Korea)"
31459,7/1/2021,KOR,Kedah,0,0,0,"Korea, Republic of (South Korea)"
31460,7/1/2021,KOR,Kelantan,0,0,0,"Korea, Republic of (South Korea)"
31461,7/1/2021,KOR,Melaka,0,0,0,"Korea, Republic of (South Korea)"
31462,7/1/2021,KOR,Negeri Sembilan,0,0,0,"Korea, Republic of (South Korea)"
31463,7/1/2021,KOR,Pahang,0,0,0,"Korea, Republic of (South Korea)"
31464,7/1/2021,KOR,Perak,0,0,0,"Korea, Republic of (South Korea)"
31465,7/1/2021,KOR,Perlis,0,0,0,"Korea, Republic of (South Korea)"
31466,7/1/2021,KOR,Pulau Pinang,9,5,4,"Korea, Republic of (South Korea)"
31467,7/1/2021,KOR,Sabah,0,0,0,"Korea, Republic of (South Korea)"
31468,7/1/2021,KOR,Sarawak,13,8,5,"Korea, Republic of (South Korea)"
31469,7/1/2021,KOR,Selangor,259,180,79,"Korea, Republic of (South Korea)"
31470,7/1/2021,KOR,Terengganu,0,0,0,"Korea, Republic of (South Korea)"
31471,7/1/2021,KOR,W.P. Labuan,0,0,0,"Korea, Republic of (South Korea)"
31472,7/1/2021,KWT,Johor,0,0,0,Kuwait
31473,7/1/2021,KWT,Kedah,0,0,0,Kuwait
31474,7/1/2021,KWT,Kelantan,0,0,0,Kuwait
31475,7/1/2021,KWT,Perak,0,0,0,Kuwait
31476,7/1/2021,KWT,Perlis,0,0,0,Kuwait
31477,7/1/2021,KWT,Pulau Pinang,0,0,0,Kuwait
31478,7/1/2021,KWT,Sabah,0,0,0,Kuwait
31479,7/1/2021,KWT,Sarawak,0,0,0,Kuwait
31480,7/1/2021,KWT,Selangor,8,3,5,Kuwait
31481,7/1/2021,KWT,W.P. Labuan,0,0,0,Kuwait
31482,7/1/2021,LAO,Johor,0,0,0,Lao People's Democratic Republic
31483,7/1/2021,LAO,Kedah,0,0,0,Lao People's Democratic Republic
31484,7/1/2021,LAO,Kelantan,0,0,0,Lao People's Democratic Republic
31485,7/1/2021,LAO,Melaka,0,0,0,Lao People's Democratic Republic
31486,7/1/2021,LAO,Perak,0,0,0,Lao People's Democratic Republic
31487,7/1/2021,LAO,Perlis,0,0,0,Lao People's Democratic Republic
31488,7/1/2021,LAO,Pulau Pinang,0,0,0,Lao People's Democratic Republic
31489,7/1/2021,LAO,Sabah,0,0,0,Lao People's Democratic Republic
31490,7/1/2021,LAO,Sarawak,0,0,0,Lao People's Democratic Republic
31491,7/1/2021,LAO,Selangor,96,95,1,Lao People's Democratic Republic
31492,7/1/2021,LAO,W.P. Labuan,0,0,0,Lao People's Democratic Republic
31493,7/1/2021,LBN,Johor,0,0,0,Lebanon
31494,7/1/2021,LBN,Kedah,0,0,0,Lebanon
31495,7/1/2021,LBN,Kelantan,0,0,0,Lebanon
31496,7/1/2021,LBN,Pahang,0,0,0,Lebanon
31497,7/1/2021,LBN,Perak,0,0,0,Lebanon
31498,7/1/2021,LBN,Perlis,0,0,0,Lebanon
31499,7/1/2021,LBN,Pulau Pinang,0,0,0,Lebanon
31500,7/1/2021,LBN,Sabah,0,0,0,Lebanon
31501,7/1/2021,LBN,Sarawak,0,0,0,Lebanon
31502,7/1/2021,LBN,Selangor,2,2,0,Lebanon
31503,7/1/2021,LBN,W.P. Labuan,0,0,0,Lebanon
31504,7/1/2021,LBR,Johor,0,0,0,Liberia
31505,7/1/2021,LBR,Kedah,0,0,0,Liberia
31506,7/1/2021,LBR,Sabah,0,0,0,Liberia
31507,7/1/2021,LBR,Sarawak,0,0,0,Liberia
31508,7/1/2021,LBR,Selangor,1,0,1,Liberia
31509,7/1/2021,LBY,Johor,0,0,0,Libyan Arab Jamahiriya
31510,7/1/2021,LBY,Kedah,0,0,0,Libyan Arab Jamahiriya
31511,7/1/2021,LBY,Perlis,0,0,0,Libyan Arab Jamahiriya
31512,7/1/2021,LBY,Pulau Pinang,0,0,0,Libyan Arab Jamahiriya
31513,7/1/2021,LBY,Sabah,0,0,0,Libyan Arab Jamahiriya
31514,7/1/2021,LBY,Sarawak,0,0,0,Libyan Arab Jamahiriya
31515,7/1/2021,LBY,Selangor,14,13,1,Libyan Arab Jamahiriya
31516,7/1/2021,LCA,Johor,0,0,0,Saint Lucia
31517,7/1/2021,LCA,Kedah,0,0,0,Saint Lucia
31518,7/1/2021,LCA,Pulau Pinang,0,0,0,Saint Lucia
31519,7/1/2021,LCA,Sarawak,0,0,0,Saint Lucia
31520,7/1/2021,LCA,Selangor,0,0,0,Saint Lucia
31521,7/1/2021,LIE,Johor,0,0,0,Liechtenstein
31522,7/1/2021,LIE,Kedah,0,0,0,Liechtenstein
31523,7/1/2021,LIE,Perlis,0,0,0,Liechtenstein
31524,7/1/2021,LIE,Pulau Pinang,0,0,0,Liechtenstein
31525,7/1/2021,LIE,Sabah,0,0,0,Liechtenstein
31526,7/1/2021,LIE,Sarawak,0,0,0,Liechtenstein
31527,7/1/2021,LIE,Selangor,0,0,0,Liechtenstein
31528,7/1/2021,LKA,Johor,0,0,0,Sri Lanka
31529,7/1/2021,LKA,Kedah,0,0,0,Sri Lanka
31530,7/1/2021,LKA,Kelantan,0,0,0,Sri Lanka
31531,7/1/2021,LKA,Melaka,0,0,0,Sri Lanka
31532,7/1/2021,LKA,Pahang,0,0,0,Sri Lanka
31533,7/1/2021,LKA,Perak,0,0,0,Sri Lanka
31534,7/1/2021,LKA,Perlis,0,0,0,Sri Lanka
31535,7/1/2021,LKA,Pulau Pinang,0,0,0,Sri Lanka
31536,7/1/2021,LKA,Sabah,0,0,0,Sri Lanka
31537,7/1/2021,LKA,Sarawak,0,0,0,Sri Lanka
31538,7/1/2021,LKA,Selangor,8,4,4,Sri Lanka
31539,7/1/2021,LKA,W.P. Labuan,0,0,0,Sri Lanka
31540,7/1/2021,LSO,Johor,0,0,0,Lesotho
31541,7/1/2021,LSO,Kedah,0,0,0,Lesotho
31542,7/1/2021,LSO,Pulau Pinang,0,0,0,Lesotho
31543,7/1/2021,LSO,Sarawak,0,0,0,Lesotho
31544,7/1/2021,LSO,Selangor,0,0,0,Lesotho
31545,7/1/2021,LTU,Johor,0,0,0,Lithuania
31546,7/1/2021,LTU,Kedah,0,0,0,Lithuania
31547,7/1/2021,LTU,Kelantan,0,0,0,Lithuania
31548,7/1/2021,LTU,Pahang,0,0,0,Lithuania
31549,7/1/2021,LTU,Perak,0,0,0,Lithuania
31550,7/1/2021,LTU,Perlis,0,0,0,Lithuania
31551,7/1/2021,LTU,Pulau Pinang,0,0,0,Lithuania
31552,7/1/2021,LTU,Sabah,0,0,0,Lithuania
31553,7/1/2021,LTU,Sarawak,0,0,0,Lithuania
31554,7/1/2021,LTU,Selangor,1,1,0,Lithuania
31555,7/1/2021,LTU,W.P. Labuan,0,0,0,Lithuania
31556,7/1/2021,LUX,Johor,0,0,0,Luxembourg
31557,7/1/2021,LUX,Kedah,0,0,0,Luxembourg
31558,7/1/2021,LUX,Kelantan,0,0,0,Luxembourg
31559,7/1/2021,LUX,Perak,0,0,0,Luxembourg
31560,7/1/2021,LUX,Perlis,0,0,0,Luxembourg
31561,7/1/2021,LUX,Pulau Pinang,0,0,0,Luxembourg
31562,7/1/2021,LUX,Sabah,0,0,0,Luxembourg
31563,7/1/2021,LUX,Sarawak,0,0,0,Luxembourg
31564,7/1/2021,LUX,Selangor,0,0,0,Luxembourg
31565,7/1/2021,LVA,Johor,0,0,0,Latvia
31566,7/1/2021,LVA,Kedah,0,0,0,Latvia
31567,7/1/2021,LVA,Kelantan,0,0,0,Latvia
31568,7/1/2021,LVA,Pahang,0,0,0,Latvia
31569,7/1/2021,LVA,Perak,0,0,0,Latvia
31570,7/1/2021,LVA,Perlis,0,0,0,Latvia
31571,7/1/2021,LVA,Pulau Pinang,0,0,0,Latvia
31572,7/1/2021,LVA,Sabah,0,0,0,Latvia
31573,7/1/2021,LVA,Sarawak,0,0,0,Latvia
31574,7/1/2021,LVA,Selangor,0,0,0,Latvia
31575,7/1/2021,LVA,W.P. Labuan,0,0,0,Latvia
31576,7/1/2021,MAC,Johor,0,0,0,Macao
31577,7/1/2021,MAC,Pahang,0,0,0,Macao
31578,7/1/2021,MAC,Perak,0,0,0,Macao
31579,7/1/2021,MAC,Selangor,0,0,0,Macao
31580,7/1/2021,MAC,W.P. Labuan,0,0,0,Macao
31581,7/1/2021,MAR,Johor,0,0,0,Morocco
31582,7/1/2021,MAR,Kedah,0,0,0,Morocco
31583,7/1/2021,MAR,Kelantan,0,0,0,Morocco
31584,7/1/2021,MAR,Melaka,0,0,0,Morocco
31585,7/1/2021,MAR,Pahang,0,0,0,Morocco
31586,7/1/2021,MAR,Perak,0,0,0,Morocco
31587,7/1/2021,MAR,Perlis,0,0,0,Morocco
31588,7/1/2021,MAR,Pulau Pinang,0,0,0,Morocco
31589,7/1/2021,MAR,Sabah,0,0,0,Morocco
31590,7/1/2021,MAR,Sarawak,0,0,0,Morocco
31591,7/1/2021,MAR,Selangor,0,0,0,Morocco
31592,7/1/2021,MAR,W.P. Labuan,0,0,0,Morocco
31593,7/1/2021,MCO,Johor,0,0,0,Monaco
31594,7/1/2021,MCO,Kedah,0,0,0,Monaco
31595,7/1/2021,MCO,Sabah,0,0,0,Monaco
31596,7/1/2021,MCO,Selangor,0,0,0,Monaco
31597,7/1/2021,MDA,Johor,0,0,0,"Moldova, Republic of"
31598,7/1/2021,MDA,Kedah,0,0,0,"Moldova, Republic of"
31599,7/1/2021,MDA,Kelantan,0,0,0,"Moldova, Republic of"
31600,7/1/2021,MDA,Negeri Sembilan,0,0,0,"Moldova, Republic of"
31601,7/1/2021,MDA,Perlis,0,0,0,"Moldova, Republic of"
31602,7/1/2021,MDA,Pulau Pinang,0,0,0,"Moldova, Republic of"
31603,7/1/2021,MDA,Sabah,0,0,0,"Moldova, Republic of"
31604,7/1/2021,MDA,Sarawak,0,0,0,"Moldova, Republic of"
31605,7/1/2021,MDA,Selangor,0,0,0,"Moldova, Republic of"
31606,7/1/2021,MDG,Johor,0,0,0,Madagascar
31607,7/1/2021,MDG,Kedah,0,0,0,Madagascar
31608,7/1/2021,MDG,Perak,0,0,0,Madagascar
31609,7/1/2021,MDG,Perlis,0,0,0,Madagascar
31610,7/1/2021,MDG,Pulau Pinang,0,0,0,Madagascar
31611,7/1/2021,MDG,Sabah,0,0,0,Madagascar
31612,7/1/2021,MDG,Sarawak,0,0,0,Madagascar
31613,7/1/2021,MDG,Selangor,0,0,0,Madagascar
31614,7/1/2021,MDV,Johor,0,0,0,Maldives
31615,7/1/2021,MDV,Kedah,0,0,0,Maldives
31616,7/1/2021,MDV,Kelantan,0,0,0,Maldives
31617,7/1/2021,MDV,Perak,0,0,0,Maldives
31618,7/1/2021,MDV,Perlis,0,0,0,Maldives
31619,7/1/2021,MDV,Pulau Pinang,0,0,0,Maldives
31620,7/1/2021,MDV,Sabah,0,0,0,Maldives
31621,7/1/2021,MDV,Sarawak,0,0,0,Maldives
31622,7/1/2021,MDV,Selangor,24,8,16,Maldives
31623,7/1/2021,MEX,Johor,0,0,0,Mexico
31624,7/1/2021,MEX,Kedah,0,0,0,Mexico
31625,7/1/2021,MEX,Kelantan,0,0,0,Mexico
31626,7/1/2021,MEX,Pahang,0,0,0,Mexico
31627,7/1/2021,MEX,Perak,0,0,0,Mexico
31628,7/1/2021,MEX,Perlis,0,0,0,Mexico
31629,7/1/2021,MEX,Pulau Pinang,0,0,0,Mexico
31630,7/1/2021,MEX,Sabah,0,0,0,Mexico
31631,7/1/2021,MEX,Sarawak,0,0,0,Mexico
31632,7/1/2021,MEX,Selangor,13,9,4,Mexico
31633,7/1/2021,MEX,W.P. Labuan,0,0,0,Mexico
31634,7/1/2021,MHL,Johor,0,0,0,Marshall Islands
31635,7/1/2021,MHL,Kedah,0,0,0,Marshall Islands
31636,7/1/2021,MHL,Perak,0,0,0,Marshall Islands
31637,7/1/2021,MHL,Pulau Pinang,0,0,0,Marshall Islands
31638,7/1/2021,MHL,Sabah,0,0,0,Marshall Islands
31639,7/1/2021,MHL,Selangor,0,0,0,Marshall Islands
31640,7/1/2021,MKD,Johor,0,0,0,"Macedonia, the former Yugoslav Republic of"
31641,7/1/2021,MKD,Kedah,0,0,0,"Macedonia, the former Yugoslav Republic of"
31642,7/1/2021,MKD,Perak,0,0,0,"Macedonia, the former Yugoslav Republic of"
31643,7/1/2021,MKD,Pulau Pinang,0,0,0,"Macedonia, the former Yugoslav Republic of"
31644,7/1/2021,MKD,Sabah,0,0,0,"Macedonia, the former Yugoslav Republic of"
31645,7/1/2021,MKD,Sarawak,0,0,0,"Macedonia, the former Yugoslav Republic of"
31646,7/1/2021,MKD,Selangor,0,0,0,"Macedonia, the former Yugoslav Republic of"
31647,7/1/2021,MLI,Johor,0,0,0,Mali
31648,7/1/2021,MLI,Sabah,0,0,0,Mali
31649,7/1/2021,MLI,Selangor,0,0,0,Mali
31650,7/1/2021,MLT,Johor,0,0,0,Malta
31651,7/1/2021,MLT,Kedah,0,0,0,Malta
31652,7/1/2021,MLT,Kelantan,0,0,0,Malta
31653,7/1/2021,MLT,Perak,0,0,0,Malta
31654,7/1/2021,MLT,Perlis,0,0,0,Malta
31655,7/1/2021,MLT,Pulau Pinang,0,0,0,Malta
31656,7/1/2021,MLT,Sabah,0,0,0,Malta
31657,7/1/2021,MLT,Sarawak,0,0,0,Malta
31658,7/1/2021,MLT,Selangor,0,0,0,Malta
31659,7/1/2021,MLT,W.P. Labuan,0,0,0,Malta
31660,7/1/2021,MMR,Johor,0,0,0,Myanmar
31661,7/1/2021,MMR,Kedah,0,0,0,Myanmar
31662,7/1/2021,MMR,Kelantan,0,0,0,Myanmar
31663,7/1/2021,MMR,Negeri Sembilan,0,0,0,Myanmar
31664,7/1/2021,MMR,Pahang,0,0,0,Myanmar
31665,7/1/2021,MMR,Perak,0,0,0,Myanmar
31666,7/1/2021,MMR,Perlis,0,0,0,Myanmar
31667,7/1/2021,MMR,Pulau Pinang,0,0,0,Myanmar
31668,7/1/2021,MMR,Sabah,0,0,0,Myanmar
31669,7/1/2021,MMR,Sarawak,0,0,0,Myanmar
31670,7/1/2021,MMR,Selangor,112,105,7,Myanmar
31671,7/1/2021,MMR,Terengganu,0,0,0,Myanmar
31672,7/1/2021,MMR,W.P. Labuan,0,0,0,Myanmar
31673,7/1/2021,MNE,Johor,0,0,0,Montenegro
31674,7/1/2021,MNE,Kedah,0,0,0,Montenegro
31675,7/1/2021,MNE,Pulau Pinang,0,0,0,Montenegro
31676,7/1/2021,MNE,Sabah,0,0,0,Montenegro
31677,7/1/2021,MNE,Sarawak,0,0,0,Montenegro
31678,7/1/2021,MNE,Selangor,5,4,1,Montenegro
31679,7/1/2021,MNG,Johor,0,0,0,Mongolia
31680,7/1/2021,MNG,Kedah,0,0,0,Mongolia
31681,7/1/2021,MNG,Kelantan,0,0,0,Mongolia
31682,7/1/2021,MNG,Perak,0,0,0,Mongolia
31683,7/1/2021,MNG,Perlis,0,0,0,Mongolia
31684,7/1/2021,MNG,Pulau Pinang,0,0,0,Mongolia
31685,7/1/2021,MNG,Sabah,0,0,0,Mongolia
31686,7/1/2021,MNG,Sarawak,0,0,0,Mongolia
31687,7/1/2021,MNG,Selangor,0,0,0,Mongolia
31688,7/1/2021,MNP,Selangor,0,0,0,Northern Mariana Islands
31689,7/1/2021,MOZ,Johor,0,0,0,Mozambique
31690,7/1/2021,MOZ,Kedah,0,0,0,Mozambique
31691,7/1/2021,MOZ,Perak,0,0,0,Mozambique
31692,7/1/2021,MOZ,Pulau Pinang,0,0,0,Mozambique
31693,7/1/2021,MOZ,Sabah,0,0,0,Mozambique
31694,7/1/2021,MOZ,Sarawak,0,0,0,Mozambique
31695,7/1/2021,MOZ,Selangor,0,0,0,Mozambique
31696,7/1/2021,MRT,Johor,0,0,0,Mauritania
31697,7/1/2021,MRT,Kedah,0,0,0,Mauritania
31698,7/1/2021,MRT,Pulau Pinang,0,0,0,Mauritania
31699,7/1/2021,MRT,Sabah,0,0,0,Mauritania
31700,7/1/2021,MRT,Sarawak,0,0,0,Mauritania
31701,7/1/2021,MRT,Selangor,1,1,0,Mauritania
31702,7/1/2021,MUS,Johor,0,0,0,Mauritius
31703,7/1/2021,MUS,Kedah,0,0,0,Mauritius
31704,7/1/2021,MUS,Kelantan,0,0,0,Mauritius
31705,7/1/2021,MUS,Pahang,0,0,0,Mauritius
31706,7/1/2021,MUS,Perak,0,0,0,Mauritius
31707,7/1/2021,MUS,Perlis,0,0,0,Mauritius
31708,7/1/2021,MUS,Pulau Pinang,0,0,0,Mauritius
31709,7/1/2021,MUS,Sabah,0,0,0,Mauritius
31710,7/1/2021,MUS,Sarawak,0,0,0,Mauritius
31711,7/1/2021,MUS,Selangor,5,4,1,Mauritius
31712,7/1/2021,MWI,Johor,0,0,0,Malawi
31713,7/1/2021,MWI,Pulau Pinang,0,0,0,Malawi
31714,7/1/2021,MWI,Sabah,0,0,0,Malawi
31715,7/1/2021,MWI,Sarawak,0,0,0,Malawi
31716,7/1/2021,MWI,Selangor,1,1,0,Malawi
31717,7/1/2021,MYT,Selangor,0,0,0,Mayotte
31718,7/1/2021,NAM,Johor,0,0,0,Namibia
31719,7/1/2021,NAM,Kedah,0,0,0,Namibia
31720,7/1/2021,NAM,Perak,0,0,0,Namibia
31721,7/1/2021,NAM,Perlis,0,0,0,Namibia
31722,7/1/2021,NAM,Pulau Pinang,0,0,0,Namibia
31723,7/1/2021,NAM,Sabah,0,0,0,Namibia
31724,7/1/2021,NAM,Sarawak,0,0,0,Namibia
31725,7/1/2021,NAM,Selangor,0,0,0,Namibia
31726,7/1/2021,NCL,Selangor,0,0,0,New Caledonia
31727,7/1/2021,NER,Johor,0,0,0,Niger
31728,7/1/2021,NER,Sabah,0,0,0,Niger
31729,7/1/2021,NER,Selangor,0,0,0,Niger
31730,7/1/2021,NGA,Johor,0,0,0,Nigeria
31731,7/1/2021,NGA,Kedah,0,0,0,Nigeria
31732,7/1/2021,NGA,Perlis,0,0,0,Nigeria
31733,7/1/2021,NGA,Pulau Pinang,0,0,0,Nigeria
31734,7/1/2021,NGA,Sabah,0,0,0,Nigeria
31735,7/1/2021,NGA,Sarawak,0,0,0,Nigeria
31736,7/1/2021,NGA,Selangor,65,58,7,Nigeria
31737,7/1/2021,NIC,Johor,0,0,0,Nicaragua
31738,7/1/2021,NIC,Kedah,0,0,0,Nicaragua
31739,7/1/2021,NIC,Pulau Pinang,0,0,0,Nicaragua
31740,7/1/2021,NIC,Sabah,0,0,0,Nicaragua
31741,7/1/2021,NIC,Selangor,3,1,2,Nicaragua
31742,7/1/2021,NLD,Johor,0,0,0,Netherlands
31743,7/1/2021,NLD,Kedah,0,0,0,Netherlands
31744,7/1/2021,NLD,Kelantan,0,0,0,Netherlands
31745,7/1/2021,NLD,Melaka,0,0,0,Netherlands
31746,7/1/2021,NLD,Negeri Sembilan,0,0,0,Netherlands
31747,7/1/2021,NLD,Pahang,0,0,0,Netherlands
31748,7/1/2021,NLD,Perak,0,0,0,Netherlands
31749,7/1/2021,NLD,Perlis,0,0,0,Netherlands
31750,7/1/2021,NLD,Pulau Pinang,2,1,1,Netherlands
31751,7/1/2021,NLD,Sabah,0,0,0,Netherlands
31752,7/1/2021,NLD,Sarawak,1,1,0,Netherlands
31753,7/1/2021,NLD,Selangor,54,36,18,Netherlands
31754,7/1/2021,NLD,Terengganu,0,0,0,Netherlands
31755,7/1/2021,NLD,W.P. Labuan,0,0,0,Netherlands
31756,7/1/2021,NOR,Johor,0,0,0,Norway
31757,7/1/2021,NOR,Kedah,0,0,0,Norway
31758,7/1/2021,NOR,Kelantan,0,0,0,Norway
31759,7/1/2021,NOR,Melaka,0,0,0,Norway
31760,7/1/2021,NOR,Pahang,0,0,0,Norway
31761,7/1/2021,NOR,Perak,0,0,0,Norway
31762,7/1/2021,NOR,Perlis,0,0,0,Norway
31763,7/1/2021,NOR,Pulau Pinang,0,0,0,Norway
31764,7/1/2021,NOR,Sabah,0,0,0,Norway
31765,7/1/2021,NOR,Sarawak,0,0,0,Norway
31766,7/1/2021,NOR,Selangor,13,9,4,Norway
31767,7/1/2021,NOR,W.P. Labuan,0,0,0,Norway
31768,7/1/2021,NPL,Johor,0,0,0,Nepal
31769,7/1/2021,NPL,Kedah,0,0,0,Nepal
31770,7/1/2021,NPL,Pahang,0,0,0,Nepal
31771,7/1/2021,NPL,Perak,0,0,0,Nepal
31772,7/1/2021,NPL,Perlis,0,0,0,Nepal
31773,7/1/2021,NPL,Pulau Pinang,0,0,0,Nepal
31774,7/1/2021,NPL,Sabah,0,0,0,Nepal
31775,7/1/2021,NPL,Sarawak,0,0,0,Nepal
31776,7/1/2021,NPL,Selangor,1,1,0,Nepal
31777,7/1/2021,NPL,W.P. Labuan,0,0,0,Nepal
31778,7/1/2021,NRU,Johor,0,0,0,Nauru
31779,7/1/2021,NRU,Pulau Pinang,0,0,0,Nauru
31780,7/1/2021,NRU,Selangor,0,0,0,Nauru
31781,7/1/2021,NZL,Johor,0,0,0,New Zealand
31782,7/1/2021,NZL,Kedah,0,0,0,New Zealand
31783,7/1/2021,NZL,Kelantan,0,0,0,New Zealand
31784,7/1/2021,NZL,Melaka,0,0,0,New Zealand
31785,7/1/2021,NZL,Negeri Sembilan,0,0,0,New Zealand
31786,7/1/2021,NZL,Pahang,0,0,0,New Zealand
31787,7/1/2021,NZL,Perak,0,0,0,New Zealand
31788,7/1/2021,NZL,Perlis,0,0,0,New Zealand
31789,7/1/2021,NZL,Pulau Pinang,2,2,0,New Zealand
31790,7/1/2021,NZL,Sabah,0,0,0,New Zealand
31791,7/1/2021,NZL,Sarawak,0,0,0,New Zealand
31792,7/1/2021,NZL,Selangor,23,17,6,New Zealand
31793,7/1/2021,NZL,Terengganu,0,0,0,New Zealand
31794,7/1/2021,NZL,W.P. Labuan,0,0,0,New Zealand
31795,7/1/2021,OMN,Johor,0,0,0,Oman
31796,7/1/2021,OMN,Kedah,0,0,0,Oman
31797,7/1/2021,OMN,Kelantan,0,0,0,Oman
31798,7/1/2021,OMN,Melaka,0,0,0,Oman
31799,7/1/2021,OMN,Perak,0,0,0,Oman
31800,7/1/2021,OMN,Perlis,0,0,0,Oman
31801,7/1/2021,OMN,Pulau Pinang,0,0,0,Oman
31802,7/1/2021,OMN,Sabah,0,0,0,Oman
31803,7/1/2021,OMN,Sarawak,0,0,0,Oman
31804,7/1/2021,OMN,Selangor,9,8,1,Oman
31805,7/1/2021,PAK,Johor,0,0,0,Pakistan
31806,7/1/2021,PAK,Kedah,0,0,0,Pakistan
31807,7/1/2021,PAK,Kelantan,0,0,0,Pakistan
31808,7/1/2021,PAK,Melaka,0,0,0,Pakistan
31809,7/1/2021,PAK,Negeri Sembilan,0,0,0,Pakistan
31810,7/1/2021,PAK,Pahang,0,0,0,Pakistan
31811,7/1/2021,PAK,Perak,0,0,0,Pakistan
31812,7/1/2021,PAK,Perlis,0,0,0,Pakistan
31813,7/1/2021,PAK,Pulau Pinang,0,0,0,Pakistan
31814,7/1/2021,PAK,Sabah,0,0,0,Pakistan
31815,7/1/2021,PAK,Sarawak,0,0,0,Pakistan
31816,7/1/2021,PAK,Selangor,6,5,1,Pakistan
31817,7/1/2021,PAK,W.P. Labuan,0,0,0,Pakistan
31818,7/1/2021,PAN,Johor,0,0,0,Panama
31819,7/1/2021,PAN,Kedah,0,0,0,Panama
31820,7/1/2021,PAN,Perak,0,0,0,Panama
31821,7/1/2021,PAN,Perlis,0,0,0,Panama
31822,7/1/2021,PAN,Pulau Pinang,0,0,0,Panama
31823,7/1/2021,PAN,Sabah,0,0,0,Panama
31824,7/1/2021,PAN,Sarawak,0,0,0,Panama
31825,7/1/2021,PAN,Selangor,5,4,1,Panama
31826,7/1/2021,PER,Johor,0,0,0,Peru
31827,7/1/2021,PER,Kedah,0,0,0,Peru
31828,7/1/2021,PER,Kelantan,0,0,0,Peru
31829,7/1/2021,PER,Pahang,0,0,0,Peru
31830,7/1/2021,PER,Perak,0,0,0,Peru
31831,7/1/2021,PER,Perlis,0,0,0,Peru
31832,7/1/2021,PER,Pulau Pinang,0,0,0,Peru
31833,7/1/2021,PER,Sabah,0,0,0,Peru
31834,7/1/2021,PER,Sarawak,0,0,0,Peru
31835,7/1/2021,PER,Selangor,1,1,0,Peru
31836,7/1/2021,PER,W.P. Labuan,0,0,0,Peru
31837,7/1/2021,PHL,Johor,6,4,2,Philippines
31838,7/1/2021,PHL,Kedah,0,0,0,Philippines
31839,7/1/2021,PHL,Kelantan,0,0,0,Philippines
31840,7/1/2021,PHL,Melaka,0,0,0,Philippines
31841,7/1/2021,PHL,Negeri Sembilan,0,0,0,Philippines
31842,7/1/2021,PHL,Pahang,0,0,0,Philippines
31843,7/1/2021,PHL,Perak,0,0,0,Philippines
31844,7/1/2021,PHL,Perlis,0,0,0,Philippines
31845,7/1/2021,PHL,Pulau Pinang,5,2,3,Philippines
31846,7/1/2021,PHL,Sabah,1,1,0,Philippines
31847,7/1/2021,PHL,Sarawak,35,35,0,Philippines
31848,7/1/2021,PHL,Selangor,634,508,126,Philippines
31849,7/1/2021,PHL,Terengganu,0,0,0,Philippines
31850,7/1/2021,PHL,W.P. Labuan,9,9,0,Philippines
31851,7/1/2021,PLW,Johor,0,0,0,Palau
31852,7/1/2021,PLW,Pulau Pinang,0,0,0,Palau
31853,7/1/2021,PLW,Selangor,0,0,0,Palau
31854,7/1/2021,PNG,Johor,0,0,0,Papua New Guinea
31855,7/1/2021,PNG,Kedah,0,0,0,Papua New Guinea
31856,7/1/2021,PNG,Kelantan,0,0,0,Papua New Guinea
31857,7/1/2021,PNG,Perak,0,0,0,Papua New Guinea
31858,7/1/2021,PNG,Pulau Pinang,0,0,0,Papua New Guinea
31859,7/1/2021,PNG,Sabah,0,0,0,Papua New Guinea
31860,7/1/2021,PNG,Sarawak,0,0,0,Papua New Guinea
31861,7/1/2021,PNG,Selangor,0,0,0,Papua New Guinea
31862,7/1/2021,POL,Johor,0,0,0,Poland
31863,7/1/2021,POL,Kedah,0,0,0,Poland
31864,7/1/2021,POL,Kelantan,0,0,0,Poland
31865,7/1/2021,POL,Melaka,0,0,0,Poland
31866,7/1/2021,POL,Negeri Sembilan,0,0,0,Poland
31867,7/1/2021,POL,Pahang,0,0,0,Poland
31868,7/1/2021,POL,Perak,0,0,0,Poland
31869,7/1/2021,POL,Perlis,0,0,0,Poland
31870,7/1/2021,POL,Pulau Pinang,0,0,0,Poland
31871,7/1/2021,POL,Sabah,0,0,0,Poland
31872,7/1/2021,POL,Sarawak,0,0,0,Poland
31873,7/1/2021,POL,Selangor,25,21,4,Poland
31874,7/1/2021,POL,Terengganu,0,0,0,Poland
31875,7/1/2021,POL,W.P. Labuan,0,0,0,Poland
31876,7/1/2021,PRK,Selangor,0,0,0,"Korea, Democratic People's Republic of"
31877,7/1/2021,PRT,Johor,0,0,0,Portugal
31878,7/1/2021,PRT,Kedah,0,0,0,Portugal
31879,7/1/2021,PRT,Kelantan,0,0,0,Portugal
31880,7/1/2021,PRT,Melaka,0,0,0,Portugal
31881,7/1/2021,PRT,Pahang,0,0,0,Portugal
31882,7/1/2021,PRT,Perak,0,0,0,Portugal
31883,7/1/2021,PRT,Perlis,0,0,0,Portugal
31884,7/1/2021,PRT,Pulau Pinang,0,0,0,Portugal
31885,7/1/2021,PRT,Sabah,0,0,0,Portugal
31886,7/1/2021,PRT,Sarawak,0,0,0,Portugal
31887,7/1/2021,PRT,Selangor,9,5,4,Portugal
31888,7/1/2021,PRT,W.P. Labuan,0,0,0,Portugal
31889,7/1/2021,PRY,Johor,0,0,0,Paraguay
31890,7/1/2021,PRY,Kedah,0,0,0,Paraguay
31891,7/1/2021,PRY,Perak,0,0,0,Paraguay
31892,7/1/2021,PRY,Perlis,0,0,0,Paraguay
31893,7/1/2021,PRY,Pulau Pinang,0,0,0,Paraguay
31894,7/1/2021,PRY,Sabah,0,0,0,Paraguay
31895,7/1/2021,PRY,Sarawak,0,0,0,Paraguay
31896,7/1/2021,PRY,Selangor,0,0,0,Paraguay
31897,7/1/2021,PSE,Johor,0,0,0,"Palestinian Territory, Occupied"
31898,7/1/2021,PSE,Kedah,0,0,0,"Palestinian Territory, Occupied"
31899,7/1/2021,PSE,Kelantan,0,0,0,"Palestinian Territory, Occupied"
31900,7/1/2021,PSE,Melaka,0,0,0,"Palestinian Territory, Occupied"
31901,7/1/2021,PSE,Perak,0,0,0,"Palestinian Territory, Occupied"
31902,7/1/2021,PSE,Perlis,0,0,0,"Palestinian Territory, Occupied"
31903,7/1/2021,PSE,Pulau Pinang,0,0,0,"Palestinian Territory, Occupied"
31904,7/1/2021,PSE,Sabah,0,0,0,"Palestinian Territory, Occupied"
31905,7/1/2021,PSE,Sarawak,0,0,0,"Palestinian Territory, Occupied"
31906,7/1/2021,PSE,Selangor,2,2,0,"Palestinian Territory, Occupied"
31907,7/1/2021,QAT,Johor,0,0,0,Qatar
31908,7/1/2021,QAT,Kedah,0,0,0,Qatar
31909,7/1/2021,QAT,Perlis,0,0,0,Qatar
31910,7/1/2021,QAT,Pulau Pinang,0,0,0,Qatar
31911,7/1/2021,QAT,Sabah,0,0,0,Qatar
31912,7/1/2021,QAT,Sarawak,0,0,0,Qatar
31913,7/1/2021,QAT,Selangor,0,0,0,Qatar
31914,7/1/2021,REU,Johor,0,0,0,Reunion
31915,7/1/2021,REU,Sarawak,0,0,0,Reunion
31916,7/1/2021,ROU,Johor,1,1,0,Romania
31917,7/1/2021,ROU,Kedah,0,0,0,Romania
31918,7/1/2021,ROU,Kelantan,0,0,0,Romania
31919,7/1/2021,ROU,Negeri Sembilan,0,0,0,Romania
31920,7/1/2021,ROU,Pahang,0,0,0,Romania
31921,7/1/2021,ROU,Perak,0,0,0,Romania
31922,7/1/2021,ROU,Perlis,0,0,0,Romania
31923,7/1/2021,ROU,Pulau Pinang,0,0,0,Romania
31924,7/1/2021,ROU,Sabah,0,0,0,Romania
31925,7/1/2021,ROU,Sarawak,0,0,0,Romania
31926,7/1/2021,ROU,Selangor,12,8,4,Romania
31927,7/1/2021,ROU,W.P. Labuan,0,0,0,Romania
31928,7/1/2021,RUS,Johor,1,1,0,Russia
31929,7/1/2021,RUS,Kedah,3,1,2,Russia
31930,7/1/2021,RUS,Kelantan,0,0,0,Russia
31931,7/1/2021,RUS,Melaka,0,0,0,Russia
31932,7/1/2021,RUS,Negeri Sembilan,0,0,0,Russia
31933,7/1/2021,RUS,Pahang,0,0,0,Russia
31934,7/1/2021,RUS,Perak,0,0,0,Russia
31935,7/1/2021,RUS,Perlis,0,0,0,Russia
31936,7/1/2021,RUS,Pulau Pinang,0,0,0,Russia
31937,7/1/2021,RUS,Sabah,0,0,0,Russia
31938,7/1/2021,RUS,Sarawak,0,0,0,Russia
31939,7/1/2021,RUS,Selangor,65,50,15,Russia
31940,7/1/2021,RUS,W.P. Labuan,0,0,0,Russia
31941,7/1/2021,RWA,Johor,0,0,0,Rwanda
31942,7/1/2021,RWA,Kedah,0,0,0,Rwanda
31943,7/1/2021,RWA,Pulau Pinang,0,0,0,Rwanda
31944,7/1/2021,RWA,Selangor,1,0,1,Rwanda
31945,7/1/2021,SAU,Johor,0,0,0,Saudi Arabia
31946,7/1/2021,SAU,Kedah,0,0,0,Saudi Arabia
31947,7/1/2021,SAU,Kelantan,0,0,0,Saudi Arabia
31948,7/1/2021,SAU,Melaka,0,0,0,Saudi Arabia
31949,7/1/2021,SAU,Perak,0,0,0,Saudi Arabia
31950,7/1/2021,SAU,Perlis,0,0,0,Saudi Arabia
31951,7/1/2021,SAU,Pulau Pinang,0,0,0,Saudi Arabia
31952,7/1/2021,SAU,Sabah,0,0,0,Saudi Arabia
31953,7/1/2021,SAU,Sarawak,0,0,0,Saudi Arabia
31954,7/1/2021,SAU,Selangor,51,27,24,Saudi Arabia
31955,7/1/2021,SAU,W.P. Labuan,0,0,0,Saudi Arabia
31956,7/1/2021,SDN,Johor,0,0,0,Sudan
31957,7/1/2021,SDN,Kedah,0,0,0,Sudan
31958,7/1/2021,SDN,Kelantan,0,0,0,Sudan
31959,7/1/2021,SDN,Perlis,0,0,0,Sudan
31960,7/1/2021,SDN,Pulau Pinang,0,0,0,Sudan
31961,7/1/2021,SDN,Sabah,0,0,0,Sudan
31962,7/1/2021,SDN,Sarawak,0,0,0,Sudan
31963,7/1/2021,SDN,Selangor,23,17,6,Sudan
31964,7/1/2021,SDN,W.P. Labuan,0,0,0,Sudan
31965,7/1/2021,SEN,Johor,0,0,0,Senegal
31966,7/1/2021,SEN,Kedah,0,0,0,Senegal
31967,7/1/2021,SEN,Kelantan,0,0,0,Senegal
31968,7/1/2021,SEN,Perak,0,0,0,Senegal
31969,7/1/2021,SEN,Perlis,0,0,0,Senegal
31970,7/1/2021,SEN,Pulau Pinang,0,0,0,Senegal
31971,7/1/2021,SEN,Sabah,0,0,0,Senegal
31972,7/1/2021,SEN,Sarawak,0,0,0,Senegal
31973,7/1/2021,SEN,Selangor,9,4,5,Senegal
31974,7/1/2021,SGP,Johor,101,81,20,Singapore
31975,7/1/2021,SGP,Kedah,2,2,0,Singapore
31976,7/1/2021,SGP,Kelantan,0,0,0,Singapore
31977,7/1/2021,SGP,Melaka,0,0,0,Singapore
31978,7/1/2021,SGP,Negeri Sembilan,0,0,0,Singapore
31979,7/1/2021,SGP,Pahang,0,0,0,Singapore
31980,7/1/2021,SGP,Perak,0,0,0,Singapore
31981,7/1/2021,SGP,Perlis,2,2,0,Singapore
31982,7/1/2021,SGP,Pulau Pinang,19,12,7,Singapore
31983,7/1/2021,SGP,Sabah,0,0,0,Singapore
31984,7/1/2021,SGP,Sarawak,3,1,2,Singapore
31985,7/1/2021,SGP,Selangor,68,38,30,Singapore
31986,7/1/2021,SGP,Terengganu,0,0,0,Singapore
31987,7/1/2021,SGP,W.P. Labuan,0,0,0,Singapore
31988,7/1/2021,SGS,Johor,0,0,0,South Georgia and the South Sandwich Islands
31989,7/1/2021,SGS,Sabah,0,0,0,South Georgia and the South Sandwich Islands
31990,7/1/2021,SGS,Selangor,0,0,0,South Georgia and the South Sandwich Islands
31991,7/1/2021,SHN,Sarawak,0,0,0,"Saint Helena, Ascension and Tristan da Cunha"
31992,7/1/2021,SLB,Johor,0,0,0,Solomon Islands
31993,7/1/2021,SLB,Perlis,0,0,0,Solomon Islands
31994,7/1/2021,SLB,Pulau Pinang,0,0,0,Solomon Islands
31995,7/1/2021,SLB,Sabah,0,0,0,Solomon Islands
31996,7/1/2021,SLB,Sarawak,0,0,0,Solomon Islands
31997,7/1/2021,SLB,Selangor,0,0,0,Solomon Islands
31998,7/1/2021,SLB,W.P. Labuan,0,0,0,Solomon Islands
31999,7/1/2021,SLE,Johor,0,0,0,Sierra Leone
32000,7/1/2021,SLE,Kedah,0,0,0,Sierra Leone
32001,7/1/2021,SLE,Perak,0,0,0,Sierra Leone
32002,7/1/2021,SLE,Pulau Pinang,0,0,0,Sierra Leone
32003,7/1/2021,SLE,Sabah,0,0,0,Sierra Leone
32004,7/1/2021,SLE,Selangor,3,3,0,Sierra Leone
32005,7/1/2021,SLV,Johor,0,0,0,El Salvador
32006,7/1/2021,SLV,Kedah,0,0,0,El Salvador
32007,7/1/2021,SLV,Perak,0,0,0,El Salvador
32008,7/1/2021,SLV,Perlis,0,0,0,El Salvador
32009,7/1/2021,SLV,Pulau Pinang,0,0,0,El Salvador
32010,7/1/2021,SLV,Sabah,0,0,0,El Salvador
32011,7/1/2021,SLV,Selangor,0,0,0,El Salvador
32012,7/1/2021,SLV,W.P. Labuan,0,0,0,El Salvador
32013,7/1/2021,SMR,Johor,0,0,0,San Marino
32014,7/1/2021,SMR,Selangor,0,0,0,San Marino
32015,7/1/2021,SOM,Johor,0,0,0,Somalia
32016,7/1/2021,SOM,Kedah,0,0,0,Somalia
32017,7/1/2021,SOM,Kelantan,0,0,0,Somalia
32018,7/1/2021,SOM,Perlis,0,0,0,Somalia
32019,7/1/2021,SOM,Sabah,0,0,0,Somalia
32020,7/1/2021,SOM,Sarawak,0,0,0,Somalia
32021,7/1/2021,SOM,Selangor,10,9,1,Somalia
32022,7/1/2021,SRB,Johor,0,0,0,Serbia
32023,7/1/2021,SRB,Kedah,0,0,0,Serbia
32024,7/1/2021,SRB,Kelantan,0,0,0,Serbia
32025,7/1/2021,SRB,Pahang,0,0,0,Serbia
32026,7/1/2021,SRB,Perak,0,0,0,Serbia
32027,7/1/2021,SRB,Perlis,0,0,0,Serbia
32028,7/1/2021,SRB,Pulau Pinang,0,0,0,Serbia
32029,7/1/2021,SRB,Sabah,0,0,0,Serbia
32030,7/1/2021,SRB,Sarawak,0,0,0,Serbia
32031,7/1/2021,SRB,Selangor,1,0,1,Serbia
32032,7/1/2021,STP,Selangor,0,0,0,Sao Tome and Principe
32033,7/1/2021,SUR,Johor,0,0,0,Suriname
32034,7/1/2021,SUR,Kedah,0,0,0,Suriname
32035,7/1/2021,SUR,Kelantan,0,0,0,Suriname
32036,7/1/2021,SUR,Perak,0,0,0,Suriname
32037,7/1/2021,SUR,Perlis,0,0,0,Suriname
32038,7/1/2021,SUR,Pulau Pinang,0,0,0,Suriname
32039,7/1/2021,SUR,Sabah,0,0,0,Suriname
32040,7/1/2021,SUR,Sarawak,0,0,0,Suriname
32041,7/1/2021,SUR,Selangor,0,0,0,Suriname
32042,7/1/2021,SVK,Johor,0,0,0,Slovakia
32043,7/1/2021,SVK,Kedah,0,0,0,Slovakia
32044,7/1/2021,SVK,Kelantan,0,0,0,Slovakia
32045,7/1/2021,SVK,Negeri Sembilan,0,0,0,Slovakia
32046,7/1/2021,SVK,Pahang,0,0,0,Slovakia
32047,7/1/2021,SVK,Perak,0,0,0,Slovakia
32048,7/1/2021,SVK,Perlis,0,0,0,Slovakia
32049,7/1/2021,SVK,Pulau Pinang,0,0,0,Slovakia
32050,7/1/2021,SVK,Sabah,0,0,0,Slovakia
32051,7/1/2021,SVK,Sarawak,0,0,0,Slovakia
32052,7/1/2021,SVK,Selangor,2,2,0,Slovakia
32053,7/1/2021,SVK,W.P. Labuan,0,0,0,Slovakia
32054,7/1/2021,SVN,Johor,0,0,0,Slovenia
32055,7/1/2021,SVN,Kedah,0,0,0,Slovenia
32056,7/1/2021,SVN,Kelantan,0,0,0,Slovenia
32057,7/1/2021,SVN,Perak,0,0,0,Slovenia
32058,7/1/2021,SVN,Perlis,0,0,0,Slovenia
32059,7/1/2021,SVN,Pulau Pinang,0,0,0,Slovenia
32060,7/1/2021,SVN,Sabah,0,0,0,Slovenia
32061,7/1/2021,SVN,Sarawak,0,0,0,Slovenia
32062,7/1/2021,SVN,Selangor,0,0,0,Slovenia
32063,7/1/2021,SVN,W.P. Labuan,0,0,0,Slovenia
32064,7/1/2021,SWE,Johor,0,0,0,Sweden
32065,7/1/2021,SWE,Kedah,0,0,0,Sweden
32066,7/1/2021,SWE,Kelantan,0,0,0,Sweden
32067,7/1/2021,SWE,Melaka,0,0,0,Sweden
32068,7/1/2021,SWE,Negeri Sembilan,0,0,0,Sweden
32069,7/1/2021,SWE,Pahang,0,0,0,Sweden
32070,7/1/2021,SWE,Perak,0,0,0,Sweden
32071,7/1/2021,SWE,Perlis,0,0,0,Sweden
32072,7/1/2021,SWE,Pulau Pinang,0,0,0,Sweden
32073,7/1/2021,SWE,Sabah,0,0,0,Sweden
32074,7/1/2021,SWE,Sarawak,0,0,0,Sweden
32075,7/1/2021,SWE,Selangor,27,24,3,Sweden
32076,7/1/2021,SWE,W.P. Labuan,0,0,0,Sweden
32077,7/1/2021,SWZ,Johor,0,0,0,Swaziland
32078,7/1/2021,SWZ,Kedah,0,0,0,Swaziland
32079,7/1/2021,SWZ,Pulau Pinang,0,0,0,Swaziland
32080,7/1/2021,SWZ,Sabah,0,0,0,Swaziland
32081,7/1/2021,SWZ,Selangor,1,1,0,Swaziland
32082,7/1/2021,SYC,Johor,1,1,0,Seychelles
32083,7/1/2021,SYC,Kedah,0,0,0,Seychelles
32084,7/1/2021,SYC,Pulau Pinang,0,0,0,Seychelles
32085,7/1/2021,SYC,Sabah,0,0,0,Seychelles
32086,7/1/2021,SYC,Sarawak,0,0,0,Seychelles
32087,7/1/2021,SYC,Selangor,2,1,1,Seychelles
32088,7/1/2021,SYR,Johor,0,0,0,Syrian Arab Republic
32089,7/1/2021,SYR,Kedah,0,0,0,Syrian Arab Republic
32090,7/1/2021,SYR,Kelantan,0,0,0,Syrian Arab Republic
32091,7/1/2021,SYR,Pahang,0,0,0,Syrian Arab Republic
32092,7/1/2021,SYR,Perlis,0,0,0,Syrian Arab Republic
32093,7/1/2021,SYR,Pulau Pinang,0,0,0,Syrian Arab Republic
32094,7/1/2021,SYR,Sabah,0,0,0,Syrian Arab Republic
32095,7/1/2021,SYR,Sarawak,0,0,0,Syrian Arab Republic
32096,7/1/2021,SYR,Selangor,20,12,8,Syrian Arab Republic
32097,7/1/2021,SYR,W.P. Labuan,0,0,0,Syrian Arab Republic
32098,7/1/2021,TCA,Perlis,0,0,0,Turks and Caicos
32099,7/1/2021,TCD,Johor,0,0,0,Chad
32100,7/1/2021,TCD,Kedah,0,0,0,Chad
32101,7/1/2021,TCD,Perlis,0,0,0,Chad
32102,7/1/2021,TCD,Selangor,0,0,0,Chad
32103,7/1/2021,TGO,Johor,0,0,0,Togo
32104,7/1/2021,TGO,Perak,0,0,0,Togo
32105,7/1/2021,TGO,Pulau Pinang,0,0,0,Togo
32106,7/1/2021,TGO,Selangor,1,1,0,Togo
32107,7/1/2021,THA,Johor,9,9,0,Thailand
32108,7/1/2021,THA,Kedah,17464,17428,36,Thailand
32109,7/1/2021,THA,Kelantan,3,1,2,Thailand
32110,7/1/2021,THA,Melaka,0,0,0,Thailand
32111,7/1/2021,THA,Negeri Sembilan,0,0,0,Thailand
32112,7/1/2021,THA,Pahang,0,0,0,Thailand
32113,7/1/2021,THA,Perak,0,0,0,Thailand
32114,7/1/2021,THA,Perlis,6956,6874,82,Thailand
32115,7/1/2021,THA,Pulau Pinang,33,28,5,Thailand
32116,7/1/2021,THA,Sabah,0,0,0,Thailand
32117,7/1/2021,THA,Sarawak,9,9,0,Thailand
32118,7/1/2021,THA,Selangor,154,83,71,Thailand
32119,7/1/2021,THA,Terengganu,0,0,0,Thailand
32120,7/1/2021,THA,W.P. Labuan,0,0,0,Thailand
32121,7/1/2021,TJK,Johor,0,0,0,Tajikistan
32122,7/1/2021,TJK,Kedah,0,0,0,Tajikistan
32123,7/1/2021,TJK,Perlis,0,0,0,Tajikistan
32124,7/1/2021,TJK,Pulau Pinang,0,0,0,Tajikistan
32125,7/1/2021,TJK,Sabah,0,0,0,Tajikistan
32126,7/1/2021,TJK,Selangor,9,5,4,Tajikistan
32127,7/1/2021,TKL,Selangor,0,0,0,Tokelau
32128,7/1/2021,TKM,Johor,0,0,0,Turkmenistan
32129,7/1/2021,TKM,Kedah,0,0,0,Turkmenistan
32130,7/1/2021,TKM,Kelantan,0,0,0,Turkmenistan
32131,7/1/2021,TKM,Perlis,0,0,0,Turkmenistan
32132,7/1/2021,TKM,Pulau Pinang,0,0,0,Turkmenistan
32133,7/1/2021,TKM,Sabah,0,0,0,Turkmenistan
32134,7/1/2021,TKM,Sarawak,0,0,0,Turkmenistan
32135,7/1/2021,TKM,Selangor,1,1,0,Turkmenistan
32136,7/1/2021,TLS,Johor,0,0,0,Timor-Leste
32137,7/1/2021,TLS,Kedah,0,0,0,Timor-Leste
32138,7/1/2021,TLS,Perlis,0,0,0,Timor-Leste
32139,7/1/2021,TLS,Pulau Pinang,0,0,0,Timor-Leste
32140,7/1/2021,TLS,Sabah,0,0,0,Timor-Leste
32141,7/1/2021,TLS,Sarawak,0,0,0,Timor-Leste
32142,7/1/2021,TLS,Selangor,4,3,1,Timor-Leste
32143,7/1/2021,TON,Johor,0,0,0,Tonga
32144,7/1/2021,TON,Pulau Pinang,0,0,0,Tonga
32145,7/1/2021,TON,Sarawak,0,0,0,Tonga
32146,7/1/2021,TON,Selangor,0,0,0,Tonga
32147,7/1/2021,TTO,Johor,0,0,0,Trinidad and Tobago
32148,7/1/2021,TTO,Kedah,0,0,0,Trinidad and Tobago
32149,7/1/2021,TTO,Pahang,0,0,0,Trinidad and Tobago
32150,7/1/2021,TTO,Pulau Pinang,0,0,0,Trinidad and Tobago
32151,7/1/2021,TTO,Sabah,0,0,0,Trinidad and Tobago
32152,7/1/2021,TTO,Sarawak,0,0,0,Trinidad and Tobago
32153,7/1/2021,TTO,Selangor,2,0,2,Trinidad and Tobago
32154,7/1/2021,TUN,Johor,0,0,0,Tunisia
32155,7/1/2021,TUN,Kedah,0,0,0,Tunisia
32156,7/1/2021,TUN,Kelantan,0,0,0,Tunisia
32157,7/1/2021,TUN,Melaka,0,0,0,Tunisia
32158,7/1/2021,TUN,Perak,0,0,0,Tunisia
32159,7/1/2021,TUN,Perlis,0,0,0,Tunisia
32160,7/1/2021,TUN,Pulau Pinang,0,0,0,Tunisia
32161,7/1/2021,TUN,Sabah,0,0,0,Tunisia
32162,7/1/2021,TUN,Sarawak,0,0,0,Tunisia
32163,7/1/2021,TUN,Selangor,1,1,0,Tunisia
32164,7/1/2021,TUN,W.P. Labuan,0,0,0,Tunisia
32165,7/1/2021,TUR,Johor,0,0,0,Turkey
32166,7/1/2021,TUR,Kedah,0,0,0,Turkey
32167,7/1/2021,TUR,Kelantan,0,0,0,Turkey
32168,7/1/2021,TUR,Melaka,0,0,0,Turkey
32169,7/1/2021,TUR,Negeri Sembilan,0,0,0,Turkey
32170,7/1/2021,TUR,Pahang,0,0,0,Turkey
32171,7/1/2021,TUR,Perak,0,0,0,Turkey
32172,7/1/2021,TUR,Perlis,0,0,0,Turkey
32173,7/1/2021,TUR,Pulau Pinang,0,0,0,Turkey
32174,7/1/2021,TUR,Sabah,0,0,0,Turkey
32175,7/1/2021,TUR,Sarawak,0,0,0,Turkey
32176,7/1/2021,TUR,Selangor,34,23,11,Turkey
32177,7/1/2021,TUR,W.P. Labuan,0,0,0,Turkey
32178,7/1/2021,TUV,Selangor,0,0,0,Tuvalu
32179,7/1/2021,TWN,Johor,0,0,0,Taiwan
32180,7/1/2021,TWN,Kedah,0,0,0,Taiwan
32181,7/1/2021,TWN,Kelantan,0,0,0,Taiwan
32182,7/1/2021,TWN,Melaka,0,0,0,Taiwan
32183,7/1/2021,TWN,Negeri Sembilan,0,0,0,Taiwan
32184,7/1/2021,TWN,Pahang,0,0,0,Taiwan
32185,7/1/2021,TWN,Perak,0,0,0,Taiwan
32186,7/1/2021,TWN,Perlis,0,0,0,Taiwan
32187,7/1/2021,TWN,Pulau Pinang,15,10,5,Taiwan
32188,7/1/2021,TWN,Sabah,0,0,0,Taiwan
32189,7/1/2021,TWN,Sarawak,0,0,0,Taiwan
32190,7/1/2021,TWN,Selangor,47,23,24,Taiwan
32191,7/1/2021,TWN,W.P. Labuan,0,0,0,Taiwan
32192,7/1/2021,TZA,Johor,0,0,0,"Tanzania, United Republic of"
32193,7/1/2021,TZA,Kedah,0,0,0,"Tanzania, United Republic of"
32194,7/1/2021,TZA,Perak,0,0,0,"Tanzania, United Republic of"
32195,7/1/2021,TZA,Perlis,0,0,0,"Tanzania, United Republic of"
32196,7/1/2021,TZA,Pulau Pinang,0,0,0,"Tanzania, United Republic of"
32197,7/1/2021,TZA,Sabah,0,0,0,"Tanzania, United Republic of"
32198,7/1/2021,TZA,Sarawak,0,0,0,"Tanzania, United Republic of"
32199,7/1/2021,TZA,Selangor,7,4,3,"Tanzania, United Republic of"
32200,7/1/2021,UGA,Johor,0,0,0,Uganda
32201,7/1/2021,UGA,Kedah,0,0,0,Uganda
32202,7/1/2021,UGA,Perak,0,0,0,Uganda
32203,7/1/2021,UGA,Perlis,0,0,0,Uganda
32204,7/1/2021,UGA,Pulau Pinang,0,0,0,Uganda
32205,7/1/2021,UGA,Sabah,0,0,0,Uganda
32206,7/1/2021,UGA,Sarawak,0,0,0,Uganda
32207,7/1/2021,UGA,Selangor,1,1,0,Uganda
32208,7/1/2021,UKR,Johor,2,2,0,Ukraine
32209,7/1/2021,UKR,Kedah,0,0,0,Ukraine
32210,7/1/2021,UKR,Kelantan,0,0,0,Ukraine
32211,7/1/2021,UKR,Melaka,0,0,0,Ukraine
32212,7/1/2021,UKR,Negeri Sembilan,0,0,0,Ukraine
32213,7/1/2021,UKR,Pahang,0,0,0,Ukraine
32214,7/1/2021,UKR,Perak,0,0,0,Ukraine
32215,7/1/2021,UKR,Perlis,0,0,0,Ukraine
32216,7/1/2021,UKR,Pulau Pinang,0,0,0,Ukraine
32217,7/1/2021,UKR,Sabah,0,0,0,Ukraine
32218,7/1/2021,UKR,Sarawak,0,0,0,Ukraine
32219,7/1/2021,UKR,Selangor,30,27,3,Ukraine
32220,7/1/2021,UKR,W.P. Labuan,0,0,0,Ukraine
32221,7/1/2021,URY,Johor,0,0,0,Uruguay
32222,7/1/2021,URY,Kedah,0,0,0,Uruguay
32223,7/1/2021,URY,Kelantan,0,0,0,Uruguay
32224,7/1/2021,URY,Perak,0,0,0,Uruguay
32225,7/1/2021,URY,Perlis,0,0,0,Uruguay
32226,7/1/2021,URY,Pulau Pinang,0,0,0,Uruguay
32227,7/1/2021,URY,Sabah,0,0,0,Uruguay
32228,7/1/2021,URY,Sarawak,0,0,0,Uruguay
32229,7/1/2021,URY,Selangor,0,0,0,Uruguay
32230,7/1/2021,URY,W.P. Labuan,0,0,0,Uruguay
32231,7/1/2021,USA,Johor,1,1,0,United States Of America
32232,7/1/2021,USA,Kedah,0,0,0,United States Of America
32233,7/1/2021,USA,Kelantan,0,0,0,United States Of America
32234,7/1/2021,USA,Melaka,0,0,0,United States Of America
32235,7/1/2021,USA,Negeri Sembilan,0,0,0,United States Of America
32236,7/1/2021,USA,Pahang,0,0,0,United States Of America
32237,7/1/2021,USA,Perak,1,0,1,United States Of America
32238,7/1/2021,USA,Perlis,0,0,0,United States Of America
32239,7/1/2021,USA,Pulau Pinang,14,8,6,United States Of America
32240,7/1/2021,USA,Sabah,0,0,0,United States Of America
32241,7/1/2021,USA,Sarawak,1,1,0,United States Of America
32242,7/1/2021,USA,Selangor,444,224,220,United States Of America
32243,7/1/2021,USA,Terengganu,0,0,0,United States Of America
32244,7/1/2021,USA,W.P. Labuan,0,0,0,United States Of America
32245,7/1/2021,UZB,Johor,0,0,0,Uzbekistan
32246,7/1/2021,UZB,Kedah,0,0,0,Uzbekistan
32247,7/1/2021,UZB,Kelantan,0,0,0,Uzbekistan
32248,7/1/2021,UZB,Perak,0,0,0,Uzbekistan
32249,7/1/2021,UZB,Perlis,0,0,0,Uzbekistan
32250,7/1/2021,UZB,Pulau Pinang,0,0,0,Uzbekistan
32251,7/1/2021,UZB,Sabah,0,0,0,Uzbekistan
32252,7/1/2021,UZB,Sarawak,0,0,0,Uzbekistan
32253,7/1/2021,UZB,Selangor,4,3,1,Uzbekistan
32254,7/1/2021,VAT,Johor,0,0,0,Holy See (Vatican City State)
32255,7/1/2021,VAT,Sarawak,0,0,0,Holy See (Vatican City State)
32256,7/1/2021,VAT,Selangor,1,1,0,Holy See (Vatican City State)
32257,7/1/2021,VCT,Johor,0,0,0,Saint Vincent and the Grenadines
32258,7/1/2021,VCT,Kedah,0,0,0,Saint Vincent and the Grenadines
32259,7/1/2021,VCT,Pulau Pinang,0,0,0,Saint Vincent and the Grenadines
32260,7/1/2021,VCT,Sarawak,0,0,0,Saint Vincent and the Grenadines
32261,7/1/2021,VCT,Selangor,0,0,0,Saint Vincent and the Grenadines
32262,7/1/2021,VEN,Johor,0,0,0,Venezuela
32263,7/1/2021,VEN,Kedah,0,0,0,Venezuela
32264,7/1/2021,VEN,Kelantan,0,0,0,Venezuela
32265,7/1/2021,VEN,Melaka,0,0,0,Venezuela
32266,7/1/2021,VEN,Perak,0,0,0,Venezuela
32267,7/1/2021,VEN,Perlis,0,0,0,Venezuela
32268,7/1/2021,VEN,Pulau Pinang,0,0,0,Venezuela
32269,7/1/2021,VEN,Sabah,0,0,0,Venezuela
32270,7/1/2021,VEN,Sarawak,0,0,0,Venezuela
32271,7/1/2021,VEN,Selangor,4,4,0,Venezuela
32272,7/1/2021,VEN,W.P. Labuan,0,0,0,Venezuela
32273,7/1/2021,VNM,Johor,2,0,2,Vietnam
32274,7/1/2021,VNM,Kedah,0,0,0,Vietnam
32275,7/1/2021,VNM,Kelantan,0,0,0,Vietnam
32276,7/1/2021,VNM,Melaka,0,0,0,Vietnam
32277,7/1/2021,VNM,Negeri Sembilan,0,0,0,Vietnam
32278,7/1/2021,VNM,Pahang,0,0,0,Vietnam
32279,7/1/2021,VNM,Perak,0,0,0,Vietnam
32280,7/1/2021,VNM,Perlis,0,0,0,Vietnam
32281,7/1/2021,VNM,Pulau Pinang,0,0,0,Vietnam
32282,7/1/2021,VNM,Sabah,0,0,0,Vietnam
32283,7/1/2021,VNM,Sarawak,1,0,1,Vietnam
32284,7/1/2021,VNM,Selangor,51,19,32,Vietnam
32285,7/1/2021,VNM,Terengganu,0,0,0,Vietnam
32286,7/1/2021,VNM,W.P. Labuan,0,0,0,Vietnam
32287,7/1/2021,VUT,Johor,0,0,0,Vanuatu
32288,7/1/2021,VUT,Kedah,0,0,0,Vanuatu
32289,7/1/2021,VUT,Pulau Pinang,0,0,0,Vanuatu
32290,7/1/2021,VUT,Sabah,0,0,0,Vanuatu
32291,7/1/2021,VUT,Sarawak,0,0,0,Vanuatu
32292,7/1/2021,VUT,Selangor,0,0,0,Vanuatu
32293,7/1/2021,WSM,Johor,0,0,0,Samoa
32294,7/1/2021,WSM,Sarawak,0,0,0,Samoa
32295,7/1/2021,WSM,Selangor,0,0,0,Samoa
32296,7/1/2021,YEM,Johor,0,0,0,Yemen
32297,7/1/2021,YEM,Kedah,0,0,0,Yemen
32298,7/1/2021,YEM,Kelantan,0,0,0,Yemen
32299,7/1/2021,YEM,Melaka,0,0,0,Yemen
32300,7/1/2021,YEM,Pahang,0,0,0,Yemen
32301,7/1/2021,YEM,Perak,0,0,0,Yemen
32302,7/1/2021,YEM,Perlis,0,0,0,Yemen
32303,7/1/2021,YEM,Pulau Pinang,0,0,0,Yemen
32304,7/1/2021,YEM,Sabah,0,0,0,Yemen
32305,7/1/2021,YEM,Sarawak,0,0,0,Yemen
32306,7/1/2021,YEM,Selangor,19,14,5,Yemen
32307,7/1/2021,YEM,W.P. Labuan,0,0,0,Yemen
32308,7/1/2021,ZAF,Johor,0,0,0,South Africa
32309,7/1/2021,ZAF,Kedah,0,0,0,South Africa
32310,7/1/2021,ZAF,Kelantan,0,0,0,South Africa
32311,7/1/2021,ZAF,Melaka,0,0,0,South Africa
32312,7/1/2021,ZAF,Pahang,0,0,0,South Africa
32313,7/1/2021,ZAF,Perak,0,0,0,South Africa
32314,7/1/2021,ZAF,Perlis,0,0,0,South Africa
32315,7/1/2021,ZAF,Pulau Pinang,0,0,0,South Africa
32316,7/1/2021,ZAF,Sabah,0,0,0,South Africa
32317,7/1/2021,ZAF,Sarawak,1,0,1,South Africa
32318,7/1/2021,ZAF,Selangor,23,14,9,South Africa
32319,7/1/2021,ZAF,Terengganu,0,0,0,South Africa
32320,7/1/2021,ZAF,W.P. Labuan,0,0,0,South Africa
32321,7/1/2021,ZMB,Johor,0,0,0,Zambia
32322,7/1/2021,ZMB,Kedah,0,0,0,Zambia
32323,7/1/2021,ZMB,Perak,0,0,0,Zambia
32324,7/1/2021,ZMB,Perlis,0,0,0,Zambia
32325,7/1/2021,ZMB,Pulau Pinang,0,0,0,Zambia
32326,7/1/2021,ZMB,Sabah,0,0,0,Zambia
32327,7/1/2021,ZMB,Sarawak,0,0,0,Zambia
32328,7/1/2021,ZMB,Selangor,1,1,0,Zambia
32329,7/1/2021,ZWE,Johor,0,0,0,Zimbabwe
32330,7/1/2021,ZWE,Kedah,0,0,0,Zimbabwe
32331,7/1/2021,ZWE,Kelantan,0,0,0,Zimbabwe
32332,7/1/2021,ZWE,Perak,0,0,0,Zimbabwe
32333,7/1/2021,ZWE,Perlis,0,0,0,Zimbabwe
32334,7/1/2021,ZWE,Pulau Pinang,0,0,0,Zimbabwe
32335,7/1/2021,ZWE,Sabah,0,0,0,Zimbabwe
32336,7/1/2021,ZWE,Sarawak,0,0,0,Zimbabwe
32337,7/1/2021,ZWE,Selangor,3,1,2,Zimbabwe
32338,8/1/2021,ABW,Kedah,0,0,0,Aruba
32339,8/1/2021,ABW,Pulau Pinang,0,0,0,Aruba
32340,8/1/2021,AFG,Johor,0,0,0,Afghanistan
32341,8/1/2021,AFG,Kedah,0,0,0,Afghanistan
32342,8/1/2021,AFG,Perlis,0,0,0,Afghanistan
32343,8/1/2021,AFG,Pulau Pinang,0,0,0,Afghanistan
32344,8/1/2021,AFG,Sarawak,0,0,0,Afghanistan
32345,8/1/2021,AFG,Selangor,15,12,3,Afghanistan
32346,8/1/2021,AGO,Johor,0,0,0,Angola
32347,8/1/2021,AGO,Kedah,0,0,0,Angola
32348,8/1/2021,AGO,Sabah,0,0,0,Angola
32349,8/1/2021,AGO,Selangor,4,3,1,Angola
32350,8/1/2021,AIA,Selangor,0,0,0,Anguilla
32351,8/1/2021,ALB,Johor,0,0,0,Albania
32352,8/1/2021,ALB,Kedah,0,0,0,Albania
32353,8/1/2021,ALB,Perak,0,0,0,Albania
32354,8/1/2021,ALB,Perlis,0,0,0,Albania
32355,8/1/2021,ALB,Pulau Pinang,0,0,0,Albania
32356,8/1/2021,ALB,Sabah,0,0,0,Albania
32357,8/1/2021,ALB,Sarawak,0,0,0,Albania
32358,8/1/2021,ALB,Selangor,0,0,0,Albania
32359,8/1/2021,AND,Johor,0,0,0,Andorra
32360,8/1/2021,AND,Kedah,0,0,0,Andorra
32361,8/1/2021,AND,Perlis,0,0,0,Andorra
32362,8/1/2021,AND,Pulau Pinang,0,0,0,Andorra
32363,8/1/2021,AND,Selangor,0,0,0,Andorra
32364,8/1/2021,ANT,Selangor,0,0,0,Netherlands Antilles
32365,8/1/2021,ARE,Johor,0,0,0,United Arab Emirates
32366,8/1/2021,ARE,Kedah,0,0,0,United Arab Emirates
32367,8/1/2021,ARE,Kelantan,0,0,0,United Arab Emirates
32368,8/1/2021,ARE,Perak,0,0,0,United Arab Emirates
32369,8/1/2021,ARE,Perlis,0,0,0,United Arab Emirates
32370,8/1/2021,ARE,Pulau Pinang,0,0,0,United Arab Emirates
32371,8/1/2021,ARE,Sabah,0,0,0,United Arab Emirates
32372,8/1/2021,ARE,Sarawak,0,0,0,United Arab Emirates
32373,8/1/2021,ARE,Selangor,1,1,0,United Arab Emirates
32374,8/1/2021,ARG,Johor,0,0,0,Argentina
32375,8/1/2021,ARG,Kedah,0,0,0,Argentina
32376,8/1/2021,ARG,Kelantan,0,0,0,Argentina
32377,8/1/2021,ARG,Melaka,0,0,0,Argentina
32378,8/1/2021,ARG,Perak,0,0,0,Argentina
32379,8/1/2021,ARG,Perlis,0,0,0,Argentina
32380,8/1/2021,ARG,Pulau Pinang,0,0,0,Argentina
32381,8/1/2021,ARG,Sabah,0,0,0,Argentina
32382,8/1/2021,ARG,Sarawak,0,0,0,Argentina
32383,8/1/2021,ARG,Selangor,19,13,6,Argentina
32384,8/1/2021,ARG,W.P. Labuan,0,0,0,Argentina
32385,8/1/2021,ARM,Johor,0,0,0,Armenia
32386,8/1/2021,ARM,Kedah,0,0,0,Armenia
32387,8/1/2021,ARM,Kelantan,0,0,0,Armenia
32388,8/1/2021,ARM,Perak,0,0,0,Armenia
32389,8/1/2021,ARM,Perlis,0,0,0,Armenia
32390,8/1/2021,ARM,Pulau Pinang,0,0,0,Armenia
32391,8/1/2021,ARM,Sabah,0,0,0,Armenia
32392,8/1/2021,ARM,Sarawak,0,0,0,Armenia
32393,8/1/2021,ARM,Selangor,0,0,0,Armenia
32394,8/1/2021,ATA,Selangor,0,0,0,Antarctica
32395,8/1/2021,ATG,Johor,0,0,0,Antigua and Barbuda
32396,8/1/2021,ATG,Kedah,0,0,0,Antigua and Barbuda
32397,8/1/2021,ATG,Pulau Pinang,0,0,0,Antigua and Barbuda
32398,8/1/2021,ATG,Sarawak,0,0,0,Antigua and Barbuda
32399,8/1/2021,ATG,Selangor,0,0,0,Antigua and Barbuda
32400,8/1/2021,AUS,Johor,0,0,0,Australia
32401,8/1/2021,AUS,Kedah,0,0,0,Australia
32402,8/1/2021,AUS,Kelantan,0,0,0,Australia
32403,8/1/2021,AUS,Melaka,0,0,0,Australia
32404,8/1/2021,AUS,Negeri Sembilan,0,0,0,Australia
32405,8/1/2021,AUS,Pahang,0,0,0,Australia
32406,8/1/2021,AUS,Perak,0,0,0,Australia
32407,8/1/2021,AUS,Perlis,0,0,0,Australia
32408,8/1/2021,AUS,Pulau Pinang,10,5,5,Australia
32409,8/1/2021,AUS,Sabah,0,0,0,Australia
32410,8/1/2021,AUS,Sarawak,0,0,0,Australia
32411,8/1/2021,AUS,Selangor,137,73,64,Australia
32412,8/1/2021,AUS,Terengganu,0,0,0,Australia
32413,8/1/2021,AUS,W.P. Labuan,0,0,0,Australia
32414,8/1/2021,AUT,Johor,0,0,0,Austria
32415,8/1/2021,AUT,Kedah,0,0,0,Austria
32416,8/1/2021,AUT,Kelantan,0,0,0,Austria
32417,8/1/2021,AUT,Melaka,0,0,0,Austria
32418,8/1/2021,AUT,Negeri Sembilan,0,0,0,Austria
32419,8/1/2021,AUT,Pahang,0,0,0,Austria
32420,8/1/2021,AUT,Perak,0,0,0,Austria
32421,8/1/2021,AUT,Perlis,0,0,0,Austria
32422,8/1/2021,AUT,Pulau Pinang,0,0,0,Austria
32423,8/1/2021,AUT,Sabah,0,0,0,Austria
32424,8/1/2021,AUT,Sarawak,0,0,0,Austria
32425,8/1/2021,AUT,Selangor,29,19,10,Austria
32426,8/1/2021,AUT,Terengganu,0,0,0,Austria
32427,8/1/2021,AUT,W.P. Labuan,0,0,0,Austria
32428,8/1/2021,AZE,Johor,0,0,0,Azerbaijan
32429,8/1/2021,AZE,Kedah,0,0,0,Azerbaijan
32430,8/1/2021,AZE,Kelantan,0,0,0,Azerbaijan
32431,8/1/2021,AZE,Melaka,0,0,0,Azerbaijan
32432,8/1/2021,AZE,Perlis,0,0,0,Azerbaijan
32433,8/1/2021,AZE,Pulau Pinang,0,0,0,Azerbaijan
32434,8/1/2021,AZE,Sabah,0,0,0,Azerbaijan
32435,8/1/2021,AZE,Sarawak,0,0,0,Azerbaijan
32436,8/1/2021,AZE,Selangor,11,5,6,Azerbaijan
32437,8/1/2021,AZE,W.P. Labuan,0,0,0,Azerbaijan
32438,8/1/2021,BDI,Pulau Pinang,0,0,0,Burundi
32439,8/1/2021,BDI,Sarawak,0,0,0,Burundi
32440,8/1/2021,BDI,Selangor,2,1,1,Burundi
32441,8/1/2021,BEL,Johor,0,0,0,Belgium
32442,8/1/2021,BEL,Kedah,0,0,0,Belgium
32443,8/1/2021,BEL,Kelantan,0,0,0,Belgium
32444,8/1/2021,BEL,Melaka,0,0,0,Belgium
32445,8/1/2021,BEL,Negeri Sembilan,0,0,0,Belgium
32446,8/1/2021,BEL,Pahang,0,0,0,Belgium
32447,8/1/2021,BEL,Perak,0,0,0,Belgium
32448,8/1/2021,BEL,Perlis,0,0,0,Belgium
32449,8/1/2021,BEL,Pulau Pinang,0,0,0,Belgium
32450,8/1/2021,BEL,Sabah,0,0,0,Belgium
32451,8/1/2021,BEL,Sarawak,0,0,0,Belgium
32452,8/1/2021,BEL,Selangor,20,12,8,Belgium
32453,8/1/2021,BEL,W.P. Labuan,0,0,0,Belgium
32454,8/1/2021,BEN,Johor,0,0,0,Benin
32455,8/1/2021,BEN,Kedah,0,0,0,Benin
32456,8/1/2021,BEN,Perak,0,0,0,Benin
32457,8/1/2021,BEN,Pulau Pinang,0,0,0,Benin
32458,8/1/2021,BEN,Sabah,0,0,0,Benin
32459,8/1/2021,BEN,Sarawak,0,0,0,Benin
32460,8/1/2021,BEN,Selangor,0,0,0,Benin
32461,8/1/2021,BFA,Perak,0,0,0,Burkina Faso
32462,8/1/2021,BFA,Pulau Pinang,0,0,0,Burkina Faso
32463,8/1/2021,BFA,Selangor,0,0,0,Burkina Faso
32464,8/1/2021,BGD,Johor,0,0,0,Bangladesh
32465,8/1/2021,BGD,Kedah,0,0,0,Bangladesh
32466,8/1/2021,BGD,Kelantan,0,0,0,Bangladesh
32467,8/1/2021,BGD,Melaka,0,0,0,Bangladesh
32468,8/1/2021,BGD,Negeri Sembilan,0,0,0,Bangladesh
32469,8/1/2021,BGD,Pahang,0,0,0,Bangladesh
32470,8/1/2021,BGD,Perak,0,0,0,Bangladesh
32471,8/1/2021,BGD,Perlis,0,0,0,Bangladesh
32472,8/1/2021,BGD,Pulau Pinang,0,0,0,Bangladesh
32473,8/1/2021,BGD,Sabah,0,0,0,Bangladesh
32474,8/1/2021,BGD,Sarawak,0,0,0,Bangladesh
32475,8/1/2021,BGD,Selangor,16,10,6,Bangladesh
32476,8/1/2021,BGD,W.P. Labuan,0,0,0,Bangladesh
32477,8/1/2021,BGR,Johor,0,0,0,Bulgaria
32478,8/1/2021,BGR,Kedah,0,0,0,Bulgaria
32479,8/1/2021,BGR,Kelantan,0,0,0,Bulgaria
32480,8/1/2021,BGR,Pahang,0,0,0,Bulgaria
32481,8/1/2021,BGR,Perak,0,0,0,Bulgaria
32482,8/1/2021,BGR,Perlis,0,0,0,Bulgaria
32483,8/1/2021,BGR,Pulau Pinang,0,0,0,Bulgaria
32484,8/1/2021,BGR,Sabah,0,0,0,Bulgaria
32485,8/1/2021,BGR,Sarawak,0,0,0,Bulgaria
32486,8/1/2021,BGR,Selangor,14,13,1,Bulgaria
32487,8/1/2021,BGR,W.P. Labuan,0,0,0,Bulgaria
32488,8/1/2021,BHR,Johor,0,0,0,Bahrain
32489,8/1/2021,BHR,Kedah,0,0,0,Bahrain
32490,8/1/2021,BHR,Kelantan,0,0,0,Bahrain
32491,8/1/2021,BHR,Perlis,0,0,0,Bahrain
32492,8/1/2021,BHR,Pulau Pinang,0,0,0,Bahrain
32493,8/1/2021,BHR,Sabah,0,0,0,Bahrain
32494,8/1/2021,BHR,Sarawak,0,0,0,Bahrain
32495,8/1/2021,BHR,Selangor,0,0,0,Bahrain
32496,8/1/2021,BHS,Johor,0,0,0,Bahamas
32497,8/1/2021,BHS,Kedah,0,0,0,Bahamas
32498,8/1/2021,BHS,Perak,0,0,0,Bahamas
32499,8/1/2021,BHS,Sabah,0,0,0,Bahamas
32500,8/1/2021,BHS,Sarawak,0,0,0,Bahamas
32501,8/1/2021,BHS,Selangor,0,0,0,Bahamas
32502,8/1/2021,BIH,Johor,0,0,0,Bosnia and Herzegovina
32503,8/1/2021,BIH,Kedah,0,0,0,Bosnia and Herzegovina
32504,8/1/2021,BIH,Perlis,0,0,0,Bosnia and Herzegovina
32505,8/1/2021,BIH,Pulau Pinang,0,0,0,Bosnia and Herzegovina
32506,8/1/2021,BIH,Sabah,0,0,0,Bosnia and Herzegovina
32507,8/1/2021,BIH,Sarawak,0,0,0,Bosnia and Herzegovina
32508,8/1/2021,BIH,Selangor,12,6,6,Bosnia and Herzegovina
32509,8/1/2021,BLR,Johor,0,0,0,Belarus
32510,8/1/2021,BLR,Kedah,0,0,0,Belarus
32511,8/1/2021,BLR,Kelantan,0,0,0,Belarus
32512,8/1/2021,BLR,Pahang,0,0,0,Belarus
32513,8/1/2021,BLR,Perak,0,0,0,Belarus
32514,8/1/2021,BLR,Perlis,0,0,0,Belarus
32515,8/1/2021,BLR,Pulau Pinang,0,0,0,Belarus
32516,8/1/2021,BLR,Sabah,0,0,0,Belarus
32517,8/1/2021,BLR,Sarawak,0,0,0,Belarus
32518,8/1/2021,BLR,Selangor,0,0,0,Belarus
32519,8/1/2021,BLR,W.P. Labuan,0,0,0,Belarus
32520,8/1/2021,BLZ,Johor,0,0,0,Belize
32521,8/1/2021,BLZ,Pulau Pinang,0,0,0,Belize
32522,8/1/2021,BLZ,Sarawak,0,0,0,Belize
32523,8/1/2021,BLZ,Selangor,4,1,3,Belize
32524,8/1/2021,BMU,Selangor,0,0,0,Bermuda
32525,8/1/2021,BOL,Johor,0,0,0,Bolivia
32526,8/1/2021,BOL,Kedah,0,0,0,Bolivia
32527,8/1/2021,BOL,Melaka,0,0,0,Bolivia
32528,8/1/2021,BOL,Perak,0,0,0,Bolivia
32529,8/1/2021,BOL,Perlis,0,0,0,Bolivia
32530,8/1/2021,BOL,Pulau Pinang,0,0,0,Bolivia
32531,8/1/2021,BOL,Sabah,0,0,0,Bolivia
32532,8/1/2021,BOL,Sarawak,0,0,0,Bolivia
32533,8/1/2021,BOL,Selangor,0,0,0,Bolivia
32534,8/1/2021,BRA,Johor,0,0,0,Brazil
32535,8/1/2021,BRA,Kedah,0,0,0,Brazil
32536,8/1/2021,BRA,Kelantan,0,0,0,Brazil
32537,8/1/2021,BRA,Melaka,0,0,0,Brazil
32538,8/1/2021,BRA,Pahang,0,0,0,Brazil
32539,8/1/2021,BRA,Perak,0,0,0,Brazil
32540,8/1/2021,BRA,Perlis,0,0,0,Brazil
32541,8/1/2021,BRA,Pulau Pinang,0,0,0,Brazil
32542,8/1/2021,BRA,Sabah,2,2,0,Brazil
32543,8/1/2021,BRA,Sarawak,0,0,0,Brazil
32544,8/1/2021,BRA,Selangor,18,11,7,Brazil
32545,8/1/2021,BRA,W.P. Labuan,0,0,0,Brazil
32546,8/1/2021,BRB,Johor,0,0,0,Barbados
32547,8/1/2021,BRB,Kedah,0,0,0,Barbados
32548,8/1/2021,BRB,Perlis,0,0,0,Barbados
32549,8/1/2021,BRB,Pulau Pinang,0,0,0,Barbados
32550,8/1/2021,BRB,Selangor,1,0,1,Barbados
32551,8/1/2021,BRN,Johor,0,0,0,Brunei Darussalam
32552,8/1/2021,BRN,Kedah,0,0,0,Brunei Darussalam
32553,8/1/2021,BRN,Kelantan,0,0,0,Brunei Darussalam
32554,8/1/2021,BRN,Melaka,0,0,0,Brunei Darussalam
32555,8/1/2021,BRN,Pahang,0,0,0,Brunei Darussalam
32556,8/1/2021,BRN,Perak,0,0,0,Brunei Darussalam
32557,8/1/2021,BRN,Perlis,0,0,0,Brunei Darussalam
32558,8/1/2021,BRN,Pulau Pinang,0,0,0,Brunei Darussalam
32559,8/1/2021,BRN,Sabah,0,0,0,Brunei Darussalam
32560,8/1/2021,BRN,Sarawak,297,294,3,Brunei Darussalam
32561,8/1/2021,BRN,Selangor,12,3,9,Brunei Darussalam
32562,8/1/2021,BRN,W.P. Labuan,0,0,0,Brunei Darussalam
32563,8/1/2021,BTN,Johor,0,0,0,Bhutan
32564,8/1/2021,BTN,Kedah,0,0,0,Bhutan
32565,8/1/2021,BTN,Perak,0,0,0,Bhutan
32566,8/1/2021,BTN,Perlis,0,0,0,Bhutan
32567,8/1/2021,BTN,Pulau Pinang,0,0,0,Bhutan
32568,8/1/2021,BTN,Sabah,0,0,0,Bhutan
32569,8/1/2021,BTN,Sarawak,0,0,0,Bhutan
32570,8/1/2021,BTN,Selangor,1,1,0,Bhutan
32571,8/1/2021,BWA,Johor,0,0,0,Botswana
32572,8/1/2021,BWA,Kedah,0,0,0,Botswana
32573,8/1/2021,BWA,Perlis,0,0,0,Botswana
32574,8/1/2021,BWA,Pulau Pinang,0,0,0,Botswana
32575,8/1/2021,BWA,Sabah,0,0,0,Botswana
32576,8/1/2021,BWA,Sarawak,0,0,0,Botswana
32577,8/1/2021,BWA,Selangor,2,2,0,Botswana
32578,8/1/2021,CAF,Kedah,0,0,0,Central African Republic
32579,8/1/2021,CAF,Selangor,0,0,0,Central African Republic
32580,8/1/2021,CAN,Johor,0,0,0,Canada
32581,8/1/2021,CAN,Kedah,0,0,0,Canada
32582,8/1/2021,CAN,Kelantan,0,0,0,Canada
32583,8/1/2021,CAN,Melaka,0,0,0,Canada
32584,8/1/2021,CAN,Negeri Sembilan,0,0,0,Canada
32585,8/1/2021,CAN,Pahang,0,0,0,Canada
32586,8/1/2021,CAN,Perak,0,0,0,Canada
32587,8/1/2021,CAN,Perlis,0,0,0,Canada
32588,8/1/2021,CAN,Pulau Pinang,1,0,1,Canada
32589,8/1/2021,CAN,Sabah,0,0,0,Canada
32590,8/1/2021,CAN,Sarawak,0,0,0,Canada
32591,8/1/2021,CAN,Selangor,79,42,37,Canada
32592,8/1/2021,CAN,Terengganu,0,0,0,Canada
32593,8/1/2021,CAN,W.P. Labuan,0,0,0,Canada
32594,8/1/2021,CCK,Selangor,0,0,0,Cocos (Keeling) Islands
32595,8/1/2021,CHE,Johor,0,0,0,Switzerland
32596,8/1/2021,CHE,Kedah,0,0,0,Switzerland
32597,8/1/2021,CHE,Kelantan,0,0,0,Switzerland
32598,8/1/2021,CHE,Melaka,0,0,0,Switzerland
32599,8/1/2021,CHE,Negeri Sembilan,0,0,0,Switzerland
32600,8/1/2021,CHE,Pahang,0,0,0,Switzerland
32601,8/1/2021,CHE,Perak,0,0,0,Switzerland
32602,8/1/2021,CHE,Perlis,0,0,0,Switzerland
32603,8/1/2021,CHE,Pulau Pinang,0,0,0,Switzerland
32604,8/1/2021,CHE,Sabah,0,0,0,Switzerland
32605,8/1/2021,CHE,Sarawak,0,0,0,Switzerland
32606,8/1/2021,CHE,Selangor,19,16,3,Switzerland
32607,8/1/2021,CHE,W.P. Labuan,0,0,0,Switzerland
32608,8/1/2021,CHL,Johor,0,0,0,Chile
32609,8/1/2021,CHL,Kedah,0,0,0,Chile
32610,8/1/2021,CHL,Kelantan,0,0,0,Chile
32611,8/1/2021,CHL,Melaka,0,0,0,Chile
32612,8/1/2021,CHL,Pahang,0,0,0,Chile
32613,8/1/2021,CHL,Perak,0,0,0,Chile
32614,8/1/2021,CHL,Perlis,0,0,0,Chile
32615,8/1/2021,CHL,Pulau Pinang,0,0,0,Chile
32616,8/1/2021,CHL,Sabah,0,0,0,Chile
32617,8/1/2021,CHL,Sarawak,0,0,0,Chile
32618,8/1/2021,CHL,Selangor,4,2,2,Chile
32619,8/1/2021,CHN,Johor,1,1,0,China
32620,8/1/2021,CHN,Kedah,0,0,0,China
32621,8/1/2021,CHN,Kelantan,0,0,0,China
32622,8/1/2021,CHN,Melaka,0,0,0,China
32623,8/1/2021,CHN,Pahang,0,0,0,China
32624,8/1/2021,CHN,Perak,0,0,0,China
32625,8/1/2021,CHN,Perlis,0,0,0,China
32626,8/1/2021,CHN,Pulau Pinang,1,1,0,China
32627,8/1/2021,CHN,Sabah,0,0,0,China
32628,8/1/2021,CHN,Sarawak,99,94,5,China
32629,8/1/2021,CHN,Selangor,705,594,111,China
32630,8/1/2021,CHN,Terengganu,0,0,0,China
32631,8/1/2021,CHN,W.P. Labuan,0,0,0,China
32632,8/1/2021,CIV,Johor,0,0,0,C��te d'Iv
32633,8/1/2021,CIV,Kedah,0,0,0,C��te d'Iv
32634,8/1/2021,CIV,Pulau Pinang,0,0,0,C��te d'Iv
32635,8/1/2021,CIV,Sabah,0,0,0,C��te d'Iv
32636,8/1/2021,CIV,Sarawak,0,0,0,C��te d'Iv
32637,8/1/2021,CIV,Selangor,0,0,0,C��te d'Iv
32638,8/1/2021,CMR,Johor,0,0,0,Cameroon
32639,8/1/2021,CMR,Kedah,0,0,0,Cameroon
32640,8/1/2021,CMR,Pulau Pinang,0,0,0,Cameroon
32641,8/1/2021,CMR,Sabah,0,0,0,Cameroon
32642,8/1/2021,CMR,Sarawak,0,0,0,Cameroon
32643,8/1/2021,CMR,Selangor,3,2,1,Cameroon
32644,8/1/2021,COD,Johor,0,0,0,"Congo, the Democratic Republic of the"
32645,8/1/2021,COD,Pulau Pinang,0,0,0,"Congo, the Democratic Republic of the"
32646,8/1/2021,COD,Sarawak,0,0,0,"Congo, the Democratic Republic of the"
32647,8/1/2021,COD,Selangor,1,1,0,"Congo, the Democratic Republic of the"
32648,8/1/2021,COG,Johor,0,0,0,Congo
32649,8/1/2021,COG,Kedah,0,0,0,Congo
32650,8/1/2021,COG,Selangor,0,0,0,Congo
32651,8/1/2021,COK,Selangor,0,0,0,Cook Islands
32652,8/1/2021,COL,Johor,0,0,0,Colombia
32653,8/1/2021,COL,Kedah,0,0,0,Colombia
32654,8/1/2021,COL,Perak,0,0,0,Colombia
32655,8/1/2021,COL,Pulau Pinang,0,0,0,Colombia
32656,8/1/2021,COL,Sabah,0,0,0,Colombia
32657,8/1/2021,COL,Sarawak,0,0,0,Colombia
32658,8/1/2021,COL,Selangor,7,4,3,Colombia
32659,8/1/2021,COL,W.P. Labuan,0,0,0,Colombia
32660,8/1/2021,COM,Johor,0,0,0,Comoros
32661,8/1/2021,COM,Kedah,0,0,0,Comoros
32662,8/1/2021,COM,Selangor,0,0,0,Comoros
32663,8/1/2021,CPV,Johor,0,0,0,Cape Verde
32664,8/1/2021,CPV,Kedah,0,0,0,Cape Verde
32665,8/1/2021,CPV,Pulau Pinang,0,0,0,Cape Verde
32666,8/1/2021,CPV,Sabah,0,0,0,Cape Verde
32667,8/1/2021,CPV,Selangor,0,0,0,Cape Verde
32668,8/1/2021,CRI,Johor,0,0,0,Costa Rica
32669,8/1/2021,CRI,Kedah,0,0,0,Costa Rica
32670,8/1/2021,CRI,Perak,0,0,0,Costa Rica
32671,8/1/2021,CRI,Perlis,0,0,0,Costa Rica
32672,8/1/2021,CRI,Pulau Pinang,0,0,0,Costa Rica
32673,8/1/2021,CRI,Sabah,0,0,0,Costa Rica
32674,8/1/2021,CRI,Sarawak,0,0,0,Costa Rica
32675,8/1/2021,CRI,Selangor,0,0,0,Costa Rica
32676,8/1/2021,CUB,Johor,0,0,0,Cuba
32677,8/1/2021,CUB,Kedah,0,0,0,Cuba
32678,8/1/2021,CUB,Perlis,0,0,0,Cuba
32679,8/1/2021,CUB,Pulau Pinang,0,0,0,Cuba
32680,8/1/2021,CUB,Sabah,0,0,0,Cuba
32681,8/1/2021,CUB,Sarawak,0,0,0,Cuba
32682,8/1/2021,CUB,Selangor,0,0,0,Cuba
32683,8/1/2021,CYP,Johor,0,0,0,Cyprus
32684,8/1/2021,CYP,Kedah,0,0,0,Cyprus
32685,8/1/2021,CYP,Perak,0,0,0,Cyprus
32686,8/1/2021,CYP,Perlis,0,0,0,Cyprus
32687,8/1/2021,CYP,Pulau Pinang,0,0,0,Cyprus
32688,8/1/2021,CYP,Sabah,0,0,0,Cyprus
32689,8/1/2021,CYP,Sarawak,0,0,0,Cyprus
32690,8/1/2021,CYP,Selangor,0,0,0,Cyprus
32691,8/1/2021,CZE,Johor,0,0,0,Czech Republic
32692,8/1/2021,CZE,Kedah,0,0,0,Czech Republic
32693,8/1/2021,CZE,Kelantan,0,0,0,Czech Republic
32694,8/1/2021,CZE,Melaka,0,0,0,Czech Republic
32695,8/1/2021,CZE,Negeri Sembilan,0,0,0,Czech Republic
32696,8/1/2021,CZE,Perak,0,0,0,Czech Republic
32697,8/1/2021,CZE,Perlis,0,0,0,Czech Republic
32698,8/1/2021,CZE,Pulau Pinang,0,0,0,Czech Republic
32699,8/1/2021,CZE,Sabah,0,0,0,Czech Republic
32700,8/1/2021,CZE,Sarawak,0,0,0,Czech Republic
32701,8/1/2021,CZE,Selangor,8,4,4,Czech Republic
32702,8/1/2021,CZE,W.P. Labuan,0,0,0,Czech Republic
32703,8/1/2021,DEU,Johor,0,0,0,Germany
32704,8/1/2021,DEU,Kedah,0,0,0,Germany
32705,8/1/2021,DEU,Kelantan,0,0,0,Germany
32706,8/1/2021,DEU,Melaka,0,0,0,Germany
32707,8/1/2021,DEU,Negeri Sembilan,0,0,0,Germany
32708,8/1/2021,DEU,Pahang,0,0,0,Germany
32709,8/1/2021,DEU,Perak,0,0,0,Germany
32710,8/1/2021,DEU,Perlis,0,0,0,Germany
32711,8/1/2021,DEU,Pulau Pinang,6,3,3,Germany
32712,8/1/2021,DEU,Sabah,0,0,0,Germany
32713,8/1/2021,DEU,Sarawak,3,3,0,Germany
32714,8/1/2021,DEU,Selangor,109,71,38,Germany
32715,8/1/2021,DEU,Terengganu,0,0,0,Germany
32716,8/1/2021,DEU,W.P. Labuan,0,0,0,Germany
32717,8/1/2021,DJI,Johor,0,0,0,Djibouti
32718,8/1/2021,DJI,Selangor,2,0,2,Djibouti
32719,8/1/2021,DMA,Johor,0,0,0,Dominica
32720,8/1/2021,DMA,Kedah,0,0,0,Dominica
32721,8/1/2021,DMA,Pulau Pinang,0,0,0,Dominica
32722,8/1/2021,DMA,Sabah,0,0,0,Dominica
32723,8/1/2021,DMA,Sarawak,0,0,0,Dominica
32724,8/1/2021,DMA,Selangor,4,3,1,Dominica
32725,8/1/2021,DMA,W.P. Labuan,0,0,0,Dominica
32726,8/1/2021,DNK,Johor,0,0,0,Denmark
32727,8/1/2021,DNK,Kedah,0,0,0,Denmark
32728,8/1/2021,DNK,Kelantan,0,0,0,Denmark
32729,8/1/2021,DNK,Melaka,0,0,0,Denmark
32730,8/1/2021,DNK,Negeri Sembilan,0,0,0,Denmark
32731,8/1/2021,DNK,Pahang,0,0,0,Denmark
32732,8/1/2021,DNK,Perak,0,0,0,Denmark
32733,8/1/2021,DNK,Perlis,0,0,0,Denmark
32734,8/1/2021,DNK,Pulau Pinang,0,0,0,Denmark
32735,8/1/2021,DNK,Sabah,0,0,0,Denmark
32736,8/1/2021,DNK,Sarawak,0,0,0,Denmark
32737,8/1/2021,DNK,Selangor,35,25,10,Denmark
32738,8/1/2021,DNK,W.P. Labuan,0,0,0,Denmark
32739,8/1/2021,DOM,Johor,0,0,0,Dominican Republic
32740,8/1/2021,DOM,Kedah,0,0,0,Dominican Republic
32741,8/1/2021,DOM,Perak,0,0,0,Dominican Republic
32742,8/1/2021,DOM,Perlis,0,0,0,Dominican Republic
32743,8/1/2021,DOM,Pulau Pinang,0,0,0,Dominican Republic
32744,8/1/2021,DOM,Sabah,0,0,0,Dominican Republic
32745,8/1/2021,DOM,Sarawak,0,0,0,Dominican Republic
32746,8/1/2021,DOM,Selangor,0,0,0,Dominican Republic
32747,8/1/2021,DZA,Johor,0,0,0,Algeria
32748,8/1/2021,DZA,Kedah,0,0,0,Algeria
32749,8/1/2021,DZA,Kelantan,0,0,0,Algeria
32750,8/1/2021,DZA,Melaka,0,0,0,Algeria
32751,8/1/2021,DZA,Perak,0,0,0,Algeria
32752,8/1/2021,DZA,Perlis,0,0,0,Algeria
32753,8/1/2021,DZA,Pulau Pinang,0,0,0,Algeria
32754,8/1/2021,DZA,Sabah,0,0,0,Algeria
32755,8/1/2021,DZA,Sarawak,0,0,0,Algeria
32756,8/1/2021,DZA,Selangor,12,5,7,Algeria
32757,8/1/2021,DZA,W.P. Labuan,0,0,0,Algeria
32758,8/1/2021,ECU,Johor,0,0,0,Ecuador
32759,8/1/2021,ECU,Kedah,0,0,0,Ecuador
32760,8/1/2021,ECU,Perak,0,0,0,Ecuador
32761,8/1/2021,ECU,Perlis,0,0,0,Ecuador
32762,8/1/2021,ECU,Pulau Pinang,0,0,0,Ecuador
32763,8/1/2021,ECU,Sabah,0,0,0,Ecuador
32764,8/1/2021,ECU,Sarawak,0,0,0,Ecuador
32765,8/1/2021,ECU,Selangor,1,0,1,Ecuador
32766,8/1/2021,EGY,Johor,0,0,0,Egypt
32767,8/1/2021,EGY,Kedah,0,0,0,Egypt
32768,8/1/2021,EGY,Kelantan,0,0,0,Egypt
32769,8/1/2021,EGY,Melaka,0,0,0,Egypt
32770,8/1/2021,EGY,Pahang,0,0,0,Egypt
32771,8/1/2021,EGY,Perak,0,0,0,Egypt
32772,8/1/2021,EGY,Perlis,0,0,0,Egypt
32773,8/1/2021,EGY,Pulau Pinang,0,0,0,Egypt
32774,8/1/2021,EGY,Sabah,0,0,0,Egypt
32775,8/1/2021,EGY,Sarawak,0,0,0,Egypt
32776,8/1/2021,EGY,Selangor,81,61,20,Egypt
32777,8/1/2021,EGY,Terengganu,0,0,0,Egypt
32778,8/1/2021,EGY,W.P. Labuan,0,0,0,Egypt
32779,8/1/2021,ERI,Johor,0,0,0,Eritrea
32780,8/1/2021,ERI,Pulau Pinang,0,0,0,Eritrea
32781,8/1/2021,ERI,Sabah,0,0,0,Eritrea
32782,8/1/2021,ERI,Selangor,0,0,0,Eritrea
32783,8/1/2021,ESP,Johor,0,0,0,Spain
32784,8/1/2021,ESP,Kedah,0,0,0,Spain
32785,8/1/2021,ESP,Kelantan,0,0,0,Spain
32786,8/1/2021,ESP,Melaka,0,0,0,Spain
32787,8/1/2021,ESP,Negeri Sembilan,0,0,0,Spain
32788,8/1/2021,ESP,Pahang,0,0,0,Spain
32789,8/1/2021,ESP,Perak,0,0,0,Spain
32790,8/1/2021,ESP,Perlis,0,0,0,Spain
32791,8/1/2021,ESP,Pulau Pinang,0,0,0,Spain
32792,8/1/2021,ESP,Sabah,0,0,0,Spain
32793,8/1/2021,ESP,Sarawak,0,0,0,Spain
32794,8/1/2021,ESP,Selangor,75,45,30,Spain
32795,8/1/2021,ESP,W.P. Labuan,0,0,0,Spain
32796,8/1/2021,EST,Johor,0,0,0,Estonia
32797,8/1/2021,EST,Kedah,0,0,0,Estonia
32798,8/1/2021,EST,Kelantan,0,0,0,Estonia
32799,8/1/2021,EST,Pahang,0,0,0,Estonia
32800,8/1/2021,EST,Perak,0,0,0,Estonia
32801,8/1/2021,EST,Perlis,0,0,0,Estonia
32802,8/1/2021,EST,Pulau Pinang,0,0,0,Estonia
32803,8/1/2021,EST,Sabah,0,0,0,Estonia
32804,8/1/2021,EST,Sarawak,0,0,0,Estonia
32805,8/1/2021,EST,Selangor,0,0,0,Estonia
32806,8/1/2021,EST,W.P. Labuan,0,0,0,Estonia
32807,8/1/2021,ETH,Johor,0,0,0,Ethiopia
32808,8/1/2021,ETH,Kedah,0,0,0,Ethiopia
32809,8/1/2021,ETH,Pulau Pinang,0,0,0,Ethiopia
32810,8/1/2021,ETH,Sarawak,0,0,0,Ethiopia
32811,8/1/2021,ETH,Selangor,1,1,0,Ethiopia
32812,8/1/2021,FIN,Johor,0,0,0,Finland
32813,8/1/2021,FIN,Kedah,0,0,0,Finland
32814,8/1/2021,FIN,Kelantan,0,0,0,Finland
32815,8/1/2021,FIN,Melaka,0,0,0,Finland
32816,8/1/2021,FIN,Negeri Sembilan,0,0,0,Finland
32817,8/1/2021,FIN,Pahang,0,0,0,Finland
32818,8/1/2021,FIN,Perak,0,0,0,Finland
32819,8/1/2021,FIN,Perlis,0,0,0,Finland
32820,8/1/2021,FIN,Pulau Pinang,0,0,0,Finland
32821,8/1/2021,FIN,Sabah,0,0,0,Finland
32822,8/1/2021,FIN,Sarawak,0,0,0,Finland
32823,8/1/2021,FIN,Selangor,16,12,4,Finland
32824,8/1/2021,FIN,W.P. Labuan,0,0,0,Finland
32825,8/1/2021,FJI,Johor,0,0,0,Fiji
32826,8/1/2021,FJI,Kedah,0,0,0,Fiji
32827,8/1/2021,FJI,Kelantan,0,0,0,Fiji
32828,8/1/2021,FJI,Perak,0,0,0,Fiji
32829,8/1/2021,FJI,Perlis,0,0,0,Fiji
32830,8/1/2021,FJI,Pulau Pinang,0,0,0,Fiji
32831,8/1/2021,FJI,Sabah,0,0,0,Fiji
32832,8/1/2021,FJI,Sarawak,0,0,0,Fiji
32833,8/1/2021,FJI,Selangor,0,0,0,Fiji
32834,8/1/2021,FRA,Johor,0,0,0,France
32835,8/1/2021,FRA,Kedah,0,0,0,France
32836,8/1/2021,FRA,Kelantan,0,0,0,France
32837,8/1/2021,FRA,Melaka,0,0,0,France
32838,8/1/2021,FRA,Negeri Sembilan,0,0,0,France
32839,8/1/2021,FRA,Pahang,0,0,0,France
32840,8/1/2021,FRA,Perak,0,0,0,France
32841,8/1/2021,FRA,Perlis,0,0,0,France
32842,8/1/2021,FRA,Pulau Pinang,5,4,1,France
32843,8/1/2021,FRA,Sabah,0,0,0,France
32844,8/1/2021,FRA,Sarawak,1,1,0,France
32845,8/1/2021,FRA,Selangor,417,243,174,France
32846,8/1/2021,FRA,Terengganu,0,0,0,France
32847,8/1/2021,FRA,W.P. Labuan,0,0,0,France
32848,8/1/2021,FSM,Johor,0,0,0,"Micronesia, Federated States of"
32849,8/1/2021,FSM,Pulau Pinang,0,0,0,"Micronesia, Federated States of"
32850,8/1/2021,FSM,Selangor,0,0,0,"Micronesia, Federated States of"
32851,8/1/2021,GAB,Johor,0,0,0,Gabon
32852,8/1/2021,GAB,Pulau Pinang,0,0,0,Gabon
32853,8/1/2021,GAB,Sarawak,0,0,0,Gabon
32854,8/1/2021,GAB,Selangor,0,0,0,Gabon
32855,8/1/2021,GBR,Johor,2,2,0,United Kingdom
32856,8/1/2021,GBR,Kedah,0,0,0,United Kingdom
32857,8/1/2021,GBR,Kelantan,0,0,0,United Kingdom
32858,8/1/2021,GBR,Melaka,0,0,0,United Kingdom
32859,8/1/2021,GBR,Negeri Sembilan,0,0,0,United Kingdom
32860,8/1/2021,GBR,Pahang,0,0,0,United Kingdom
32861,8/1/2021,GBR,Perak,0,0,0,United Kingdom
32862,8/1/2021,GBR,Perlis,0,0,0,United Kingdom
32863,8/1/2021,GBR,Pulau Pinang,26,9,17,United Kingdom
32864,8/1/2021,GBR,Sabah,0,0,0,United Kingdom
32865,8/1/2021,GBR,Sarawak,7,6,1,United Kingdom
32866,8/1/2021,GBR,Selangor,627,364,263,United Kingdom
32867,8/1/2021,GBR,Terengganu,0,0,0,United Kingdom
32868,8/1/2021,GBR,W.P. Labuan,0,0,0,United Kingdom
32869,8/1/2021,GEO,Johor,0,0,0,Georgia
32870,8/1/2021,GEO,Kedah,0,0,0,Georgia
32871,8/1/2021,GEO,Melaka,0,0,0,Georgia
32872,8/1/2021,GEO,Perak,0,0,0,Georgia
32873,8/1/2021,GEO,Perlis,0,0,0,Georgia
32874,8/1/2021,GEO,Pulau Pinang,0,0,0,Georgia
32875,8/1/2021,GEO,Sabah,0,0,0,Georgia
32876,8/1/2021,GEO,Sarawak,0,0,0,Georgia
32877,8/1/2021,GEO,Selangor,9,9,0,Georgia
32878,8/1/2021,GHA,Johor,0,0,0,Ghana
32879,8/1/2021,GHA,Kedah,0,0,0,Ghana
32880,8/1/2021,GHA,Kelantan,0,0,0,Ghana
32881,8/1/2021,GHA,Pulau Pinang,0,0,0,Ghana
32882,8/1/2021,GHA,Sabah,0,0,0,Ghana
32883,8/1/2021,GHA,Sarawak,0,0,0,Ghana
32884,8/1/2021,GHA,Selangor,10,5,5,Ghana
32885,8/1/2021,GIB,Johor,0,0,0,Gibraltar
32886,8/1/2021,GIB,Sarawak,0,0,0,Gibraltar
32887,8/1/2021,GIN,Johor,0,0,0,Guinea
32888,8/1/2021,GIN,Kedah,0,0,0,Guinea
32889,8/1/2021,GIN,Kelantan,0,0,0,Guinea
32890,8/1/2021,GIN,Perlis,0,0,0,Guinea
32891,8/1/2021,GIN,Pulau Pinang,0,0,0,Guinea
32892,8/1/2021,GIN,Sabah,0,0,0,Guinea
32893,8/1/2021,GIN,Sarawak,0,0,0,Guinea
32894,8/1/2021,GIN,Selangor,4,3,1,Guinea
32895,8/1/2021,GLP,Selangor,0,0,0,Guadeloupe
32896,8/1/2021,GMB,Johor,0,0,0,Gambia
32897,8/1/2021,GMB,Kedah,0,0,0,Gambia
32898,8/1/2021,GMB,Kelantan,0,0,0,Gambia
32899,8/1/2021,GMB,Pulau Pinang,0,0,0,Gambia
32900,8/1/2021,GMB,Sabah,0,0,0,Gambia
32901,8/1/2021,GMB,Sarawak,0,0,0,Gambia
32902,8/1/2021,GMB,Selangor,0,0,0,Gambia
32903,8/1/2021,GNB,Johor,0,0,0,Guinea-Bissau
32904,8/1/2021,GNB,Selangor,0,0,0,Guinea-Bissau
32905,8/1/2021,GNQ,Johor,0,0,0,Equatorial Guinea
32906,8/1/2021,GNQ,Selangor,0,0,0,Equatorial Guinea
32907,8/1/2021,GRC,Johor,0,0,0,Greece
32908,8/1/2021,GRC,Kedah,0,0,0,Greece
32909,8/1/2021,GRC,Kelantan,0,0,0,Greece
32910,8/1/2021,GRC,Melaka,0,0,0,Greece
32911,8/1/2021,GRC,Negeri Sembilan,0,0,0,Greece
32912,8/1/2021,GRC,Pahang,0,0,0,Greece
32913,8/1/2021,GRC,Perak,0,0,0,Greece
32914,8/1/2021,GRC,Perlis,0,0,0,Greece
32915,8/1/2021,GRC,Pulau Pinang,0,0,0,Greece
32916,8/1/2021,GRC,Sabah,0,0,0,Greece
32917,8/1/2021,GRC,Sarawak,0,0,0,Greece
32918,8/1/2021,GRC,Selangor,10,7,3,Greece
32919,8/1/2021,GRD,Johor,0,0,0,Grenada
32920,8/1/2021,GRD,Kedah,0,0,0,Grenada
32921,8/1/2021,GRD,Pulau Pinang,0,0,0,Grenada
32922,8/1/2021,GRD,Sabah,0,0,0,Grenada
32923,8/1/2021,GRD,Sarawak,0,0,0,Grenada
32924,8/1/2021,GRD,Selangor,0,0,0,Grenada
32925,8/1/2021,GRL,Johor,0,0,0,Greenland
32926,8/1/2021,GRL,Selangor,0,0,0,Greenland
32927,8/1/2021,GTM,Johor,0,0,0,Guatemala
32928,8/1/2021,GTM,Kedah,0,0,0,Guatemala
32929,8/1/2021,GTM,Pahang,0,0,0,Guatemala
32930,8/1/2021,GTM,Perak,0,0,0,Guatemala
32931,8/1/2021,GTM,Pulau Pinang,0,0,0,Guatemala
32932,8/1/2021,GTM,Sabah,0,0,0,Guatemala
32933,8/1/2021,GTM,Sarawak,0,0,0,Guatemala
32934,8/1/2021,GTM,Selangor,0,0,0,Guatemala
32935,8/1/2021,GTM,W.P. Labuan,0,0,0,Guatemala
32936,8/1/2021,GUY,Johor,0,0,0,Guyana
32937,8/1/2021,GUY,Kedah,0,0,0,Guyana
32938,8/1/2021,GUY,Pulau Pinang,0,0,0,Guyana
32939,8/1/2021,GUY,Sarawak,0,0,0,Guyana
32940,8/1/2021,GUY,Selangor,0,0,0,Guyana
32941,8/1/2021,HKG,Johor,0,0,0,Hong Kong
32942,8/1/2021,HKG,Kedah,0,0,0,Hong Kong
32943,8/1/2021,HKG,Kelantan,0,0,0,Hong Kong
32944,8/1/2021,HKG,Pahang,0,0,0,Hong Kong
32945,8/1/2021,HKG,Perak,0,0,0,Hong Kong
32946,8/1/2021,HKG,Perlis,0,0,0,Hong Kong
32947,8/1/2021,HKG,Pulau Pinang,3,1,2,Hong Kong
32948,8/1/2021,HKG,Sabah,0,0,0,Hong Kong
32949,8/1/2021,HKG,Sarawak,0,0,0,Hong Kong
32950,8/1/2021,HKG,Selangor,0,0,0,Hong Kong
32951,8/1/2021,HKG,Terengganu,0,0,0,Hong Kong
32952,8/1/2021,HMD,Johor,0,0,0,Heard Island and McDonald Islands
32953,8/1/2021,HND,Johor,0,0,0,Honduras
32954,8/1/2021,HND,Kedah,0,0,0,Honduras
32955,8/1/2021,HND,Perak,0,0,0,Honduras
32956,8/1/2021,HND,Pulau Pinang,0,0,0,Honduras
32957,8/1/2021,HND,Sabah,0,0,0,Honduras
32958,8/1/2021,HND,Sarawak,0,0,0,Honduras
32959,8/1/2021,HND,Selangor,2,1,1,Honduras
32960,8/1/2021,HRV,Johor,0,0,0,Croatia
32961,8/1/2021,HRV,Kedah,0,0,0,Croatia
32962,8/1/2021,HRV,Kelantan,0,0,0,Croatia
32963,8/1/2021,HRV,Melaka,0,0,0,Croatia
32964,8/1/2021,HRV,Pahang,0,0,0,Croatia
32965,8/1/2021,HRV,Perak,0,0,0,Croatia
32966,8/1/2021,HRV,Perlis,0,0,0,Croatia
32967,8/1/2021,HRV,Pulau Pinang,0,0,0,Croatia
32968,8/1/2021,HRV,Sabah,2,2,0,Croatia
32969,8/1/2021,HRV,Sarawak,0,0,0,Croatia
32970,8/1/2021,HRV,Selangor,23,22,1,Croatia
32971,8/1/2021,HTI,Johor,0,0,0,Haiti
32972,8/1/2021,HTI,Kedah,0,0,0,Haiti
32973,8/1/2021,HTI,Kelantan,0,0,0,Haiti
32974,8/1/2021,HTI,Perak,0,0,0,Haiti
32975,8/1/2021,HTI,Pulau Pinang,0,0,0,Haiti
32976,8/1/2021,HTI,Sabah,0,0,0,Haiti
32977,8/1/2021,HTI,Selangor,0,0,0,Haiti
32978,8/1/2021,HUN,Johor,0,0,0,Hungary
32979,8/1/2021,HUN,Kedah,0,0,0,Hungary
32980,8/1/2021,HUN,Kelantan,0,0,0,Hungary
32981,8/1/2021,HUN,Pahang,0,0,0,Hungary
32982,8/1/2021,HUN,Perak,0,0,0,Hungary
32983,8/1/2021,HUN,Perlis,0,0,0,Hungary
32984,8/1/2021,HUN,Pulau Pinang,2,0,2,Hungary
32985,8/1/2021,HUN,Sabah,0,0,0,Hungary
32986,8/1/2021,HUN,Sarawak,0,0,0,Hungary
32987,8/1/2021,HUN,Selangor,8,7,1,Hungary
32988,8/1/2021,HUN,W.P. Labuan,0,0,0,Hungary
32989,8/1/2021,IDN,Johor,61,49,12,Indonesia
32990,8/1/2021,IDN,Kedah,5,5,0,Indonesia
32991,8/1/2021,IDN,Kelantan,0,0,0,Indonesia
32992,8/1/2021,IDN,Melaka,0,0,0,Indonesia
32993,8/1/2021,IDN,Negeri Sembilan,0,0,0,Indonesia
32994,8/1/2021,IDN,Pahang,0,0,0,Indonesia
32995,8/1/2021,IDN,Perak,0,0,0,Indonesia
32996,8/1/2021,IDN,Perlis,7,7,0,Indonesia
32997,8/1/2021,IDN,Pulau Pinang,1,1,0,Indonesia
32998,8/1/2021,IDN,Sabah,2,0,2,Indonesia
32999,8/1/2021,IDN,Sarawak,206,200,6,Indonesia
33000,8/1/2021,IDN,Selangor,601,409,192,Indonesia
33001,8/1/2021,IDN,Terengganu,0,0,0,Indonesia
33002,8/1/2021,IDN,W.P. Labuan,2,2,0,Indonesia
33003,8/1/2021,IND,Johor,17,17,0,India
33004,8/1/2021,IND,Kedah,0,0,0,India
33005,8/1/2021,IND,Kelantan,0,0,0,India
33006,8/1/2021,IND,Melaka,0,0,0,India
33007,8/1/2021,IND,Negeri Sembilan,0,0,0,India
33008,8/1/2021,IND,Pahang,0,0,0,India
33009,8/1/2021,IND,Perak,0,0,0,India
33010,8/1/2021,IND,Perlis,0,0,0,India
33011,8/1/2021,IND,Pulau Pinang,1,1,0,India
33012,8/1/2021,IND,Sabah,0,0,0,India
33013,8/1/2021,IND,Sarawak,0,0,0,India
33014,8/1/2021,IND,Selangor,50,33,17,India
33015,8/1/2021,IND,Terengganu,0,0,0,India
33016,8/1/2021,IND,W.P. Labuan,0,0,0,India
33017,8/1/2021,IOT,Pulau Pinang,0,0,0,British Indian Ocean Territory
33018,8/1/2021,IOT,Selangor,0,0,0,British Indian Ocean Territory
33019,8/1/2021,IRL,Johor,0,0,0,Ireland
33020,8/1/2021,IRL,Kedah,0,0,0,Ireland
33021,8/1/2021,IRL,Kelantan,0,0,0,Ireland
33022,8/1/2021,IRL,Negeri Sembilan,0,0,0,Ireland
33023,8/1/2021,IRL,Pahang,0,0,0,Ireland
33024,8/1/2021,IRL,Perak,0,0,0,Ireland
33025,8/1/2021,IRL,Perlis,0,0,0,Ireland
33026,8/1/2021,IRL,Pulau Pinang,0,0,0,Ireland
33027,8/1/2021,IRL,Sabah,0,0,0,Ireland
33028,8/1/2021,IRL,Sarawak,0,0,0,Ireland
33029,8/1/2021,IRL,Selangor,29,18,11,Ireland
33030,8/1/2021,IRL,Terengganu,0,0,0,Ireland
33031,8/1/2021,IRL,W.P. Labuan,0,0,0,Ireland
33032,8/1/2021,IRN,Johor,0,0,0,Iran
33033,8/1/2021,IRN,Kedah,0,0,0,Iran
33034,8/1/2021,IRN,Kelantan,0,0,0,Iran
33035,8/1/2021,IRN,Perak,0,0,0,Iran
33036,8/1/2021,IRN,Perlis,0,0,0,Iran
33037,8/1/2021,IRN,Pulau Pinang,1,0,1,Iran
33038,8/1/2021,IRN,Sabah,0,0,0,Iran
33039,8/1/2021,IRN,Sarawak,0,0,0,Iran
33040,8/1/2021,IRN,Selangor,45,33,12,Iran
33041,8/1/2021,IRN,W.P. Labuan,0,0,0,Iran
33042,8/1/2021,IRQ,Johor,0,0,0,Iraq
33043,8/1/2021,IRQ,Kedah,0,0,0,Iraq
33044,8/1/2021,IRQ,Kelantan,0,0,0,Iraq
33045,8/1/2021,IRQ,Melaka,0,0,0,Iraq
33046,8/1/2021,IRQ,Pahang,0,0,0,Iraq
33047,8/1/2021,IRQ,Perak,0,0,0,Iraq
33048,8/1/2021,IRQ,Perlis,0,0,0,Iraq
33049,8/1/2021,IRQ,Pulau Pinang,0,0,0,Iraq
33050,8/1/2021,IRQ,Sabah,0,0,0,Iraq
33051,8/1/2021,IRQ,Sarawak,0,0,0,Iraq
33052,8/1/2021,IRQ,Selangor,29,15,14,Iraq
33053,8/1/2021,ISL,Johor,0,0,0,Iceland
33054,8/1/2021,ISL,Kedah,0,0,0,Iceland
33055,8/1/2021,ISL,Kelantan,0,0,0,Iceland
33056,8/1/2021,ISL,Perak,0,0,0,Iceland
33057,8/1/2021,ISL,Perlis,0,0,0,Iceland
33058,8/1/2021,ISL,Pulau Pinang,0,0,0,Iceland
33059,8/1/2021,ISL,Sabah,0,0,0,Iceland
33060,8/1/2021,ISL,Sarawak,0,0,0,Iceland
33061,8/1/2021,ISL,Selangor,0,0,0,Iceland
33062,8/1/2021,ISL,W.P. Labuan,0,0,0,Iceland
33063,8/1/2021,ISR,Pulau Pinang,0,0,0,Israel
33064,8/1/2021,ITA,Johor,0,0,0,Italy
33065,8/1/2021,ITA,Kedah,0,0,0,Italy
33066,8/1/2021,ITA,Kelantan,0,0,0,Italy
33067,8/1/2021,ITA,Melaka,0,0,0,Italy
33068,8/1/2021,ITA,Negeri Sembilan,0,0,0,Italy
33069,8/1/2021,ITA,Pahang,0,0,0,Italy
33070,8/1/2021,ITA,Perak,0,0,0,Italy
33071,8/1/2021,ITA,Perlis,0,0,0,Italy
33072,8/1/2021,ITA,Pulau Pinang,1,1,0,Italy
33073,8/1/2021,ITA,Sabah,0,0,0,Italy
33074,8/1/2021,ITA,Sarawak,1,1,0,Italy
33075,8/1/2021,ITA,Selangor,65,43,22,Italy
33076,8/1/2021,ITA,W.P. Labuan,0,0,0,Italy
33077,8/1/2021,JAM,Johor,0,0,0,Jamaica
33078,8/1/2021,JAM,Kedah,0,0,0,Jamaica
33079,8/1/2021,JAM,Perak,0,0,0,Jamaica
33080,8/1/2021,JAM,Pulau Pinang,0,0,0,Jamaica
33081,8/1/2021,JAM,Sabah,0,0,0,Jamaica
33082,8/1/2021,JAM,Sarawak,0,0,0,Jamaica
33083,8/1/2021,JAM,Selangor,0,0,0,Jamaica
33084,8/1/2021,JAM,W.P. Labuan,0,0,0,Jamaica
33085,8/1/2021,JOR,Johor,0,0,0,Jordan
33086,8/1/2021,JOR,Kedah,0,0,0,Jordan
33087,8/1/2021,JOR,Kelantan,0,0,0,Jordan
33088,8/1/2021,JOR,Melaka,0,0,0,Jordan
33089,8/1/2021,JOR,Perlis,0,0,0,Jordan
33090,8/1/2021,JOR,Pulau Pinang,0,0,0,Jordan
33091,8/1/2021,JOR,Sabah,0,0,0,Jordan
33092,8/1/2021,JOR,Sarawak,0,0,0,Jordan
33093,8/1/2021,JOR,Selangor,24,15,9,Jordan
33094,8/1/2021,JOR,W.P. Labuan,0,0,0,Jordan
33095,8/1/2021,JPN,Johor,1,1,0,Japan
33096,8/1/2021,JPN,Kedah,0,0,0,Japan
33097,8/1/2021,JPN,Kelantan,0,0,0,Japan
33098,8/1/2021,JPN,Melaka,0,0,0,Japan
33099,8/1/2021,JPN,Negeri Sembilan,0,0,0,Japan
33100,8/1/2021,JPN,Pahang,0,0,0,Japan
33101,8/1/2021,JPN,Perak,1,1,0,Japan
33102,8/1/2021,JPN,Perlis,0,0,0,Japan
33103,8/1/2021,JPN,Pulau Pinang,22,16,6,Japan
33104,8/1/2021,JPN,Sabah,0,0,0,Japan
33105,8/1/2021,JPN,Sarawak,1,1,0,Japan
33106,8/1/2021,JPN,Selangor,360,226,134,Japan
33107,8/1/2021,JPN,W.P. Labuan,0,0,0,Japan
33108,8/1/2021,KAZ,Johor,0,0,0,Kazakhstan
33109,8/1/2021,KAZ,Kedah,0,0,0,Kazakhstan
33110,8/1/2021,KAZ,Kelantan,0,0,0,Kazakhstan
33111,8/1/2021,KAZ,Melaka,0,0,0,Kazakhstan
33112,8/1/2021,KAZ,Perak,0,0,0,Kazakhstan
33113,8/1/2021,KAZ,Perlis,0,0,0,Kazakhstan
33114,8/1/2021,KAZ,Pulau Pinang,0,0,0,Kazakhstan
33115,8/1/2021,KAZ,Sabah,0,0,0,Kazakhstan
33116,8/1/2021,KAZ,Sarawak,0,0,0,Kazakhstan
33117,8/1/2021,KAZ,Selangor,21,17,4,Kazakhstan
33118,8/1/2021,KAZ,W.P. Labuan,0,0,0,Kazakhstan
33119,8/1/2021,KEN,Johor,0,0,0,Kenya
33120,8/1/2021,KEN,Kedah,0,0,0,Kenya
33121,8/1/2021,KEN,Kelantan,0,0,0,Kenya
33122,8/1/2021,KEN,Perak,0,0,0,Kenya
33123,8/1/2021,KEN,Perlis,0,0,0,Kenya
33124,8/1/2021,KEN,Pulau Pinang,0,0,0,Kenya
33125,8/1/2021,KEN,Sabah,0,0,0,Kenya
33126,8/1/2021,KEN,Sarawak,0,0,0,Kenya
33127,8/1/2021,KEN,Selangor,8,4,4,Kenya
33128,8/1/2021,KGZ,Johor,0,0,0,Kyrgyzstan
33129,8/1/2021,KGZ,Kedah,0,0,0,Kyrgyzstan
33130,8/1/2021,KGZ,Kelantan,0,0,0,Kyrgyzstan
33131,8/1/2021,KGZ,Perak,0,0,0,Kyrgyzstan
33132,8/1/2021,KGZ,Perlis,0,0,0,Kyrgyzstan
33133,8/1/2021,KGZ,Pulau Pinang,0,0,0,Kyrgyzstan
33134,8/1/2021,KGZ,Sabah,0,0,0,Kyrgyzstan
33135,8/1/2021,KGZ,Sarawak,0,0,0,Kyrgyzstan
33136,8/1/2021,KGZ,Selangor,8,8,0,Kyrgyzstan
33137,8/1/2021,KHM,Johor,0,0,0,Cambodia
33138,8/1/2021,KHM,Kedah,0,0,0,Cambodia
33139,8/1/2021,KHM,Kelantan,0,0,0,Cambodia
33140,8/1/2021,KHM,Melaka,0,0,0,Cambodia
33141,8/1/2021,KHM,Negeri Sembilan,0,0,0,Cambodia
33142,8/1/2021,KHM,Pahang,0,0,0,Cambodia
33143,8/1/2021,KHM,Perak,0,0,0,Cambodia
33144,8/1/2021,KHM,Perlis,0,0,0,Cambodia
33145,8/1/2021,KHM,Pulau Pinang,1,0,1,Cambodia
33146,8/1/2021,KHM,Sabah,0,0,0,Cambodia
33147,8/1/2021,KHM,Sarawak,0,0,0,Cambodia
33148,8/1/2021,KHM,Selangor,63,61,2,Cambodia
33149,8/1/2021,KHM,W.P. Labuan,0,0,0,Cambodia
33150,8/1/2021,KIR,Johor,0,0,0,Kiribati
33151,8/1/2021,KIR,Sabah,0,0,0,Kiribati
33152,8/1/2021,KIR,Selangor,0,0,0,Kiribati
33153,8/1/2021,KNA,Johor,0,0,0,Saint Kitts and Nevis
33154,8/1/2021,KNA,Kedah,0,0,0,Saint Kitts and Nevis
33155,8/1/2021,KNA,Perlis,0,0,0,Saint Kitts and Nevis
33156,8/1/2021,KNA,Pulau Pinang,0,0,0,Saint Kitts and Nevis
33157,8/1/2021,KNA,Sabah,0,0,0,Saint Kitts and Nevis
33158,8/1/2021,KNA,Selangor,0,0,0,Saint Kitts and Nevis
33159,8/1/2021,KNA,W.P. Labuan,0,0,0,Saint Kitts and Nevis
33160,8/1/2021,KOR,Johor,0,0,0,"Korea, Republic of (South Korea)"
33161,8/1/2021,KOR,Kedah,0,0,0,"Korea, Republic of (South Korea)"
33162,8/1/2021,KOR,Kelantan,0,0,0,"Korea, Republic of (South Korea)"
33163,8/1/2021,KOR,Melaka,0,0,0,"Korea, Republic of (South Korea)"
33164,8/1/2021,KOR,Negeri Sembilan,0,0,0,"Korea, Republic of (South Korea)"
33165,8/1/2021,KOR,Pahang,0,0,0,"Korea, Republic of (South Korea)"
33166,8/1/2021,KOR,Perak,0,0,0,"Korea, Republic of (South Korea)"
33167,8/1/2021,KOR,Perlis,0,0,0,"Korea, Republic of (South Korea)"
33168,8/1/2021,KOR,Pulau Pinang,12,6,6,"Korea, Republic of (South Korea)"
33169,8/1/2021,KOR,Sabah,0,0,0,"Korea, Republic of (South Korea)"
33170,8/1/2021,KOR,Sarawak,28,28,0,"Korea, Republic of (South Korea)"
33171,8/1/2021,KOR,Selangor,332,187,145,"Korea, Republic of (South Korea)"
33172,8/1/2021,KOR,Terengganu,0,0,0,"Korea, Republic of (South Korea)"
33173,8/1/2021,KOR,W.P. Labuan,0,0,0,"Korea, Republic of (South Korea)"
33174,8/1/2021,KWT,Johor,0,0,0,Kuwait
33175,8/1/2021,KWT,Kedah,0,0,0,Kuwait
33176,8/1/2021,KWT,Kelantan,0,0,0,Kuwait
33177,8/1/2021,KWT,Perak,0,0,0,Kuwait
33178,8/1/2021,KWT,Perlis,0,0,0,Kuwait
33179,8/1/2021,KWT,Pulau Pinang,0,0,0,Kuwait
33180,8/1/2021,KWT,Sabah,0,0,0,Kuwait
33181,8/1/2021,KWT,Sarawak,0,0,0,Kuwait
33182,8/1/2021,KWT,Selangor,10,8,2,Kuwait
33183,8/1/2021,KWT,W.P. Labuan,0,0,0,Kuwait
33184,8/1/2021,LAO,Johor,0,0,0,Lao People's Democratic Republic
33185,8/1/2021,LAO,Kedah,0,0,0,Lao People's Democratic Republic
33186,8/1/2021,LAO,Kelantan,0,0,0,Lao People's Democratic Republic
33187,8/1/2021,LAO,Melaka,0,0,0,Lao People's Democratic Republic
33188,8/1/2021,LAO,Perak,0,0,0,Lao People's Democratic Republic
33189,8/1/2021,LAO,Perlis,0,0,0,Lao People's Democratic Republic
33190,8/1/2021,LAO,Pulau Pinang,0,0,0,Lao People's Democratic Republic
33191,8/1/2021,LAO,Sabah,0,0,0,Lao People's Democratic Republic
33192,8/1/2021,LAO,Sarawak,0,0,0,Lao People's Democratic Republic
33193,8/1/2021,LAO,Selangor,202,202,0,Lao People's Democratic Republic
33194,8/1/2021,LAO,W.P. Labuan,0,0,0,Lao People's Democratic Republic
33195,8/1/2021,LBN,Johor,0,0,0,Lebanon
33196,8/1/2021,LBN,Kedah,0,0,0,Lebanon
33197,8/1/2021,LBN,Kelantan,0,0,0,Lebanon
33198,8/1/2021,LBN,Pahang,0,0,0,Lebanon
33199,8/1/2021,LBN,Perak,0,0,0,Lebanon
33200,8/1/2021,LBN,Perlis,0,0,0,Lebanon
33201,8/1/2021,LBN,Pulau Pinang,0,0,0,Lebanon
33202,8/1/2021,LBN,Sabah,0,0,0,Lebanon
33203,8/1/2021,LBN,Sarawak,0,0,0,Lebanon
33204,8/1/2021,LBN,Selangor,1,1,0,Lebanon
33205,8/1/2021,LBN,W.P. Labuan,0,0,0,Lebanon
33206,8/1/2021,LBR,Johor,0,0,0,Liberia
33207,8/1/2021,LBR,Kedah,0,0,0,Liberia
33208,8/1/2021,LBR,Sabah,0,0,0,Liberia
33209,8/1/2021,LBR,Sarawak,0,0,0,Liberia
33210,8/1/2021,LBR,Selangor,1,1,0,Liberia
33211,8/1/2021,LBY,Johor,0,0,0,Libyan Arab Jamahiriya
33212,8/1/2021,LBY,Kedah,0,0,0,Libyan Arab Jamahiriya
33213,8/1/2021,LBY,Perlis,0,0,0,Libyan Arab Jamahiriya
33214,8/1/2021,LBY,Pulau Pinang,0,0,0,Libyan Arab Jamahiriya
33215,8/1/2021,LBY,Sabah,0,0,0,Libyan Arab Jamahiriya
33216,8/1/2021,LBY,Sarawak,0,0,0,Libyan Arab Jamahiriya
33217,8/1/2021,LBY,Selangor,28,23,5,Libyan Arab Jamahiriya
33218,8/1/2021,LCA,Johor,0,0,0,Saint Lucia
33219,8/1/2021,LCA,Kedah,0,0,0,Saint Lucia
33220,8/1/2021,LCA,Pulau Pinang,0,0,0,Saint Lucia
33221,8/1/2021,LCA,Sarawak,0,0,0,Saint Lucia
33222,8/1/2021,LCA,Selangor,0,0,0,Saint Lucia
33223,8/1/2021,LIE,Johor,0,0,0,Liechtenstein
33224,8/1/2021,LIE,Kedah,0,0,0,Liechtenstein
33225,8/1/2021,LIE,Perlis,0,0,0,Liechtenstein
33226,8/1/2021,LIE,Pulau Pinang,0,0,0,Liechtenstein
33227,8/1/2021,LIE,Sabah,0,0,0,Liechtenstein
33228,8/1/2021,LIE,Sarawak,0,0,0,Liechtenstein
33229,8/1/2021,LIE,Selangor,0,0,0,Liechtenstein
33230,8/1/2021,LKA,Johor,0,0,0,Sri Lanka
33231,8/1/2021,LKA,Kedah,0,0,0,Sri Lanka
33232,8/1/2021,LKA,Kelantan,0,0,0,Sri Lanka
33233,8/1/2021,LKA,Melaka,0,0,0,Sri Lanka
33234,8/1/2021,LKA,Pahang,0,0,0,Sri Lanka
33235,8/1/2021,LKA,Perak,0,0,0,Sri Lanka
33236,8/1/2021,LKA,Perlis,0,0,0,Sri Lanka
33237,8/1/2021,LKA,Pulau Pinang,0,0,0,Sri Lanka
33238,8/1/2021,LKA,Sabah,0,0,0,Sri Lanka
33239,8/1/2021,LKA,Sarawak,0,0,0,Sri Lanka
33240,8/1/2021,LKA,Selangor,5,4,1,Sri Lanka
33241,8/1/2021,LKA,W.P. Labuan,0,0,0,Sri Lanka
33242,8/1/2021,LSO,Johor,0,0,0,Lesotho
33243,8/1/2021,LSO,Kedah,0,0,0,Lesotho
33244,8/1/2021,LSO,Pulau Pinang,0,0,0,Lesotho
33245,8/1/2021,LSO,Sarawak,0,0,0,Lesotho
33246,8/1/2021,LSO,Selangor,0,0,0,Lesotho
33247,8/1/2021,LTU,Johor,0,0,0,Lithuania
33248,8/1/2021,LTU,Kedah,0,0,0,Lithuania
33249,8/1/2021,LTU,Kelantan,0,0,0,Lithuania
33250,8/1/2021,LTU,Pahang,0,0,0,Lithuania
33251,8/1/2021,LTU,Perak,0,0,0,Lithuania
33252,8/1/2021,LTU,Perlis,0,0,0,Lithuania
33253,8/1/2021,LTU,Pulau Pinang,0,0,0,Lithuania
33254,8/1/2021,LTU,Sabah,0,0,0,Lithuania
33255,8/1/2021,LTU,Sarawak,0,0,0,Lithuania
33256,8/1/2021,LTU,Selangor,5,5,0,Lithuania
33257,8/1/2021,LTU,W.P. Labuan,0,0,0,Lithuania
33258,8/1/2021,LUX,Johor,0,0,0,Luxembourg
33259,8/1/2021,LUX,Kedah,0,0,0,Luxembourg
33260,8/1/2021,LUX,Kelantan,0,0,0,Luxembourg
33261,8/1/2021,LUX,Perak,0,0,0,Luxembourg
33262,8/1/2021,LUX,Perlis,0,0,0,Luxembourg
33263,8/1/2021,LUX,Pulau Pinang,0,0,0,Luxembourg
33264,8/1/2021,LUX,Sabah,0,0,0,Luxembourg
33265,8/1/2021,LUX,Sarawak,0,0,0,Luxembourg
33266,8/1/2021,LUX,Selangor,0,0,0,Luxembourg
33267,8/1/2021,LVA,Johor,0,0,0,Latvia
33268,8/1/2021,LVA,Kedah,0,0,0,Latvia
33269,8/1/2021,LVA,Kelantan,0,0,0,Latvia
33270,8/1/2021,LVA,Pahang,0,0,0,Latvia
33271,8/1/2021,LVA,Perak,0,0,0,Latvia
33272,8/1/2021,LVA,Perlis,0,0,0,Latvia
33273,8/1/2021,LVA,Pulau Pinang,0,0,0,Latvia
33274,8/1/2021,LVA,Sabah,0,0,0,Latvia
33275,8/1/2021,LVA,Sarawak,0,0,0,Latvia
33276,8/1/2021,LVA,Selangor,6,5,1,Latvia
33277,8/1/2021,LVA,W.P. Labuan,0,0,0,Latvia
33278,8/1/2021,MAC,Johor,0,0,0,Macao
33279,8/1/2021,MAC,Pahang,0,0,0,Macao
33280,8/1/2021,MAC,Perak,0,0,0,Macao
33281,8/1/2021,MAC,Selangor,0,0,0,Macao
33282,8/1/2021,MAC,W.P. Labuan,0,0,0,Macao
33283,8/1/2021,MAR,Johor,0,0,0,Morocco
33284,8/1/2021,MAR,Kedah,0,0,0,Morocco
33285,8/1/2021,MAR,Kelantan,0,0,0,Morocco
33286,8/1/2021,MAR,Melaka,0,0,0,Morocco
33287,8/1/2021,MAR,Pahang,0,0,0,Morocco
33288,8/1/2021,MAR,Perak,0,0,0,Morocco
33289,8/1/2021,MAR,Perlis,0,0,0,Morocco
33290,8/1/2021,MAR,Pulau Pinang,0,0,0,Morocco
33291,8/1/2021,MAR,Sabah,0,0,0,Morocco
33292,8/1/2021,MAR,Sarawak,0,0,0,Morocco
33293,8/1/2021,MAR,Selangor,10,5,5,Morocco
33294,8/1/2021,MAR,W.P. Labuan,0,0,0,Morocco
33295,8/1/2021,MCO,Johor,0,0,0,Monaco
33296,8/1/2021,MCO,Kedah,0,0,0,Monaco
33297,8/1/2021,MCO,Sabah,0,0,0,Monaco
33298,8/1/2021,MCO,Selangor,3,0,3,Monaco
33299,8/1/2021,MDA,Johor,0,0,0,"Moldova, Republic of"
33300,8/1/2021,MDA,Kedah,0,0,0,"Moldova, Republic of"
33301,8/1/2021,MDA,Kelantan,0,0,0,"Moldova, Republic of"
33302,8/1/2021,MDA,Negeri Sembilan,0,0,0,"Moldova, Republic of"
33303,8/1/2021,MDA,Perlis,0,0,0,"Moldova, Republic of"
33304,8/1/2021,MDA,Pulau Pinang,0,0,0,"Moldova, Republic of"
33305,8/1/2021,MDA,Sabah,0,0,0,"Moldova, Republic of"
33306,8/1/2021,MDA,Sarawak,0,0,0,"Moldova, Republic of"
33307,8/1/2021,MDA,Selangor,0,0,0,"Moldova, Republic of"
33308,8/1/2021,MDG,Johor,0,0,0,Madagascar
33309,8/1/2021,MDG,Kedah,0,0,0,Madagascar
33310,8/1/2021,MDG,Perak,0,0,0,Madagascar
33311,8/1/2021,MDG,Perlis,0,0,0,Madagascar
33312,8/1/2021,MDG,Pulau Pinang,0,0,0,Madagascar
33313,8/1/2021,MDG,Sabah,0,0,0,Madagascar
33314,8/1/2021,MDG,Sarawak,0,0,0,Madagascar
33315,8/1/2021,MDG,Selangor,1,1,0,Madagascar
33316,8/1/2021,MDV,Johor,0,0,0,Maldives
33317,8/1/2021,MDV,Kedah,0,0,0,Maldives
33318,8/1/2021,MDV,Kelantan,0,0,0,Maldives
33319,8/1/2021,MDV,Perak,0,0,0,Maldives
33320,8/1/2021,MDV,Perlis,0,0,0,Maldives
33321,8/1/2021,MDV,Pulau Pinang,1,1,0,Maldives
33322,8/1/2021,MDV,Sabah,0,0,0,Maldives
33323,8/1/2021,MDV,Sarawak,0,0,0,Maldives
33324,8/1/2021,MDV,Selangor,56,29,27,Maldives
33325,8/1/2021,MEX,Johor,0,0,0,Mexico
33326,8/1/2021,MEX,Kedah,0,0,0,Mexico
33327,8/1/2021,MEX,Kelantan,0,0,0,Mexico
33328,8/1/2021,MEX,Pahang,0,0,0,Mexico
33329,8/1/2021,MEX,Perak,0,0,0,Mexico
33330,8/1/2021,MEX,Perlis,0,0,0,Mexico
33331,8/1/2021,MEX,Pulau Pinang,0,0,0,Mexico
33332,8/1/2021,MEX,Sabah,0,0,0,Mexico
33333,8/1/2021,MEX,Sarawak,0,0,0,Mexico
33334,8/1/2021,MEX,Selangor,14,10,4,Mexico
33335,8/1/2021,MEX,W.P. Labuan,0,0,0,Mexico
33336,8/1/2021,MHL,Johor,0,0,0,Marshall Islands
33337,8/1/2021,MHL,Kedah,0,0,0,Marshall Islands
33338,8/1/2021,MHL,Perak,0,0,0,Marshall Islands
33339,8/1/2021,MHL,Pulau Pinang,0,0,0,Marshall Islands
33340,8/1/2021,MHL,Sabah,0,0,0,Marshall Islands
33341,8/1/2021,MHL,Selangor,0,0,0,Marshall Islands
33342,8/1/2021,MKD,Johor,0,0,0,"Macedonia, the former Yugoslav Republic of"
33343,8/1/2021,MKD,Kedah,0,0,0,"Macedonia, the former Yugoslav Republic of"
33344,8/1/2021,MKD,Perak,0,0,0,"Macedonia, the former Yugoslav Republic of"
33345,8/1/2021,MKD,Pulau Pinang,0,0,0,"Macedonia, the former Yugoslav Republic of"
33346,8/1/2021,MKD,Sabah,0,0,0,"Macedonia, the former Yugoslav Republic of"
33347,8/1/2021,MKD,Sarawak,0,0,0,"Macedonia, the former Yugoslav Republic of"
33348,8/1/2021,MKD,Selangor,1,0,1,"Macedonia, the former Yugoslav Republic of"
33349,8/1/2021,MLI,Johor,0,0,0,Mali
33350,8/1/2021,MLI,Sabah,0,0,0,Mali
33351,8/1/2021,MLI,Selangor,0,0,0,Mali
33352,8/1/2021,MLT,Johor,0,0,0,Malta
33353,8/1/2021,MLT,Kedah,0,0,0,Malta
33354,8/1/2021,MLT,Kelantan,0,0,0,Malta
33355,8/1/2021,MLT,Perak,0,0,0,Malta
33356,8/1/2021,MLT,Perlis,0,0,0,Malta
33357,8/1/2021,MLT,Pulau Pinang,0,0,0,Malta
33358,8/1/2021,MLT,Sabah,0,0,0,Malta
33359,8/1/2021,MLT,Sarawak,0,0,0,Malta
33360,8/1/2021,MLT,Selangor,0,0,0,Malta
33361,8/1/2021,MLT,W.P. Labuan,0,0,0,Malta
33362,8/1/2021,MMR,Johor,0,0,0,Myanmar
33363,8/1/2021,MMR,Kedah,0,0,0,Myanmar
33364,8/1/2021,MMR,Kelantan,0,0,0,Myanmar
33365,8/1/2021,MMR,Negeri Sembilan,0,0,0,Myanmar
33366,8/1/2021,MMR,Pahang,0,0,0,Myanmar
33367,8/1/2021,MMR,Perak,0,0,0,Myanmar
33368,8/1/2021,MMR,Perlis,0,0,0,Myanmar
33369,8/1/2021,MMR,Pulau Pinang,0,0,0,Myanmar
33370,8/1/2021,MMR,Sabah,0,0,0,Myanmar
33371,8/1/2021,MMR,Sarawak,0,0,0,Myanmar
33372,8/1/2021,MMR,Selangor,59,55,4,Myanmar
33373,8/1/2021,MMR,Terengganu,0,0,0,Myanmar
33374,8/1/2021,MMR,W.P. Labuan,0,0,0,Myanmar
33375,8/1/2021,MNE,Johor,0,0,0,Montenegro
33376,8/1/2021,MNE,Kedah,0,0,0,Montenegro
33377,8/1/2021,MNE,Pulau Pinang,0,0,0,Montenegro
33378,8/1/2021,MNE,Sabah,0,0,0,Montenegro
33379,8/1/2021,MNE,Sarawak,0,0,0,Montenegro
33380,8/1/2021,MNE,Selangor,5,5,0,Montenegro
33381,8/1/2021,MNG,Johor,0,0,0,Mongolia
33382,8/1/2021,MNG,Kedah,0,0,0,Mongolia
33383,8/1/2021,MNG,Kelantan,0,0,0,Mongolia
33384,8/1/2021,MNG,Perak,0,0,0,Mongolia
33385,8/1/2021,MNG,Perlis,0,0,0,Mongolia
33386,8/1/2021,MNG,Pulau Pinang,0,0,0,Mongolia
33387,8/1/2021,MNG,Sabah,0,0,0,Mongolia
33388,8/1/2021,MNG,Sarawak,0,0,0,Mongolia
33389,8/1/2021,MNG,Selangor,1,0,1,Mongolia
33390,8/1/2021,MNP,Selangor,0,0,0,Northern Mariana Islands
33391,8/1/2021,MOZ,Johor,0,0,0,Mozambique
33392,8/1/2021,MOZ,Kedah,0,0,0,Mozambique
33393,8/1/2021,MOZ,Perak,0,0,0,Mozambique
33394,8/1/2021,MOZ,Pulau Pinang,0,0,0,Mozambique
33395,8/1/2021,MOZ,Sabah,0,0,0,Mozambique
33396,8/1/2021,MOZ,Sarawak,0,0,0,Mozambique
33397,8/1/2021,MOZ,Selangor,8,6,2,Mozambique
33398,8/1/2021,MRT,Johor,0,0,0,Mauritania
33399,8/1/2021,MRT,Kedah,0,0,0,Mauritania
33400,8/1/2021,MRT,Pulau Pinang,0,0,0,Mauritania
33401,8/1/2021,MRT,Sabah,0,0,0,Mauritania
33402,8/1/2021,MRT,Sarawak,0,0,0,Mauritania
33403,8/1/2021,MRT,Selangor,0,0,0,Mauritania
33404,8/1/2021,MUS,Johor,0,0,0,Mauritius
33405,8/1/2021,MUS,Kedah,0,0,0,Mauritius
33406,8/1/2021,MUS,Kelantan,0,0,0,Mauritius
33407,8/1/2021,MUS,Pahang,0,0,0,Mauritius
33408,8/1/2021,MUS,Perak,0,0,0,Mauritius
33409,8/1/2021,MUS,Perlis,0,0,0,Mauritius
33410,8/1/2021,MUS,Pulau Pinang,0,0,0,Mauritius
33411,8/1/2021,MUS,Sabah,0,0,0,Mauritius
33412,8/1/2021,MUS,Sarawak,0,0,0,Mauritius
33413,8/1/2021,MUS,Selangor,6,1,5,Mauritius
33414,8/1/2021,MWI,Johor,0,0,0,Malawi
33415,8/1/2021,MWI,Pulau Pinang,0,0,0,Malawi
33416,8/1/2021,MWI,Sabah,0,0,0,Malawi
33417,8/1/2021,MWI,Sarawak,0,0,0,Malawi
33418,8/1/2021,MWI,Selangor,4,3,1,Malawi
33419,8/1/2021,MYT,Selangor,0,0,0,Mayotte
33420,8/1/2021,NAM,Johor,0,0,0,Namibia
33421,8/1/2021,NAM,Kedah,0,0,0,Namibia
33422,8/1/2021,NAM,Perak,0,0,0,Namibia
33423,8/1/2021,NAM,Perlis,0,0,0,Namibia
33424,8/1/2021,NAM,Pulau Pinang,0,0,0,Namibia
33425,8/1/2021,NAM,Sabah,0,0,0,Namibia
33426,8/1/2021,NAM,Sarawak,0,0,0,Namibia
33427,8/1/2021,NAM,Selangor,0,0,0,Namibia
33428,8/1/2021,NCL,Selangor,0,0,0,New Caledonia
33429,8/1/2021,NER,Johor,0,0,0,Niger
33430,8/1/2021,NER,Sabah,0,0,0,Niger
33431,8/1/2021,NER,Selangor,0,0,0,Niger
33432,8/1/2021,NGA,Johor,0,0,0,Nigeria
33433,8/1/2021,NGA,Kedah,0,0,0,Nigeria
33434,8/1/2021,NGA,Perlis,0,0,0,Nigeria
33435,8/1/2021,NGA,Pulau Pinang,0,0,0,Nigeria
33436,8/1/2021,NGA,Sabah,0,0,0,Nigeria
33437,8/1/2021,NGA,Sarawak,1,1,0,Nigeria
33438,8/1/2021,NGA,Selangor,88,80,8,Nigeria
33439,8/1/2021,NIC,Johor,0,0,0,Nicaragua
33440,8/1/2021,NIC,Kedah,0,0,0,Nicaragua
33441,8/1/2021,NIC,Pulau Pinang,0,0,0,Nicaragua
33442,8/1/2021,NIC,Sabah,0,0,0,Nicaragua
33443,8/1/2021,NIC,Selangor,0,0,0,Nicaragua
33444,8/1/2021,NLD,Johor,0,0,0,Netherlands
33445,8/1/2021,NLD,Kedah,0,0,0,Netherlands
33446,8/1/2021,NLD,Kelantan,0,0,0,Netherlands
33447,8/1/2021,NLD,Melaka,0,0,0,Netherlands
33448,8/1/2021,NLD,Negeri Sembilan,0,0,0,Netherlands
33449,8/1/2021,NLD,Pahang,0,0,0,Netherlands
33450,8/1/2021,NLD,Perak,0,0,0,Netherlands
33451,8/1/2021,NLD,Perlis,0,0,0,Netherlands
33452,8/1/2021,NLD,Pulau Pinang,0,0,0,Netherlands
33453,8/1/2021,NLD,Sabah,0,0,0,Netherlands
33454,8/1/2021,NLD,Sarawak,0,0,0,Netherlands
33455,8/1/2021,NLD,Selangor,91,61,30,Netherlands
33456,8/1/2021,NLD,Terengganu,0,0,0,Netherlands
33457,8/1/2021,NLD,W.P. Labuan,0,0,0,Netherlands
33458,8/1/2021,NOR,Johor,0,0,0,Norway
33459,8/1/2021,NOR,Kedah,0,0,0,Norway
33460,8/1/2021,NOR,Kelantan,0,0,0,Norway
33461,8/1/2021,NOR,Melaka,0,0,0,Norway
33462,8/1/2021,NOR,Pahang,0,0,0,Norway
33463,8/1/2021,NOR,Perak,0,0,0,Norway
33464,8/1/2021,NOR,Perlis,0,0,0,Norway
33465,8/1/2021,NOR,Pulau Pinang,0,0,0,Norway
33466,8/1/2021,NOR,Sabah,0,0,0,Norway
33467,8/1/2021,NOR,Sarawak,1,1,0,Norway
33468,8/1/2021,NOR,Selangor,23,19,4,Norway
33469,8/1/2021,NOR,W.P. Labuan,0,0,0,Norway
33470,8/1/2021,NPL,Johor,0,0,0,Nepal
33471,8/1/2021,NPL,Kedah,0,0,0,Nepal
33472,8/1/2021,NPL,Pahang,0,0,0,Nepal
33473,8/1/2021,NPL,Perak,0,0,0,Nepal
33474,8/1/2021,NPL,Perlis,0,0,0,Nepal
33475,8/1/2021,NPL,Pulau Pinang,0,0,0,Nepal
33476,8/1/2021,NPL,Sabah,0,0,0,Nepal
33477,8/1/2021,NPL,Sarawak,0,0,0,Nepal
33478,8/1/2021,NPL,Selangor,0,0,0,Nepal
33479,8/1/2021,NPL,W.P. Labuan,0,0,0,Nepal
33480,8/1/2021,NRU,Johor,0,0,0,Nauru
33481,8/1/2021,NRU,Pulau Pinang,0,0,0,Nauru
33482,8/1/2021,NRU,Selangor,0,0,0,Nauru
33483,8/1/2021,NZL,Johor,0,0,0,New Zealand
33484,8/1/2021,NZL,Kedah,0,0,0,New Zealand
33485,8/1/2021,NZL,Kelantan,0,0,0,New Zealand
33486,8/1/2021,NZL,Melaka,0,0,0,New Zealand
33487,8/1/2021,NZL,Negeri Sembilan,0,0,0,New Zealand
33488,8/1/2021,NZL,Pahang,0,0,0,New Zealand
33489,8/1/2021,NZL,Perak,0,0,0,New Zealand
33490,8/1/2021,NZL,Perlis,0,0,0,New Zealand
33491,8/1/2021,NZL,Pulau Pinang,0,0,0,New Zealand
33492,8/1/2021,NZL,Sabah,0,0,0,New Zealand
33493,8/1/2021,NZL,Sarawak,0,0,0,New Zealand
33494,8/1/2021,NZL,Selangor,21,10,11,New Zealand
33495,8/1/2021,NZL,Terengganu,0,0,0,New Zealand
33496,8/1/2021,NZL,W.P. Labuan,0,0,0,New Zealand
33497,8/1/2021,OMN,Johor,0,0,0,Oman
33498,8/1/2021,OMN,Kedah,0,0,0,Oman
33499,8/1/2021,OMN,Kelantan,0,0,0,Oman
33500,8/1/2021,OMN,Melaka,0,0,0,Oman
33501,8/1/2021,OMN,Perak,0,0,0,Oman
33502,8/1/2021,OMN,Perlis,0,0,0,Oman
33503,8/1/2021,OMN,Pulau Pinang,0,0,0,Oman
33504,8/1/2021,OMN,Sabah,0,0,0,Oman
33505,8/1/2021,OMN,Sarawak,0,0,0,Oman
33506,8/1/2021,OMN,Selangor,18,15,3,Oman
33507,8/1/2021,PAK,Johor,2,2,0,Pakistan
33508,8/1/2021,PAK,Kedah,0,0,0,Pakistan
33509,8/1/2021,PAK,Kelantan,0,0,0,Pakistan
33510,8/1/2021,PAK,Melaka,0,0,0,Pakistan
33511,8/1/2021,PAK,Negeri Sembilan,0,0,0,Pakistan
33512,8/1/2021,PAK,Pahang,0,0,0,Pakistan
33513,8/1/2021,PAK,Perak,0,0,0,Pakistan
33514,8/1/2021,PAK,Perlis,0,0,0,Pakistan
33515,8/1/2021,PAK,Pulau Pinang,0,0,0,Pakistan
33516,8/1/2021,PAK,Sabah,0,0,0,Pakistan
33517,8/1/2021,PAK,Sarawak,0,0,0,Pakistan
33518,8/1/2021,PAK,Selangor,29,22,7,Pakistan
33519,8/1/2021,PAK,W.P. Labuan,0,0,0,Pakistan
33520,8/1/2021,PAN,Johor,0,0,0,Panama
33521,8/1/2021,PAN,Kedah,0,0,0,Panama
33522,8/1/2021,PAN,Perak,0,0,0,Panama
33523,8/1/2021,PAN,Perlis,0,0,0,Panama
33524,8/1/2021,PAN,Pulau Pinang,0,0,0,Panama
33525,8/1/2021,PAN,Sabah,0,0,0,Panama
33526,8/1/2021,PAN,Sarawak,0,0,0,Panama
33527,8/1/2021,PAN,Selangor,2,1,1,Panama
33528,8/1/2021,PER,Johor,0,0,0,Peru
33529,8/1/2021,PER,Kedah,0,0,0,Peru
33530,8/1/2021,PER,Kelantan,0,0,0,Peru
33531,8/1/2021,PER,Pahang,0,0,0,Peru
33532,8/1/2021,PER,Perak,0,0,0,Peru
33533,8/1/2021,PER,Perlis,0,0,0,Peru
33534,8/1/2021,PER,Pulau Pinang,0,0,0,Peru
33535,8/1/2021,PER,Sabah,0,0,0,Peru
33536,8/1/2021,PER,Sarawak,0,0,0,Peru
33537,8/1/2021,PER,Selangor,4,2,2,Peru
33538,8/1/2021,PER,W.P. Labuan,0,0,0,Peru
33539,8/1/2021,PHL,Johor,2,1,1,Philippines
33540,8/1/2021,PHL,Kedah,0,0,0,Philippines
33541,8/1/2021,PHL,Kelantan,0,0,0,Philippines
33542,8/1/2021,PHL,Melaka,0,0,0,Philippines
33543,8/1/2021,PHL,Negeri Sembilan,0,0,0,Philippines
33544,8/1/2021,PHL,Pahang,0,0,0,Philippines
33545,8/1/2021,PHL,Perak,0,0,0,Philippines
33546,8/1/2021,PHL,Perlis,0,0,0,Philippines
33547,8/1/2021,PHL,Pulau Pinang,6,2,4,Philippines
33548,8/1/2021,PHL,Sabah,1,1,0,Philippines
33549,8/1/2021,PHL,Sarawak,40,37,3,Philippines
33550,8/1/2021,PHL,Selangor,361,290,71,Philippines
33551,8/1/2021,PHL,Terengganu,0,0,0,Philippines
33552,8/1/2021,PHL,W.P. Labuan,7,7,0,Philippines
33553,8/1/2021,PLW,Johor,0,0,0,Palau
33554,8/1/2021,PLW,Pulau Pinang,0,0,0,Palau
33555,8/1/2021,PLW,Selangor,0,0,0,Palau
33556,8/1/2021,PNG,Johor,0,0,0,Papua New Guinea
33557,8/1/2021,PNG,Kedah,0,0,0,Papua New Guinea
33558,8/1/2021,PNG,Kelantan,0,0,0,Papua New Guinea
33559,8/1/2021,PNG,Perak,0,0,0,Papua New Guinea
33560,8/1/2021,PNG,Pulau Pinang,0,0,0,Papua New Guinea
33561,8/1/2021,PNG,Sabah,0,0,0,Papua New Guinea
33562,8/1/2021,PNG,Sarawak,0,0,0,Papua New Guinea
33563,8/1/2021,PNG,Selangor,0,0,0,Papua New Guinea
33564,8/1/2021,POL,Johor,0,0,0,Poland
33565,8/1/2021,POL,Kedah,0,0,0,Poland
33566,8/1/2021,POL,Kelantan,0,0,0,Poland
33567,8/1/2021,POL,Melaka,0,0,0,Poland
33568,8/1/2021,POL,Negeri Sembilan,0,0,0,Poland
33569,8/1/2021,POL,Pahang,0,0,0,Poland
33570,8/1/2021,POL,Perak,0,0,0,Poland
33571,8/1/2021,POL,Perlis,0,0,0,Poland
33572,8/1/2021,POL,Pulau Pinang,0,0,0,Poland
33573,8/1/2021,POL,Sabah,0,0,0,Poland
33574,8/1/2021,POL,Sarawak,0,0,0,Poland
33575,8/1/2021,POL,Selangor,37,32,5,Poland
33576,8/1/2021,POL,Terengganu,0,0,0,Poland
33577,8/1/2021,POL,W.P. Labuan,0,0,0,Poland
33578,8/1/2021,PRK,Selangor,0,0,0,"Korea, Democratic People's Republic of"
33579,8/1/2021,PRT,Johor,0,0,0,Portugal
33580,8/1/2021,PRT,Kedah,0,0,0,Portugal
33581,8/1/2021,PRT,Kelantan,0,0,0,Portugal
33582,8/1/2021,PRT,Melaka,0,0,0,Portugal
33583,8/1/2021,PRT,Pahang,0,0,0,Portugal
33584,8/1/2021,PRT,Perak,0,0,0,Portugal
33585,8/1/2021,PRT,Perlis,0,0,0,Portugal
33586,8/1/2021,PRT,Pulau Pinang,0,0,0,Portugal
33587,8/1/2021,PRT,Sabah,0,0,0,Portugal
33588,8/1/2021,PRT,Sarawak,0,0,0,Portugal
33589,8/1/2021,PRT,Selangor,18,5,13,Portugal
33590,8/1/2021,PRT,W.P. Labuan,0,0,0,Portugal
33591,8/1/2021,PRY,Johor,0,0,0,Paraguay
33592,8/1/2021,PRY,Kedah,0,0,0,Paraguay
33593,8/1/2021,PRY,Perak,0,0,0,Paraguay
33594,8/1/2021,PRY,Perlis,0,0,0,Paraguay
33595,8/1/2021,PRY,Pulau Pinang,0,0,0,Paraguay
33596,8/1/2021,PRY,Sabah,0,0,0,Paraguay
33597,8/1/2021,PRY,Sarawak,0,0,0,Paraguay
33598,8/1/2021,PRY,Selangor,0,0,0,Paraguay
33599,8/1/2021,PSE,Johor,0,0,0,"Palestinian Territory, Occupied"
33600,8/1/2021,PSE,Kedah,0,0,0,"Palestinian Territory, Occupied"
33601,8/1/2021,PSE,Kelantan,0,0,0,"Palestinian Territory, Occupied"
33602,8/1/2021,PSE,Melaka,0,0,0,"Palestinian Territory, Occupied"
33603,8/1/2021,PSE,Perak,0,0,0,"Palestinian Territory, Occupied"
33604,8/1/2021,PSE,Perlis,0,0,0,"Palestinian Territory, Occupied"
33605,8/1/2021,PSE,Pulau Pinang,0,0,0,"Palestinian Territory, Occupied"
33606,8/1/2021,PSE,Sabah,0,0,0,"Palestinian Territory, Occupied"
33607,8/1/2021,PSE,Sarawak,0,0,0,"Palestinian Territory, Occupied"
33608,8/1/2021,PSE,Selangor,14,9,5,"Palestinian Territory, Occupied"
33609,8/1/2021,QAT,Johor,0,0,0,Qatar
33610,8/1/2021,QAT,Kedah,0,0,0,Qatar
33611,8/1/2021,QAT,Perlis,0,0,0,Qatar
33612,8/1/2021,QAT,Pulau Pinang,0,0,0,Qatar
33613,8/1/2021,QAT,Sabah,0,0,0,Qatar
33614,8/1/2021,QAT,Sarawak,0,0,0,Qatar
33615,8/1/2021,QAT,Selangor,19,12,7,Qatar
33616,8/1/2021,REU,Johor,0,0,0,Reunion
33617,8/1/2021,REU,Sarawak,0,0,0,Reunion
33618,8/1/2021,ROU,Johor,0,0,0,Romania
33619,8/1/2021,ROU,Kedah,0,0,0,Romania
33620,8/1/2021,ROU,Kelantan,0,0,0,Romania
33621,8/1/2021,ROU,Negeri Sembilan,0,0,0,Romania
33622,8/1/2021,ROU,Pahang,0,0,0,Romania
33623,8/1/2021,ROU,Perak,0,0,0,Romania
33624,8/1/2021,ROU,Perlis,0,0,0,Romania
33625,8/1/2021,ROU,Pulau Pinang,0,0,0,Romania
33626,8/1/2021,ROU,Sabah,0,0,0,Romania
33627,8/1/2021,ROU,Sarawak,1,1,0,Romania
33628,8/1/2021,ROU,Selangor,25,19,6,Romania
33629,8/1/2021,ROU,W.P. Labuan,0,0,0,Romania
33630,8/1/2021,RUS,Johor,6,6,0,Russia
33631,8/1/2021,RUS,Kedah,0,0,0,Russia
33632,8/1/2021,RUS,Kelantan,0,0,0,Russia
33633,8/1/2021,RUS,Melaka,0,0,0,Russia
33634,8/1/2021,RUS,Negeri Sembilan,0,0,0,Russia
33635,8/1/2021,RUS,Pahang,0,0,0,Russia
33636,8/1/2021,RUS,Perak,0,0,0,Russia
33637,8/1/2021,RUS,Perlis,0,0,0,Russia
33638,8/1/2021,RUS,Pulau Pinang,0,0,0,Russia
33639,8/1/2021,RUS,Sabah,0,0,0,Russia
33640,8/1/2021,RUS,Sarawak,0,0,0,Russia
33641,8/1/2021,RUS,Selangor,85,63,22,Russia
33642,8/1/2021,RUS,W.P. Labuan,0,0,0,Russia
33643,8/1/2021,RWA,Johor,0,0,0,Rwanda
33644,8/1/2021,RWA,Kedah,0,0,0,Rwanda
33645,8/1/2021,RWA,Pulau Pinang,0,0,0,Rwanda
33646,8/1/2021,RWA,Selangor,2,1,1,Rwanda
33647,8/1/2021,SAU,Johor,0,0,0,Saudi Arabia
33648,8/1/2021,SAU,Kedah,0,0,0,Saudi Arabia
33649,8/1/2021,SAU,Kelantan,0,0,0,Saudi Arabia
33650,8/1/2021,SAU,Melaka,0,0,0,Saudi Arabia
33651,8/1/2021,SAU,Perak,0,0,0,Saudi Arabia
33652,8/1/2021,SAU,Perlis,0,0,0,Saudi Arabia
33653,8/1/2021,SAU,Pulau Pinang,0,0,0,Saudi Arabia
33654,8/1/2021,SAU,Sabah,0,0,0,Saudi Arabia
33655,8/1/2021,SAU,Sarawak,0,0,0,Saudi Arabia
33656,8/1/2021,SAU,Selangor,123,75,48,Saudi Arabia
33657,8/1/2021,SAU,W.P. Labuan,0,0,0,Saudi Arabia
33658,8/1/2021,SDN,Johor,0,0,0,Sudan
33659,8/1/2021,SDN,Kedah,0,0,0,Sudan
33660,8/1/2021,SDN,Kelantan,0,0,0,Sudan
33661,8/1/2021,SDN,Perlis,0,0,0,Sudan
33662,8/1/2021,SDN,Pulau Pinang,0,0,0,Sudan
33663,8/1/2021,SDN,Sabah,0,0,0,Sudan
33664,8/1/2021,SDN,Sarawak,0,0,0,Sudan
33665,8/1/2021,SDN,Selangor,33,22,11,Sudan
33666,8/1/2021,SDN,W.P. Labuan,0,0,0,Sudan
33667,8/1/2021,SEN,Johor,0,0,0,Senegal
33668,8/1/2021,SEN,Kedah,0,0,0,Senegal
33669,8/1/2021,SEN,Kelantan,0,0,0,Senegal
33670,8/1/2021,SEN,Perak,0,0,0,Senegal
33671,8/1/2021,SEN,Perlis,0,0,0,Senegal
33672,8/1/2021,SEN,Pulau Pinang,0,0,0,Senegal
33673,8/1/2021,SEN,Sabah,0,0,0,Senegal
33674,8/1/2021,SEN,Sarawak,0,0,0,Senegal
33675,8/1/2021,SEN,Selangor,15,11,4,Senegal
33676,8/1/2021,SGP,Johor,81,63,18,Singapore
33677,8/1/2021,SGP,Kedah,3,3,0,Singapore
33678,8/1/2021,SGP,Kelantan,0,0,0,Singapore
33679,8/1/2021,SGP,Melaka,0,0,0,Singapore
33680,8/1/2021,SGP,Negeri Sembilan,0,0,0,Singapore
33681,8/1/2021,SGP,Pahang,0,0,0,Singapore
33682,8/1/2021,SGP,Perak,1,0,1,Singapore
33683,8/1/2021,SGP,Perlis,0,0,0,Singapore
33684,8/1/2021,SGP,Pulau Pinang,12,6,6,Singapore
33685,8/1/2021,SGP,Sabah,0,0,0,Singapore
33686,8/1/2021,SGP,Sarawak,4,4,0,Singapore
33687,8/1/2021,SGP,Selangor,107,75,32,Singapore
33688,8/1/2021,SGP,Terengganu,0,0,0,Singapore
33689,8/1/2021,SGP,W.P. Labuan,0,0,0,Singapore
33690,8/1/2021,SGS,Johor,0,0,0,South Georgia and the South Sandwich Islands
33691,8/1/2021,SGS,Sabah,0,0,0,South Georgia and the South Sandwich Islands
33692,8/1/2021,SGS,Selangor,0,0,0,South Georgia and the South Sandwich Islands
33693,8/1/2021,SHN,Sarawak,0,0,0,"Saint Helena, Ascension and Tristan da Cunha"
33694,8/1/2021,SLB,Johor,0,0,0,Solomon Islands
33695,8/1/2021,SLB,Perlis,0,0,0,Solomon Islands
33696,8/1/2021,SLB,Pulau Pinang,0,0,0,Solomon Islands
33697,8/1/2021,SLB,Sabah,0,0,0,Solomon Islands
33698,8/1/2021,SLB,Sarawak,0,0,0,Solomon Islands
33699,8/1/2021,SLB,Selangor,0,0,0,Solomon Islands
33700,8/1/2021,SLB,W.P. Labuan,0,0,0,Solomon Islands
33701,8/1/2021,SLE,Johor,0,0,0,Sierra Leone
33702,8/1/2021,SLE,Kedah,0,0,0,Sierra Leone
33703,8/1/2021,SLE,Perak,0,0,0,Sierra Leone
33704,8/1/2021,SLE,Pulau Pinang,0,0,0,Sierra Leone
33705,8/1/2021,SLE,Sabah,0,0,0,Sierra Leone
33706,8/1/2021,SLE,Selangor,0,0,0,Sierra Leone
33707,8/1/2021,SLV,Johor,0,0,0,El Salvador
33708,8/1/2021,SLV,Kedah,0,0,0,El Salvador
33709,8/1/2021,SLV,Perak,0,0,0,El Salvador
33710,8/1/2021,SLV,Perlis,0,0,0,El Salvador
33711,8/1/2021,SLV,Pulau Pinang,0,0,0,El Salvador
33712,8/1/2021,SLV,Sabah,0,0,0,El Salvador
33713,8/1/2021,SLV,Selangor,0,0,0,El Salvador
33714,8/1/2021,SLV,W.P. Labuan,0,0,0,El Salvador
33715,8/1/2021,SMR,Johor,0,0,0,San Marino
33716,8/1/2021,SMR,Selangor,0,0,0,San Marino
33717,8/1/2021,SOM,Johor,0,0,0,Somalia
33718,8/1/2021,SOM,Kedah,0,0,0,Somalia
33719,8/1/2021,SOM,Kelantan,0,0,0,Somalia
33720,8/1/2021,SOM,Perlis,0,0,0,Somalia
33721,8/1/2021,SOM,Sabah,0,0,0,Somalia
33722,8/1/2021,SOM,Sarawak,0,0,0,Somalia
33723,8/1/2021,SOM,Selangor,19,9,10,Somalia
33724,8/1/2021,SRB,Johor,0,0,0,Serbia
33725,8/1/2021,SRB,Kedah,0,0,0,Serbia
33726,8/1/2021,SRB,Kelantan,0,0,0,Serbia
33727,8/1/2021,SRB,Pahang,0,0,0,Serbia
33728,8/1/2021,SRB,Perak,0,0,0,Serbia
33729,8/1/2021,SRB,Perlis,0,0,0,Serbia
33730,8/1/2021,SRB,Pulau Pinang,0,0,0,Serbia
33731,8/1/2021,SRB,Sabah,0,0,0,Serbia
33732,8/1/2021,SRB,Sarawak,0,0,0,Serbia
33733,8/1/2021,SRB,Selangor,6,3,3,Serbia
33734,8/1/2021,STP,Selangor,0,0,0,Sao Tome and Principe
33735,8/1/2021,SUR,Johor,0,0,0,Suriname
33736,8/1/2021,SUR,Kedah,0,0,0,Suriname
33737,8/1/2021,SUR,Kelantan,0,0,0,Suriname
33738,8/1/2021,SUR,Perak,0,0,0,Suriname
33739,8/1/2021,SUR,Perlis,0,0,0,Suriname
33740,8/1/2021,SUR,Pulau Pinang,0,0,0,Suriname
33741,8/1/2021,SUR,Sabah,0,0,0,Suriname
33742,8/1/2021,SUR,Sarawak,0,0,0,Suriname
33743,8/1/2021,SUR,Selangor,0,0,0,Suriname
33744,8/1/2021,SVK,Johor,0,0,0,Slovakia
33745,8/1/2021,SVK,Kedah,0,0,0,Slovakia
33746,8/1/2021,SVK,Kelantan,0,0,0,Slovakia
33747,8/1/2021,SVK,Negeri Sembilan,0,0,0,Slovakia
33748,8/1/2021,SVK,Pahang,0,0,0,Slovakia
33749,8/1/2021,SVK,Perak,0,0,0,Slovakia
33750,8/1/2021,SVK,Perlis,0,0,0,Slovakia
33751,8/1/2021,SVK,Pulau Pinang,0,0,0,Slovakia
33752,8/1/2021,SVK,Sabah,0,0,0,Slovakia
33753,8/1/2021,SVK,Sarawak,0,0,0,Slovakia
33754,8/1/2021,SVK,Selangor,11,6,5,Slovakia
33755,8/1/2021,SVK,W.P. Labuan,0,0,0,Slovakia
33756,8/1/2021,SVN,Johor,0,0,0,Slovenia
33757,8/1/2021,SVN,Kedah,0,0,0,Slovenia
33758,8/1/2021,SVN,Kelantan,0,0,0,Slovenia
33759,8/1/2021,SVN,Perak,0,0,0,Slovenia
33760,8/1/2021,SVN,Perlis,0,0,0,Slovenia
33761,8/1/2021,SVN,Pulau Pinang,0,0,0,Slovenia
33762,8/1/2021,SVN,Sabah,0,0,0,Slovenia
33763,8/1/2021,SVN,Sarawak,0,0,0,Slovenia
33764,8/1/2021,SVN,Selangor,2,1,1,Slovenia
33765,8/1/2021,SVN,W.P. Labuan,0,0,0,Slovenia
33766,8/1/2021,SWE,Johor,0,0,0,Sweden
33767,8/1/2021,SWE,Kedah,0,0,0,Sweden
33768,8/1/2021,SWE,Kelantan,0,0,0,Sweden
33769,8/1/2021,SWE,Melaka,0,0,0,Sweden
33770,8/1/2021,SWE,Negeri Sembilan,0,0,0,Sweden
33771,8/1/2021,SWE,Pahang,0,0,0,Sweden
33772,8/1/2021,SWE,Perak,0,0,0,Sweden
33773,8/1/2021,SWE,Perlis,0,0,0,Sweden
33774,8/1/2021,SWE,Pulau Pinang,0,0,0,Sweden
33775,8/1/2021,SWE,Sabah,0,0,0,Sweden
33776,8/1/2021,SWE,Sarawak,0,0,0,Sweden
33777,8/1/2021,SWE,Selangor,35,26,9,Sweden
33778,8/1/2021,SWE,W.P. Labuan,0,0,0,Sweden
33779,8/1/2021,SWZ,Johor,0,0,0,Swaziland
33780,8/1/2021,SWZ,Kedah,0,0,0,Swaziland
33781,8/1/2021,SWZ,Pulau Pinang,0,0,0,Swaziland
33782,8/1/2021,SWZ,Sabah,0,0,0,Swaziland
33783,8/1/2021,SWZ,Selangor,0,0,0,Swaziland
33784,8/1/2021,SYC,Johor,0,0,0,Seychelles
33785,8/1/2021,SYC,Kedah,0,0,0,Seychelles
33786,8/1/2021,SYC,Pulau Pinang,0,0,0,Seychelles
33787,8/1/2021,SYC,Sabah,0,0,0,Seychelles
33788,8/1/2021,SYC,Sarawak,0,0,0,Seychelles
33789,8/1/2021,SYC,Selangor,4,3,1,Seychelles
33790,8/1/2021,SYR,Johor,0,0,0,Syrian Arab Republic
33791,8/1/2021,SYR,Kedah,0,0,0,Syrian Arab Republic
33792,8/1/2021,SYR,Kelantan,0,0,0,Syrian Arab Republic
33793,8/1/2021,SYR,Pahang,0,0,0,Syrian Arab Republic
33794,8/1/2021,SYR,Perlis,0,0,0,Syrian Arab Republic
33795,8/1/2021,SYR,Pulau Pinang,0,0,0,Syrian Arab Republic
33796,8/1/2021,SYR,Sabah,0,0,0,Syrian Arab Republic
33797,8/1/2021,SYR,Sarawak,0,0,0,Syrian Arab Republic
33798,8/1/2021,SYR,Selangor,22,15,7,Syrian Arab Republic
33799,8/1/2021,SYR,W.P. Labuan,0,0,0,Syrian Arab Republic
33800,8/1/2021,TCA,Perlis,0,0,0,Turks and Caicos
33801,8/1/2021,TCD,Johor,0,0,0,Chad
33802,8/1/2021,TCD,Kedah,0,0,0,Chad
33803,8/1/2021,TCD,Perlis,0,0,0,Chad
33804,8/1/2021,TCD,Selangor,2,1,1,Chad
33805,8/1/2021,TGO,Johor,0,0,0,Togo
33806,8/1/2021,TGO,Perak,0,0,0,Togo
33807,8/1/2021,TGO,Pulau Pinang,0,0,0,Togo
33808,8/1/2021,TGO,Selangor,0,0,0,Togo
33809,8/1/2021,THA,Johor,12,12,0,Thailand
33810,8/1/2021,THA,Kedah,16335,16295,40,Thailand
33811,8/1/2021,THA,Kelantan,0,0,0,Thailand
33812,8/1/2021,THA,Melaka,0,0,0,Thailand
33813,8/1/2021,THA,Negeri Sembilan,0,0,0,Thailand
33814,8/1/2021,THA,Pahang,0,0,0,Thailand
33815,8/1/2021,THA,Perak,0,0,0,Thailand
33816,8/1/2021,THA,Perlis,7375,7314,61,Thailand
33817,8/1/2021,THA,Pulau Pinang,126,124,2,Thailand
33818,8/1/2021,THA,Sabah,0,0,0,Thailand
33819,8/1/2021,THA,Sarawak,10,9,1,Thailand
33820,8/1/2021,THA,Selangor,196,144,52,Thailand
33821,8/1/2021,THA,Terengganu,0,0,0,Thailand
33822,8/1/2021,THA,W.P. Labuan,0,0,0,Thailand
33823,8/1/2021,TJK,Johor,0,0,0,Tajikistan
33824,8/1/2021,TJK,Kedah,0,0,0,Tajikistan
33825,8/1/2021,TJK,Perlis,0,0,0,Tajikistan
33826,8/1/2021,TJK,Pulau Pinang,0,0,0,Tajikistan
33827,8/1/2021,TJK,Sabah,0,0,0,Tajikistan
33828,8/1/2021,TJK,Selangor,2,2,0,Tajikistan
33829,8/1/2021,TKL,Selangor,0,0,0,Tokelau
33830,8/1/2021,TKM,Johor,0,0,0,Turkmenistan
33831,8/1/2021,TKM,Kedah,0,0,0,Turkmenistan
33832,8/1/2021,TKM,Kelantan,0,0,0,Turkmenistan
33833,8/1/2021,TKM,Perlis,0,0,0,Turkmenistan
33834,8/1/2021,TKM,Pulau Pinang,0,0,0,Turkmenistan
33835,8/1/2021,TKM,Sabah,0,0,0,Turkmenistan
33836,8/1/2021,TKM,Sarawak,0,0,0,Turkmenistan
33837,8/1/2021,TKM,Selangor,2,1,1,Turkmenistan
33838,8/1/2021,TLS,Johor,0,0,0,Timor-Leste
33839,8/1/2021,TLS,Kedah,0,0,0,Timor-Leste
33840,8/1/2021,TLS,Perlis,0,0,0,Timor-Leste
33841,8/1/2021,TLS,Pulau Pinang,0,0,0,Timor-Leste
33842,8/1/2021,TLS,Sabah,0,0,0,Timor-Leste
33843,8/1/2021,TLS,Sarawak,0,0,0,Timor-Leste
33844,8/1/2021,TLS,Selangor,1,0,1,Timor-Leste
33845,8/1/2021,TON,Johor,0,0,0,Tonga
33846,8/1/2021,TON,Pulau Pinang,0,0,0,Tonga
33847,8/1/2021,TON,Sarawak,0,0,0,Tonga
33848,8/1/2021,TON,Selangor,0,0,0,Tonga
33849,8/1/2021,TTO,Johor,0,0,0,Trinidad and Tobago
33850,8/1/2021,TTO,Kedah,0,0,0,Trinidad and Tobago
33851,8/1/2021,TTO,Pahang,0,0,0,Trinidad and Tobago
33852,8/1/2021,TTO,Pulau Pinang,0,0,0,Trinidad and Tobago
33853,8/1/2021,TTO,Sabah,0,0,0,Trinidad and Tobago
33854,8/1/2021,TTO,Sarawak,0,0,0,Trinidad and Tobago
33855,8/1/2021,TTO,Selangor,0,0,0,Trinidad and Tobago
33856,8/1/2021,TUN,Johor,0,0,0,Tunisia
33857,8/1/2021,TUN,Kedah,0,0,0,Tunisia
33858,8/1/2021,TUN,Kelantan,0,0,0,Tunisia
33859,8/1/2021,TUN,Melaka,0,0,0,Tunisia
33860,8/1/2021,TUN,Perak,0,0,0,Tunisia
33861,8/1/2021,TUN,Perlis,0,0,0,Tunisia
33862,8/1/2021,TUN,Pulau Pinang,0,0,0,Tunisia
33863,8/1/2021,TUN,Sabah,0,0,0,Tunisia
33864,8/1/2021,TUN,Sarawak,0,0,0,Tunisia
33865,8/1/2021,TUN,Selangor,2,1,1,Tunisia
33866,8/1/2021,TUN,W.P. Labuan,0,0,0,Tunisia
33867,8/1/2021,TUR,Johor,0,0,0,Turkey
33868,8/1/2021,TUR,Kedah,0,0,0,Turkey
33869,8/1/2021,TUR,Kelantan,0,0,0,Turkey
33870,8/1/2021,TUR,Melaka,0,0,0,Turkey
33871,8/1/2021,TUR,Negeri Sembilan,0,0,0,Turkey
33872,8/1/2021,TUR,Pahang,0,0,0,Turkey
33873,8/1/2021,TUR,Perak,0,0,0,Turkey
33874,8/1/2021,TUR,Perlis,0,0,0,Turkey
33875,8/1/2021,TUR,Pulau Pinang,0,0,0,Turkey
33876,8/1/2021,TUR,Sabah,0,0,0,Turkey
33877,8/1/2021,TUR,Sarawak,0,0,0,Turkey
33878,8/1/2021,TUR,Selangor,66,45,21,Turkey
33879,8/1/2021,TUR,W.P. Labuan,0,0,0,Turkey
33880,8/1/2021,TUV,Selangor,0,0,0,Tuvalu
33881,8/1/2021,TWN,Johor,0,0,0,Taiwan
33882,8/1/2021,TWN,Kedah,0,0,0,Taiwan
33883,8/1/2021,TWN,Kelantan,0,0,0,Taiwan
33884,8/1/2021,TWN,Melaka,0,0,0,Taiwan
33885,8/1/2021,TWN,Negeri Sembilan,0,0,0,Taiwan
33886,8/1/2021,TWN,Pahang,0,0,0,Taiwan
33887,8/1/2021,TWN,Perak,0,0,0,Taiwan
33888,8/1/2021,TWN,Perlis,0,0,0,Taiwan
33889,8/1/2021,TWN,Pulau Pinang,8,5,3,Taiwan
33890,8/1/2021,TWN,Sabah,0,0,0,Taiwan
33891,8/1/2021,TWN,Sarawak,1,1,0,Taiwan
33892,8/1/2021,TWN,Selangor,73,55,18,Taiwan
33893,8/1/2021,TWN,W.P. Labuan,0,0,0,Taiwan
33894,8/1/2021,TZA,Johor,0,0,0,"Tanzania, United Republic of"
33895,8/1/2021,TZA,Kedah,0,0,0,"Tanzania, United Republic of"
33896,8/1/2021,TZA,Perak,0,0,0,"Tanzania, United Republic of"
33897,8/1/2021,TZA,Perlis,0,0,0,"Tanzania, United Republic of"
33898,8/1/2021,TZA,Pulau Pinang,0,0,0,"Tanzania, United Republic of"
33899,8/1/2021,TZA,Sabah,0,0,0,"Tanzania, United Republic of"
33900,8/1/2021,TZA,Sarawak,0,0,0,"Tanzania, United Republic of"
33901,8/1/2021,TZA,Selangor,16,14,2,"Tanzania, United Republic of"
33902,8/1/2021,UGA,Johor,0,0,0,Uganda
33903,8/1/2021,UGA,Kedah,0,0,0,Uganda
33904,8/1/2021,UGA,Perak,0,0,0,Uganda
33905,8/1/2021,UGA,Perlis,0,0,0,Uganda
33906,8/1/2021,UGA,Pulau Pinang,0,0,0,Uganda
33907,8/1/2021,UGA,Sabah,0,0,0,Uganda
33908,8/1/2021,UGA,Sarawak,0,0,0,Uganda
33909,8/1/2021,UGA,Selangor,2,1,1,Uganda
33910,8/1/2021,UKR,Johor,0,0,0,Ukraine
33911,8/1/2021,UKR,Kedah,0,0,0,Ukraine
33912,8/1/2021,UKR,Kelantan,0,0,0,Ukraine
33913,8/1/2021,UKR,Melaka,0,0,0,Ukraine
33914,8/1/2021,UKR,Negeri Sembilan,0,0,0,Ukraine
33915,8/1/2021,UKR,Pahang,0,0,0,Ukraine
33916,8/1/2021,UKR,Perak,0,0,0,Ukraine
33917,8/1/2021,UKR,Perlis,0,0,0,Ukraine
33918,8/1/2021,UKR,Pulau Pinang,0,0,0,Ukraine
33919,8/1/2021,UKR,Sabah,0,0,0,Ukraine
33920,8/1/2021,UKR,Sarawak,0,0,0,Ukraine
33921,8/1/2021,UKR,Selangor,100,95,5,Ukraine
33922,8/1/2021,UKR,W.P. Labuan,0,0,0,Ukraine
33923,8/1/2021,URY,Johor,0,0,0,Uruguay
33924,8/1/2021,URY,Kedah,0,0,0,Uruguay
33925,8/1/2021,URY,Kelantan,0,0,0,Uruguay
33926,8/1/2021,URY,Perak,0,0,0,Uruguay
33927,8/1/2021,URY,Perlis,0,0,0,Uruguay
33928,8/1/2021,URY,Pulau Pinang,0,0,0,Uruguay
33929,8/1/2021,URY,Sabah,0,0,0,Uruguay
33930,8/1/2021,URY,Sarawak,0,0,0,Uruguay
33931,8/1/2021,URY,Selangor,0,0,0,Uruguay
33932,8/1/2021,URY,W.P. Labuan,0,0,0,Uruguay
33933,8/1/2021,USA,Johor,0,0,0,United States Of America
33934,8/1/2021,USA,Kedah,0,0,0,United States Of America
33935,8/1/2021,USA,Kelantan,0,0,0,United States Of America
33936,8/1/2021,USA,Melaka,0,0,0,United States Of America
33937,8/1/2021,USA,Negeri Sembilan,0,0,0,United States Of America
33938,8/1/2021,USA,Pahang,0,0,0,United States Of America
33939,8/1/2021,USA,Perak,0,0,0,United States Of America
33940,8/1/2021,USA,Perlis,0,0,0,United States Of America
33941,8/1/2021,USA,Pulau Pinang,11,8,3,United States Of America
33942,8/1/2021,USA,Sabah,0,0,0,United States Of America
33943,8/1/2021,USA,Sarawak,0,0,0,United States Of America
33944,8/1/2021,USA,Selangor,262,156,106,United States Of America
33945,8/1/2021,USA,Terengganu,0,0,0,United States Of America
33946,8/1/2021,USA,W.P. Labuan,0,0,0,United States Of America
33947,8/1/2021,UZB,Johor,0,0,0,Uzbekistan
33948,8/1/2021,UZB,Kedah,0,0,0,Uzbekistan
33949,8/1/2021,UZB,Kelantan,0,0,0,Uzbekistan
33950,8/1/2021,UZB,Perak,0,0,0,Uzbekistan
33951,8/1/2021,UZB,Perlis,0,0,0,Uzbekistan
33952,8/1/2021,UZB,Pulau Pinang,0,0,0,Uzbekistan
33953,8/1/2021,UZB,Sabah,0,0,0,Uzbekistan
33954,8/1/2021,UZB,Sarawak,0,0,0,Uzbekistan
33955,8/1/2021,UZB,Selangor,9,5,4,Uzbekistan
33956,8/1/2021,VAT,Johor,0,0,0,Holy See (Vatican City State)
33957,8/1/2021,VAT,Sarawak,0,0,0,Holy See (Vatican City State)
33958,8/1/2021,VAT,Selangor,0,0,0,Holy See (Vatican City State)
33959,8/1/2021,VCT,Johor,0,0,0,Saint Vincent and the Grenadines
33960,8/1/2021,VCT,Kedah,0,0,0,Saint Vincent and the Grenadines
33961,8/1/2021,VCT,Pulau Pinang,0,0,0,Saint Vincent and the Grenadines
33962,8/1/2021,VCT,Sarawak,0,0,0,Saint Vincent and the Grenadines
33963,8/1/2021,VCT,Selangor,0,0,0,Saint Vincent and the Grenadines
33964,8/1/2021,VEN,Johor,0,0,0,Venezuela
33965,8/1/2021,VEN,Kedah,0,0,0,Venezuela
33966,8/1/2021,VEN,Kelantan,0,0,0,Venezuela
33967,8/1/2021,VEN,Melaka,0,0,0,Venezuela
33968,8/1/2021,VEN,Perak,0,0,0,Venezuela
33969,8/1/2021,VEN,Perlis,0,0,0,Venezuela
33970,8/1/2021,VEN,Pulau Pinang,0,0,0,Venezuela
33971,8/1/2021,VEN,Sabah,0,0,0,Venezuela
33972,8/1/2021,VEN,Sarawak,0,0,0,Venezuela
33973,8/1/2021,VEN,Selangor,7,5,2,Venezuela
33974,8/1/2021,VEN,W.P. Labuan,0,0,0,Venezuela
33975,8/1/2021,VNM,Johor,0,0,0,Vietnam
33976,8/1/2021,VNM,Kedah,0,0,0,Vietnam
33977,8/1/2021,VNM,Kelantan,0,0,0,Vietnam
33978,8/1/2021,VNM,Melaka,0,0,0,Vietnam
33979,8/1/2021,VNM,Negeri Sembilan,0,0,0,Vietnam
33980,8/1/2021,VNM,Pahang,0,0,0,Vietnam
33981,8/1/2021,VNM,Perak,0,0,0,Vietnam
33982,8/1/2021,VNM,Perlis,0,0,0,Vietnam
33983,8/1/2021,VNM,Pulau Pinang,0,0,0,Vietnam
33984,8/1/2021,VNM,Sabah,0,0,0,Vietnam
33985,8/1/2021,VNM,Sarawak,0,0,0,Vietnam
33986,8/1/2021,VNM,Selangor,35,22,13,Vietnam
33987,8/1/2021,VNM,Terengganu,0,0,0,Vietnam
33988,8/1/2021,VNM,W.P. Labuan,0,0,0,Vietnam
33989,8/1/2021,VUT,Johor,0,0,0,Vanuatu
33990,8/1/2021,VUT,Kedah,0,0,0,Vanuatu
33991,8/1/2021,VUT,Pulau Pinang,0,0,0,Vanuatu
33992,8/1/2021,VUT,Sabah,0,0,0,Vanuatu
33993,8/1/2021,VUT,Sarawak,0,0,0,Vanuatu
33994,8/1/2021,VUT,Selangor,0,0,0,Vanuatu
33995,8/1/2021,WSM,Johor,0,0,0,Samoa
33996,8/1/2021,WSM,Sarawak,0,0,0,Samoa
33997,8/1/2021,WSM,Selangor,0,0,0,Samoa
33998,8/1/2021,YEM,Johor,0,0,0,Yemen
33999,8/1/2021,YEM,Kedah,0,0,0,Yemen
34000,8/1/2021,YEM,Kelantan,0,0,0,Yemen
34001,8/1/2021,YEM,Melaka,0,0,0,Yemen
34002,8/1/2021,YEM,Pahang,0,0,0,Yemen
34003,8/1/2021,YEM,Perak,0,0,0,Yemen
34004,8/1/2021,YEM,Perlis,0,0,0,Yemen
34005,8/1/2021,YEM,Pulau Pinang,0,0,0,Yemen
34006,8/1/2021,YEM,Sabah,0,0,0,Yemen
34007,8/1/2021,YEM,Sarawak,0,0,0,Yemen
34008,8/1/2021,YEM,Selangor,63,40,23,Yemen
34009,8/1/2021,YEM,W.P. Labuan,0,0,0,Yemen
34010,8/1/2021,ZAF,Johor,0,0,0,South Africa
34011,8/1/2021,ZAF,Kedah,0,0,0,South Africa
34012,8/1/2021,ZAF,Kelantan,0,0,0,South Africa
34013,8/1/2021,ZAF,Melaka,0,0,0,South Africa
34014,8/1/2021,ZAF,Pahang,0,0,0,South Africa
34015,8/1/2021,ZAF,Perak,0,0,0,South Africa
34016,8/1/2021,ZAF,Perlis,0,0,0,South Africa
34017,8/1/2021,ZAF,Pulau Pinang,0,0,0,South Africa
34018,8/1/2021,ZAF,Sabah,0,0,0,South Africa
34019,8/1/2021,ZAF,Sarawak,0,0,0,South Africa
34020,8/1/2021,ZAF,Selangor,30,20,10,South Africa
34021,8/1/2021,ZAF,Terengganu,0,0,0,South Africa
34022,8/1/2021,ZAF,W.P. Labuan,0,0,0,South Africa
34023,8/1/2021,ZMB,Johor,0,0,0,Zambia
34024,8/1/2021,ZMB,Kedah,0,0,0,Zambia
34025,8/1/2021,ZMB,Perak,0,0,0,Zambia
34026,8/1/2021,ZMB,Perlis,0,0,0,Zambia
34027,8/1/2021,ZMB,Pulau Pinang,0,0,0,Zambia
34028,8/1/2021,ZMB,Sabah,0,0,0,Zambia
34029,8/1/2021,ZMB,Sarawak,0,0,0,Zambia
34030,8/1/2021,ZMB,Selangor,8,4,4,Zambia
34031,8/1/2021,ZWE,Johor,0,0,0,Zimbabwe
34032,8/1/2021,ZWE,Kedah,0,0,0,Zimbabwe
34033,8/1/2021,ZWE,Kelantan,0,0,0,Zimbabwe
34034,8/1/2021,ZWE,Perak,0,0,0,Zimbabwe
34035,8/1/2021,ZWE,Perlis,0,0,0,Zimbabwe
34036,8/1/2021,ZWE,Pulau Pinang,0,0,0,Zimbabwe
34037,8/1/2021,ZWE,Sabah,0,0,0,Zimbabwe
34038,8/1/2021,ZWE,Sarawak,0,0,0,Zimbabwe
34039,8/1/2021,ZWE,Selangor,15,4,11,Zimbabwe
34040,9/1/2021,ABW,Kedah,0,0,0,Aruba
34041,9/1/2021,ABW,Pulau Pinang,0,0,0,Aruba
34042,9/1/2021,AFG,Johor,0,0,0,Afghanistan
34043,9/1/2021,AFG,Kedah,0,0,0,Afghanistan
34044,9/1/2021,AFG,Perlis,0,0,0,Afghanistan
34045,9/1/2021,AFG,Pulau Pinang,0,0,0,Afghanistan
34046,9/1/2021,AFG,Sarawak,0,0,0,Afghanistan
34047,9/1/2021,AFG,Selangor,8,4,4,Afghanistan
34048,9/1/2021,AGO,Johor,0,0,0,Angola
34049,9/1/2021,AGO,Kedah,0,0,0,Angola
34050,9/1/2021,AGO,Sabah,0,0,0,Angola
34051,9/1/2021,AGO,Selangor,0,0,0,Angola
34052,9/1/2021,AIA,Selangor,0,0,0,Anguilla
34053,9/1/2021,ALB,Johor,0,0,0,Albania
34054,9/1/2021,ALB,Kedah,0,0,0,Albania
34055,9/1/2021,ALB,Perak,0,0,0,Albania
34056,9/1/2021,ALB,Perlis,0,0,0,Albania
34057,9/1/2021,ALB,Pulau Pinang,0,0,0,Albania
34058,9/1/2021,ALB,Sabah,0,0,0,Albania
34059,9/1/2021,ALB,Sarawak,0,0,0,Albania
34060,9/1/2021,ALB,Selangor,2,1,1,Albania
34061,9/1/2021,AND,Johor,0,0,0,Andorra
34062,9/1/2021,AND,Kedah,0,0,0,Andorra
34063,9/1/2021,AND,Perlis,0,0,0,Andorra
34064,9/1/2021,AND,Pulau Pinang,0,0,0,Andorra
34065,9/1/2021,AND,Selangor,0,0,0,Andorra
34066,9/1/2021,ANT,Selangor,0,0,0,Netherlands Antilles
34067,9/1/2021,ARE,Johor,0,0,0,United Arab Emirates
34068,9/1/2021,ARE,Kedah,0,0,0,United Arab Emirates
34069,9/1/2021,ARE,Kelantan,0,0,0,United Arab Emirates
34070,9/1/2021,ARE,Perak,0,0,0,United Arab Emirates
34071,9/1/2021,ARE,Perlis,0,0,0,United Arab Emirates
34072,9/1/2021,ARE,Pulau Pinang,0,0,0,United Arab Emirates
34073,9/1/2021,ARE,Sabah,0,0,0,United Arab Emirates
34074,9/1/2021,ARE,Sarawak,43,43,0,United Arab Emirates
34075,9/1/2021,ARE,Selangor,2,1,1,United Arab Emirates
34076,9/1/2021,ARG,Johor,0,0,0,Argentina
34077,9/1/2021,ARG,Kedah,0,0,0,Argentina
34078,9/1/2021,ARG,Kelantan,0,0,0,Argentina
34079,9/1/2021,ARG,Melaka,0,0,0,Argentina
34080,9/1/2021,ARG,Perak,0,0,0,Argentina
34081,9/1/2021,ARG,Perlis,0,0,0,Argentina
34082,9/1/2021,ARG,Pulau Pinang,0,0,0,Argentina
34083,9/1/2021,ARG,Sabah,0,0,0,Argentina
34084,9/1/2021,ARG,Sarawak,0,0,0,Argentina
34085,9/1/2021,ARG,Selangor,4,1,3,Argentina
34086,9/1/2021,ARG,W.P. Labuan,0,0,0,Argentina
34087,9/1/2021,ARM,Johor,0,0,0,Armenia
34088,9/1/2021,ARM,Kedah,0,0,0,Armenia
34089,9/1/2021,ARM,Kelantan,0,0,0,Armenia
34090,9/1/2021,ARM,Perak,0,0,0,Armenia
34091,9/1/2021,ARM,Perlis,0,0,0,Armenia
34092,9/1/2021,ARM,Pulau Pinang,0,0,0,Armenia
34093,9/1/2021,ARM,Sabah,0,0,0,Armenia
34094,9/1/2021,ARM,Sarawak,0,0,0,Armenia
34095,9/1/2021,ARM,Selangor,0,0,0,Armenia
34096,9/1/2021,ATA,Selangor,0,0,0,Antarctica
34097,9/1/2021,ATG,Johor,0,0,0,Antigua and Barbuda
34098,9/1/2021,ATG,Kedah,0,0,0,Antigua and Barbuda
34099,9/1/2021,ATG,Pulau Pinang,0,0,0,Antigua and Barbuda
34100,9/1/2021,ATG,Sarawak,0,0,0,Antigua and Barbuda
34101,9/1/2021,ATG,Selangor,0,0,0,Antigua and Barbuda
34102,9/1/2021,AUS,Johor,1,1,0,Australia
34103,9/1/2021,AUS,Kedah,0,0,0,Australia
34104,9/1/2021,AUS,Kelantan,0,0,0,Australia
34105,9/1/2021,AUS,Melaka,0,0,0,Australia
34106,9/1/2021,AUS,Negeri Sembilan,0,0,0,Australia
34107,9/1/2021,AUS,Pahang,0,0,0,Australia
34108,9/1/2021,AUS,Perak,0,0,0,Australia
34109,9/1/2021,AUS,Perlis,0,0,0,Australia
34110,9/1/2021,AUS,Pulau Pinang,4,3,1,Australia
34111,9/1/2021,AUS,Sabah,0,0,0,Australia
34112,9/1/2021,AUS,Sarawak,0,0,0,Australia
34113,9/1/2021,AUS,Selangor,96,63,33,Australia
34114,9/1/2021,AUS,Terengganu,0,0,0,Australia
34115,9/1/2021,AUS,W.P. Labuan,0,0,0,Australia
34116,9/1/2021,AUT,Johor,0,0,0,Austria
34117,9/1/2021,AUT,Kedah,0,0,0,Austria
34118,9/1/2021,AUT,Kelantan,1,1,0,Austria
34119,9/1/2021,AUT,Melaka,0,0,0,Austria
34120,9/1/2021,AUT,Negeri Sembilan,0,0,0,Austria
34121,9/1/2021,AUT,Pahang,0,0,0,Austria
34122,9/1/2021,AUT,Perak,0,0,0,Austria
34123,9/1/2021,AUT,Perlis,0,0,0,Austria
34124,9/1/2021,AUT,Pulau Pinang,1,0,1,Austria
34125,9/1/2021,AUT,Sabah,0,0,0,Austria
34126,9/1/2021,AUT,Sarawak,0,0,0,Austria
34127,9/1/2021,AUT,Selangor,31,27,4,Austria
34128,9/1/2021,AUT,Terengganu,0,0,0,Austria
34129,9/1/2021,AUT,W.P. Labuan,0,0,0,Austria
34130,9/1/2021,AZE,Johor,0,0,0,Azerbaijan
34131,9/1/2021,AZE,Kedah,0,0,0,Azerbaijan
34132,9/1/2021,AZE,Kelantan,0,0,0,Azerbaijan
34133,9/1/2021,AZE,Melaka,0,0,0,Azerbaijan
34134,9/1/2021,AZE,Perlis,0,0,0,Azerbaijan
34135,9/1/2021,AZE,Pulau Pinang,0,0,0,Azerbaijan
34136,9/1/2021,AZE,Sabah,0,0,0,Azerbaijan
34137,9/1/2021,AZE,Sarawak,0,0,0,Azerbaijan
34138,9/1/2021,AZE,Selangor,2,1,1,Azerbaijan
34139,9/1/2021,AZE,W.P. Labuan,0,0,0,Azerbaijan
34140,9/1/2021,BDI,Pulau Pinang,0,0,0,Burundi
34141,9/1/2021,BDI,Sarawak,0,0,0,Burundi
34142,9/1/2021,BDI,Selangor,0,0,0,Burundi
34143,9/1/2021,BEL,Johor,0,0,0,Belgium
34144,9/1/2021,BEL,Kedah,0,0,0,Belgium
34145,9/1/2021,BEL,Kelantan,0,0,0,Belgium
34146,9/1/2021,BEL,Melaka,0,0,0,Belgium
34147,9/1/2021,BEL,Negeri Sembilan,0,0,0,Belgium
34148,9/1/2021,BEL,Pahang,0,0,0,Belgium
34149,9/1/2021,BEL,Perak,0,0,0,Belgium
34150,9/1/2021,BEL,Perlis,0,0,0,Belgium
34151,9/1/2021,BEL,Pulau Pinang,2,1,1,Belgium
34152,9/1/2021,BEL,Sabah,0,0,0,Belgium
34153,9/1/2021,BEL,Sarawak,0,0,0,Belgium
34154,9/1/2021,BEL,Selangor,26,13,13,Belgium
34155,9/1/2021,BEL,W.P. Labuan,0,0,0,Belgium
34156,9/1/2021,BEN,Johor,0,0,0,Benin
34157,9/1/2021,BEN,Kedah,0,0,0,Benin
34158,9/1/2021,BEN,Perak,0,0,0,Benin
34159,9/1/2021,BEN,Pulau Pinang,0,0,0,Benin
34160,9/1/2021,BEN,Sabah,0,0,0,Benin
34161,9/1/2021,BEN,Sarawak,0,0,0,Benin
34162,9/1/2021,BEN,Selangor,0,0,0,Benin
34163,9/1/2021,BFA,Perak,0,0,0,Burkina Faso
34164,9/1/2021,BFA,Pulau Pinang,0,0,0,Burkina Faso
34165,9/1/2021,BFA,Selangor,1,0,1,Burkina Faso
34166,9/1/2021,BGD,Johor,2,2,0,Bangladesh
34167,9/1/2021,BGD,Kedah,0,0,0,Bangladesh
34168,9/1/2021,BGD,Kelantan,0,0,0,Bangladesh
34169,9/1/2021,BGD,Melaka,0,0,0,Bangladesh
34170,9/1/2021,BGD,Negeri Sembilan,0,0,0,Bangladesh
34171,9/1/2021,BGD,Pahang,0,0,0,Bangladesh
34172,9/1/2021,BGD,Perak,0,0,0,Bangladesh
34173,9/1/2021,BGD,Perlis,0,0,0,Bangladesh
34174,9/1/2021,BGD,Pulau Pinang,0,0,0,Bangladesh
34175,9/1/2021,BGD,Sabah,0,0,0,Bangladesh
34176,9/1/2021,BGD,Sarawak,1,1,0,Bangladesh
34177,9/1/2021,BGD,Selangor,31,22,9,Bangladesh
34178,9/1/2021,BGD,W.P. Labuan,0,0,0,Bangladesh
34179,9/1/2021,BGR,Johor,0,0,0,Bulgaria
34180,9/1/2021,BGR,Kedah,0,0,0,Bulgaria
34181,9/1/2021,BGR,Kelantan,0,0,0,Bulgaria
34182,9/1/2021,BGR,Pahang,0,0,0,Bulgaria
34183,9/1/2021,BGR,Perak,0,0,0,Bulgaria
34184,9/1/2021,BGR,Perlis,0,0,0,Bulgaria
34185,9/1/2021,BGR,Pulau Pinang,0,0,0,Bulgaria
34186,9/1/2021,BGR,Sabah,0,0,0,Bulgaria
34187,9/1/2021,BGR,Sarawak,0,0,0,Bulgaria
34188,9/1/2021,BGR,Selangor,9,7,2,Bulgaria
34189,9/1/2021,BGR,W.P. Labuan,0,0,0,Bulgaria
34190,9/1/2021,BHR,Johor,0,0,0,Bahrain
34191,9/1/2021,BHR,Kedah,0,0,0,Bahrain
34192,9/1/2021,BHR,Kelantan,0,0,0,Bahrain
34193,9/1/2021,BHR,Perlis,0,0,0,Bahrain
34194,9/1/2021,BHR,Pulau Pinang,0,0,0,Bahrain
34195,9/1/2021,BHR,Sabah,0,0,0,Bahrain
34196,9/1/2021,BHR,Sarawak,0,0,0,Bahrain
34197,9/1/2021,BHR,Selangor,0,0,0,Bahrain
34198,9/1/2021,BHS,Johor,0,0,0,Bahamas
34199,9/1/2021,BHS,Kedah,0,0,0,Bahamas
34200,9/1/2021,BHS,Perak,0,0,0,Bahamas
34201,9/1/2021,BHS,Sabah,0,0,0,Bahamas
34202,9/1/2021,BHS,Sarawak,0,0,0,Bahamas
34203,9/1/2021,BHS,Selangor,0,0,0,Bahamas
34204,9/1/2021,BIH,Johor,0,0,0,Bosnia and Herzegovina
34205,9/1/2021,BIH,Kedah,0,0,0,Bosnia and Herzegovina
34206,9/1/2021,BIH,Perlis,0,0,0,Bosnia and Herzegovina
34207,9/1/2021,BIH,Pulau Pinang,0,0,0,Bosnia and Herzegovina
34208,9/1/2021,BIH,Sabah,0,0,0,Bosnia and Herzegovina
34209,9/1/2021,BIH,Sarawak,0,0,0,Bosnia and Herzegovina
34210,9/1/2021,BIH,Selangor,4,2,2,Bosnia and Herzegovina
34211,9/1/2021,BLR,Johor,0,0,0,Belarus
34212,9/1/2021,BLR,Kedah,0,0,0,Belarus
34213,9/1/2021,BLR,Kelantan,0,0,0,Belarus
34214,9/1/2021,BLR,Pahang,0,0,0,Belarus
34215,9/1/2021,BLR,Perak,0,0,0,Belarus
34216,9/1/2021,BLR,Perlis,0,0,0,Belarus
34217,9/1/2021,BLR,Pulau Pinang,0,0,0,Belarus
34218,9/1/2021,BLR,Sabah,0,0,0,Belarus
34219,9/1/2021,BLR,Sarawak,0,0,0,Belarus
34220,9/1/2021,BLR,Selangor,2,1,1,Belarus
34221,9/1/2021,BLR,W.P. Labuan,0,0,0,Belarus
34222,9/1/2021,BLZ,Johor,0,0,0,Belize
34223,9/1/2021,BLZ,Pulau Pinang,0,0,0,Belize
34224,9/1/2021,BLZ,Sarawak,0,0,0,Belize
34225,9/1/2021,BLZ,Selangor,0,0,0,Belize
34226,9/1/2021,BMU,Selangor,0,0,0,Bermuda
34227,9/1/2021,BOL,Johor,0,0,0,Bolivia
34228,9/1/2021,BOL,Kedah,0,0,0,Bolivia
34229,9/1/2021,BOL,Melaka,0,0,0,Bolivia
34230,9/1/2021,BOL,Perak,0,0,0,Bolivia
34231,9/1/2021,BOL,Perlis,0,0,0,Bolivia
34232,9/1/2021,BOL,Pulau Pinang,0,0,0,Bolivia
34233,9/1/2021,BOL,Sabah,0,0,0,Bolivia
34234,9/1/2021,BOL,Sarawak,0,0,0,Bolivia
34235,9/1/2021,BOL,Selangor,0,0,0,Bolivia
34236,9/1/2021,BRA,Johor,0,0,0,Brazil
34237,9/1/2021,BRA,Kedah,0,0,0,Brazil
34238,9/1/2021,BRA,Kelantan,0,0,0,Brazil
34239,9/1/2021,BRA,Melaka,0,0,0,Brazil
34240,9/1/2021,BRA,Pahang,0,0,0,Brazil
34241,9/1/2021,BRA,Perak,0,0,0,Brazil
34242,9/1/2021,BRA,Perlis,0,0,0,Brazil
34243,9/1/2021,BRA,Pulau Pinang,0,0,0,Brazil
34244,9/1/2021,BRA,Sabah,0,0,0,Brazil
34245,9/1/2021,BRA,Sarawak,0,0,0,Brazil
34246,9/1/2021,BRA,Selangor,11,5,6,Brazil
34247,9/1/2021,BRA,W.P. Labuan,0,0,0,Brazil
34248,9/1/2021,BRB,Johor,0,0,0,Barbados
34249,9/1/2021,BRB,Kedah,0,0,0,Barbados
34250,9/1/2021,BRB,Perlis,0,0,0,Barbados
34251,9/1/2021,BRB,Pulau Pinang,0,0,0,Barbados
34252,9/1/2021,BRB,Selangor,1,1,0,Barbados
34253,9/1/2021,BRN,Johor,0,0,0,Brunei Darussalam
34254,9/1/2021,BRN,Kedah,0,0,0,Brunei Darussalam
34255,9/1/2021,BRN,Kelantan,0,0,0,Brunei Darussalam
34256,9/1/2021,BRN,Melaka,0,0,0,Brunei Darussalam
34257,9/1/2021,BRN,Pahang,0,0,0,Brunei Darussalam
34258,9/1/2021,BRN,Perak,0,0,0,Brunei Darussalam
34259,9/1/2021,BRN,Perlis,0,0,0,Brunei Darussalam
34260,9/1/2021,BRN,Pulau Pinang,0,0,0,Brunei Darussalam
34261,9/1/2021,BRN,Sabah,0,0,0,Brunei Darussalam
34262,9/1/2021,BRN,Sarawak,234,234,0,Brunei Darussalam
34263,9/1/2021,BRN,Selangor,38,32,6,Brunei Darussalam
34264,9/1/2021,BRN,W.P. Labuan,0,0,0,Brunei Darussalam
34265,9/1/2021,BTN,Johor,0,0,0,Bhutan
34266,9/1/2021,BTN,Kedah,0,0,0,Bhutan
34267,9/1/2021,BTN,Perak,0,0,0,Bhutan
34268,9/1/2021,BTN,Perlis,0,0,0,Bhutan
34269,9/1/2021,BTN,Pulau Pinang,0,0,0,Bhutan
34270,9/1/2021,BTN,Sabah,0,0,0,Bhutan
34271,9/1/2021,BTN,Sarawak,0,0,0,Bhutan
34272,9/1/2021,BTN,Selangor,1,1,0,Bhutan
34273,9/1/2021,BWA,Johor,0,0,0,Botswana
34274,9/1/2021,BWA,Kedah,0,0,0,Botswana
34275,9/1/2021,BWA,Perlis,0,0,0,Botswana
34276,9/1/2021,BWA,Pulau Pinang,0,0,0,Botswana
34277,9/1/2021,BWA,Sabah,0,0,0,Botswana
34278,9/1/2021,BWA,Sarawak,0,0,0,Botswana
34279,9/1/2021,BWA,Selangor,0,0,0,Botswana
34280,9/1/2021,CAF,Kedah,0,0,0,Central African Republic
34281,9/1/2021,CAF,Selangor,0,0,0,Central African Republic
34282,9/1/2021,CAN,Johor,0,0,0,Canada
34283,9/1/2021,CAN,Kedah,0,0,0,Canada
34284,9/1/2021,CAN,Kelantan,0,0,0,Canada
34285,9/1/2021,CAN,Melaka,0,0,0,Canada
34286,9/1/2021,CAN,Negeri Sembilan,0,0,0,Canada
34287,9/1/2021,CAN,Pahang,0,0,0,Canada
34288,9/1/2021,CAN,Perak,0,0,0,Canada
34289,9/1/2021,CAN,Perlis,0,0,0,Canada
34290,9/1/2021,CAN,Pulau Pinang,1,1,0,Canada
34291,9/1/2021,CAN,Sabah,0,0,0,Canada
34292,9/1/2021,CAN,Sarawak,0,0,0,Canada
34293,9/1/2021,CAN,Selangor,58,45,13,Canada
34294,9/1/2021,CAN,Terengganu,0,0,0,Canada
34295,9/1/2021,CAN,W.P. Labuan,0,0,0,Canada
34296,9/1/2021,CCK,Selangor,0,0,0,Cocos (Keeling) Islands
34297,9/1/2021,CHE,Johor,0,0,0,Switzerland
34298,9/1/2021,CHE,Kedah,0,0,0,Switzerland
34299,9/1/2021,CHE,Kelantan,0,0,0,Switzerland
34300,9/1/2021,CHE,Melaka,0,0,0,Switzerland
34301,9/1/2021,CHE,Negeri Sembilan,0,0,0,Switzerland
34302,9/1/2021,CHE,Pahang,0,0,0,Switzerland
34303,9/1/2021,CHE,Perak,0,0,0,Switzerland
34304,9/1/2021,CHE,Perlis,0,0,0,Switzerland
34305,9/1/2021,CHE,Pulau Pinang,1,1,0,Switzerland
34306,9/1/2021,CHE,Sabah,0,0,0,Switzerland
34307,9/1/2021,CHE,Sarawak,0,0,0,Switzerland
34308,9/1/2021,CHE,Selangor,22,16,6,Switzerland
34309,9/1/2021,CHE,W.P. Labuan,0,0,0,Switzerland
34310,9/1/2021,CHL,Johor,0,0,0,Chile
34311,9/1/2021,CHL,Kedah,0,0,0,Chile
34312,9/1/2021,CHL,Kelantan,0,0,0,Chile
34313,9/1/2021,CHL,Melaka,0,0,0,Chile
34314,9/1/2021,CHL,Pahang,0,0,0,Chile
34315,9/1/2021,CHL,Perak,0,0,0,Chile
34316,9/1/2021,CHL,Perlis,0,0,0,Chile
34317,9/1/2021,CHL,Pulau Pinang,0,0,0,Chile
34318,9/1/2021,CHL,Sabah,0,0,0,Chile
34319,9/1/2021,CHL,Sarawak,0,0,0,Chile
34320,9/1/2021,CHL,Selangor,1,1,0,Chile
34321,9/1/2021,CHN,Johor,2,2,0,China
34322,9/1/2021,CHN,Kedah,0,0,0,China
34323,9/1/2021,CHN,Kelantan,0,0,0,China
34324,9/1/2021,CHN,Melaka,0,0,0,China
34325,9/1/2021,CHN,Pahang,0,0,0,China
34326,9/1/2021,CHN,Perak,0,0,0,China
34327,9/1/2021,CHN,Perlis,0,0,0,China
34328,9/1/2021,CHN,Pulau Pinang,3,1,2,China
34329,9/1/2021,CHN,Sabah,0,0,0,China
34330,9/1/2021,CHN,Sarawak,144,133,11,China
34331,9/1/2021,CHN,Selangor,935,753,182,China
34332,9/1/2021,CHN,Terengganu,0,0,0,China
34333,9/1/2021,CHN,W.P. Labuan,0,0,0,China
34334,9/1/2021,CIV,Johor,0,0,0,C��te d'Iv
34335,9/1/2021,CIV,Kedah,0,0,0,C��te d'Iv
34336,9/1/2021,CIV,Pulau Pinang,0,0,0,C��te d'Iv
34337,9/1/2021,CIV,Sabah,0,0,0,C��te d'Iv
34338,9/1/2021,CIV,Sarawak,0,0,0,C��te d'Iv
34339,9/1/2021,CIV,Selangor,0,0,0,C��te d'Iv
34340,9/1/2021,CMR,Johor,0,0,0,Cameroon
34341,9/1/2021,CMR,Kedah,0,0,0,Cameroon
34342,9/1/2021,CMR,Pulau Pinang,0,0,0,Cameroon
34343,9/1/2021,CMR,Sabah,0,0,0,Cameroon
34344,9/1/2021,CMR,Sarawak,0,0,0,Cameroon
34345,9/1/2021,CMR,Selangor,3,1,2,Cameroon
34346,9/1/2021,COD,Johor,0,0,0,"Congo, the Democratic Republic of the"
34347,9/1/2021,COD,Pulau Pinang,0,0,0,"Congo, the Democratic Republic of the"
34348,9/1/2021,COD,Sarawak,0,0,0,"Congo, the Democratic Republic of the"
34349,9/1/2021,COD,Selangor,0,0,0,"Congo, the Democratic Republic of the"
34350,9/1/2021,COG,Johor,0,0,0,Congo
34351,9/1/2021,COG,Kedah,0,0,0,Congo
34352,9/1/2021,COG,Selangor,0,0,0,Congo
34353,9/1/2021,COK,Selangor,0,0,0,Cook Islands
34354,9/1/2021,COL,Johor,0,0,0,Colombia
34355,9/1/2021,COL,Kedah,0,0,0,Colombia
34356,9/1/2021,COL,Perak,0,0,0,Colombia
34357,9/1/2021,COL,Pulau Pinang,0,0,0,Colombia
34358,9/1/2021,COL,Sabah,0,0,0,Colombia
34359,9/1/2021,COL,Sarawak,0,0,0,Colombia
34360,9/1/2021,COL,Selangor,9,5,4,Colombia
34361,9/1/2021,COL,W.P. Labuan,0,0,0,Colombia
34362,9/1/2021,COM,Johor,0,0,0,Comoros
34363,9/1/2021,COM,Kedah,0,0,0,Comoros
34364,9/1/2021,COM,Selangor,6,4,2,Comoros
34365,9/1/2021,CPV,Johor,0,0,0,Cape Verde
34366,9/1/2021,CPV,Kedah,0,0,0,Cape Verde
34367,9/1/2021,CPV,Pulau Pinang,0,0,0,Cape Verde
34368,9/1/2021,CPV,Sabah,0,0,0,Cape Verde
34369,9/1/2021,CPV,Selangor,0,0,0,Cape Verde
34370,9/1/2021,CRI,Johor,0,0,0,Costa Rica
34371,9/1/2021,CRI,Kedah,0,0,0,Costa Rica
34372,9/1/2021,CRI,Perak,0,0,0,Costa Rica
34373,9/1/2021,CRI,Perlis,0,0,0,Costa Rica
34374,9/1/2021,CRI,Pulau Pinang,0,0,0,Costa Rica
34375,9/1/2021,CRI,Sabah,0,0,0,Costa Rica
34376,9/1/2021,CRI,Sarawak,0,0,0,Costa Rica
34377,9/1/2021,CRI,Selangor,0,0,0,Costa Rica
34378,9/1/2021,CUB,Johor,0,0,0,Cuba
34379,9/1/2021,CUB,Kedah,0,0,0,Cuba
34380,9/1/2021,CUB,Perlis,0,0,0,Cuba
34381,9/1/2021,CUB,Pulau Pinang,0,0,0,Cuba
34382,9/1/2021,CUB,Sabah,0,0,0,Cuba
34383,9/1/2021,CUB,Sarawak,0,0,0,Cuba
34384,9/1/2021,CUB,Selangor,0,0,0,Cuba
34385,9/1/2021,CYP,Johor,0,0,0,Cyprus
34386,9/1/2021,CYP,Kedah,0,0,0,Cyprus
34387,9/1/2021,CYP,Perak,0,0,0,Cyprus
34388,9/1/2021,CYP,Perlis,0,0,0,Cyprus
34389,9/1/2021,CYP,Pulau Pinang,0,0,0,Cyprus
34390,9/1/2021,CYP,Sabah,0,0,0,Cyprus
34391,9/1/2021,CYP,Sarawak,0,0,0,Cyprus
34392,9/1/2021,CYP,Selangor,0,0,0,Cyprus
34393,9/1/2021,CZE,Johor,0,0,0,Czech Republic
34394,9/1/2021,CZE,Kedah,0,0,0,Czech Republic
34395,9/1/2021,CZE,Kelantan,0,0,0,Czech Republic
34396,9/1/2021,CZE,Melaka,0,0,0,Czech Republic
34397,9/1/2021,CZE,Negeri Sembilan,0,0,0,Czech Republic
34398,9/1/2021,CZE,Perak,0,0,0,Czech Republic
34399,9/1/2021,CZE,Perlis,0,0,0,Czech Republic
34400,9/1/2021,CZE,Pulau Pinang,0,0,0,Czech Republic
34401,9/1/2021,CZE,Sabah,0,0,0,Czech Republic
34402,9/1/2021,CZE,Sarawak,0,0,0,Czech Republic
34403,9/1/2021,CZE,Selangor,3,2,1,Czech Republic
34404,9/1/2021,CZE,W.P. Labuan,0,0,0,Czech Republic
34405,9/1/2021,DEU,Johor,2,2,0,Germany
34406,9/1/2021,DEU,Kedah,0,0,0,Germany
34407,9/1/2021,DEU,Kelantan,0,0,0,Germany
34408,9/1/2021,DEU,Melaka,0,0,0,Germany
34409,9/1/2021,DEU,Negeri Sembilan,0,0,0,Germany
34410,9/1/2021,DEU,Pahang,0,0,0,Germany
34411,9/1/2021,DEU,Perak,0,0,0,Germany
34412,9/1/2021,DEU,Perlis,0,0,0,Germany
34413,9/1/2021,DEU,Pulau Pinang,8,5,3,Germany
34414,9/1/2021,DEU,Sabah,0,0,0,Germany
34415,9/1/2021,DEU,Sarawak,1,1,0,Germany
34416,9/1/2021,DEU,Selangor,148,110,38,Germany
34417,9/1/2021,DEU,Terengganu,0,0,0,Germany
34418,9/1/2021,DEU,W.P. Labuan,0,0,0,Germany
34419,9/1/2021,DJI,Johor,0,0,0,Djibouti
34420,9/1/2021,DJI,Selangor,1,1,0,Djibouti
34421,9/1/2021,DMA,Johor,0,0,0,Dominica
34422,9/1/2021,DMA,Kedah,0,0,0,Dominica
34423,9/1/2021,DMA,Pulau Pinang,0,0,0,Dominica
34424,9/1/2021,DMA,Sabah,0,0,0,Dominica
34425,9/1/2021,DMA,Sarawak,0,0,0,Dominica
34426,9/1/2021,DMA,Selangor,0,0,0,Dominica
34427,9/1/2021,DMA,W.P. Labuan,0,0,0,Dominica
34428,9/1/2021,DNK,Johor,0,0,0,Denmark
34429,9/1/2021,DNK,Kedah,0,0,0,Denmark
34430,9/1/2021,DNK,Kelantan,0,0,0,Denmark
34431,9/1/2021,DNK,Melaka,0,0,0,Denmark
34432,9/1/2021,DNK,Negeri Sembilan,0,0,0,Denmark
34433,9/1/2021,DNK,Pahang,0,0,0,Denmark
34434,9/1/2021,DNK,Perak,0,0,0,Denmark
34435,9/1/2021,DNK,Perlis,0,0,0,Denmark
34436,9/1/2021,DNK,Pulau Pinang,3,2,1,Denmark
34437,9/1/2021,DNK,Sabah,0,0,0,Denmark
34438,9/1/2021,DNK,Sarawak,0,0,0,Denmark
34439,9/1/2021,DNK,Selangor,36,30,6,Denmark
34440,9/1/2021,DNK,W.P. Labuan,0,0,0,Denmark
34441,9/1/2021,DOM,Johor,0,0,0,Dominican Republic
34442,9/1/2021,DOM,Kedah,0,0,0,Dominican Republic
34443,9/1/2021,DOM,Perak,0,0,0,Dominican Republic
34444,9/1/2021,DOM,Perlis,0,0,0,Dominican Republic
34445,9/1/2021,DOM,Pulau Pinang,0,0,0,Dominican Republic
34446,9/1/2021,DOM,Sabah,0,0,0,Dominican Republic
34447,9/1/2021,DOM,Sarawak,0,0,0,Dominican Republic
34448,9/1/2021,DOM,Selangor,0,0,0,Dominican Republic
34449,9/1/2021,DZA,Johor,0,0,0,Algeria
34450,9/1/2021,DZA,Kedah,0,0,0,Algeria
34451,9/1/2021,DZA,Kelantan,0,0,0,Algeria
34452,9/1/2021,DZA,Melaka,0,0,0,Algeria
34453,9/1/2021,DZA,Perak,0,0,0,Algeria
34454,9/1/2021,DZA,Perlis,0,0,0,Algeria
34455,9/1/2021,DZA,Pulau Pinang,0,0,0,Algeria
34456,9/1/2021,DZA,Sabah,0,0,0,Algeria
34457,9/1/2021,DZA,Sarawak,0,0,0,Algeria
34458,9/1/2021,DZA,Selangor,26,12,14,Algeria
34459,9/1/2021,DZA,W.P. Labuan,0,0,0,Algeria
34460,9/1/2021,ECU,Johor,0,0,0,Ecuador
34461,9/1/2021,ECU,Kedah,0,0,0,Ecuador
34462,9/1/2021,ECU,Perak,0,0,0,Ecuador
34463,9/1/2021,ECU,Perlis,0,0,0,Ecuador
34464,9/1/2021,ECU,Pulau Pinang,0,0,0,Ecuador
34465,9/1/2021,ECU,Sabah,0,0,0,Ecuador
34466,9/1/2021,ECU,Sarawak,0,0,0,Ecuador
34467,9/1/2021,ECU,Selangor,0,0,0,Ecuador
34468,9/1/2021,EGY,Johor,0,0,0,Egypt
34469,9/1/2021,EGY,Kedah,0,0,0,Egypt
34470,9/1/2021,EGY,Kelantan,0,0,0,Egypt
34471,9/1/2021,EGY,Melaka,0,0,0,Egypt
34472,9/1/2021,EGY,Pahang,0,0,0,Egypt
34473,9/1/2021,EGY,Perak,0,0,0,Egypt
34474,9/1/2021,EGY,Perlis,0,0,0,Egypt
34475,9/1/2021,EGY,Pulau Pinang,0,0,0,Egypt
34476,9/1/2021,EGY,Sabah,0,0,0,Egypt
34477,9/1/2021,EGY,Sarawak,1,1,0,Egypt
34478,9/1/2021,EGY,Selangor,72,53,19,Egypt
34479,9/1/2021,EGY,Terengganu,0,0,0,Egypt
34480,9/1/2021,EGY,W.P. Labuan,0,0,0,Egypt
34481,9/1/2021,ERI,Johor,0,0,0,Eritrea
34482,9/1/2021,ERI,Pulau Pinang,0,0,0,Eritrea
34483,9/1/2021,ERI,Sabah,0,0,0,Eritrea
34484,9/1/2021,ERI,Selangor,1,1,0,Eritrea
34485,9/1/2021,ESP,Johor,0,0,0,Spain
34486,9/1/2021,ESP,Kedah,0,0,0,Spain
34487,9/1/2021,ESP,Kelantan,0,0,0,Spain
34488,9/1/2021,ESP,Melaka,0,0,0,Spain
34489,9/1/2021,ESP,Negeri Sembilan,0,0,0,Spain
34490,9/1/2021,ESP,Pahang,0,0,0,Spain
34491,9/1/2021,ESP,Perak,0,0,0,Spain
34492,9/1/2021,ESP,Perlis,0,0,0,Spain
34493,9/1/2021,ESP,Pulau Pinang,2,1,1,Spain
34494,9/1/2021,ESP,Sabah,0,0,0,Spain
34495,9/1/2021,ESP,Sarawak,0,0,0,Spain
34496,9/1/2021,ESP,Selangor,41,31,10,Spain
34497,9/1/2021,ESP,W.P. Labuan,0,0,0,Spain
34498,9/1/2021,EST,Johor,0,0,0,Estonia
34499,9/1/2021,EST,Kedah,0,0,0,Estonia
34500,9/1/2021,EST,Kelantan,0,0,0,Estonia
34501,9/1/2021,EST,Pahang,0,0,0,Estonia
34502,9/1/2021,EST,Perak,0,0,0,Estonia
34503,9/1/2021,EST,Perlis,0,0,0,Estonia
34504,9/1/2021,EST,Pulau Pinang,0,0,0,Estonia
34505,9/1/2021,EST,Sabah,0,0,0,Estonia
34506,9/1/2021,EST,Sarawak,0,0,0,Estonia
34507,9/1/2021,EST,Selangor,4,1,3,Estonia
34508,9/1/2021,EST,W.P. Labuan,0,0,0,Estonia
34509,9/1/2021,ETH,Johor,1,1,0,Ethiopia
34510,9/1/2021,ETH,Kedah,0,0,0,Ethiopia
34511,9/1/2021,ETH,Pulau Pinang,0,0,0,Ethiopia
34512,9/1/2021,ETH,Sarawak,0,0,0,Ethiopia
34513,9/1/2021,ETH,Selangor,4,4,0,Ethiopia
34514,9/1/2021,FIN,Johor,0,0,0,Finland
34515,9/1/2021,FIN,Kedah,0,0,0,Finland
34516,9/1/2021,FIN,Kelantan,0,0,0,Finland
34517,9/1/2021,FIN,Melaka,0,0,0,Finland
34518,9/1/2021,FIN,Negeri Sembilan,0,0,0,Finland
34519,9/1/2021,FIN,Pahang,0,0,0,Finland
34520,9/1/2021,FIN,Perak,0,0,0,Finland
34521,9/1/2021,FIN,Perlis,0,0,0,Finland
34522,9/1/2021,FIN,Pulau Pinang,1,1,0,Finland
34523,9/1/2021,FIN,Sabah,0,0,0,Finland
34524,9/1/2021,FIN,Sarawak,0,0,0,Finland
34525,9/1/2021,FIN,Selangor,23,19,4,Finland
34526,9/1/2021,FIN,W.P. Labuan,0,0,0,Finland
34527,9/1/2021,FJI,Johor,0,0,0,Fiji
34528,9/1/2021,FJI,Kedah,0,0,0,Fiji
34529,9/1/2021,FJI,Kelantan,0,0,0,Fiji
34530,9/1/2021,FJI,Perak,0,0,0,Fiji
34531,9/1/2021,FJI,Perlis,0,0,0,Fiji
34532,9/1/2021,FJI,Pulau Pinang,0,0,0,Fiji
34533,9/1/2021,FJI,Sabah,0,0,0,Fiji
34534,9/1/2021,FJI,Sarawak,0,0,0,Fiji
34535,9/1/2021,FJI,Selangor,0,0,0,Fiji
34536,9/1/2021,FRA,Johor,0,0,0,France
34537,9/1/2021,FRA,Kedah,0,0,0,France
34538,9/1/2021,FRA,Kelantan,0,0,0,France
34539,9/1/2021,FRA,Melaka,0,0,0,France
34540,9/1/2021,FRA,Negeri Sembilan,0,0,0,France
34541,9/1/2021,FRA,Pahang,0,0,0,France
34542,9/1/2021,FRA,Perak,0,0,0,France
34543,9/1/2021,FRA,Perlis,0,0,0,France
34544,9/1/2021,FRA,Pulau Pinang,5,3,2,France
34545,9/1/2021,FRA,Sabah,0,0,0,France
34546,9/1/2021,FRA,Sarawak,2,2,0,France
34547,9/1/2021,FRA,Selangor,243,168,75,France
34548,9/1/2021,FRA,Terengganu,0,0,0,France
34549,9/1/2021,FRA,W.P. Labuan,0,0,0,France
34550,9/1/2021,FSM,Johor,0,0,0,"Micronesia, Federated States of"
34551,9/1/2021,FSM,Pulau Pinang,0,0,0,"Micronesia, Federated States of"
34552,9/1/2021,FSM,Selangor,0,0,0,"Micronesia, Federated States of"
34553,9/1/2021,GAB,Johor,0,0,0,Gabon
34554,9/1/2021,GAB,Pulau Pinang,0,0,0,Gabon
34555,9/1/2021,GAB,Sarawak,0,0,0,Gabon
34556,9/1/2021,GAB,Selangor,2,1,1,Gabon
34557,9/1/2021,GBR,Johor,2,1,1,United Kingdom
34558,9/1/2021,GBR,Kedah,0,0,0,United Kingdom
34559,9/1/2021,GBR,Kelantan,0,0,0,United Kingdom
34560,9/1/2021,GBR,Melaka,0,0,0,United Kingdom
34561,9/1/2021,GBR,Negeri Sembilan,0,0,0,United Kingdom
34562,9/1/2021,GBR,Pahang,0,0,0,United Kingdom
34563,9/1/2021,GBR,Perak,0,0,0,United Kingdom
34564,9/1/2021,GBR,Perlis,0,0,0,United Kingdom
34565,9/1/2021,GBR,Pulau Pinang,18,11,7,United Kingdom
34566,9/1/2021,GBR,Sabah,0,0,0,United Kingdom
34567,9/1/2021,GBR,Sarawak,1,1,0,United Kingdom
34568,9/1/2021,GBR,Selangor,348,271,77,United Kingdom
34569,9/1/2021,GBR,Terengganu,0,0,0,United Kingdom
34570,9/1/2021,GBR,W.P. Labuan,0,0,0,United Kingdom
34571,9/1/2021,GEO,Johor,0,0,0,Georgia
34572,9/1/2021,GEO,Kedah,0,0,0,Georgia
34573,9/1/2021,GEO,Melaka,0,0,0,Georgia
34574,9/1/2021,GEO,Perak,0,0,0,Georgia
34575,9/1/2021,GEO,Perlis,0,0,0,Georgia
34576,9/1/2021,GEO,Pulau Pinang,0,0,0,Georgia
34577,9/1/2021,GEO,Sabah,0,0,0,Georgia
34578,9/1/2021,GEO,Sarawak,0,0,0,Georgia
34579,9/1/2021,GEO,Selangor,3,3,0,Georgia
34580,9/1/2021,GHA,Johor,0,0,0,Ghana
34581,9/1/2021,GHA,Kedah,0,0,0,Ghana
34582,9/1/2021,GHA,Kelantan,0,0,0,Ghana
34583,9/1/2021,GHA,Pulau Pinang,0,0,0,Ghana
34584,9/1/2021,GHA,Sabah,0,0,0,Ghana
34585,9/1/2021,GHA,Sarawak,0,0,0,Ghana
34586,9/1/2021,GHA,Selangor,5,3,2,Ghana
34587,9/1/2021,GIB,Johor,0,0,0,Gibraltar
34588,9/1/2021,GIB,Sarawak,0,0,0,Gibraltar
34589,9/1/2021,GIN,Johor,0,0,0,Guinea
34590,9/1/2021,GIN,Kedah,0,0,0,Guinea
34591,9/1/2021,GIN,Kelantan,0,0,0,Guinea
34592,9/1/2021,GIN,Perlis,0,0,0,Guinea
34593,9/1/2021,GIN,Pulau Pinang,0,0,0,Guinea
34594,9/1/2021,GIN,Sabah,0,0,0,Guinea
34595,9/1/2021,GIN,Sarawak,0,0,0,Guinea
34596,9/1/2021,GIN,Selangor,11,6,5,Guinea
34597,9/1/2021,GLP,Selangor,0,0,0,Guadeloupe
34598,9/1/2021,GMB,Johor,0,0,0,Gambia
34599,9/1/2021,GMB,Kedah,0,0,0,Gambia
34600,9/1/2021,GMB,Kelantan,0,0,0,Gambia
34601,9/1/2021,GMB,Pulau Pinang,0,0,0,Gambia
34602,9/1/2021,GMB,Sabah,0,0,0,Gambia
34603,9/1/2021,GMB,Sarawak,0,0,0,Gambia
34604,9/1/2021,GMB,Selangor,6,4,2,Gambia
34605,9/1/2021,GNB,Johor,0,0,0,Guinea-Bissau
34606,9/1/2021,GNB,Selangor,0,0,0,Guinea-Bissau
34607,9/1/2021,GNQ,Johor,0,0,0,Equatorial Guinea
34608,9/1/2021,GNQ,Selangor,0,0,0,Equatorial Guinea
34609,9/1/2021,GRC,Johor,0,0,0,Greece
34610,9/1/2021,GRC,Kedah,0,0,0,Greece
34611,9/1/2021,GRC,Kelantan,0,0,0,Greece
34612,9/1/2021,GRC,Melaka,0,0,0,Greece
34613,9/1/2021,GRC,Negeri Sembilan,0,0,0,Greece
34614,9/1/2021,GRC,Pahang,0,0,0,Greece
34615,9/1/2021,GRC,Perak,0,0,0,Greece
34616,9/1/2021,GRC,Perlis,0,0,0,Greece
34617,9/1/2021,GRC,Pulau Pinang,0,0,0,Greece
34618,9/1/2021,GRC,Sabah,0,0,0,Greece
34619,9/1/2021,GRC,Sarawak,0,0,0,Greece
34620,9/1/2021,GRC,Selangor,13,12,1,Greece
34621,9/1/2021,GRD,Johor,0,0,0,Grenada
34622,9/1/2021,GRD,Kedah,0,0,0,Grenada
34623,9/1/2021,GRD,Pulau Pinang,0,0,0,Grenada
34624,9/1/2021,GRD,Sabah,0,0,0,Grenada
34625,9/1/2021,GRD,Sarawak,0,0,0,Grenada
34626,9/1/2021,GRD,Selangor,0,0,0,Grenada
34627,9/1/2021,GRL,Johor,0,0,0,Greenland
34628,9/1/2021,GRL,Selangor,0,0,0,Greenland
34629,9/1/2021,GTM,Johor,0,0,0,Guatemala
34630,9/1/2021,GTM,Kedah,0,0,0,Guatemala
34631,9/1/2021,GTM,Pahang,0,0,0,Guatemala
34632,9/1/2021,GTM,Perak,0,0,0,Guatemala
34633,9/1/2021,GTM,Pulau Pinang,0,0,0,Guatemala
34634,9/1/2021,GTM,Sabah,0,0,0,Guatemala
34635,9/1/2021,GTM,Sarawak,0,0,0,Guatemala
34636,9/1/2021,GTM,Selangor,0,0,0,Guatemala
34637,9/1/2021,GTM,W.P. Labuan,0,0,0,Guatemala
34638,9/1/2021,GUY,Johor,0,0,0,Guyana
34639,9/1/2021,GUY,Kedah,0,0,0,Guyana
34640,9/1/2021,GUY,Pulau Pinang,0,0,0,Guyana
34641,9/1/2021,GUY,Sarawak,0,0,0,Guyana
34642,9/1/2021,GUY,Selangor,0,0,0,Guyana
34643,9/1/2021,HKG,Johor,0,0,0,Hong Kong
34644,9/1/2021,HKG,Kedah,0,0,0,Hong Kong
34645,9/1/2021,HKG,Kelantan,0,0,0,Hong Kong
34646,9/1/2021,HKG,Pahang,0,0,0,Hong Kong
34647,9/1/2021,HKG,Perak,0,0,0,Hong Kong
34648,9/1/2021,HKG,Perlis,0,0,0,Hong Kong
34649,9/1/2021,HKG,Pulau Pinang,5,4,1,Hong Kong
34650,9/1/2021,HKG,Sabah,0,0,0,Hong Kong
34651,9/1/2021,HKG,Sarawak,6,4,2,Hong Kong
34652,9/1/2021,HKG,Selangor,0,0,0,Hong Kong
34653,9/1/2021,HKG,Terengganu,0,0,0,Hong Kong
34654,9/1/2021,HMD,Johor,0,0,0,Heard Island and McDonald Islands
34655,9/1/2021,HND,Johor,0,0,0,Honduras
34656,9/1/2021,HND,Kedah,0,0,0,Honduras
34657,9/1/2021,HND,Perak,0,0,0,Honduras
34658,9/1/2021,HND,Pulau Pinang,0,0,0,Honduras
34659,9/1/2021,HND,Sabah,0,0,0,Honduras
34660,9/1/2021,HND,Sarawak,0,0,0,Honduras
34661,9/1/2021,HND,Selangor,0,0,0,Honduras
34662,9/1/2021,HRV,Johor,1,1,0,Croatia
34663,9/1/2021,HRV,Kedah,0,0,0,Croatia
34664,9/1/2021,HRV,Kelantan,0,0,0,Croatia
34665,9/1/2021,HRV,Melaka,0,0,0,Croatia
34666,9/1/2021,HRV,Pahang,0,0,0,Croatia
34667,9/1/2021,HRV,Perak,0,0,0,Croatia
34668,9/1/2021,HRV,Perlis,0,0,0,Croatia
34669,9/1/2021,HRV,Pulau Pinang,0,0,0,Croatia
34670,9/1/2021,HRV,Sabah,0,0,0,Croatia
34671,9/1/2021,HRV,Sarawak,0,0,0,Croatia
34672,9/1/2021,HRV,Selangor,21,17,4,Croatia
34673,9/1/2021,HTI,Johor,0,0,0,Haiti
34674,9/1/2021,HTI,Kedah,0,0,0,Haiti
34675,9/1/2021,HTI,Kelantan,0,0,0,Haiti
34676,9/1/2021,HTI,Perak,0,0,0,Haiti
34677,9/1/2021,HTI,Pulau Pinang,0,0,0,Haiti
34678,9/1/2021,HTI,Sabah,0,0,0,Haiti
34679,9/1/2021,HTI,Selangor,0,0,0,Haiti
34680,9/1/2021,HUN,Johor,0,0,0,Hungary
34681,9/1/2021,HUN,Kedah,0,0,0,Hungary
34682,9/1/2021,HUN,Kelantan,0,0,0,Hungary
34683,9/1/2021,HUN,Pahang,0,0,0,Hungary
34684,9/1/2021,HUN,Perak,0,0,0,Hungary
34685,9/1/2021,HUN,Perlis,0,0,0,Hungary
34686,9/1/2021,HUN,Pulau Pinang,0,0,0,Hungary
34687,9/1/2021,HUN,Sabah,0,0,0,Hungary
34688,9/1/2021,HUN,Sarawak,0,0,0,Hungary
34689,9/1/2021,HUN,Selangor,17,8,9,Hungary
34690,9/1/2021,HUN,W.P. Labuan,0,0,0,Hungary
34691,9/1/2021,IDN,Johor,64,50,14,Indonesia
34692,9/1/2021,IDN,Kedah,7,7,0,Indonesia
34693,9/1/2021,IDN,Kelantan,0,0,0,Indonesia
34694,9/1/2021,IDN,Melaka,0,0,0,Indonesia
34695,9/1/2021,IDN,Negeri Sembilan,0,0,0,Indonesia
34696,9/1/2021,IDN,Pahang,0,0,0,Indonesia
34697,9/1/2021,IDN,Perak,0,0,0,Indonesia
34698,9/1/2021,IDN,Perlis,5,5,0,Indonesia
34699,9/1/2021,IDN,Pulau Pinang,11,5,6,Indonesia
34700,9/1/2021,IDN,Sabah,0,0,0,Indonesia
34701,9/1/2021,IDN,Sarawak,136,131,5,Indonesia
34702,9/1/2021,IDN,Selangor,972,608,364,Indonesia
34703,9/1/2021,IDN,Terengganu,1,1,0,Indonesia
34704,9/1/2021,IDN,W.P. Labuan,1,1,0,Indonesia
34705,9/1/2021,IND,Johor,2,2,0,India
34706,9/1/2021,IND,Kedah,0,0,0,India
34707,9/1/2021,IND,Kelantan,0,0,0,India
34708,9/1/2021,IND,Melaka,0,0,0,India
34709,9/1/2021,IND,Negeri Sembilan,0,0,0,India
34710,9/1/2021,IND,Pahang,0,0,0,India
34711,9/1/2021,IND,Perak,0,0,0,India
34712,9/1/2021,IND,Perlis,0,0,0,India
34713,9/1/2021,IND,Pulau Pinang,0,0,0,India
34714,9/1/2021,IND,Sabah,0,0,0,India
34715,9/1/2021,IND,Sarawak,2,2,0,India
34716,9/1/2021,IND,Selangor,180,131,49,India
34717,9/1/2021,IND,Terengganu,0,0,0,India
34718,9/1/2021,IND,W.P. Labuan,0,0,0,India
34719,9/1/2021,IOT,Pulau Pinang,0,0,0,British Indian Ocean Territory
34720,9/1/2021,IOT,Selangor,0,0,0,British Indian Ocean Territory
34721,9/1/2021,IRL,Johor,0,0,0,Ireland
34722,9/1/2021,IRL,Kedah,0,0,0,Ireland
34723,9/1/2021,IRL,Kelantan,0,0,0,Ireland
34724,9/1/2021,IRL,Negeri Sembilan,0,0,0,Ireland
34725,9/1/2021,IRL,Pahang,0,0,0,Ireland
34726,9/1/2021,IRL,Perak,0,0,0,Ireland
34727,9/1/2021,IRL,Perlis,0,0,0,Ireland
34728,9/1/2021,IRL,Pulau Pinang,0,0,0,Ireland
34729,9/1/2021,IRL,Sabah,0,0,0,Ireland
34730,9/1/2021,IRL,Sarawak,0,0,0,Ireland
34731,9/1/2021,IRL,Selangor,15,10,5,Ireland
34732,9/1/2021,IRL,Terengganu,0,0,0,Ireland
34733,9/1/2021,IRL,W.P. Labuan,0,0,0,Ireland
34734,9/1/2021,IRN,Johor,0,0,0,Iran
34735,9/1/2021,IRN,Kedah,0,0,0,Iran
34736,9/1/2021,IRN,Kelantan,0,0,0,Iran
34737,9/1/2021,IRN,Perak,0,0,0,Iran
34738,9/1/2021,IRN,Perlis,0,0,0,Iran
34739,9/1/2021,IRN,Pulau Pinang,0,0,0,Iran
34740,9/1/2021,IRN,Sabah,0,0,0,Iran
34741,9/1/2021,IRN,Sarawak,0,0,0,Iran
34742,9/1/2021,IRN,Selangor,45,27,18,Iran
34743,9/1/2021,IRN,W.P. Labuan,0,0,0,Iran
34744,9/1/2021,IRQ,Johor,0,0,0,Iraq
34745,9/1/2021,IRQ,Kedah,0,0,0,Iraq
34746,9/1/2021,IRQ,Kelantan,0,0,0,Iraq
34747,9/1/2021,IRQ,Melaka,0,0,0,Iraq
34748,9/1/2021,IRQ,Pahang,0,0,0,Iraq
34749,9/1/2021,IRQ,Perak,0,0,0,Iraq
34750,9/1/2021,IRQ,Perlis,0,0,0,Iraq
34751,9/1/2021,IRQ,Pulau Pinang,0,0,0,Iraq
34752,9/1/2021,IRQ,Sabah,0,0,0,Iraq
34753,9/1/2021,IRQ,Sarawak,0,0,0,Iraq
34754,9/1/2021,IRQ,Selangor,47,35,12,Iraq
34755,9/1/2021,ISL,Johor,0,0,0,Iceland
34756,9/1/2021,ISL,Kedah,0,0,0,Iceland
34757,9/1/2021,ISL,Kelantan,0,0,0,Iceland
34758,9/1/2021,ISL,Perak,0,0,0,Iceland
34759,9/1/2021,ISL,Perlis,0,0,0,Iceland
34760,9/1/2021,ISL,Pulau Pinang,0,0,0,Iceland
34761,9/1/2021,ISL,Sabah,0,0,0,Iceland
34762,9/1/2021,ISL,Sarawak,0,0,0,Iceland
34763,9/1/2021,ISL,Selangor,1,1,0,Iceland
34764,9/1/2021,ISL,W.P. Labuan,0,0,0,Iceland
34765,9/1/2021,ISR,Pulau Pinang,0,0,0,Israel
34766,9/1/2021,ITA,Johor,0,0,0,Italy
34767,9/1/2021,ITA,Kedah,0,0,0,Italy
34768,9/1/2021,ITA,Kelantan,0,0,0,Italy
34769,9/1/2021,ITA,Melaka,0,0,0,Italy
34770,9/1/2021,ITA,Negeri Sembilan,0,0,0,Italy
34771,9/1/2021,ITA,Pahang,0,0,0,Italy
34772,9/1/2021,ITA,Perak,0,0,0,Italy
34773,9/1/2021,ITA,Perlis,0,0,0,Italy
34774,9/1/2021,ITA,Pulau Pinang,2,2,0,Italy
34775,9/1/2021,ITA,Sabah,0,0,0,Italy
34776,9/1/2021,ITA,Sarawak,0,0,0,Italy
34777,9/1/2021,ITA,Selangor,83,62,21,Italy
34778,9/1/2021,ITA,W.P. Labuan,0,0,0,Italy
34779,9/1/2021,JAM,Johor,0,0,0,Jamaica
34780,9/1/2021,JAM,Kedah,0,0,0,Jamaica
34781,9/1/2021,JAM,Perak,0,0,0,Jamaica
34782,9/1/2021,JAM,Pulau Pinang,0,0,0,Jamaica
34783,9/1/2021,JAM,Sabah,0,0,0,Jamaica
34784,9/1/2021,JAM,Sarawak,0,0,0,Jamaica
34785,9/1/2021,JAM,Selangor,1,1,0,Jamaica
34786,9/1/2021,JAM,W.P. Labuan,0,0,0,Jamaica
34787,9/1/2021,JOR,Johor,0,0,0,Jordan
34788,9/1/2021,JOR,Kedah,0,0,0,Jordan
34789,9/1/2021,JOR,Kelantan,0,0,0,Jordan
34790,9/1/2021,JOR,Melaka,0,0,0,Jordan
34791,9/1/2021,JOR,Perlis,0,0,0,Jordan
34792,9/1/2021,JOR,Pulau Pinang,0,0,0,Jordan
34793,9/1/2021,JOR,Sabah,0,0,0,Jordan
34794,9/1/2021,JOR,Sarawak,0,0,0,Jordan
34795,9/1/2021,JOR,Selangor,39,26,13,Jordan
34796,9/1/2021,JOR,W.P. Labuan,0,0,0,Jordan
34797,9/1/2021,JPN,Johor,0,0,0,Japan
34798,9/1/2021,JPN,Kedah,0,0,0,Japan
34799,9/1/2021,JPN,Kelantan,0,0,0,Japan
34800,9/1/2021,JPN,Melaka,0,0,0,Japan
34801,9/1/2021,JPN,Negeri Sembilan,0,0,0,Japan
34802,9/1/2021,JPN,Pahang,0,0,0,Japan
34803,9/1/2021,JPN,Perak,0,0,0,Japan
34804,9/1/2021,JPN,Perlis,0,0,0,Japan
34805,9/1/2021,JPN,Pulau Pinang,31,16,15,Japan
34806,9/1/2021,JPN,Sabah,0,0,0,Japan
34807,9/1/2021,JPN,Sarawak,2,2,0,Japan
34808,9/1/2021,JPN,Selangor,637,428,209,Japan
34809,9/1/2021,JPN,W.P. Labuan,0,0,0,Japan
34810,9/1/2021,KAZ,Johor,0,0,0,Kazakhstan
34811,9/1/2021,KAZ,Kedah,0,0,0,Kazakhstan
34812,9/1/2021,KAZ,Kelantan,0,0,0,Kazakhstan
34813,9/1/2021,KAZ,Melaka,0,0,0,Kazakhstan
34814,9/1/2021,KAZ,Perak,0,0,0,Kazakhstan
34815,9/1/2021,KAZ,Perlis,0,0,0,Kazakhstan
34816,9/1/2021,KAZ,Pulau Pinang,0,0,0,Kazakhstan
34817,9/1/2021,KAZ,Sabah,0,0,0,Kazakhstan
34818,9/1/2021,KAZ,Sarawak,0,0,0,Kazakhstan
34819,9/1/2021,KAZ,Selangor,36,15,21,Kazakhstan
34820,9/1/2021,KAZ,W.P. Labuan,0,0,0,Kazakhstan
34821,9/1/2021,KEN,Johor,0,0,0,Kenya
34822,9/1/2021,KEN,Kedah,0,0,0,Kenya
34823,9/1/2021,KEN,Kelantan,0,0,0,Kenya
34824,9/1/2021,KEN,Perak,0,0,0,Kenya
34825,9/1/2021,KEN,Perlis,0,0,0,Kenya
34826,9/1/2021,KEN,Pulau Pinang,0,0,0,Kenya
34827,9/1/2021,KEN,Sabah,0,0,0,Kenya
34828,9/1/2021,KEN,Sarawak,0,0,0,Kenya
34829,9/1/2021,KEN,Selangor,37,27,10,Kenya
34830,9/1/2021,KGZ,Johor,0,0,0,Kyrgyzstan
34831,9/1/2021,KGZ,Kedah,0,0,0,Kyrgyzstan
34832,9/1/2021,KGZ,Kelantan,0,0,0,Kyrgyzstan
34833,9/1/2021,KGZ,Perak,0,0,0,Kyrgyzstan
34834,9/1/2021,KGZ,Perlis,0,0,0,Kyrgyzstan
34835,9/1/2021,KGZ,Pulau Pinang,0,0,0,Kyrgyzstan
34836,9/1/2021,KGZ,Sabah,0,0,0,Kyrgyzstan
34837,9/1/2021,KGZ,Sarawak,0,0,0,Kyrgyzstan
34838,9/1/2021,KGZ,Selangor,0,0,0,Kyrgyzstan
34839,9/1/2021,KHM,Johor,0,0,0,Cambodia
34840,9/1/2021,KHM,Kedah,0,0,0,Cambodia
34841,9/1/2021,KHM,Kelantan,0,0,0,Cambodia
34842,9/1/2021,KHM,Melaka,0,0,0,Cambodia
34843,9/1/2021,KHM,Negeri Sembilan,0,0,0,Cambodia
34844,9/1/2021,KHM,Pahang,0,0,0,Cambodia
34845,9/1/2021,KHM,Perak,0,0,0,Cambodia
34846,9/1/2021,KHM,Perlis,0,0,0,Cambodia
34847,9/1/2021,KHM,Pulau Pinang,1,0,1,Cambodia
34848,9/1/2021,KHM,Sabah,0,0,0,Cambodia
34849,9/1/2021,KHM,Sarawak,0,0,0,Cambodia
34850,9/1/2021,KHM,Selangor,1,1,0,Cambodia
34851,9/1/2021,KHM,W.P. Labuan,0,0,0,Cambodia
34852,9/1/2021,KIR,Johor,0,0,0,Kiribati
34853,9/1/2021,KIR,Sabah,0,0,0,Kiribati
34854,9/1/2021,KIR,Selangor,0,0,0,Kiribati
34855,9/1/2021,KNA,Johor,0,0,0,Saint Kitts and Nevis
34856,9/1/2021,KNA,Kedah,0,0,0,Saint Kitts and Nevis
34857,9/1/2021,KNA,Perlis,0,0,0,Saint Kitts and Nevis
34858,9/1/2021,KNA,Pulau Pinang,0,0,0,Saint Kitts and Nevis
34859,9/1/2021,KNA,Sabah,0,0,0,Saint Kitts and Nevis
34860,9/1/2021,KNA,Selangor,1,1,0,Saint Kitts and Nevis
34861,9/1/2021,KNA,W.P. Labuan,0,0,0,Saint Kitts and Nevis
34862,9/1/2021,KOR,Johor,0,0,0,"Korea, Republic of (South Korea)"
34863,9/1/2021,KOR,Kedah,0,0,0,"Korea, Republic of (South Korea)"
34864,9/1/2021,KOR,Kelantan,0,0,0,"Korea, Republic of (South Korea)"
34865,9/1/2021,KOR,Melaka,0,0,0,"Korea, Republic of (South Korea)"
34866,9/1/2021,KOR,Negeri Sembilan,0,0,0,"Korea, Republic of (South Korea)"
34867,9/1/2021,KOR,Pahang,0,0,0,"Korea, Republic of (South Korea)"
34868,9/1/2021,KOR,Perak,0,0,0,"Korea, Republic of (South Korea)"
34869,9/1/2021,KOR,Perlis,0,0,0,"Korea, Republic of (South Korea)"
34870,9/1/2021,KOR,Pulau Pinang,15,7,8,"Korea, Republic of (South Korea)"
34871,9/1/2021,KOR,Sabah,0,0,0,"Korea, Republic of (South Korea)"
34872,9/1/2021,KOR,Sarawak,49,48,1,"Korea, Republic of (South Korea)"
34873,9/1/2021,KOR,Selangor,323,194,129,"Korea, Republic of (South Korea)"
34874,9/1/2021,KOR,Terengganu,0,0,0,"Korea, Republic of (South Korea)"
34875,9/1/2021,KOR,W.P. Labuan,0,0,0,"Korea, Republic of (South Korea)"
34876,9/1/2021,KWT,Johor,0,0,0,Kuwait
34877,9/1/2021,KWT,Kedah,0,0,0,Kuwait
34878,9/1/2021,KWT,Kelantan,0,0,0,Kuwait
34879,9/1/2021,KWT,Perak,0,0,0,Kuwait
34880,9/1/2021,KWT,Perlis,0,0,0,Kuwait
34881,9/1/2021,KWT,Pulau Pinang,0,0,0,Kuwait
34882,9/1/2021,KWT,Sabah,0,0,0,Kuwait
34883,9/1/2021,KWT,Sarawak,0,0,0,Kuwait
34884,9/1/2021,KWT,Selangor,2,2,0,Kuwait
34885,9/1/2021,KWT,W.P. Labuan,0,0,0,Kuwait
34886,9/1/2021,LAO,Johor,0,0,0,Lao People's Democratic Republic
34887,9/1/2021,LAO,Kedah,0,0,0,Lao People's Democratic Republic
34888,9/1/2021,LAO,Kelantan,0,0,0,Lao People's Democratic Republic
34889,9/1/2021,LAO,Melaka,0,0,0,Lao People's Democratic Republic
34890,9/1/2021,LAO,Perak,0,0,0,Lao People's Democratic Republic
34891,9/1/2021,LAO,Perlis,0,0,0,Lao People's Democratic Republic
34892,9/1/2021,LAO,Pulau Pinang,0,0,0,Lao People's Democratic Republic
34893,9/1/2021,LAO,Sabah,0,0,0,Lao People's Democratic Republic
34894,9/1/2021,LAO,Sarawak,0,0,0,Lao People's Democratic Republic
34895,9/1/2021,LAO,Selangor,23,23,0,Lao People's Democratic Republic
34896,9/1/2021,LAO,W.P. Labuan,0,0,0,Lao People's Democratic Republic
34897,9/1/2021,LBN,Johor,0,0,0,Lebanon
34898,9/1/2021,LBN,Kedah,0,0,0,Lebanon
34899,9/1/2021,LBN,Kelantan,0,0,0,Lebanon
34900,9/1/2021,LBN,Pahang,0,0,0,Lebanon
34901,9/1/2021,LBN,Perak,0,0,0,Lebanon
34902,9/1/2021,LBN,Perlis,0,0,0,Lebanon
34903,9/1/2021,LBN,Pulau Pinang,0,0,0,Lebanon
34904,9/1/2021,LBN,Sabah,0,0,0,Lebanon
34905,9/1/2021,LBN,Sarawak,0,0,0,Lebanon
34906,9/1/2021,LBN,Selangor,7,4,3,Lebanon
34907,9/1/2021,LBN,W.P. Labuan,0,0,0,Lebanon
34908,9/1/2021,LBR,Johor,0,0,0,Liberia
34909,9/1/2021,LBR,Kedah,0,0,0,Liberia
34910,9/1/2021,LBR,Sabah,0,0,0,Liberia
34911,9/1/2021,LBR,Sarawak,0,0,0,Liberia
34912,9/1/2021,LBR,Selangor,2,2,0,Liberia
34913,9/1/2021,LBY,Johor,0,0,0,Libyan Arab Jamahiriya
34914,9/1/2021,LBY,Kedah,0,0,0,Libyan Arab Jamahiriya
34915,9/1/2021,LBY,Perlis,0,0,0,Libyan Arab Jamahiriya
34916,9/1/2021,LBY,Pulau Pinang,0,0,0,Libyan Arab Jamahiriya
34917,9/1/2021,LBY,Sabah,0,0,0,Libyan Arab Jamahiriya
34918,9/1/2021,LBY,Sarawak,0,0,0,Libyan Arab Jamahiriya
34919,9/1/2021,LBY,Selangor,41,36,5,Libyan Arab Jamahiriya
34920,9/1/2021,LCA,Johor,0,0,0,Saint Lucia
34921,9/1/2021,LCA,Kedah,0,0,0,Saint Lucia
34922,9/1/2021,LCA,Pulau Pinang,0,0,0,Saint Lucia
34923,9/1/2021,LCA,Sarawak,0,0,0,Saint Lucia
34924,9/1/2021,LCA,Selangor,0,0,0,Saint Lucia
34925,9/1/2021,LIE,Johor,0,0,0,Liechtenstein
34926,9/1/2021,LIE,Kedah,0,0,0,Liechtenstein
34927,9/1/2021,LIE,Perlis,0,0,0,Liechtenstein
34928,9/1/2021,LIE,Pulau Pinang,0,0,0,Liechtenstein
34929,9/1/2021,LIE,Sabah,0,0,0,Liechtenstein
34930,9/1/2021,LIE,Sarawak,0,0,0,Liechtenstein
34931,9/1/2021,LIE,Selangor,0,0,0,Liechtenstein
34932,9/1/2021,LKA,Johor,0,0,0,Sri Lanka
34933,9/1/2021,LKA,Kedah,0,0,0,Sri Lanka
34934,9/1/2021,LKA,Kelantan,0,0,0,Sri Lanka
34935,9/1/2021,LKA,Melaka,0,0,0,Sri Lanka
34936,9/1/2021,LKA,Pahang,0,0,0,Sri Lanka
34937,9/1/2021,LKA,Perak,0,0,0,Sri Lanka
34938,9/1/2021,LKA,Perlis,0,0,0,Sri Lanka
34939,9/1/2021,LKA,Pulau Pinang,0,0,0,Sri Lanka
34940,9/1/2021,LKA,Sabah,0,0,0,Sri Lanka
34941,9/1/2021,LKA,Sarawak,0,0,0,Sri Lanka
34942,9/1/2021,LKA,Selangor,4,4,0,Sri Lanka
34943,9/1/2021,LKA,W.P. Labuan,0,0,0,Sri Lanka
34944,9/1/2021,LSO,Johor,0,0,0,Lesotho
34945,9/1/2021,LSO,Kedah,0,0,0,Lesotho
34946,9/1/2021,LSO,Pulau Pinang,0,0,0,Lesotho
34947,9/1/2021,LSO,Sarawak,0,0,0,Lesotho
34948,9/1/2021,LSO,Selangor,0,0,0,Lesotho
34949,9/1/2021,LTU,Johor,0,0,0,Lithuania
34950,9/1/2021,LTU,Kedah,0,0,0,Lithuania
34951,9/1/2021,LTU,Kelantan,0,0,0,Lithuania
34952,9/1/2021,LTU,Pahang,0,0,0,Lithuania
34953,9/1/2021,LTU,Perak,0,0,0,Lithuania
34954,9/1/2021,LTU,Perlis,0,0,0,Lithuania
34955,9/1/2021,LTU,Pulau Pinang,0,0,0,Lithuania
34956,9/1/2021,LTU,Sabah,0,0,0,Lithuania
34957,9/1/2021,LTU,Sarawak,0,0,0,Lithuania
34958,9/1/2021,LTU,Selangor,6,3,3,Lithuania
34959,9/1/2021,LTU,W.P. Labuan,0,0,0,Lithuania
34960,9/1/2021,LUX,Johor,0,0,0,Luxembourg
34961,9/1/2021,LUX,Kedah,0,0,0,Luxembourg
34962,9/1/2021,LUX,Kelantan,0,0,0,Luxembourg
34963,9/1/2021,LUX,Perak,0,0,0,Luxembourg
34964,9/1/2021,LUX,Perlis,0,0,0,Luxembourg
34965,9/1/2021,LUX,Pulau Pinang,0,0,0,Luxembourg
34966,9/1/2021,LUX,Sabah,0,0,0,Luxembourg
34967,9/1/2021,LUX,Sarawak,0,0,0,Luxembourg
34968,9/1/2021,LUX,Selangor,1,1,0,Luxembourg
34969,9/1/2021,LVA,Johor,0,0,0,Latvia
34970,9/1/2021,LVA,Kedah,0,0,0,Latvia
34971,9/1/2021,LVA,Kelantan,0,0,0,Latvia
34972,9/1/2021,LVA,Pahang,0,0,0,Latvia
34973,9/1/2021,LVA,Perak,0,0,0,Latvia
34974,9/1/2021,LVA,Perlis,0,0,0,Latvia
34975,9/1/2021,LVA,Pulau Pinang,0,0,0,Latvia
34976,9/1/2021,LVA,Sabah,0,0,0,Latvia
34977,9/1/2021,LVA,Sarawak,0,0,0,Latvia
34978,9/1/2021,LVA,Selangor,4,2,2,Latvia
34979,9/1/2021,LVA,W.P. Labuan,0,0,0,Latvia
34980,9/1/2021,MAC,Johor,0,0,0,Macao
34981,9/1/2021,MAC,Pahang,0,0,0,Macao
34982,9/1/2021,MAC,Perak,0,0,0,Macao
34983,9/1/2021,MAC,Selangor,0,0,0,Macao
34984,9/1/2021,MAC,W.P. Labuan,0,0,0,Macao
34985,9/1/2021,MAR,Johor,0,0,0,Morocco
34986,9/1/2021,MAR,Kedah,0,0,0,Morocco
34987,9/1/2021,MAR,Kelantan,0,0,0,Morocco
34988,9/1/2021,MAR,Melaka,0,0,0,Morocco
34989,9/1/2021,MAR,Pahang,0,0,0,Morocco
34990,9/1/2021,MAR,Perak,0,0,0,Morocco
34991,9/1/2021,MAR,Perlis,0,0,0,Morocco
34992,9/1/2021,MAR,Pulau Pinang,0,0,0,Morocco
34993,9/1/2021,MAR,Sabah,0,0,0,Morocco
34994,9/1/2021,MAR,Sarawak,0,0,0,Morocco
34995,9/1/2021,MAR,Selangor,16,8,8,Morocco
34996,9/1/2021,MAR,W.P. Labuan,0,0,0,Morocco
34997,9/1/2021,MCO,Johor,0,0,0,Monaco
34998,9/1/2021,MCO,Kedah,0,0,0,Monaco
34999,9/1/2021,MCO,Sabah,0,0,0,Monaco
35000,9/1/2021,MCO,Selangor,0,0,0,Monaco
35001,9/1/2021,MDA,Johor,0,0,0,"Moldova, Republic of"
35002,9/1/2021,MDA,Kedah,0,0,0,"Moldova, Republic of"
35003,9/1/2021,MDA,Kelantan,1,1,0,"Moldova, Republic of"
35004,9/1/2021,MDA,Negeri Sembilan,0,0,0,"Moldova, Republic of"
35005,9/1/2021,MDA,Perlis,0,0,0,"Moldova, Republic of"
35006,9/1/2021,MDA,Pulau Pinang,0,0,0,"Moldova, Republic of"
35007,9/1/2021,MDA,Sabah,0,0,0,"Moldova, Republic of"
35008,9/1/2021,MDA,Sarawak,0,0,0,"Moldova, Republic of"
35009,9/1/2021,MDA,Selangor,0,0,0,"Moldova, Republic of"
35010,9/1/2021,MDG,Johor,0,0,0,Madagascar
35011,9/1/2021,MDG,Kedah,0,0,0,Madagascar
35012,9/1/2021,MDG,Perak,0,0,0,Madagascar
35013,9/1/2021,MDG,Perlis,0,0,0,Madagascar
35014,9/1/2021,MDG,Pulau Pinang,0,0,0,Madagascar
35015,9/1/2021,MDG,Sabah,0,0,0,Madagascar
35016,9/1/2021,MDG,Sarawak,0,0,0,Madagascar
35017,9/1/2021,MDG,Selangor,0,0,0,Madagascar
35018,9/1/2021,MDV,Johor,0,0,0,Maldives
35019,9/1/2021,MDV,Kedah,0,0,0,Maldives
35020,9/1/2021,MDV,Kelantan,0,0,0,Maldives
35021,9/1/2021,MDV,Perak,0,0,0,Maldives
35022,9/1/2021,MDV,Perlis,0,0,0,Maldives
35023,9/1/2021,MDV,Pulau Pinang,0,0,0,Maldives
35024,9/1/2021,MDV,Sabah,0,0,0,Maldives
35025,9/1/2021,MDV,Sarawak,0,0,0,Maldives
35026,9/1/2021,MDV,Selangor,52,20,32,Maldives
35027,9/1/2021,MEX,Johor,0,0,0,Mexico
35028,9/1/2021,MEX,Kedah,0,0,0,Mexico
35029,9/1/2021,MEX,Kelantan,0,0,0,Mexico
35030,9/1/2021,MEX,Pahang,0,0,0,Mexico
35031,9/1/2021,MEX,Perak,0,0,0,Mexico
35032,9/1/2021,MEX,Perlis,0,0,0,Mexico
35033,9/1/2021,MEX,Pulau Pinang,2,1,1,Mexico
35034,9/1/2021,MEX,Sabah,0,0,0,Mexico
35035,9/1/2021,MEX,Sarawak,0,0,0,Mexico
35036,9/1/2021,MEX,Selangor,10,7,3,Mexico
35037,9/1/2021,MEX,W.P. Labuan,0,0,0,Mexico
35038,9/1/2021,MHL,Johor,0,0,0,Marshall Islands
35039,9/1/2021,MHL,Kedah,0,0,0,Marshall Islands
35040,9/1/2021,MHL,Perak,0,0,0,Marshall Islands
35041,9/1/2021,MHL,Pulau Pinang,0,0,0,Marshall Islands
35042,9/1/2021,MHL,Sabah,0,0,0,Marshall Islands
35043,9/1/2021,MHL,Selangor,0,0,0,Marshall Islands
35044,9/1/2021,MKD,Johor,0,0,0,"Macedonia, the former Yugoslav Republic of"
35045,9/1/2021,MKD,Kedah,0,0,0,"Macedonia, the former Yugoslav Republic of"
35046,9/1/2021,MKD,Perak,0,0,0,"Macedonia, the former Yugoslav Republic of"
35047,9/1/2021,MKD,Pulau Pinang,0,0,0,"Macedonia, the former Yugoslav Republic of"
35048,9/1/2021,MKD,Sabah,0,0,0,"Macedonia, the former Yugoslav Republic of"
35049,9/1/2021,MKD,Sarawak,0,0,0,"Macedonia, the former Yugoslav Republic of"
35050,9/1/2021,MKD,Selangor,0,0,0,"Macedonia, the former Yugoslav Republic of"
35051,9/1/2021,MLI,Johor,0,0,0,Mali
35052,9/1/2021,MLI,Sabah,0,0,0,Mali
35053,9/1/2021,MLI,Selangor,0,0,0,Mali
35054,9/1/2021,MLT,Johor,0,0,0,Malta
35055,9/1/2021,MLT,Kedah,0,0,0,Malta
35056,9/1/2021,MLT,Kelantan,0,0,0,Malta
35057,9/1/2021,MLT,Perak,0,0,0,Malta
35058,9/1/2021,MLT,Perlis,0,0,0,Malta
35059,9/1/2021,MLT,Pulau Pinang,0,0,0,Malta
35060,9/1/2021,MLT,Sabah,0,0,0,Malta
35061,9/1/2021,MLT,Sarawak,0,0,0,Malta
35062,9/1/2021,MLT,Selangor,2,2,0,Malta
35063,9/1/2021,MLT,W.P. Labuan,0,0,0,Malta
35064,9/1/2021,MMR,Johor,0,0,0,Myanmar
35065,9/1/2021,MMR,Kedah,0,0,0,Myanmar
35066,9/1/2021,MMR,Kelantan,0,0,0,Myanmar
35067,9/1/2021,MMR,Negeri Sembilan,0,0,0,Myanmar
35068,9/1/2021,MMR,Pahang,0,0,0,Myanmar
35069,9/1/2021,MMR,Perak,0,0,0,Myanmar
35070,9/1/2021,MMR,Perlis,0,0,0,Myanmar
35071,9/1/2021,MMR,Pulau Pinang,0,0,0,Myanmar
35072,9/1/2021,MMR,Sabah,0,0,0,Myanmar
35073,9/1/2021,MMR,Sarawak,0,0,0,Myanmar
35074,9/1/2021,MMR,Selangor,161,135,26,Myanmar
35075,9/1/2021,MMR,Terengganu,0,0,0,Myanmar
35076,9/1/2021,MMR,W.P. Labuan,0,0,0,Myanmar
35077,9/1/2021,MNE,Johor,0,0,0,Montenegro
35078,9/1/2021,MNE,Kedah,0,0,0,Montenegro
35079,9/1/2021,MNE,Pulau Pinang,0,0,0,Montenegro
35080,9/1/2021,MNE,Sabah,0,0,0,Montenegro
35081,9/1/2021,MNE,Sarawak,0,0,0,Montenegro
35082,9/1/2021,MNE,Selangor,5,5,0,Montenegro
35083,9/1/2021,MNG,Johor,0,0,0,Mongolia
35084,9/1/2021,MNG,Kedah,0,0,0,Mongolia
35085,9/1/2021,MNG,Kelantan,0,0,0,Mongolia
35086,9/1/2021,MNG,Perak,0,0,0,Mongolia
35087,9/1/2021,MNG,Perlis,0,0,0,Mongolia
35088,9/1/2021,MNG,Pulau Pinang,0,0,0,Mongolia
35089,9/1/2021,MNG,Sabah,0,0,0,Mongolia
35090,9/1/2021,MNG,Sarawak,0,0,0,Mongolia
35091,9/1/2021,MNG,Selangor,2,0,2,Mongolia
35092,9/1/2021,MNP,Selangor,0,0,0,Northern Mariana Islands
35093,9/1/2021,MOZ,Johor,0,0,0,Mozambique
35094,9/1/2021,MOZ,Kedah,0,0,0,Mozambique
35095,9/1/2021,MOZ,Perak,0,0,0,Mozambique
35096,9/1/2021,MOZ,Pulau Pinang,0,0,0,Mozambique
35097,9/1/2021,MOZ,Sabah,0,0,0,Mozambique
35098,9/1/2021,MOZ,Sarawak,0,0,0,Mozambique
35099,9/1/2021,MOZ,Selangor,3,2,1,Mozambique
35100,9/1/2021,MRT,Johor,0,0,0,Mauritania
35101,9/1/2021,MRT,Kedah,0,0,0,Mauritania
35102,9/1/2021,MRT,Pulau Pinang,0,0,0,Mauritania
35103,9/1/2021,MRT,Sabah,0,0,0,Mauritania
35104,9/1/2021,MRT,Sarawak,0,0,0,Mauritania
35105,9/1/2021,MRT,Selangor,5,4,1,Mauritania
35106,9/1/2021,MUS,Johor,0,0,0,Mauritius
35107,9/1/2021,MUS,Kedah,0,0,0,Mauritius
35108,9/1/2021,MUS,Kelantan,0,0,0,Mauritius
35109,9/1/2021,MUS,Pahang,0,0,0,Mauritius
35110,9/1/2021,MUS,Perak,0,0,0,Mauritius
35111,9/1/2021,MUS,Perlis,0,0,0,Mauritius
35112,9/1/2021,MUS,Pulau Pinang,0,0,0,Mauritius
35113,9/1/2021,MUS,Sabah,0,0,0,Mauritius
35114,9/1/2021,MUS,Sarawak,0,0,0,Mauritius
35115,9/1/2021,MUS,Selangor,7,4,3,Mauritius
35116,9/1/2021,MWI,Johor,0,0,0,Malawi
35117,9/1/2021,MWI,Pulau Pinang,0,0,0,Malawi
35118,9/1/2021,MWI,Sabah,0,0,0,Malawi
35119,9/1/2021,MWI,Sarawak,0,0,0,Malawi
35120,9/1/2021,MWI,Selangor,0,0,0,Malawi
35121,9/1/2021,MYT,Selangor,0,0,0,Mayotte
35122,9/1/2021,NAM,Johor,0,0,0,Namibia
35123,9/1/2021,NAM,Kedah,0,0,0,Namibia
35124,9/1/2021,NAM,Perak,0,0,0,Namibia
35125,9/1/2021,NAM,Perlis,0,0,0,Namibia
35126,9/1/2021,NAM,Pulau Pinang,0,0,0,Namibia
35127,9/1/2021,NAM,Sabah,0,0,0,Namibia
35128,9/1/2021,NAM,Sarawak,0,0,0,Namibia
35129,9/1/2021,NAM,Selangor,3,1,2,Namibia
35130,9/1/2021,NCL,Selangor,0,0,0,New Caledonia
35131,9/1/2021,NER,Johor,0,0,0,Niger
35132,9/1/2021,NER,Sabah,0,0,0,Niger
35133,9/1/2021,NER,Selangor,1,1,0,Niger
35134,9/1/2021,NGA,Johor,0,0,0,Nigeria
35135,9/1/2021,NGA,Kedah,0,0,0,Nigeria
35136,9/1/2021,NGA,Perlis,0,0,0,Nigeria
35137,9/1/2021,NGA,Pulau Pinang,0,0,0,Nigeria
35138,9/1/2021,NGA,Sabah,0,0,0,Nigeria
35139,9/1/2021,NGA,Sarawak,0,0,0,Nigeria
35140,9/1/2021,NGA,Selangor,94,86,8,Nigeria
35141,9/1/2021,NIC,Johor,0,0,0,Nicaragua
35142,9/1/2021,NIC,Kedah,0,0,0,Nicaragua
35143,9/1/2021,NIC,Pulau Pinang,0,0,0,Nicaragua
35144,9/1/2021,NIC,Sabah,0,0,0,Nicaragua
35145,9/1/2021,NIC,Selangor,0,0,0,Nicaragua
35146,9/1/2021,NLD,Johor,0,0,0,Netherlands
35147,9/1/2021,NLD,Kedah,0,0,0,Netherlands
35148,9/1/2021,NLD,Kelantan,0,0,0,Netherlands
35149,9/1/2021,NLD,Melaka,0,0,0,Netherlands
35150,9/1/2021,NLD,Negeri Sembilan,0,0,0,Netherlands
35151,9/1/2021,NLD,Pahang,0,0,0,Netherlands
35152,9/1/2021,NLD,Perak,0,0,0,Netherlands
35153,9/1/2021,NLD,Perlis,0,0,0,Netherlands
35154,9/1/2021,NLD,Pulau Pinang,2,2,0,Netherlands
35155,9/1/2021,NLD,Sabah,0,0,0,Netherlands
35156,9/1/2021,NLD,Sarawak,1,1,0,Netherlands
35157,9/1/2021,NLD,Selangor,90,56,34,Netherlands
35158,9/1/2021,NLD,Terengganu,0,0,0,Netherlands
35159,9/1/2021,NLD,W.P. Labuan,0,0,0,Netherlands
35160,9/1/2021,NOR,Johor,0,0,0,Norway
35161,9/1/2021,NOR,Kedah,0,0,0,Norway
35162,9/1/2021,NOR,Kelantan,0,0,0,Norway
35163,9/1/2021,NOR,Melaka,0,0,0,Norway
35164,9/1/2021,NOR,Pahang,0,0,0,Norway
35165,9/1/2021,NOR,Perak,0,0,0,Norway
35166,9/1/2021,NOR,Perlis,0,0,0,Norway
35167,9/1/2021,NOR,Pulau Pinang,0,0,0,Norway
35168,9/1/2021,NOR,Sabah,0,0,0,Norway
35169,9/1/2021,NOR,Sarawak,2,2,0,Norway
35170,9/1/2021,NOR,Selangor,19,15,4,Norway
35171,9/1/2021,NOR,W.P. Labuan,0,0,0,Norway
35172,9/1/2021,NPL,Johor,0,0,0,Nepal
35173,9/1/2021,NPL,Kedah,0,0,0,Nepal
35174,9/1/2021,NPL,Pahang,0,0,0,Nepal
35175,9/1/2021,NPL,Perak,0,0,0,Nepal
35176,9/1/2021,NPL,Perlis,0,0,0,Nepal
35177,9/1/2021,NPL,Pulau Pinang,0,0,0,Nepal
35178,9/1/2021,NPL,Sabah,0,0,0,Nepal
35179,9/1/2021,NPL,Sarawak,0,0,0,Nepal
35180,9/1/2021,NPL,Selangor,2,1,1,Nepal
35181,9/1/2021,NPL,W.P. Labuan,0,0,0,Nepal
35182,9/1/2021,NRU,Johor,0,0,0,Nauru
35183,9/1/2021,NRU,Pulau Pinang,0,0,0,Nauru
35184,9/1/2021,NRU,Selangor,0,0,0,Nauru
35185,9/1/2021,NZL,Johor,0,0,0,New Zealand
35186,9/1/2021,NZL,Kedah,0,0,0,New Zealand
35187,9/1/2021,NZL,Kelantan,0,0,0,New Zealand
35188,9/1/2021,NZL,Melaka,0,0,0,New Zealand
35189,9/1/2021,NZL,Negeri Sembilan,0,0,0,New Zealand
35190,9/1/2021,NZL,Pahang,0,0,0,New Zealand
35191,9/1/2021,NZL,Perak,0,0,0,New Zealand
35192,9/1/2021,NZL,Perlis,0,0,0,New Zealand
35193,9/1/2021,NZL,Pulau Pinang,1,1,0,New Zealand
35194,9/1/2021,NZL,Sabah,0,0,0,New Zealand
35195,9/1/2021,NZL,Sarawak,0,0,0,New Zealand
35196,9/1/2021,NZL,Selangor,12,9,3,New Zealand
35197,9/1/2021,NZL,Terengganu,0,0,0,New Zealand
35198,9/1/2021,NZL,W.P. Labuan,0,0,0,New Zealand
35199,9/1/2021,OMN,Johor,0,0,0,Oman
35200,9/1/2021,OMN,Kedah,0,0,0,Oman
35201,9/1/2021,OMN,Kelantan,0,0,0,Oman
35202,9/1/2021,OMN,Melaka,0,0,0,Oman
35203,9/1/2021,OMN,Perak,0,0,0,Oman
35204,9/1/2021,OMN,Perlis,0,0,0,Oman
35205,9/1/2021,OMN,Pulau Pinang,0,0,0,Oman
35206,9/1/2021,OMN,Sabah,0,0,0,Oman
35207,9/1/2021,OMN,Sarawak,0,0,0,Oman
35208,9/1/2021,OMN,Selangor,15,11,4,Oman
35209,9/1/2021,PAK,Johor,0,0,0,Pakistan
35210,9/1/2021,PAK,Kedah,0,0,0,Pakistan
35211,9/1/2021,PAK,Kelantan,0,0,0,Pakistan
35212,9/1/2021,PAK,Melaka,0,0,0,Pakistan
35213,9/1/2021,PAK,Negeri Sembilan,0,0,0,Pakistan
35214,9/1/2021,PAK,Pahang,0,0,0,Pakistan
35215,9/1/2021,PAK,Perak,0,0,0,Pakistan
35216,9/1/2021,PAK,Perlis,0,0,0,Pakistan
35217,9/1/2021,PAK,Pulau Pinang,0,0,0,Pakistan
35218,9/1/2021,PAK,Sabah,0,0,0,Pakistan
35219,9/1/2021,PAK,Sarawak,0,0,0,Pakistan
35220,9/1/2021,PAK,Selangor,23,14,9,Pakistan
35221,9/1/2021,PAK,W.P. Labuan,0,0,0,Pakistan
35222,9/1/2021,PAN,Johor,0,0,0,Panama
35223,9/1/2021,PAN,Kedah,0,0,0,Panama
35224,9/1/2021,PAN,Perak,0,0,0,Panama
35225,9/1/2021,PAN,Perlis,0,0,0,Panama
35226,9/1/2021,PAN,Pulau Pinang,0,0,0,Panama
35227,9/1/2021,PAN,Sabah,0,0,0,Panama
35228,9/1/2021,PAN,Sarawak,0,0,0,Panama
35229,9/1/2021,PAN,Selangor,4,4,0,Panama
35230,9/1/2021,PER,Johor,0,0,0,Peru
35231,9/1/2021,PER,Kedah,0,0,0,Peru
35232,9/1/2021,PER,Kelantan,0,0,0,Peru
35233,9/1/2021,PER,Pahang,0,0,0,Peru
35234,9/1/2021,PER,Perak,0,0,0,Peru
35235,9/1/2021,PER,Perlis,0,0,0,Peru
35236,9/1/2021,PER,Pulau Pinang,0,0,0,Peru
35237,9/1/2021,PER,Sabah,0,0,0,Peru
35238,9/1/2021,PER,Sarawak,0,0,0,Peru
35239,9/1/2021,PER,Selangor,0,0,0,Peru
35240,9/1/2021,PER,W.P. Labuan,0,0,0,Peru
35241,9/1/2021,PHL,Johor,3,2,1,Philippines
35242,9/1/2021,PHL,Kedah,0,0,0,Philippines
35243,9/1/2021,PHL,Kelantan,0,0,0,Philippines
35244,9/1/2021,PHL,Melaka,0,0,0,Philippines
35245,9/1/2021,PHL,Negeri Sembilan,0,0,0,Philippines
35246,9/1/2021,PHL,Pahang,0,0,0,Philippines
35247,9/1/2021,PHL,Perak,0,0,0,Philippines
35248,9/1/2021,PHL,Perlis,0,0,0,Philippines
35249,9/1/2021,PHL,Pulau Pinang,3,1,2,Philippines
35250,9/1/2021,PHL,Sabah,1,0,1,Philippines
35251,9/1/2021,PHL,Sarawak,28,28,0,Philippines
35252,9/1/2021,PHL,Selangor,456,398,58,Philippines
35253,9/1/2021,PHL,Terengganu,0,0,0,Philippines
35254,9/1/2021,PHL,W.P. Labuan,6,6,0,Philippines
35255,9/1/2021,PLW,Johor,0,0,0,Palau
35256,9/1/2021,PLW,Pulau Pinang,0,0,0,Palau
35257,9/1/2021,PLW,Selangor,0,0,0,Palau
35258,9/1/2021,PNG,Johor,0,0,0,Papua New Guinea
35259,9/1/2021,PNG,Kedah,0,0,0,Papua New Guinea
35260,9/1/2021,PNG,Kelantan,0,0,0,Papua New Guinea
35261,9/1/2021,PNG,Perak,0,0,0,Papua New Guinea
35262,9/1/2021,PNG,Pulau Pinang,0,0,0,Papua New Guinea
35263,9/1/2021,PNG,Sabah,0,0,0,Papua New Guinea
35264,9/1/2021,PNG,Sarawak,0,0,0,Papua New Guinea
35265,9/1/2021,PNG,Selangor,0,0,0,Papua New Guinea
35266,9/1/2021,POL,Johor,0,0,0,Poland
35267,9/1/2021,POL,Kedah,0,0,0,Poland
35268,9/1/2021,POL,Kelantan,0,0,0,Poland
35269,9/1/2021,POL,Melaka,0,0,0,Poland
35270,9/1/2021,POL,Negeri Sembilan,0,0,0,Poland
35271,9/1/2021,POL,Pahang,0,0,0,Poland
35272,9/1/2021,POL,Perak,0,0,0,Poland
35273,9/1/2021,POL,Perlis,0,0,0,Poland
35274,9/1/2021,POL,Pulau Pinang,0,0,0,Poland
35275,9/1/2021,POL,Sabah,0,0,0,Poland
35276,9/1/2021,POL,Sarawak,0,0,0,Poland
35277,9/1/2021,POL,Selangor,37,26,11,Poland
35278,9/1/2021,POL,Terengganu,0,0,0,Poland
35279,9/1/2021,POL,W.P. Labuan,0,0,0,Poland
35280,9/1/2021,PRK,Selangor,0,0,0,"Korea, Democratic People's Republic of"
35281,9/1/2021,PRT,Johor,0,0,0,Portugal
35282,9/1/2021,PRT,Kedah,0,0,0,Portugal
35283,9/1/2021,PRT,Kelantan,0,0,0,Portugal
35284,9/1/2021,PRT,Melaka,0,0,0,Portugal
35285,9/1/2021,PRT,Pahang,0,0,0,Portugal
35286,9/1/2021,PRT,Perak,0,0,0,Portugal
35287,9/1/2021,PRT,Perlis,0,0,0,Portugal
35288,9/1/2021,PRT,Pulau Pinang,0,0,0,Portugal
35289,9/1/2021,PRT,Sabah,0,0,0,Portugal
35290,9/1/2021,PRT,Sarawak,0,0,0,Portugal
35291,9/1/2021,PRT,Selangor,10,6,4,Portugal
35292,9/1/2021,PRT,W.P. Labuan,0,0,0,Portugal
35293,9/1/2021,PRY,Johor,0,0,0,Paraguay
35294,9/1/2021,PRY,Kedah,0,0,0,Paraguay
35295,9/1/2021,PRY,Perak,0,0,0,Paraguay
35296,9/1/2021,PRY,Perlis,0,0,0,Paraguay
35297,9/1/2021,PRY,Pulau Pinang,0,0,0,Paraguay
35298,9/1/2021,PRY,Sabah,0,0,0,Paraguay
35299,9/1/2021,PRY,Sarawak,0,0,0,Paraguay
35300,9/1/2021,PRY,Selangor,0,0,0,Paraguay
35301,9/1/2021,PSE,Johor,0,0,0,"Palestinian Territory, Occupied"
35302,9/1/2021,PSE,Kedah,0,0,0,"Palestinian Territory, Occupied"
35303,9/1/2021,PSE,Kelantan,0,0,0,"Palestinian Territory, Occupied"
35304,9/1/2021,PSE,Melaka,0,0,0,"Palestinian Territory, Occupied"
35305,9/1/2021,PSE,Perak,0,0,0,"Palestinian Territory, Occupied"
35306,9/1/2021,PSE,Perlis,0,0,0,"Palestinian Territory, Occupied"
35307,9/1/2021,PSE,Pulau Pinang,0,0,0,"Palestinian Territory, Occupied"
35308,9/1/2021,PSE,Sabah,0,0,0,"Palestinian Territory, Occupied"
35309,9/1/2021,PSE,Sarawak,0,0,0,"Palestinian Territory, Occupied"
35310,9/1/2021,PSE,Selangor,24,19,5,"Palestinian Territory, Occupied"
35311,9/1/2021,QAT,Johor,0,0,0,Qatar
35312,9/1/2021,QAT,Kedah,0,0,0,Qatar
35313,9/1/2021,QAT,Perlis,0,0,0,Qatar
35314,9/1/2021,QAT,Pulau Pinang,0,0,0,Qatar
35315,9/1/2021,QAT,Sabah,0,0,0,Qatar
35316,9/1/2021,QAT,Sarawak,0,0,0,Qatar
35317,9/1/2021,QAT,Selangor,2,1,1,Qatar
35318,9/1/2021,REU,Johor,0,0,0,Reunion
35319,9/1/2021,REU,Sarawak,0,0,0,Reunion
35320,9/1/2021,ROU,Johor,0,0,0,Romania
35321,9/1/2021,ROU,Kedah,0,0,0,Romania
35322,9/1/2021,ROU,Kelantan,2,2,0,Romania
35323,9/1/2021,ROU,Negeri Sembilan,0,0,0,Romania
35324,9/1/2021,ROU,Pahang,0,0,0,Romania
35325,9/1/2021,ROU,Perak,0,0,0,Romania
35326,9/1/2021,ROU,Perlis,0,0,0,Romania
35327,9/1/2021,ROU,Pulau Pinang,0,0,0,Romania
35328,9/1/2021,ROU,Sabah,0,0,0,Romania
35329,9/1/2021,ROU,Sarawak,1,1,0,Romania
35330,9/1/2021,ROU,Selangor,30,24,6,Romania
35331,9/1/2021,ROU,W.P. Labuan,0,0,0,Romania
35332,9/1/2021,RUS,Johor,0,0,0,Russia
35333,9/1/2021,RUS,Kedah,0,0,0,Russia
35334,9/1/2021,RUS,Kelantan,2,0,2,Russia
35335,9/1/2021,RUS,Melaka,0,0,0,Russia
35336,9/1/2021,RUS,Negeri Sembilan,0,0,0,Russia
35337,9/1/2021,RUS,Pahang,0,0,0,Russia
35338,9/1/2021,RUS,Perak,0,0,0,Russia
35339,9/1/2021,RUS,Perlis,0,0,0,Russia
35340,9/1/2021,RUS,Pulau Pinang,0,0,0,Russia
35341,9/1/2021,RUS,Sabah,0,0,0,Russia
35342,9/1/2021,RUS,Sarawak,0,0,0,Russia
35343,9/1/2021,RUS,Selangor,98,63,35,Russia
35344,9/1/2021,RUS,W.P. Labuan,0,0,0,Russia
35345,9/1/2021,RWA,Johor,0,0,0,Rwanda
35346,9/1/2021,RWA,Kedah,0,0,0,Rwanda
35347,9/1/2021,RWA,Pulau Pinang,0,0,0,Rwanda
35348,9/1/2021,RWA,Selangor,1,0,1,Rwanda
35349,9/1/2021,SAU,Johor,0,0,0,Saudi Arabia
35350,9/1/2021,SAU,Kedah,0,0,0,Saudi Arabia
35351,9/1/2021,SAU,Kelantan,0,0,0,Saudi Arabia
35352,9/1/2021,SAU,Melaka,0,0,0,Saudi Arabia
35353,9/1/2021,SAU,Perak,0,0,0,Saudi Arabia
35354,9/1/2021,SAU,Perlis,0,0,0,Saudi Arabia
35355,9/1/2021,SAU,Pulau Pinang,0,0,0,Saudi Arabia
35356,9/1/2021,SAU,Sabah,0,0,0,Saudi Arabia
35357,9/1/2021,SAU,Sarawak,0,0,0,Saudi Arabia
35358,9/1/2021,SAU,Selangor,141,85,56,Saudi Arabia
35359,9/1/2021,SAU,W.P. Labuan,0,0,0,Saudi Arabia
35360,9/1/2021,SDN,Johor,0,0,0,Sudan
35361,9/1/2021,SDN,Kedah,0,0,0,Sudan
35362,9/1/2021,SDN,Kelantan,0,0,0,Sudan
35363,9/1/2021,SDN,Perlis,0,0,0,Sudan
35364,9/1/2021,SDN,Pulau Pinang,0,0,0,Sudan
35365,9/1/2021,SDN,Sabah,0,0,0,Sudan
35366,9/1/2021,SDN,Sarawak,0,0,0,Sudan
35367,9/1/2021,SDN,Selangor,36,28,8,Sudan
35368,9/1/2021,SDN,W.P. Labuan,0,0,0,Sudan
35369,9/1/2021,SEN,Johor,0,0,0,Senegal
35370,9/1/2021,SEN,Kedah,0,0,0,Senegal
35371,9/1/2021,SEN,Kelantan,0,0,0,Senegal
35372,9/1/2021,SEN,Perak,0,0,0,Senegal
35373,9/1/2021,SEN,Perlis,0,0,0,Senegal
35374,9/1/2021,SEN,Pulau Pinang,0,0,0,Senegal
35375,9/1/2021,SEN,Sabah,0,0,0,Senegal
35376,9/1/2021,SEN,Sarawak,0,0,0,Senegal
35377,9/1/2021,SEN,Selangor,0,0,0,Senegal
35378,9/1/2021,SGP,Johor,107,89,18,Singapore
35379,9/1/2021,SGP,Kedah,0,0,0,Singapore
35380,9/1/2021,SGP,Kelantan,0,0,0,Singapore
35381,9/1/2021,SGP,Melaka,0,0,0,Singapore
35382,9/1/2021,SGP,Negeri Sembilan,0,0,0,Singapore
35383,9/1/2021,SGP,Pahang,0,0,0,Singapore
35384,9/1/2021,SGP,Perak,2,0,2,Singapore
35385,9/1/2021,SGP,Perlis,0,0,0,Singapore
35386,9/1/2021,SGP,Pulau Pinang,19,12,7,Singapore
35387,9/1/2021,SGP,Sabah,0,0,0,Singapore
35388,9/1/2021,SGP,Sarawak,5,3,2,Singapore
35389,9/1/2021,SGP,Selangor,103,76,27,Singapore
35390,9/1/2021,SGP,Terengganu,0,0,0,Singapore
35391,9/1/2021,SGP,W.P. Labuan,0,0,0,Singapore
35392,9/1/2021,SGS,Johor,0,0,0,South Georgia and the South Sandwich Islands
35393,9/1/2021,SGS,Sabah,0,0,0,South Georgia and the South Sandwich Islands
35394,9/1/2021,SGS,Selangor,0,0,0,South Georgia and the South Sandwich Islands
35395,9/1/2021,SHN,Sarawak,0,0,0,"Saint Helena, Ascension and Tristan da Cunha"
35396,9/1/2021,SLB,Johor,0,0,0,Solomon Islands
35397,9/1/2021,SLB,Perlis,0,0,0,Solomon Islands
35398,9/1/2021,SLB,Pulau Pinang,0,0,0,Solomon Islands
35399,9/1/2021,SLB,Sabah,0,0,0,Solomon Islands
35400,9/1/2021,SLB,Sarawak,0,0,0,Solomon Islands
35401,9/1/2021,SLB,Selangor,0,0,0,Solomon Islands
35402,9/1/2021,SLB,W.P. Labuan,0,0,0,Solomon Islands
35403,9/1/2021,SLE,Johor,0,0,0,Sierra Leone
35404,9/1/2021,SLE,Kedah,0,0,0,Sierra Leone
35405,9/1/2021,SLE,Perak,0,0,0,Sierra Leone
35406,9/1/2021,SLE,Pulau Pinang,0,0,0,Sierra Leone
35407,9/1/2021,SLE,Sabah,0,0,0,Sierra Leone
35408,9/1/2021,SLE,Selangor,1,1,0,Sierra Leone
35409,9/1/2021,SLV,Johor,0,0,0,El Salvador
35410,9/1/2021,SLV,Kedah,0,0,0,El Salvador
35411,9/1/2021,SLV,Perak,0,0,0,El Salvador
35412,9/1/2021,SLV,Perlis,0,0,0,El Salvador
35413,9/1/2021,SLV,Pulau Pinang,0,0,0,El Salvador
35414,9/1/2021,SLV,Sabah,0,0,0,El Salvador
35415,9/1/2021,SLV,Selangor,0,0,0,El Salvador
35416,9/1/2021,SLV,W.P. Labuan,0,0,0,El Salvador
35417,9/1/2021,SMR,Johor,0,0,0,San Marino
35418,9/1/2021,SMR,Selangor,0,0,0,San Marino
35419,9/1/2021,SOM,Johor,0,0,0,Somalia
35420,9/1/2021,SOM,Kedah,0,0,0,Somalia
35421,9/1/2021,SOM,Kelantan,0,0,0,Somalia
35422,9/1/2021,SOM,Perlis,0,0,0,Somalia
35423,9/1/2021,SOM,Sabah,0,0,0,Somalia
35424,9/1/2021,SOM,Sarawak,0,0,0,Somalia
35425,9/1/2021,SOM,Selangor,45,41,4,Somalia
35426,9/1/2021,SRB,Johor,0,0,0,Serbia
35427,9/1/2021,SRB,Kedah,0,0,0,Serbia
35428,9/1/2021,SRB,Kelantan,0,0,0,Serbia
35429,9/1/2021,SRB,Pahang,0,0,0,Serbia
35430,9/1/2021,SRB,Perak,0,0,0,Serbia
35431,9/1/2021,SRB,Perlis,0,0,0,Serbia
35432,9/1/2021,SRB,Pulau Pinang,0,0,0,Serbia
35433,9/1/2021,SRB,Sabah,0,0,0,Serbia
35434,9/1/2021,SRB,Sarawak,0,0,0,Serbia
35435,9/1/2021,SRB,Selangor,0,0,0,Serbia
35436,9/1/2021,STP,Selangor,0,0,0,Sao Tome and Principe
35437,9/1/2021,SUR,Johor,0,0,0,Suriname
35438,9/1/2021,SUR,Kedah,0,0,0,Suriname
35439,9/1/2021,SUR,Kelantan,0,0,0,Suriname
35440,9/1/2021,SUR,Perak,0,0,0,Suriname
35441,9/1/2021,SUR,Perlis,0,0,0,Suriname
35442,9/1/2021,SUR,Pulau Pinang,0,0,0,Suriname
35443,9/1/2021,SUR,Sabah,0,0,0,Suriname
35444,9/1/2021,SUR,Sarawak,0,0,0,Suriname
35445,9/1/2021,SUR,Selangor,0,0,0,Suriname
35446,9/1/2021,SVK,Johor,0,0,0,Slovakia
35447,9/1/2021,SVK,Kedah,0,0,0,Slovakia
35448,9/1/2021,SVK,Kelantan,0,0,0,Slovakia
35449,9/1/2021,SVK,Negeri Sembilan,0,0,0,Slovakia
35450,9/1/2021,SVK,Pahang,0,0,0,Slovakia
35451,9/1/2021,SVK,Perak,0,0,0,Slovakia
35452,9/1/2021,SVK,Perlis,0,0,0,Slovakia
35453,9/1/2021,SVK,Pulau Pinang,0,0,0,Slovakia
35454,9/1/2021,SVK,Sabah,0,0,0,Slovakia
35455,9/1/2021,SVK,Sarawak,0,0,0,Slovakia
35456,9/1/2021,SVK,Selangor,6,5,1,Slovakia
35457,9/1/2021,SVK,W.P. Labuan,0,0,0,Slovakia
35458,9/1/2021,SVN,Johor,0,0,0,Slovenia
35459,9/1/2021,SVN,Kedah,0,0,0,Slovenia
35460,9/1/2021,SVN,Kelantan,0,0,0,Slovenia
35461,9/1/2021,SVN,Perak,0,0,0,Slovenia
35462,9/1/2021,SVN,Perlis,0,0,0,Slovenia
35463,9/1/2021,SVN,Pulau Pinang,0,0,0,Slovenia
35464,9/1/2021,SVN,Sabah,0,0,0,Slovenia
35465,9/1/2021,SVN,Sarawak,0,0,0,Slovenia
35466,9/1/2021,SVN,Selangor,0,0,0,Slovenia
35467,9/1/2021,SVN,W.P. Labuan,0,0,0,Slovenia
35468,9/1/2021,SWE,Johor,0,0,0,Sweden
35469,9/1/2021,SWE,Kedah,0,0,0,Sweden
35470,9/1/2021,SWE,Kelantan,0,0,0,Sweden
35471,9/1/2021,SWE,Melaka,0,0,0,Sweden
35472,9/1/2021,SWE,Negeri Sembilan,0,0,0,Sweden
35473,9/1/2021,SWE,Pahang,0,0,0,Sweden
35474,9/1/2021,SWE,Perak,0,0,0,Sweden
35475,9/1/2021,SWE,Perlis,0,0,0,Sweden
35476,9/1/2021,SWE,Pulau Pinang,0,0,0,Sweden
35477,9/1/2021,SWE,Sabah,0,0,0,Sweden
35478,9/1/2021,SWE,Sarawak,0,0,0,Sweden
35479,9/1/2021,SWE,Selangor,51,38,13,Sweden
35480,9/1/2021,SWE,W.P. Labuan,0,0,0,Sweden
35481,9/1/2021,SWZ,Johor,0,0,0,Swaziland
35482,9/1/2021,SWZ,Kedah,0,0,0,Swaziland
35483,9/1/2021,SWZ,Pulau Pinang,0,0,0,Swaziland
35484,9/1/2021,SWZ,Sabah,0,0,0,Swaziland
35485,9/1/2021,SWZ,Selangor,0,0,0,Swaziland
35486,9/1/2021,SYC,Johor,0,0,0,Seychelles
35487,9/1/2021,SYC,Kedah,0,0,0,Seychelles
35488,9/1/2021,SYC,Pulau Pinang,0,0,0,Seychelles
35489,9/1/2021,SYC,Sabah,0,0,0,Seychelles
35490,9/1/2021,SYC,Sarawak,0,0,0,Seychelles
35491,9/1/2021,SYC,Selangor,18,5,13,Seychelles
35492,9/1/2021,SYR,Johor,0,0,0,Syrian Arab Republic
35493,9/1/2021,SYR,Kedah,0,0,0,Syrian Arab Republic
35494,9/1/2021,SYR,Kelantan,0,0,0,Syrian Arab Republic
35495,9/1/2021,SYR,Pahang,0,0,0,Syrian Arab Republic
35496,9/1/2021,SYR,Perlis,0,0,0,Syrian Arab Republic
35497,9/1/2021,SYR,Pulau Pinang,0,0,0,Syrian Arab Republic
35498,9/1/2021,SYR,Sabah,0,0,0,Syrian Arab Republic
35499,9/1/2021,SYR,Sarawak,0,0,0,Syrian Arab Republic
35500,9/1/2021,SYR,Selangor,22,16,6,Syrian Arab Republic
35501,9/1/2021,SYR,W.P. Labuan,0,0,0,Syrian Arab Republic
35502,9/1/2021,TCA,Perlis,0,0,0,Turks and Caicos
35503,9/1/2021,TCD,Johor,0,0,0,Chad
35504,9/1/2021,TCD,Kedah,0,0,0,Chad
35505,9/1/2021,TCD,Perlis,0,0,0,Chad
35506,9/1/2021,TCD,Selangor,2,2,0,Chad
35507,9/1/2021,TGO,Johor,0,0,0,Togo
35508,9/1/2021,TGO,Perak,0,0,0,Togo
35509,9/1/2021,TGO,Pulau Pinang,0,0,0,Togo
35510,9/1/2021,TGO,Selangor,0,0,0,Togo
35511,9/1/2021,THA,Johor,16,16,0,Thailand
35512,9/1/2021,THA,Kedah,18826,18780,46,Thailand
35513,9/1/2021,THA,Kelantan,0,0,0,Thailand
35514,9/1/2021,THA,Melaka,0,0,0,Thailand
35515,9/1/2021,THA,Negeri Sembilan,0,0,0,Thailand
35516,9/1/2021,THA,Pahang,0,0,0,Thailand
35517,9/1/2021,THA,Perak,0,0,0,Thailand
35518,9/1/2021,THA,Perlis,7738,7657,81,Thailand
35519,9/1/2021,THA,Pulau Pinang,101,100,1,Thailand
35520,9/1/2021,THA,Sabah,0,0,0,Thailand
35521,9/1/2021,THA,Sarawak,15,14,1,Thailand
35522,9/1/2021,THA,Selangor,153,97,56,Thailand
35523,9/1/2021,THA,Terengganu,0,0,0,Thailand
35524,9/1/2021,THA,W.P. Labuan,0,0,0,Thailand
35525,9/1/2021,TJK,Johor,0,0,0,Tajikistan
35526,9/1/2021,TJK,Kedah,0,0,0,Tajikistan
35527,9/1/2021,TJK,Perlis,0,0,0,Tajikistan
35528,9/1/2021,TJK,Pulau Pinang,0,0,0,Tajikistan
35529,9/1/2021,TJK,Sabah,0,0,0,Tajikistan
35530,9/1/2021,TJK,Selangor,1,0,1,Tajikistan
35531,9/1/2021,TKL,Selangor,0,0,0,Tokelau
35532,9/1/2021,TKM,Johor,0,0,0,Turkmenistan
35533,9/1/2021,TKM,Kedah,0,0,0,Turkmenistan
35534,9/1/2021,TKM,Kelantan,0,0,0,Turkmenistan
35535,9/1/2021,TKM,Perlis,0,0,0,Turkmenistan
35536,9/1/2021,TKM,Pulau Pinang,0,0,0,Turkmenistan
35537,9/1/2021,TKM,Sabah,0,0,0,Turkmenistan
35538,9/1/2021,TKM,Sarawak,0,0,0,Turkmenistan
35539,9/1/2021,TKM,Selangor,1,0,1,Turkmenistan
35540,9/1/2021,TLS,Johor,0,0,0,Timor-Leste
35541,9/1/2021,TLS,Kedah,0,0,0,Timor-Leste
35542,9/1/2021,TLS,Perlis,0,0,0,Timor-Leste
35543,9/1/2021,TLS,Pulau Pinang,0,0,0,Timor-Leste
35544,9/1/2021,TLS,Sabah,0,0,0,Timor-Leste
35545,9/1/2021,TLS,Sarawak,0,0,0,Timor-Leste
35546,9/1/2021,TLS,Selangor,0,0,0,Timor-Leste
35547,9/1/2021,TON,Johor,0,0,0,Tonga
35548,9/1/2021,TON,Pulau Pinang,0,0,0,Tonga
35549,9/1/2021,TON,Sarawak,0,0,0,Tonga
35550,9/1/2021,TON,Selangor,0,0,0,Tonga
35551,9/1/2021,TTO,Johor,0,0,0,Trinidad and Tobago
35552,9/1/2021,TTO,Kedah,0,0,0,Trinidad and Tobago
35553,9/1/2021,TTO,Pahang,0,0,0,Trinidad and Tobago
35554,9/1/2021,TTO,Pulau Pinang,0,0,0,Trinidad and Tobago
35555,9/1/2021,TTO,Sabah,0,0,0,Trinidad and Tobago
35556,9/1/2021,TTO,Sarawak,0,0,0,Trinidad and Tobago
35557,9/1/2021,TTO,Selangor,1,1,0,Trinidad and Tobago
35558,9/1/2021,TUN,Johor,0,0,0,Tunisia
35559,9/1/2021,TUN,Kedah,0,0,0,Tunisia
35560,9/1/2021,TUN,Kelantan,0,0,0,Tunisia
35561,9/1/2021,TUN,Melaka,0,0,0,Tunisia
35562,9/1/2021,TUN,Perak,0,0,0,Tunisia
35563,9/1/2021,TUN,Perlis,0,0,0,Tunisia
35564,9/1/2021,TUN,Pulau Pinang,0,0,0,Tunisia
35565,9/1/2021,TUN,Sabah,0,0,0,Tunisia
35566,9/1/2021,TUN,Sarawak,0,0,0,Tunisia
35567,9/1/2021,TUN,Selangor,10,3,7,Tunisia
35568,9/1/2021,TUN,W.P. Labuan,0,0,0,Tunisia
35569,9/1/2021,TUR,Johor,0,0,0,Turkey
35570,9/1/2021,TUR,Kedah,0,0,0,Turkey
35571,9/1/2021,TUR,Kelantan,0,0,0,Turkey
35572,9/1/2021,TUR,Melaka,0,0,0,Turkey
35573,9/1/2021,TUR,Negeri Sembilan,0,0,0,Turkey
35574,9/1/2021,TUR,Pahang,0,0,0,Turkey
35575,9/1/2021,TUR,Perak,0,0,0,Turkey
35576,9/1/2021,TUR,Perlis,0,0,0,Turkey
35577,9/1/2021,TUR,Pulau Pinang,0,0,0,Turkey
35578,9/1/2021,TUR,Sabah,0,0,0,Turkey
35579,9/1/2021,TUR,Sarawak,0,0,0,Turkey
35580,9/1/2021,TUR,Selangor,54,40,14,Turkey
35581,9/1/2021,TUR,W.P. Labuan,0,0,0,Turkey
35582,9/1/2021,TUV,Selangor,0,0,0,Tuvalu
35583,9/1/2021,TWN,Johor,0,0,0,Taiwan
35584,9/1/2021,TWN,Kedah,0,0,0,Taiwan
35585,9/1/2021,TWN,Kelantan,0,0,0,Taiwan
35586,9/1/2021,TWN,Melaka,0,0,0,Taiwan
35587,9/1/2021,TWN,Negeri Sembilan,0,0,0,Taiwan
35588,9/1/2021,TWN,Pahang,0,0,0,Taiwan
35589,9/1/2021,TWN,Perak,0,0,0,Taiwan
35590,9/1/2021,TWN,Perlis,0,0,0,Taiwan
35591,9/1/2021,TWN,Pulau Pinang,13,10,3,Taiwan
35592,9/1/2021,TWN,Sabah,0,0,0,Taiwan
35593,9/1/2021,TWN,Sarawak,0,0,0,Taiwan
35594,9/1/2021,TWN,Selangor,40,27,13,Taiwan
35595,9/1/2021,TWN,W.P. Labuan,0,0,0,Taiwan
35596,9/1/2021,TZA,Johor,0,0,0,"Tanzania, United Republic of"
35597,9/1/2021,TZA,Kedah,0,0,0,"Tanzania, United Republic of"
35598,9/1/2021,TZA,Perak,0,0,0,"Tanzania, United Republic of"
35599,9/1/2021,TZA,Perlis,0,0,0,"Tanzania, United Republic of"
35600,9/1/2021,TZA,Pulau Pinang,0,0,0,"Tanzania, United Republic of"
35601,9/1/2021,TZA,Sabah,0,0,0,"Tanzania, United Republic of"
35602,9/1/2021,TZA,Sarawak,0,0,0,"Tanzania, United Republic of"
35603,9/1/2021,TZA,Selangor,16,11,5,"Tanzania, United Republic of"
35604,9/1/2021,UGA,Johor,0,0,0,Uganda
35605,9/1/2021,UGA,Kedah,0,0,0,Uganda
35606,9/1/2021,UGA,Perak,0,0,0,Uganda
35607,9/1/2021,UGA,Perlis,0,0,0,Uganda
35608,9/1/2021,UGA,Pulau Pinang,0,0,0,Uganda
35609,9/1/2021,UGA,Sabah,0,0,0,Uganda
35610,9/1/2021,UGA,Sarawak,0,0,0,Uganda
35611,9/1/2021,UGA,Selangor,7,2,5,Uganda
35612,9/1/2021,UKR,Johor,2,2,0,Ukraine
35613,9/1/2021,UKR,Kedah,0,0,0,Ukraine
35614,9/1/2021,UKR,Kelantan,0,0,0,Ukraine
35615,9/1/2021,UKR,Melaka,0,0,0,Ukraine
35616,9/1/2021,UKR,Negeri Sembilan,0,0,0,Ukraine
35617,9/1/2021,UKR,Pahang,0,0,0,Ukraine
35618,9/1/2021,UKR,Perak,0,0,0,Ukraine
35619,9/1/2021,UKR,Perlis,0,0,0,Ukraine
35620,9/1/2021,UKR,Pulau Pinang,0,0,0,Ukraine
35621,9/1/2021,UKR,Sabah,0,0,0,Ukraine
35622,9/1/2021,UKR,Sarawak,0,0,0,Ukraine
35623,9/1/2021,UKR,Selangor,49,45,4,Ukraine
35624,9/1/2021,UKR,W.P. Labuan,0,0,0,Ukraine
35625,9/1/2021,URY,Johor,0,0,0,Uruguay
35626,9/1/2021,URY,Kedah,0,0,0,Uruguay
35627,9/1/2021,URY,Kelantan,0,0,0,Uruguay
35628,9/1/2021,URY,Perak,0,0,0,Uruguay
35629,9/1/2021,URY,Perlis,0,0,0,Uruguay
35630,9/1/2021,URY,Pulau Pinang,0,0,0,Uruguay
35631,9/1/2021,URY,Sabah,0,0,0,Uruguay
35632,9/1/2021,URY,Sarawak,0,0,0,Uruguay
35633,9/1/2021,URY,Selangor,1,0,1,Uruguay
35634,9/1/2021,URY,W.P. Labuan,0,0,0,Uruguay
35635,9/1/2021,USA,Johor,0,0,0,United States Of America
35636,9/1/2021,USA,Kedah,0,0,0,United States Of America
35637,9/1/2021,USA,Kelantan,0,0,0,United States Of America
35638,9/1/2021,USA,Melaka,0,0,0,United States Of America
35639,9/1/2021,USA,Negeri Sembilan,0,0,0,United States Of America
35640,9/1/2021,USA,Pahang,0,0,0,United States Of America
35641,9/1/2021,USA,Perak,0,0,0,United States Of America
35642,9/1/2021,USA,Perlis,0,0,0,United States Of America
35643,9/1/2021,USA,Pulau Pinang,11,6,5,United States Of America
35644,9/1/2021,USA,Sabah,1,1,0,United States Of America
35645,9/1/2021,USA,Sarawak,0,0,0,United States Of America
35646,9/1/2021,USA,Selangor,226,143,83,United States Of America
35647,9/1/2021,USA,Terengganu,0,0,0,United States Of America
35648,9/1/2021,USA,W.P. Labuan,0,0,0,United States Of America
35649,9/1/2021,UZB,Johor,0,0,0,Uzbekistan
35650,9/1/2021,UZB,Kedah,0,0,0,Uzbekistan
35651,9/1/2021,UZB,Kelantan,0,0,0,Uzbekistan
35652,9/1/2021,UZB,Perak,0,0,0,Uzbekistan
35653,9/1/2021,UZB,Perlis,0,0,0,Uzbekistan
35654,9/1/2021,UZB,Pulau Pinang,0,0,0,Uzbekistan
35655,9/1/2021,UZB,Sabah,0,0,0,Uzbekistan
35656,9/1/2021,UZB,Sarawak,0,0,0,Uzbekistan
35657,9/1/2021,UZB,Selangor,12,8,4,Uzbekistan
35658,9/1/2021,VAT,Johor,0,0,0,Holy See (Vatican City State)
35659,9/1/2021,VAT,Sarawak,0,0,0,Holy See (Vatican City State)
35660,9/1/2021,VAT,Selangor,0,0,0,Holy See (Vatican City State)
35661,9/1/2021,VCT,Johor,0,0,0,Saint Vincent and the Grenadines
35662,9/1/2021,VCT,Kedah,0,0,0,Saint Vincent and the Grenadines
35663,9/1/2021,VCT,Pulau Pinang,0,0,0,Saint Vincent and the Grenadines
35664,9/1/2021,VCT,Sarawak,0,0,0,Saint Vincent and the Grenadines
35665,9/1/2021,VCT,Selangor,0,0,0,Saint Vincent and the Grenadines
35666,9/1/2021,VEN,Johor,0,0,0,Venezuela
35667,9/1/2021,VEN,Kedah,0,0,0,Venezuela
35668,9/1/2021,VEN,Kelantan,0,0,0,Venezuela
35669,9/1/2021,VEN,Melaka,0,0,0,Venezuela
35670,9/1/2021,VEN,Perak,0,0,0,Venezuela
35671,9/1/2021,VEN,Perlis,0,0,0,Venezuela
35672,9/1/2021,VEN,Pulau Pinang,0,0,0,Venezuela
35673,9/1/2021,VEN,Sabah,0,0,0,Venezuela
35674,9/1/2021,VEN,Sarawak,0,0,0,Venezuela
35675,9/1/2021,VEN,Selangor,5,3,2,Venezuela
35676,9/1/2021,VEN,W.P. Labuan,0,0,0,Venezuela
35677,9/1/2021,VNM,Johor,1,0,1,Vietnam
35678,9/1/2021,VNM,Kedah,0,0,0,Vietnam
35679,9/1/2021,VNM,Kelantan,0,0,0,Vietnam
35680,9/1/2021,VNM,Melaka,0,0,0,Vietnam
35681,9/1/2021,VNM,Negeri Sembilan,0,0,0,Vietnam
35682,9/1/2021,VNM,Pahang,0,0,0,Vietnam
35683,9/1/2021,VNM,Perak,0,0,0,Vietnam
35684,9/1/2021,VNM,Perlis,0,0,0,Vietnam
35685,9/1/2021,VNM,Pulau Pinang,0,0,0,Vietnam
35686,9/1/2021,VNM,Sabah,0,0,0,Vietnam
35687,9/1/2021,VNM,Sarawak,0,0,0,Vietnam
35688,9/1/2021,VNM,Selangor,57,22,35,Vietnam
35689,9/1/2021,VNM,Terengganu,0,0,0,Vietnam
35690,9/1/2021,VNM,W.P. Labuan,0,0,0,Vietnam
35691,9/1/2021,VUT,Johor,0,0,0,Vanuatu
35692,9/1/2021,VUT,Kedah,0,0,0,Vanuatu
35693,9/1/2021,VUT,Pulau Pinang,0,0,0,Vanuatu
35694,9/1/2021,VUT,Sabah,0,0,0,Vanuatu
35695,9/1/2021,VUT,Sarawak,0,0,0,Vanuatu
35696,9/1/2021,VUT,Selangor,1,1,0,Vanuatu
35697,9/1/2021,WSM,Johor,0,0,0,Samoa
35698,9/1/2021,WSM,Sarawak,0,0,0,Samoa
35699,9/1/2021,WSM,Selangor,0,0,0,Samoa
35700,9/1/2021,YEM,Johor,0,0,0,Yemen
35701,9/1/2021,YEM,Kedah,0,0,0,Yemen
35702,9/1/2021,YEM,Kelantan,0,0,0,Yemen
35703,9/1/2021,YEM,Melaka,0,0,0,Yemen
35704,9/1/2021,YEM,Pahang,0,0,0,Yemen
35705,9/1/2021,YEM,Perak,0,0,0,Yemen
35706,9/1/2021,YEM,Perlis,0,0,0,Yemen
35707,9/1/2021,YEM,Pulau Pinang,0,0,0,Yemen
35708,9/1/2021,YEM,Sabah,0,0,0,Yemen
35709,9/1/2021,YEM,Sarawak,0,0,0,Yemen
35710,9/1/2021,YEM,Selangor,98,69,29,Yemen
35711,9/1/2021,YEM,W.P. Labuan,0,0,0,Yemen
35712,9/1/2021,ZAF,Johor,0,0,0,South Africa
35713,9/1/2021,ZAF,Kedah,0,0,0,South Africa
35714,9/1/2021,ZAF,Kelantan,0,0,0,South Africa
35715,9/1/2021,ZAF,Melaka,0,0,0,South Africa
35716,9/1/2021,ZAF,Pahang,0,0,0,South Africa
35717,9/1/2021,ZAF,Perak,0,0,0,South Africa
35718,9/1/2021,ZAF,Perlis,0,0,0,South Africa
35719,9/1/2021,ZAF,Pulau Pinang,0,0,0,South Africa
35720,9/1/2021,ZAF,Sabah,0,0,0,South Africa
35721,9/1/2021,ZAF,Sarawak,0,0,0,South Africa
35722,9/1/2021,ZAF,Selangor,61,48,13,South Africa
35723,9/1/2021,ZAF,Terengganu,0,0,0,South Africa
35724,9/1/2021,ZAF,W.P. Labuan,0,0,0,South Africa
35725,9/1/2021,ZMB,Johor,0,0,0,Zambia
35726,9/1/2021,ZMB,Kedah,0,0,0,Zambia
35727,9/1/2021,ZMB,Perak,0,0,0,Zambia
35728,9/1/2021,ZMB,Perlis,0,0,0,Zambia
35729,9/1/2021,ZMB,Pulau Pinang,0,0,0,Zambia
35730,9/1/2021,ZMB,Sabah,0,0,0,Zambia
35731,9/1/2021,ZMB,Sarawak,0,0,0,Zambia
35732,9/1/2021,ZMB,Selangor,9,5,4,Zambia
35733,9/1/2021,ZWE,Johor,0,0,0,Zimbabwe
35734,9/1/2021,ZWE,Kedah,0,0,0,Zimbabwe
35735,9/1/2021,ZWE,Kelantan,0,0,0,Zimbabwe
35736,9/1/2021,ZWE,Perak,0,0,0,Zimbabwe
35737,9/1/2021,ZWE,Perlis,0,0,0,Zimbabwe
35738,9/1/2021,ZWE,Pulau Pinang,0,0,0,Zimbabwe
35739,9/1/2021,ZWE,Sabah,0,0,0,Zimbabwe
35740,9/1/2021,ZWE,Sarawak,0,0,0,Zimbabwe
35741,9/1/2021,ZWE,Selangor,8,3,5,Zimbabwe
35742,10/1/2021,ABW,Kedah,0,0,0,Aruba
35743,10/1/2021,ABW,Pulau Pinang,0,0,0,Aruba
35744,10/1/2021,AFG,Johor,0,0,0,Afghanistan
35745,10/1/2021,AFG,Kedah,0,0,0,Afghanistan
35746,10/1/2021,AFG,Perlis,0,0,0,Afghanistan
35747,10/1/2021,AFG,Pulau Pinang,0,0,0,Afghanistan
35748,10/1/2021,AFG,Sarawak,0,0,0,Afghanistan
35749,10/1/2021,AFG,Selangor,16,11,5,Afghanistan
35750,10/1/2021,AGO,Johor,0,0,0,Angola
35751,10/1/2021,AGO,Kedah,0,0,0,Angola
35752,10/1/2021,AGO,Sabah,0,0,0,Angola
35753,10/1/2021,AGO,Selangor,0,0,0,Angola
35754,10/1/2021,AIA,Selangor,0,0,0,Anguilla
35755,10/1/2021,ALB,Johor,0,0,0,Albania
35756,10/1/2021,ALB,Kedah,0,0,0,Albania
35757,10/1/2021,ALB,Perak,0,0,0,Albania
35758,10/1/2021,ALB,Perlis,0,0,0,Albania
35759,10/1/2021,ALB,Pulau Pinang,0,0,0,Albania
35760,10/1/2021,ALB,Sabah,0,0,0,Albania
35761,10/1/2021,ALB,Sarawak,0,0,0,Albania
35762,10/1/2021,ALB,Selangor,1,1,0,Albania
35763,10/1/2021,AND,Johor,0,0,0,Andorra
35764,10/1/2021,AND,Kedah,0,0,0,Andorra
35765,10/1/2021,AND,Perlis,0,0,0,Andorra
35766,10/1/2021,AND,Pulau Pinang,0,0,0,Andorra
35767,10/1/2021,AND,Selangor,0,0,0,Andorra
35768,10/1/2021,ANT,Selangor,0,0,0,Netherlands Antilles
35769,10/1/2021,ARE,Johor,0,0,0,United Arab Emirates
35770,10/1/2021,ARE,Kedah,0,0,0,United Arab Emirates
35771,10/1/2021,ARE,Kelantan,0,0,0,United Arab Emirates
35772,10/1/2021,ARE,Perak,0,0,0,United Arab Emirates
35773,10/1/2021,ARE,Perlis,0,0,0,United Arab Emirates
35774,10/1/2021,ARE,Pulau Pinang,0,0,0,United Arab Emirates
35775,10/1/2021,ARE,Sabah,0,0,0,United Arab Emirates
35776,10/1/2021,ARE,Sarawak,0,0,0,United Arab Emirates
35777,10/1/2021,ARE,Selangor,2,2,0,United Arab Emirates
35778,10/1/2021,ARG,Johor,0,0,0,Argentina
35779,10/1/2021,ARG,Kedah,0,0,0,Argentina
35780,10/1/2021,ARG,Kelantan,0,0,0,Argentina
35781,10/1/2021,ARG,Melaka,0,0,0,Argentina
35782,10/1/2021,ARG,Perak,0,0,0,Argentina
35783,10/1/2021,ARG,Perlis,0,0,0,Argentina
35784,10/1/2021,ARG,Pulau Pinang,0,0,0,Argentina
35785,10/1/2021,ARG,Sabah,0,0,0,Argentina
35786,10/1/2021,ARG,Sarawak,0,0,0,Argentina
35787,10/1/2021,ARG,Selangor,12,7,5,Argentina
35788,10/1/2021,ARG,W.P. Labuan,0,0,0,Argentina
35789,10/1/2021,ARM,Johor,0,0,0,Armenia
35790,10/1/2021,ARM,Kedah,0,0,0,Armenia
35791,10/1/2021,ARM,Kelantan,0,0,0,Armenia
35792,10/1/2021,ARM,Perak,0,0,0,Armenia
35793,10/1/2021,ARM,Perlis,0,0,0,Armenia
35794,10/1/2021,ARM,Pulau Pinang,0,0,0,Armenia
35795,10/1/2021,ARM,Sabah,0,0,0,Armenia
35796,10/1/2021,ARM,Sarawak,0,0,0,Armenia
35797,10/1/2021,ARM,Selangor,0,0,0,Armenia
35798,10/1/2021,ATA,Selangor,0,0,0,Antarctica
35799,10/1/2021,ATG,Johor,0,0,0,Antigua and Barbuda
35800,10/1/2021,ATG,Kedah,0,0,0,Antigua and Barbuda
35801,10/1/2021,ATG,Pulau Pinang,0,0,0,Antigua and Barbuda
35802,10/1/2021,ATG,Sarawak,0,0,0,Antigua and Barbuda
35803,10/1/2021,ATG,Selangor,0,0,0,Antigua and Barbuda
35804,10/1/2021,AUS,Johor,2,2,0,Australia
35805,10/1/2021,AUS,Kedah,0,0,0,Australia
35806,10/1/2021,AUS,Kelantan,0,0,0,Australia
35807,10/1/2021,AUS,Melaka,0,0,0,Australia
35808,10/1/2021,AUS,Negeri Sembilan,0,0,0,Australia
35809,10/1/2021,AUS,Pahang,0,0,0,Australia
35810,10/1/2021,AUS,Perak,0,0,0,Australia
35811,10/1/2021,AUS,Perlis,0,0,0,Australia
35812,10/1/2021,AUS,Pulau Pinang,4,2,2,Australia
35813,10/1/2021,AUS,Sabah,0,0,0,Australia
35814,10/1/2021,AUS,Sarawak,2,2,0,Australia
35815,10/1/2021,AUS,Selangor,117,79,38,Australia
35816,10/1/2021,AUS,Terengganu,0,0,0,Australia
35817,10/1/2021,AUS,W.P. Labuan,0,0,0,Australia
35818,10/1/2021,AUT,Johor,0,0,0,Austria
35819,10/1/2021,AUT,Kedah,0,0,0,Austria
35820,10/1/2021,AUT,Kelantan,0,0,0,Austria
35821,10/1/2021,AUT,Melaka,0,0,0,Austria
35822,10/1/2021,AUT,Negeri Sembilan,0,0,0,Austria
35823,10/1/2021,AUT,Pahang,0,0,0,Austria
35824,10/1/2021,AUT,Perak,0,0,0,Austria
35825,10/1/2021,AUT,Perlis,0,0,0,Austria
35826,10/1/2021,AUT,Pulau Pinang,1,0,1,Austria
35827,10/1/2021,AUT,Sabah,0,0,0,Austria
35828,10/1/2021,AUT,Sarawak,2,2,0,Austria
35829,10/1/2021,AUT,Selangor,23,20,3,Austria
35830,10/1/2021,AUT,Terengganu,0,0,0,Austria
35831,10/1/2021,AUT,W.P. Labuan,0,0,0,Austria
35832,10/1/2021,AZE,Johor,0,0,0,Azerbaijan
35833,10/1/2021,AZE,Kedah,0,0,0,Azerbaijan
35834,10/1/2021,AZE,Kelantan,0,0,0,Azerbaijan
35835,10/1/2021,AZE,Melaka,0,0,0,Azerbaijan
35836,10/1/2021,AZE,Perlis,0,0,0,Azerbaijan
35837,10/1/2021,AZE,Pulau Pinang,0,0,0,Azerbaijan
35838,10/1/2021,AZE,Sabah,0,0,0,Azerbaijan
35839,10/1/2021,AZE,Sarawak,0,0,0,Azerbaijan
35840,10/1/2021,AZE,Selangor,6,2,4,Azerbaijan
35841,10/1/2021,AZE,W.P. Labuan,0,0,0,Azerbaijan
35842,10/1/2021,BDI,Pulau Pinang,0,0,0,Burundi
35843,10/1/2021,BDI,Sarawak,0,0,0,Burundi
35844,10/1/2021,BDI,Selangor,0,0,0,Burundi
35845,10/1/2021,BEL,Johor,0,0,0,Belgium
35846,10/1/2021,BEL,Kedah,0,0,0,Belgium
35847,10/1/2021,BEL,Kelantan,0,0,0,Belgium
35848,10/1/2021,BEL,Melaka,0,0,0,Belgium
35849,10/1/2021,BEL,Negeri Sembilan,0,0,0,Belgium
35850,10/1/2021,BEL,Pahang,0,0,0,Belgium
35851,10/1/2021,BEL,Perak,0,0,0,Belgium
35852,10/1/2021,BEL,Perlis,0,0,0,Belgium
35853,10/1/2021,BEL,Pulau Pinang,1,1,0,Belgium
35854,10/1/2021,BEL,Sabah,0,0,0,Belgium
35855,10/1/2021,BEL,Sarawak,0,0,0,Belgium
35856,10/1/2021,BEL,Selangor,21,15,6,Belgium
35857,10/1/2021,BEL,W.P. Labuan,0,0,0,Belgium
35858,10/1/2021,BEN,Johor,0,0,0,Benin
35859,10/1/2021,BEN,Kedah,0,0,0,Benin
35860,10/1/2021,BEN,Perak,0,0,0,Benin
35861,10/1/2021,BEN,Pulau Pinang,0,0,0,Benin
35862,10/1/2021,BEN,Sabah,0,0,0,Benin
35863,10/1/2021,BEN,Sarawak,0,0,0,Benin
35864,10/1/2021,BEN,Selangor,0,0,0,Benin
35865,10/1/2021,BFA,Perak,0,0,0,Burkina Faso
35866,10/1/2021,BFA,Pulau Pinang,0,0,0,Burkina Faso
35867,10/1/2021,BFA,Selangor,0,0,0,Burkina Faso
35868,10/1/2021,BGD,Johor,1,1,0,Bangladesh
35869,10/1/2021,BGD,Kedah,0,0,0,Bangladesh
35870,10/1/2021,BGD,Kelantan,0,0,0,Bangladesh
35871,10/1/2021,BGD,Melaka,0,0,0,Bangladesh
35872,10/1/2021,BGD,Negeri Sembilan,0,0,0,Bangladesh
35873,10/1/2021,BGD,Pahang,0,0,0,Bangladesh
35874,10/1/2021,BGD,Perak,0,0,0,Bangladesh
35875,10/1/2021,BGD,Perlis,0,0,0,Bangladesh
35876,10/1/2021,BGD,Pulau Pinang,1,1,0,Bangladesh
35877,10/1/2021,BGD,Sabah,0,0,0,Bangladesh
35878,10/1/2021,BGD,Sarawak,0,0,0,Bangladesh
35879,10/1/2021,BGD,Selangor,215,153,62,Bangladesh
35880,10/1/2021,BGD,W.P. Labuan,0,0,0,Bangladesh
35881,10/1/2021,BGR,Johor,0,0,0,Bulgaria
35882,10/1/2021,BGR,Kedah,0,0,0,Bulgaria
35883,10/1/2021,BGR,Kelantan,0,0,0,Bulgaria
35884,10/1/2021,BGR,Pahang,0,0,0,Bulgaria
35885,10/1/2021,BGR,Perak,0,0,0,Bulgaria
35886,10/1/2021,BGR,Perlis,0,0,0,Bulgaria
35887,10/1/2021,BGR,Pulau Pinang,0,0,0,Bulgaria
35888,10/1/2021,BGR,Sabah,0,0,0,Bulgaria
35889,10/1/2021,BGR,Sarawak,0,0,0,Bulgaria
35890,10/1/2021,BGR,Selangor,18,15,3,Bulgaria
35891,10/1/2021,BGR,W.P. Labuan,0,0,0,Bulgaria
35892,10/1/2021,BHR,Johor,0,0,0,Bahrain
35893,10/1/2021,BHR,Kedah,0,0,0,Bahrain
35894,10/1/2021,BHR,Kelantan,0,0,0,Bahrain
35895,10/1/2021,BHR,Perlis,0,0,0,Bahrain
35896,10/1/2021,BHR,Pulau Pinang,0,0,0,Bahrain
35897,10/1/2021,BHR,Sabah,0,0,0,Bahrain
35898,10/1/2021,BHR,Sarawak,0,0,0,Bahrain
35899,10/1/2021,BHR,Selangor,7,5,2,Bahrain
35900,10/1/2021,BHS,Johor,0,0,0,Bahamas
35901,10/1/2021,BHS,Kedah,0,0,0,Bahamas
35902,10/1/2021,BHS,Perak,0,0,0,Bahamas
35903,10/1/2021,BHS,Sabah,0,0,0,Bahamas
35904,10/1/2021,BHS,Sarawak,0,0,0,Bahamas
35905,10/1/2021,BHS,Selangor,0,0,0,Bahamas
35906,10/1/2021,BIH,Johor,0,0,0,Bosnia and Herzegovina
35907,10/1/2021,BIH,Kedah,0,0,0,Bosnia and Herzegovina
35908,10/1/2021,BIH,Perlis,0,0,0,Bosnia and Herzegovina
35909,10/1/2021,BIH,Pulau Pinang,0,0,0,Bosnia and Herzegovina
35910,10/1/2021,BIH,Sabah,0,0,0,Bosnia and Herzegovina
35911,10/1/2021,BIH,Sarawak,1,1,0,Bosnia and Herzegovina
35912,10/1/2021,BIH,Selangor,6,3,3,Bosnia and Herzegovina
35913,10/1/2021,BLR,Johor,0,0,0,Belarus
35914,10/1/2021,BLR,Kedah,0,0,0,Belarus
35915,10/1/2021,BLR,Kelantan,0,0,0,Belarus
35916,10/1/2021,BLR,Pahang,0,0,0,Belarus
35917,10/1/2021,BLR,Perak,0,0,0,Belarus
35918,10/1/2021,BLR,Perlis,0,0,0,Belarus
35919,10/1/2021,BLR,Pulau Pinang,0,0,0,Belarus
35920,10/1/2021,BLR,Sabah,0,0,0,Belarus
35921,10/1/2021,BLR,Sarawak,0,0,0,Belarus
35922,10/1/2021,BLR,Selangor,3,1,2,Belarus
35923,10/1/2021,BLR,W.P. Labuan,0,0,0,Belarus
35924,10/1/2021,BLZ,Johor,0,0,0,Belize
35925,10/1/2021,BLZ,Pulau Pinang,0,0,0,Belize
35926,10/1/2021,BLZ,Sarawak,0,0,0,Belize
35927,10/1/2021,BLZ,Selangor,0,0,0,Belize
35928,10/1/2021,BMU,Selangor,0,0,0,Bermuda
35929,10/1/2021,BOL,Johor,0,0,0,Bolivia
35930,10/1/2021,BOL,Kedah,0,0,0,Bolivia
35931,10/1/2021,BOL,Melaka,0,0,0,Bolivia
35932,10/1/2021,BOL,Perak,0,0,0,Bolivia
35933,10/1/2021,BOL,Perlis,0,0,0,Bolivia
35934,10/1/2021,BOL,Pulau Pinang,0,0,0,Bolivia
35935,10/1/2021,BOL,Sabah,0,0,0,Bolivia
35936,10/1/2021,BOL,Sarawak,0,0,0,Bolivia
35937,10/1/2021,BOL,Selangor,1,1,0,Bolivia
35938,10/1/2021,BRA,Johor,0,0,0,Brazil
35939,10/1/2021,BRA,Kedah,1,0,1,Brazil
35940,10/1/2021,BRA,Kelantan,0,0,0,Brazil
35941,10/1/2021,BRA,Melaka,0,0,0,Brazil
35942,10/1/2021,BRA,Pahang,0,0,0,Brazil
35943,10/1/2021,BRA,Perak,0,0,0,Brazil
35944,10/1/2021,BRA,Perlis,0,0,0,Brazil
35945,10/1/2021,BRA,Pulau Pinang,0,0,0,Brazil
35946,10/1/2021,BRA,Sabah,0,0,0,Brazil
35947,10/1/2021,BRA,Sarawak,0,0,0,Brazil
35948,10/1/2021,BRA,Selangor,28,19,9,Brazil
35949,10/1/2021,BRA,W.P. Labuan,0,0,0,Brazil
35950,10/1/2021,BRB,Johor,0,0,0,Barbados
35951,10/1/2021,BRB,Kedah,0,0,0,Barbados
35952,10/1/2021,BRB,Perlis,0,0,0,Barbados
35953,10/1/2021,BRB,Pulau Pinang,0,0,0,Barbados
35954,10/1/2021,BRB,Selangor,0,0,0,Barbados
35955,10/1/2021,BRN,Johor,0,0,0,Brunei Darussalam
35956,10/1/2021,BRN,Kedah,0,0,0,Brunei Darussalam
35957,10/1/2021,BRN,Kelantan,0,0,0,Brunei Darussalam
35958,10/1/2021,BRN,Melaka,0,0,0,Brunei Darussalam
35959,10/1/2021,BRN,Pahang,0,0,0,Brunei Darussalam
35960,10/1/2021,BRN,Perak,0,0,0,Brunei Darussalam
35961,10/1/2021,BRN,Perlis,0,0,0,Brunei Darussalam
35962,10/1/2021,BRN,Pulau Pinang,0,0,0,Brunei Darussalam
35963,10/1/2021,BRN,Sabah,0,0,0,Brunei Darussalam
35964,10/1/2021,BRN,Sarawak,210,208,2,Brunei Darussalam
35965,10/1/2021,BRN,Selangor,27,15,12,Brunei Darussalam
35966,10/1/2021,BRN,W.P. Labuan,0,0,0,Brunei Darussalam
35967,10/1/2021,BTN,Johor,0,0,0,Bhutan
35968,10/1/2021,BTN,Kedah,0,0,0,Bhutan
35969,10/1/2021,BTN,Perak,0,0,0,Bhutan
35970,10/1/2021,BTN,Perlis,0,0,0,Bhutan
35971,10/1/2021,BTN,Pulau Pinang,0,0,0,Bhutan
35972,10/1/2021,BTN,Sabah,0,0,0,Bhutan
35973,10/1/2021,BTN,Sarawak,0,0,0,Bhutan
35974,10/1/2021,BTN,Selangor,0,0,0,Bhutan
35975,10/1/2021,BWA,Johor,0,0,0,Botswana
35976,10/1/2021,BWA,Kedah,0,0,0,Botswana
35977,10/1/2021,BWA,Perlis,0,0,0,Botswana
35978,10/1/2021,BWA,Pulau Pinang,0,0,0,Botswana
35979,10/1/2021,BWA,Sabah,0,0,0,Botswana
35980,10/1/2021,BWA,Sarawak,0,0,0,Botswana
35981,10/1/2021,BWA,Selangor,5,3,2,Botswana
35982,10/1/2021,CAF,Kedah,0,0,0,Central African Republic
35983,10/1/2021,CAF,Selangor,0,0,0,Central African Republic
35984,10/1/2021,CAN,Johor,0,0,0,Canada
35985,10/1/2021,CAN,Kedah,0,0,0,Canada
35986,10/1/2021,CAN,Kelantan,0,0,0,Canada
35987,10/1/2021,CAN,Melaka,0,0,0,Canada
35988,10/1/2021,CAN,Negeri Sembilan,0,0,0,Canada
35989,10/1/2021,CAN,Pahang,0,0,0,Canada
35990,10/1/2021,CAN,Perak,0,0,0,Canada
35991,10/1/2021,CAN,Perlis,0,0,0,Canada
35992,10/1/2021,CAN,Pulau Pinang,0,0,0,Canada
35993,10/1/2021,CAN,Sabah,0,0,0,Canada
35994,10/1/2021,CAN,Sarawak,0,0,0,Canada
35995,10/1/2021,CAN,Selangor,68,50,18,Canada
35996,10/1/2021,CAN,Terengganu,0,0,0,Canada
35997,10/1/2021,CAN,W.P. Labuan,0,0,0,Canada
35998,10/1/2021,CCK,Selangor,0,0,0,Cocos (Keeling) Islands
35999,10/1/2021,CHE,Johor,0,0,0,Switzerland
36000,10/1/2021,CHE,Kedah,0,0,0,Switzerland
36001,10/1/2021,CHE,Kelantan,0,0,0,Switzerland
36002,10/1/2021,CHE,Melaka,0,0,0,Switzerland
36003,10/1/2021,CHE,Negeri Sembilan,0,0,0,Switzerland
36004,10/1/2021,CHE,Pahang,0,0,0,Switzerland
36005,10/1/2021,CHE,Perak,0,0,0,Switzerland
36006,10/1/2021,CHE,Perlis,0,0,0,Switzerland
36007,10/1/2021,CHE,Pulau Pinang,2,1,1,Switzerland
36008,10/1/2021,CHE,Sabah,0,0,0,Switzerland
36009,10/1/2021,CHE,Sarawak,0,0,0,Switzerland
36010,10/1/2021,CHE,Selangor,41,26,15,Switzerland
36011,10/1/2021,CHE,W.P. Labuan,0,0,0,Switzerland
36012,10/1/2021,CHL,Johor,0,0,0,Chile
36013,10/1/2021,CHL,Kedah,0,0,0,Chile
36014,10/1/2021,CHL,Kelantan,0,0,0,Chile
36015,10/1/2021,CHL,Melaka,0,0,0,Chile
36016,10/1/2021,CHL,Pahang,0,0,0,Chile
36017,10/1/2021,CHL,Perak,0,0,0,Chile
36018,10/1/2021,CHL,Perlis,0,0,0,Chile
36019,10/1/2021,CHL,Pulau Pinang,0,0,0,Chile
36020,10/1/2021,CHL,Sabah,0,0,0,Chile
36021,10/1/2021,CHL,Sarawak,0,0,0,Chile
36022,10/1/2021,CHL,Selangor,15,9,6,Chile
36023,10/1/2021,CHN,Johor,15,13,2,China
36024,10/1/2021,CHN,Kedah,0,0,0,China
36025,10/1/2021,CHN,Kelantan,0,0,0,China
36026,10/1/2021,CHN,Melaka,0,0,0,China
36027,10/1/2021,CHN,Pahang,0,0,0,China
36028,10/1/2021,CHN,Perak,0,0,0,China
36029,10/1/2021,CHN,Perlis,0,0,0,China
36030,10/1/2021,CHN,Pulau Pinang,5,4,1,China
36031,10/1/2021,CHN,Sabah,4,3,1,China
36032,10/1/2021,CHN,Sarawak,31,28,3,China
36033,10/1/2021,CHN,Selangor,1141,880,261,China
36034,10/1/2021,CHN,Terengganu,0,0,0,China
36035,10/1/2021,CHN,W.P. Labuan,0,0,0,China
36036,10/1/2021,CIV,Johor,0,0,0,C��te d'Iv
36037,10/1/2021,CIV,Kedah,0,0,0,C��te d'Iv
36038,10/1/2021,CIV,Pulau Pinang,0,0,0,C��te d'Iv
36039,10/1/2021,CIV,Sabah,0,0,0,C��te d'Iv
36040,10/1/2021,CIV,Sarawak,0,0,0,C��te d'Iv
36041,10/1/2021,CIV,Selangor,1,0,1,C��te d'Iv
36042,10/1/2021,CMR,Johor,0,0,0,Cameroon
36043,10/1/2021,CMR,Kedah,0,0,0,Cameroon
36044,10/1/2021,CMR,Pulau Pinang,0,0,0,Cameroon
36045,10/1/2021,CMR,Sabah,0,0,0,Cameroon
36046,10/1/2021,CMR,Sarawak,0,0,0,Cameroon
36047,10/1/2021,CMR,Selangor,5,3,2,Cameroon
36048,10/1/2021,COD,Johor,0,0,0,"Congo, the Democratic Republic of the"
36049,10/1/2021,COD,Pulau Pinang,0,0,0,"Congo, the Democratic Republic of the"
36050,10/1/2021,COD,Sarawak,0,0,0,"Congo, the Democratic Republic of the"
36051,10/1/2021,COD,Selangor,6,3,3,"Congo, the Democratic Republic of the"
36052,10/1/2021,COG,Johor,0,0,0,Congo
36053,10/1/2021,COG,Kedah,0,0,0,Congo
36054,10/1/2021,COG,Selangor,1,1,0,Congo
36055,10/1/2021,COK,Selangor,0,0,0,Cook Islands
36056,10/1/2021,COL,Johor,0,0,0,Colombia
36057,10/1/2021,COL,Kedah,0,0,0,Colombia
36058,10/1/2021,COL,Perak,0,0,0,Colombia
36059,10/1/2021,COL,Pulau Pinang,1,0,1,Colombia
36060,10/1/2021,COL,Sabah,0,0,0,Colombia
36061,10/1/2021,COL,Sarawak,0,0,0,Colombia
36062,10/1/2021,COL,Selangor,6,4,2,Colombia
36063,10/1/2021,COL,W.P. Labuan,0,0,0,Colombia
36064,10/1/2021,COM,Johor,0,0,0,Comoros
36065,10/1/2021,COM,Kedah,0,0,0,Comoros
36066,10/1/2021,COM,Selangor,2,2,0,Comoros
36067,10/1/2021,CPV,Johor,0,0,0,Cape Verde
36068,10/1/2021,CPV,Kedah,0,0,0,Cape Verde
36069,10/1/2021,CPV,Pulau Pinang,0,0,0,Cape Verde
36070,10/1/2021,CPV,Sabah,0,0,0,Cape Verde
36071,10/1/2021,CPV,Selangor,0,0,0,Cape Verde
36072,10/1/2021,CRI,Johor,0,0,0,Costa Rica
36073,10/1/2021,CRI,Kedah,0,0,0,Costa Rica
36074,10/1/2021,CRI,Perak,0,0,0,Costa Rica
36075,10/1/2021,CRI,Perlis,0,0,0,Costa Rica
36076,10/1/2021,CRI,Pulau Pinang,0,0,0,Costa Rica
36077,10/1/2021,CRI,Sabah,0,0,0,Costa Rica
36078,10/1/2021,CRI,Sarawak,0,0,0,Costa Rica
36079,10/1/2021,CRI,Selangor,2,1,1,Costa Rica
36080,10/1/2021,CUB,Johor,0,0,0,Cuba
36081,10/1/2021,CUB,Kedah,0,0,0,Cuba
36082,10/1/2021,CUB,Perlis,0,0,0,Cuba
36083,10/1/2021,CUB,Pulau Pinang,0,0,0,Cuba
36084,10/1/2021,CUB,Sabah,0,0,0,Cuba
36085,10/1/2021,CUB,Sarawak,0,0,0,Cuba
36086,10/1/2021,CUB,Selangor,0,0,0,Cuba
36087,10/1/2021,CYP,Johor,0,0,0,Cyprus
36088,10/1/2021,CYP,Kedah,0,0,0,Cyprus
36089,10/1/2021,CYP,Perak,0,0,0,Cyprus
36090,10/1/2021,CYP,Perlis,0,0,0,Cyprus
36091,10/1/2021,CYP,Pulau Pinang,0,0,0,Cyprus
36092,10/1/2021,CYP,Sabah,0,0,0,Cyprus
36093,10/1/2021,CYP,Sarawak,0,0,0,Cyprus
36094,10/1/2021,CYP,Selangor,0,0,0,Cyprus
36095,10/1/2021,CZE,Johor,0,0,0,Czech Republic
36096,10/1/2021,CZE,Kedah,0,0,0,Czech Republic
36097,10/1/2021,CZE,Kelantan,0,0,0,Czech Republic
36098,10/1/2021,CZE,Melaka,0,0,0,Czech Republic
36099,10/1/2021,CZE,Negeri Sembilan,0,0,0,Czech Republic
36100,10/1/2021,CZE,Perak,0,0,0,Czech Republic
36101,10/1/2021,CZE,Perlis,0,0,0,Czech Republic
36102,10/1/2021,CZE,Pulau Pinang,0,0,0,Czech Republic
36103,10/1/2021,CZE,Sabah,0,0,0,Czech Republic
36104,10/1/2021,CZE,Sarawak,0,0,0,Czech Republic
36105,10/1/2021,CZE,Selangor,4,4,0,Czech Republic
36106,10/1/2021,CZE,W.P. Labuan,0,0,0,Czech Republic
36107,10/1/2021,DEU,Johor,1,1,0,Germany
36108,10/1/2021,DEU,Kedah,0,0,0,Germany
36109,10/1/2021,DEU,Kelantan,0,0,0,Germany
36110,10/1/2021,DEU,Melaka,0,0,0,Germany
36111,10/1/2021,DEU,Negeri Sembilan,0,0,0,Germany
36112,10/1/2021,DEU,Pahang,0,0,0,Germany
36113,10/1/2021,DEU,Perak,0,0,0,Germany
36114,10/1/2021,DEU,Perlis,0,0,0,Germany
36115,10/1/2021,DEU,Pulau Pinang,6,4,2,Germany
36116,10/1/2021,DEU,Sabah,0,0,0,Germany
36117,10/1/2021,DEU,Sarawak,2,2,0,Germany
36118,10/1/2021,DEU,Selangor,122,100,22,Germany
36119,10/1/2021,DEU,Terengganu,0,0,0,Germany
36120,10/1/2021,DEU,W.P. Labuan,0,0,0,Germany
36121,10/1/2021,DJI,Johor,0,0,0,Djibouti
36122,10/1/2021,DJI,Selangor,2,0,2,Djibouti
36123,10/1/2021,DMA,Johor,0,0,0,Dominica
36124,10/1/2021,DMA,Kedah,0,0,0,Dominica
36125,10/1/2021,DMA,Pulau Pinang,0,0,0,Dominica
36126,10/1/2021,DMA,Sabah,0,0,0,Dominica
36127,10/1/2021,DMA,Sarawak,0,0,0,Dominica
36128,10/1/2021,DMA,Selangor,0,0,0,Dominica
36129,10/1/2021,DMA,W.P. Labuan,0,0,0,Dominica
36130,10/1/2021,DNK,Johor,0,0,0,Denmark
36131,10/1/2021,DNK,Kedah,0,0,0,Denmark
36132,10/1/2021,DNK,Kelantan,0,0,0,Denmark
36133,10/1/2021,DNK,Melaka,0,0,0,Denmark
36134,10/1/2021,DNK,Negeri Sembilan,0,0,0,Denmark
36135,10/1/2021,DNK,Pahang,0,0,0,Denmark
36136,10/1/2021,DNK,Perak,0,0,0,Denmark
36137,10/1/2021,DNK,Perlis,0,0,0,Denmark
36138,10/1/2021,DNK,Pulau Pinang,2,2,0,Denmark
36139,10/1/2021,DNK,Sabah,0,0,0,Denmark
36140,10/1/2021,DNK,Sarawak,0,0,0,Denmark
36141,10/1/2021,DNK,Selangor,28,19,9,Denmark
36142,10/1/2021,DNK,W.P. Labuan,0,0,0,Denmark
36143,10/1/2021,DOM,Johor,0,0,0,Dominican Republic
36144,10/1/2021,DOM,Kedah,0,0,0,Dominican Republic
36145,10/1/2021,DOM,Perak,0,0,0,Dominican Republic
36146,10/1/2021,DOM,Perlis,0,0,0,Dominican Republic
36147,10/1/2021,DOM,Pulau Pinang,0,0,0,Dominican Republic
36148,10/1/2021,DOM,Sabah,0,0,0,Dominican Republic
36149,10/1/2021,DOM,Sarawak,0,0,0,Dominican Republic
36150,10/1/2021,DOM,Selangor,0,0,0,Dominican Republic
36151,10/1/2021,DZA,Johor,0,0,0,Algeria
36152,10/1/2021,DZA,Kedah,0,0,0,Algeria
36153,10/1/2021,DZA,Kelantan,0,0,0,Algeria
36154,10/1/2021,DZA,Melaka,0,0,0,Algeria
36155,10/1/2021,DZA,Perak,0,0,0,Algeria
36156,10/1/2021,DZA,Perlis,0,0,0,Algeria
36157,10/1/2021,DZA,Pulau Pinang,0,0,0,Algeria
36158,10/1/2021,DZA,Sabah,0,0,0,Algeria
36159,10/1/2021,DZA,Sarawak,0,0,0,Algeria
36160,10/1/2021,DZA,Selangor,11,9,2,Algeria
36161,10/1/2021,DZA,W.P. Labuan,0,0,0,Algeria
36162,10/1/2021,ECU,Johor,0,0,0,Ecuador
36163,10/1/2021,ECU,Kedah,0,0,0,Ecuador
36164,10/1/2021,ECU,Perak,0,0,0,Ecuador
36165,10/1/2021,ECU,Perlis,0,0,0,Ecuador
36166,10/1/2021,ECU,Pulau Pinang,0,0,0,Ecuador
36167,10/1/2021,ECU,Sabah,0,0,0,Ecuador
36168,10/1/2021,ECU,Sarawak,0,0,0,Ecuador
36169,10/1/2021,ECU,Selangor,1,1,0,Ecuador
36170,10/1/2021,EGY,Johor,1,1,0,Egypt
36171,10/1/2021,EGY,Kedah,0,0,0,Egypt
36172,10/1/2021,EGY,Kelantan,0,0,0,Egypt
36173,10/1/2021,EGY,Melaka,0,0,0,Egypt
36174,10/1/2021,EGY,Pahang,0,0,0,Egypt
36175,10/1/2021,EGY,Perak,0,0,0,Egypt
36176,10/1/2021,EGY,Perlis,0,0,0,Egypt
36177,10/1/2021,EGY,Pulau Pinang,0,0,0,Egypt
36178,10/1/2021,EGY,Sabah,0,0,0,Egypt
36179,10/1/2021,EGY,Sarawak,0,0,0,Egypt
36180,10/1/2021,EGY,Selangor,164,124,40,Egypt
36181,10/1/2021,EGY,Terengganu,0,0,0,Egypt
36182,10/1/2021,EGY,W.P. Labuan,0,0,0,Egypt
36183,10/1/2021,ERI,Johor,0,0,0,Eritrea
36184,10/1/2021,ERI,Pulau Pinang,0,0,0,Eritrea
36185,10/1/2021,ERI,Sabah,0,0,0,Eritrea
36186,10/1/2021,ERI,Selangor,2,1,1,Eritrea
36187,10/1/2021,ESP,Johor,0,0,0,Spain
36188,10/1/2021,ESP,Kedah,0,0,0,Spain
36189,10/1/2021,ESP,Kelantan,0,0,0,Spain
36190,10/1/2021,ESP,Melaka,0,0,0,Spain
36191,10/1/2021,ESP,Negeri Sembilan,0,0,0,Spain
36192,10/1/2021,ESP,Pahang,0,0,0,Spain
36193,10/1/2021,ESP,Perak,0,0,0,Spain
36194,10/1/2021,ESP,Perlis,0,0,0,Spain
36195,10/1/2021,ESP,Pulau Pinang,0,0,0,Spain
36196,10/1/2021,ESP,Sabah,0,0,0,Spain
36197,10/1/2021,ESP,Sarawak,0,0,0,Spain
36198,10/1/2021,ESP,Selangor,19,13,6,Spain
36199,10/1/2021,ESP,W.P. Labuan,0,0,0,Spain
36200,10/1/2021,EST,Johor,0,0,0,Estonia
36201,10/1/2021,EST,Kedah,0,0,0,Estonia
36202,10/1/2021,EST,Kelantan,0,0,0,Estonia
36203,10/1/2021,EST,Pahang,0,0,0,Estonia
36204,10/1/2021,EST,Perak,0,0,0,Estonia
36205,10/1/2021,EST,Perlis,0,0,0,Estonia
36206,10/1/2021,EST,Pulau Pinang,0,0,0,Estonia
36207,10/1/2021,EST,Sabah,0,0,0,Estonia
36208,10/1/2021,EST,Sarawak,0,0,0,Estonia
36209,10/1/2021,EST,Selangor,1,1,0,Estonia
36210,10/1/2021,EST,W.P. Labuan,0,0,0,Estonia
36211,10/1/2021,ETH,Johor,0,0,0,Ethiopia
36212,10/1/2021,ETH,Kedah,0,0,0,Ethiopia
36213,10/1/2021,ETH,Pulau Pinang,0,0,0,Ethiopia
36214,10/1/2021,ETH,Sarawak,0,0,0,Ethiopia
36215,10/1/2021,ETH,Selangor,4,2,2,Ethiopia
36216,10/1/2021,FIN,Johor,0,0,0,Finland
36217,10/1/2021,FIN,Kedah,0,0,0,Finland
36218,10/1/2021,FIN,Kelantan,0,0,0,Finland
36219,10/1/2021,FIN,Melaka,0,0,0,Finland
36220,10/1/2021,FIN,Negeri Sembilan,0,0,0,Finland
36221,10/1/2021,FIN,Pahang,0,0,0,Finland
36222,10/1/2021,FIN,Perak,0,0,0,Finland
36223,10/1/2021,FIN,Perlis,0,0,0,Finland
36224,10/1/2021,FIN,Pulau Pinang,0,0,0,Finland
36225,10/1/2021,FIN,Sabah,0,0,0,Finland
36226,10/1/2021,FIN,Sarawak,0,0,0,Finland
36227,10/1/2021,FIN,Selangor,12,7,5,Finland
36228,10/1/2021,FIN,W.P. Labuan,0,0,0,Finland
36229,10/1/2021,FJI,Johor,0,0,0,Fiji
36230,10/1/2021,FJI,Kedah,0,0,0,Fiji
36231,10/1/2021,FJI,Kelantan,0,0,0,Fiji
36232,10/1/2021,FJI,Perak,0,0,0,Fiji
36233,10/1/2021,FJI,Perlis,0,0,0,Fiji
36234,10/1/2021,FJI,Pulau Pinang,0,0,0,Fiji
36235,10/1/2021,FJI,Sabah,0,0,0,Fiji
36236,10/1/2021,FJI,Sarawak,0,0,0,Fiji
36237,10/1/2021,FJI,Selangor,0,0,0,Fiji
36238,10/1/2021,FRA,Johor,0,0,0,France
36239,10/1/2021,FRA,Kedah,0,0,0,France
36240,10/1/2021,FRA,Kelantan,0,0,0,France
36241,10/1/2021,FRA,Melaka,0,0,0,France
36242,10/1/2021,FRA,Negeri Sembilan,0,0,0,France
36243,10/1/2021,FRA,Pahang,0,0,0,France
36244,10/1/2021,FRA,Perak,0,0,0,France
36245,10/1/2021,FRA,Perlis,0,0,0,France
36246,10/1/2021,FRA,Pulau Pinang,5,3,2,France
36247,10/1/2021,FRA,Sabah,0,0,0,France
36248,10/1/2021,FRA,Sarawak,0,0,0,France
36249,10/1/2021,FRA,Selangor,180,120,60,France
36250,10/1/2021,FRA,Terengganu,0,0,0,France
36251,10/1/2021,FRA,W.P. Labuan,0,0,0,France
36252,10/1/2021,FSM,Johor,0,0,0,"Micronesia, Federated States of"
36253,10/1/2021,FSM,Pulau Pinang,0,0,0,"Micronesia, Federated States of"
36254,10/1/2021,FSM,Selangor,0,0,0,"Micronesia, Federated States of"
36255,10/1/2021,GAB,Johor,0,0,0,Gabon
36256,10/1/2021,GAB,Pulau Pinang,0,0,0,Gabon
36257,10/1/2021,GAB,Sarawak,0,0,0,Gabon
36258,10/1/2021,GAB,Selangor,1,1,0,Gabon
36259,10/1/2021,GBR,Johor,0,0,0,United Kingdom
36260,10/1/2021,GBR,Kedah,1,0,1,United Kingdom
36261,10/1/2021,GBR,Kelantan,0,0,0,United Kingdom
36262,10/1/2021,GBR,Melaka,0,0,0,United Kingdom
36263,10/1/2021,GBR,Negeri Sembilan,0,0,0,United Kingdom
36264,10/1/2021,GBR,Pahang,0,0,0,United Kingdom
36265,10/1/2021,GBR,Perak,1,0,1,United Kingdom
36266,10/1/2021,GBR,Perlis,0,0,0,United Kingdom
36267,10/1/2021,GBR,Pulau Pinang,17,9,8,United Kingdom
36268,10/1/2021,GBR,Sabah,0,0,0,United Kingdom
36269,10/1/2021,GBR,Sarawak,3,2,1,United Kingdom
36270,10/1/2021,GBR,Selangor,350,242,108,United Kingdom
36271,10/1/2021,GBR,Terengganu,0,0,0,United Kingdom
36272,10/1/2021,GBR,W.P. Labuan,0,0,0,United Kingdom
36273,10/1/2021,GEO,Johor,0,0,0,Georgia
36274,10/1/2021,GEO,Kedah,0,0,0,Georgia
36275,10/1/2021,GEO,Melaka,0,0,0,Georgia
36276,10/1/2021,GEO,Perak,0,0,0,Georgia
36277,10/1/2021,GEO,Perlis,0,0,0,Georgia
36278,10/1/2021,GEO,Pulau Pinang,0,0,0,Georgia
36279,10/1/2021,GEO,Sabah,0,0,0,Georgia
36280,10/1/2021,GEO,Sarawak,0,0,0,Georgia
36281,10/1/2021,GEO,Selangor,2,1,1,Georgia
36282,10/1/2021,GHA,Johor,0,0,0,Ghana
36283,10/1/2021,GHA,Kedah,0,0,0,Ghana
36284,10/1/2021,GHA,Kelantan,0,0,0,Ghana
36285,10/1/2021,GHA,Pulau Pinang,0,0,0,Ghana
36286,10/1/2021,GHA,Sabah,0,0,0,Ghana
36287,10/1/2021,GHA,Sarawak,0,0,0,Ghana
36288,10/1/2021,GHA,Selangor,6,3,3,Ghana
36289,10/1/2021,GIB,Johor,0,0,0,Gibraltar
36290,10/1/2021,GIB,Sarawak,0,0,0,Gibraltar
36291,10/1/2021,GIN,Johor,0,0,0,Guinea
36292,10/1/2021,GIN,Kedah,0,0,0,Guinea
36293,10/1/2021,GIN,Kelantan,0,0,0,Guinea
36294,10/1/2021,GIN,Perlis,0,0,0,Guinea
36295,10/1/2021,GIN,Pulau Pinang,0,0,0,Guinea
36296,10/1/2021,GIN,Sabah,0,0,0,Guinea
36297,10/1/2021,GIN,Sarawak,0,0,0,Guinea
36298,10/1/2021,GIN,Selangor,10,7,3,Guinea
36299,10/1/2021,GLP,Selangor,0,0,0,Guadeloupe
36300,10/1/2021,GMB,Johor,0,0,0,Gambia
36301,10/1/2021,GMB,Kedah,0,0,0,Gambia
36302,10/1/2021,GMB,Kelantan,0,0,0,Gambia
36303,10/1/2021,GMB,Pulau Pinang,0,0,0,Gambia
36304,10/1/2021,GMB,Sabah,0,0,0,Gambia
36305,10/1/2021,GMB,Sarawak,0,0,0,Gambia
36306,10/1/2021,GMB,Selangor,1,1,0,Gambia
36307,10/1/2021,GNB,Johor,0,0,0,Guinea-Bissau
36308,10/1/2021,GNB,Selangor,0,0,0,Guinea-Bissau
36309,10/1/2021,GNQ,Johor,0,0,0,Equatorial Guinea
36310,10/1/2021,GNQ,Selangor,0,0,0,Equatorial Guinea
36311,10/1/2021,GRC,Johor,0,0,0,Greece
36312,10/1/2021,GRC,Kedah,0,0,0,Greece
36313,10/1/2021,GRC,Kelantan,0,0,0,Greece
36314,10/1/2021,GRC,Melaka,0,0,0,Greece
36315,10/1/2021,GRC,Negeri Sembilan,0,0,0,Greece
36316,10/1/2021,GRC,Pahang,0,0,0,Greece
36317,10/1/2021,GRC,Perak,0,0,0,Greece
36318,10/1/2021,GRC,Perlis,0,0,0,Greece
36319,10/1/2021,GRC,Pulau Pinang,0,0,0,Greece
36320,10/1/2021,GRC,Sabah,0,0,0,Greece
36321,10/1/2021,GRC,Sarawak,0,0,0,Greece
36322,10/1/2021,GRC,Selangor,9,7,2,Greece
36323,10/1/2021,GRD,Johor,0,0,0,Grenada
36324,10/1/2021,GRD,Kedah,0,0,0,Grenada
36325,10/1/2021,GRD,Pulau Pinang,0,0,0,Grenada
36326,10/1/2021,GRD,Sabah,0,0,0,Grenada
36327,10/1/2021,GRD,Sarawak,0,0,0,Grenada
36328,10/1/2021,GRD,Selangor,3,1,2,Grenada
36329,10/1/2021,GRL,Johor,0,0,0,Greenland
36330,10/1/2021,GRL,Selangor,0,0,0,Greenland
36331,10/1/2021,GTM,Johor,0,0,0,Guatemala
36332,10/1/2021,GTM,Kedah,0,0,0,Guatemala
36333,10/1/2021,GTM,Pahang,0,0,0,Guatemala
36334,10/1/2021,GTM,Perak,0,0,0,Guatemala
36335,10/1/2021,GTM,Pulau Pinang,0,0,0,Guatemala
36336,10/1/2021,GTM,Sabah,0,0,0,Guatemala
36337,10/1/2021,GTM,Sarawak,0,0,0,Guatemala
36338,10/1/2021,GTM,Selangor,2,2,0,Guatemala
36339,10/1/2021,GTM,W.P. Labuan,0,0,0,Guatemala
36340,10/1/2021,GUY,Johor,0,0,0,Guyana
36341,10/1/2021,GUY,Kedah,0,0,0,Guyana
36342,10/1/2021,GUY,Pulau Pinang,0,0,0,Guyana
36343,10/1/2021,GUY,Sarawak,0,0,0,Guyana
36344,10/1/2021,GUY,Selangor,0,0,0,Guyana
36345,10/1/2021,HKG,Johor,0,0,0,Hong Kong
36346,10/1/2021,HKG,Kedah,0,0,0,Hong Kong
36347,10/1/2021,HKG,Kelantan,0,0,0,Hong Kong
36348,10/1/2021,HKG,Pahang,0,0,0,Hong Kong
36349,10/1/2021,HKG,Perak,0,0,0,Hong Kong
36350,10/1/2021,HKG,Perlis,0,0,0,Hong Kong
36351,10/1/2021,HKG,Pulau Pinang,1,0,1,Hong Kong
36352,10/1/2021,HKG,Sabah,0,0,0,Hong Kong
36353,10/1/2021,HKG,Sarawak,49,47,2,Hong Kong
36354,10/1/2021,HKG,Selangor,0,0,0,Hong Kong
36355,10/1/2021,HKG,Terengganu,0,0,0,Hong Kong
36356,10/1/2021,HMD,Johor,0,0,0,Heard Island and McDonald Islands
36357,10/1/2021,HND,Johor,0,0,0,Honduras
36358,10/1/2021,HND,Kedah,0,0,0,Honduras
36359,10/1/2021,HND,Perak,0,0,0,Honduras
36360,10/1/2021,HND,Pulau Pinang,0,0,0,Honduras
36361,10/1/2021,HND,Sabah,0,0,0,Honduras
36362,10/1/2021,HND,Sarawak,0,0,0,Honduras
36363,10/1/2021,HND,Selangor,2,2,0,Honduras
36364,10/1/2021,HRV,Johor,0,0,0,Croatia
36365,10/1/2021,HRV,Kedah,0,0,0,Croatia
36366,10/1/2021,HRV,Kelantan,0,0,0,Croatia
36367,10/1/2021,HRV,Melaka,0,0,0,Croatia
36368,10/1/2021,HRV,Pahang,0,0,0,Croatia
36369,10/1/2021,HRV,Perak,0,0,0,Croatia
36370,10/1/2021,HRV,Perlis,0,0,0,Croatia
36371,10/1/2021,HRV,Pulau Pinang,0,0,0,Croatia
36372,10/1/2021,HRV,Sabah,0,0,0,Croatia
36373,10/1/2021,HRV,Sarawak,1,1,0,Croatia
36374,10/1/2021,HRV,Selangor,10,10,0,Croatia
36375,10/1/2021,HTI,Johor,0,0,0,Haiti
36376,10/1/2021,HTI,Kedah,0,0,0,Haiti
36377,10/1/2021,HTI,Kelantan,0,0,0,Haiti
36378,10/1/2021,HTI,Perak,0,0,0,Haiti
36379,10/1/2021,HTI,Pulau Pinang,0,0,0,Haiti
36380,10/1/2021,HTI,Sabah,0,0,0,Haiti
36381,10/1/2021,HTI,Selangor,0,0,0,Haiti
36382,10/1/2021,HUN,Johor,0,0,0,Hungary
36383,10/1/2021,HUN,Kedah,0,0,0,Hungary
36384,10/1/2021,HUN,Kelantan,0,0,0,Hungary
36385,10/1/2021,HUN,Pahang,0,0,0,Hungary
36386,10/1/2021,HUN,Perak,0,0,0,Hungary
36387,10/1/2021,HUN,Perlis,0,0,0,Hungary
36388,10/1/2021,HUN,Pulau Pinang,0,0,0,Hungary
36389,10/1/2021,HUN,Sabah,0,0,0,Hungary
36390,10/1/2021,HUN,Sarawak,0,0,0,Hungary
36391,10/1/2021,HUN,Selangor,8,3,5,Hungary
36392,10/1/2021,HUN,W.P. Labuan,0,0,0,Hungary
36393,10/1/2021,IDN,Johor,73,56,17,Indonesia
36394,10/1/2021,IDN,Kedah,4,4,0,Indonesia
36395,10/1/2021,IDN,Kelantan,0,0,0,Indonesia
36396,10/1/2021,IDN,Melaka,0,0,0,Indonesia
36397,10/1/2021,IDN,Negeri Sembilan,0,0,0,Indonesia
36398,10/1/2021,IDN,Pahang,0,0,0,Indonesia
36399,10/1/2021,IDN,Perak,2,0,2,Indonesia
36400,10/1/2021,IDN,Perlis,8,8,0,Indonesia
36401,10/1/2021,IDN,Pulau Pinang,36,14,22,Indonesia
36402,10/1/2021,IDN,Sabah,1,0,1,Indonesia
36403,10/1/2021,IDN,Sarawak,149,146,3,Indonesia
36404,10/1/2021,IDN,Selangor,1241,658,583,Indonesia
36405,10/1/2021,IDN,Terengganu,0,0,0,Indonesia
36406,10/1/2021,IDN,W.P. Labuan,0,0,0,Indonesia
36407,10/1/2021,IND,Johor,10,10,0,India
36408,10/1/2021,IND,Kedah,1,1,0,India
36409,10/1/2021,IND,Kelantan,0,0,0,India
36410,10/1/2021,IND,Melaka,0,0,0,India
36411,10/1/2021,IND,Negeri Sembilan,0,0,0,India
36412,10/1/2021,IND,Pahang,0,0,0,India
36413,10/1/2021,IND,Perak,0,0,0,India
36414,10/1/2021,IND,Perlis,0,0,0,India
36415,10/1/2021,IND,Pulau Pinang,5,3,2,India
36416,10/1/2021,IND,Sabah,1,1,0,India
36417,10/1/2021,IND,Sarawak,2,2,0,India
36418,10/1/2021,IND,Selangor,926,695,231,India
36419,10/1/2021,IND,Terengganu,0,0,0,India
36420,10/1/2021,IND,W.P. Labuan,0,0,0,India
36421,10/1/2021,IOT,Pulau Pinang,0,0,0,British Indian Ocean Territory
36422,10/1/2021,IOT,Selangor,0,0,0,British Indian Ocean Territory
36423,10/1/2021,IRL,Johor,1,1,0,Ireland
36424,10/1/2021,IRL,Kedah,0,0,0,Ireland
36425,10/1/2021,IRL,Kelantan,0,0,0,Ireland
36426,10/1/2021,IRL,Negeri Sembilan,0,0,0,Ireland
36427,10/1/2021,IRL,Pahang,0,0,0,Ireland
36428,10/1/2021,IRL,Perak,0,0,0,Ireland
36429,10/1/2021,IRL,Perlis,0,0,0,Ireland
36430,10/1/2021,IRL,Pulau Pinang,2,2,0,Ireland
36431,10/1/2021,IRL,Sabah,0,0,0,Ireland
36432,10/1/2021,IRL,Sarawak,0,0,0,Ireland
36433,10/1/2021,IRL,Selangor,17,11,6,Ireland
36434,10/1/2021,IRL,Terengganu,0,0,0,Ireland
36435,10/1/2021,IRL,W.P. Labuan,0,0,0,Ireland
36436,10/1/2021,IRN,Johor,0,0,0,Iran
36437,10/1/2021,IRN,Kedah,0,0,0,Iran
36438,10/1/2021,IRN,Kelantan,0,0,0,Iran
36439,10/1/2021,IRN,Perak,0,0,0,Iran
36440,10/1/2021,IRN,Perlis,0,0,0,Iran
36441,10/1/2021,IRN,Pulau Pinang,0,0,0,Iran
36442,10/1/2021,IRN,Sabah,0,0,0,Iran
36443,10/1/2021,IRN,Sarawak,0,0,0,Iran
36444,10/1/2021,IRN,Selangor,92,47,45,Iran
36445,10/1/2021,IRN,W.P. Labuan,0,0,0,Iran
36446,10/1/2021,IRQ,Johor,0,0,0,Iraq
36447,10/1/2021,IRQ,Kedah,0,0,0,Iraq
36448,10/1/2021,IRQ,Kelantan,0,0,0,Iraq
36449,10/1/2021,IRQ,Melaka,0,0,0,Iraq
36450,10/1/2021,IRQ,Pahang,0,0,0,Iraq
36451,10/1/2021,IRQ,Perak,0,0,0,Iraq
36452,10/1/2021,IRQ,Perlis,0,0,0,Iraq
36453,10/1/2021,IRQ,Pulau Pinang,0,0,0,Iraq
36454,10/1/2021,IRQ,Sabah,0,0,0,Iraq
36455,10/1/2021,IRQ,Sarawak,0,0,0,Iraq
36456,10/1/2021,IRQ,Selangor,69,49,20,Iraq
36457,10/1/2021,ISL,Johor,0,0,0,Iceland
36458,10/1/2021,ISL,Kedah,0,0,0,Iceland
36459,10/1/2021,ISL,Kelantan,0,0,0,Iceland
36460,10/1/2021,ISL,Perak,0,0,0,Iceland
36461,10/1/2021,ISL,Perlis,0,0,0,Iceland
36462,10/1/2021,ISL,Pulau Pinang,0,0,0,Iceland
36463,10/1/2021,ISL,Sabah,0,0,0,Iceland
36464,10/1/2021,ISL,Sarawak,0,0,0,Iceland
36465,10/1/2021,ISL,Selangor,0,0,0,Iceland
36466,10/1/2021,ISL,W.P. Labuan,0,0,0,Iceland
36467,10/1/2021,ISR,Pulau Pinang,0,0,0,Israel
36468,10/1/2021,ITA,Johor,0,0,0,Italy
36469,10/1/2021,ITA,Kedah,0,0,0,Italy
36470,10/1/2021,ITA,Kelantan,0,0,0,Italy
36471,10/1/2021,ITA,Melaka,0,0,0,Italy
36472,10/1/2021,ITA,Negeri Sembilan,0,0,0,Italy
36473,10/1/2021,ITA,Pahang,0,0,0,Italy
36474,10/1/2021,ITA,Perak,0,0,0,Italy
36475,10/1/2021,ITA,Perlis,0,0,0,Italy
36476,10/1/2021,ITA,Pulau Pinang,0,0,0,Italy
36477,10/1/2021,ITA,Sabah,0,0,0,Italy
36478,10/1/2021,ITA,Sarawak,3,3,0,Italy
36479,10/1/2021,ITA,Selangor,78,53,25,Italy
36480,10/1/2021,ITA,W.P. Labuan,0,0,0,Italy
36481,10/1/2021,JAM,Johor,0,0,0,Jamaica
36482,10/1/2021,JAM,Kedah,0,0,0,Jamaica
36483,10/1/2021,JAM,Perak,0,0,0,Jamaica
36484,10/1/2021,JAM,Pulau Pinang,0,0,0,Jamaica
36485,10/1/2021,JAM,Sabah,0,0,0,Jamaica
36486,10/1/2021,JAM,Sarawak,0,0,0,Jamaica
36487,10/1/2021,JAM,Selangor,1,0,1,Jamaica
36488,10/1/2021,JAM,W.P. Labuan,0,0,0,Jamaica
36489,10/1/2021,JOR,Johor,0,0,0,Jordan
36490,10/1/2021,JOR,Kedah,0,0,0,Jordan
36491,10/1/2021,JOR,Kelantan,0,0,0,Jordan
36492,10/1/2021,JOR,Melaka,0,0,0,Jordan
36493,10/1/2021,JOR,Perlis,0,0,0,Jordan
36494,10/1/2021,JOR,Pulau Pinang,0,0,0,Jordan
36495,10/1/2021,JOR,Sabah,0,0,0,Jordan
36496,10/1/2021,JOR,Sarawak,0,0,0,Jordan
36497,10/1/2021,JOR,Selangor,66,43,23,Jordan
36498,10/1/2021,JOR,W.P. Labuan,0,0,0,Jordan
36499,10/1/2021,JPN,Johor,0,0,0,Japan
36500,10/1/2021,JPN,Kedah,0,0,0,Japan
36501,10/1/2021,JPN,Kelantan,0,0,0,Japan
36502,10/1/2021,JPN,Melaka,0,0,0,Japan
36503,10/1/2021,JPN,Negeri Sembilan,0,0,0,Japan
36504,10/1/2021,JPN,Pahang,0,0,0,Japan
36505,10/1/2021,JPN,Perak,2,1,1,Japan
36506,10/1/2021,JPN,Perlis,0,0,0,Japan
36507,10/1/2021,JPN,Pulau Pinang,69,38,31,Japan
36508,10/1/2021,JPN,Sabah,0,0,0,Japan
36509,10/1/2021,JPN,Sarawak,4,4,0,Japan
36510,10/1/2021,JPN,Selangor,834,541,293,Japan
36511,10/1/2021,JPN,W.P. Labuan,0,0,0,Japan
36512,10/1/2021,KAZ,Johor,0,0,0,Kazakhstan
36513,10/1/2021,KAZ,Kedah,0,0,0,Kazakhstan
36514,10/1/2021,KAZ,Kelantan,0,0,0,Kazakhstan
36515,10/1/2021,KAZ,Melaka,0,0,0,Kazakhstan
36516,10/1/2021,KAZ,Perak,0,0,0,Kazakhstan
36517,10/1/2021,KAZ,Perlis,0,0,0,Kazakhstan
36518,10/1/2021,KAZ,Pulau Pinang,0,0,0,Kazakhstan
36519,10/1/2021,KAZ,Sabah,0,0,0,Kazakhstan
36520,10/1/2021,KAZ,Sarawak,0,0,0,Kazakhstan
36521,10/1/2021,KAZ,Selangor,23,9,14,Kazakhstan
36522,10/1/2021,KAZ,W.P. Labuan,0,0,0,Kazakhstan
36523,10/1/2021,KEN,Johor,0,0,0,Kenya
36524,10/1/2021,KEN,Kedah,0,0,0,Kenya
36525,10/1/2021,KEN,Kelantan,0,0,0,Kenya
36526,10/1/2021,KEN,Perak,0,0,0,Kenya
36527,10/1/2021,KEN,Perlis,0,0,0,Kenya
36528,10/1/2021,KEN,Pulau Pinang,0,0,0,Kenya
36529,10/1/2021,KEN,Sabah,0,0,0,Kenya
36530,10/1/2021,KEN,Sarawak,0,0,0,Kenya
36531,10/1/2021,KEN,Selangor,15,4,11,Kenya
36532,10/1/2021,KGZ,Johor,0,0,0,Kyrgyzstan
36533,10/1/2021,KGZ,Kedah,0,0,0,Kyrgyzstan
36534,10/1/2021,KGZ,Kelantan,0,0,0,Kyrgyzstan
36535,10/1/2021,KGZ,Perak,0,0,0,Kyrgyzstan
36536,10/1/2021,KGZ,Perlis,0,0,0,Kyrgyzstan
36537,10/1/2021,KGZ,Pulau Pinang,0,0,0,Kyrgyzstan
36538,10/1/2021,KGZ,Sabah,0,0,0,Kyrgyzstan
36539,10/1/2021,KGZ,Sarawak,0,0,0,Kyrgyzstan
36540,10/1/2021,KGZ,Selangor,4,1,3,Kyrgyzstan
36541,10/1/2021,KHM,Johor,0,0,0,Cambodia
36542,10/1/2021,KHM,Kedah,0,0,0,Cambodia
36543,10/1/2021,KHM,Kelantan,0,0,0,Cambodia
36544,10/1/2021,KHM,Melaka,0,0,0,Cambodia
36545,10/1/2021,KHM,Negeri Sembilan,0,0,0,Cambodia
36546,10/1/2021,KHM,Pahang,0,0,0,Cambodia
36547,10/1/2021,KHM,Perak,0,0,0,Cambodia
36548,10/1/2021,KHM,Perlis,0,0,0,Cambodia
36549,10/1/2021,KHM,Pulau Pinang,0,0,0,Cambodia
36550,10/1/2021,KHM,Sabah,0,0,0,Cambodia
36551,10/1/2021,KHM,Sarawak,0,0,0,Cambodia
36552,10/1/2021,KHM,Selangor,36,34,2,Cambodia
36553,10/1/2021,KHM,W.P. Labuan,0,0,0,Cambodia
36554,10/1/2021,KIR,Johor,0,0,0,Kiribati
36555,10/1/2021,KIR,Sabah,0,0,0,Kiribati
36556,10/1/2021,KIR,Selangor,0,0,0,Kiribati
36557,10/1/2021,KNA,Johor,0,0,0,Saint Kitts and Nevis
36558,10/1/2021,KNA,Kedah,0,0,0,Saint Kitts and Nevis
36559,10/1/2021,KNA,Perlis,0,0,0,Saint Kitts and Nevis
36560,10/1/2021,KNA,Pulau Pinang,0,0,0,Saint Kitts and Nevis
36561,10/1/2021,KNA,Sabah,0,0,0,Saint Kitts and Nevis
36562,10/1/2021,KNA,Selangor,3,2,1,Saint Kitts and Nevis
36563,10/1/2021,KNA,W.P. Labuan,0,0,0,Saint Kitts and Nevis
36564,10/1/2021,KOR,Johor,0,0,0,"Korea, Republic of (South Korea)"
36565,10/1/2021,KOR,Kedah,0,0,0,"Korea, Republic of (South Korea)"
36566,10/1/2021,KOR,Kelantan,0,0,0,"Korea, Republic of (South Korea)"
36567,10/1/2021,KOR,Melaka,0,0,0,"Korea, Republic of (South Korea)"
36568,10/1/2021,KOR,Negeri Sembilan,0,0,0,"Korea, Republic of (South Korea)"
36569,10/1/2021,KOR,Pahang,0,0,0,"Korea, Republic of (South Korea)"
36570,10/1/2021,KOR,Perak,0,0,0,"Korea, Republic of (South Korea)"
36571,10/1/2021,KOR,Perlis,0,0,0,"Korea, Republic of (South Korea)"
36572,10/1/2021,KOR,Pulau Pinang,11,5,6,"Korea, Republic of (South Korea)"
36573,10/1/2021,KOR,Sabah,2,2,0,"Korea, Republic of (South Korea)"
36574,10/1/2021,KOR,Sarawak,36,31,5,"Korea, Republic of (South Korea)"
36575,10/1/2021,KOR,Selangor,627,423,204,"Korea, Republic of (South Korea)"
36576,10/1/2021,KOR,Terengganu,0,0,0,"Korea, Republic of (South Korea)"
36577,10/1/2021,KOR,W.P. Labuan,0,0,0,"Korea, Republic of (South Korea)"
36578,10/1/2021,KWT,Johor,0,0,0,Kuwait
36579,10/1/2021,KWT,Kedah,0,0,0,Kuwait
36580,10/1/2021,KWT,Kelantan,0,0,0,Kuwait
36581,10/1/2021,KWT,Perak,0,0,0,Kuwait
36582,10/1/2021,KWT,Perlis,0,0,0,Kuwait
36583,10/1/2021,KWT,Pulau Pinang,0,0,0,Kuwait
36584,10/1/2021,KWT,Sabah,0,0,0,Kuwait
36585,10/1/2021,KWT,Sarawak,0,0,0,Kuwait
36586,10/1/2021,KWT,Selangor,9,4,5,Kuwait
36587,10/1/2021,KWT,W.P. Labuan,0,0,0,Kuwait
36588,10/1/2021,LAO,Johor,0,0,0,Lao People's Democratic Republic
36589,10/1/2021,LAO,Kedah,0,0,0,Lao People's Democratic Republic
36590,10/1/2021,LAO,Kelantan,0,0,0,Lao People's Democratic Republic
36591,10/1/2021,LAO,Melaka,0,0,0,Lao People's Democratic Republic
36592,10/1/2021,LAO,Perak,0,0,0,Lao People's Democratic Republic
36593,10/1/2021,LAO,Perlis,0,0,0,Lao People's Democratic Republic
36594,10/1/2021,LAO,Pulau Pinang,0,0,0,Lao People's Democratic Republic
36595,10/1/2021,LAO,Sabah,0,0,0,Lao People's Democratic Republic
36596,10/1/2021,LAO,Sarawak,0,0,0,Lao People's Democratic Republic
36597,10/1/2021,LAO,Selangor,1,0,1,Lao People's Democratic Republic
36598,10/1/2021,LAO,W.P. Labuan,0,0,0,Lao People's Democratic Republic
36599,10/1/2021,LBN,Johor,0,0,0,Lebanon
36600,10/1/2021,LBN,Kedah,0,0,0,Lebanon
36601,10/1/2021,LBN,Kelantan,0,0,0,Lebanon
36602,10/1/2021,LBN,Pahang,0,0,0,Lebanon
36603,10/1/2021,LBN,Perak,0,0,0,Lebanon
36604,10/1/2021,LBN,Perlis,0,0,0,Lebanon
36605,10/1/2021,LBN,Pulau Pinang,0,0,0,Lebanon
36606,10/1/2021,LBN,Sabah,0,0,0,Lebanon
36607,10/1/2021,LBN,Sarawak,0,0,0,Lebanon
36608,10/1/2021,LBN,Selangor,14,10,4,Lebanon
36609,10/1/2021,LBN,W.P. Labuan,0,0,0,Lebanon
36610,10/1/2021,LBR,Johor,0,0,0,Liberia
36611,10/1/2021,LBR,Kedah,0,0,0,Liberia
36612,10/1/2021,LBR,Sabah,0,0,0,Liberia
36613,10/1/2021,LBR,Sarawak,0,0,0,Liberia
36614,10/1/2021,LBR,Selangor,2,1,1,Liberia
36615,10/1/2021,LBY,Johor,0,0,0,Libyan Arab Jamahiriya
36616,10/1/2021,LBY,Kedah,0,0,0,Libyan Arab Jamahiriya
36617,10/1/2021,LBY,Perlis,0,0,0,Libyan Arab Jamahiriya
36618,10/1/2021,LBY,Pulau Pinang,0,0,0,Libyan Arab Jamahiriya
36619,10/1/2021,LBY,Sabah,0,0,0,Libyan Arab Jamahiriya
36620,10/1/2021,LBY,Sarawak,0,0,0,Libyan Arab Jamahiriya
36621,10/1/2021,LBY,Selangor,76,56,20,Libyan Arab Jamahiriya
36622,10/1/2021,LCA,Johor,0,0,0,Saint Lucia
36623,10/1/2021,LCA,Kedah,0,0,0,Saint Lucia
36624,10/1/2021,LCA,Pulau Pinang,0,0,0,Saint Lucia
36625,10/1/2021,LCA,Sarawak,0,0,0,Saint Lucia
36626,10/1/2021,LCA,Selangor,0,0,0,Saint Lucia
36627,10/1/2021,LIE,Johor,0,0,0,Liechtenstein
36628,10/1/2021,LIE,Kedah,0,0,0,Liechtenstein
36629,10/1/2021,LIE,Perlis,0,0,0,Liechtenstein
36630,10/1/2021,LIE,Pulau Pinang,0,0,0,Liechtenstein
36631,10/1/2021,LIE,Sabah,0,0,0,Liechtenstein
36632,10/1/2021,LIE,Sarawak,0,0,0,Liechtenstein
36633,10/1/2021,LIE,Selangor,1,1,0,Liechtenstein
36634,10/1/2021,LKA,Johor,0,0,0,Sri Lanka
36635,10/1/2021,LKA,Kedah,0,0,0,Sri Lanka
36636,10/1/2021,LKA,Kelantan,0,0,0,Sri Lanka
36637,10/1/2021,LKA,Melaka,0,0,0,Sri Lanka
36638,10/1/2021,LKA,Pahang,0,0,0,Sri Lanka
36639,10/1/2021,LKA,Perak,0,0,0,Sri Lanka
36640,10/1/2021,LKA,Perlis,0,0,0,Sri Lanka
36641,10/1/2021,LKA,Pulau Pinang,1,0,1,Sri Lanka
36642,10/1/2021,LKA,Sabah,0,0,0,Sri Lanka
36643,10/1/2021,LKA,Sarawak,0,0,0,Sri Lanka
36644,10/1/2021,LKA,Selangor,62,39,23,Sri Lanka
36645,10/1/2021,LKA,W.P. Labuan,0,0,0,Sri Lanka
36646,10/1/2021,LSO,Johor,0,0,0,Lesotho
36647,10/1/2021,LSO,Kedah,0,0,0,Lesotho
36648,10/1/2021,LSO,Pulau Pinang,0,0,0,Lesotho
36649,10/1/2021,LSO,Sarawak,0,0,0,Lesotho
36650,10/1/2021,LSO,Selangor,0,0,0,Lesotho
36651,10/1/2021,LTU,Johor,0,0,0,Lithuania
36652,10/1/2021,LTU,Kedah,0,0,0,Lithuania
36653,10/1/2021,LTU,Kelantan,0,0,0,Lithuania
36654,10/1/2021,LTU,Pahang,0,0,0,Lithuania
36655,10/1/2021,LTU,Perak,0,0,0,Lithuania
36656,10/1/2021,LTU,Perlis,0,0,0,Lithuania
36657,10/1/2021,LTU,Pulau Pinang,0,0,0,Lithuania
36658,10/1/2021,LTU,Sabah,0,0,0,Lithuania
36659,10/1/2021,LTU,Sarawak,1,1,0,Lithuania
36660,10/1/2021,LTU,Selangor,5,3,2,Lithuania
36661,10/1/2021,LTU,W.P. Labuan,0,0,0,Lithuania
36662,10/1/2021,LUX,Johor,0,0,0,Luxembourg
36663,10/1/2021,LUX,Kedah,0,0,0,Luxembourg
36664,10/1/2021,LUX,Kelantan,0,0,0,Luxembourg
36665,10/1/2021,LUX,Perak,0,0,0,Luxembourg
36666,10/1/2021,LUX,Perlis,0,0,0,Luxembourg
36667,10/1/2021,LUX,Pulau Pinang,0,0,0,Luxembourg
36668,10/1/2021,LUX,Sabah,0,0,0,Luxembourg
36669,10/1/2021,LUX,Sarawak,0,0,0,Luxembourg
36670,10/1/2021,LUX,Selangor,4,4,0,Luxembourg
36671,10/1/2021,LVA,Johor,0,0,0,Latvia
36672,10/1/2021,LVA,Kedah,0,0,0,Latvia
36673,10/1/2021,LVA,Kelantan,0,0,0,Latvia
36674,10/1/2021,LVA,Pahang,0,0,0,Latvia
36675,10/1/2021,LVA,Perak,0,0,0,Latvia
36676,10/1/2021,LVA,Perlis,0,0,0,Latvia
36677,10/1/2021,LVA,Pulau Pinang,0,0,0,Latvia
36678,10/1/2021,LVA,Sabah,0,0,0,Latvia
36679,10/1/2021,LVA,Sarawak,0,0,0,Latvia
36680,10/1/2021,LVA,Selangor,1,1,0,Latvia
36681,10/1/2021,LVA,W.P. Labuan,0,0,0,Latvia
36682,10/1/2021,MAC,Johor,0,0,0,Macao
36683,10/1/2021,MAC,Pahang,0,0,0,Macao
36684,10/1/2021,MAC,Perak,0,0,0,Macao
36685,10/1/2021,MAC,Selangor,0,0,0,Macao
36686,10/1/2021,MAC,W.P. Labuan,0,0,0,Macao
36687,10/1/2021,MAR,Johor,0,0,0,Morocco
36688,10/1/2021,MAR,Kedah,0,0,0,Morocco
36689,10/1/2021,MAR,Kelantan,0,0,0,Morocco
36690,10/1/2021,MAR,Melaka,0,0,0,Morocco
36691,10/1/2021,MAR,Pahang,0,0,0,Morocco
36692,10/1/2021,MAR,Perak,0,0,0,Morocco
36693,10/1/2021,MAR,Perlis,0,0,0,Morocco
36694,10/1/2021,MAR,Pulau Pinang,0,0,0,Morocco
36695,10/1/2021,MAR,Sabah,0,0,0,Morocco
36696,10/1/2021,MAR,Sarawak,0,0,0,Morocco
36697,10/1/2021,MAR,Selangor,8,2,6,Morocco
36698,10/1/2021,MAR,W.P. Labuan,0,0,0,Morocco
36699,10/1/2021,MCO,Johor,0,0,0,Monaco
36700,10/1/2021,MCO,Kedah,0,0,0,Monaco
36701,10/1/2021,MCO,Sabah,0,0,0,Monaco
36702,10/1/2021,MCO,Selangor,0,0,0,Monaco
36703,10/1/2021,MDA,Johor,0,0,0,"Moldova, Republic of"
36704,10/1/2021,MDA,Kedah,0,0,0,"Moldova, Republic of"
36705,10/1/2021,MDA,Kelantan,0,0,0,"Moldova, Republic of"
36706,10/1/2021,MDA,Negeri Sembilan,0,0,0,"Moldova, Republic of"
36707,10/1/2021,MDA,Perlis,0,0,0,"Moldova, Republic of"
36708,10/1/2021,MDA,Pulau Pinang,0,0,0,"Moldova, Republic of"
36709,10/1/2021,MDA,Sabah,0,0,0,"Moldova, Republic of"
36710,10/1/2021,MDA,Sarawak,0,0,0,"Moldova, Republic of"
36711,10/1/2021,MDA,Selangor,0,0,0,"Moldova, Republic of"
36712,10/1/2021,MDG,Johor,0,0,0,Madagascar
36713,10/1/2021,MDG,Kedah,0,0,0,Madagascar
36714,10/1/2021,MDG,Perak,0,0,0,Madagascar
36715,10/1/2021,MDG,Perlis,0,0,0,Madagascar
36716,10/1/2021,MDG,Pulau Pinang,0,0,0,Madagascar
36717,10/1/2021,MDG,Sabah,0,0,0,Madagascar
36718,10/1/2021,MDG,Sarawak,0,0,0,Madagascar
36719,10/1/2021,MDG,Selangor,0,0,0,Madagascar
36720,10/1/2021,MDV,Johor,0,0,0,Maldives
36721,10/1/2021,MDV,Kedah,0,0,0,Maldives
36722,10/1/2021,MDV,Kelantan,0,0,0,Maldives
36723,10/1/2021,MDV,Perak,0,0,0,Maldives
36724,10/1/2021,MDV,Perlis,0,0,0,Maldives
36725,10/1/2021,MDV,Pulau Pinang,0,0,0,Maldives
36726,10/1/2021,MDV,Sabah,0,0,0,Maldives
36727,10/1/2021,MDV,Sarawak,0,0,0,Maldives
36728,10/1/2021,MDV,Selangor,94,32,62,Maldives
36729,10/1/2021,MEX,Johor,0,0,0,Mexico
36730,10/1/2021,MEX,Kedah,0,0,0,Mexico
36731,10/1/2021,MEX,Kelantan,0,0,0,Mexico
36732,10/1/2021,MEX,Pahang,0,0,0,Mexico
36733,10/1/2021,MEX,Perak,0,0,0,Mexico
36734,10/1/2021,MEX,Perlis,0,0,0,Mexico
36735,10/1/2021,MEX,Pulau Pinang,0,0,0,Mexico
36736,10/1/2021,MEX,Sabah,0,0,0,Mexico
36737,10/1/2021,MEX,Sarawak,0,0,0,Mexico
36738,10/1/2021,MEX,Selangor,7,6,1,Mexico
36739,10/1/2021,MEX,W.P. Labuan,0,0,0,Mexico
36740,10/1/2021,MHL,Johor,0,0,0,Marshall Islands
36741,10/1/2021,MHL,Kedah,0,0,0,Marshall Islands
36742,10/1/2021,MHL,Perak,0,0,0,Marshall Islands
36743,10/1/2021,MHL,Pulau Pinang,0,0,0,Marshall Islands
36744,10/1/2021,MHL,Sabah,0,0,0,Marshall Islands
36745,10/1/2021,MHL,Selangor,1,1,0,Marshall Islands
36746,10/1/2021,MKD,Johor,0,0,0,"Macedonia, the former Yugoslav Republic of"
36747,10/1/2021,MKD,Kedah,0,0,0,"Macedonia, the former Yugoslav Republic of"
36748,10/1/2021,MKD,Perak,0,0,0,"Macedonia, the former Yugoslav Republic of"
36749,10/1/2021,MKD,Pulau Pinang,0,0,0,"Macedonia, the former Yugoslav Republic of"
36750,10/1/2021,MKD,Sabah,0,0,0,"Macedonia, the former Yugoslav Republic of"
36751,10/1/2021,MKD,Sarawak,0,0,0,"Macedonia, the former Yugoslav Republic of"
36752,10/1/2021,MKD,Selangor,4,2,2,"Macedonia, the former Yugoslav Republic of"
36753,10/1/2021,MLI,Johor,0,0,0,Mali
36754,10/1/2021,MLI,Sabah,0,0,0,Mali
36755,10/1/2021,MLI,Selangor,3,3,0,Mali
36756,10/1/2021,MLT,Johor,0,0,0,Malta
36757,10/1/2021,MLT,Kedah,0,0,0,Malta
36758,10/1/2021,MLT,Kelantan,0,0,0,Malta
36759,10/1/2021,MLT,Perak,0,0,0,Malta
36760,10/1/2021,MLT,Perlis,0,0,0,Malta
36761,10/1/2021,MLT,Pulau Pinang,0,0,0,Malta
36762,10/1/2021,MLT,Sabah,0,0,0,Malta
36763,10/1/2021,MLT,Sarawak,0,0,0,Malta
36764,10/1/2021,MLT,Selangor,0,0,0,Malta
36765,10/1/2021,MLT,W.P. Labuan,0,0,0,Malta
36766,10/1/2021,MMR,Johor,0,0,0,Myanmar
36767,10/1/2021,MMR,Kedah,0,0,0,Myanmar
36768,10/1/2021,MMR,Kelantan,0,0,0,Myanmar
36769,10/1/2021,MMR,Negeri Sembilan,0,0,0,Myanmar
36770,10/1/2021,MMR,Pahang,0,0,0,Myanmar
36771,10/1/2021,MMR,Perak,0,0,0,Myanmar
36772,10/1/2021,MMR,Perlis,0,0,0,Myanmar
36773,10/1/2021,MMR,Pulau Pinang,0,0,0,Myanmar
36774,10/1/2021,MMR,Sabah,1,1,0,Myanmar
36775,10/1/2021,MMR,Sarawak,2,1,1,Myanmar
36776,10/1/2021,MMR,Selangor,177,145,32,Myanmar
36777,10/1/2021,MMR,Terengganu,0,0,0,Myanmar
36778,10/1/2021,MMR,W.P. Labuan,0,0,0,Myanmar
36779,10/1/2021,MNE,Johor,0,0,0,Montenegro
36780,10/1/2021,MNE,Kedah,0,0,0,Montenegro
36781,10/1/2021,MNE,Pulau Pinang,0,0,0,Montenegro
36782,10/1/2021,MNE,Sabah,0,0,0,Montenegro
36783,10/1/2021,MNE,Sarawak,0,0,0,Montenegro
36784,10/1/2021,MNE,Selangor,1,1,0,Montenegro
36785,10/1/2021,MNG,Johor,0,0,0,Mongolia
36786,10/1/2021,MNG,Kedah,0,0,0,Mongolia
36787,10/1/2021,MNG,Kelantan,0,0,0,Mongolia
36788,10/1/2021,MNG,Perak,0,0,0,Mongolia
36789,10/1/2021,MNG,Perlis,0,0,0,Mongolia
36790,10/1/2021,MNG,Pulau Pinang,0,0,0,Mongolia
36791,10/1/2021,MNG,Sabah,0,0,0,Mongolia
36792,10/1/2021,MNG,Sarawak,0,0,0,Mongolia
36793,10/1/2021,MNG,Selangor,3,0,3,Mongolia
36794,10/1/2021,MNP,Selangor,0,0,0,Northern Mariana Islands
36795,10/1/2021,MOZ,Johor,0,0,0,Mozambique
36796,10/1/2021,MOZ,Kedah,0,0,0,Mozambique
36797,10/1/2021,MOZ,Perak,0,0,0,Mozambique
36798,10/1/2021,MOZ,Pulau Pinang,0,0,0,Mozambique
36799,10/1/2021,MOZ,Sabah,0,0,0,Mozambique
36800,10/1/2021,MOZ,Sarawak,0,0,0,Mozambique
36801,10/1/2021,MOZ,Selangor,7,4,3,Mozambique
36802,10/1/2021,MRT,Johor,0,0,0,Mauritania
36803,10/1/2021,MRT,Kedah,0,0,0,Mauritania
36804,10/1/2021,MRT,Pulau Pinang,0,0,0,Mauritania
36805,10/1/2021,MRT,Sabah,0,0,0,Mauritania
36806,10/1/2021,MRT,Sarawak,0,0,0,Mauritania
36807,10/1/2021,MRT,Selangor,3,2,1,Mauritania
36808,10/1/2021,MUS,Johor,0,0,0,Mauritius
36809,10/1/2021,MUS,Kedah,0,0,0,Mauritius
36810,10/1/2021,MUS,Kelantan,0,0,0,Mauritius
36811,10/1/2021,MUS,Pahang,0,0,0,Mauritius
36812,10/1/2021,MUS,Perak,0,0,0,Mauritius
36813,10/1/2021,MUS,Perlis,0,0,0,Mauritius
36814,10/1/2021,MUS,Pulau Pinang,0,0,0,Mauritius
36815,10/1/2021,MUS,Sabah,0,0,0,Mauritius
36816,10/1/2021,MUS,Sarawak,0,0,0,Mauritius
36817,10/1/2021,MUS,Selangor,11,6,5,Mauritius
36818,10/1/2021,MWI,Johor,0,0,0,Malawi
36819,10/1/2021,MWI,Pulau Pinang,0,0,0,Malawi
36820,10/1/2021,MWI,Sabah,0,0,0,Malawi
36821,10/1/2021,MWI,Sarawak,0,0,0,Malawi
36822,10/1/2021,MWI,Selangor,1,0,1,Malawi
36823,10/1/2021,MYT,Selangor,0,0,0,Mayotte
36824,10/1/2021,NAM,Johor,0,0,0,Namibia
36825,10/1/2021,NAM,Kedah,0,0,0,Namibia
36826,10/1/2021,NAM,Perak,0,0,0,Namibia
36827,10/1/2021,NAM,Perlis,0,0,0,Namibia
36828,10/1/2021,NAM,Pulau Pinang,0,0,0,Namibia
36829,10/1/2021,NAM,Sabah,0,0,0,Namibia
36830,10/1/2021,NAM,Sarawak,0,0,0,Namibia
36831,10/1/2021,NAM,Selangor,0,0,0,Namibia
36832,10/1/2021,NCL,Selangor,0,0,0,New Caledonia
36833,10/1/2021,NER,Johor,0,0,0,Niger
36834,10/1/2021,NER,Sabah,0,0,0,Niger
36835,10/1/2021,NER,Selangor,0,0,0,Niger
36836,10/1/2021,NGA,Johor,0,0,0,Nigeria
36837,10/1/2021,NGA,Kedah,0,0,0,Nigeria
36838,10/1/2021,NGA,Perlis,0,0,0,Nigeria
36839,10/1/2021,NGA,Pulau Pinang,0,0,0,Nigeria
36840,10/1/2021,NGA,Sabah,0,0,0,Nigeria
36841,10/1/2021,NGA,Sarawak,2,2,0,Nigeria
36842,10/1/2021,NGA,Selangor,118,94,24,Nigeria
36843,10/1/2021,NIC,Johor,0,0,0,Nicaragua
36844,10/1/2021,NIC,Kedah,0,0,0,Nicaragua
36845,10/1/2021,NIC,Pulau Pinang,0,0,0,Nicaragua
36846,10/1/2021,NIC,Sabah,0,0,0,Nicaragua
36847,10/1/2021,NIC,Selangor,0,0,0,Nicaragua
36848,10/1/2021,NLD,Johor,1,1,0,Netherlands
36849,10/1/2021,NLD,Kedah,0,0,0,Netherlands
36850,10/1/2021,NLD,Kelantan,0,0,0,Netherlands
36851,10/1/2021,NLD,Melaka,0,0,0,Netherlands
36852,10/1/2021,NLD,Negeri Sembilan,0,0,0,Netherlands
36853,10/1/2021,NLD,Pahang,0,0,0,Netherlands
36854,10/1/2021,NLD,Perak,0,0,0,Netherlands
36855,10/1/2021,NLD,Perlis,0,0,0,Netherlands
36856,10/1/2021,NLD,Pulau Pinang,12,7,5,Netherlands
36857,10/1/2021,NLD,Sabah,0,0,0,Netherlands
36858,10/1/2021,NLD,Sarawak,5,4,1,Netherlands
36859,10/1/2021,NLD,Selangor,76,61,15,Netherlands
36860,10/1/2021,NLD,Terengganu,0,0,0,Netherlands
36861,10/1/2021,NLD,W.P. Labuan,0,0,0,Netherlands
36862,10/1/2021,NOR,Johor,0,0,0,Norway
36863,10/1/2021,NOR,Kedah,0,0,0,Norway
36864,10/1/2021,NOR,Kelantan,0,0,0,Norway
36865,10/1/2021,NOR,Melaka,0,0,0,Norway
36866,10/1/2021,NOR,Pahang,0,0,0,Norway
36867,10/1/2021,NOR,Perak,0,0,0,Norway
36868,10/1/2021,NOR,Perlis,0,0,0,Norway
36869,10/1/2021,NOR,Pulau Pinang,0,0,0,Norway
36870,10/1/2021,NOR,Sabah,0,0,0,Norway
36871,10/1/2021,NOR,Sarawak,0,0,0,Norway
36872,10/1/2021,NOR,Selangor,14,10,4,Norway
36873,10/1/2021,NOR,W.P. Labuan,0,0,0,Norway
36874,10/1/2021,NPL,Johor,0,0,0,Nepal
36875,10/1/2021,NPL,Kedah,0,0,0,Nepal
36876,10/1/2021,NPL,Pahang,0,0,0,Nepal
36877,10/1/2021,NPL,Perak,0,0,0,Nepal
36878,10/1/2021,NPL,Perlis,0,0,0,Nepal
36879,10/1/2021,NPL,Pulau Pinang,0,0,0,Nepal
36880,10/1/2021,NPL,Sabah,0,0,0,Nepal
36881,10/1/2021,NPL,Sarawak,0,0,0,Nepal
36882,10/1/2021,NPL,Selangor,16,12,4,Nepal
36883,10/1/2021,NPL,W.P. Labuan,0,0,0,Nepal
36884,10/1/2021,NRU,Johor,0,0,0,Nauru
36885,10/1/2021,NRU,Pulau Pinang,0,0,0,Nauru
36886,10/1/2021,NRU,Selangor,0,0,0,Nauru
36887,10/1/2021,NZL,Johor,0,0,0,New Zealand
36888,10/1/2021,NZL,Kedah,0,0,0,New Zealand
36889,10/1/2021,NZL,Kelantan,0,0,0,New Zealand
36890,10/1/2021,NZL,Melaka,0,0,0,New Zealand
36891,10/1/2021,NZL,Negeri Sembilan,0,0,0,New Zealand
36892,10/1/2021,NZL,Pahang,0,0,0,New Zealand
36893,10/1/2021,NZL,Perak,0,0,0,New Zealand
36894,10/1/2021,NZL,Perlis,0,0,0,New Zealand
36895,10/1/2021,NZL,Pulau Pinang,0,0,0,New Zealand
36896,10/1/2021,NZL,Sabah,0,0,0,New Zealand
36897,10/1/2021,NZL,Sarawak,0,0,0,New Zealand
36898,10/1/2021,NZL,Selangor,19,15,4,New Zealand
36899,10/1/2021,NZL,Terengganu,0,0,0,New Zealand
36900,10/1/2021,NZL,W.P. Labuan,0,0,0,New Zealand
36901,10/1/2021,OMN,Johor,0,0,0,Oman
36902,10/1/2021,OMN,Kedah,0,0,0,Oman
36903,10/1/2021,OMN,Kelantan,0,0,0,Oman
36904,10/1/2021,OMN,Melaka,0,0,0,Oman
36905,10/1/2021,OMN,Perak,0,0,0,Oman
36906,10/1/2021,OMN,Perlis,0,0,0,Oman
36907,10/1/2021,OMN,Pulau Pinang,0,0,0,Oman
36908,10/1/2021,OMN,Sabah,0,0,0,Oman
36909,10/1/2021,OMN,Sarawak,0,0,0,Oman
36910,10/1/2021,OMN,Selangor,29,14,15,Oman
36911,10/1/2021,PAK,Johor,1,1,0,Pakistan
36912,10/1/2021,PAK,Kedah,0,0,0,Pakistan
36913,10/1/2021,PAK,Kelantan,0,0,0,Pakistan
36914,10/1/2021,PAK,Melaka,0,0,0,Pakistan
36915,10/1/2021,PAK,Negeri Sembilan,0,0,0,Pakistan
36916,10/1/2021,PAK,Pahang,0,0,0,Pakistan
36917,10/1/2021,PAK,Perak,0,0,0,Pakistan
36918,10/1/2021,PAK,Perlis,0,0,0,Pakistan
36919,10/1/2021,PAK,Pulau Pinang,0,0,0,Pakistan
36920,10/1/2021,PAK,Sabah,0,0,0,Pakistan
36921,10/1/2021,PAK,Sarawak,0,0,0,Pakistan
36922,10/1/2021,PAK,Selangor,204,157,47,Pakistan
36923,10/1/2021,PAK,W.P. Labuan,0,0,0,Pakistan
36924,10/1/2021,PAN,Johor,0,0,0,Panama
36925,10/1/2021,PAN,Kedah,0,0,0,Panama
36926,10/1/2021,PAN,Perak,0,0,0,Panama
36927,10/1/2021,PAN,Perlis,0,0,0,Panama
36928,10/1/2021,PAN,Pulau Pinang,0,0,0,Panama
36929,10/1/2021,PAN,Sabah,0,0,0,Panama
36930,10/1/2021,PAN,Sarawak,0,0,0,Panama
36931,10/1/2021,PAN,Selangor,1,0,1,Panama
36932,10/1/2021,PER,Johor,0,0,0,Peru
36933,10/1/2021,PER,Kedah,0,0,0,Peru
36934,10/1/2021,PER,Kelantan,0,0,0,Peru
36935,10/1/2021,PER,Pahang,0,0,0,Peru
36936,10/1/2021,PER,Perak,0,0,0,Peru
36937,10/1/2021,PER,Perlis,0,0,0,Peru
36938,10/1/2021,PER,Pulau Pinang,0,0,0,Peru
36939,10/1/2021,PER,Sabah,0,0,0,Peru
36940,10/1/2021,PER,Sarawak,0,0,0,Peru
36941,10/1/2021,PER,Selangor,3,3,0,Peru
36942,10/1/2021,PER,W.P. Labuan,0,0,0,Peru
36943,10/1/2021,PHL,Johor,9,6,3,Philippines
36944,10/1/2021,PHL,Kedah,0,0,0,Philippines
36945,10/1/2021,PHL,Kelantan,0,0,0,Philippines
36946,10/1/2021,PHL,Melaka,0,0,0,Philippines
36947,10/1/2021,PHL,Negeri Sembilan,0,0,0,Philippines
36948,10/1/2021,PHL,Pahang,0,0,0,Philippines
36949,10/1/2021,PHL,Perak,0,0,0,Philippines
36950,10/1/2021,PHL,Perlis,0,0,0,Philippines
36951,10/1/2021,PHL,Pulau Pinang,8,6,2,Philippines
36952,10/1/2021,PHL,Sabah,0,0,0,Philippines
36953,10/1/2021,PHL,Sarawak,42,42,0,Philippines
36954,10/1/2021,PHL,Selangor,394,286,108,Philippines
36955,10/1/2021,PHL,Terengganu,0,0,0,Philippines
36956,10/1/2021,PHL,W.P. Labuan,0,0,0,Philippines
36957,10/1/2021,PLW,Johor,0,0,0,Palau
36958,10/1/2021,PLW,Pulau Pinang,0,0,0,Palau
36959,10/1/2021,PLW,Selangor,0,0,0,Palau
36960,10/1/2021,PNG,Johor,0,0,0,Papua New Guinea
36961,10/1/2021,PNG,Kedah,0,0,0,Papua New Guinea
36962,10/1/2021,PNG,Kelantan,0,0,0,Papua New Guinea
36963,10/1/2021,PNG,Perak,0,0,0,Papua New Guinea
36964,10/1/2021,PNG,Pulau Pinang,0,0,0,Papua New Guinea
36965,10/1/2021,PNG,Sabah,0,0,0,Papua New Guinea
36966,10/1/2021,PNG,Sarawak,0,0,0,Papua New Guinea
36967,10/1/2021,PNG,Selangor,0,0,0,Papua New Guinea
36968,10/1/2021,POL,Johor,0,0,0,Poland
36969,10/1/2021,POL,Kedah,0,0,0,Poland
36970,10/1/2021,POL,Kelantan,0,0,0,Poland
36971,10/1/2021,POL,Melaka,0,0,0,Poland
36972,10/1/2021,POL,Negeri Sembilan,0,0,0,Poland
36973,10/1/2021,POL,Pahang,0,0,0,Poland
36974,10/1/2021,POL,Perak,0,0,0,Poland
36975,10/1/2021,POL,Perlis,0,0,0,Poland
36976,10/1/2021,POL,Pulau Pinang,0,0,0,Poland
36977,10/1/2021,POL,Sabah,0,0,0,Poland
36978,10/1/2021,POL,Sarawak,2,2,0,Poland
36979,10/1/2021,POL,Selangor,18,15,3,Poland
36980,10/1/2021,POL,Terengganu,0,0,0,Poland
36981,10/1/2021,POL,W.P. Labuan,0,0,0,Poland
36982,10/1/2021,PRK,Selangor,0,0,0,"Korea, Democratic People's Republic of"
36983,10/1/2021,PRT,Johor,0,0,0,Portugal
36984,10/1/2021,PRT,Kedah,0,0,0,Portugal
36985,10/1/2021,PRT,Kelantan,0,0,0,Portugal
36986,10/1/2021,PRT,Melaka,0,0,0,Portugal
36987,10/1/2021,PRT,Pahang,0,0,0,Portugal
36988,10/1/2021,PRT,Perak,0,0,0,Portugal
36989,10/1/2021,PRT,Perlis,0,0,0,Portugal
36990,10/1/2021,PRT,Pulau Pinang,1,0,1,Portugal
36991,10/1/2021,PRT,Sabah,0,0,0,Portugal
36992,10/1/2021,PRT,Sarawak,0,0,0,Portugal
36993,10/1/2021,PRT,Selangor,13,8,5,Portugal
36994,10/1/2021,PRT,W.P. Labuan,0,0,0,Portugal
36995,10/1/2021,PRY,Johor,0,0,0,Paraguay
36996,10/1/2021,PRY,Kedah,0,0,0,Paraguay
36997,10/1/2021,PRY,Perak,0,0,0,Paraguay
36998,10/1/2021,PRY,Perlis,0,0,0,Paraguay
36999,10/1/2021,PRY,Pulau Pinang,0,0,0,Paraguay
37000,10/1/2021,PRY,Sabah,0,0,0,Paraguay
37001,10/1/2021,PRY,Sarawak,0,0,0,Paraguay
37002,10/1/2021,PRY,Selangor,0,0,0,Paraguay
37003,10/1/2021,PSE,Johor,0,0,0,"Palestinian Territory, Occupied"
37004,10/1/2021,PSE,Kedah,0,0,0,"Palestinian Territory, Occupied"
37005,10/1/2021,PSE,Kelantan,0,0,0,"Palestinian Territory, Occupied"
37006,10/1/2021,PSE,Melaka,0,0,0,"Palestinian Territory, Occupied"
37007,10/1/2021,PSE,Perak,0,0,0,"Palestinian Territory, Occupied"
37008,10/1/2021,PSE,Perlis,0,0,0,"Palestinian Territory, Occupied"
37009,10/1/2021,PSE,Pulau Pinang,0,0,0,"Palestinian Territory, Occupied"
37010,10/1/2021,PSE,Sabah,0,0,0,"Palestinian Territory, Occupied"
37011,10/1/2021,PSE,Sarawak,0,0,0,"Palestinian Territory, Occupied"
37012,10/1/2021,PSE,Selangor,37,35,2,"Palestinian Territory, Occupied"
37013,10/1/2021,QAT,Johor,0,0,0,Qatar
37014,10/1/2021,QAT,Kedah,0,0,0,Qatar
37015,10/1/2021,QAT,Perlis,0,0,0,Qatar
37016,10/1/2021,QAT,Pulau Pinang,0,0,0,Qatar
37017,10/1/2021,QAT,Sabah,0,0,0,Qatar
37018,10/1/2021,QAT,Sarawak,0,0,0,Qatar
37019,10/1/2021,QAT,Selangor,2,2,0,Qatar
37020,10/1/2021,REU,Johor,0,0,0,Reunion
37021,10/1/2021,REU,Sarawak,0,0,0,Reunion
37022,10/1/2021,ROU,Johor,1,1,0,Romania
37023,10/1/2021,ROU,Kedah,0,0,0,Romania
37024,10/1/2021,ROU,Kelantan,0,0,0,Romania
37025,10/1/2021,ROU,Negeri Sembilan,0,0,0,Romania
37026,10/1/2021,ROU,Pahang,0,0,0,Romania
37027,10/1/2021,ROU,Perak,0,0,0,Romania
37028,10/1/2021,ROU,Perlis,0,0,0,Romania
37029,10/1/2021,ROU,Pulau Pinang,0,0,0,Romania
37030,10/1/2021,ROU,Sabah,0,0,0,Romania
37031,10/1/2021,ROU,Sarawak,0,0,0,Romania
37032,10/1/2021,ROU,Selangor,21,12,9,Romania
37033,10/1/2021,ROU,W.P. Labuan,0,0,0,Romania
37034,10/1/2021,RUS,Johor,2,1,1,Russia
37035,10/1/2021,RUS,Kedah,0,0,0,Russia
37036,10/1/2021,RUS,Kelantan,0,0,0,Russia
37037,10/1/2021,RUS,Melaka,0,0,0,Russia
37038,10/1/2021,RUS,Negeri Sembilan,0,0,0,Russia
37039,10/1/2021,RUS,Pahang,0,0,0,Russia
37040,10/1/2021,RUS,Perak,0,0,0,Russia
37041,10/1/2021,RUS,Perlis,0,0,0,Russia
37042,10/1/2021,RUS,Pulau Pinang,0,0,0,Russia
37043,10/1/2021,RUS,Sabah,0,0,0,Russia
37044,10/1/2021,RUS,Sarawak,0,0,0,Russia
37045,10/1/2021,RUS,Selangor,54,32,22,Russia
37046,10/1/2021,RUS,W.P. Labuan,0,0,0,Russia
37047,10/1/2021,RWA,Johor,0,0,0,Rwanda
37048,10/1/2021,RWA,Kedah,0,0,0,Rwanda
37049,10/1/2021,RWA,Pulau Pinang,0,0,0,Rwanda
37050,10/1/2021,RWA,Selangor,1,1,0,Rwanda
37051,10/1/2021,SAU,Johor,0,0,0,Saudi Arabia
37052,10/1/2021,SAU,Kedah,0,0,0,Saudi Arabia
37053,10/1/2021,SAU,Kelantan,0,0,0,Saudi Arabia
37054,10/1/2021,SAU,Melaka,0,0,0,Saudi Arabia
37055,10/1/2021,SAU,Perak,0,0,0,Saudi Arabia
37056,10/1/2021,SAU,Perlis,0,0,0,Saudi Arabia
37057,10/1/2021,SAU,Pulau Pinang,0,0,0,Saudi Arabia
37058,10/1/2021,SAU,Sabah,0,0,0,Saudi Arabia
37059,10/1/2021,SAU,Sarawak,0,0,0,Saudi Arabia
37060,10/1/2021,SAU,Selangor,139,91,48,Saudi Arabia
37061,10/1/2021,SAU,W.P. Labuan,0,0,0,Saudi Arabia
37062,10/1/2021,SDN,Johor,0,0,0,Sudan
37063,10/1/2021,SDN,Kedah,0,0,0,Sudan
37064,10/1/2021,SDN,Kelantan,0,0,0,Sudan
37065,10/1/2021,SDN,Perlis,0,0,0,Sudan
37066,10/1/2021,SDN,Pulau Pinang,0,0,0,Sudan
37067,10/1/2021,SDN,Sabah,0,0,0,Sudan
37068,10/1/2021,SDN,Sarawak,0,0,0,Sudan
37069,10/1/2021,SDN,Selangor,93,61,32,Sudan
37070,10/1/2021,SDN,W.P. Labuan,0,0,0,Sudan
37071,10/1/2021,SEN,Johor,0,0,0,Senegal
37072,10/1/2021,SEN,Kedah,0,0,0,Senegal
37073,10/1/2021,SEN,Kelantan,0,0,0,Senegal
37074,10/1/2021,SEN,Perak,0,0,0,Senegal
37075,10/1/2021,SEN,Perlis,0,0,0,Senegal
37076,10/1/2021,SEN,Pulau Pinang,0,0,0,Senegal
37077,10/1/2021,SEN,Sabah,0,0,0,Senegal
37078,10/1/2021,SEN,Sarawak,0,0,0,Senegal
37079,10/1/2021,SEN,Selangor,3,1,2,Senegal
37080,10/1/2021,SGP,Johor,158,131,27,Singapore
37081,10/1/2021,SGP,Kedah,1,1,0,Singapore
37082,10/1/2021,SGP,Kelantan,0,0,0,Singapore
37083,10/1/2021,SGP,Melaka,0,0,0,Singapore
37084,10/1/2021,SGP,Negeri Sembilan,0,0,0,Singapore
37085,10/1/2021,SGP,Pahang,0,0,0,Singapore
37086,10/1/2021,SGP,Perak,2,1,1,Singapore
37087,10/1/2021,SGP,Perlis,2,2,0,Singapore
37088,10/1/2021,SGP,Pulau Pinang,19,11,8,Singapore
37089,10/1/2021,SGP,Sabah,0,0,0,Singapore
37090,10/1/2021,SGP,Sarawak,12,9,3,Singapore
37091,10/1/2021,SGP,Selangor,194,128,66,Singapore
37092,10/1/2021,SGP,Terengganu,0,0,0,Singapore
37093,10/1/2021,SGP,W.P. Labuan,0,0,0,Singapore
37094,10/1/2021,SGS,Johor,0,0,0,South Georgia and the South Sandwich Islands
37095,10/1/2021,SGS,Sabah,0,0,0,South Georgia and the South Sandwich Islands
37096,10/1/2021,SGS,Selangor,0,0,0,South Georgia and the South Sandwich Islands
37097,10/1/2021,SHN,Sarawak,0,0,0,"Saint Helena, Ascension and Tristan da Cunha"
37098,10/1/2021,SLB,Johor,0,0,0,Solomon Islands
37099,10/1/2021,SLB,Perlis,0,0,0,Solomon Islands
37100,10/1/2021,SLB,Pulau Pinang,0,0,0,Solomon Islands
37101,10/1/2021,SLB,Sabah,0,0,0,Solomon Islands
37102,10/1/2021,SLB,Sarawak,0,0,0,Solomon Islands
37103,10/1/2021,SLB,Selangor,0,0,0,Solomon Islands
37104,10/1/2021,SLB,W.P. Labuan,0,0,0,Solomon Islands
37105,10/1/2021,SLE,Johor,0,0,0,Sierra Leone
37106,10/1/2021,SLE,Kedah,0,0,0,Sierra Leone
37107,10/1/2021,SLE,Perak,0,0,0,Sierra Leone
37108,10/1/2021,SLE,Pulau Pinang,0,0,0,Sierra Leone
37109,10/1/2021,SLE,Sabah,0,0,0,Sierra Leone
37110,10/1/2021,SLE,Selangor,3,1,2,Sierra Leone
37111,10/1/2021,SLV,Johor,0,0,0,El Salvador
37112,10/1/2021,SLV,Kedah,0,0,0,El Salvador
37113,10/1/2021,SLV,Perak,0,0,0,El Salvador
37114,10/1/2021,SLV,Perlis,0,0,0,El Salvador
37115,10/1/2021,SLV,Pulau Pinang,0,0,0,El Salvador
37116,10/1/2021,SLV,Sabah,0,0,0,El Salvador
37117,10/1/2021,SLV,Selangor,0,0,0,El Salvador
37118,10/1/2021,SLV,W.P. Labuan,0,0,0,El Salvador
37119,10/1/2021,SMR,Johor,0,0,0,San Marino
37120,10/1/2021,SMR,Selangor,0,0,0,San Marino
37121,10/1/2021,SOM,Johor,0,0,0,Somalia
37122,10/1/2021,SOM,Kedah,0,0,0,Somalia
37123,10/1/2021,SOM,Kelantan,0,0,0,Somalia
37124,10/1/2021,SOM,Perlis,0,0,0,Somalia
37125,10/1/2021,SOM,Sabah,0,0,0,Somalia
37126,10/1/2021,SOM,Sarawak,0,0,0,Somalia
37127,10/1/2021,SOM,Selangor,78,63,15,Somalia
37128,10/1/2021,SRB,Johor,0,0,0,Serbia
37129,10/1/2021,SRB,Kedah,0,0,0,Serbia
37130,10/1/2021,SRB,Kelantan,0,0,0,Serbia
37131,10/1/2021,SRB,Pahang,0,0,0,Serbia
37132,10/1/2021,SRB,Perak,0,0,0,Serbia
37133,10/1/2021,SRB,Perlis,0,0,0,Serbia
37134,10/1/2021,SRB,Pulau Pinang,0,0,0,Serbia
37135,10/1/2021,SRB,Sabah,0,0,0,Serbia
37136,10/1/2021,SRB,Sarawak,0,0,0,Serbia
37137,10/1/2021,SRB,Selangor,3,2,1,Serbia
37138,10/1/2021,STP,Selangor,0,0,0,Sao Tome and Principe
37139,10/1/2021,SUR,Johor,0,0,0,Suriname
37140,10/1/2021,SUR,Kedah,0,0,0,Suriname
37141,10/1/2021,SUR,Kelantan,0,0,0,Suriname
37142,10/1/2021,SUR,Perak,0,0,0,Suriname
37143,10/1/2021,SUR,Perlis,0,0,0,Suriname
37144,10/1/2021,SUR,Pulau Pinang,0,0,0,Suriname
37145,10/1/2021,SUR,Sabah,0,0,0,Suriname
37146,10/1/2021,SUR,Sarawak,0,0,0,Suriname
37147,10/1/2021,SUR,Selangor,0,0,0,Suriname
37148,10/1/2021,SVK,Johor,0,0,0,Slovakia
37149,10/1/2021,SVK,Kedah,0,0,0,Slovakia
37150,10/1/2021,SVK,Kelantan,0,0,0,Slovakia
37151,10/1/2021,SVK,Negeri Sembilan,0,0,0,Slovakia
37152,10/1/2021,SVK,Pahang,0,0,0,Slovakia
37153,10/1/2021,SVK,Perak,0,0,0,Slovakia
37154,10/1/2021,SVK,Perlis,0,0,0,Slovakia
37155,10/1/2021,SVK,Pulau Pinang,0,0,0,Slovakia
37156,10/1/2021,SVK,Sabah,0,0,0,Slovakia
37157,10/1/2021,SVK,Sarawak,0,0,0,Slovakia
37158,10/1/2021,SVK,Selangor,11,9,2,Slovakia
37159,10/1/2021,SVK,W.P. Labuan,0,0,0,Slovakia
37160,10/1/2021,SVN,Johor,0,0,0,Slovenia
37161,10/1/2021,SVN,Kedah,0,0,0,Slovenia
37162,10/1/2021,SVN,Kelantan,0,0,0,Slovenia
37163,10/1/2021,SVN,Perak,0,0,0,Slovenia
37164,10/1/2021,SVN,Perlis,0,0,0,Slovenia
37165,10/1/2021,SVN,Pulau Pinang,0,0,0,Slovenia
37166,10/1/2021,SVN,Sabah,0,0,0,Slovenia
37167,10/1/2021,SVN,Sarawak,0,0,0,Slovenia
37168,10/1/2021,SVN,Selangor,4,3,1,Slovenia
37169,10/1/2021,SVN,W.P. Labuan,0,0,0,Slovenia
37170,10/1/2021,SWE,Johor,0,0,0,Sweden
37171,10/1/2021,SWE,Kedah,0,0,0,Sweden
37172,10/1/2021,SWE,Kelantan,0,0,0,Sweden
37173,10/1/2021,SWE,Melaka,0,0,0,Sweden
37174,10/1/2021,SWE,Negeri Sembilan,0,0,0,Sweden
37175,10/1/2021,SWE,Pahang,0,0,0,Sweden
37176,10/1/2021,SWE,Perak,0,0,0,Sweden
37177,10/1/2021,SWE,Perlis,0,0,0,Sweden
37178,10/1/2021,SWE,Pulau Pinang,0,0,0,Sweden
37179,10/1/2021,SWE,Sabah,0,0,0,Sweden
37180,10/1/2021,SWE,Sarawak,0,0,0,Sweden
37181,10/1/2021,SWE,Selangor,39,33,6,Sweden
37182,10/1/2021,SWE,W.P. Labuan,0,0,0,Sweden
37183,10/1/2021,SWZ,Johor,0,0,0,Swaziland
37184,10/1/2021,SWZ,Kedah,0,0,0,Swaziland
37185,10/1/2021,SWZ,Pulau Pinang,0,0,0,Swaziland
37186,10/1/2021,SWZ,Sabah,0,0,0,Swaziland
37187,10/1/2021,SWZ,Selangor,0,0,0,Swaziland
37188,10/1/2021,SYC,Johor,0,0,0,Seychelles
37189,10/1/2021,SYC,Kedah,0,0,0,Seychelles
37190,10/1/2021,SYC,Pulau Pinang,0,0,0,Seychelles
37191,10/1/2021,SYC,Sabah,0,0,0,Seychelles
37192,10/1/2021,SYC,Sarawak,1,1,0,Seychelles
37193,10/1/2021,SYC,Selangor,10,5,5,Seychelles
37194,10/1/2021,SYR,Johor,0,0,0,Syrian Arab Republic
37195,10/1/2021,SYR,Kedah,0,0,0,Syrian Arab Republic
37196,10/1/2021,SYR,Kelantan,0,0,0,Syrian Arab Republic
37197,10/1/2021,SYR,Pahang,0,0,0,Syrian Arab Republic
37198,10/1/2021,SYR,Perlis,0,0,0,Syrian Arab Republic
37199,10/1/2021,SYR,Pulau Pinang,0,0,0,Syrian Arab Republic
37200,10/1/2021,SYR,Sabah,0,0,0,Syrian Arab Republic
37201,10/1/2021,SYR,Sarawak,0,0,0,Syrian Arab Republic
37202,10/1/2021,SYR,Selangor,53,45,8,Syrian Arab Republic
37203,10/1/2021,SYR,W.P. Labuan,0,0,0,Syrian Arab Republic
37204,10/1/2021,TCA,Perlis,0,0,0,Turks and Caicos
37205,10/1/2021,TCD,Johor,0,0,0,Chad
37206,10/1/2021,TCD,Kedah,0,0,0,Chad
37207,10/1/2021,TCD,Perlis,0,0,0,Chad
37208,10/1/2021,TCD,Selangor,1,1,0,Chad
37209,10/1/2021,TGO,Johor,0,0,0,Togo
37210,10/1/2021,TGO,Perak,0,0,0,Togo
37211,10/1/2021,TGO,Pulau Pinang,0,0,0,Togo
37212,10/1/2021,TGO,Selangor,0,0,0,Togo
37213,10/1/2021,THA,Johor,27,27,0,Thailand
37214,10/1/2021,THA,Kedah,19375,19336,39,Thailand
37215,10/1/2021,THA,Kelantan,0,0,0,Thailand
37216,10/1/2021,THA,Melaka,0,0,0,Thailand
37217,10/1/2021,THA,Negeri Sembilan,0,0,0,Thailand
37218,10/1/2021,THA,Pahang,0,0,0,Thailand
37219,10/1/2021,THA,Perak,0,0,0,Thailand
37220,10/1/2021,THA,Perlis,7946,7835,111,Thailand
37221,10/1/2021,THA,Pulau Pinang,40,36,4,Thailand
37222,10/1/2021,THA,Sabah,1,0,1,Thailand
37223,10/1/2021,THA,Sarawak,1,1,0,Thailand
37224,10/1/2021,THA,Selangor,154,68,86,Thailand
37225,10/1/2021,THA,Terengganu,0,0,0,Thailand
37226,10/1/2021,THA,W.P. Labuan,0,0,0,Thailand
37227,10/1/2021,TJK,Johor,0,0,0,Tajikistan
37228,10/1/2021,TJK,Kedah,0,0,0,Tajikistan
37229,10/1/2021,TJK,Perlis,0,0,0,Tajikistan
37230,10/1/2021,TJK,Pulau Pinang,0,0,0,Tajikistan
37231,10/1/2021,TJK,Sabah,0,0,0,Tajikistan
37232,10/1/2021,TJK,Selangor,2,2,0,Tajikistan
37233,10/1/2021,TKL,Selangor,0,0,0,Tokelau
37234,10/1/2021,TKM,Johor,0,0,0,Turkmenistan
37235,10/1/2021,TKM,Kedah,0,0,0,Turkmenistan
37236,10/1/2021,TKM,Kelantan,0,0,0,Turkmenistan
37237,10/1/2021,TKM,Perlis,0,0,0,Turkmenistan
37238,10/1/2021,TKM,Pulau Pinang,0,0,0,Turkmenistan
37239,10/1/2021,TKM,Sabah,0,0,0,Turkmenistan
37240,10/1/2021,TKM,Sarawak,0,0,0,Turkmenistan
37241,10/1/2021,TKM,Selangor,3,0,3,Turkmenistan
37242,10/1/2021,TLS,Johor,0,0,0,Timor-Leste
37243,10/1/2021,TLS,Kedah,0,0,0,Timor-Leste
37244,10/1/2021,TLS,Perlis,0,0,0,Timor-Leste
37245,10/1/2021,TLS,Pulau Pinang,0,0,0,Timor-Leste
37246,10/1/2021,TLS,Sabah,0,0,0,Timor-Leste
37247,10/1/2021,TLS,Sarawak,0,0,0,Timor-Leste
37248,10/1/2021,TLS,Selangor,3,3,0,Timor-Leste
37249,10/1/2021,TON,Johor,0,0,0,Tonga
37250,10/1/2021,TON,Pulau Pinang,0,0,0,Tonga
37251,10/1/2021,TON,Sarawak,0,0,0,Tonga
37252,10/1/2021,TON,Selangor,0,0,0,Tonga
37253,10/1/2021,TTO,Johor,0,0,0,Trinidad and Tobago
37254,10/1/2021,TTO,Kedah,0,0,0,Trinidad and Tobago
37255,10/1/2021,TTO,Pahang,0,0,0,Trinidad and Tobago
37256,10/1/2021,TTO,Pulau Pinang,0,0,0,Trinidad and Tobago
37257,10/1/2021,TTO,Sabah,0,0,0,Trinidad and Tobago
37258,10/1/2021,TTO,Sarawak,0,0,0,Trinidad and Tobago
37259,10/1/2021,TTO,Selangor,1,1,0,Trinidad and Tobago
37260,10/1/2021,TUN,Johor,0,0,0,Tunisia
37261,10/1/2021,TUN,Kedah,0,0,0,Tunisia
37262,10/1/2021,TUN,Kelantan,0,0,0,Tunisia
37263,10/1/2021,TUN,Melaka,0,0,0,Tunisia
37264,10/1/2021,TUN,Perak,0,0,0,Tunisia
37265,10/1/2021,TUN,Perlis,0,0,0,Tunisia
37266,10/1/2021,TUN,Pulau Pinang,0,0,0,Tunisia
37267,10/1/2021,TUN,Sabah,0,0,0,Tunisia
37268,10/1/2021,TUN,Sarawak,0,0,0,Tunisia
37269,10/1/2021,TUN,Selangor,10,6,4,Tunisia
37270,10/1/2021,TUN,W.P. Labuan,0,0,0,Tunisia
37271,10/1/2021,TUR,Johor,1,1,0,Turkey
37272,10/1/2021,TUR,Kedah,0,0,0,Turkey
37273,10/1/2021,TUR,Kelantan,0,0,0,Turkey
37274,10/1/2021,TUR,Melaka,0,0,0,Turkey
37275,10/1/2021,TUR,Negeri Sembilan,0,0,0,Turkey
37276,10/1/2021,TUR,Pahang,0,0,0,Turkey
37277,10/1/2021,TUR,Perak,0,0,0,Turkey
37278,10/1/2021,TUR,Perlis,0,0,0,Turkey
37279,10/1/2021,TUR,Pulau Pinang,0,0,0,Turkey
37280,10/1/2021,TUR,Sabah,0,0,0,Turkey
37281,10/1/2021,TUR,Sarawak,2,2,0,Turkey
37282,10/1/2021,TUR,Selangor,82,51,31,Turkey
37283,10/1/2021,TUR,W.P. Labuan,0,0,0,Turkey
37284,10/1/2021,TUV,Selangor,0,0,0,Tuvalu
37285,10/1/2021,TWN,Johor,0,0,0,Taiwan
37286,10/1/2021,TWN,Kedah,0,0,0,Taiwan
37287,10/1/2021,TWN,Kelantan,0,0,0,Taiwan
37288,10/1/2021,TWN,Melaka,0,0,0,Taiwan
37289,10/1/2021,TWN,Negeri Sembilan,0,0,0,Taiwan
37290,10/1/2021,TWN,Pahang,0,0,0,Taiwan
37291,10/1/2021,TWN,Perak,0,0,0,Taiwan
37292,10/1/2021,TWN,Perlis,0,0,0,Taiwan
37293,10/1/2021,TWN,Pulau Pinang,19,14,5,Taiwan
37294,10/1/2021,TWN,Sabah,0,0,0,Taiwan
37295,10/1/2021,TWN,Sarawak,2,1,1,Taiwan
37296,10/1/2021,TWN,Selangor,63,37,26,Taiwan
37297,10/1/2021,TWN,W.P. Labuan,0,0,0,Taiwan
37298,10/1/2021,TZA,Johor,0,0,0,"Tanzania, United Republic of"
37299,10/1/2021,TZA,Kedah,0,0,0,"Tanzania, United Republic of"
37300,10/1/2021,TZA,Perak,0,0,0,"Tanzania, United Republic of"
37301,10/1/2021,TZA,Perlis,0,0,0,"Tanzania, United Republic of"
37302,10/1/2021,TZA,Pulau Pinang,0,0,0,"Tanzania, United Republic of"
37303,10/1/2021,TZA,Sabah,0,0,0,"Tanzania, United Republic of"
37304,10/1/2021,TZA,Sarawak,0,0,0,"Tanzania, United Republic of"
37305,10/1/2021,TZA,Selangor,11,2,9,"Tanzania, United Republic of"
37306,10/1/2021,UGA,Johor,0,0,0,Uganda
37307,10/1/2021,UGA,Kedah,0,0,0,Uganda
37308,10/1/2021,UGA,Perak,0,0,0,Uganda
37309,10/1/2021,UGA,Perlis,0,0,0,Uganda
37310,10/1/2021,UGA,Pulau Pinang,0,0,0,Uganda
37311,10/1/2021,UGA,Sabah,0,0,0,Uganda
37312,10/1/2021,UGA,Sarawak,0,0,0,Uganda
37313,10/1/2021,UGA,Selangor,5,4,1,Uganda
37314,10/1/2021,UKR,Johor,1,1,0,Ukraine
37315,10/1/2021,UKR,Kedah,0,0,0,Ukraine
37316,10/1/2021,UKR,Kelantan,0,0,0,Ukraine
37317,10/1/2021,UKR,Melaka,0,0,0,Ukraine
37318,10/1/2021,UKR,Negeri Sembilan,0,0,0,Ukraine
37319,10/1/2021,UKR,Pahang,0,0,0,Ukraine
37320,10/1/2021,UKR,Perak,0,0,0,Ukraine
37321,10/1/2021,UKR,Perlis,0,0,0,Ukraine
37322,10/1/2021,UKR,Pulau Pinang,0,0,0,Ukraine
37323,10/1/2021,UKR,Sabah,0,0,0,Ukraine
37324,10/1/2021,UKR,Sarawak,1,1,0,Ukraine
37325,10/1/2021,UKR,Selangor,44,32,12,Ukraine
37326,10/1/2021,UKR,W.P. Labuan,0,0,0,Ukraine
37327,10/1/2021,URY,Johor,0,0,0,Uruguay
37328,10/1/2021,URY,Kedah,0,0,0,Uruguay
37329,10/1/2021,URY,Kelantan,0,0,0,Uruguay
37330,10/1/2021,URY,Perak,0,0,0,Uruguay
37331,10/1/2021,URY,Perlis,0,0,0,Uruguay
37332,10/1/2021,URY,Pulau Pinang,0,0,0,Uruguay
37333,10/1/2021,URY,Sabah,0,0,0,Uruguay
37334,10/1/2021,URY,Sarawak,0,0,0,Uruguay
37335,10/1/2021,URY,Selangor,2,0,2,Uruguay
37336,10/1/2021,URY,W.P. Labuan,0,0,0,Uruguay
37337,10/1/2021,USA,Johor,0,0,0,United States Of America
37338,10/1/2021,USA,Kedah,0,0,0,United States Of America
37339,10/1/2021,USA,Kelantan,0,0,0,United States Of America
37340,10/1/2021,USA,Melaka,0,0,0,United States Of America
37341,10/1/2021,USA,Negeri Sembilan,0,0,0,United States Of America
37342,10/1/2021,USA,Pahang,0,0,0,United States Of America
37343,10/1/2021,USA,Perak,0,0,0,United States Of America
37344,10/1/2021,USA,Perlis,0,0,0,United States Of America
37345,10/1/2021,USA,Pulau Pinang,11,6,5,United States Of America
37346,10/1/2021,USA,Sabah,0,0,0,United States Of America
37347,10/1/2021,USA,Sarawak,1,0,1,United States Of America
37348,10/1/2021,USA,Selangor,252,186,66,United States Of America
37349,10/1/2021,USA,Terengganu,0,0,0,United States Of America
37350,10/1/2021,USA,W.P. Labuan,0,0,0,United States Of America
37351,10/1/2021,UZB,Johor,0,0,0,Uzbekistan
37352,10/1/2021,UZB,Kedah,0,0,0,Uzbekistan
37353,10/1/2021,UZB,Kelantan,0,0,0,Uzbekistan
37354,10/1/2021,UZB,Perak,0,0,0,Uzbekistan
37355,10/1/2021,UZB,Perlis,0,0,0,Uzbekistan
37356,10/1/2021,UZB,Pulau Pinang,0,0,0,Uzbekistan
37357,10/1/2021,UZB,Sabah,0,0,0,Uzbekistan
37358,10/1/2021,UZB,Sarawak,0,0,0,Uzbekistan
37359,10/1/2021,UZB,Selangor,36,26,10,Uzbekistan
37360,10/1/2021,VAT,Johor,0,0,0,Holy See (Vatican City State)
37361,10/1/2021,VAT,Sarawak,0,0,0,Holy See (Vatican City State)
37362,10/1/2021,VAT,Selangor,0,0,0,Holy See (Vatican City State)
37363,10/1/2021,VCT,Johor,0,0,0,Saint Vincent and the Grenadines
37364,10/1/2021,VCT,Kedah,0,0,0,Saint Vincent and the Grenadines
37365,10/1/2021,VCT,Pulau Pinang,0,0,0,Saint Vincent and the Grenadines
37366,10/1/2021,VCT,Sarawak,0,0,0,Saint Vincent and the Grenadines
37367,10/1/2021,VCT,Selangor,0,0,0,Saint Vincent and the Grenadines
37368,10/1/2021,VEN,Johor,0,0,0,Venezuela
37369,10/1/2021,VEN,Kedah,0,0,0,Venezuela
37370,10/1/2021,VEN,Kelantan,0,0,0,Venezuela
37371,10/1/2021,VEN,Melaka,0,0,0,Venezuela
37372,10/1/2021,VEN,Perak,0,0,0,Venezuela
37373,10/1/2021,VEN,Perlis,0,0,0,Venezuela
37374,10/1/2021,VEN,Pulau Pinang,0,0,0,Venezuela
37375,10/1/2021,VEN,Sabah,0,0,0,Venezuela
37376,10/1/2021,VEN,Sarawak,0,0,0,Venezuela
37377,10/1/2021,VEN,Selangor,1,1,0,Venezuela
37378,10/1/2021,VEN,W.P. Labuan,0,0,0,Venezuela
37379,10/1/2021,VNM,Johor,1,0,1,Vietnam
37380,10/1/2021,VNM,Kedah,0,0,0,Vietnam
37381,10/1/2021,VNM,Kelantan,0,0,0,Vietnam
37382,10/1/2021,VNM,Melaka,0,0,0,Vietnam
37383,10/1/2021,VNM,Negeri Sembilan,0,0,0,Vietnam
37384,10/1/2021,VNM,Pahang,0,0,0,Vietnam
37385,10/1/2021,VNM,Perak,0,0,0,Vietnam
37386,10/1/2021,VNM,Perlis,0,0,0,Vietnam
37387,10/1/2021,VNM,Pulau Pinang,1,0,1,Vietnam
37388,10/1/2021,VNM,Sabah,0,0,0,Vietnam
37389,10/1/2021,VNM,Sarawak,1,0,1,Vietnam
37390,10/1/2021,VNM,Selangor,152,62,90,Vietnam
37391,10/1/2021,VNM,Terengganu,0,0,0,Vietnam
37392,10/1/2021,VNM,W.P. Labuan,0,0,0,Vietnam
37393,10/1/2021,VUT,Johor,0,0,0,Vanuatu
37394,10/1/2021,VUT,Kedah,0,0,0,Vanuatu
37395,10/1/2021,VUT,Pulau Pinang,0,0,0,Vanuatu
37396,10/1/2021,VUT,Sabah,0,0,0,Vanuatu
37397,10/1/2021,VUT,Sarawak,0,0,0,Vanuatu
37398,10/1/2021,VUT,Selangor,0,0,0,Vanuatu
37399,10/1/2021,WSM,Johor,0,0,0,Samoa
37400,10/1/2021,WSM,Sarawak,0,0,0,Samoa
37401,10/1/2021,WSM,Selangor,0,0,0,Samoa
37402,10/1/2021,YEM,Johor,0,0,0,Yemen
37403,10/1/2021,YEM,Kedah,0,0,0,Yemen
37404,10/1/2021,YEM,Kelantan,0,0,0,Yemen
37405,10/1/2021,YEM,Melaka,0,0,0,Yemen
37406,10/1/2021,YEM,Pahang,0,0,0,Yemen
37407,10/1/2021,YEM,Perak,0,0,0,Yemen
37408,10/1/2021,YEM,Perlis,0,0,0,Yemen
37409,10/1/2021,YEM,Pulau Pinang,0,0,0,Yemen
37410,10/1/2021,YEM,Sabah,0,0,0,Yemen
37411,10/1/2021,YEM,Sarawak,0,0,0,Yemen
37412,10/1/2021,YEM,Selangor,206,165,41,Yemen
37413,10/1/2021,YEM,W.P. Labuan,0,0,0,Yemen
37414,10/1/2021,ZAF,Johor,0,0,0,South Africa
37415,10/1/2021,ZAF,Kedah,0,0,0,South Africa
37416,10/1/2021,ZAF,Kelantan,0,0,0,South Africa
37417,10/1/2021,ZAF,Melaka,0,0,0,South Africa
37418,10/1/2021,ZAF,Pahang,0,0,0,South Africa
37419,10/1/2021,ZAF,Perak,0,0,0,South Africa
37420,10/1/2021,ZAF,Perlis,0,0,0,South Africa
37421,10/1/2021,ZAF,Pulau Pinang,0,0,0,South Africa
37422,10/1/2021,ZAF,Sabah,0,0,0,South Africa
37423,10/1/2021,ZAF,Sarawak,0,0,0,South Africa
37424,10/1/2021,ZAF,Selangor,38,25,13,South Africa
37425,10/1/2021,ZAF,Terengganu,0,0,0,South Africa
37426,10/1/2021,ZAF,W.P. Labuan,0,0,0,South Africa
37427,10/1/2021,ZMB,Johor,0,0,0,Zambia
37428,10/1/2021,ZMB,Kedah,0,0,0,Zambia
37429,10/1/2021,ZMB,Perak,0,0,0,Zambia
37430,10/1/2021,ZMB,Perlis,0,0,0,Zambia
37431,10/1/2021,ZMB,Pulau Pinang,0,0,0,Zambia
37432,10/1/2021,ZMB,Sabah,0,0,0,Zambia
37433,10/1/2021,ZMB,Sarawak,0,0,0,Zambia
37434,10/1/2021,ZMB,Selangor,10,3,7,Zambia
37435,10/1/2021,ZWE,Johor,0,0,0,Zimbabwe
37436,10/1/2021,ZWE,Kedah,0,0,0,Zimbabwe
37437,10/1/2021,ZWE,Kelantan,0,0,0,Zimbabwe
37438,10/1/2021,ZWE,Perak,0,0,0,Zimbabwe
37439,10/1/2021,ZWE,Perlis,0,0,0,Zimbabwe
37440,10/1/2021,ZWE,Pulau Pinang,0,0,0,Zimbabwe
37441,10/1/2021,ZWE,Sabah,0,0,0,Zimbabwe
37442,10/1/2021,ZWE,Sarawak,0,0,0,Zimbabwe
37443,10/1/2021,ZWE,Selangor,19,7,12,Zimbabwe
37444,11/1/2021,ABW,Kedah,0,0,0,Aruba
37445,11/1/2021,ABW,Pulau Pinang,0,0,0,Aruba
37446,11/1/2021,AFG,Johor,0,0,0,Afghanistan
37447,11/1/2021,AFG,Kedah,0,0,0,Afghanistan
37448,11/1/2021,AFG,Perlis,0,0,0,Afghanistan
37449,11/1/2021,AFG,Pulau Pinang,0,0,0,Afghanistan
37450,11/1/2021,AFG,Sarawak,0,0,0,Afghanistan
37451,11/1/2021,AFG,Selangor,57,36,21,Afghanistan
37452,11/1/2021,AGO,Johor,0,0,0,Angola
37453,11/1/2021,AGO,Kedah,0,0,0,Angola
37454,11/1/2021,AGO,Sabah,0,0,0,Angola
37455,11/1/2021,AGO,Selangor,0,0,0,Angola
37456,11/1/2021,AIA,Selangor,0,0,0,Anguilla
37457,11/1/2021,ALB,Johor,0,0,0,Albania
37458,11/1/2021,ALB,Kedah,0,0,0,Albania
37459,11/1/2021,ALB,Perak,0,0,0,Albania
37460,11/1/2021,ALB,Perlis,0,0,0,Albania
37461,11/1/2021,ALB,Pulau Pinang,0,0,0,Albania
37462,11/1/2021,ALB,Sabah,0,0,0,Albania
37463,11/1/2021,ALB,Sarawak,0,0,0,Albania
37464,11/1/2021,ALB,Selangor,0,0,0,Albania
37465,11/1/2021,AND,Johor,0,0,0,Andorra
37466,11/1/2021,AND,Kedah,0,0,0,Andorra
37467,11/1/2021,AND,Perlis,0,0,0,Andorra
37468,11/1/2021,AND,Pulau Pinang,0,0,0,Andorra
37469,11/1/2021,AND,Selangor,0,0,0,Andorra
37470,11/1/2021,ANT,Selangor,0,0,0,Netherlands Antilles
37471,11/1/2021,ARE,Johor,0,0,0,United Arab Emirates
37472,11/1/2021,ARE,Kedah,0,0,0,United Arab Emirates
37473,11/1/2021,ARE,Kelantan,0,0,0,United Arab Emirates
37474,11/1/2021,ARE,Perak,0,0,0,United Arab Emirates
37475,11/1/2021,ARE,Perlis,0,0,0,United Arab Emirates
37476,11/1/2021,ARE,Pulau Pinang,0,0,0,United Arab Emirates
37477,11/1/2021,ARE,Sabah,0,0,0,United Arab Emirates
37478,11/1/2021,ARE,Sarawak,0,0,0,United Arab Emirates
37479,11/1/2021,ARE,Selangor,2,1,1,United Arab Emirates
37480,11/1/2021,ARG,Johor,0,0,0,Argentina
37481,11/1/2021,ARG,Kedah,0,0,0,Argentina
37482,11/1/2021,ARG,Kelantan,0,0,0,Argentina
37483,11/1/2021,ARG,Melaka,0,0,0,Argentina
37484,11/1/2021,ARG,Perak,0,0,0,Argentina
37485,11/1/2021,ARG,Perlis,0,0,0,Argentina
37486,11/1/2021,ARG,Pulau Pinang,0,0,0,Argentina
37487,11/1/2021,ARG,Sabah,0,0,0,Argentina
37488,11/1/2021,ARG,Sarawak,0,0,0,Argentina
37489,11/1/2021,ARG,Selangor,1,0,1,Argentina
37490,11/1/2021,ARG,W.P. Labuan,0,0,0,Argentina
37491,11/1/2021,ARM,Johor,0,0,0,Armenia
37492,11/1/2021,ARM,Kedah,0,0,0,Armenia
37493,11/1/2021,ARM,Kelantan,0,0,0,Armenia
37494,11/1/2021,ARM,Perak,0,0,0,Armenia
37495,11/1/2021,ARM,Perlis,0,0,0,Armenia
37496,11/1/2021,ARM,Pulau Pinang,0,0,0,Armenia
37497,11/1/2021,ARM,Sabah,0,0,0,Armenia
37498,11/1/2021,ARM,Sarawak,0,0,0,Armenia
37499,11/1/2021,ARM,Selangor,0,0,0,Armenia
37500,11/1/2021,ATA,Selangor,0,0,0,Antarctica
37501,11/1/2021,ATG,Johor,0,0,0,Antigua and Barbuda
37502,11/1/2021,ATG,Kedah,0,0,0,Antigua and Barbuda
37503,11/1/2021,ATG,Pulau Pinang,0,0,0,Antigua and Barbuda
37504,11/1/2021,ATG,Sarawak,0,0,0,Antigua and Barbuda
37505,11/1/2021,ATG,Selangor,1,0,1,Antigua and Barbuda
37506,11/1/2021,AUS,Johor,0,0,0,Australia
37507,11/1/2021,AUS,Kedah,0,0,0,Australia
37508,11/1/2021,AUS,Kelantan,0,0,0,Australia
37509,11/1/2021,AUS,Melaka,0,0,0,Australia
37510,11/1/2021,AUS,Negeri Sembilan,0,0,0,Australia
37511,11/1/2021,AUS,Pahang,0,0,0,Australia
37512,11/1/2021,AUS,Perak,0,0,0,Australia
37513,11/1/2021,AUS,Perlis,0,0,0,Australia
37514,11/1/2021,AUS,Pulau Pinang,12,6,6,Australia
37515,11/1/2021,AUS,Sabah,5,3,2,Australia
37516,11/1/2021,AUS,Sarawak,4,3,1,Australia
37517,11/1/2021,AUS,Selangor,200,129,71,Australia
37518,11/1/2021,AUS,Terengganu,0,0,0,Australia
37519,11/1/2021,AUS,W.P. Labuan,0,0,0,Australia
37520,11/1/2021,AUT,Johor,0,0,0,Austria
37521,11/1/2021,AUT,Kedah,0,0,0,Austria
37522,11/1/2021,AUT,Kelantan,0,0,0,Austria
37523,11/1/2021,AUT,Melaka,0,0,0,Austria
37524,11/1/2021,AUT,Negeri Sembilan,0,0,0,Austria
37525,11/1/2021,AUT,Pahang,0,0,0,Austria
37526,11/1/2021,AUT,Perak,0,0,0,Austria
37527,11/1/2021,AUT,Perlis,0,0,0,Austria
37528,11/1/2021,AUT,Pulau Pinang,2,1,1,Austria
37529,11/1/2021,AUT,Sabah,0,0,0,Austria
37530,11/1/2021,AUT,Sarawak,1,1,0,Austria
37531,11/1/2021,AUT,Selangor,28,21,7,Austria
37532,11/1/2021,AUT,Terengganu,0,0,0,Austria
37533,11/1/2021,AUT,W.P. Labuan,0,0,0,Austria
37534,11/1/2021,AZE,Johor,0,0,0,Azerbaijan
37535,11/1/2021,AZE,Kedah,0,0,0,Azerbaijan
37536,11/1/2021,AZE,Kelantan,0,0,0,Azerbaijan
37537,11/1/2021,AZE,Melaka,0,0,0,Azerbaijan
37538,11/1/2021,AZE,Perlis,0,0,0,Azerbaijan
37539,11/1/2021,AZE,Pulau Pinang,0,0,0,Azerbaijan
37540,11/1/2021,AZE,Sabah,0,0,0,Azerbaijan
37541,11/1/2021,AZE,Sarawak,0,0,0,Azerbaijan
37542,11/1/2021,AZE,Selangor,7,6,1,Azerbaijan
37543,11/1/2021,AZE,W.P. Labuan,0,0,0,Azerbaijan
37544,11/1/2021,BDI,Pulau Pinang,0,0,0,Burundi
37545,11/1/2021,BDI,Sarawak,0,0,0,Burundi
37546,11/1/2021,BDI,Selangor,0,0,0,Burundi
37547,11/1/2021,BEL,Johor,0,0,0,Belgium
37548,11/1/2021,BEL,Kedah,0,0,0,Belgium
37549,11/1/2021,BEL,Kelantan,0,0,0,Belgium
37550,11/1/2021,BEL,Melaka,0,0,0,Belgium
37551,11/1/2021,BEL,Negeri Sembilan,0,0,0,Belgium
37552,11/1/2021,BEL,Pahang,0,0,0,Belgium
37553,11/1/2021,BEL,Perak,0,0,0,Belgium
37554,11/1/2021,BEL,Perlis,0,0,0,Belgium
37555,11/1/2021,BEL,Pulau Pinang,3,2,1,Belgium
37556,11/1/2021,BEL,Sabah,0,0,0,Belgium
37557,11/1/2021,BEL,Sarawak,1,1,0,Belgium
37558,11/1/2021,BEL,Selangor,21,18,3,Belgium
37559,11/1/2021,BEL,W.P. Labuan,0,0,0,Belgium
37560,11/1/2021,BEN,Johor,0,0,0,Benin
37561,11/1/2021,BEN,Kedah,0,0,0,Benin
37562,11/1/2021,BEN,Perak,0,0,0,Benin
37563,11/1/2021,BEN,Pulau Pinang,0,0,0,Benin
37564,11/1/2021,BEN,Sabah,0,0,0,Benin
37565,11/1/2021,BEN,Sarawak,0,0,0,Benin
37566,11/1/2021,BEN,Selangor,0,0,0,Benin
37567,11/1/2021,BFA,Perak,0,0,0,Burkina Faso
37568,11/1/2021,BFA,Pulau Pinang,0,0,0,Burkina Faso
37569,11/1/2021,BFA,Selangor,1,1,0,Burkina Faso
37570,11/1/2021,BGD,Johor,4,1,3,Bangladesh
37571,11/1/2021,BGD,Kedah,0,0,0,Bangladesh
37572,11/1/2021,BGD,Kelantan,0,0,0,Bangladesh
37573,11/1/2021,BGD,Melaka,0,0,0,Bangladesh
37574,11/1/2021,BGD,Negeri Sembilan,0,0,0,Bangladesh
37575,11/1/2021,BGD,Pahang,0,0,0,Bangladesh
37576,11/1/2021,BGD,Perak,0,0,0,Bangladesh
37577,11/1/2021,BGD,Perlis,0,0,0,Bangladesh
37578,11/1/2021,BGD,Pulau Pinang,1,1,0,Bangladesh
37579,11/1/2021,BGD,Sabah,0,0,0,Bangladesh
37580,11/1/2021,BGD,Sarawak,1,1,0,Bangladesh
37581,11/1/2021,BGD,Selangor,1092,947,145,Bangladesh
37582,11/1/2021,BGD,W.P. Labuan,0,0,0,Bangladesh
37583,11/1/2021,BGR,Johor,0,0,0,Bulgaria
37584,11/1/2021,BGR,Kedah,0,0,0,Bulgaria
37585,11/1/2021,BGR,Kelantan,0,0,0,Bulgaria
37586,11/1/2021,BGR,Pahang,0,0,0,Bulgaria
37587,11/1/2021,BGR,Perak,0,0,0,Bulgaria
37588,11/1/2021,BGR,Perlis,0,0,0,Bulgaria
37589,11/1/2021,BGR,Pulau Pinang,0,0,0,Bulgaria
37590,11/1/2021,BGR,Sabah,0,0,0,Bulgaria
37591,11/1/2021,BGR,Sarawak,0,0,0,Bulgaria
37592,11/1/2021,BGR,Selangor,15,14,1,Bulgaria
37593,11/1/2021,BGR,W.P. Labuan,0,0,0,Bulgaria
37594,11/1/2021,BHR,Johor,0,0,0,Bahrain
37595,11/1/2021,BHR,Kedah,0,0,0,Bahrain
37596,11/1/2021,BHR,Kelantan,0,0,0,Bahrain
37597,11/1/2021,BHR,Perlis,0,0,0,Bahrain
37598,11/1/2021,BHR,Pulau Pinang,0,0,0,Bahrain
37599,11/1/2021,BHR,Sabah,0,0,0,Bahrain
37600,11/1/2021,BHR,Sarawak,0,0,0,Bahrain
37601,11/1/2021,BHR,Selangor,4,2,2,Bahrain
37602,11/1/2021,BHS,Johor,0,0,0,Bahamas
37603,11/1/2021,BHS,Kedah,0,0,0,Bahamas
37604,11/1/2021,BHS,Perak,0,0,0,Bahamas
37605,11/1/2021,BHS,Sabah,0,0,0,Bahamas
37606,11/1/2021,BHS,Sarawak,0,0,0,Bahamas
37607,11/1/2021,BHS,Selangor,0,0,0,Bahamas
37608,11/1/2021,BIH,Johor,0,0,0,Bosnia and Herzegovina
37609,11/1/2021,BIH,Kedah,0,0,0,Bosnia and Herzegovina
37610,11/1/2021,BIH,Perlis,0,0,0,Bosnia and Herzegovina
37611,11/1/2021,BIH,Pulau Pinang,0,0,0,Bosnia and Herzegovina
37612,11/1/2021,BIH,Sabah,0,0,0,Bosnia and Herzegovina
37613,11/1/2021,BIH,Sarawak,0,0,0,Bosnia and Herzegovina
37614,11/1/2021,BIH,Selangor,2,1,1,Bosnia and Herzegovina
37615,11/1/2021,BLR,Johor,0,0,0,Belarus
37616,11/1/2021,BLR,Kedah,0,0,0,Belarus
37617,11/1/2021,BLR,Kelantan,0,0,0,Belarus
37618,11/1/2021,BLR,Pahang,0,0,0,Belarus
37619,11/1/2021,BLR,Perak,0,0,0,Belarus
37620,11/1/2021,BLR,Perlis,0,0,0,Belarus
37621,11/1/2021,BLR,Pulau Pinang,0,0,0,Belarus
37622,11/1/2021,BLR,Sabah,0,0,0,Belarus
37623,11/1/2021,BLR,Sarawak,0,0,0,Belarus
37624,11/1/2021,BLR,Selangor,0,0,0,Belarus
37625,11/1/2021,BLR,W.P. Labuan,0,0,0,Belarus
37626,11/1/2021,BLZ,Johor,0,0,0,Belize
37627,11/1/2021,BLZ,Pulau Pinang,0,0,0,Belize
37628,11/1/2021,BLZ,Sarawak,0,0,0,Belize
37629,11/1/2021,BLZ,Selangor,1,0,1,Belize
37630,11/1/2021,BMU,Selangor,0,0,0,Bermuda
37631,11/1/2021,BOL,Johor,0,0,0,Bolivia
37632,11/1/2021,BOL,Kedah,0,0,0,Bolivia
37633,11/1/2021,BOL,Melaka,0,0,0,Bolivia
37634,11/1/2021,BOL,Perak,0,0,0,Bolivia
37635,11/1/2021,BOL,Perlis,0,0,0,Bolivia
37636,11/1/2021,BOL,Pulau Pinang,0,0,0,Bolivia
37637,11/1/2021,BOL,Sabah,0,0,0,Bolivia
37638,11/1/2021,BOL,Sarawak,0,0,0,Bolivia
37639,11/1/2021,BOL,Selangor,0,0,0,Bolivia
37640,11/1/2021,BRA,Johor,0,0,0,Brazil
37641,11/1/2021,BRA,Kedah,0,0,0,Brazil
37642,11/1/2021,BRA,Kelantan,0,0,0,Brazil
37643,11/1/2021,BRA,Melaka,0,0,0,Brazil
37644,11/1/2021,BRA,Pahang,0,0,0,Brazil
37645,11/1/2021,BRA,Perak,0,0,0,Brazil
37646,11/1/2021,BRA,Perlis,0,0,0,Brazil
37647,11/1/2021,BRA,Pulau Pinang,0,0,0,Brazil
37648,11/1/2021,BRA,Sabah,0,0,0,Brazil
37649,11/1/2021,BRA,Sarawak,0,0,0,Brazil
37650,11/1/2021,BRA,Selangor,32,22,10,Brazil
37651,11/1/2021,BRA,W.P. Labuan,0,0,0,Brazil
37652,11/1/2021,BRB,Johor,0,0,0,Barbados
37653,11/1/2021,BRB,Kedah,0,0,0,Barbados
37654,11/1/2021,BRB,Perlis,0,0,0,Barbados
37655,11/1/2021,BRB,Pulau Pinang,0,0,0,Barbados
37656,11/1/2021,BRB,Selangor,1,1,0,Barbados
37657,11/1/2021,BRN,Johor,0,0,0,Brunei Darussalam
37658,11/1/2021,BRN,Kedah,0,0,0,Brunei Darussalam
37659,11/1/2021,BRN,Kelantan,0,0,0,Brunei Darussalam
37660,11/1/2021,BRN,Melaka,0,0,0,Brunei Darussalam
37661,11/1/2021,BRN,Pahang,0,0,0,Brunei Darussalam
37662,11/1/2021,BRN,Perak,0,0,0,Brunei Darussalam
37663,11/1/2021,BRN,Perlis,0,0,0,Brunei Darussalam
37664,11/1/2021,BRN,Pulau Pinang,0,0,0,Brunei Darussalam
37665,11/1/2021,BRN,Sabah,0,0,0,Brunei Darussalam
37666,11/1/2021,BRN,Sarawak,312,310,2,Brunei Darussalam
37667,11/1/2021,BRN,Selangor,40,20,20,Brunei Darussalam
37668,11/1/2021,BRN,W.P. Labuan,1,1,0,Brunei Darussalam
37669,11/1/2021,BTN,Johor,0,0,0,Bhutan
37670,11/1/2021,BTN,Kedah,0,0,0,Bhutan
37671,11/1/2021,BTN,Perak,0,0,0,Bhutan
37672,11/1/2021,BTN,Perlis,0,0,0,Bhutan
37673,11/1/2021,BTN,Pulau Pinang,0,0,0,Bhutan
37674,11/1/2021,BTN,Sabah,0,0,0,Bhutan
37675,11/1/2021,BTN,Sarawak,0,0,0,Bhutan
37676,11/1/2021,BTN,Selangor,3,2,1,Bhutan
37677,11/1/2021,BWA,Johor,0,0,0,Botswana
37678,11/1/2021,BWA,Kedah,0,0,0,Botswana
37679,11/1/2021,BWA,Perlis,0,0,0,Botswana
37680,11/1/2021,BWA,Pulau Pinang,0,0,0,Botswana
37681,11/1/2021,BWA,Sabah,0,0,0,Botswana
37682,11/1/2021,BWA,Sarawak,0,0,0,Botswana
37683,11/1/2021,BWA,Selangor,0,0,0,Botswana
37684,11/1/2021,CAF,Kedah,0,0,0,Central African Republic
37685,11/1/2021,CAF,Selangor,1,1,0,Central African Republic
37686,11/1/2021,CAN,Johor,1,1,0,Canada
37687,11/1/2021,CAN,Kedah,0,0,0,Canada
37688,11/1/2021,CAN,Kelantan,0,0,0,Canada
37689,11/1/2021,CAN,Melaka,0,0,0,Canada
37690,11/1/2021,CAN,Negeri Sembilan,0,0,0,Canada
37691,11/1/2021,CAN,Pahang,0,0,0,Canada
37692,11/1/2021,CAN,Perak,0,0,0,Canada
37693,11/1/2021,CAN,Perlis,0,0,0,Canada
37694,11/1/2021,CAN,Pulau Pinang,4,2,2,Canada
37695,11/1/2021,CAN,Sabah,0,0,0,Canada
37696,11/1/2021,CAN,Sarawak,1,1,0,Canada
37697,11/1/2021,CAN,Selangor,79,44,35,Canada
37698,11/1/2021,CAN,Terengganu,0,0,0,Canada
37699,11/1/2021,CAN,W.P. Labuan,0,0,0,Canada
37700,11/1/2021,CCK,Selangor,0,0,0,Cocos (Keeling) Islands
37701,11/1/2021,CHE,Johor,0,0,0,Switzerland
37702,11/1/2021,CHE,Kedah,0,0,0,Switzerland
37703,11/1/2021,CHE,Kelantan,0,0,0,Switzerland
37704,11/1/2021,CHE,Melaka,0,0,0,Switzerland
37705,11/1/2021,CHE,Negeri Sembilan,0,0,0,Switzerland
37706,11/1/2021,CHE,Pahang,0,0,0,Switzerland
37707,11/1/2021,CHE,Perak,0,0,0,Switzerland
37708,11/1/2021,CHE,Perlis,0,0,0,Switzerland
37709,11/1/2021,CHE,Pulau Pinang,3,0,3,Switzerland
37710,11/1/2021,CHE,Sabah,0,0,0,Switzerland
37711,11/1/2021,CHE,Sarawak,0,0,0,Switzerland
37712,11/1/2021,CHE,Selangor,28,17,11,Switzerland
37713,11/1/2021,CHE,W.P. Labuan,0,0,0,Switzerland
37714,11/1/2021,CHL,Johor,0,0,0,Chile
37715,11/1/2021,CHL,Kedah,0,0,0,Chile
37716,11/1/2021,CHL,Kelantan,0,0,0,Chile
37717,11/1/2021,CHL,Melaka,0,0,0,Chile
37718,11/1/2021,CHL,Pahang,0,0,0,Chile
37719,11/1/2021,CHL,Perak,0,0,0,Chile
37720,11/1/2021,CHL,Perlis,0,0,0,Chile
37721,11/1/2021,CHL,Pulau Pinang,0,0,0,Chile
37722,11/1/2021,CHL,Sabah,0,0,0,Chile
37723,11/1/2021,CHL,Sarawak,0,0,0,Chile
37724,11/1/2021,CHL,Selangor,2,0,2,Chile
37725,11/1/2021,CHN,Johor,61,59,2,China
37726,11/1/2021,CHN,Kedah,0,0,0,China
37727,11/1/2021,CHN,Kelantan,0,0,0,China
37728,11/1/2021,CHN,Melaka,0,0,0,China
37729,11/1/2021,CHN,Pahang,0,0,0,China
37730,11/1/2021,CHN,Perak,0,0,0,China
37731,11/1/2021,CHN,Perlis,0,0,0,China
37732,11/1/2021,CHN,Pulau Pinang,1,0,1,China
37733,11/1/2021,CHN,Sabah,2,1,1,China
37734,11/1/2021,CHN,Sarawak,64,60,4,China
37735,11/1/2021,CHN,Selangor,1249,961,288,China
37736,11/1/2021,CHN,Terengganu,0,0,0,China
37737,11/1/2021,CHN,W.P. Labuan,0,0,0,China
37738,11/1/2021,CIV,Johor,0,0,0,C��te d'Iv
37739,11/1/2021,CIV,Kedah,0,0,0,C��te d'Iv
37740,11/1/2021,CIV,Pulau Pinang,0,0,0,C��te d'Iv
37741,11/1/2021,CIV,Sabah,0,0,0,C��te d'Iv
37742,11/1/2021,CIV,Sarawak,0,0,0,C��te d'Iv
37743,11/1/2021,CIV,Selangor,0,0,0,C��te d'Iv
37744,11/1/2021,CMR,Johor,0,0,0,Cameroon
37745,11/1/2021,CMR,Kedah,0,0,0,Cameroon
37746,11/1/2021,CMR,Pulau Pinang,0,0,0,Cameroon
37747,11/1/2021,CMR,Sabah,0,0,0,Cameroon
37748,11/1/2021,CMR,Sarawak,0,0,0,Cameroon
37749,11/1/2021,CMR,Selangor,1,1,0,Cameroon
37750,11/1/2021,COD,Johor,0,0,0,"Congo, the Democratic Republic of the"
37751,11/1/2021,COD,Pulau Pinang,0,0,0,"Congo, the Democratic Republic of the"
37752,11/1/2021,COD,Sarawak,0,0,0,"Congo, the Democratic Republic of the"
37753,11/1/2021,COD,Selangor,0,0,0,"Congo, the Democratic Republic of the"
37754,11/1/2021,COG,Johor,0,0,0,Congo
37755,11/1/2021,COG,Kedah,0,0,0,Congo
37756,11/1/2021,COG,Selangor,0,0,0,Congo
37757,11/1/2021,COK,Selangor,0,0,0,Cook Islands
37758,11/1/2021,COL,Johor,0,0,0,Colombia
37759,11/1/2021,COL,Kedah,0,0,0,Colombia
37760,11/1/2021,COL,Perak,0,0,0,Colombia
37761,11/1/2021,COL,Pulau Pinang,0,0,0,Colombia
37762,11/1/2021,COL,Sabah,0,0,0,Colombia
37763,11/1/2021,COL,Sarawak,0,0,0,Colombia
37764,11/1/2021,COL,Selangor,5,3,2,Colombia
37765,11/1/2021,COL,W.P. Labuan,0,0,0,Colombia
37766,11/1/2021,COM,Johor,0,0,0,Comoros
37767,11/1/2021,COM,Kedah,0,0,0,Comoros
37768,11/1/2021,COM,Selangor,1,0,1,Comoros
37769,11/1/2021,CPV,Johor,0,0,0,Cape Verde
37770,11/1/2021,CPV,Kedah,0,0,0,Cape Verde
37771,11/1/2021,CPV,Pulau Pinang,0,0,0,Cape Verde
37772,11/1/2021,CPV,Sabah,0,0,0,Cape Verde
37773,11/1/2021,CPV,Selangor,0,0,0,Cape Verde
37774,11/1/2021,CRI,Johor,0,0,0,Costa Rica
37775,11/1/2021,CRI,Kedah,0,0,0,Costa Rica
37776,11/1/2021,CRI,Perak,0,0,0,Costa Rica
37777,11/1/2021,CRI,Perlis,0,0,0,Costa Rica
37778,11/1/2021,CRI,Pulau Pinang,0,0,0,Costa Rica
37779,11/1/2021,CRI,Sabah,0,0,0,Costa Rica
37780,11/1/2021,CRI,Sarawak,0,0,0,Costa Rica
37781,11/1/2021,CRI,Selangor,3,1,2,Costa Rica
37782,11/1/2021,CUB,Johor,0,0,0,Cuba
37783,11/1/2021,CUB,Kedah,0,0,0,Cuba
37784,11/1/2021,CUB,Perlis,0,0,0,Cuba
37785,11/1/2021,CUB,Pulau Pinang,0,0,0,Cuba
37786,11/1/2021,CUB,Sabah,0,0,0,Cuba
37787,11/1/2021,CUB,Sarawak,0,0,0,Cuba
37788,11/1/2021,CUB,Selangor,0,0,0,Cuba
37789,11/1/2021,CYP,Johor,0,0,0,Cyprus
37790,11/1/2021,CYP,Kedah,0,0,0,Cyprus
37791,11/1/2021,CYP,Perak,0,0,0,Cyprus
37792,11/1/2021,CYP,Perlis,0,0,0,Cyprus
37793,11/1/2021,CYP,Pulau Pinang,0,0,0,Cyprus
37794,11/1/2021,CYP,Sabah,0,0,0,Cyprus
37795,11/1/2021,CYP,Sarawak,0,0,0,Cyprus
37796,11/1/2021,CYP,Selangor,0,0,0,Cyprus
37797,11/1/2021,CZE,Johor,0,0,0,Czech Republic
37798,11/1/2021,CZE,Kedah,0,0,0,Czech Republic
37799,11/1/2021,CZE,Kelantan,0,0,0,Czech Republic
37800,11/1/2021,CZE,Melaka,0,0,0,Czech Republic
37801,11/1/2021,CZE,Negeri Sembilan,0,0,0,Czech Republic
37802,11/1/2021,CZE,Perak,0,0,0,Czech Republic
37803,11/1/2021,CZE,Perlis,0,0,0,Czech Republic
37804,11/1/2021,CZE,Pulau Pinang,0,0,0,Czech Republic
37805,11/1/2021,CZE,Sabah,0,0,0,Czech Republic
37806,11/1/2021,CZE,Sarawak,0,0,0,Czech Republic
37807,11/1/2021,CZE,Selangor,13,10,3,Czech Republic
37808,11/1/2021,CZE,W.P. Labuan,0,0,0,Czech Republic
37809,11/1/2021,DEU,Johor,0,0,0,Germany
37810,11/1/2021,DEU,Kedah,0,0,0,Germany
37811,11/1/2021,DEU,Kelantan,0,0,0,Germany
37812,11/1/2021,DEU,Melaka,0,0,0,Germany
37813,11/1/2021,DEU,Negeri Sembilan,0,0,0,Germany
37814,11/1/2021,DEU,Pahang,0,0,0,Germany
37815,11/1/2021,DEU,Perak,0,0,0,Germany
37816,11/1/2021,DEU,Perlis,0,0,0,Germany
37817,11/1/2021,DEU,Pulau Pinang,7,7,0,Germany
37818,11/1/2021,DEU,Sabah,0,0,0,Germany
37819,11/1/2021,DEU,Sarawak,1,1,0,Germany
37820,11/1/2021,DEU,Selangor,163,138,25,Germany
37821,11/1/2021,DEU,Terengganu,0,0,0,Germany
37822,11/1/2021,DEU,W.P. Labuan,0,0,0,Germany
37823,11/1/2021,DJI,Johor,0,0,0,Djibouti
37824,11/1/2021,DJI,Selangor,3,2,1,Djibouti
37825,11/1/2021,DMA,Johor,0,0,0,Dominica
37826,11/1/2021,DMA,Kedah,0,0,0,Dominica
37827,11/1/2021,DMA,Pulau Pinang,0,0,0,Dominica
37828,11/1/2021,DMA,Sabah,0,0,0,Dominica
37829,11/1/2021,DMA,Sarawak,0,0,0,Dominica
37830,11/1/2021,DMA,Selangor,8,3,5,Dominica
37831,11/1/2021,DMA,W.P. Labuan,0,0,0,Dominica
37832,11/1/2021,DNK,Johor,0,0,0,Denmark
37833,11/1/2021,DNK,Kedah,0,0,0,Denmark
37834,11/1/2021,DNK,Kelantan,0,0,0,Denmark
37835,11/1/2021,DNK,Melaka,0,0,0,Denmark
37836,11/1/2021,DNK,Negeri Sembilan,0,0,0,Denmark
37837,11/1/2021,DNK,Pahang,0,0,0,Denmark
37838,11/1/2021,DNK,Perak,0,0,0,Denmark
37839,11/1/2021,DNK,Perlis,0,0,0,Denmark
37840,11/1/2021,DNK,Pulau Pinang,2,2,0,Denmark
37841,11/1/2021,DNK,Sabah,0,0,0,Denmark
37842,11/1/2021,DNK,Sarawak,0,0,0,Denmark
37843,11/1/2021,DNK,Selangor,34,30,4,Denmark
37844,11/1/2021,DNK,W.P. Labuan,0,0,0,Denmark
37845,11/1/2021,DOM,Johor,0,0,0,Dominican Republic
37846,11/1/2021,DOM,Kedah,0,0,0,Dominican Republic
37847,11/1/2021,DOM,Perak,0,0,0,Dominican Republic
37848,11/1/2021,DOM,Perlis,0,0,0,Dominican Republic
37849,11/1/2021,DOM,Pulau Pinang,0,0,0,Dominican Republic
37850,11/1/2021,DOM,Sabah,0,0,0,Dominican Republic
37851,11/1/2021,DOM,Sarawak,0,0,0,Dominican Republic
37852,11/1/2021,DOM,Selangor,0,0,0,Dominican Republic
37853,11/1/2021,DZA,Johor,0,0,0,Algeria
37854,11/1/2021,DZA,Kedah,0,0,0,Algeria
37855,11/1/2021,DZA,Kelantan,0,0,0,Algeria
37856,11/1/2021,DZA,Melaka,0,0,0,Algeria
37857,11/1/2021,DZA,Perak,0,0,0,Algeria
37858,11/1/2021,DZA,Perlis,0,0,0,Algeria
37859,11/1/2021,DZA,Pulau Pinang,0,0,0,Algeria
37860,11/1/2021,DZA,Sabah,0,0,0,Algeria
37861,11/1/2021,DZA,Sarawak,0,0,0,Algeria
37862,11/1/2021,DZA,Selangor,26,18,8,Algeria
37863,11/1/2021,DZA,W.P. Labuan,0,0,0,Algeria
37864,11/1/2021,ECU,Johor,0,0,0,Ecuador
37865,11/1/2021,ECU,Kedah,0,0,0,Ecuador
37866,11/1/2021,ECU,Perak,0,0,0,Ecuador
37867,11/1/2021,ECU,Perlis,0,0,0,Ecuador
37868,11/1/2021,ECU,Pulau Pinang,0,0,0,Ecuador
37869,11/1/2021,ECU,Sabah,0,0,0,Ecuador
37870,11/1/2021,ECU,Sarawak,0,0,0,Ecuador
37871,11/1/2021,ECU,Selangor,0,0,0,Ecuador
37872,11/1/2021,EGY,Johor,0,0,0,Egypt
37873,11/1/2021,EGY,Kedah,0,0,0,Egypt
37874,11/1/2021,EGY,Kelantan,0,0,0,Egypt
37875,11/1/2021,EGY,Melaka,0,0,0,Egypt
37876,11/1/2021,EGY,Pahang,0,0,0,Egypt
37877,11/1/2021,EGY,Perak,0,0,0,Egypt
37878,11/1/2021,EGY,Perlis,0,0,0,Egypt
37879,11/1/2021,EGY,Pulau Pinang,0,0,0,Egypt
37880,11/1/2021,EGY,Sabah,0,0,0,Egypt
37881,11/1/2021,EGY,Sarawak,0,0,0,Egypt
37882,11/1/2021,EGY,Selangor,213,160,53,Egypt
37883,11/1/2021,EGY,Terengganu,0,0,0,Egypt
37884,11/1/2021,EGY,W.P. Labuan,0,0,0,Egypt
37885,11/1/2021,ERI,Johor,0,0,0,Eritrea
37886,11/1/2021,ERI,Pulau Pinang,0,0,0,Eritrea
37887,11/1/2021,ERI,Sabah,0,0,0,Eritrea
37888,11/1/2021,ERI,Selangor,1,0,1,Eritrea
37889,11/1/2021,ESP,Johor,0,0,0,Spain
37890,11/1/2021,ESP,Kedah,0,0,0,Spain
37891,11/1/2021,ESP,Kelantan,0,0,0,Spain
37892,11/1/2021,ESP,Melaka,0,0,0,Spain
37893,11/1/2021,ESP,Negeri Sembilan,0,0,0,Spain
37894,11/1/2021,ESP,Pahang,0,0,0,Spain
37895,11/1/2021,ESP,Perak,0,0,0,Spain
37896,11/1/2021,ESP,Perlis,0,0,0,Spain
37897,11/1/2021,ESP,Pulau Pinang,0,0,0,Spain
37898,11/1/2021,ESP,Sabah,0,0,0,Spain
37899,11/1/2021,ESP,Sarawak,0,0,0,Spain
37900,11/1/2021,ESP,Selangor,44,31,13,Spain
37901,11/1/2021,ESP,W.P. Labuan,0,0,0,Spain
37902,11/1/2021,EST,Johor,0,0,0,Estonia
37903,11/1/2021,EST,Kedah,1,1,0,Estonia
37904,11/1/2021,EST,Kelantan,0,0,0,Estonia
37905,11/1/2021,EST,Pahang,0,0,0,Estonia
37906,11/1/2021,EST,Perak,0,0,0,Estonia
37907,11/1/2021,EST,Perlis,0,0,0,Estonia
37908,11/1/2021,EST,Pulau Pinang,0,0,0,Estonia
37909,11/1/2021,EST,Sabah,0,0,0,Estonia
37910,11/1/2021,EST,Sarawak,0,0,0,Estonia
37911,11/1/2021,EST,Selangor,6,6,0,Estonia
37912,11/1/2021,EST,W.P. Labuan,0,0,0,Estonia
37913,11/1/2021,ETH,Johor,0,0,0,Ethiopia
37914,11/1/2021,ETH,Kedah,0,0,0,Ethiopia
37915,11/1/2021,ETH,Pulau Pinang,0,0,0,Ethiopia
37916,11/1/2021,ETH,Sarawak,0,0,0,Ethiopia
37917,11/1/2021,ETH,Selangor,10,2,8,Ethiopia
37918,11/1/2021,FIN,Johor,0,0,0,Finland
37919,11/1/2021,FIN,Kedah,0,0,0,Finland
37920,11/1/2021,FIN,Kelantan,0,0,0,Finland
37921,11/1/2021,FIN,Melaka,0,0,0,Finland
37922,11/1/2021,FIN,Negeri Sembilan,0,0,0,Finland
37923,11/1/2021,FIN,Pahang,0,0,0,Finland
37924,11/1/2021,FIN,Perak,0,0,0,Finland
37925,11/1/2021,FIN,Perlis,0,0,0,Finland
37926,11/1/2021,FIN,Pulau Pinang,0,0,0,Finland
37927,11/1/2021,FIN,Sabah,0,0,0,Finland
37928,11/1/2021,FIN,Sarawak,0,0,0,Finland
37929,11/1/2021,FIN,Selangor,19,18,1,Finland
37930,11/1/2021,FIN,W.P. Labuan,0,0,0,Finland
37931,11/1/2021,FJI,Johor,0,0,0,Fiji
37932,11/1/2021,FJI,Kedah,0,0,0,Fiji
37933,11/1/2021,FJI,Kelantan,0,0,0,Fiji
37934,11/1/2021,FJI,Perak,0,0,0,Fiji
37935,11/1/2021,FJI,Perlis,0,0,0,Fiji
37936,11/1/2021,FJI,Pulau Pinang,0,0,0,Fiji
37937,11/1/2021,FJI,Sabah,0,0,0,Fiji
37938,11/1/2021,FJI,Sarawak,0,0,0,Fiji
37939,11/1/2021,FJI,Selangor,2,0,2,Fiji
37940,11/1/2021,FRA,Johor,0,0,0,France
37941,11/1/2021,FRA,Kedah,0,0,0,France
37942,11/1/2021,FRA,Kelantan,0,0,0,France
37943,11/1/2021,FRA,Melaka,0,0,0,France
37944,11/1/2021,FRA,Negeri Sembilan,0,0,0,France
37945,11/1/2021,FRA,Pahang,0,0,0,France
37946,11/1/2021,FRA,Perak,0,0,0,France
37947,11/1/2021,FRA,Perlis,0,0,0,France
37948,11/1/2021,FRA,Pulau Pinang,3,3,0,France
37949,11/1/2021,FRA,Sabah,0,0,0,France
37950,11/1/2021,FRA,Sarawak,2,2,0,France
37951,11/1/2021,FRA,Selangor,166,120,46,France
37952,11/1/2021,FRA,Terengganu,0,0,0,France
37953,11/1/2021,FRA,W.P. Labuan,0,0,0,France
37954,11/1/2021,FSM,Johor,0,0,0,"Micronesia, Federated States of"
37955,11/1/2021,FSM,Pulau Pinang,0,0,0,"Micronesia, Federated States of"
37956,11/1/2021,FSM,Selangor,0,0,0,"Micronesia, Federated States of"
37957,11/1/2021,GAB,Johor,0,0,0,Gabon
37958,11/1/2021,GAB,Pulau Pinang,0,0,0,Gabon
37959,11/1/2021,GAB,Sarawak,0,0,0,Gabon
37960,11/1/2021,GAB,Selangor,1,1,0,Gabon
37961,11/1/2021,GBR,Johor,0,0,0,United Kingdom
37962,11/1/2021,GBR,Kedah,0,0,0,United Kingdom
37963,11/1/2021,GBR,Kelantan,0,0,0,United Kingdom
37964,11/1/2021,GBR,Melaka,0,0,0,United Kingdom
37965,11/1/2021,GBR,Negeri Sembilan,0,0,0,United Kingdom
37966,11/1/2021,GBR,Pahang,0,0,0,United Kingdom
37967,11/1/2021,GBR,Perak,0,0,0,United Kingdom
37968,11/1/2021,GBR,Perlis,0,0,0,United Kingdom
37969,11/1/2021,GBR,Pulau Pinang,18,11,7,United Kingdom
37970,11/1/2021,GBR,Sabah,0,0,0,United Kingdom
37971,11/1/2021,GBR,Sarawak,4,3,1,United Kingdom
37972,11/1/2021,GBR,Selangor,433,333,100,United Kingdom
37973,11/1/2021,GBR,Terengganu,0,0,0,United Kingdom
37974,11/1/2021,GBR,W.P. Labuan,0,0,0,United Kingdom
37975,11/1/2021,GEO,Johor,1,1,0,Georgia
37976,11/1/2021,GEO,Kedah,0,0,0,Georgia
37977,11/1/2021,GEO,Melaka,0,0,0,Georgia
37978,11/1/2021,GEO,Perak,0,0,0,Georgia
37979,11/1/2021,GEO,Perlis,0,0,0,Georgia
37980,11/1/2021,GEO,Pulau Pinang,0,0,0,Georgia
37981,11/1/2021,GEO,Sabah,0,0,0,Georgia
37982,11/1/2021,GEO,Sarawak,0,0,0,Georgia
37983,11/1/2021,GEO,Selangor,1,1,0,Georgia
37984,11/1/2021,GHA,Johor,0,0,0,Ghana
37985,11/1/2021,GHA,Kedah,0,0,0,Ghana
37986,11/1/2021,GHA,Kelantan,0,0,0,Ghana
37987,11/1/2021,GHA,Pulau Pinang,0,0,0,Ghana
37988,11/1/2021,GHA,Sabah,0,0,0,Ghana
37989,11/1/2021,GHA,Sarawak,0,0,0,Ghana
37990,11/1/2021,GHA,Selangor,2,1,1,Ghana
37991,11/1/2021,GIB,Johor,0,0,0,Gibraltar
37992,11/1/2021,GIB,Sarawak,0,0,0,Gibraltar
37993,11/1/2021,GIN,Johor,0,0,0,Guinea
37994,11/1/2021,GIN,Kedah,0,0,0,Guinea
37995,11/1/2021,GIN,Kelantan,0,0,0,Guinea
37996,11/1/2021,GIN,Perlis,0,0,0,Guinea
37997,11/1/2021,GIN,Pulau Pinang,0,0,0,Guinea
37998,11/1/2021,GIN,Sabah,0,0,0,Guinea
37999,11/1/2021,GIN,Sarawak,0,0,0,Guinea
38000,11/1/2021,GIN,Selangor,4,4,0,Guinea
38001,11/1/2021,GLP,Selangor,0,0,0,Guadeloupe
38002,11/1/2021,GMB,Johor,0,0,0,Gambia
38003,11/1/2021,GMB,Kedah,0,0,0,Gambia
38004,11/1/2021,GMB,Kelantan,0,0,0,Gambia
38005,11/1/2021,GMB,Pulau Pinang,0,0,0,Gambia
38006,11/1/2021,GMB,Sabah,0,0,0,Gambia
38007,11/1/2021,GMB,Sarawak,0,0,0,Gambia
38008,11/1/2021,GMB,Selangor,3,1,2,Gambia
38009,11/1/2021,GNB,Johor,0,0,0,Guinea-Bissau
38010,11/1/2021,GNB,Selangor,0,0,0,Guinea-Bissau
38011,11/1/2021,GNQ,Johor,0,0,0,Equatorial Guinea
38012,11/1/2021,GNQ,Selangor,0,0,0,Equatorial Guinea
38013,11/1/2021,GRC,Johor,0,0,0,Greece
38014,11/1/2021,GRC,Kedah,0,0,0,Greece
38015,11/1/2021,GRC,Kelantan,0,0,0,Greece
38016,11/1/2021,GRC,Melaka,0,0,0,Greece
38017,11/1/2021,GRC,Negeri Sembilan,0,0,0,Greece
38018,11/1/2021,GRC,Pahang,0,0,0,Greece
38019,11/1/2021,GRC,Perak,0,0,0,Greece
38020,11/1/2021,GRC,Perlis,0,0,0,Greece
38021,11/1/2021,GRC,Pulau Pinang,0,0,0,Greece
38022,11/1/2021,GRC,Sabah,0,0,0,Greece
38023,11/1/2021,GRC,Sarawak,0,0,0,Greece
38024,11/1/2021,GRC,Selangor,15,14,1,Greece
38025,11/1/2021,GRD,Johor,0,0,0,Grenada
38026,11/1/2021,GRD,Kedah,0,0,0,Grenada
38027,11/1/2021,GRD,Pulau Pinang,0,0,0,Grenada
38028,11/1/2021,GRD,Sabah,0,0,0,Grenada
38029,11/1/2021,GRD,Sarawak,0,0,0,Grenada
38030,11/1/2021,GRD,Selangor,0,0,0,Grenada
38031,11/1/2021,GRL,Johor,0,0,0,Greenland
38032,11/1/2021,GRL,Selangor,0,0,0,Greenland
38033,11/1/2021,GTM,Johor,0,0,0,Guatemala
38034,11/1/2021,GTM,Kedah,0,0,0,Guatemala
38035,11/1/2021,GTM,Pahang,0,0,0,Guatemala
38036,11/1/2021,GTM,Perak,0,0,0,Guatemala
38037,11/1/2021,GTM,Pulau Pinang,0,0,0,Guatemala
38038,11/1/2021,GTM,Sabah,0,0,0,Guatemala
38039,11/1/2021,GTM,Sarawak,0,0,0,Guatemala
38040,11/1/2021,GTM,Selangor,0,0,0,Guatemala
38041,11/1/2021,GTM,W.P. Labuan,0,0,0,Guatemala
38042,11/1/2021,GUY,Johor,0,0,0,Guyana
38043,11/1/2021,GUY,Kedah,0,0,0,Guyana
38044,11/1/2021,GUY,Pulau Pinang,0,0,0,Guyana
38045,11/1/2021,GUY,Sarawak,0,0,0,Guyana
38046,11/1/2021,GUY,Selangor,0,0,0,Guyana
38047,11/1/2021,HKG,Johor,0,0,0,Hong Kong
38048,11/1/2021,HKG,Kedah,0,0,0,Hong Kong
38049,11/1/2021,HKG,Kelantan,0,0,0,Hong Kong
38050,11/1/2021,HKG,Pahang,0,0,0,Hong Kong
38051,11/1/2021,HKG,Perak,0,0,0,Hong Kong
38052,11/1/2021,HKG,Perlis,0,0,0,Hong Kong
38053,11/1/2021,HKG,Pulau Pinang,4,2,2,Hong Kong
38054,11/1/2021,HKG,Sabah,0,0,0,Hong Kong
38055,11/1/2021,HKG,Sarawak,30,28,2,Hong Kong
38056,11/1/2021,HKG,Selangor,10,9,1,Hong Kong
38057,11/1/2021,HKG,Terengganu,0,0,0,Hong Kong
38058,11/1/2021,HMD,Johor,0,0,0,Heard Island and McDonald Islands
38059,11/1/2021,HND,Johor,0,0,0,Honduras
38060,11/1/2021,HND,Kedah,0,0,0,Honduras
38061,11/1/2021,HND,Perak,0,0,0,Honduras
38062,11/1/2021,HND,Pulau Pinang,0,0,0,Honduras
38063,11/1/2021,HND,Sabah,0,0,0,Honduras
38064,11/1/2021,HND,Sarawak,0,0,0,Honduras
38065,11/1/2021,HND,Selangor,0,0,0,Honduras
38066,11/1/2021,HRV,Johor,0,0,0,Croatia
38067,11/1/2021,HRV,Kedah,0,0,0,Croatia
38068,11/1/2021,HRV,Kelantan,0,0,0,Croatia
38069,11/1/2021,HRV,Melaka,0,0,0,Croatia
38070,11/1/2021,HRV,Pahang,0,0,0,Croatia
38071,11/1/2021,HRV,Perak,0,0,0,Croatia
38072,11/1/2021,HRV,Perlis,0,0,0,Croatia
38073,11/1/2021,HRV,Pulau Pinang,0,0,0,Croatia
38074,11/1/2021,HRV,Sabah,0,0,0,Croatia
38075,11/1/2021,HRV,Sarawak,0,0,0,Croatia
38076,11/1/2021,HRV,Selangor,19,18,1,Croatia
38077,11/1/2021,HTI,Johor,0,0,0,Haiti
38078,11/1/2021,HTI,Kedah,0,0,0,Haiti
38079,11/1/2021,HTI,Kelantan,0,0,0,Haiti
38080,11/1/2021,HTI,Perak,0,0,0,Haiti
38081,11/1/2021,HTI,Pulau Pinang,0,0,0,Haiti
38082,11/1/2021,HTI,Sabah,0,0,0,Haiti
38083,11/1/2021,HTI,Selangor,0,0,0,Haiti
38084,11/1/2021,HUN,Johor,0,0,0,Hungary
38085,11/1/2021,HUN,Kedah,0,0,0,Hungary
38086,11/1/2021,HUN,Kelantan,0,0,0,Hungary
38087,11/1/2021,HUN,Pahang,0,0,0,Hungary
38088,11/1/2021,HUN,Perak,0,0,0,Hungary
38089,11/1/2021,HUN,Perlis,0,0,0,Hungary
38090,11/1/2021,HUN,Pulau Pinang,0,0,0,Hungary
38091,11/1/2021,HUN,Sabah,0,0,0,Hungary
38092,11/1/2021,HUN,Sarawak,0,0,0,Hungary
38093,11/1/2021,HUN,Selangor,5,3,2,Hungary
38094,11/1/2021,HUN,W.P. Labuan,0,0,0,Hungary
38095,11/1/2021,IDN,Johor,204,130,74,Indonesia
38096,11/1/2021,IDN,Kedah,4,4,0,Indonesia
38097,11/1/2021,IDN,Kelantan,0,0,0,Indonesia
38098,11/1/2021,IDN,Melaka,0,0,0,Indonesia
38099,11/1/2021,IDN,Negeri Sembilan,0,0,0,Indonesia
38100,11/1/2021,IDN,Pahang,0,0,0,Indonesia
38101,11/1/2021,IDN,Perak,0,0,0,Indonesia
38102,11/1/2021,IDN,Perlis,4,4,0,Indonesia
38103,11/1/2021,IDN,Pulau Pinang,45,18,27,Indonesia
38104,11/1/2021,IDN,Sabah,10,4,6,Indonesia
38105,11/1/2021,IDN,Sarawak,265,250,15,Indonesia
38106,11/1/2021,IDN,Selangor,1970,915,1055,Indonesia
38107,11/1/2021,IDN,Terengganu,0,0,0,Indonesia
38108,11/1/2021,IDN,W.P. Labuan,0,0,0,Indonesia
38109,11/1/2021,IND,Johor,12,12,0,India
38110,11/1/2021,IND,Kedah,0,0,0,India
38111,11/1/2021,IND,Kelantan,0,0,0,India
38112,11/1/2021,IND,Melaka,0,0,0,India
38113,11/1/2021,IND,Negeri Sembilan,0,0,0,India
38114,11/1/2021,IND,Pahang,0,0,0,India
38115,11/1/2021,IND,Perak,0,0,0,India
38116,11/1/2021,IND,Perlis,0,0,0,India
38117,11/1/2021,IND,Pulau Pinang,5,4,1,India
38118,11/1/2021,IND,Sabah,1,1,0,India
38119,11/1/2021,IND,Sarawak,0,0,0,India
38120,11/1/2021,IND,Selangor,2054,1623,431,India
38121,11/1/2021,IND,Terengganu,0,0,0,India
38122,11/1/2021,IND,W.P. Labuan,0,0,0,India
38123,11/1/2021,IOT,Pulau Pinang,0,0,0,British Indian Ocean Territory
38124,11/1/2021,IOT,Selangor,0,0,0,British Indian Ocean Territory
38125,11/1/2021,IRL,Johor,0,0,0,Ireland
38126,11/1/2021,IRL,Kedah,0,0,0,Ireland
38127,11/1/2021,IRL,Kelantan,0,0,0,Ireland
38128,11/1/2021,IRL,Negeri Sembilan,0,0,0,Ireland
38129,11/1/2021,IRL,Pahang,0,0,0,Ireland
38130,11/1/2021,IRL,Perak,0,0,0,Ireland
38131,11/1/2021,IRL,Perlis,0,0,0,Ireland
38132,11/1/2021,IRL,Pulau Pinang,0,0,0,Ireland
38133,11/1/2021,IRL,Sabah,0,0,0,Ireland
38134,11/1/2021,IRL,Sarawak,1,1,0,Ireland
38135,11/1/2021,IRL,Selangor,24,15,9,Ireland
38136,11/1/2021,IRL,Terengganu,0,0,0,Ireland
38137,11/1/2021,IRL,W.P. Labuan,0,0,0,Ireland
38138,11/1/2021,IRN,Johor,0,0,0,Iran
38139,11/1/2021,IRN,Kedah,0,0,0,Iran
38140,11/1/2021,IRN,Kelantan,0,0,0,Iran
38141,11/1/2021,IRN,Perak,0,0,0,Iran
38142,11/1/2021,IRN,Perlis,0,0,0,Iran
38143,11/1/2021,IRN,Pulau Pinang,0,0,0,Iran
38144,11/1/2021,IRN,Sabah,0,0,0,Iran
38145,11/1/2021,IRN,Sarawak,0,0,0,Iran
38146,11/1/2021,IRN,Selangor,99,58,41,Iran
38147,11/1/2021,IRN,W.P. Labuan,0,0,0,Iran
38148,11/1/2021,IRQ,Johor,0,0,0,Iraq
38149,11/1/2021,IRQ,Kedah,0,0,0,Iraq
38150,11/1/2021,IRQ,Kelantan,0,0,0,Iraq
38151,11/1/2021,IRQ,Melaka,0,0,0,Iraq
38152,11/1/2021,IRQ,Pahang,0,0,0,Iraq
38153,11/1/2021,IRQ,Perak,0,0,0,Iraq
38154,11/1/2021,IRQ,Perlis,0,0,0,Iraq
38155,11/1/2021,IRQ,Pulau Pinang,0,0,0,Iraq
38156,11/1/2021,IRQ,Sabah,0,0,0,Iraq
38157,11/1/2021,IRQ,Sarawak,0,0,0,Iraq
38158,11/1/2021,IRQ,Selangor,104,73,31,Iraq
38159,11/1/2021,ISL,Johor,0,0,0,Iceland
38160,11/1/2021,ISL,Kedah,0,0,0,Iceland
38161,11/1/2021,ISL,Kelantan,0,0,0,Iceland
38162,11/1/2021,ISL,Perak,0,0,0,Iceland
38163,11/1/2021,ISL,Perlis,0,0,0,Iceland
38164,11/1/2021,ISL,Pulau Pinang,0,0,0,Iceland
38165,11/1/2021,ISL,Sabah,0,0,0,Iceland
38166,11/1/2021,ISL,Sarawak,0,0,0,Iceland
38167,11/1/2021,ISL,Selangor,0,0,0,Iceland
38168,11/1/2021,ISL,W.P. Labuan,0,0,0,Iceland
38169,11/1/2021,ISR,Pulau Pinang,0,0,0,Israel
38170,11/1/2021,ITA,Johor,0,0,0,Italy
38171,11/1/2021,ITA,Kedah,0,0,0,Italy
38172,11/1/2021,ITA,Kelantan,0,0,0,Italy
38173,11/1/2021,ITA,Melaka,0,0,0,Italy
38174,11/1/2021,ITA,Negeri Sembilan,0,0,0,Italy
38175,11/1/2021,ITA,Pahang,0,0,0,Italy
38176,11/1/2021,ITA,Perak,0,0,0,Italy
38177,11/1/2021,ITA,Perlis,0,0,0,Italy
38178,11/1/2021,ITA,Pulau Pinang,1,1,0,Italy
38179,11/1/2021,ITA,Sabah,0,0,0,Italy
38180,11/1/2021,ITA,Sarawak,0,0,0,Italy
38181,11/1/2021,ITA,Selangor,73,61,12,Italy
38182,11/1/2021,ITA,W.P. Labuan,0,0,0,Italy
38183,11/1/2021,JAM,Johor,0,0,0,Jamaica
38184,11/1/2021,JAM,Kedah,0,0,0,Jamaica
38185,11/1/2021,JAM,Perak,0,0,0,Jamaica
38186,11/1/2021,JAM,Pulau Pinang,0,0,0,Jamaica
38187,11/1/2021,JAM,Sabah,0,0,0,Jamaica
38188,11/1/2021,JAM,Sarawak,0,0,0,Jamaica
38189,11/1/2021,JAM,Selangor,0,0,0,Jamaica
38190,11/1/2021,JAM,W.P. Labuan,0,0,0,Jamaica
38191,11/1/2021,JOR,Johor,0,0,0,Jordan
38192,11/1/2021,JOR,Kedah,0,0,0,Jordan
38193,11/1/2021,JOR,Kelantan,0,0,0,Jordan
38194,11/1/2021,JOR,Melaka,0,0,0,Jordan
38195,11/1/2021,JOR,Perlis,0,0,0,Jordan
38196,11/1/2021,JOR,Pulau Pinang,0,0,0,Jordan
38197,11/1/2021,JOR,Sabah,0,0,0,Jordan
38198,11/1/2021,JOR,Sarawak,1,1,0,Jordan
38199,11/1/2021,JOR,Selangor,50,45,5,Jordan
38200,11/1/2021,JOR,W.P. Labuan,0,0,0,Jordan
38201,11/1/2021,JPN,Johor,0,0,0,Japan
38202,11/1/2021,JPN,Kedah,0,0,0,Japan
38203,11/1/2021,JPN,Kelantan,0,0,0,Japan
38204,11/1/2021,JPN,Melaka,0,0,0,Japan
38205,11/1/2021,JPN,Negeri Sembilan,0,0,0,Japan
38206,11/1/2021,JPN,Pahang,0,0,0,Japan
38207,11/1/2021,JPN,Perak,0,0,0,Japan
38208,11/1/2021,JPN,Perlis,0,0,0,Japan
38209,11/1/2021,JPN,Pulau Pinang,54,38,16,Japan
38210,11/1/2021,JPN,Sabah,1,1,0,Japan
38211,11/1/2021,JPN,Sarawak,5,3,2,Japan
38212,11/1/2021,JPN,Selangor,732,505,227,Japan
38213,11/1/2021,JPN,W.P. Labuan,0,0,0,Japan
38214,11/1/2021,KAZ,Johor,0,0,0,Kazakhstan
38215,11/1/2021,KAZ,Kedah,0,0,0,Kazakhstan
38216,11/1/2021,KAZ,Kelantan,0,0,0,Kazakhstan
38217,11/1/2021,KAZ,Melaka,0,0,0,Kazakhstan
38218,11/1/2021,KAZ,Perak,0,0,0,Kazakhstan
38219,11/1/2021,KAZ,Perlis,0,0,0,Kazakhstan
38220,11/1/2021,KAZ,Pulau Pinang,0,0,0,Kazakhstan
38221,11/1/2021,KAZ,Sabah,0,0,0,Kazakhstan
38222,11/1/2021,KAZ,Sarawak,0,0,0,Kazakhstan
38223,11/1/2021,KAZ,Selangor,25,13,12,Kazakhstan
38224,11/1/2021,KAZ,W.P. Labuan,0,0,0,Kazakhstan
38225,11/1/2021,KEN,Johor,0,0,0,Kenya
38226,11/1/2021,KEN,Kedah,0,0,0,Kenya
38227,11/1/2021,KEN,Kelantan,0,0,0,Kenya
38228,11/1/2021,KEN,Perak,0,0,0,Kenya
38229,11/1/2021,KEN,Perlis,0,0,0,Kenya
38230,11/1/2021,KEN,Pulau Pinang,0,0,0,Kenya
38231,11/1/2021,KEN,Sabah,0,0,0,Kenya
38232,11/1/2021,KEN,Sarawak,0,0,0,Kenya
38233,11/1/2021,KEN,Selangor,42,32,10,Kenya
38234,11/1/2021,KGZ,Johor,0,0,0,Kyrgyzstan
38235,11/1/2021,KGZ,Kedah,0,0,0,Kyrgyzstan
38236,11/1/2021,KGZ,Kelantan,0,0,0,Kyrgyzstan
38237,11/1/2021,KGZ,Perak,0,0,0,Kyrgyzstan
38238,11/1/2021,KGZ,Perlis,0,0,0,Kyrgyzstan
38239,11/1/2021,KGZ,Pulau Pinang,0,0,0,Kyrgyzstan
38240,11/1/2021,KGZ,Sabah,0,0,0,Kyrgyzstan
38241,11/1/2021,KGZ,Sarawak,0,0,0,Kyrgyzstan
38242,11/1/2021,KGZ,Selangor,6,2,4,Kyrgyzstan
38243,11/1/2021,KHM,Johor,0,0,0,Cambodia
38244,11/1/2021,KHM,Kedah,0,0,0,Cambodia
38245,11/1/2021,KHM,Kelantan,0,0,0,Cambodia
38246,11/1/2021,KHM,Melaka,0,0,0,Cambodia
38247,11/1/2021,KHM,Negeri Sembilan,0,0,0,Cambodia
38248,11/1/2021,KHM,Pahang,0,0,0,Cambodia
38249,11/1/2021,KHM,Perak,0,0,0,Cambodia
38250,11/1/2021,KHM,Perlis,0,0,0,Cambodia
38251,11/1/2021,KHM,Pulau Pinang,18,17,1,Cambodia
38252,11/1/2021,KHM,Sabah,0,0,0,Cambodia
38253,11/1/2021,KHM,Sarawak,1,1,0,Cambodia
38254,11/1/2021,KHM,Selangor,28,15,13,Cambodia
38255,11/1/2021,KHM,W.P. Labuan,0,0,0,Cambodia
38256,11/1/2021,KIR,Johor,0,0,0,Kiribati
38257,11/1/2021,KIR,Sabah,0,0,0,Kiribati
38258,11/1/2021,KIR,Selangor,0,0,0,Kiribati
38259,11/1/2021,KNA,Johor,0,0,0,Saint Kitts and Nevis
38260,11/1/2021,KNA,Kedah,0,0,0,Saint Kitts and Nevis
38261,11/1/2021,KNA,Perlis,0,0,0,Saint Kitts and Nevis
38262,11/1/2021,KNA,Pulau Pinang,0,0,0,Saint Kitts and Nevis
38263,11/1/2021,KNA,Sabah,0,0,0,Saint Kitts and Nevis
38264,11/1/2021,KNA,Selangor,0,0,0,Saint Kitts and Nevis
38265,11/1/2021,KNA,W.P. Labuan,0,0,0,Saint Kitts and Nevis
38266,11/1/2021,KOR,Johor,2,1,1,"Korea, Republic of (South Korea)"
38267,11/1/2021,KOR,Kedah,0,0,0,"Korea, Republic of (South Korea)"
38268,11/1/2021,KOR,Kelantan,0,0,0,"Korea, Republic of (South Korea)"
38269,11/1/2021,KOR,Melaka,0,0,0,"Korea, Republic of (South Korea)"
38270,11/1/2021,KOR,Negeri Sembilan,0,0,0,"Korea, Republic of (South Korea)"
38271,11/1/2021,KOR,Pahang,0,0,0,"Korea, Republic of (South Korea)"
38272,11/1/2021,KOR,Perak,1,1,0,"Korea, Republic of (South Korea)"
38273,11/1/2021,KOR,Perlis,0,0,0,"Korea, Republic of (South Korea)"
38274,11/1/2021,KOR,Pulau Pinang,34,13,21,"Korea, Republic of (South Korea)"
38275,11/1/2021,KOR,Sabah,6,3,3,"Korea, Republic of (South Korea)"
38276,11/1/2021,KOR,Sarawak,34,31,3,"Korea, Republic of (South Korea)"
38277,11/1/2021,KOR,Selangor,546,337,209,"Korea, Republic of (South Korea)"
38278,11/1/2021,KOR,Terengganu,0,0,0,"Korea, Republic of (South Korea)"
38279,11/1/2021,KOR,W.P. Labuan,0,0,0,"Korea, Republic of (South Korea)"
38280,11/1/2021,KWT,Johor,0,0,0,Kuwait
38281,11/1/2021,KWT,Kedah,0,0,0,Kuwait
38282,11/1/2021,KWT,Kelantan,0,0,0,Kuwait
38283,11/1/2021,KWT,Perak,0,0,0,Kuwait
38284,11/1/2021,KWT,Perlis,0,0,0,Kuwait
38285,11/1/2021,KWT,Pulau Pinang,0,0,0,Kuwait
38286,11/1/2021,KWT,Sabah,0,0,0,Kuwait
38287,11/1/2021,KWT,Sarawak,0,0,0,Kuwait
38288,11/1/2021,KWT,Selangor,2,2,0,Kuwait
38289,11/1/2021,KWT,W.P. Labuan,0,0,0,Kuwait
38290,11/1/2021,LAO,Johor,0,0,0,Lao People's Democratic Republic
38291,11/1/2021,LAO,Kedah,0,0,0,Lao People's Democratic Republic
38292,11/1/2021,LAO,Kelantan,0,0,0,Lao People's Democratic Republic
38293,11/1/2021,LAO,Melaka,0,0,0,Lao People's Democratic Republic
38294,11/1/2021,LAO,Perak,0,0,0,Lao People's Democratic Republic
38295,11/1/2021,LAO,Perlis,0,0,0,Lao People's Democratic Republic
38296,11/1/2021,LAO,Pulau Pinang,0,0,0,Lao People's Democratic Republic
38297,11/1/2021,LAO,Sabah,0,0,0,Lao People's Democratic Republic
38298,11/1/2021,LAO,Sarawak,0,0,0,Lao People's Democratic Republic
38299,11/1/2021,LAO,Selangor,1,0,1,Lao People's Democratic Republic
38300,11/1/2021,LAO,W.P. Labuan,0,0,0,Lao People's Democratic Republic
38301,11/1/2021,LBN,Johor,0,0,0,Lebanon
38302,11/1/2021,LBN,Kedah,0,0,0,Lebanon
38303,11/1/2021,LBN,Kelantan,0,0,0,Lebanon
38304,11/1/2021,LBN,Pahang,0,0,0,Lebanon
38305,11/1/2021,LBN,Perak,0,0,0,Lebanon
38306,11/1/2021,LBN,Perlis,0,0,0,Lebanon
38307,11/1/2021,LBN,Pulau Pinang,0,0,0,Lebanon
38308,11/1/2021,LBN,Sabah,0,0,0,Lebanon
38309,11/1/2021,LBN,Sarawak,0,0,0,Lebanon
38310,11/1/2021,LBN,Selangor,14,9,5,Lebanon
38311,11/1/2021,LBN,W.P. Labuan,0,0,0,Lebanon
38312,11/1/2021,LBR,Johor,0,0,0,Liberia
38313,11/1/2021,LBR,Kedah,0,0,0,Liberia
38314,11/1/2021,LBR,Sabah,0,0,0,Liberia
38315,11/1/2021,LBR,Sarawak,0,0,0,Liberia
38316,11/1/2021,LBR,Selangor,0,0,0,Liberia
38317,11/1/2021,LBY,Johor,0,0,0,Libyan Arab Jamahiriya
38318,11/1/2021,LBY,Kedah,0,0,0,Libyan Arab Jamahiriya
38319,11/1/2021,LBY,Perlis,0,0,0,Libyan Arab Jamahiriya
38320,11/1/2021,LBY,Pulau Pinang,0,0,0,Libyan Arab Jamahiriya
38321,11/1/2021,LBY,Sabah,0,0,0,Libyan Arab Jamahiriya
38322,11/1/2021,LBY,Sarawak,0,0,0,Libyan Arab Jamahiriya
38323,11/1/2021,LBY,Selangor,58,49,9,Libyan Arab Jamahiriya
38324,11/1/2021,LCA,Johor,0,0,0,Saint Lucia
38325,11/1/2021,LCA,Kedah,0,0,0,Saint Lucia
38326,11/1/2021,LCA,Pulau Pinang,0,0,0,Saint Lucia
38327,11/1/2021,LCA,Sarawak,0,0,0,Saint Lucia
38328,11/1/2021,LCA,Selangor,1,1,0,Saint Lucia
38329,11/1/2021,LIE,Johor,0,0,0,Liechtenstein
38330,11/1/2021,LIE,Kedah,0,0,0,Liechtenstein
38331,11/1/2021,LIE,Perlis,0,0,0,Liechtenstein
38332,11/1/2021,LIE,Pulau Pinang,0,0,0,Liechtenstein
38333,11/1/2021,LIE,Sabah,0,0,0,Liechtenstein
38334,11/1/2021,LIE,Sarawak,0,0,0,Liechtenstein
38335,11/1/2021,LIE,Selangor,0,0,0,Liechtenstein
38336,11/1/2021,LKA,Johor,0,0,0,Sri Lanka
38337,11/1/2021,LKA,Kedah,0,0,0,Sri Lanka
38338,11/1/2021,LKA,Kelantan,0,0,0,Sri Lanka
38339,11/1/2021,LKA,Melaka,0,0,0,Sri Lanka
38340,11/1/2021,LKA,Pahang,0,0,0,Sri Lanka
38341,11/1/2021,LKA,Perak,0,0,0,Sri Lanka
38342,11/1/2021,LKA,Perlis,0,0,0,Sri Lanka
38343,11/1/2021,LKA,Pulau Pinang,0,0,0,Sri Lanka
38344,11/1/2021,LKA,Sabah,0,0,0,Sri Lanka
38345,11/1/2021,LKA,Sarawak,1,1,0,Sri Lanka
38346,11/1/2021,LKA,Selangor,126,76,50,Sri Lanka
38347,11/1/2021,LKA,W.P. Labuan,0,0,0,Sri Lanka
38348,11/1/2021,LSO,Johor,0,0,0,Lesotho
38349,11/1/2021,LSO,Kedah,0,0,0,Lesotho
38350,11/1/2021,LSO,Pulau Pinang,0,0,0,Lesotho
38351,11/1/2021,LSO,Sarawak,0,0,0,Lesotho
38352,11/1/2021,LSO,Selangor,0,0,0,Lesotho
38353,11/1/2021,LTU,Johor,0,0,0,Lithuania
38354,11/1/2021,LTU,Kedah,0,0,0,Lithuania
38355,11/1/2021,LTU,Kelantan,0,0,0,Lithuania
38356,11/1/2021,LTU,Pahang,0,0,0,Lithuania
38357,11/1/2021,LTU,Perak,0,0,0,Lithuania
38358,11/1/2021,LTU,Perlis,0,0,0,Lithuania
38359,11/1/2021,LTU,Pulau Pinang,0,0,0,Lithuania
38360,11/1/2021,LTU,Sabah,0,0,0,Lithuania
38361,11/1/2021,LTU,Sarawak,0,0,0,Lithuania
38362,11/1/2021,LTU,Selangor,3,2,1,Lithuania
38363,11/1/2021,LTU,W.P. Labuan,0,0,0,Lithuania
38364,11/1/2021,LUX,Johor,0,0,0,Luxembourg
38365,11/1/2021,LUX,Kedah,0,0,0,Luxembourg
38366,11/1/2021,LUX,Kelantan,0,0,0,Luxembourg
38367,11/1/2021,LUX,Perak,0,0,0,Luxembourg
38368,11/1/2021,LUX,Perlis,0,0,0,Luxembourg
38369,11/1/2021,LUX,Pulau Pinang,0,0,0,Luxembourg
38370,11/1/2021,LUX,Sabah,0,0,0,Luxembourg
38371,11/1/2021,LUX,Sarawak,0,0,0,Luxembourg
38372,11/1/2021,LUX,Selangor,0,0,0,Luxembourg
38373,11/1/2021,LVA,Johor,0,0,0,Latvia
38374,11/1/2021,LVA,Kedah,0,0,0,Latvia
38375,11/1/2021,LVA,Kelantan,0,0,0,Latvia
38376,11/1/2021,LVA,Pahang,0,0,0,Latvia
38377,11/1/2021,LVA,Perak,0,0,0,Latvia
38378,11/1/2021,LVA,Perlis,0,0,0,Latvia
38379,11/1/2021,LVA,Pulau Pinang,0,0,0,Latvia
38380,11/1/2021,LVA,Sabah,0,0,0,Latvia
38381,11/1/2021,LVA,Sarawak,0,0,0,Latvia
38382,11/1/2021,LVA,Selangor,2,2,0,Latvia
38383,11/1/2021,LVA,W.P. Labuan,0,0,0,Latvia
38384,11/1/2021,MAC,Johor,0,0,0,Macao
38385,11/1/2021,MAC,Pahang,0,0,0,Macao
38386,11/1/2021,MAC,Perak,0,0,0,Macao
38387,11/1/2021,MAC,Selangor,0,0,0,Macao
38388,11/1/2021,MAC,W.P. Labuan,0,0,0,Macao
38389,11/1/2021,MAR,Johor,0,0,0,Morocco
38390,11/1/2021,MAR,Kedah,0,0,0,Morocco
38391,11/1/2021,MAR,Kelantan,0,0,0,Morocco
38392,11/1/2021,MAR,Melaka,0,0,0,Morocco
38393,11/1/2021,MAR,Pahang,0,0,0,Morocco
38394,11/1/2021,MAR,Perak,0,0,0,Morocco
38395,11/1/2021,MAR,Perlis,0,0,0,Morocco
38396,11/1/2021,MAR,Pulau Pinang,0,0,0,Morocco
38397,11/1/2021,MAR,Sabah,0,0,0,Morocco
38398,11/1/2021,MAR,Sarawak,0,0,0,Morocco
38399,11/1/2021,MAR,Selangor,18,9,9,Morocco
38400,11/1/2021,MAR,W.P. Labuan,0,0,0,Morocco
38401,11/1/2021,MCO,Johor,0,0,0,Monaco
38402,11/1/2021,MCO,Kedah,0,0,0,Monaco
38403,11/1/2021,MCO,Sabah,0,0,0,Monaco
38404,11/1/2021,MCO,Selangor,0,0,0,Monaco
38405,11/1/2021,MDA,Johor,0,0,0,"Moldova, Republic of"
38406,11/1/2021,MDA,Kedah,0,0,0,"Moldova, Republic of"
38407,11/1/2021,MDA,Kelantan,0,0,0,"Moldova, Republic of"
38408,11/1/2021,MDA,Negeri Sembilan,0,0,0,"Moldova, Republic of"
38409,11/1/2021,MDA,Perlis,0,0,0,"Moldova, Republic of"
38410,11/1/2021,MDA,Pulau Pinang,0,0,0,"Moldova, Republic of"
38411,11/1/2021,MDA,Sabah,0,0,0,"Moldova, Republic of"
38412,11/1/2021,MDA,Sarawak,0,0,0,"Moldova, Republic of"
38413,11/1/2021,MDA,Selangor,0,0,0,"Moldova, Republic of"
38414,11/1/2021,MDG,Johor,0,0,0,Madagascar
38415,11/1/2021,MDG,Kedah,0,0,0,Madagascar
38416,11/1/2021,MDG,Perak,0,0,0,Madagascar
38417,11/1/2021,MDG,Perlis,0,0,0,Madagascar
38418,11/1/2021,MDG,Pulau Pinang,0,0,0,Madagascar
38419,11/1/2021,MDG,Sabah,0,0,0,Madagascar
38420,11/1/2021,MDG,Sarawak,0,0,0,Madagascar
38421,11/1/2021,MDG,Selangor,1,0,1,Madagascar
38422,11/1/2021,MDV,Johor,0,0,0,Maldives
38423,11/1/2021,MDV,Kedah,0,0,0,Maldives
38424,11/1/2021,MDV,Kelantan,0,0,0,Maldives
38425,11/1/2021,MDV,Perak,0,0,0,Maldives
38426,11/1/2021,MDV,Perlis,0,0,0,Maldives
38427,11/1/2021,MDV,Pulau Pinang,1,1,0,Maldives
38428,11/1/2021,MDV,Sabah,0,0,0,Maldives
38429,11/1/2021,MDV,Sarawak,0,0,0,Maldives
38430,11/1/2021,MDV,Selangor,99,44,55,Maldives
38431,11/1/2021,MEX,Johor,0,0,0,Mexico
38432,11/1/2021,MEX,Kedah,0,0,0,Mexico
38433,11/1/2021,MEX,Kelantan,0,0,0,Mexico
38434,11/1/2021,MEX,Pahang,0,0,0,Mexico
38435,11/1/2021,MEX,Perak,0,0,0,Mexico
38436,11/1/2021,MEX,Perlis,0,0,0,Mexico
38437,11/1/2021,MEX,Pulau Pinang,0,0,0,Mexico
38438,11/1/2021,MEX,Sabah,0,0,0,Mexico
38439,11/1/2021,MEX,Sarawak,0,0,0,Mexico
38440,11/1/2021,MEX,Selangor,7,5,2,Mexico
38441,11/1/2021,MEX,W.P. Labuan,0,0,0,Mexico
38442,11/1/2021,MHL,Johor,0,0,0,Marshall Islands
38443,11/1/2021,MHL,Kedah,0,0,0,Marshall Islands
38444,11/1/2021,MHL,Perak,0,0,0,Marshall Islands
38445,11/1/2021,MHL,Pulau Pinang,0,0,0,Marshall Islands
38446,11/1/2021,MHL,Sabah,0,0,0,Marshall Islands
38447,11/1/2021,MHL,Selangor,0,0,0,Marshall Islands
38448,11/1/2021,MKD,Johor,0,0,0,"Macedonia, the former Yugoslav Republic of"
38449,11/1/2021,MKD,Kedah,0,0,0,"Macedonia, the former Yugoslav Republic of"
38450,11/1/2021,MKD,Perak,0,0,0,"Macedonia, the former Yugoslav Republic of"
38451,11/1/2021,MKD,Pulau Pinang,0,0,0,"Macedonia, the former Yugoslav Republic of"
38452,11/1/2021,MKD,Sabah,0,0,0,"Macedonia, the former Yugoslav Republic of"
38453,11/1/2021,MKD,Sarawak,0,0,0,"Macedonia, the former Yugoslav Republic of"
38454,11/1/2021,MKD,Selangor,1,0,1,"Macedonia, the former Yugoslav Republic of"
38455,11/1/2021,MLI,Johor,0,0,0,Mali
38456,11/1/2021,MLI,Sabah,0,0,0,Mali
38457,11/1/2021,MLI,Selangor,4,4,0,Mali
38458,11/1/2021,MLT,Johor,0,0,0,Malta
38459,11/1/2021,MLT,Kedah,0,0,0,Malta
38460,11/1/2021,MLT,Kelantan,0,0,0,Malta
38461,11/1/2021,MLT,Perak,0,0,0,Malta
38462,11/1/2021,MLT,Perlis,0,0,0,Malta
38463,11/1/2021,MLT,Pulau Pinang,0,0,0,Malta
38464,11/1/2021,MLT,Sabah,0,0,0,Malta
38465,11/1/2021,MLT,Sarawak,0,0,0,Malta
38466,11/1/2021,MLT,Selangor,1,0,1,Malta
38467,11/1/2021,MLT,W.P. Labuan,0,0,0,Malta
38468,11/1/2021,MMR,Johor,2,2,0,Myanmar
38469,11/1/2021,MMR,Kedah,0,0,0,Myanmar
38470,11/1/2021,MMR,Kelantan,0,0,0,Myanmar
38471,11/1/2021,MMR,Negeri Sembilan,0,0,0,Myanmar
38472,11/1/2021,MMR,Pahang,0,0,0,Myanmar
38473,11/1/2021,MMR,Perak,0,0,0,Myanmar
38474,11/1/2021,MMR,Perlis,0,0,0,Myanmar
38475,11/1/2021,MMR,Pulau Pinang,0,0,0,Myanmar
38476,11/1/2021,MMR,Sabah,0,0,0,Myanmar
38477,11/1/2021,MMR,Sarawak,0,0,0,Myanmar
38478,11/1/2021,MMR,Selangor,208,193,15,Myanmar
38479,11/1/2021,MMR,Terengganu,0,0,0,Myanmar
38480,11/1/2021,MMR,W.P. Labuan,0,0,0,Myanmar
38481,11/1/2021,MNE,Johor,0,0,0,Montenegro
38482,11/1/2021,MNE,Kedah,0,0,0,Montenegro
38483,11/1/2021,MNE,Pulau Pinang,0,0,0,Montenegro
38484,11/1/2021,MNE,Sabah,0,0,0,Montenegro
38485,11/1/2021,MNE,Sarawak,0,0,0,Montenegro
38486,11/1/2021,MNE,Selangor,6,6,0,Montenegro
38487,11/1/2021,MNG,Johor,0,0,0,Mongolia
38488,11/1/2021,MNG,Kedah,0,0,0,Mongolia
38489,11/1/2021,MNG,Kelantan,0,0,0,Mongolia
38490,11/1/2021,MNG,Perak,0,0,0,Mongolia
38491,11/1/2021,MNG,Perlis,0,0,0,Mongolia
38492,11/1/2021,MNG,Pulau Pinang,0,0,0,Mongolia
38493,11/1/2021,MNG,Sabah,0,0,0,Mongolia
38494,11/1/2021,MNG,Sarawak,0,0,0,Mongolia
38495,11/1/2021,MNG,Selangor,2,1,1,Mongolia
38496,11/1/2021,MNP,Selangor,0,0,0,Northern Mariana Islands
38497,11/1/2021,MOZ,Johor,0,0,0,Mozambique
38498,11/1/2021,MOZ,Kedah,0,0,0,Mozambique
38499,11/1/2021,MOZ,Perak,0,0,0,Mozambique
38500,11/1/2021,MOZ,Pulau Pinang,0,0,0,Mozambique
38501,11/1/2021,MOZ,Sabah,0,0,0,Mozambique
38502,11/1/2021,MOZ,Sarawak,0,0,0,Mozambique
38503,11/1/2021,MOZ,Selangor,0,0,0,Mozambique
38504,11/1/2021,MRT,Johor,0,0,0,Mauritania
38505,11/1/2021,MRT,Kedah,0,0,0,Mauritania
38506,11/1/2021,MRT,Pulau Pinang,0,0,0,Mauritania
38507,11/1/2021,MRT,Sabah,0,0,0,Mauritania
38508,11/1/2021,MRT,Sarawak,0,0,0,Mauritania
38509,11/1/2021,MRT,Selangor,9,8,1,Mauritania
38510,11/1/2021,MUS,Johor,0,0,0,Mauritius
38511,11/1/2021,MUS,Kedah,0,0,0,Mauritius
38512,11/1/2021,MUS,Kelantan,0,0,0,Mauritius
38513,11/1/2021,MUS,Pahang,0,0,0,Mauritius
38514,11/1/2021,MUS,Perak,0,0,0,Mauritius
38515,11/1/2021,MUS,Perlis,0,0,0,Mauritius
38516,11/1/2021,MUS,Pulau Pinang,0,0,0,Mauritius
38517,11/1/2021,MUS,Sabah,0,0,0,Mauritius
38518,11/1/2021,MUS,Sarawak,0,0,0,Mauritius
38519,11/1/2021,MUS,Selangor,16,9,7,Mauritius
38520,11/1/2021,MWI,Johor,0,0,0,Malawi
38521,11/1/2021,MWI,Pulau Pinang,0,0,0,Malawi
38522,11/1/2021,MWI,Sabah,0,0,0,Malawi
38523,11/1/2021,MWI,Sarawak,0,0,0,Malawi
38524,11/1/2021,MWI,Selangor,4,2,2,Malawi
38525,11/1/2021,MYT,Selangor,0,0,0,Mayotte
38526,11/1/2021,NAM,Johor,0,0,0,Namibia
38527,11/1/2021,NAM,Kedah,0,0,0,Namibia
38528,11/1/2021,NAM,Perak,0,0,0,Namibia
38529,11/1/2021,NAM,Perlis,0,0,0,Namibia
38530,11/1/2021,NAM,Pulau Pinang,0,0,0,Namibia
38531,11/1/2021,NAM,Sabah,0,0,0,Namibia
38532,11/1/2021,NAM,Sarawak,0,0,0,Namibia
38533,11/1/2021,NAM,Selangor,0,0,0,Namibia
38534,11/1/2021,NCL,Selangor,0,0,0,New Caledonia
38535,11/1/2021,NER,Johor,0,0,0,Niger
38536,11/1/2021,NER,Sabah,0,0,0,Niger
38537,11/1/2021,NER,Selangor,1,1,0,Niger
38538,11/1/2021,NGA,Johor,0,0,0,Nigeria
38539,11/1/2021,NGA,Kedah,0,0,0,Nigeria
38540,11/1/2021,NGA,Perlis,0,0,0,Nigeria
38541,11/1/2021,NGA,Pulau Pinang,0,0,0,Nigeria
38542,11/1/2021,NGA,Sabah,1,1,0,Nigeria
38543,11/1/2021,NGA,Sarawak,1,1,0,Nigeria
38544,11/1/2021,NGA,Selangor,95,88,7,Nigeria
38545,11/1/2021,NIC,Johor,0,0,0,Nicaragua
38546,11/1/2021,NIC,Kedah,0,0,0,Nicaragua
38547,11/1/2021,NIC,Pulau Pinang,0,0,0,Nicaragua
38548,11/1/2021,NIC,Sabah,0,0,0,Nicaragua
38549,11/1/2021,NIC,Selangor,0,0,0,Nicaragua
38550,11/1/2021,NLD,Johor,0,0,0,Netherlands
38551,11/1/2021,NLD,Kedah,0,0,0,Netherlands
38552,11/1/2021,NLD,Kelantan,0,0,0,Netherlands
38553,11/1/2021,NLD,Melaka,0,0,0,Netherlands
38554,11/1/2021,NLD,Negeri Sembilan,0,0,0,Netherlands
38555,11/1/2021,NLD,Pahang,0,0,0,Netherlands
38556,11/1/2021,NLD,Perak,0,0,0,Netherlands
38557,11/1/2021,NLD,Perlis,0,0,0,Netherlands
38558,11/1/2021,NLD,Pulau Pinang,5,3,2,Netherlands
38559,11/1/2021,NLD,Sabah,0,0,0,Netherlands
38560,11/1/2021,NLD,Sarawak,0,0,0,Netherlands
38561,11/1/2021,NLD,Selangor,90,67,23,Netherlands
38562,11/1/2021,NLD,Terengganu,0,0,0,Netherlands
38563,11/1/2021,NLD,W.P. Labuan,0,0,0,Netherlands
38564,11/1/2021,NOR,Johor,0,0,0,Norway
38565,11/1/2021,NOR,Kedah,0,0,0,Norway
38566,11/1/2021,NOR,Kelantan,0,0,0,Norway
38567,11/1/2021,NOR,Melaka,0,0,0,Norway
38568,11/1/2021,NOR,Pahang,0,0,0,Norway
38569,11/1/2021,NOR,Perak,0,0,0,Norway
38570,11/1/2021,NOR,Perlis,0,0,0,Norway
38571,11/1/2021,NOR,Pulau Pinang,0,0,0,Norway
38572,11/1/2021,NOR,Sabah,0,0,0,Norway
38573,11/1/2021,NOR,Sarawak,0,0,0,Norway
38574,11/1/2021,NOR,Selangor,28,24,4,Norway
38575,11/1/2021,NOR,W.P. Labuan,0,0,0,Norway
38576,11/1/2021,NPL,Johor,0,0,0,Nepal
38577,11/1/2021,NPL,Kedah,0,0,0,Nepal
38578,11/1/2021,NPL,Pahang,0,0,0,Nepal
38579,11/1/2021,NPL,Perak,0,0,0,Nepal
38580,11/1/2021,NPL,Perlis,0,0,0,Nepal
38581,11/1/2021,NPL,Pulau Pinang,0,0,0,Nepal
38582,11/1/2021,NPL,Sabah,0,0,0,Nepal
38583,11/1/2021,NPL,Sarawak,0,0,0,Nepal
38584,11/1/2021,NPL,Selangor,98,87,11,Nepal
38585,11/1/2021,NPL,W.P. Labuan,0,0,0,Nepal
38586,11/1/2021,NRU,Johor,0,0,0,Nauru
38587,11/1/2021,NRU,Pulau Pinang,0,0,0,Nauru
38588,11/1/2021,NRU,Selangor,0,0,0,Nauru
38589,11/1/2021,NZL,Johor,0,0,0,New Zealand
38590,11/1/2021,NZL,Kedah,0,0,0,New Zealand
38591,11/1/2021,NZL,Kelantan,0,0,0,New Zealand
38592,11/1/2021,NZL,Melaka,0,0,0,New Zealand
38593,11/1/2021,NZL,Negeri Sembilan,0,0,0,New Zealand
38594,11/1/2021,NZL,Pahang,0,0,0,New Zealand
38595,11/1/2021,NZL,Perak,0,0,0,New Zealand
38596,11/1/2021,NZL,Perlis,0,0,0,New Zealand
38597,11/1/2021,NZL,Pulau Pinang,0,0,0,New Zealand
38598,11/1/2021,NZL,Sabah,1,1,0,New Zealand
38599,11/1/2021,NZL,Sarawak,0,0,0,New Zealand
38600,11/1/2021,NZL,Selangor,21,14,7,New Zealand
38601,11/1/2021,NZL,Terengganu,0,0,0,New Zealand
38602,11/1/2021,NZL,W.P. Labuan,0,0,0,New Zealand
38603,11/1/2021,OMN,Johor,0,0,0,Oman
38604,11/1/2021,OMN,Kedah,0,0,0,Oman
38605,11/1/2021,OMN,Kelantan,0,0,0,Oman
38606,11/1/2021,OMN,Melaka,0,0,0,Oman
38607,11/1/2021,OMN,Perak,0,0,0,Oman
38608,11/1/2021,OMN,Perlis,0,0,0,Oman
38609,11/1/2021,OMN,Pulau Pinang,0,0,0,Oman
38610,11/1/2021,OMN,Sabah,0,0,0,Oman
38611,11/1/2021,OMN,Sarawak,0,0,0,Oman
38612,11/1/2021,OMN,Selangor,16,11,5,Oman
38613,11/1/2021,PAK,Johor,1,1,0,Pakistan
38614,11/1/2021,PAK,Kedah,0,0,0,Pakistan
38615,11/1/2021,PAK,Kelantan,0,0,0,Pakistan
38616,11/1/2021,PAK,Melaka,0,0,0,Pakistan
38617,11/1/2021,PAK,Negeri Sembilan,0,0,0,Pakistan
38618,11/1/2021,PAK,Pahang,0,0,0,Pakistan
38619,11/1/2021,PAK,Perak,0,0,0,Pakistan
38620,11/1/2021,PAK,Perlis,0,0,0,Pakistan
38621,11/1/2021,PAK,Pulau Pinang,1,1,0,Pakistan
38622,11/1/2021,PAK,Sabah,1,1,0,Pakistan
38623,11/1/2021,PAK,Sarawak,1,1,0,Pakistan
38624,11/1/2021,PAK,Selangor,939,869,70,Pakistan
38625,11/1/2021,PAK,W.P. Labuan,0,0,0,Pakistan
38626,11/1/2021,PAN,Johor,0,0,0,Panama
38627,11/1/2021,PAN,Kedah,0,0,0,Panama
38628,11/1/2021,PAN,Perak,0,0,0,Panama
38629,11/1/2021,PAN,Perlis,0,0,0,Panama
38630,11/1/2021,PAN,Pulau Pinang,0,0,0,Panama
38631,11/1/2021,PAN,Sabah,0,0,0,Panama
38632,11/1/2021,PAN,Sarawak,0,0,0,Panama
38633,11/1/2021,PAN,Selangor,1,1,0,Panama
38634,11/1/2021,PER,Johor,0,0,0,Peru
38635,11/1/2021,PER,Kedah,0,0,0,Peru
38636,11/1/2021,PER,Kelantan,0,0,0,Peru
38637,11/1/2021,PER,Pahang,0,0,0,Peru
38638,11/1/2021,PER,Perak,0,0,0,Peru
38639,11/1/2021,PER,Perlis,0,0,0,Peru
38640,11/1/2021,PER,Pulau Pinang,0,0,0,Peru
38641,11/1/2021,PER,Sabah,0,0,0,Peru
38642,11/1/2021,PER,Sarawak,0,0,0,Peru
38643,11/1/2021,PER,Selangor,3,3,0,Peru
38644,11/1/2021,PER,W.P. Labuan,0,0,0,Peru
38645,11/1/2021,PHL,Johor,23,21,2,Philippines
38646,11/1/2021,PHL,Kedah,0,0,0,Philippines
38647,11/1/2021,PHL,Kelantan,0,0,0,Philippines
38648,11/1/2021,PHL,Melaka,0,0,0,Philippines
38649,11/1/2021,PHL,Negeri Sembilan,0,0,0,Philippines
38650,11/1/2021,PHL,Pahang,0,0,0,Philippines
38651,11/1/2021,PHL,Perak,0,0,0,Philippines
38652,11/1/2021,PHL,Perlis,0,0,0,Philippines
38653,11/1/2021,PHL,Pulau Pinang,5,4,1,Philippines
38654,11/1/2021,PHL,Sabah,3,1,2,Philippines
38655,11/1/2021,PHL,Sarawak,45,42,3,Philippines
38656,11/1/2021,PHL,Selangor,626,502,124,Philippines
38657,11/1/2021,PHL,Terengganu,0,0,0,Philippines
38658,11/1/2021,PHL,W.P. Labuan,2,2,0,Philippines
38659,11/1/2021,PLW,Johor,0,0,0,Palau
38660,11/1/2021,PLW,Pulau Pinang,0,0,0,Palau
38661,11/1/2021,PLW,Selangor,0,0,0,Palau
38662,11/1/2021,PNG,Johor,0,0,0,Papua New Guinea
38663,11/1/2021,PNG,Kedah,0,0,0,Papua New Guinea
38664,11/1/2021,PNG,Kelantan,0,0,0,Papua New Guinea
38665,11/1/2021,PNG,Perak,0,0,0,Papua New Guinea
38666,11/1/2021,PNG,Pulau Pinang,0,0,0,Papua New Guinea
38667,11/1/2021,PNG,Sabah,0,0,0,Papua New Guinea
38668,11/1/2021,PNG,Sarawak,1,0,1,Papua New Guinea
38669,11/1/2021,PNG,Selangor,1,0,1,Papua New Guinea
38670,11/1/2021,POL,Johor,2,2,0,Poland
38671,11/1/2021,POL,Kedah,0,0,0,Poland
38672,11/1/2021,POL,Kelantan,0,0,0,Poland
38673,11/1/2021,POL,Melaka,0,0,0,Poland
38674,11/1/2021,POL,Negeri Sembilan,0,0,0,Poland
38675,11/1/2021,POL,Pahang,0,0,0,Poland
38676,11/1/2021,POL,Perak,0,0,0,Poland
38677,11/1/2021,POL,Perlis,0,0,0,Poland
38678,11/1/2021,POL,Pulau Pinang,0,0,0,Poland
38679,11/1/2021,POL,Sabah,0,0,0,Poland
38680,11/1/2021,POL,Sarawak,1,1,0,Poland
38681,11/1/2021,POL,Selangor,33,32,1,Poland
38682,11/1/2021,POL,Terengganu,0,0,0,Poland
38683,11/1/2021,POL,W.P. Labuan,0,0,0,Poland
38684,11/1/2021,PRK,Selangor,0,0,0,"Korea, Democratic People's Republic of"
38685,11/1/2021,PRT,Johor,0,0,0,Portugal
38686,11/1/2021,PRT,Kedah,0,0,0,Portugal
38687,11/1/2021,PRT,Kelantan,0,0,0,Portugal
38688,11/1/2021,PRT,Melaka,0,0,0,Portugal
38689,11/1/2021,PRT,Pahang,0,0,0,Portugal
38690,11/1/2021,PRT,Perak,0,0,0,Portugal
38691,11/1/2021,PRT,Perlis,0,0,0,Portugal
38692,11/1/2021,PRT,Pulau Pinang,1,0,1,Portugal
38693,11/1/2021,PRT,Sabah,0,0,0,Portugal
38694,11/1/2021,PRT,Sarawak,0,0,0,Portugal
38695,11/1/2021,PRT,Selangor,15,12,3,Portugal
38696,11/1/2021,PRT,W.P. Labuan,0,0,0,Portugal
38697,11/1/2021,PRY,Johor,0,0,0,Paraguay
38698,11/1/2021,PRY,Kedah,0,0,0,Paraguay
38699,11/1/2021,PRY,Perak,0,0,0,Paraguay
38700,11/1/2021,PRY,Perlis,0,0,0,Paraguay
38701,11/1/2021,PRY,Pulau Pinang,0,0,0,Paraguay
38702,11/1/2021,PRY,Sabah,0,0,0,Paraguay
38703,11/1/2021,PRY,Sarawak,0,0,0,Paraguay
38704,11/1/2021,PRY,Selangor,0,0,0,Paraguay
38705,11/1/2021,PSE,Johor,0,0,0,"Palestinian Territory, Occupied"
38706,11/1/2021,PSE,Kedah,0,0,0,"Palestinian Territory, Occupied"
38707,11/1/2021,PSE,Kelantan,0,0,0,"Palestinian Territory, Occupied"
38708,11/1/2021,PSE,Melaka,0,0,0,"Palestinian Territory, Occupied"
38709,11/1/2021,PSE,Perak,0,0,0,"Palestinian Territory, Occupied"
38710,11/1/2021,PSE,Perlis,0,0,0,"Palestinian Territory, Occupied"
38711,11/1/2021,PSE,Pulau Pinang,0,0,0,"Palestinian Territory, Occupied"
38712,11/1/2021,PSE,Sabah,0,0,0,"Palestinian Territory, Occupied"
38713,11/1/2021,PSE,Sarawak,0,0,0,"Palestinian Territory, Occupied"
38714,11/1/2021,PSE,Selangor,34,24,10,"Palestinian Territory, Occupied"
38715,11/1/2021,QAT,Johor,0,0,0,Qatar
38716,11/1/2021,QAT,Kedah,0,0,0,Qatar
38717,11/1/2021,QAT,Perlis,0,0,0,Qatar
38718,11/1/2021,QAT,Pulau Pinang,0,0,0,Qatar
38719,11/1/2021,QAT,Sabah,0,0,0,Qatar
38720,11/1/2021,QAT,Sarawak,0,0,0,Qatar
38721,11/1/2021,QAT,Selangor,1,1,0,Qatar
38722,11/1/2021,REU,Johor,0,0,0,Reunion
38723,11/1/2021,REU,Sarawak,0,0,0,Reunion
38724,11/1/2021,ROU,Johor,1,1,0,Romania
38725,11/1/2021,ROU,Kedah,0,0,0,Romania
38726,11/1/2021,ROU,Kelantan,0,0,0,Romania
38727,11/1/2021,ROU,Negeri Sembilan,0,0,0,Romania
38728,11/1/2021,ROU,Pahang,0,0,0,Romania
38729,11/1/2021,ROU,Perak,0,0,0,Romania
38730,11/1/2021,ROU,Perlis,0,0,0,Romania
38731,11/1/2021,ROU,Pulau Pinang,0,0,0,Romania
38732,11/1/2021,ROU,Sabah,0,0,0,Romania
38733,11/1/2021,ROU,Sarawak,1,1,0,Romania
38734,11/1/2021,ROU,Selangor,21,18,3,Romania
38735,11/1/2021,ROU,W.P. Labuan,0,0,0,Romania
38736,11/1/2021,RUS,Johor,1,1,0,Russia
38737,11/1/2021,RUS,Kedah,0,0,0,Russia
38738,11/1/2021,RUS,Kelantan,0,0,0,Russia
38739,11/1/2021,RUS,Melaka,0,0,0,Russia
38740,11/1/2021,RUS,Negeri Sembilan,0,0,0,Russia
38741,11/1/2021,RUS,Pahang,0,0,0,Russia
38742,11/1/2021,RUS,Perak,0,0,0,Russia
38743,11/1/2021,RUS,Perlis,0,0,0,Russia
38744,11/1/2021,RUS,Pulau Pinang,0,0,0,Russia
38745,11/1/2021,RUS,Sabah,0,0,0,Russia
38746,11/1/2021,RUS,Sarawak,0,0,0,Russia
38747,11/1/2021,RUS,Selangor,72,47,25,Russia
38748,11/1/2021,RUS,W.P. Labuan,0,0,0,Russia
38749,11/1/2021,RWA,Johor,0,0,0,Rwanda
38750,11/1/2021,RWA,Kedah,0,0,0,Rwanda
38751,11/1/2021,RWA,Pulau Pinang,0,0,0,Rwanda
38752,11/1/2021,RWA,Selangor,2,0,2,Rwanda
38753,11/1/2021,SAU,Johor,0,0,0,Saudi Arabia
38754,11/1/2021,SAU,Kedah,0,0,0,Saudi Arabia
38755,11/1/2021,SAU,Kelantan,0,0,0,Saudi Arabia
38756,11/1/2021,SAU,Melaka,0,0,0,Saudi Arabia
38757,11/1/2021,SAU,Perak,0,0,0,Saudi Arabia
38758,11/1/2021,SAU,Perlis,0,0,0,Saudi Arabia
38759,11/1/2021,SAU,Pulau Pinang,0,0,0,Saudi Arabia
38760,11/1/2021,SAU,Sabah,0,0,0,Saudi Arabia
38761,11/1/2021,SAU,Sarawak,0,0,0,Saudi Arabia
38762,11/1/2021,SAU,Selangor,137,82,55,Saudi Arabia
38763,11/1/2021,SAU,W.P. Labuan,0,0,0,Saudi Arabia
38764,11/1/2021,SDN,Johor,0,0,0,Sudan
38765,11/1/2021,SDN,Kedah,0,0,0,Sudan
38766,11/1/2021,SDN,Kelantan,0,0,0,Sudan
38767,11/1/2021,SDN,Perlis,0,0,0,Sudan
38768,11/1/2021,SDN,Pulau Pinang,0,0,0,Sudan
38769,11/1/2021,SDN,Sabah,0,0,0,Sudan
38770,11/1/2021,SDN,Sarawak,0,0,0,Sudan
38771,11/1/2021,SDN,Selangor,103,77,26,Sudan
38772,11/1/2021,SDN,W.P. Labuan,0,0,0,Sudan
38773,11/1/2021,SEN,Johor,0,0,0,Senegal
38774,11/1/2021,SEN,Kedah,0,0,0,Senegal
38775,11/1/2021,SEN,Kelantan,0,0,0,Senegal
38776,11/1/2021,SEN,Perak,0,0,0,Senegal
38777,11/1/2021,SEN,Perlis,0,0,0,Senegal
38778,11/1/2021,SEN,Pulau Pinang,0,0,0,Senegal
38779,11/1/2021,SEN,Sabah,0,0,0,Senegal
38780,11/1/2021,SEN,Sarawak,0,0,0,Senegal
38781,11/1/2021,SEN,Selangor,3,0,3,Senegal
38782,11/1/2021,SGP,Johor,257,174,83,Singapore
38783,11/1/2021,SGP,Kedah,2,2,0,Singapore
38784,11/1/2021,SGP,Kelantan,0,0,0,Singapore
38785,11/1/2021,SGP,Melaka,0,0,0,Singapore
38786,11/1/2021,SGP,Negeri Sembilan,0,0,0,Singapore
38787,11/1/2021,SGP,Pahang,0,0,0,Singapore
38788,11/1/2021,SGP,Perak,3,1,2,Singapore
38789,11/1/2021,SGP,Perlis,0,0,0,Singapore
38790,11/1/2021,SGP,Pulau Pinang,28,18,10,Singapore
38791,11/1/2021,SGP,Sabah,3,1,2,Singapore
38792,11/1/2021,SGP,Sarawak,17,7,10,Singapore
38793,11/1/2021,SGP,Selangor,726,437,289,Singapore
38794,11/1/2021,SGP,Terengganu,0,0,0,Singapore
38795,11/1/2021,SGP,W.P. Labuan,0,0,0,Singapore
38796,11/1/2021,SGS,Johor,0,0,0,South Georgia and the South Sandwich Islands
38797,11/1/2021,SGS,Sabah,0,0,0,South Georgia and the South Sandwich Islands
38798,11/1/2021,SGS,Selangor,0,0,0,South Georgia and the South Sandwich Islands
38799,11/1/2021,SHN,Sarawak,0,0,0,"Saint Helena, Ascension and Tristan da Cunha"
38800,11/1/2021,SLB,Johor,0,0,0,Solomon Islands
38801,11/1/2021,SLB,Perlis,0,0,0,Solomon Islands
38802,11/1/2021,SLB,Pulau Pinang,0,0,0,Solomon Islands
38803,11/1/2021,SLB,Sabah,0,0,0,Solomon Islands
38804,11/1/2021,SLB,Sarawak,0,0,0,Solomon Islands
38805,11/1/2021,SLB,Selangor,0,0,0,Solomon Islands
38806,11/1/2021,SLB,W.P. Labuan,0,0,0,Solomon Islands
38807,11/1/2021,SLE,Johor,0,0,0,Sierra Leone
38808,11/1/2021,SLE,Kedah,0,0,0,Sierra Leone
38809,11/1/2021,SLE,Perak,0,0,0,Sierra Leone
38810,11/1/2021,SLE,Pulau Pinang,0,0,0,Sierra Leone
38811,11/1/2021,SLE,Sabah,0,0,0,Sierra Leone
38812,11/1/2021,SLE,Selangor,3,2,1,Sierra Leone
38813,11/1/2021,SLV,Johor,0,0,0,El Salvador
38814,11/1/2021,SLV,Kedah,0,0,0,El Salvador
38815,11/1/2021,SLV,Perak,0,0,0,El Salvador
38816,11/1/2021,SLV,Perlis,0,0,0,El Salvador
38817,11/1/2021,SLV,Pulau Pinang,0,0,0,El Salvador
38818,11/1/2021,SLV,Sabah,0,0,0,El Salvador
38819,11/1/2021,SLV,Selangor,0,0,0,El Salvador
38820,11/1/2021,SLV,W.P. Labuan,0,0,0,El Salvador
38821,11/1/2021,SMR,Johor,0,0,0,San Marino
38822,11/1/2021,SMR,Selangor,0,0,0,San Marino
38823,11/1/2021,SOM,Johor,0,0,0,Somalia
38824,11/1/2021,SOM,Kedah,0,0,0,Somalia
38825,11/1/2021,SOM,Kelantan,0,0,0,Somalia
38826,11/1/2021,SOM,Perlis,0,0,0,Somalia
38827,11/1/2021,SOM,Sabah,0,0,0,Somalia
38828,11/1/2021,SOM,Sarawak,0,0,0,Somalia
38829,11/1/2021,SOM,Selangor,43,33,10,Somalia
38830,11/1/2021,SRB,Johor,0,0,0,Serbia
38831,11/1/2021,SRB,Kedah,0,0,0,Serbia
38832,11/1/2021,SRB,Kelantan,0,0,0,Serbia
38833,11/1/2021,SRB,Pahang,0,0,0,Serbia
38834,11/1/2021,SRB,Perak,0,0,0,Serbia
38835,11/1/2021,SRB,Perlis,0,0,0,Serbia
38836,11/1/2021,SRB,Pulau Pinang,0,0,0,Serbia
38837,11/1/2021,SRB,Sabah,0,0,0,Serbia
38838,11/1/2021,SRB,Sarawak,0,0,0,Serbia
38839,11/1/2021,SRB,Selangor,6,4,2,Serbia
38840,11/1/2021,STP,Selangor,0,0,0,Sao Tome and Principe
38841,11/1/2021,SUR,Johor,0,0,0,Suriname
38842,11/1/2021,SUR,Kedah,0,0,0,Suriname
38843,11/1/2021,SUR,Kelantan,0,0,0,Suriname
38844,11/1/2021,SUR,Perak,0,0,0,Suriname
38845,11/1/2021,SUR,Perlis,0,0,0,Suriname
38846,11/1/2021,SUR,Pulau Pinang,0,0,0,Suriname
38847,11/1/2021,SUR,Sabah,0,0,0,Suriname
38848,11/1/2021,SUR,Sarawak,0,0,0,Suriname
38849,11/1/2021,SUR,Selangor,0,0,0,Suriname
38850,11/1/2021,SVK,Johor,0,0,0,Slovakia
38851,11/1/2021,SVK,Kedah,0,0,0,Slovakia
38852,11/1/2021,SVK,Kelantan,0,0,0,Slovakia
38853,11/1/2021,SVK,Negeri Sembilan,0,0,0,Slovakia
38854,11/1/2021,SVK,Pahang,0,0,0,Slovakia
38855,11/1/2021,SVK,Perak,0,0,0,Slovakia
38856,11/1/2021,SVK,Perlis,0,0,0,Slovakia
38857,11/1/2021,SVK,Pulau Pinang,0,0,0,Slovakia
38858,11/1/2021,SVK,Sabah,0,0,0,Slovakia
38859,11/1/2021,SVK,Sarawak,0,0,0,Slovakia
38860,11/1/2021,SVK,Selangor,20,18,2,Slovakia
38861,11/1/2021,SVK,W.P. Labuan,0,0,0,Slovakia
38862,11/1/2021,SVN,Johor,0,0,0,Slovenia
38863,11/1/2021,SVN,Kedah,0,0,0,Slovenia
38864,11/1/2021,SVN,Kelantan,0,0,0,Slovenia
38865,11/1/2021,SVN,Perak,0,0,0,Slovenia
38866,11/1/2021,SVN,Perlis,0,0,0,Slovenia
38867,11/1/2021,SVN,Pulau Pinang,0,0,0,Slovenia
38868,11/1/2021,SVN,Sabah,0,0,0,Slovenia
38869,11/1/2021,SVN,Sarawak,0,0,0,Slovenia
38870,11/1/2021,SVN,Selangor,2,1,1,Slovenia
38871,11/1/2021,SVN,W.P. Labuan,0,0,0,Slovenia
38872,11/1/2021,SWE,Johor,0,0,0,Sweden
38873,11/1/2021,SWE,Kedah,0,0,0,Sweden
38874,11/1/2021,SWE,Kelantan,0,0,0,Sweden
38875,11/1/2021,SWE,Melaka,0,0,0,Sweden
38876,11/1/2021,SWE,Negeri Sembilan,0,0,0,Sweden
38877,11/1/2021,SWE,Pahang,0,0,0,Sweden
38878,11/1/2021,SWE,Perak,0,0,0,Sweden
38879,11/1/2021,SWE,Perlis,0,0,0,Sweden
38880,11/1/2021,SWE,Pulau Pinang,2,2,0,Sweden
38881,11/1/2021,SWE,Sabah,0,0,0,Sweden
38882,11/1/2021,SWE,Sarawak,0,0,0,Sweden
38883,11/1/2021,SWE,Selangor,27,26,1,Sweden
38884,11/1/2021,SWE,W.P. Labuan,0,0,0,Sweden
38885,11/1/2021,SWZ,Johor,0,0,0,Swaziland
38886,11/1/2021,SWZ,Kedah,0,0,0,Swaziland
38887,11/1/2021,SWZ,Pulau Pinang,0,0,0,Swaziland
38888,11/1/2021,SWZ,Sabah,0,0,0,Swaziland
38889,11/1/2021,SWZ,Selangor,0,0,0,Swaziland
38890,11/1/2021,SYC,Johor,0,0,0,Seychelles
38891,11/1/2021,SYC,Kedah,0,0,0,Seychelles
38892,11/1/2021,SYC,Pulau Pinang,0,0,0,Seychelles
38893,11/1/2021,SYC,Sabah,0,0,0,Seychelles
38894,11/1/2021,SYC,Sarawak,0,0,0,Seychelles
38895,11/1/2021,SYC,Selangor,15,8,7,Seychelles
38896,11/1/2021,SYR,Johor,0,0,0,Syrian Arab Republic
38897,11/1/2021,SYR,Kedah,0,0,0,Syrian Arab Republic
38898,11/1/2021,SYR,Kelantan,0,0,0,Syrian Arab Republic
38899,11/1/2021,SYR,Pahang,0,0,0,Syrian Arab Republic
38900,11/1/2021,SYR,Perlis,0,0,0,Syrian Arab Republic
38901,11/1/2021,SYR,Pulau Pinang,0,0,0,Syrian Arab Republic
38902,11/1/2021,SYR,Sabah,0,0,0,Syrian Arab Republic
38903,11/1/2021,SYR,Sarawak,1,1,0,Syrian Arab Republic
38904,11/1/2021,SYR,Selangor,46,34,12,Syrian Arab Republic
38905,11/1/2021,SYR,W.P. Labuan,0,0,0,Syrian Arab Republic
38906,11/1/2021,TCA,Perlis,0,0,0,Turks and Caicos
38907,11/1/2021,TCD,Johor,0,0,0,Chad
38908,11/1/2021,TCD,Kedah,0,0,0,Chad
38909,11/1/2021,TCD,Perlis,0,0,0,Chad
38910,11/1/2021,TCD,Selangor,2,2,0,Chad
38911,11/1/2021,TGO,Johor,0,0,0,Togo
38912,11/1/2021,TGO,Perak,0,0,0,Togo
38913,11/1/2021,TGO,Pulau Pinang,0,0,0,Togo
38914,11/1/2021,TGO,Selangor,3,3,0,Togo
38915,11/1/2021,THA,Johor,34,33,1,Thailand
38916,11/1/2021,THA,Kedah,18311,18250,61,Thailand
38917,11/1/2021,THA,Kelantan,4,0,4,Thailand
38918,11/1/2021,THA,Melaka,0,0,0,Thailand
38919,11/1/2021,THA,Negeri Sembilan,0,0,0,Thailand
38920,11/1/2021,THA,Pahang,0,0,0,Thailand
38921,11/1/2021,THA,Perak,0,0,0,Thailand
38922,11/1/2021,THA,Perlis,7400,7287,113,Thailand
38923,11/1/2021,THA,Pulau Pinang,20,13,7,Thailand
38924,11/1/2021,THA,Sabah,0,0,0,Thailand
38925,11/1/2021,THA,Sarawak,9,8,1,Thailand
38926,11/1/2021,THA,Selangor,173,80,93,Thailand
38927,11/1/2021,THA,Terengganu,0,0,0,Thailand
38928,11/1/2021,THA,W.P. Labuan,0,0,0,Thailand
38929,11/1/2021,TJK,Johor,0,0,0,Tajikistan
38930,11/1/2021,TJK,Kedah,0,0,0,Tajikistan
38931,11/1/2021,TJK,Perlis,0,0,0,Tajikistan
38932,11/1/2021,TJK,Pulau Pinang,0,0,0,Tajikistan
38933,11/1/2021,TJK,Sabah,0,0,0,Tajikistan
38934,11/1/2021,TJK,Selangor,5,3,2,Tajikistan
38935,11/1/2021,TKL,Selangor,0,0,0,Tokelau
38936,11/1/2021,TKM,Johor,0,0,0,Turkmenistan
38937,11/1/2021,TKM,Kedah,0,0,0,Turkmenistan
38938,11/1/2021,TKM,Kelantan,0,0,0,Turkmenistan
38939,11/1/2021,TKM,Perlis,0,0,0,Turkmenistan
38940,11/1/2021,TKM,Pulau Pinang,0,0,0,Turkmenistan
38941,11/1/2021,TKM,Sabah,0,0,0,Turkmenistan
38942,11/1/2021,TKM,Sarawak,0,0,0,Turkmenistan
38943,11/1/2021,TKM,Selangor,7,3,4,Turkmenistan
38944,11/1/2021,TLS,Johor,0,0,0,Timor-Leste
38945,11/1/2021,TLS,Kedah,0,0,0,Timor-Leste
38946,11/1/2021,TLS,Perlis,0,0,0,Timor-Leste
38947,11/1/2021,TLS,Pulau Pinang,0,0,0,Timor-Leste
38948,11/1/2021,TLS,Sabah,0,0,0,Timor-Leste
38949,11/1/2021,TLS,Sarawak,0,0,0,Timor-Leste
38950,11/1/2021,TLS,Selangor,3,1,2,Timor-Leste
38951,11/1/2021,TON,Johor,0,0,0,Tonga
38952,11/1/2021,TON,Pulau Pinang,0,0,0,Tonga
38953,11/1/2021,TON,Sarawak,0,0,0,Tonga
38954,11/1/2021,TON,Selangor,0,0,0,Tonga
38955,11/1/2021,TTO,Johor,0,0,0,Trinidad and Tobago
38956,11/1/2021,TTO,Kedah,0,0,0,Trinidad and Tobago
38957,11/1/2021,TTO,Pahang,0,0,0,Trinidad and Tobago
38958,11/1/2021,TTO,Pulau Pinang,0,0,0,Trinidad and Tobago
38959,11/1/2021,TTO,Sabah,0,0,0,Trinidad and Tobago
38960,11/1/2021,TTO,Sarawak,0,0,0,Trinidad and Tobago
38961,11/1/2021,TTO,Selangor,3,2,1,Trinidad and Tobago
38962,11/1/2021,TUN,Johor,0,0,0,Tunisia
38963,11/1/2021,TUN,Kedah,0,0,0,Tunisia
38964,11/1/2021,TUN,Kelantan,0,0,0,Tunisia
38965,11/1/2021,TUN,Melaka,0,0,0,Tunisia
38966,11/1/2021,TUN,Perak,0,0,0,Tunisia
38967,11/1/2021,TUN,Perlis,0,0,0,Tunisia
38968,11/1/2021,TUN,Pulau Pinang,0,0,0,Tunisia
38969,11/1/2021,TUN,Sabah,0,0,0,Tunisia
38970,11/1/2021,TUN,Sarawak,0,0,0,Tunisia
38971,11/1/2021,TUN,Selangor,12,6,6,Tunisia
38972,11/1/2021,TUN,W.P. Labuan,0,0,0,Tunisia
38973,11/1/2021,TUR,Johor,0,0,0,Turkey
38974,11/1/2021,TUR,Kedah,0,0,0,Turkey
38975,11/1/2021,TUR,Kelantan,0,0,0,Turkey
38976,11/1/2021,TUR,Melaka,0,0,0,Turkey
38977,11/1/2021,TUR,Negeri Sembilan,0,0,0,Turkey
38978,11/1/2021,TUR,Pahang,0,0,0,Turkey
38979,11/1/2021,TUR,Perak,0,0,0,Turkey
38980,11/1/2021,TUR,Perlis,0,0,0,Turkey
38981,11/1/2021,TUR,Pulau Pinang,0,0,0,Turkey
38982,11/1/2021,TUR,Sabah,0,0,0,Turkey
38983,11/1/2021,TUR,Sarawak,1,1,0,Turkey
38984,11/1/2021,TUR,Selangor,53,41,12,Turkey
38985,11/1/2021,TUR,W.P. Labuan,0,0,0,Turkey
38986,11/1/2021,TUV,Selangor,0,0,0,Tuvalu
38987,11/1/2021,TWN,Johor,2,0,2,Taiwan
38988,11/1/2021,TWN,Kedah,0,0,0,Taiwan
38989,11/1/2021,TWN,Kelantan,0,0,0,Taiwan
38990,11/1/2021,TWN,Melaka,0,0,0,Taiwan
38991,11/1/2021,TWN,Negeri Sembilan,0,0,0,Taiwan
38992,11/1/2021,TWN,Pahang,0,0,0,Taiwan
38993,11/1/2021,TWN,Perak,0,0,0,Taiwan
38994,11/1/2021,TWN,Perlis,0,0,0,Taiwan
38995,11/1/2021,TWN,Pulau Pinang,25,17,8,Taiwan
38996,11/1/2021,TWN,Sabah,0,0,0,Taiwan
38997,11/1/2021,TWN,Sarawak,2,1,1,Taiwan
38998,11/1/2021,TWN,Selangor,94,56,38,Taiwan
38999,11/1/2021,TWN,W.P. Labuan,0,0,0,Taiwan
39000,11/1/2021,TZA,Johor,0,0,0,"Tanzania, United Republic of"
39001,11/1/2021,TZA,Kedah,0,0,0,"Tanzania, United Republic of"
39002,11/1/2021,TZA,Perak,0,0,0,"Tanzania, United Republic of"
39003,11/1/2021,TZA,Perlis,0,0,0,"Tanzania, United Republic of"
39004,11/1/2021,TZA,Pulau Pinang,0,0,0,"Tanzania, United Republic of"
39005,11/1/2021,TZA,Sabah,0,0,0,"Tanzania, United Republic of"
39006,11/1/2021,TZA,Sarawak,0,0,0,"Tanzania, United Republic of"
39007,11/1/2021,TZA,Selangor,26,20,6,"Tanzania, United Republic of"
39008,11/1/2021,UGA,Johor,0,0,0,Uganda
39009,11/1/2021,UGA,Kedah,0,0,0,Uganda
39010,11/1/2021,UGA,Perak,0,0,0,Uganda
39011,11/1/2021,UGA,Perlis,0,0,0,Uganda
39012,11/1/2021,UGA,Pulau Pinang,0,0,0,Uganda
39013,11/1/2021,UGA,Sabah,0,0,0,Uganda
39014,11/1/2021,UGA,Sarawak,0,0,0,Uganda
39015,11/1/2021,UGA,Selangor,3,3,0,Uganda
39016,11/1/2021,UKR,Johor,4,3,1,Ukraine
39017,11/1/2021,UKR,Kedah,0,0,0,Ukraine
39018,11/1/2021,UKR,Kelantan,0,0,0,Ukraine
39019,11/1/2021,UKR,Melaka,3,3,0,Ukraine
39020,11/1/2021,UKR,Negeri Sembilan,0,0,0,Ukraine
39021,11/1/2021,UKR,Pahang,0,0,0,Ukraine
39022,11/1/2021,UKR,Perak,0,0,0,Ukraine
39023,11/1/2021,UKR,Perlis,0,0,0,Ukraine
39024,11/1/2021,UKR,Pulau Pinang,0,0,0,Ukraine
39025,11/1/2021,UKR,Sabah,0,0,0,Ukraine
39026,11/1/2021,UKR,Sarawak,0,0,0,Ukraine
39027,11/1/2021,UKR,Selangor,40,33,7,Ukraine
39028,11/1/2021,UKR,W.P. Labuan,0,0,0,Ukraine
39029,11/1/2021,URY,Johor,0,0,0,Uruguay
39030,11/1/2021,URY,Kedah,0,0,0,Uruguay
39031,11/1/2021,URY,Kelantan,0,0,0,Uruguay
39032,11/1/2021,URY,Perak,0,0,0,Uruguay
39033,11/1/2021,URY,Perlis,0,0,0,Uruguay
39034,11/1/2021,URY,Pulau Pinang,0,0,0,Uruguay
39035,11/1/2021,URY,Sabah,0,0,0,Uruguay
39036,11/1/2021,URY,Sarawak,0,0,0,Uruguay
39037,11/1/2021,URY,Selangor,0,0,0,Uruguay
39038,11/1/2021,URY,W.P. Labuan,0,0,0,Uruguay
39039,11/1/2021,USA,Johor,3,1,2,United States Of America
39040,11/1/2021,USA,Kedah,0,0,0,United States Of America
39041,11/1/2021,USA,Kelantan,0,0,0,United States Of America
39042,11/1/2021,USA,Melaka,0,0,0,United States Of America
39043,11/1/2021,USA,Negeri Sembilan,0,0,0,United States Of America
39044,11/1/2021,USA,Pahang,0,0,0,United States Of America
39045,11/1/2021,USA,Perak,1,1,0,United States Of America
39046,11/1/2021,USA,Perlis,0,0,0,United States Of America
39047,11/1/2021,USA,Pulau Pinang,55,46,9,United States Of America
39048,11/1/2021,USA,Sabah,0,0,0,United States Of America
39049,11/1/2021,USA,Sarawak,2,1,1,United States Of America
39050,11/1/2021,USA,Selangor,274,180,94,United States Of America
39051,11/1/2021,USA,Terengganu,0,0,0,United States Of America
39052,11/1/2021,USA,W.P. Labuan,0,0,0,United States Of America
39053,11/1/2021,UZB,Johor,0,0,0,Uzbekistan
39054,11/1/2021,UZB,Kedah,0,0,0,Uzbekistan
39055,11/1/2021,UZB,Kelantan,0,0,0,Uzbekistan
39056,11/1/2021,UZB,Perak,0,0,0,Uzbekistan
39057,11/1/2021,UZB,Perlis,0,0,0,Uzbekistan
39058,11/1/2021,UZB,Pulau Pinang,0,0,0,Uzbekistan
39059,11/1/2021,UZB,Sabah,0,0,0,Uzbekistan
39060,11/1/2021,UZB,Sarawak,0,0,0,Uzbekistan
39061,11/1/2021,UZB,Selangor,17,11,6,Uzbekistan
39062,11/1/2021,VAT,Johor,0,0,0,Holy See (Vatican City State)
39063,11/1/2021,VAT,Sarawak,0,0,0,Holy See (Vatican City State)
39064,11/1/2021,VAT,Selangor,0,0,0,Holy See (Vatican City State)
39065,11/1/2021,VCT,Johor,0,0,0,Saint Vincent and the Grenadines
39066,11/1/2021,VCT,Kedah,0,0,0,Saint Vincent and the Grenadines
39067,11/1/2021,VCT,Pulau Pinang,0,0,0,Saint Vincent and the Grenadines
39068,11/1/2021,VCT,Sarawak,0,0,0,Saint Vincent and the Grenadines
39069,11/1/2021,VCT,Selangor,0,0,0,Saint Vincent and the Grenadines
39070,11/1/2021,VEN,Johor,0,0,0,Venezuela
39071,11/1/2021,VEN,Kedah,0,0,0,Venezuela
39072,11/1/2021,VEN,Kelantan,0,0,0,Venezuela
39073,11/1/2021,VEN,Melaka,0,0,0,Venezuela
39074,11/1/2021,VEN,Perak,0,0,0,Venezuela
39075,11/1/2021,VEN,Perlis,0,0,0,Venezuela
39076,11/1/2021,VEN,Pulau Pinang,0,0,0,Venezuela
39077,11/1/2021,VEN,Sabah,0,0,0,Venezuela
39078,11/1/2021,VEN,Sarawak,0,0,0,Venezuela
39079,11/1/2021,VEN,Selangor,3,2,1,Venezuela
39080,11/1/2021,VEN,W.P. Labuan,0,0,0,Venezuela
39081,11/1/2021,VNM,Johor,5,4,1,Vietnam
39082,11/1/2021,VNM,Kedah,0,0,0,Vietnam
39083,11/1/2021,VNM,Kelantan,0,0,0,Vietnam
39084,11/1/2021,VNM,Melaka,0,0,0,Vietnam
39085,11/1/2021,VNM,Negeri Sembilan,0,0,0,Vietnam
39086,11/1/2021,VNM,Pahang,0,0,0,Vietnam
39087,11/1/2021,VNM,Perak,0,0,0,Vietnam
39088,11/1/2021,VNM,Perlis,0,0,0,Vietnam
39089,11/1/2021,VNM,Pulau Pinang,3,1,2,Vietnam
39090,11/1/2021,VNM,Sabah,0,0,0,Vietnam
39091,11/1/2021,VNM,Sarawak,0,0,0,Vietnam
39092,11/1/2021,VNM,Selangor,126,46,80,Vietnam
39093,11/1/2021,VNM,Terengganu,0,0,0,Vietnam
39094,11/1/2021,VNM,W.P. Labuan,0,0,0,Vietnam
39095,11/1/2021,VUT,Johor,0,0,0,Vanuatu
39096,11/1/2021,VUT,Kedah,0,0,0,Vanuatu
39097,11/1/2021,VUT,Pulau Pinang,0,0,0,Vanuatu
39098,11/1/2021,VUT,Sabah,0,0,0,Vanuatu
39099,11/1/2021,VUT,Sarawak,0,0,0,Vanuatu
39100,11/1/2021,VUT,Selangor,0,0,0,Vanuatu
39101,11/1/2021,WSM,Johor,0,0,0,Samoa
39102,11/1/2021,WSM,Sarawak,0,0,0,Samoa
39103,11/1/2021,WSM,Selangor,0,0,0,Samoa
39104,11/1/2021,YEM,Johor,0,0,0,Yemen
39105,11/1/2021,YEM,Kedah,0,0,0,Yemen
39106,11/1/2021,YEM,Kelantan,0,0,0,Yemen
39107,11/1/2021,YEM,Melaka,0,0,0,Yemen
39108,11/1/2021,YEM,Pahang,0,0,0,Yemen
39109,11/1/2021,YEM,Perak,0,0,0,Yemen
39110,11/1/2021,YEM,Perlis,0,0,0,Yemen
39111,11/1/2021,YEM,Pulau Pinang,0,0,0,Yemen
39112,11/1/2021,YEM,Sabah,0,0,0,Yemen
39113,11/1/2021,YEM,Sarawak,0,0,0,Yemen
39114,11/1/2021,YEM,Selangor,190,150,40,Yemen
39115,11/1/2021,YEM,W.P. Labuan,0,0,0,Yemen
39116,11/1/2021,ZAF,Johor,0,0,0,South Africa
39117,11/1/2021,ZAF,Kedah,0,0,0,South Africa
39118,11/1/2021,ZAF,Kelantan,0,0,0,South Africa
39119,11/1/2021,ZAF,Melaka,0,0,0,South Africa
39120,11/1/2021,ZAF,Pahang,0,0,0,South Africa
39121,11/1/2021,ZAF,Perak,0,0,0,South Africa
39122,11/1/2021,ZAF,Perlis,0,0,0,South Africa
39123,11/1/2021,ZAF,Pulau Pinang,3,1,2,South Africa
39124,11/1/2021,ZAF,Sabah,1,1,0,South Africa
39125,11/1/2021,ZAF,Sarawak,0,0,0,South Africa
39126,11/1/2021,ZAF,Selangor,40,30,10,South Africa
39127,11/1/2021,ZAF,Terengganu,0,0,0,South Africa
39128,11/1/2021,ZAF,W.P. Labuan,0,0,0,South Africa
39129,11/1/2021,ZMB,Johor,0,0,0,Zambia
39130,11/1/2021,ZMB,Kedah,0,0,0,Zambia
39131,11/1/2021,ZMB,Perak,0,0,0,Zambia
39132,11/1/2021,ZMB,Perlis,0,0,0,Zambia
39133,11/1/2021,ZMB,Pulau Pinang,0,0,0,Zambia
39134,11/1/2021,ZMB,Sabah,0,0,0,Zambia
39135,11/1/2021,ZMB,Sarawak,0,0,0,Zambia
39136,11/1/2021,ZMB,Selangor,6,3,3,Zambia
39137,11/1/2021,ZWE,Johor,0,0,0,Zimbabwe
39138,11/1/2021,ZWE,Kedah,0,0,0,Zimbabwe
39139,11/1/2021,ZWE,Kelantan,0,0,0,Zimbabwe
39140,11/1/2021,ZWE,Perak,0,0,0,Zimbabwe
39141,11/1/2021,ZWE,Perlis,0,0,0,Zimbabwe
39142,11/1/2021,ZWE,Pulau Pinang,0,0,0,Zimbabwe
39143,11/1/2021,ZWE,Sabah,0,0,0,Zimbabwe
39144,11/1/2021,ZWE,Sarawak,0,0,0,Zimbabwe
39145,11/1/2021,ZWE,Selangor,13,6,7,Zimbabwe
39146,12/1/2021,ABW,Kedah,0,0,0,Aruba
39147,12/1/2021,ABW,Pulau Pinang,0,0,0,Aruba
39148,12/1/2021,AFG,Johor,0,0,0,Afghanistan
39149,12/1/2021,AFG,Kedah,0,0,0,Afghanistan
39150,12/1/2021,AFG,Perlis,0,0,0,Afghanistan
39151,12/1/2021,AFG,Pulau Pinang,0,0,0,Afghanistan
39152,12/1/2021,AFG,Sarawak,0,0,0,Afghanistan
39153,12/1/2021,AFG,Selangor,68,44,24,Afghanistan
39154,12/1/2021,AGO,Johor,0,0,0,Angola
39155,12/1/2021,AGO,Kedah,0,0,0,Angola
39156,12/1/2021,AGO,Sabah,0,0,0,Angola
39157,12/1/2021,AGO,Selangor,0,0,0,Angola
39158,12/1/2021,AIA,Selangor,0,0,0,Anguilla
39159,12/1/2021,ALB,Johor,0,0,0,Albania
39160,12/1/2021,ALB,Kedah,0,0,0,Albania
39161,12/1/2021,ALB,Perak,0,0,0,Albania
39162,12/1/2021,ALB,Perlis,0,0,0,Albania
39163,12/1/2021,ALB,Pulau Pinang,0,0,0,Albania
39164,12/1/2021,ALB,Sabah,0,0,0,Albania
39165,12/1/2021,ALB,Sarawak,0,0,0,Albania
39166,12/1/2021,ALB,Selangor,5,4,1,Albania
39167,12/1/2021,AND,Johor,0,0,0,Andorra
39168,12/1/2021,AND,Kedah,0,0,0,Andorra
39169,12/1/2021,AND,Perlis,0,0,0,Andorra
39170,12/1/2021,AND,Pulau Pinang,0,0,0,Andorra
39171,12/1/2021,AND,Selangor,0,0,0,Andorra
39172,12/1/2021,ANT,Selangor,0,0,0,Netherlands Antilles
39173,12/1/2021,ARE,Johor,0,0,0,United Arab Emirates
39174,12/1/2021,ARE,Kedah,0,0,0,United Arab Emirates
39175,12/1/2021,ARE,Kelantan,0,0,0,United Arab Emirates
39176,12/1/2021,ARE,Perak,0,0,0,United Arab Emirates
39177,12/1/2021,ARE,Perlis,0,0,0,United Arab Emirates
39178,12/1/2021,ARE,Pulau Pinang,0,0,0,United Arab Emirates
39179,12/1/2021,ARE,Sabah,0,0,0,United Arab Emirates
39180,12/1/2021,ARE,Sarawak,0,0,0,United Arab Emirates
39181,12/1/2021,ARE,Selangor,21,15,6,United Arab Emirates
39182,12/1/2021,ARG,Johor,0,0,0,Argentina
39183,12/1/2021,ARG,Kedah,0,0,0,Argentina
39184,12/1/2021,ARG,Kelantan,0,0,0,Argentina
39185,12/1/2021,ARG,Melaka,0,0,0,Argentina
39186,12/1/2021,ARG,Perak,0,0,0,Argentina
39187,12/1/2021,ARG,Perlis,0,0,0,Argentina
39188,12/1/2021,ARG,Pulau Pinang,0,0,0,Argentina
39189,12/1/2021,ARG,Sabah,0,0,0,Argentina
39190,12/1/2021,ARG,Sarawak,0,0,0,Argentina
39191,12/1/2021,ARG,Selangor,11,5,6,Argentina
39192,12/1/2021,ARG,W.P. Labuan,0,0,0,Argentina
39193,12/1/2021,ARM,Johor,0,0,0,Armenia
39194,12/1/2021,ARM,Kedah,0,0,0,Armenia
39195,12/1/2021,ARM,Kelantan,0,0,0,Armenia
39196,12/1/2021,ARM,Perak,0,0,0,Armenia
39197,12/1/2021,ARM,Perlis,0,0,0,Armenia
39198,12/1/2021,ARM,Pulau Pinang,0,0,0,Armenia
39199,12/1/2021,ARM,Sabah,0,0,0,Armenia
39200,12/1/2021,ARM,Sarawak,0,0,0,Armenia
39201,12/1/2021,ARM,Selangor,1,0,1,Armenia
39202,12/1/2021,ATA,Selangor,0,0,0,Antarctica
39203,12/1/2021,ATG,Johor,0,0,0,Antigua and Barbuda
39204,12/1/2021,ATG,Kedah,0,0,0,Antigua and Barbuda
39205,12/1/2021,ATG,Pulau Pinang,0,0,0,Antigua and Barbuda
39206,12/1/2021,ATG,Sarawak,0,0,0,Antigua and Barbuda
39207,12/1/2021,ATG,Selangor,1,1,0,Antigua and Barbuda
39208,12/1/2021,AUS,Johor,2,1,1,Australia
39209,12/1/2021,AUS,Kedah,20,12,8,Australia
39210,12/1/2021,AUS,Kelantan,0,0,0,Australia
39211,12/1/2021,AUS,Melaka,0,0,0,Australia
39212,12/1/2021,AUS,Negeri Sembilan,0,0,0,Australia
39213,12/1/2021,AUS,Pahang,0,0,0,Australia
39214,12/1/2021,AUS,Perak,1,1,0,Australia
39215,12/1/2021,AUS,Perlis,0,0,0,Australia
39216,12/1/2021,AUS,Pulau Pinang,23,12,11,Australia
39217,12/1/2021,AUS,Sabah,0,0,0,Australia
39218,12/1/2021,AUS,Sarawak,2,2,0,Australia
39219,12/1/2021,AUS,Selangor,580,378,202,Australia
39220,12/1/2021,AUS,Terengganu,0,0,0,Australia
39221,12/1/2021,AUS,W.P. Labuan,0,0,0,Australia
39222,12/1/2021,AUT,Johor,0,0,0,Austria
39223,12/1/2021,AUT,Kedah,0,0,0,Austria
39224,12/1/2021,AUT,Kelantan,0,0,0,Austria
39225,12/1/2021,AUT,Melaka,0,0,0,Austria
39226,12/1/2021,AUT,Negeri Sembilan,0,0,0,Austria
39227,12/1/2021,AUT,Pahang,0,0,0,Austria
39228,12/1/2021,AUT,Perak,0,0,0,Austria
39229,12/1/2021,AUT,Perlis,0,0,0,Austria
39230,12/1/2021,AUT,Pulau Pinang,0,0,0,Austria
39231,12/1/2021,AUT,Sabah,0,0,0,Austria
39232,12/1/2021,AUT,Sarawak,0,0,0,Austria
39233,12/1/2021,AUT,Selangor,21,15,6,Austria
39234,12/1/2021,AUT,Terengganu,0,0,0,Austria
39235,12/1/2021,AUT,W.P. Labuan,0,0,0,Austria
39236,12/1/2021,AZE,Johor,0,0,0,Azerbaijan
39237,12/1/2021,AZE,Kedah,0,0,0,Azerbaijan
39238,12/1/2021,AZE,Kelantan,0,0,0,Azerbaijan
39239,12/1/2021,AZE,Melaka,0,0,0,Azerbaijan
39240,12/1/2021,AZE,Perlis,0,0,0,Azerbaijan
39241,12/1/2021,AZE,Pulau Pinang,0,0,0,Azerbaijan
39242,12/1/2021,AZE,Sabah,0,0,0,Azerbaijan
39243,12/1/2021,AZE,Sarawak,0,0,0,Azerbaijan
39244,12/1/2021,AZE,Selangor,1,1,0,Azerbaijan
39245,12/1/2021,AZE,W.P. Labuan,0,0,0,Azerbaijan
39246,12/1/2021,BDI,Pulau Pinang,0,0,0,Burundi
39247,12/1/2021,BDI,Sarawak,0,0,0,Burundi
39248,12/1/2021,BDI,Selangor,0,0,0,Burundi
39249,12/1/2021,BEL,Johor,0,0,0,Belgium
39250,12/1/2021,BEL,Kedah,1,1,0,Belgium
39251,12/1/2021,BEL,Kelantan,0,0,0,Belgium
39252,12/1/2021,BEL,Melaka,0,0,0,Belgium
39253,12/1/2021,BEL,Negeri Sembilan,0,0,0,Belgium
39254,12/1/2021,BEL,Pahang,0,0,0,Belgium
39255,12/1/2021,BEL,Perak,0,0,0,Belgium
39256,12/1/2021,BEL,Perlis,0,0,0,Belgium
39257,12/1/2021,BEL,Pulau Pinang,2,1,1,Belgium
39258,12/1/2021,BEL,Sabah,0,0,0,Belgium
39259,12/1/2021,BEL,Sarawak,1,1,0,Belgium
39260,12/1/2021,BEL,Selangor,56,47,9,Belgium
39261,12/1/2021,BEL,W.P. Labuan,0,0,0,Belgium
39262,12/1/2021,BEN,Johor,0,0,0,Benin
39263,12/1/2021,BEN,Kedah,0,0,0,Benin
39264,12/1/2021,BEN,Perak,0,0,0,Benin
39265,12/1/2021,BEN,Pulau Pinang,0,0,0,Benin
39266,12/1/2021,BEN,Sabah,0,0,0,Benin
39267,12/1/2021,BEN,Sarawak,0,0,0,Benin
39268,12/1/2021,BEN,Selangor,1,1,0,Benin
39269,12/1/2021,BFA,Perak,0,0,0,Burkina Faso
39270,12/1/2021,BFA,Pulau Pinang,0,0,0,Burkina Faso
39271,12/1/2021,BFA,Selangor,0,0,0,Burkina Faso
39272,12/1/2021,BGD,Johor,3,3,0,Bangladesh
39273,12/1/2021,BGD,Kedah,0,0,0,Bangladesh
39274,12/1/2021,BGD,Kelantan,0,0,0,Bangladesh
39275,12/1/2021,BGD,Melaka,0,0,0,Bangladesh
39276,12/1/2021,BGD,Negeri Sembilan,0,0,0,Bangladesh
39277,12/1/2021,BGD,Pahang,0,0,0,Bangladesh
39278,12/1/2021,BGD,Perak,0,0,0,Bangladesh
39279,12/1/2021,BGD,Perlis,0,0,0,Bangladesh
39280,12/1/2021,BGD,Pulau Pinang,0,0,0,Bangladesh
39281,12/1/2021,BGD,Sabah,0,0,0,Bangladesh
39282,12/1/2021,BGD,Sarawak,0,0,0,Bangladesh
39283,12/1/2021,BGD,Selangor,5749,5372,377,Bangladesh
39284,12/1/2021,BGD,W.P. Labuan,0,0,0,Bangladesh
39285,12/1/2021,BGR,Johor,0,0,0,Bulgaria
39286,12/1/2021,BGR,Kedah,0,0,0,Bulgaria
39287,12/1/2021,BGR,Kelantan,0,0,0,Bulgaria
39288,12/1/2021,BGR,Pahang,0,0,0,Bulgaria
39289,12/1/2021,BGR,Perak,0,0,0,Bulgaria
39290,12/1/2021,BGR,Perlis,0,0,0,Bulgaria
39291,12/1/2021,BGR,Pulau Pinang,0,0,0,Bulgaria
39292,12/1/2021,BGR,Sabah,0,0,0,Bulgaria
39293,12/1/2021,BGR,Sarawak,0,0,0,Bulgaria
39294,12/1/2021,BGR,Selangor,6,5,1,Bulgaria
39295,12/1/2021,BGR,W.P. Labuan,0,0,0,Bulgaria
39296,12/1/2021,BHR,Johor,0,0,0,Bahrain
39297,12/1/2021,BHR,Kedah,0,0,0,Bahrain
39298,12/1/2021,BHR,Kelantan,0,0,0,Bahrain
39299,12/1/2021,BHR,Perlis,0,0,0,Bahrain
39300,12/1/2021,BHR,Pulau Pinang,0,0,0,Bahrain
39301,12/1/2021,BHR,Sabah,0,0,0,Bahrain
39302,12/1/2021,BHR,Sarawak,0,0,0,Bahrain
39303,12/1/2021,BHR,Selangor,5,4,1,Bahrain
39304,12/1/2021,BHS,Johor,0,0,0,Bahamas
39305,12/1/2021,BHS,Kedah,0,0,0,Bahamas
39306,12/1/2021,BHS,Perak,0,0,0,Bahamas
39307,12/1/2021,BHS,Sabah,0,0,0,Bahamas
39308,12/1/2021,BHS,Sarawak,0,0,0,Bahamas
39309,12/1/2021,BHS,Selangor,0,0,0,Bahamas
39310,12/1/2021,BIH,Johor,0,0,0,Bosnia and Herzegovina
39311,12/1/2021,BIH,Kedah,0,0,0,Bosnia and Herzegovina
39312,12/1/2021,BIH,Perlis,0,0,0,Bosnia and Herzegovina
39313,12/1/2021,BIH,Pulau Pinang,0,0,0,Bosnia and Herzegovina
39314,12/1/2021,BIH,Sabah,0,0,0,Bosnia and Herzegovina
39315,12/1/2021,BIH,Sarawak,0,0,0,Bosnia and Herzegovina
39316,12/1/2021,BIH,Selangor,10,5,5,Bosnia and Herzegovina
39317,12/1/2021,BLR,Johor,0,0,0,Belarus
39318,12/1/2021,BLR,Kedah,0,0,0,Belarus
39319,12/1/2021,BLR,Kelantan,0,0,0,Belarus
39320,12/1/2021,BLR,Pahang,0,0,0,Belarus
39321,12/1/2021,BLR,Perak,0,0,0,Belarus
39322,12/1/2021,BLR,Perlis,0,0,0,Belarus
39323,12/1/2021,BLR,Pulau Pinang,0,0,0,Belarus
39324,12/1/2021,BLR,Sabah,0,0,0,Belarus
39325,12/1/2021,BLR,Sarawak,0,0,0,Belarus
39326,12/1/2021,BLR,Selangor,2,2,0,Belarus
39327,12/1/2021,BLR,W.P. Labuan,0,0,0,Belarus
39328,12/1/2021,BLZ,Johor,0,0,0,Belize
39329,12/1/2021,BLZ,Pulau Pinang,0,0,0,Belize
39330,12/1/2021,BLZ,Sarawak,0,0,0,Belize
39331,12/1/2021,BLZ,Selangor,0,0,0,Belize
39332,12/1/2021,BMU,Selangor,0,0,0,Bermuda
39333,12/1/2021,BOL,Johor,0,0,0,Bolivia
39334,12/1/2021,BOL,Kedah,0,0,0,Bolivia
39335,12/1/2021,BOL,Melaka,0,0,0,Bolivia
39336,12/1/2021,BOL,Perak,0,0,0,Bolivia
39337,12/1/2021,BOL,Perlis,0,0,0,Bolivia
39338,12/1/2021,BOL,Pulau Pinang,0,0,0,Bolivia
39339,12/1/2021,BOL,Sabah,0,0,0,Bolivia
39340,12/1/2021,BOL,Sarawak,0,0,0,Bolivia
39341,12/1/2021,BOL,Selangor,0,0,0,Bolivia
39342,12/1/2021,BRA,Johor,0,0,0,Brazil
39343,12/1/2021,BRA,Kedah,0,0,0,Brazil
39344,12/1/2021,BRA,Kelantan,0,0,0,Brazil
39345,12/1/2021,BRA,Melaka,0,0,0,Brazil
39346,12/1/2021,BRA,Pahang,0,0,0,Brazil
39347,12/1/2021,BRA,Perak,0,0,0,Brazil
39348,12/1/2021,BRA,Perlis,0,0,0,Brazil
39349,12/1/2021,BRA,Pulau Pinang,0,0,0,Brazil
39350,12/1/2021,BRA,Sabah,0,0,0,Brazil
39351,12/1/2021,BRA,Sarawak,3,2,1,Brazil
39352,12/1/2021,BRA,Selangor,31,16,15,Brazil
39353,12/1/2021,BRA,W.P. Labuan,0,0,0,Brazil
39354,12/1/2021,BRB,Johor,0,0,0,Barbados
39355,12/1/2021,BRB,Kedah,0,0,0,Barbados
39356,12/1/2021,BRB,Perlis,0,0,0,Barbados
39357,12/1/2021,BRB,Pulau Pinang,0,0,0,Barbados
39358,12/1/2021,BRB,Selangor,1,1,0,Barbados
39359,12/1/2021,BRN,Johor,0,0,0,Brunei Darussalam
39360,12/1/2021,BRN,Kedah,2,2,0,Brunei Darussalam
39361,12/1/2021,BRN,Kelantan,0,0,0,Brunei Darussalam
39362,12/1/2021,BRN,Melaka,0,0,0,Brunei Darussalam
39363,12/1/2021,BRN,Pahang,0,0,0,Brunei Darussalam
39364,12/1/2021,BRN,Perak,0,0,0,Brunei Darussalam
39365,12/1/2021,BRN,Perlis,0,0,0,Brunei Darussalam
39366,12/1/2021,BRN,Pulau Pinang,0,0,0,Brunei Darussalam
39367,12/1/2021,BRN,Sabah,0,0,0,Brunei Darussalam
39368,12/1/2021,BRN,Sarawak,303,291,12,Brunei Darussalam
39369,12/1/2021,BRN,Selangor,97,55,42,Brunei Darussalam
39370,12/1/2021,BRN,W.P. Labuan,1,1,0,Brunei Darussalam
39371,12/1/2021,BTN,Johor,0,0,0,Bhutan
39372,12/1/2021,BTN,Kedah,0,0,0,Bhutan
39373,12/1/2021,BTN,Perak,0,0,0,Bhutan
39374,12/1/2021,BTN,Perlis,0,0,0,Bhutan
39375,12/1/2021,BTN,Pulau Pinang,0,0,0,Bhutan
39376,12/1/2021,BTN,Sabah,0,0,0,Bhutan
39377,12/1/2021,BTN,Sarawak,0,0,0,Bhutan
39378,12/1/2021,BTN,Selangor,8,7,1,Bhutan
39379,12/1/2021,BWA,Johor,0,0,0,Botswana
39380,12/1/2021,BWA,Kedah,0,0,0,Botswana
39381,12/1/2021,BWA,Perlis,0,0,0,Botswana
39382,12/1/2021,BWA,Pulau Pinang,0,0,0,Botswana
39383,12/1/2021,BWA,Sabah,0,0,0,Botswana
39384,12/1/2021,BWA,Sarawak,0,0,0,Botswana
39385,12/1/2021,BWA,Selangor,0,0,0,Botswana
39386,12/1/2021,CAF,Kedah,0,0,0,Central African Republic
39387,12/1/2021,CAF,Selangor,0,0,0,Central African Republic
39388,12/1/2021,CAN,Johor,0,0,0,Canada
39389,12/1/2021,CAN,Kedah,2,2,0,Canada
39390,12/1/2021,CAN,Kelantan,0,0,0,Canada
39391,12/1/2021,CAN,Melaka,0,0,0,Canada
39392,12/1/2021,CAN,Negeri Sembilan,0,0,0,Canada
39393,12/1/2021,CAN,Pahang,0,0,0,Canada
39394,12/1/2021,CAN,Perak,0,0,0,Canada
39395,12/1/2021,CAN,Perlis,0,0,0,Canada
39396,12/1/2021,CAN,Pulau Pinang,1,0,1,Canada
39397,12/1/2021,CAN,Sabah,0,0,0,Canada
39398,12/1/2021,CAN,Sarawak,2,2,0,Canada
39399,12/1/2021,CAN,Selangor,181,115,66,Canada
39400,12/1/2021,CAN,Terengganu,0,0,0,Canada
39401,12/1/2021,CAN,W.P. Labuan,0,0,0,Canada
39402,12/1/2021,CCK,Selangor,0,0,0,Cocos (Keeling) Islands
39403,12/1/2021,CHE,Johor,0,0,0,Switzerland
39404,12/1/2021,CHE,Kedah,1,1,0,Switzerland
39405,12/1/2021,CHE,Kelantan,0,0,0,Switzerland
39406,12/1/2021,CHE,Melaka,0,0,0,Switzerland
39407,12/1/2021,CHE,Negeri Sembilan,0,0,0,Switzerland
39408,12/1/2021,CHE,Pahang,0,0,0,Switzerland
39409,12/1/2021,CHE,Perak,0,0,0,Switzerland
39410,12/1/2021,CHE,Perlis,0,0,0,Switzerland
39411,12/1/2021,CHE,Pulau Pinang,6,3,3,Switzerland
39412,12/1/2021,CHE,Sabah,0,0,0,Switzerland
39413,12/1/2021,CHE,Sarawak,0,0,0,Switzerland
39414,12/1/2021,CHE,Selangor,67,47,20,Switzerland
39415,12/1/2021,CHE,W.P. Labuan,0,0,0,Switzerland
39416,12/1/2021,CHL,Johor,0,0,0,Chile
39417,12/1/2021,CHL,Kedah,0,0,0,Chile
39418,12/1/2021,CHL,Kelantan,0,0,0,Chile
39419,12/1/2021,CHL,Melaka,0,0,0,Chile
39420,12/1/2021,CHL,Pahang,0,0,0,Chile
39421,12/1/2021,CHL,Perak,0,0,0,Chile
39422,12/1/2021,CHL,Perlis,0,0,0,Chile
39423,12/1/2021,CHL,Pulau Pinang,0,0,0,Chile
39424,12/1/2021,CHL,Sabah,1,1,0,Chile
39425,12/1/2021,CHL,Sarawak,0,0,0,Chile
39426,12/1/2021,CHL,Selangor,8,5,3,Chile
39427,12/1/2021,CHN,Johor,83,77,6,China
39428,12/1/2021,CHN,Kedah,3,3,0,China
39429,12/1/2021,CHN,Kelantan,0,0,0,China
39430,12/1/2021,CHN,Melaka,0,0,0,China
39431,12/1/2021,CHN,Pahang,0,0,0,China
39432,12/1/2021,CHN,Perak,0,0,0,China
39433,12/1/2021,CHN,Perlis,0,0,0,China
39434,12/1/2021,CHN,Pulau Pinang,15,8,7,China
39435,12/1/2021,CHN,Sabah,2,1,1,China
39436,12/1/2021,CHN,Sarawak,31,28,3,China
39437,12/1/2021,CHN,Selangor,2250,1486,764,China
39438,12/1/2021,CHN,Terengganu,0,0,0,China
39439,12/1/2021,CHN,W.P. Labuan,0,0,0,China
39440,12/1/2021,CIV,Johor,0,0,0,C��te d'Iv
39441,12/1/2021,CIV,Kedah,0,0,0,C��te d'Iv
39442,12/1/2021,CIV,Pulau Pinang,0,0,0,C��te d'Iv
39443,12/1/2021,CIV,Sabah,0,0,0,C��te d'Iv
39444,12/1/2021,CIV,Sarawak,0,0,0,C��te d'Iv
39445,12/1/2021,CIV,Selangor,2,2,0,C��te d'Iv
39446,12/1/2021,CMR,Johor,0,0,0,Cameroon
39447,12/1/2021,CMR,Kedah,0,0,0,Cameroon
39448,12/1/2021,CMR,Pulau Pinang,0,0,0,Cameroon
39449,12/1/2021,CMR,Sabah,0,0,0,Cameroon
39450,12/1/2021,CMR,Sarawak,0,0,0,Cameroon
39451,12/1/2021,CMR,Selangor,0,0,0,Cameroon
39452,12/1/2021,COD,Johor,0,0,0,"Congo, the Democratic Republic of the"
39453,12/1/2021,COD,Pulau Pinang,0,0,0,"Congo, the Democratic Republic of the"
39454,12/1/2021,COD,Sarawak,0,0,0,"Congo, the Democratic Republic of the"
39455,12/1/2021,COD,Selangor,1,0,1,"Congo, the Democratic Republic of the"
39456,12/1/2021,COG,Johor,0,0,0,Congo
39457,12/1/2021,COG,Kedah,0,0,0,Congo
39458,12/1/2021,COG,Selangor,0,0,0,Congo
39459,12/1/2021,COK,Selangor,0,0,0,Cook Islands
39460,12/1/2021,COL,Johor,0,0,0,Colombia
39461,12/1/2021,COL,Kedah,0,0,0,Colombia
39462,12/1/2021,COL,Perak,0,0,0,Colombia
39463,12/1/2021,COL,Pulau Pinang,0,0,0,Colombia
39464,12/1/2021,COL,Sabah,0,0,0,Colombia
39465,12/1/2021,COL,Sarawak,0,0,0,Colombia
39466,12/1/2021,COL,Selangor,10,6,4,Colombia
39467,12/1/2021,COL,W.P. Labuan,0,0,0,Colombia
39468,12/1/2021,COM,Johor,0,0,0,Comoros
39469,12/1/2021,COM,Kedah,0,0,0,Comoros
39470,12/1/2021,COM,Selangor,2,1,1,Comoros
39471,12/1/2021,CPV,Johor,0,0,0,Cape Verde
39472,12/1/2021,CPV,Kedah,0,0,0,Cape Verde
39473,12/1/2021,CPV,Pulau Pinang,0,0,0,Cape Verde
39474,12/1/2021,CPV,Sabah,0,0,0,Cape Verde
39475,12/1/2021,CPV,Selangor,0,0,0,Cape Verde
39476,12/1/2021,CRI,Johor,0,0,0,Costa Rica
39477,12/1/2021,CRI,Kedah,0,0,0,Costa Rica
39478,12/1/2021,CRI,Perak,0,0,0,Costa Rica
39479,12/1/2021,CRI,Perlis,0,0,0,Costa Rica
39480,12/1/2021,CRI,Pulau Pinang,0,0,0,Costa Rica
39481,12/1/2021,CRI,Sabah,0,0,0,Costa Rica
39482,12/1/2021,CRI,Sarawak,0,0,0,Costa Rica
39483,12/1/2021,CRI,Selangor,1,0,1,Costa Rica
39484,12/1/2021,CUB,Johor,0,0,0,Cuba
39485,12/1/2021,CUB,Kedah,0,0,0,Cuba
39486,12/1/2021,CUB,Perlis,0,0,0,Cuba
39487,12/1/2021,CUB,Pulau Pinang,0,0,0,Cuba
39488,12/1/2021,CUB,Sabah,0,0,0,Cuba
39489,12/1/2021,CUB,Sarawak,0,0,0,Cuba
39490,12/1/2021,CUB,Selangor,2,1,1,Cuba
39491,12/1/2021,CYP,Johor,0,0,0,Cyprus
39492,12/1/2021,CYP,Kedah,0,0,0,Cyprus
39493,12/1/2021,CYP,Perak,0,0,0,Cyprus
39494,12/1/2021,CYP,Perlis,0,0,0,Cyprus
39495,12/1/2021,CYP,Pulau Pinang,0,0,0,Cyprus
39496,12/1/2021,CYP,Sabah,0,0,0,Cyprus
39497,12/1/2021,CYP,Sarawak,0,0,0,Cyprus
39498,12/1/2021,CYP,Selangor,0,0,0,Cyprus
39499,12/1/2021,CZE,Johor,0,0,0,Czech Republic
39500,12/1/2021,CZE,Kedah,0,0,0,Czech Republic
39501,12/1/2021,CZE,Kelantan,0,0,0,Czech Republic
39502,12/1/2021,CZE,Melaka,0,0,0,Czech Republic
39503,12/1/2021,CZE,Negeri Sembilan,0,0,0,Czech Republic
39504,12/1/2021,CZE,Perak,0,0,0,Czech Republic
39505,12/1/2021,CZE,Perlis,0,0,0,Czech Republic
39506,12/1/2021,CZE,Pulau Pinang,0,0,0,Czech Republic
39507,12/1/2021,CZE,Sabah,0,0,0,Czech Republic
39508,12/1/2021,CZE,Sarawak,0,0,0,Czech Republic
39509,12/1/2021,CZE,Selangor,15,8,7,Czech Republic
39510,12/1/2021,CZE,W.P. Labuan,0,0,0,Czech Republic
39511,12/1/2021,DEU,Johor,3,3,0,Germany
39512,12/1/2021,DEU,Kedah,8,5,3,Germany
39513,12/1/2021,DEU,Kelantan,0,0,0,Germany
39514,12/1/2021,DEU,Melaka,0,0,0,Germany
39515,12/1/2021,DEU,Negeri Sembilan,0,0,0,Germany
39516,12/1/2021,DEU,Pahang,0,0,0,Germany
39517,12/1/2021,DEU,Perak,1,1,0,Germany
39518,12/1/2021,DEU,Perlis,0,0,0,Germany
39519,12/1/2021,DEU,Pulau Pinang,6,5,1,Germany
39520,12/1/2021,DEU,Sabah,0,0,0,Germany
39521,12/1/2021,DEU,Sarawak,5,3,2,Germany
39522,12/1/2021,DEU,Selangor,348,247,101,Germany
39523,12/1/2021,DEU,Terengganu,0,0,0,Germany
39524,12/1/2021,DEU,W.P. Labuan,0,0,0,Germany
39525,12/1/2021,DJI,Johor,0,0,0,Djibouti
39526,12/1/2021,DJI,Selangor,6,1,5,Djibouti
39527,12/1/2021,DMA,Johor,0,0,0,Dominica
39528,12/1/2021,DMA,Kedah,0,0,0,Dominica
39529,12/1/2021,DMA,Pulau Pinang,0,0,0,Dominica
39530,12/1/2021,DMA,Sabah,0,0,0,Dominica
39531,12/1/2021,DMA,Sarawak,0,0,0,Dominica
39532,12/1/2021,DMA,Selangor,5,5,0,Dominica
39533,12/1/2021,DMA,W.P. Labuan,0,0,0,Dominica
39534,12/1/2021,DNK,Johor,1,1,0,Denmark
39535,12/1/2021,DNK,Kedah,1,1,0,Denmark
39536,12/1/2021,DNK,Kelantan,0,0,0,Denmark
39537,12/1/2021,DNK,Melaka,0,0,0,Denmark
39538,12/1/2021,DNK,Negeri Sembilan,0,0,0,Denmark
39539,12/1/2021,DNK,Pahang,0,0,0,Denmark
39540,12/1/2021,DNK,Perak,0,0,0,Denmark
39541,12/1/2021,DNK,Perlis,0,0,0,Denmark
39542,12/1/2021,DNK,Pulau Pinang,5,5,0,Denmark
39543,12/1/2021,DNK,Sabah,0,0,0,Denmark
39544,12/1/2021,DNK,Sarawak,1,1,0,Denmark
39545,12/1/2021,DNK,Selangor,50,39,11,Denmark
39546,12/1/2021,DNK,W.P. Labuan,0,0,0,Denmark
39547,12/1/2021,DOM,Johor,0,0,0,Dominican Republic
39548,12/1/2021,DOM,Kedah,0,0,0,Dominican Republic
39549,12/1/2021,DOM,Perak,0,0,0,Dominican Republic
39550,12/1/2021,DOM,Perlis,0,0,0,Dominican Republic
39551,12/1/2021,DOM,Pulau Pinang,0,0,0,Dominican Republic
39552,12/1/2021,DOM,Sabah,0,0,0,Dominican Republic
39553,12/1/2021,DOM,Sarawak,0,0,0,Dominican Republic
39554,12/1/2021,DOM,Selangor,1,1,0,Dominican Republic
39555,12/1/2021,DZA,Johor,0,0,0,Algeria
39556,12/1/2021,DZA,Kedah,0,0,0,Algeria
39557,12/1/2021,DZA,Kelantan,0,0,0,Algeria
39558,12/1/2021,DZA,Melaka,0,0,0,Algeria
39559,12/1/2021,DZA,Perak,0,0,0,Algeria
39560,12/1/2021,DZA,Perlis,0,0,0,Algeria
39561,12/1/2021,DZA,Pulau Pinang,0,0,0,Algeria
39562,12/1/2021,DZA,Sabah,0,0,0,Algeria
39563,12/1/2021,DZA,Sarawak,0,0,0,Algeria
39564,12/1/2021,DZA,Selangor,45,35,10,Algeria
39565,12/1/2021,DZA,W.P. Labuan,0,0,0,Algeria
39566,12/1/2021,ECU,Johor,0,0,0,Ecuador
39567,12/1/2021,ECU,Kedah,0,0,0,Ecuador
39568,12/1/2021,ECU,Perak,0,0,0,Ecuador
39569,12/1/2021,ECU,Perlis,0,0,0,Ecuador
39570,12/1/2021,ECU,Pulau Pinang,0,0,0,Ecuador
39571,12/1/2021,ECU,Sabah,0,0,0,Ecuador
39572,12/1/2021,ECU,Sarawak,0,0,0,Ecuador
39573,12/1/2021,ECU,Selangor,3,3,0,Ecuador
39574,12/1/2021,EGY,Johor,0,0,0,Egypt
39575,12/1/2021,EGY,Kedah,0,0,0,Egypt
39576,12/1/2021,EGY,Kelantan,0,0,0,Egypt
39577,12/1/2021,EGY,Melaka,0,0,0,Egypt
39578,12/1/2021,EGY,Pahang,0,0,0,Egypt
39579,12/1/2021,EGY,Perak,0,0,0,Egypt
39580,12/1/2021,EGY,Perlis,0,0,0,Egypt
39581,12/1/2021,EGY,Pulau Pinang,0,0,0,Egypt
39582,12/1/2021,EGY,Sabah,0,0,0,Egypt
39583,12/1/2021,EGY,Sarawak,0,0,0,Egypt
39584,12/1/2021,EGY,Selangor,271,206,65,Egypt
39585,12/1/2021,EGY,Terengganu,0,0,0,Egypt
39586,12/1/2021,EGY,W.P. Labuan,0,0,0,Egypt
39587,12/1/2021,ERI,Johor,0,0,0,Eritrea
39588,12/1/2021,ERI,Pulau Pinang,0,0,0,Eritrea
39589,12/1/2021,ERI,Sabah,0,0,0,Eritrea
39590,12/1/2021,ERI,Selangor,4,2,2,Eritrea
39591,12/1/2021,ESP,Johor,0,0,0,Spain
39592,12/1/2021,ESP,Kedah,0,0,0,Spain
39593,12/1/2021,ESP,Kelantan,0,0,0,Spain
39594,12/1/2021,ESP,Melaka,0,0,0,Spain
39595,12/1/2021,ESP,Negeri Sembilan,0,0,0,Spain
39596,12/1/2021,ESP,Pahang,0,0,0,Spain
39597,12/1/2021,ESP,Perak,0,0,0,Spain
39598,12/1/2021,ESP,Perlis,0,0,0,Spain
39599,12/1/2021,ESP,Pulau Pinang,0,0,0,Spain
39600,12/1/2021,ESP,Sabah,0,0,0,Spain
39601,12/1/2021,ESP,Sarawak,0,0,0,Spain
39602,12/1/2021,ESP,Selangor,44,30,14,Spain
39603,12/1/2021,ESP,W.P. Labuan,0,0,0,Spain
39604,12/1/2021,EST,Johor,0,0,0,Estonia
39605,12/1/2021,EST,Kedah,0,0,0,Estonia
39606,12/1/2021,EST,Kelantan,0,0,0,Estonia
39607,12/1/2021,EST,Pahang,0,0,0,Estonia
39608,12/1/2021,EST,Perak,0,0,0,Estonia
39609,12/1/2021,EST,Perlis,0,0,0,Estonia
39610,12/1/2021,EST,Pulau Pinang,0,0,0,Estonia
39611,12/1/2021,EST,Sabah,0,0,0,Estonia
39612,12/1/2021,EST,Sarawak,0,0,0,Estonia
39613,12/1/2021,EST,Selangor,4,3,1,Estonia
39614,12/1/2021,EST,W.P. Labuan,0,0,0,Estonia
39615,12/1/2021,ETH,Johor,0,0,0,Ethiopia
39616,12/1/2021,ETH,Kedah,0,0,0,Ethiopia
39617,12/1/2021,ETH,Pulau Pinang,0,0,0,Ethiopia
39618,12/1/2021,ETH,Sarawak,0,0,0,Ethiopia
39619,12/1/2021,ETH,Selangor,3,2,1,Ethiopia
39620,12/1/2021,FIN,Johor,0,0,0,Finland
39621,12/1/2021,FIN,Kedah,0,0,0,Finland
39622,12/1/2021,FIN,Kelantan,0,0,0,Finland
39623,12/1/2021,FIN,Melaka,0,0,0,Finland
39624,12/1/2021,FIN,Negeri Sembilan,0,0,0,Finland
39625,12/1/2021,FIN,Pahang,0,0,0,Finland
39626,12/1/2021,FIN,Perak,0,0,0,Finland
39627,12/1/2021,FIN,Perlis,0,0,0,Finland
39628,12/1/2021,FIN,Pulau Pinang,0,0,0,Finland
39629,12/1/2021,FIN,Sabah,0,0,0,Finland
39630,12/1/2021,FIN,Sarawak,0,0,0,Finland
39631,12/1/2021,FIN,Selangor,36,25,11,Finland
39632,12/1/2021,FIN,W.P. Labuan,0,0,0,Finland
39633,12/1/2021,FJI,Johor,0,0,0,Fiji
39634,12/1/2021,FJI,Kedah,0,0,0,Fiji
39635,12/1/2021,FJI,Kelantan,0,0,0,Fiji
39636,12/1/2021,FJI,Perak,0,0,0,Fiji
39637,12/1/2021,FJI,Perlis,0,0,0,Fiji
39638,12/1/2021,FJI,Pulau Pinang,0,0,0,Fiji
39639,12/1/2021,FJI,Sabah,0,0,0,Fiji
39640,12/1/2021,FJI,Sarawak,0,0,0,Fiji
39641,12/1/2021,FJI,Selangor,6,4,2,Fiji
39642,12/1/2021,FRA,Johor,0,0,0,France
39643,12/1/2021,FRA,Kedah,3,2,1,France
39644,12/1/2021,FRA,Kelantan,0,0,0,France
39645,12/1/2021,FRA,Melaka,0,0,0,France
39646,12/1/2021,FRA,Negeri Sembilan,0,0,0,France
39647,12/1/2021,FRA,Pahang,0,0,0,France
39648,12/1/2021,FRA,Perak,0,0,0,France
39649,12/1/2021,FRA,Perlis,0,0,0,France
39650,12/1/2021,FRA,Pulau Pinang,4,4,0,France
39651,12/1/2021,FRA,Sabah,0,0,0,France
39652,12/1/2021,FRA,Sarawak,1,1,0,France
39653,12/1/2021,FRA,Selangor,390,265,125,France
39654,12/1/2021,FRA,Terengganu,0,0,0,France
39655,12/1/2021,FRA,W.P. Labuan,0,0,0,France
39656,12/1/2021,FSM,Johor,0,0,0,"Micronesia, Federated States of"
39657,12/1/2021,FSM,Pulau Pinang,0,0,0,"Micronesia, Federated States of"
39658,12/1/2021,FSM,Selangor,0,0,0,"Micronesia, Federated States of"
39659,12/1/2021,GAB,Johor,0,0,0,Gabon
39660,12/1/2021,GAB,Pulau Pinang,0,0,0,Gabon
39661,12/1/2021,GAB,Sarawak,0,0,0,Gabon
39662,12/1/2021,GAB,Selangor,1,1,0,Gabon
39663,12/1/2021,GBR,Johor,0,0,0,United Kingdom
39664,12/1/2021,GBR,Kedah,17,11,6,United Kingdom
39665,12/1/2021,GBR,Kelantan,0,0,0,United Kingdom
39666,12/1/2021,GBR,Melaka,0,0,0,United Kingdom
39667,12/1/2021,GBR,Negeri Sembilan,0,0,0,United Kingdom
39668,12/1/2021,GBR,Pahang,0,0,0,United Kingdom
39669,12/1/2021,GBR,Perak,1,0,1,United Kingdom
39670,12/1/2021,GBR,Perlis,0,0,0,United Kingdom
39671,12/1/2021,GBR,Pulau Pinang,20,14,6,United Kingdom
39672,12/1/2021,GBR,Sabah,2,1,1,United Kingdom
39673,12/1/2021,GBR,Sarawak,4,4,0,United Kingdom
39674,12/1/2021,GBR,Selangor,1347,874,473,United Kingdom
39675,12/1/2021,GBR,Terengganu,0,0,0,United Kingdom
39676,12/1/2021,GBR,W.P. Labuan,0,0,0,United Kingdom
39677,12/1/2021,GEO,Johor,0,0,0,Georgia
39678,12/1/2021,GEO,Kedah,0,0,0,Georgia
39679,12/1/2021,GEO,Melaka,0,0,0,Georgia
39680,12/1/2021,GEO,Perak,0,0,0,Georgia
39681,12/1/2021,GEO,Perlis,0,0,0,Georgia
39682,12/1/2021,GEO,Pulau Pinang,0,0,0,Georgia
39683,12/1/2021,GEO,Sabah,0,0,0,Georgia
39684,12/1/2021,GEO,Sarawak,0,0,0,Georgia
39685,12/1/2021,GEO,Selangor,12,10,2,Georgia
39686,12/1/2021,GHA,Johor,0,0,0,Ghana
39687,12/1/2021,GHA,Kedah,0,0,0,Ghana
39688,12/1/2021,GHA,Kelantan,0,0,0,Ghana
39689,12/1/2021,GHA,Pulau Pinang,0,0,0,Ghana
39690,12/1/2021,GHA,Sabah,0,0,0,Ghana
39691,12/1/2021,GHA,Sarawak,0,0,0,Ghana
39692,12/1/2021,GHA,Selangor,9,8,1,Ghana
39693,12/1/2021,GIB,Johor,0,0,0,Gibraltar
39694,12/1/2021,GIB,Sarawak,0,0,0,Gibraltar
39695,12/1/2021,GIN,Johor,0,0,0,Guinea
39696,12/1/2021,GIN,Kedah,0,0,0,Guinea
39697,12/1/2021,GIN,Kelantan,0,0,0,Guinea
39698,12/1/2021,GIN,Perlis,0,0,0,Guinea
39699,12/1/2021,GIN,Pulau Pinang,0,0,0,Guinea
39700,12/1/2021,GIN,Sabah,0,0,0,Guinea
39701,12/1/2021,GIN,Sarawak,0,0,0,Guinea
39702,12/1/2021,GIN,Selangor,8,5,3,Guinea
39703,12/1/2021,GLP,Selangor,0,0,0,Guadeloupe
39704,12/1/2021,GMB,Johor,0,0,0,Gambia
39705,12/1/2021,GMB,Kedah,0,0,0,Gambia
39706,12/1/2021,GMB,Kelantan,0,0,0,Gambia
39707,12/1/2021,GMB,Pulau Pinang,0,0,0,Gambia
39708,12/1/2021,GMB,Sabah,0,0,0,Gambia
39709,12/1/2021,GMB,Sarawak,0,0,0,Gambia
39710,12/1/2021,GMB,Selangor,3,3,0,Gambia
39711,12/1/2021,GNB,Johor,0,0,0,Guinea-Bissau
39712,12/1/2021,GNB,Selangor,0,0,0,Guinea-Bissau
39713,12/1/2021,GNQ,Johor,0,0,0,Equatorial Guinea
39714,12/1/2021,GNQ,Selangor,8,6,2,Equatorial Guinea
39715,12/1/2021,GRC,Johor,0,0,0,Greece
39716,12/1/2021,GRC,Kedah,0,0,0,Greece
39717,12/1/2021,GRC,Kelantan,0,0,0,Greece
39718,12/1/2021,GRC,Melaka,0,0,0,Greece
39719,12/1/2021,GRC,Negeri Sembilan,0,0,0,Greece
39720,12/1/2021,GRC,Pahang,0,0,0,Greece
39721,12/1/2021,GRC,Perak,0,0,0,Greece
39722,12/1/2021,GRC,Perlis,0,0,0,Greece
39723,12/1/2021,GRC,Pulau Pinang,0,0,0,Greece
39724,12/1/2021,GRC,Sabah,0,0,0,Greece
39725,12/1/2021,GRC,Sarawak,0,0,0,Greece
39726,12/1/2021,GRC,Selangor,8,8,0,Greece
39727,12/1/2021,GRD,Johor,0,0,0,Grenada
39728,12/1/2021,GRD,Kedah,0,0,0,Grenada
39729,12/1/2021,GRD,Pulau Pinang,0,0,0,Grenada
39730,12/1/2021,GRD,Sabah,0,0,0,Grenada
39731,12/1/2021,GRD,Sarawak,0,0,0,Grenada
39732,12/1/2021,GRD,Selangor,0,0,0,Grenada
39733,12/1/2021,GRL,Johor,0,0,0,Greenland
39734,12/1/2021,GRL,Selangor,0,0,0,Greenland
39735,12/1/2021,GTM,Johor,0,0,0,Guatemala
39736,12/1/2021,GTM,Kedah,0,0,0,Guatemala
39737,12/1/2021,GTM,Pahang,0,0,0,Guatemala
39738,12/1/2021,GTM,Perak,0,0,0,Guatemala
39739,12/1/2021,GTM,Pulau Pinang,0,0,0,Guatemala
39740,12/1/2021,GTM,Sabah,0,0,0,Guatemala
39741,12/1/2021,GTM,Sarawak,0,0,0,Guatemala
39742,12/1/2021,GTM,Selangor,0,0,0,Guatemala
39743,12/1/2021,GTM,W.P. Labuan,0,0,0,Guatemala
39744,12/1/2021,GUY,Johor,0,0,0,Guyana
39745,12/1/2021,GUY,Kedah,0,0,0,Guyana
39746,12/1/2021,GUY,Pulau Pinang,0,0,0,Guyana
39747,12/1/2021,GUY,Sarawak,0,0,0,Guyana
39748,12/1/2021,GUY,Selangor,0,0,0,Guyana
39749,12/1/2021,HKG,Johor,0,0,0,Hong Kong
39750,12/1/2021,HKG,Kedah,0,0,0,Hong Kong
39751,12/1/2021,HKG,Kelantan,0,0,0,Hong Kong
39752,12/1/2021,HKG,Pahang,0,0,0,Hong Kong
39753,12/1/2021,HKG,Perak,0,0,0,Hong Kong
39754,12/1/2021,HKG,Perlis,0,0,0,Hong Kong
39755,12/1/2021,HKG,Pulau Pinang,2,1,1,Hong Kong
39756,12/1/2021,HKG,Sabah,0,0,0,Hong Kong
39757,12/1/2021,HKG,Sarawak,44,38,6,Hong Kong
39758,12/1/2021,HKG,Selangor,1,1,0,Hong Kong
39759,12/1/2021,HKG,Terengganu,0,0,0,Hong Kong
39760,12/1/2021,HMD,Johor,0,0,0,Heard Island and McDonald Islands
39761,12/1/2021,HND,Johor,0,0,0,Honduras
39762,12/1/2021,HND,Kedah,0,0,0,Honduras
39763,12/1/2021,HND,Perak,0,0,0,Honduras
39764,12/1/2021,HND,Pulau Pinang,0,0,0,Honduras
39765,12/1/2021,HND,Sabah,0,0,0,Honduras
39766,12/1/2021,HND,Sarawak,0,0,0,Honduras
39767,12/1/2021,HND,Selangor,0,0,0,Honduras
39768,12/1/2021,HRV,Johor,0,0,0,Croatia
39769,12/1/2021,HRV,Kedah,0,0,0,Croatia
39770,12/1/2021,HRV,Kelantan,0,0,0,Croatia
39771,12/1/2021,HRV,Melaka,0,0,0,Croatia
39772,12/1/2021,HRV,Pahang,0,0,0,Croatia
39773,12/1/2021,HRV,Perak,0,0,0,Croatia
39774,12/1/2021,HRV,Perlis,0,0,0,Croatia
39775,12/1/2021,HRV,Pulau Pinang,0,0,0,Croatia
39776,12/1/2021,HRV,Sabah,0,0,0,Croatia
39777,12/1/2021,HRV,Sarawak,0,0,0,Croatia
39778,12/1/2021,HRV,Selangor,12,11,1,Croatia
39779,12/1/2021,HTI,Johor,0,0,0,Haiti
39780,12/1/2021,HTI,Kedah,0,0,0,Haiti
39781,12/1/2021,HTI,Kelantan,0,0,0,Haiti
39782,12/1/2021,HTI,Perak,0,0,0,Haiti
39783,12/1/2021,HTI,Pulau Pinang,0,0,0,Haiti
39784,12/1/2021,HTI,Sabah,0,0,0,Haiti
39785,12/1/2021,HTI,Selangor,0,0,0,Haiti
39786,12/1/2021,HUN,Johor,0,0,0,Hungary
39787,12/1/2021,HUN,Kedah,0,0,0,Hungary
39788,12/1/2021,HUN,Kelantan,0,0,0,Hungary
39789,12/1/2021,HUN,Pahang,0,0,0,Hungary
39790,12/1/2021,HUN,Perak,0,0,0,Hungary
39791,12/1/2021,HUN,Perlis,0,0,0,Hungary
39792,12/1/2021,HUN,Pulau Pinang,0,0,0,Hungary
39793,12/1/2021,HUN,Sabah,0,0,0,Hungary
39794,12/1/2021,HUN,Sarawak,0,0,0,Hungary
39795,12/1/2021,HUN,Selangor,15,10,5,Hungary
39796,12/1/2021,HUN,W.P. Labuan,0,0,0,Hungary
39797,12/1/2021,IDN,Johor,332,174,158,Indonesia
39798,12/1/2021,IDN,Kedah,19,10,9,Indonesia
39799,12/1/2021,IDN,Kelantan,0,0,0,Indonesia
39800,12/1/2021,IDN,Melaka,0,0,0,Indonesia
39801,12/1/2021,IDN,Negeri Sembilan,0,0,0,Indonesia
39802,12/1/2021,IDN,Pahang,0,0,0,Indonesia
39803,12/1/2021,IDN,Perak,0,0,0,Indonesia
39804,12/1/2021,IDN,Perlis,1,1,0,Indonesia
39805,12/1/2021,IDN,Pulau Pinang,22,11,11,Indonesia
39806,12/1/2021,IDN,Sabah,3,2,1,Indonesia
39807,12/1/2021,IDN,Sarawak,154,144,10,Indonesia
39808,12/1/2021,IDN,Selangor,3834,1643,2191,Indonesia
39809,12/1/2021,IDN,Terengganu,0,0,0,Indonesia
39810,12/1/2021,IDN,W.P. Labuan,0,0,0,Indonesia
39811,12/1/2021,IND,Johor,35,32,3,India
39812,12/1/2021,IND,Kedah,0,0,0,India
39813,12/1/2021,IND,Kelantan,0,0,0,India
39814,12/1/2021,IND,Melaka,0,0,0,India
39815,12/1/2021,IND,Negeri Sembilan,0,0,0,India
39816,12/1/2021,IND,Pahang,0,0,0,India
39817,12/1/2021,IND,Perak,0,0,0,India
39818,12/1/2021,IND,Perlis,0,0,0,India
39819,12/1/2021,IND,Pulau Pinang,9,7,2,India
39820,12/1/2021,IND,Sabah,4,3,1,India
39821,12/1/2021,IND,Sarawak,3,3,0,India
39822,12/1/2021,IND,Selangor,6305,4601,1704,India
39823,12/1/2021,IND,Terengganu,0,0,0,India
39824,12/1/2021,IND,W.P. Labuan,0,0,0,India
39825,12/1/2021,IOT,Pulau Pinang,0,0,0,British Indian Ocean Territory
39826,12/1/2021,IOT,Selangor,0,0,0,British Indian Ocean Territory
39827,12/1/2021,IRL,Johor,0,0,0,Ireland
39828,12/1/2021,IRL,Kedah,0,0,0,Ireland
39829,12/1/2021,IRL,Kelantan,0,0,0,Ireland
39830,12/1/2021,IRL,Negeri Sembilan,0,0,0,Ireland
39831,12/1/2021,IRL,Pahang,0,0,0,Ireland
39832,12/1/2021,IRL,Perak,0,0,0,Ireland
39833,12/1/2021,IRL,Perlis,0,0,0,Ireland
39834,12/1/2021,IRL,Pulau Pinang,0,0,0,Ireland
39835,12/1/2021,IRL,Sabah,0,0,0,Ireland
39836,12/1/2021,IRL,Sarawak,0,0,0,Ireland
39837,12/1/2021,IRL,Selangor,74,46,28,Ireland
39838,12/1/2021,IRL,Terengganu,0,0,0,Ireland
39839,12/1/2021,IRL,W.P. Labuan,0,0,0,Ireland
39840,12/1/2021,IRN,Johor,0,0,0,Iran
39841,12/1/2021,IRN,Kedah,0,0,0,Iran
39842,12/1/2021,IRN,Kelantan,0,0,0,Iran
39843,12/1/2021,IRN,Perak,0,0,0,Iran
39844,12/1/2021,IRN,Perlis,0,0,0,Iran
39845,12/1/2021,IRN,Pulau Pinang,0,0,0,Iran
39846,12/1/2021,IRN,Sabah,0,0,0,Iran
39847,12/1/2021,IRN,Sarawak,0,0,0,Iran
39848,12/1/2021,IRN,Selangor,175,101,74,Iran
39849,12/1/2021,IRN,W.P. Labuan,0,0,0,Iran
39850,12/1/2021,IRQ,Johor,0,0,0,Iraq
39851,12/1/2021,IRQ,Kedah,0,0,0,Iraq
39852,12/1/2021,IRQ,Kelantan,0,0,0,Iraq
39853,12/1/2021,IRQ,Melaka,0,0,0,Iraq
39854,12/1/2021,IRQ,Pahang,0,0,0,Iraq
39855,12/1/2021,IRQ,Perak,0,0,0,Iraq
39856,12/1/2021,IRQ,Perlis,0,0,0,Iraq
39857,12/1/2021,IRQ,Pulau Pinang,0,0,0,Iraq
39858,12/1/2021,IRQ,Sabah,0,0,0,Iraq
39859,12/1/2021,IRQ,Sarawak,0,0,0,Iraq
39860,12/1/2021,IRQ,Selangor,256,164,92,Iraq
39861,12/1/2021,ISL,Johor,0,0,0,Iceland
39862,12/1/2021,ISL,Kedah,0,0,0,Iceland
39863,12/1/2021,ISL,Kelantan,0,0,0,Iceland
39864,12/1/2021,ISL,Perak,0,0,0,Iceland
39865,12/1/2021,ISL,Perlis,0,0,0,Iceland
39866,12/1/2021,ISL,Pulau Pinang,0,0,0,Iceland
39867,12/1/2021,ISL,Sabah,0,0,0,Iceland
39868,12/1/2021,ISL,Sarawak,0,0,0,Iceland
39869,12/1/2021,ISL,Selangor,1,1,0,Iceland
39870,12/1/2021,ISL,W.P. Labuan,0,0,0,Iceland
39871,12/1/2021,ISR,Pulau Pinang,0,0,0,Israel
39872,12/1/2021,ITA,Johor,0,0,0,Italy
39873,12/1/2021,ITA,Kedah,4,3,1,Italy
39874,12/1/2021,ITA,Kelantan,0,0,0,Italy
39875,12/1/2021,ITA,Melaka,0,0,0,Italy
39876,12/1/2021,ITA,Negeri Sembilan,0,0,0,Italy
39877,12/1/2021,ITA,Pahang,0,0,0,Italy
39878,12/1/2021,ITA,Perak,0,0,0,Italy
39879,12/1/2021,ITA,Perlis,0,0,0,Italy
39880,12/1/2021,ITA,Pulau Pinang,1,1,0,Italy
39881,12/1/2021,ITA,Sabah,1,1,0,Italy
39882,12/1/2021,ITA,Sarawak,0,0,0,Italy
39883,12/1/2021,ITA,Selangor,85,70,15,Italy
39884,12/1/2021,ITA,W.P. Labuan,0,0,0,Italy
39885,12/1/2021,JAM,Johor,0,0,0,Jamaica
39886,12/1/2021,JAM,Kedah,0,0,0,Jamaica
39887,12/1/2021,JAM,Perak,0,0,0,Jamaica
39888,12/1/2021,JAM,Pulau Pinang,0,0,0,Jamaica
39889,12/1/2021,JAM,Sabah,0,0,0,Jamaica
39890,12/1/2021,JAM,Sarawak,0,0,0,Jamaica
39891,12/1/2021,JAM,Selangor,2,2,0,Jamaica
39892,12/1/2021,JAM,W.P. Labuan,0,0,0,Jamaica
39893,12/1/2021,JOR,Johor,0,0,0,Jordan
39894,12/1/2021,JOR,Kedah,0,0,0,Jordan
39895,12/1/2021,JOR,Kelantan,0,0,0,Jordan
39896,12/1/2021,JOR,Melaka,0,0,0,Jordan
39897,12/1/2021,JOR,Perlis,0,0,0,Jordan
39898,12/1/2021,JOR,Pulau Pinang,0,0,0,Jordan
39899,12/1/2021,JOR,Sabah,0,0,0,Jordan
39900,12/1/2021,JOR,Sarawak,0,0,0,Jordan
39901,12/1/2021,JOR,Selangor,78,62,16,Jordan
39902,12/1/2021,JOR,W.P. Labuan,0,0,0,Jordan
39903,12/1/2021,JPN,Johor,5,4,1,Japan
39904,12/1/2021,JPN,Kedah,7,1,6,Japan
39905,12/1/2021,JPN,Kelantan,0,0,0,Japan
39906,12/1/2021,JPN,Melaka,0,0,0,Japan
39907,12/1/2021,JPN,Negeri Sembilan,0,0,0,Japan
39908,12/1/2021,JPN,Pahang,0,0,0,Japan
39909,12/1/2021,JPN,Perak,3,2,1,Japan
39910,12/1/2021,JPN,Perlis,0,0,0,Japan
39911,12/1/2021,JPN,Pulau Pinang,58,32,26,Japan
39912,12/1/2021,JPN,Sabah,3,1,2,Japan
39913,12/1/2021,JPN,Sarawak,9,8,1,Japan
39914,12/1/2021,JPN,Selangor,1066,624,442,Japan
39915,12/1/2021,JPN,W.P. Labuan,0,0,0,Japan
39916,12/1/2021,KAZ,Johor,0,0,0,Kazakhstan
39917,12/1/2021,KAZ,Kedah,0,0,0,Kazakhstan
39918,12/1/2021,KAZ,Kelantan,0,0,0,Kazakhstan
39919,12/1/2021,KAZ,Melaka,0,0,0,Kazakhstan
39920,12/1/2021,KAZ,Perak,0,0,0,Kazakhstan
39921,12/1/2021,KAZ,Perlis,0,0,0,Kazakhstan
39922,12/1/2021,KAZ,Pulau Pinang,0,0,0,Kazakhstan
39923,12/1/2021,KAZ,Sabah,0,0,0,Kazakhstan
39924,12/1/2021,KAZ,Sarawak,0,0,0,Kazakhstan
39925,12/1/2021,KAZ,Selangor,21,10,11,Kazakhstan
39926,12/1/2021,KAZ,W.P. Labuan,0,0,0,Kazakhstan
39927,12/1/2021,KEN,Johor,0,0,0,Kenya
39928,12/1/2021,KEN,Kedah,0,0,0,Kenya
39929,12/1/2021,KEN,Kelantan,0,0,0,Kenya
39930,12/1/2021,KEN,Perak,0,0,0,Kenya
39931,12/1/2021,KEN,Perlis,0,0,0,Kenya
39932,12/1/2021,KEN,Pulau Pinang,0,0,0,Kenya
39933,12/1/2021,KEN,Sabah,0,0,0,Kenya
39934,12/1/2021,KEN,Sarawak,0,0,0,Kenya
39935,12/1/2021,KEN,Selangor,37,22,15,Kenya
39936,12/1/2021,KGZ,Johor,0,0,0,Kyrgyzstan
39937,12/1/2021,KGZ,Kedah,0,0,0,Kyrgyzstan
39938,12/1/2021,KGZ,Kelantan,0,0,0,Kyrgyzstan
39939,12/1/2021,KGZ,Perak,0,0,0,Kyrgyzstan
39940,12/1/2021,KGZ,Perlis,0,0,0,Kyrgyzstan
39941,12/1/2021,KGZ,Pulau Pinang,0,0,0,Kyrgyzstan
39942,12/1/2021,KGZ,Sabah,0,0,0,Kyrgyzstan
39943,12/1/2021,KGZ,Sarawak,0,0,0,Kyrgyzstan
39944,12/1/2021,KGZ,Selangor,13,6,7,Kyrgyzstan
39945,12/1/2021,KHM,Johor,0,0,0,Cambodia
39946,12/1/2021,KHM,Kedah,0,0,0,Cambodia
39947,12/1/2021,KHM,Kelantan,0,0,0,Cambodia
39948,12/1/2021,KHM,Melaka,0,0,0,Cambodia
39949,12/1/2021,KHM,Negeri Sembilan,0,0,0,Cambodia
39950,12/1/2021,KHM,Pahang,0,0,0,Cambodia
39951,12/1/2021,KHM,Perak,0,0,0,Cambodia
39952,12/1/2021,KHM,Perlis,0,0,0,Cambodia
39953,12/1/2021,KHM,Pulau Pinang,16,16,0,Cambodia
39954,12/1/2021,KHM,Sabah,0,0,0,Cambodia
39955,12/1/2021,KHM,Sarawak,0,0,0,Cambodia
39956,12/1/2021,KHM,Selangor,67,42,25,Cambodia
39957,12/1/2021,KHM,W.P. Labuan,0,0,0,Cambodia
39958,12/1/2021,KIR,Johor,0,0,0,Kiribati
39959,12/1/2021,KIR,Sabah,0,0,0,Kiribati
39960,12/1/2021,KIR,Selangor,0,0,0,Kiribati
39961,12/1/2021,KNA,Johor,0,0,0,Saint Kitts and Nevis
39962,12/1/2021,KNA,Kedah,0,0,0,Saint Kitts and Nevis
39963,12/1/2021,KNA,Perlis,0,0,0,Saint Kitts and Nevis
39964,12/1/2021,KNA,Pulau Pinang,0,0,0,Saint Kitts and Nevis
39965,12/1/2021,KNA,Sabah,0,0,0,Saint Kitts and Nevis
39966,12/1/2021,KNA,Selangor,1,1,0,Saint Kitts and Nevis
39967,12/1/2021,KNA,W.P. Labuan,0,0,0,Saint Kitts and Nevis
39968,12/1/2021,KOR,Johor,2,2,0,"Korea, Republic of (South Korea)"
39969,12/1/2021,KOR,Kedah,0,0,0,"Korea, Republic of (South Korea)"
39970,12/1/2021,KOR,Kelantan,0,0,0,"Korea, Republic of (South Korea)"
39971,12/1/2021,KOR,Melaka,0,0,0,"Korea, Republic of (South Korea)"
39972,12/1/2021,KOR,Negeri Sembilan,0,0,0,"Korea, Republic of (South Korea)"
39973,12/1/2021,KOR,Pahang,0,0,0,"Korea, Republic of (South Korea)"
39974,12/1/2021,KOR,Perak,0,0,0,"Korea, Republic of (South Korea)"
39975,12/1/2021,KOR,Perlis,0,0,0,"Korea, Republic of (South Korea)"
39976,12/1/2021,KOR,Pulau Pinang,22,6,16,"Korea, Republic of (South Korea)"
39977,12/1/2021,KOR,Sabah,2,0,2,"Korea, Republic of (South Korea)"
39978,12/1/2021,KOR,Sarawak,40,34,6,"Korea, Republic of (South Korea)"
39979,12/1/2021,KOR,Selangor,1288,809,479,"Korea, Republic of (South Korea)"
39980,12/1/2021,KOR,Terengganu,0,0,0,"Korea, Republic of (South Korea)"
39981,12/1/2021,KOR,W.P. Labuan,0,0,0,"Korea, Republic of (South Korea)"
39982,12/1/2021,KWT,Johor,0,0,0,Kuwait
39983,12/1/2021,KWT,Kedah,0,0,0,Kuwait
39984,12/1/2021,KWT,Kelantan,0,0,0,Kuwait
39985,12/1/2021,KWT,Perak,0,0,0,Kuwait
39986,12/1/2021,KWT,Perlis,0,0,0,Kuwait
39987,12/1/2021,KWT,Pulau Pinang,0,0,0,Kuwait
39988,12/1/2021,KWT,Sabah,0,0,0,Kuwait
39989,12/1/2021,KWT,Sarawak,0,0,0,Kuwait
39990,12/1/2021,KWT,Selangor,6,5,1,Kuwait
39991,12/1/2021,KWT,W.P. Labuan,0,0,0,Kuwait
39992,12/1/2021,LAO,Johor,0,0,0,Lao People's Democratic Republic
39993,12/1/2021,LAO,Kedah,0,0,0,Lao People's Democratic Republic
39994,12/1/2021,LAO,Kelantan,0,0,0,Lao People's Democratic Republic
39995,12/1/2021,LAO,Melaka,0,0,0,Lao People's Democratic Republic
39996,12/1/2021,LAO,Perak,0,0,0,Lao People's Democratic Republic
39997,12/1/2021,LAO,Perlis,0,0,0,Lao People's Democratic Republic
39998,12/1/2021,LAO,Pulau Pinang,0,0,0,Lao People's Democratic Republic
39999,12/1/2021,LAO,Sabah,0,0,0,Lao People's Democratic Republic
40000,12/1/2021,LAO,Sarawak,0,0,0,Lao People's Democratic Republic
40001,12/1/2021,LAO,Selangor,19,15,4,Lao People's Democratic Republic
40002,12/1/2021,LAO,W.P. Labuan,0,0,0,Lao People's Democratic Republic
40003,12/1/2021,LBN,Johor,0,0,0,Lebanon
40004,12/1/2021,LBN,Kedah,0,0,0,Lebanon
40005,12/1/2021,LBN,Kelantan,0,0,0,Lebanon
40006,12/1/2021,LBN,Pahang,0,0,0,Lebanon
40007,12/1/2021,LBN,Perak,0,0,0,Lebanon
40008,12/1/2021,LBN,Perlis,0,0,0,Lebanon
40009,12/1/2021,LBN,Pulau Pinang,0,0,0,Lebanon
40010,12/1/2021,LBN,Sabah,0,0,0,Lebanon
40011,12/1/2021,LBN,Sarawak,0,0,0,Lebanon
40012,12/1/2021,LBN,Selangor,14,8,6,Lebanon
40013,12/1/2021,LBN,W.P. Labuan,0,0,0,Lebanon
40014,12/1/2021,LBR,Johor,0,0,0,Liberia
40015,12/1/2021,LBR,Kedah,0,0,0,Liberia
40016,12/1/2021,LBR,Sabah,0,0,0,Liberia
40017,12/1/2021,LBR,Sarawak,0,0,0,Liberia
40018,12/1/2021,LBR,Selangor,5,5,0,Liberia
40019,12/1/2021,LBY,Johor,0,0,0,Libyan Arab Jamahiriya
40020,12/1/2021,LBY,Kedah,0,0,0,Libyan Arab Jamahiriya
40021,12/1/2021,LBY,Perlis,0,0,0,Libyan Arab Jamahiriya
40022,12/1/2021,LBY,Pulau Pinang,0,0,0,Libyan Arab Jamahiriya
40023,12/1/2021,LBY,Sabah,0,0,0,Libyan Arab Jamahiriya
40024,12/1/2021,LBY,Sarawak,0,0,0,Libyan Arab Jamahiriya
40025,12/1/2021,LBY,Selangor,194,124,70,Libyan Arab Jamahiriya
40026,12/1/2021,LCA,Johor,0,0,0,Saint Lucia
40027,12/1/2021,LCA,Kedah,0,0,0,Saint Lucia
40028,12/1/2021,LCA,Pulau Pinang,0,0,0,Saint Lucia
40029,12/1/2021,LCA,Sarawak,0,0,0,Saint Lucia
40030,12/1/2021,LCA,Selangor,1,1,0,Saint Lucia
40031,12/1/2021,LIE,Johor,0,0,0,Liechtenstein
40032,12/1/2021,LIE,Kedah,0,0,0,Liechtenstein
40033,12/1/2021,LIE,Perlis,0,0,0,Liechtenstein
40034,12/1/2021,LIE,Pulau Pinang,0,0,0,Liechtenstein
40035,12/1/2021,LIE,Sabah,0,0,0,Liechtenstein
40036,12/1/2021,LIE,Sarawak,0,0,0,Liechtenstein
40037,12/1/2021,LIE,Selangor,1,1,0,Liechtenstein
40038,12/1/2021,LKA,Johor,0,0,0,Sri Lanka
40039,12/1/2021,LKA,Kedah,0,0,0,Sri Lanka
40040,12/1/2021,LKA,Kelantan,0,0,0,Sri Lanka
40041,12/1/2021,LKA,Melaka,0,0,0,Sri Lanka
40042,12/1/2021,LKA,Pahang,0,0,0,Sri Lanka
40043,12/1/2021,LKA,Perak,0,0,0,Sri Lanka
40044,12/1/2021,LKA,Perlis,0,0,0,Sri Lanka
40045,12/1/2021,LKA,Pulau Pinang,0,0,0,Sri Lanka
40046,12/1/2021,LKA,Sabah,0,0,0,Sri Lanka
40047,12/1/2021,LKA,Sarawak,0,0,0,Sri Lanka
40048,12/1/2021,LKA,Selangor,204,119,85,Sri Lanka
40049,12/1/2021,LKA,W.P. Labuan,0,0,0,Sri Lanka
40050,12/1/2021,LSO,Johor,0,0,0,Lesotho
40051,12/1/2021,LSO,Kedah,0,0,0,Lesotho
40052,12/1/2021,LSO,Pulau Pinang,0,0,0,Lesotho
40053,12/1/2021,LSO,Sarawak,0,0,0,Lesotho
40054,12/1/2021,LSO,Selangor,0,0,0,Lesotho
40055,12/1/2021,LTU,Johor,1,0,1,Lithuania
40056,12/1/2021,LTU,Kedah,0,0,0,Lithuania
40057,12/1/2021,LTU,Kelantan,0,0,0,Lithuania
40058,12/1/2021,LTU,Pahang,0,0,0,Lithuania
40059,12/1/2021,LTU,Perak,0,0,0,Lithuania
40060,12/1/2021,LTU,Perlis,0,0,0,Lithuania
40061,12/1/2021,LTU,Pulau Pinang,0,0,0,Lithuania
40062,12/1/2021,LTU,Sabah,0,0,0,Lithuania
40063,12/1/2021,LTU,Sarawak,0,0,0,Lithuania
40064,12/1/2021,LTU,Selangor,15,13,2,Lithuania
40065,12/1/2021,LTU,W.P. Labuan,0,0,0,Lithuania
40066,12/1/2021,LUX,Johor,0,0,0,Luxembourg
40067,12/1/2021,LUX,Kedah,0,0,0,Luxembourg
40068,12/1/2021,LUX,Kelantan,0,0,0,Luxembourg
40069,12/1/2021,LUX,Perak,0,0,0,Luxembourg
40070,12/1/2021,LUX,Perlis,0,0,0,Luxembourg
40071,12/1/2021,LUX,Pulau Pinang,0,0,0,Luxembourg
40072,12/1/2021,LUX,Sabah,0,0,0,Luxembourg
40073,12/1/2021,LUX,Sarawak,0,0,0,Luxembourg
40074,12/1/2021,LUX,Selangor,1,0,1,Luxembourg
40075,12/1/2021,LVA,Johor,0,0,0,Latvia
40076,12/1/2021,LVA,Kedah,0,0,0,Latvia
40077,12/1/2021,LVA,Kelantan,0,0,0,Latvia
40078,12/1/2021,LVA,Pahang,0,0,0,Latvia
40079,12/1/2021,LVA,Perak,0,0,0,Latvia
40080,12/1/2021,LVA,Perlis,0,0,0,Latvia
40081,12/1/2021,LVA,Pulau Pinang,0,0,0,Latvia
40082,12/1/2021,LVA,Sabah,0,0,0,Latvia
40083,12/1/2021,LVA,Sarawak,0,0,0,Latvia
40084,12/1/2021,LVA,Selangor,7,5,2,Latvia
40085,12/1/2021,LVA,W.P. Labuan,0,0,0,Latvia
40086,12/1/2021,MAC,Johor,0,0,0,Macao
40087,12/1/2021,MAC,Pahang,0,0,0,Macao
40088,12/1/2021,MAC,Perak,0,0,0,Macao
40089,12/1/2021,MAC,Selangor,0,0,0,Macao
40090,12/1/2021,MAC,W.P. Labuan,0,0,0,Macao
40091,12/1/2021,MAR,Johor,0,0,0,Morocco
40092,12/1/2021,MAR,Kedah,1,1,0,Morocco
40093,12/1/2021,MAR,Kelantan,0,0,0,Morocco
40094,12/1/2021,MAR,Melaka,0,0,0,Morocco
40095,12/1/2021,MAR,Pahang,0,0,0,Morocco
40096,12/1/2021,MAR,Perak,0,0,0,Morocco
40097,12/1/2021,MAR,Perlis,0,0,0,Morocco
40098,12/1/2021,MAR,Pulau Pinang,0,0,0,Morocco
40099,12/1/2021,MAR,Sabah,0,0,0,Morocco
40100,12/1/2021,MAR,Sarawak,0,0,0,Morocco
40101,12/1/2021,MAR,Selangor,21,5,16,Morocco
40102,12/1/2021,MAR,W.P. Labuan,0,0,0,Morocco
40103,12/1/2021,MCO,Johor,0,0,0,Monaco
40104,12/1/2021,MCO,Kedah,0,0,0,Monaco
40105,12/1/2021,MCO,Sabah,0,0,0,Monaco
40106,12/1/2021,MCO,Selangor,0,0,0,Monaco
40107,12/1/2021,MDA,Johor,0,0,0,"Moldova, Republic of"
40108,12/1/2021,MDA,Kedah,0,0,0,"Moldova, Republic of"
40109,12/1/2021,MDA,Kelantan,0,0,0,"Moldova, Republic of"
40110,12/1/2021,MDA,Negeri Sembilan,0,0,0,"Moldova, Republic of"
40111,12/1/2021,MDA,Perlis,0,0,0,"Moldova, Republic of"
40112,12/1/2021,MDA,Pulau Pinang,0,0,0,"Moldova, Republic of"
40113,12/1/2021,MDA,Sabah,0,0,0,"Moldova, Republic of"
40114,12/1/2021,MDA,Sarawak,0,0,0,"Moldova, Republic of"
40115,12/1/2021,MDA,Selangor,0,0,0,"Moldova, Republic of"
40116,12/1/2021,MDG,Johor,0,0,0,Madagascar
40117,12/1/2021,MDG,Kedah,0,0,0,Madagascar
40118,12/1/2021,MDG,Perak,0,0,0,Madagascar
40119,12/1/2021,MDG,Perlis,0,0,0,Madagascar
40120,12/1/2021,MDG,Pulau Pinang,0,0,0,Madagascar
40121,12/1/2021,MDG,Sabah,0,0,0,Madagascar
40122,12/1/2021,MDG,Sarawak,0,0,0,Madagascar
40123,12/1/2021,MDG,Selangor,0,0,0,Madagascar
40124,12/1/2021,MDV,Johor,0,0,0,Maldives
40125,12/1/2021,MDV,Kedah,4,3,1,Maldives
40126,12/1/2021,MDV,Kelantan,0,0,0,Maldives
40127,12/1/2021,MDV,Perak,0,0,0,Maldives
40128,12/1/2021,MDV,Perlis,0,0,0,Maldives
40129,12/1/2021,MDV,Pulau Pinang,0,0,0,Maldives
40130,12/1/2021,MDV,Sabah,0,0,0,Maldives
40131,12/1/2021,MDV,Sarawak,0,0,0,Maldives
40132,12/1/2021,MDV,Selangor,223,99,124,Maldives
40133,12/1/2021,MEX,Johor,0,0,0,Mexico
40134,12/1/2021,MEX,Kedah,0,0,0,Mexico
40135,12/1/2021,MEX,Kelantan,0,0,0,Mexico
40136,12/1/2021,MEX,Pahang,0,0,0,Mexico
40137,12/1/2021,MEX,Perak,0,0,0,Mexico
40138,12/1/2021,MEX,Perlis,0,0,0,Mexico
40139,12/1/2021,MEX,Pulau Pinang,0,0,0,Mexico
40140,12/1/2021,MEX,Sabah,0,0,0,Mexico
40141,12/1/2021,MEX,Sarawak,0,0,0,Mexico
40142,12/1/2021,MEX,Selangor,22,12,10,Mexico
40143,12/1/2021,MEX,W.P. Labuan,0,0,0,Mexico
40144,12/1/2021,MHL,Johor,0,0,0,Marshall Islands
40145,12/1/2021,MHL,Kedah,0,0,0,Marshall Islands
40146,12/1/2021,MHL,Perak,0,0,0,Marshall Islands
40147,12/1/2021,MHL,Pulau Pinang,0,0,0,Marshall Islands
40148,12/1/2021,MHL,Sabah,0,0,0,Marshall Islands
40149,12/1/2021,MHL,Selangor,0,0,0,Marshall Islands
40150,12/1/2021,MKD,Johor,0,0,0,"Macedonia, the former Yugoslav Republic of"
40151,12/1/2021,MKD,Kedah,0,0,0,"Macedonia, the former Yugoslav Republic of"
40152,12/1/2021,MKD,Perak,0,0,0,"Macedonia, the former Yugoslav Republic of"
40153,12/1/2021,MKD,Pulau Pinang,0,0,0,"Macedonia, the former Yugoslav Republic of"
40154,12/1/2021,MKD,Sabah,0,0,0,"Macedonia, the former Yugoslav Republic of"
40155,12/1/2021,MKD,Sarawak,0,0,0,"Macedonia, the former Yugoslav Republic of"
40156,12/1/2021,MKD,Selangor,0,0,0,"Macedonia, the former Yugoslav Republic of"
40157,12/1/2021,MLI,Johor,0,0,0,Mali
40158,12/1/2021,MLI,Sabah,0,0,0,Mali
40159,12/1/2021,MLI,Selangor,1,0,1,Mali
40160,12/1/2021,MLT,Johor,0,0,0,Malta
40161,12/1/2021,MLT,Kedah,0,0,0,Malta
40162,12/1/2021,MLT,Kelantan,0,0,0,Malta
40163,12/1/2021,MLT,Perak,0,0,0,Malta
40164,12/1/2021,MLT,Perlis,0,0,0,Malta
40165,12/1/2021,MLT,Pulau Pinang,0,0,0,Malta
40166,12/1/2021,MLT,Sabah,0,0,0,Malta
40167,12/1/2021,MLT,Sarawak,0,0,0,Malta
40168,12/1/2021,MLT,Selangor,2,2,0,Malta
40169,12/1/2021,MLT,W.P. Labuan,0,0,0,Malta
40170,12/1/2021,MMR,Johor,0,0,0,Myanmar
40171,12/1/2021,MMR,Kedah,0,0,0,Myanmar
40172,12/1/2021,MMR,Kelantan,0,0,0,Myanmar
40173,12/1/2021,MMR,Negeri Sembilan,0,0,0,Myanmar
40174,12/1/2021,MMR,Pahang,0,0,0,Myanmar
40175,12/1/2021,MMR,Perak,0,0,0,Myanmar
40176,12/1/2021,MMR,Perlis,0,0,0,Myanmar
40177,12/1/2021,MMR,Pulau Pinang,0,0,0,Myanmar
40178,12/1/2021,MMR,Sabah,0,0,0,Myanmar
40179,12/1/2021,MMR,Sarawak,0,0,0,Myanmar
40180,12/1/2021,MMR,Selangor,341,295,46,Myanmar
40181,12/1/2021,MMR,Terengganu,0,0,0,Myanmar
40182,12/1/2021,MMR,W.P. Labuan,0,0,0,Myanmar
40183,12/1/2021,MNE,Johor,0,0,0,Montenegro
40184,12/1/2021,MNE,Kedah,0,0,0,Montenegro
40185,12/1/2021,MNE,Pulau Pinang,0,0,0,Montenegro
40186,12/1/2021,MNE,Sabah,0,0,0,Montenegro
40187,12/1/2021,MNE,Sarawak,0,0,0,Montenegro
40188,12/1/2021,MNE,Selangor,8,8,0,Montenegro
40189,12/1/2021,MNG,Johor,0,0,0,Mongolia
40190,12/1/2021,MNG,Kedah,0,0,0,Mongolia
40191,12/1/2021,MNG,Kelantan,0,0,0,Mongolia
40192,12/1/2021,MNG,Perak,0,0,0,Mongolia
40193,12/1/2021,MNG,Perlis,0,0,0,Mongolia
40194,12/1/2021,MNG,Pulau Pinang,0,0,0,Mongolia
40195,12/1/2021,MNG,Sabah,0,0,0,Mongolia
40196,12/1/2021,MNG,Sarawak,0,0,0,Mongolia
40197,12/1/2021,MNG,Selangor,7,2,5,Mongolia
40198,12/1/2021,MNP,Selangor,0,0,0,Northern Mariana Islands
40199,12/1/2021,MOZ,Johor,0,0,0,Mozambique
40200,12/1/2021,MOZ,Kedah,0,0,0,Mozambique
40201,12/1/2021,MOZ,Perak,0,0,0,Mozambique
40202,12/1/2021,MOZ,Pulau Pinang,0,0,0,Mozambique
40203,12/1/2021,MOZ,Sabah,0,0,0,Mozambique
40204,12/1/2021,MOZ,Sarawak,0,0,0,Mozambique
40205,12/1/2021,MOZ,Selangor,0,0,0,Mozambique
40206,12/1/2021,MRT,Johor,0,0,0,Mauritania
40207,12/1/2021,MRT,Kedah,0,0,0,Mauritania
40208,12/1/2021,MRT,Pulau Pinang,0,0,0,Mauritania
40209,12/1/2021,MRT,Sabah,0,0,0,Mauritania
40210,12/1/2021,MRT,Sarawak,0,0,0,Mauritania
40211,12/1/2021,MRT,Selangor,8,7,1,Mauritania
40212,12/1/2021,MUS,Johor,0,0,0,Mauritius
40213,12/1/2021,MUS,Kedah,0,0,0,Mauritius
40214,12/1/2021,MUS,Kelantan,0,0,0,Mauritius
40215,12/1/2021,MUS,Pahang,0,0,0,Mauritius
40216,12/1/2021,MUS,Perak,0,0,0,Mauritius
40217,12/1/2021,MUS,Perlis,0,0,0,Mauritius
40218,12/1/2021,MUS,Pulau Pinang,0,0,0,Mauritius
40219,12/1/2021,MUS,Sabah,0,0,0,Mauritius
40220,12/1/2021,MUS,Sarawak,0,0,0,Mauritius
40221,12/1/2021,MUS,Selangor,31,15,16,Mauritius
40222,12/1/2021,MWI,Johor,0,0,0,Malawi
40223,12/1/2021,MWI,Pulau Pinang,0,0,0,Malawi
40224,12/1/2021,MWI,Sabah,0,0,0,Malawi
40225,12/1/2021,MWI,Sarawak,0,0,0,Malawi
40226,12/1/2021,MWI,Selangor,0,0,0,Malawi
40227,12/1/2021,MYT,Selangor,0,0,0,Mayotte
40228,12/1/2021,NAM,Johor,0,0,0,Namibia
40229,12/1/2021,NAM,Kedah,0,0,0,Namibia
40230,12/1/2021,NAM,Perak,0,0,0,Namibia
40231,12/1/2021,NAM,Perlis,0,0,0,Namibia
40232,12/1/2021,NAM,Pulau Pinang,0,0,0,Namibia
40233,12/1/2021,NAM,Sabah,0,0,0,Namibia
40234,12/1/2021,NAM,Sarawak,0,0,0,Namibia
40235,12/1/2021,NAM,Selangor,1,1,0,Namibia
40236,12/1/2021,NCL,Selangor,0,0,0,New Caledonia
40237,12/1/2021,NER,Johor,0,0,0,Niger
40238,12/1/2021,NER,Sabah,0,0,0,Niger
40239,12/1/2021,NER,Selangor,0,0,0,Niger
40240,12/1/2021,NGA,Johor,0,0,0,Nigeria
40241,12/1/2021,NGA,Kedah,0,0,0,Nigeria
40242,12/1/2021,NGA,Perlis,0,0,0,Nigeria
40243,12/1/2021,NGA,Pulau Pinang,0,0,0,Nigeria
40244,12/1/2021,NGA,Sabah,0,0,0,Nigeria
40245,12/1/2021,NGA,Sarawak,4,2,2,Nigeria
40246,12/1/2021,NGA,Selangor,169,145,24,Nigeria
40247,12/1/2021,NIC,Johor,0,0,0,Nicaragua
40248,12/1/2021,NIC,Kedah,0,0,0,Nicaragua
40249,12/1/2021,NIC,Pulau Pinang,0,0,0,Nicaragua
40250,12/1/2021,NIC,Sabah,0,0,0,Nicaragua
40251,12/1/2021,NIC,Selangor,0,0,0,Nicaragua
40252,12/1/2021,NLD,Johor,0,0,0,Netherlands
40253,12/1/2021,NLD,Kedah,1,0,1,Netherlands
40254,12/1/2021,NLD,Kelantan,0,0,0,Netherlands
40255,12/1/2021,NLD,Melaka,0,0,0,Netherlands
40256,12/1/2021,NLD,Negeri Sembilan,0,0,0,Netherlands
40257,12/1/2021,NLD,Pahang,0,0,0,Netherlands
40258,12/1/2021,NLD,Perak,0,0,0,Netherlands
40259,12/1/2021,NLD,Perlis,0,0,0,Netherlands
40260,12/1/2021,NLD,Pulau Pinang,3,1,2,Netherlands
40261,12/1/2021,NLD,Sabah,1,1,0,Netherlands
40262,12/1/2021,NLD,Sarawak,2,2,0,Netherlands
40263,12/1/2021,NLD,Selangor,163,128,35,Netherlands
40264,12/1/2021,NLD,Terengganu,0,0,0,Netherlands
40265,12/1/2021,NLD,W.P. Labuan,0,0,0,Netherlands
40266,12/1/2021,NOR,Johor,0,0,0,Norway
40267,12/1/2021,NOR,Kedah,0,0,0,Norway
40268,12/1/2021,NOR,Kelantan,0,0,0,Norway
40269,12/1/2021,NOR,Melaka,0,0,0,Norway
40270,12/1/2021,NOR,Pahang,0,0,0,Norway
40271,12/1/2021,NOR,Perak,0,0,0,Norway
40272,12/1/2021,NOR,Perlis,0,0,0,Norway
40273,12/1/2021,NOR,Pulau Pinang,1,1,0,Norway
40274,12/1/2021,NOR,Sabah,0,0,0,Norway
40275,12/1/2021,NOR,Sarawak,1,1,0,Norway
40276,12/1/2021,NOR,Selangor,54,39,15,Norway
40277,12/1/2021,NOR,W.P. Labuan,0,0,0,Norway
40278,12/1/2021,NPL,Johor,0,0,0,Nepal
40279,12/1/2021,NPL,Kedah,0,0,0,Nepal
40280,12/1/2021,NPL,Pahang,0,0,0,Nepal
40281,12/1/2021,NPL,Perak,0,0,0,Nepal
40282,12/1/2021,NPL,Perlis,0,0,0,Nepal
40283,12/1/2021,NPL,Pulau Pinang,1,1,0,Nepal
40284,12/1/2021,NPL,Sabah,0,0,0,Nepal
40285,12/1/2021,NPL,Sarawak,0,0,0,Nepal
40286,12/1/2021,NPL,Selangor,599,570,29,Nepal
40287,12/1/2021,NPL,W.P. Labuan,0,0,0,Nepal
40288,12/1/2021,NRU,Johor,0,0,0,Nauru
40289,12/1/2021,NRU,Pulau Pinang,0,0,0,Nauru
40290,12/1/2021,NRU,Selangor,0,0,0,Nauru
40291,12/1/2021,NZL,Johor,0,0,0,New Zealand
40292,12/1/2021,NZL,Kedah,1,0,1,New Zealand
40293,12/1/2021,NZL,Kelantan,0,0,0,New Zealand
40294,12/1/2021,NZL,Melaka,0,0,0,New Zealand
40295,12/1/2021,NZL,Negeri Sembilan,0,0,0,New Zealand
40296,12/1/2021,NZL,Pahang,0,0,0,New Zealand
40297,12/1/2021,NZL,Perak,0,0,0,New Zealand
40298,12/1/2021,NZL,Perlis,0,0,0,New Zealand
40299,12/1/2021,NZL,Pulau Pinang,0,0,0,New Zealand
40300,12/1/2021,NZL,Sabah,1,1,0,New Zealand
40301,12/1/2021,NZL,Sarawak,0,0,0,New Zealand
40302,12/1/2021,NZL,Selangor,95,66,29,New Zealand
40303,12/1/2021,NZL,Terengganu,0,0,0,New Zealand
40304,12/1/2021,NZL,W.P. Labuan,0,0,0,New Zealand
40305,12/1/2021,OMN,Johor,0,0,0,Oman
40306,12/1/2021,OMN,Kedah,0,0,0,Oman
40307,12/1/2021,OMN,Kelantan,0,0,0,Oman
40308,12/1/2021,OMN,Melaka,0,0,0,Oman
40309,12/1/2021,OMN,Perak,0,0,0,Oman
40310,12/1/2021,OMN,Perlis,0,0,0,Oman
40311,12/1/2021,OMN,Pulau Pinang,0,0,0,Oman
40312,12/1/2021,OMN,Sabah,0,0,0,Oman
40313,12/1/2021,OMN,Sarawak,0,0,0,Oman
40314,12/1/2021,OMN,Selangor,38,28,10,Oman
40315,12/1/2021,PAK,Johor,0,0,0,Pakistan
40316,12/1/2021,PAK,Kedah,0,0,0,Pakistan
40317,12/1/2021,PAK,Kelantan,0,0,0,Pakistan
40318,12/1/2021,PAK,Melaka,0,0,0,Pakistan
40319,12/1/2021,PAK,Negeri Sembilan,0,0,0,Pakistan
40320,12/1/2021,PAK,Pahang,0,0,0,Pakistan
40321,12/1/2021,PAK,Perak,0,0,0,Pakistan
40322,12/1/2021,PAK,Perlis,0,0,0,Pakistan
40323,12/1/2021,PAK,Pulau Pinang,0,0,0,Pakistan
40324,12/1/2021,PAK,Sabah,0,0,0,Pakistan
40325,12/1/2021,PAK,Sarawak,2,2,0,Pakistan
40326,12/1/2021,PAK,Selangor,2812,2519,293,Pakistan
40327,12/1/2021,PAK,W.P. Labuan,0,0,0,Pakistan
40328,12/1/2021,PAN,Johor,0,0,0,Panama
40329,12/1/2021,PAN,Kedah,0,0,0,Panama
40330,12/1/2021,PAN,Perak,0,0,0,Panama
40331,12/1/2021,PAN,Perlis,0,0,0,Panama
40332,12/1/2021,PAN,Pulau Pinang,0,0,0,Panama
40333,12/1/2021,PAN,Sabah,0,0,0,Panama
40334,12/1/2021,PAN,Sarawak,0,0,0,Panama
40335,12/1/2021,PAN,Selangor,1,0,1,Panama
40336,12/1/2021,PER,Johor,0,0,0,Peru
40337,12/1/2021,PER,Kedah,0,0,0,Peru
40338,12/1/2021,PER,Kelantan,0,0,0,Peru
40339,12/1/2021,PER,Pahang,0,0,0,Peru
40340,12/1/2021,PER,Perak,0,0,0,Peru
40341,12/1/2021,PER,Perlis,0,0,0,Peru
40342,12/1/2021,PER,Pulau Pinang,0,0,0,Peru
40343,12/1/2021,PER,Sabah,0,0,0,Peru
40344,12/1/2021,PER,Sarawak,0,0,0,Peru
40345,12/1/2021,PER,Selangor,7,2,5,Peru
40346,12/1/2021,PER,W.P. Labuan,0,0,0,Peru
40347,12/1/2021,PHL,Johor,24,18,6,Philippines
40348,12/1/2021,PHL,Kedah,0,0,0,Philippines
40349,12/1/2021,PHL,Kelantan,0,0,0,Philippines
40350,12/1/2021,PHL,Melaka,0,0,0,Philippines
40351,12/1/2021,PHL,Negeri Sembilan,0,0,0,Philippines
40352,12/1/2021,PHL,Pahang,0,0,0,Philippines
40353,12/1/2021,PHL,Perak,0,0,0,Philippines
40354,12/1/2021,PHL,Perlis,0,0,0,Philippines
40355,12/1/2021,PHL,Pulau Pinang,5,4,1,Philippines
40356,12/1/2021,PHL,Sabah,4,0,4,Philippines
40357,12/1/2021,PHL,Sarawak,23,18,5,Philippines
40358,12/1/2021,PHL,Selangor,1108,649,459,Philippines
40359,12/1/2021,PHL,Terengganu,0,0,0,Philippines
40360,12/1/2021,PHL,W.P. Labuan,9,9,0,Philippines
40361,12/1/2021,PLW,Johor,0,0,0,Palau
40362,12/1/2021,PLW,Pulau Pinang,0,0,0,Palau
40363,12/1/2021,PLW,Selangor,0,0,0,Palau
40364,12/1/2021,PNG,Johor,0,0,0,Papua New Guinea
40365,12/1/2021,PNG,Kedah,1,0,1,Papua New Guinea
40366,12/1/2021,PNG,Kelantan,0,0,0,Papua New Guinea
40367,12/1/2021,PNG,Perak,0,0,0,Papua New Guinea
40368,12/1/2021,PNG,Pulau Pinang,0,0,0,Papua New Guinea
40369,12/1/2021,PNG,Sabah,0,0,0,Papua New Guinea
40370,12/1/2021,PNG,Sarawak,0,0,0,Papua New Guinea
40371,12/1/2021,PNG,Selangor,2,1,1,Papua New Guinea
40372,12/1/2021,POL,Johor,0,0,0,Poland
40373,12/1/2021,POL,Kedah,1,0,1,Poland
40374,12/1/2021,POL,Kelantan,0,0,0,Poland
40375,12/1/2021,POL,Melaka,0,0,0,Poland
40376,12/1/2021,POL,Negeri Sembilan,0,0,0,Poland
40377,12/1/2021,POL,Pahang,0,0,0,Poland
40378,12/1/2021,POL,Perak,0,0,0,Poland
40379,12/1/2021,POL,Perlis,0,0,0,Poland
40380,12/1/2021,POL,Pulau Pinang,0,0,0,Poland
40381,12/1/2021,POL,Sabah,0,0,0,Poland
40382,12/1/2021,POL,Sarawak,0,0,0,Poland
40383,12/1/2021,POL,Selangor,29,21,8,Poland
40384,12/1/2021,POL,Terengganu,0,0,0,Poland
40385,12/1/2021,POL,W.P. Labuan,0,0,0,Poland
40386,12/1/2021,PRK,Selangor,0,0,0,"Korea, Democratic People's Republic of"
40387,12/1/2021,PRT,Johor,0,0,0,Portugal
40388,12/1/2021,PRT,Kedah,0,0,0,Portugal
40389,12/1/2021,PRT,Kelantan,0,0,0,Portugal
40390,12/1/2021,PRT,Melaka,0,0,0,Portugal
40391,12/1/2021,PRT,Pahang,0,0,0,Portugal
40392,12/1/2021,PRT,Perak,0,0,0,Portugal
40393,12/1/2021,PRT,Perlis,0,0,0,Portugal
40394,12/1/2021,PRT,Pulau Pinang,1,1,0,Portugal
40395,12/1/2021,PRT,Sabah,0,0,0,Portugal
40396,12/1/2021,PRT,Sarawak,0,0,0,Portugal
40397,12/1/2021,PRT,Selangor,31,20,11,Portugal
40398,12/1/2021,PRT,W.P. Labuan,0,0,0,Portugal
40399,12/1/2021,PRY,Johor,0,0,0,Paraguay
40400,12/1/2021,PRY,Kedah,0,0,0,Paraguay
40401,12/1/2021,PRY,Perak,0,0,0,Paraguay
40402,12/1/2021,PRY,Perlis,0,0,0,Paraguay
40403,12/1/2021,PRY,Pulau Pinang,0,0,0,Paraguay
40404,12/1/2021,PRY,Sabah,0,0,0,Paraguay
40405,12/1/2021,PRY,Sarawak,0,0,0,Paraguay
40406,12/1/2021,PRY,Selangor,0,0,0,Paraguay
40407,12/1/2021,PSE,Johor,0,0,0,"Palestinian Territory, Occupied"
40408,12/1/2021,PSE,Kedah,0,0,0,"Palestinian Territory, Occupied"
40409,12/1/2021,PSE,Kelantan,0,0,0,"Palestinian Territory, Occupied"
40410,12/1/2021,PSE,Melaka,0,0,0,"Palestinian Territory, Occupied"
40411,12/1/2021,PSE,Perak,0,0,0,"Palestinian Territory, Occupied"
40412,12/1/2021,PSE,Perlis,0,0,0,"Palestinian Territory, Occupied"
40413,12/1/2021,PSE,Pulau Pinang,0,0,0,"Palestinian Territory, Occupied"
40414,12/1/2021,PSE,Sabah,0,0,0,"Palestinian Territory, Occupied"
40415,12/1/2021,PSE,Sarawak,0,0,0,"Palestinian Territory, Occupied"
40416,12/1/2021,PSE,Selangor,61,49,12,"Palestinian Territory, Occupied"
40417,12/1/2021,QAT,Johor,0,0,0,Qatar
40418,12/1/2021,QAT,Kedah,0,0,0,Qatar
40419,12/1/2021,QAT,Perlis,0,0,0,Qatar
40420,12/1/2021,QAT,Pulau Pinang,0,0,0,Qatar
40421,12/1/2021,QAT,Sabah,0,0,0,Qatar
40422,12/1/2021,QAT,Sarawak,0,0,0,Qatar
40423,12/1/2021,QAT,Selangor,1,1,0,Qatar
40424,12/1/2021,REU,Johor,0,0,0,Reunion
40425,12/1/2021,REU,Sarawak,0,0,0,Reunion
40426,12/1/2021,ROU,Johor,2,2,0,Romania
40427,12/1/2021,ROU,Kedah,0,0,0,Romania
40428,12/1/2021,ROU,Kelantan,0,0,0,Romania
40429,12/1/2021,ROU,Negeri Sembilan,0,0,0,Romania
40430,12/1/2021,ROU,Pahang,0,0,0,Romania
40431,12/1/2021,ROU,Perak,0,0,0,Romania
40432,12/1/2021,ROU,Perlis,0,0,0,Romania
40433,12/1/2021,ROU,Pulau Pinang,0,0,0,Romania
40434,12/1/2021,ROU,Sabah,0,0,0,Romania
40435,12/1/2021,ROU,Sarawak,0,0,0,Romania
40436,12/1/2021,ROU,Selangor,29,23,6,Romania
40437,12/1/2021,ROU,W.P. Labuan,0,0,0,Romania
40438,12/1/2021,RUS,Johor,0,0,0,Russia
40439,12/1/2021,RUS,Kedah,0,0,0,Russia
40440,12/1/2021,RUS,Kelantan,0,0,0,Russia
40441,12/1/2021,RUS,Melaka,0,0,0,Russia
40442,12/1/2021,RUS,Negeri Sembilan,0,0,0,Russia
40443,12/1/2021,RUS,Pahang,0,0,0,Russia
40444,12/1/2021,RUS,Perak,0,0,0,Russia
40445,12/1/2021,RUS,Perlis,0,0,0,Russia
40446,12/1/2021,RUS,Pulau Pinang,0,0,0,Russia
40447,12/1/2021,RUS,Sabah,0,0,0,Russia
40448,12/1/2021,RUS,Sarawak,8,7,1,Russia
40449,12/1/2021,RUS,Selangor,113,77,36,Russia
40450,12/1/2021,RUS,W.P. Labuan,0,0,0,Russia
40451,12/1/2021,RWA,Johor,0,0,0,Rwanda
40452,12/1/2021,RWA,Kedah,0,0,0,Rwanda
40453,12/1/2021,RWA,Pulau Pinang,0,0,0,Rwanda
40454,12/1/2021,RWA,Selangor,2,1,1,Rwanda
40455,12/1/2021,SAU,Johor,0,0,0,Saudi Arabia
40456,12/1/2021,SAU,Kedah,0,0,0,Saudi Arabia
40457,12/1/2021,SAU,Kelantan,0,0,0,Saudi Arabia
40458,12/1/2021,SAU,Melaka,0,0,0,Saudi Arabia
40459,12/1/2021,SAU,Perak,0,0,0,Saudi Arabia
40460,12/1/2021,SAU,Perlis,0,0,0,Saudi Arabia
40461,12/1/2021,SAU,Pulau Pinang,0,0,0,Saudi Arabia
40462,12/1/2021,SAU,Sabah,0,0,0,Saudi Arabia
40463,12/1/2021,SAU,Sarawak,1,1,0,Saudi Arabia
40464,12/1/2021,SAU,Selangor,211,132,79,Saudi Arabia
40465,12/1/2021,SAU,W.P. Labuan,0,0,0,Saudi Arabia
40466,12/1/2021,SDN,Johor,0,0,0,Sudan
40467,12/1/2021,SDN,Kedah,0,0,0,Sudan
40468,12/1/2021,SDN,Kelantan,0,0,0,Sudan
40469,12/1/2021,SDN,Perlis,0,0,0,Sudan
40470,12/1/2021,SDN,Pulau Pinang,0,0,0,Sudan
40471,12/1/2021,SDN,Sabah,0,0,0,Sudan
40472,12/1/2021,SDN,Sarawak,0,0,0,Sudan
40473,12/1/2021,SDN,Selangor,146,95,51,Sudan
40474,12/1/2021,SDN,W.P. Labuan,0,0,0,Sudan
40475,12/1/2021,SEN,Johor,0,0,0,Senegal
40476,12/1/2021,SEN,Kedah,0,0,0,Senegal
40477,12/1/2021,SEN,Kelantan,0,0,0,Senegal
40478,12/1/2021,SEN,Perak,0,0,0,Senegal
40479,12/1/2021,SEN,Perlis,0,0,0,Senegal
40480,12/1/2021,SEN,Pulau Pinang,0,0,0,Senegal
40481,12/1/2021,SEN,Sabah,0,0,0,Senegal
40482,12/1/2021,SEN,Sarawak,0,0,0,Senegal
40483,12/1/2021,SEN,Selangor,4,2,2,Senegal
40484,12/1/2021,SGP,Johor,2642,1423,1219,Singapore
40485,12/1/2021,SGP,Kedah,16,7,9,Singapore
40486,12/1/2021,SGP,Kelantan,0,0,0,Singapore
40487,12/1/2021,SGP,Melaka,0,0,0,Singapore
40488,12/1/2021,SGP,Negeri Sembilan,0,0,0,Singapore
40489,12/1/2021,SGP,Pahang,0,0,0,Singapore
40490,12/1/2021,SGP,Perak,4,2,2,Singapore
40491,12/1/2021,SGP,Perlis,0,0,0,Singapore
40492,12/1/2021,SGP,Pulau Pinang,18,6,12,Singapore
40493,12/1/2021,SGP,Sabah,0,0,0,Singapore
40494,12/1/2021,SGP,Sarawak,28,17,11,Singapore
40495,12/1/2021,SGP,Selangor,10716,6000,4716,Singapore
40496,12/1/2021,SGP,Terengganu,0,0,0,Singapore
40497,12/1/2021,SGP,W.P. Labuan,0,0,0,Singapore
40498,12/1/2021,SGS,Johor,0,0,0,South Georgia and the South Sandwich Islands
40499,12/1/2021,SGS,Sabah,0,0,0,South Georgia and the South Sandwich Islands
40500,12/1/2021,SGS,Selangor,0,0,0,South Georgia and the South Sandwich Islands
40501,12/1/2021,SHN,Sarawak,0,0,0,"Saint Helena, Ascension and Tristan da Cunha"
40502,12/1/2021,SLB,Johor,0,0,0,Solomon Islands
40503,12/1/2021,SLB,Perlis,0,0,0,Solomon Islands
40504,12/1/2021,SLB,Pulau Pinang,0,0,0,Solomon Islands
40505,12/1/2021,SLB,Sabah,0,0,0,Solomon Islands
40506,12/1/2021,SLB,Sarawak,1,1,0,Solomon Islands
40507,12/1/2021,SLB,Selangor,1,1,0,Solomon Islands
40508,12/1/2021,SLB,W.P. Labuan,0,0,0,Solomon Islands
40509,12/1/2021,SLE,Johor,0,0,0,Sierra Leone
40510,12/1/2021,SLE,Kedah,0,0,0,Sierra Leone
40511,12/1/2021,SLE,Perak,0,0,0,Sierra Leone
40512,12/1/2021,SLE,Pulau Pinang,0,0,0,Sierra Leone
40513,12/1/2021,SLE,Sabah,0,0,0,Sierra Leone
40514,12/1/2021,SLE,Selangor,0,0,0,Sierra Leone
40515,12/1/2021,SLV,Johor,0,0,0,El Salvador
40516,12/1/2021,SLV,Kedah,0,0,0,El Salvador
40517,12/1/2021,SLV,Perak,0,0,0,El Salvador
40518,12/1/2021,SLV,Perlis,0,0,0,El Salvador
40519,12/1/2021,SLV,Pulau Pinang,0,0,0,El Salvador
40520,12/1/2021,SLV,Sabah,0,0,0,El Salvador
40521,12/1/2021,SLV,Selangor,0,0,0,El Salvador
40522,12/1/2021,SLV,W.P. Labuan,0,0,0,El Salvador
40523,12/1/2021,SMR,Johor,0,0,0,San Marino
40524,12/1/2021,SMR,Selangor,0,0,0,San Marino
40525,12/1/2021,SOM,Johor,0,0,0,Somalia
40526,12/1/2021,SOM,Kedah,0,0,0,Somalia
40527,12/1/2021,SOM,Kelantan,0,0,0,Somalia
40528,12/1/2021,SOM,Perlis,0,0,0,Somalia
40529,12/1/2021,SOM,Sabah,0,0,0,Somalia
40530,12/1/2021,SOM,Sarawak,0,0,0,Somalia
40531,12/1/2021,SOM,Selangor,80,51,29,Somalia
40532,12/1/2021,SRB,Johor,0,0,0,Serbia
40533,12/1/2021,SRB,Kedah,0,0,0,Serbia
40534,12/1/2021,SRB,Kelantan,0,0,0,Serbia
40535,12/1/2021,SRB,Pahang,0,0,0,Serbia
40536,12/1/2021,SRB,Perak,0,0,0,Serbia
40537,12/1/2021,SRB,Perlis,0,0,0,Serbia
40538,12/1/2021,SRB,Pulau Pinang,0,0,0,Serbia
40539,12/1/2021,SRB,Sabah,0,0,0,Serbia
40540,12/1/2021,SRB,Sarawak,0,0,0,Serbia
40541,12/1/2021,SRB,Selangor,5,5,0,Serbia
40542,12/1/2021,STP,Selangor,0,0,0,Sao Tome and Principe
40543,12/1/2021,SUR,Johor,0,0,0,Suriname
40544,12/1/2021,SUR,Kedah,0,0,0,Suriname
40545,12/1/2021,SUR,Kelantan,0,0,0,Suriname
40546,12/1/2021,SUR,Perak,0,0,0,Suriname
40547,12/1/2021,SUR,Perlis,0,0,0,Suriname
40548,12/1/2021,SUR,Pulau Pinang,0,0,0,Suriname
40549,12/1/2021,SUR,Sabah,0,0,0,Suriname
40550,12/1/2021,SUR,Sarawak,0,0,0,Suriname
40551,12/1/2021,SUR,Selangor,0,0,0,Suriname
40552,12/1/2021,SVK,Johor,0,0,0,Slovakia
40553,12/1/2021,SVK,Kedah,0,0,0,Slovakia
40554,12/1/2021,SVK,Kelantan,0,0,0,Slovakia
40555,12/1/2021,SVK,Negeri Sembilan,0,0,0,Slovakia
40556,12/1/2021,SVK,Pahang,0,0,0,Slovakia
40557,12/1/2021,SVK,Perak,0,0,0,Slovakia
40558,12/1/2021,SVK,Perlis,0,0,0,Slovakia
40559,12/1/2021,SVK,Pulau Pinang,0,0,0,Slovakia
40560,12/1/2021,SVK,Sabah,0,0,0,Slovakia
40561,12/1/2021,SVK,Sarawak,0,0,0,Slovakia
40562,12/1/2021,SVK,Selangor,10,4,6,Slovakia
40563,12/1/2021,SVK,W.P. Labuan,0,0,0,Slovakia
40564,12/1/2021,SVN,Johor,0,0,0,Slovenia
40565,12/1/2021,SVN,Kedah,0,0,0,Slovenia
40566,12/1/2021,SVN,Kelantan,0,0,0,Slovenia
40567,12/1/2021,SVN,Perak,0,0,0,Slovenia
40568,12/1/2021,SVN,Perlis,0,0,0,Slovenia
40569,12/1/2021,SVN,Pulau Pinang,0,0,0,Slovenia
40570,12/1/2021,SVN,Sabah,0,0,0,Slovenia
40571,12/1/2021,SVN,Sarawak,0,0,0,Slovenia
40572,12/1/2021,SVN,Selangor,3,2,1,Slovenia
40573,12/1/2021,SVN,W.P. Labuan,0,0,0,Slovenia
40574,12/1/2021,SWE,Johor,0,0,0,Sweden
40575,12/1/2021,SWE,Kedah,0,0,0,Sweden
40576,12/1/2021,SWE,Kelantan,0,0,0,Sweden
40577,12/1/2021,SWE,Melaka,0,0,0,Sweden
40578,12/1/2021,SWE,Negeri Sembilan,0,0,0,Sweden
40579,12/1/2021,SWE,Pahang,0,0,0,Sweden
40580,12/1/2021,SWE,Perak,0,0,0,Sweden
40581,12/1/2021,SWE,Perlis,0,0,0,Sweden
40582,12/1/2021,SWE,Pulau Pinang,3,1,2,Sweden
40583,12/1/2021,SWE,Sabah,0,0,0,Sweden
40584,12/1/2021,SWE,Sarawak,0,0,0,Sweden
40585,12/1/2021,SWE,Selangor,79,54,25,Sweden
40586,12/1/2021,SWE,W.P. Labuan,0,0,0,Sweden
40587,12/1/2021,SWZ,Johor,0,0,0,Swaziland
40588,12/1/2021,SWZ,Kedah,0,0,0,Swaziland
40589,12/1/2021,SWZ,Pulau Pinang,0,0,0,Swaziland
40590,12/1/2021,SWZ,Sabah,0,0,0,Swaziland
40591,12/1/2021,SWZ,Selangor,1,1,0,Swaziland
40592,12/1/2021,SYC,Johor,0,0,0,Seychelles
40593,12/1/2021,SYC,Kedah,0,0,0,Seychelles
40594,12/1/2021,SYC,Pulau Pinang,0,0,0,Seychelles
40595,12/1/2021,SYC,Sabah,0,0,0,Seychelles
40596,12/1/2021,SYC,Sarawak,1,1,0,Seychelles
40597,12/1/2021,SYC,Selangor,12,3,9,Seychelles
40598,12/1/2021,SYR,Johor,0,0,0,Syrian Arab Republic
40599,12/1/2021,SYR,Kedah,0,0,0,Syrian Arab Republic
40600,12/1/2021,SYR,Kelantan,0,0,0,Syrian Arab Republic
40601,12/1/2021,SYR,Pahang,0,0,0,Syrian Arab Republic
40602,12/1/2021,SYR,Perlis,0,0,0,Syrian Arab Republic
40603,12/1/2021,SYR,Pulau Pinang,0,0,0,Syrian Arab Republic
40604,12/1/2021,SYR,Sabah,0,0,0,Syrian Arab Republic
40605,12/1/2021,SYR,Sarawak,0,0,0,Syrian Arab Republic
40606,12/1/2021,SYR,Selangor,90,55,35,Syrian Arab Republic
40607,12/1/2021,SYR,W.P. Labuan,0,0,0,Syrian Arab Republic
40608,12/1/2021,TCA,Perlis,0,0,0,Turks and Caicos
40609,12/1/2021,TCD,Johor,0,0,0,Chad
40610,12/1/2021,TCD,Kedah,0,0,0,Chad
40611,12/1/2021,TCD,Perlis,0,0,0,Chad
40612,12/1/2021,TCD,Selangor,4,3,1,Chad
40613,12/1/2021,TGO,Johor,0,0,0,Togo
40614,12/1/2021,TGO,Perak,0,0,0,Togo
40615,12/1/2021,TGO,Pulau Pinang,0,0,0,Togo
40616,12/1/2021,TGO,Selangor,0,0,0,Togo
40617,12/1/2021,THA,Johor,44,43,1,Thailand
40618,12/1/2021,THA,Kedah,18122,18065,57,Thailand
40619,12/1/2021,THA,Kelantan,0,0,0,Thailand
40620,12/1/2021,THA,Melaka,0,0,0,Thailand
40621,12/1/2021,THA,Negeri Sembilan,0,0,0,Thailand
40622,12/1/2021,THA,Pahang,0,0,0,Thailand
40623,12/1/2021,THA,Perak,0,0,0,Thailand
40624,12/1/2021,THA,Perlis,9207,9060,147,Thailand
40625,12/1/2021,THA,Pulau Pinang,77,73,4,Thailand
40626,12/1/2021,THA,Sabah,0,0,0,Thailand
40627,12/1/2021,THA,Sarawak,9,8,1,Thailand
40628,12/1/2021,THA,Selangor,583,183,400,Thailand
40629,12/1/2021,THA,Terengganu,0,0,0,Thailand
40630,12/1/2021,THA,W.P. Labuan,0,0,0,Thailand
40631,12/1/2021,TJK,Johor,0,0,0,Tajikistan
40632,12/1/2021,TJK,Kedah,0,0,0,Tajikistan
40633,12/1/2021,TJK,Perlis,0,0,0,Tajikistan
40634,12/1/2021,TJK,Pulau Pinang,0,0,0,Tajikistan
40635,12/1/2021,TJK,Sabah,0,0,0,Tajikistan
40636,12/1/2021,TJK,Selangor,8,4,4,Tajikistan
40637,12/1/2021,TKL,Selangor,0,0,0,Tokelau
40638,12/1/2021,TKM,Johor,0,0,0,Turkmenistan
40639,12/1/2021,TKM,Kedah,0,0,0,Turkmenistan
40640,12/1/2021,TKM,Kelantan,0,0,0,Turkmenistan
40641,12/1/2021,TKM,Perlis,0,0,0,Turkmenistan
40642,12/1/2021,TKM,Pulau Pinang,0,0,0,Turkmenistan
40643,12/1/2021,TKM,Sabah,0,0,0,Turkmenistan
40644,12/1/2021,TKM,Sarawak,0,0,0,Turkmenistan
40645,12/1/2021,TKM,Selangor,9,6,3,Turkmenistan
40646,12/1/2021,TLS,Johor,0,0,0,Timor-Leste
40647,12/1/2021,TLS,Kedah,0,0,0,Timor-Leste
40648,12/1/2021,TLS,Perlis,0,0,0,Timor-Leste
40649,12/1/2021,TLS,Pulau Pinang,0,0,0,Timor-Leste
40650,12/1/2021,TLS,Sabah,0,0,0,Timor-Leste
40651,12/1/2021,TLS,Sarawak,0,0,0,Timor-Leste
40652,12/1/2021,TLS,Selangor,7,2,5,Timor-Leste
40653,12/1/2021,TON,Johor,0,0,0,Tonga
40654,12/1/2021,TON,Pulau Pinang,0,0,0,Tonga
40655,12/1/2021,TON,Sarawak,0,0,0,Tonga
40656,12/1/2021,TON,Selangor,0,0,0,Tonga
40657,12/1/2021,TTO,Johor,0,0,0,Trinidad and Tobago
40658,12/1/2021,TTO,Kedah,0,0,0,Trinidad and Tobago
40659,12/1/2021,TTO,Pahang,0,0,0,Trinidad and Tobago
40660,12/1/2021,TTO,Pulau Pinang,0,0,0,Trinidad and Tobago
40661,12/1/2021,TTO,Sabah,0,0,0,Trinidad and Tobago
40662,12/1/2021,TTO,Sarawak,0,0,0,Trinidad and Tobago
40663,12/1/2021,TTO,Selangor,0,0,0,Trinidad and Tobago
40664,12/1/2021,TUN,Johor,0,0,0,Tunisia
40665,12/1/2021,TUN,Kedah,0,0,0,Tunisia
40666,12/1/2021,TUN,Kelantan,0,0,0,Tunisia
40667,12/1/2021,TUN,Melaka,0,0,0,Tunisia
40668,12/1/2021,TUN,Perak,0,0,0,Tunisia
40669,12/1/2021,TUN,Perlis,0,0,0,Tunisia
40670,12/1/2021,TUN,Pulau Pinang,0,0,0,Tunisia
40671,12/1/2021,TUN,Sabah,0,0,0,Tunisia
40672,12/1/2021,TUN,Sarawak,0,0,0,Tunisia
40673,12/1/2021,TUN,Selangor,11,5,6,Tunisia
40674,12/1/2021,TUN,W.P. Labuan,0,0,0,Tunisia
40675,12/1/2021,TUR,Johor,0,0,0,Turkey
40676,12/1/2021,TUR,Kedah,0,0,0,Turkey
40677,12/1/2021,TUR,Kelantan,0,0,0,Turkey
40678,12/1/2021,TUR,Melaka,0,0,0,Turkey
40679,12/1/2021,TUR,Negeri Sembilan,0,0,0,Turkey
40680,12/1/2021,TUR,Pahang,0,0,0,Turkey
40681,12/1/2021,TUR,Perak,1,1,0,Turkey
40682,12/1/2021,TUR,Perlis,0,0,0,Turkey
40683,12/1/2021,TUR,Pulau Pinang,0,0,0,Turkey
40684,12/1/2021,TUR,Sabah,0,0,0,Turkey
40685,12/1/2021,TUR,Sarawak,0,0,0,Turkey
40686,12/1/2021,TUR,Selangor,92,73,19,Turkey
40687,12/1/2021,TUR,W.P. Labuan,0,0,0,Turkey
40688,12/1/2021,TUV,Selangor,0,0,0,Tuvalu
40689,12/1/2021,TWN,Johor,4,2,2,Taiwan
40690,12/1/2021,TWN,Kedah,3,1,2,Taiwan
40691,12/1/2021,TWN,Kelantan,0,0,0,Taiwan
40692,12/1/2021,TWN,Melaka,0,0,0,Taiwan
40693,12/1/2021,TWN,Negeri Sembilan,0,0,0,Taiwan
40694,12/1/2021,TWN,Pahang,0,0,0,Taiwan
40695,12/1/2021,TWN,Perak,0,0,0,Taiwan
40696,12/1/2021,TWN,Perlis,0,0,0,Taiwan
40697,12/1/2021,TWN,Pulau Pinang,13,8,5,Taiwan
40698,12/1/2021,TWN,Sabah,1,0,1,Taiwan
40699,12/1/2021,TWN,Sarawak,2,0,2,Taiwan
40700,12/1/2021,TWN,Selangor,205,128,77,Taiwan
40701,12/1/2021,TWN,W.P. Labuan,0,0,0,Taiwan
40702,12/1/2021,TZA,Johor,0,0,0,"Tanzania, United Republic of"
40703,12/1/2021,TZA,Kedah,0,0,0,"Tanzania, United Republic of"
40704,12/1/2021,TZA,Perak,0,0,0,"Tanzania, United Republic of"
40705,12/1/2021,TZA,Perlis,0,0,0,"Tanzania, United Republic of"
40706,12/1/2021,TZA,Pulau Pinang,0,0,0,"Tanzania, United Republic of"
40707,12/1/2021,TZA,Sabah,0,0,0,"Tanzania, United Republic of"
40708,12/1/2021,TZA,Sarawak,0,0,0,"Tanzania, United Republic of"
40709,12/1/2021,TZA,Selangor,36,14,22,"Tanzania, United Republic of"
40710,12/1/2021,UGA,Johor,0,0,0,Uganda
40711,12/1/2021,UGA,Kedah,0,0,0,Uganda
40712,12/1/2021,UGA,Perak,0,0,0,Uganda
40713,12/1/2021,UGA,Perlis,0,0,0,Uganda
40714,12/1/2021,UGA,Pulau Pinang,0,0,0,Uganda
40715,12/1/2021,UGA,Sabah,0,0,0,Uganda
40716,12/1/2021,UGA,Sarawak,0,0,0,Uganda
40717,12/1/2021,UGA,Selangor,15,10,5,Uganda
40718,12/1/2021,UKR,Johor,0,0,0,Ukraine
40719,12/1/2021,UKR,Kedah,0,0,0,Ukraine
40720,12/1/2021,UKR,Kelantan,0,0,0,Ukraine
40721,12/1/2021,UKR,Melaka,0,0,0,Ukraine
40722,12/1/2021,UKR,Negeri Sembilan,0,0,0,Ukraine
40723,12/1/2021,UKR,Pahang,0,0,0,Ukraine
40724,12/1/2021,UKR,Perak,0,0,0,Ukraine
40725,12/1/2021,UKR,Perlis,0,0,0,Ukraine
40726,12/1/2021,UKR,Pulau Pinang,8,8,0,Ukraine
40727,12/1/2021,UKR,Sabah,0,0,0,Ukraine
40728,12/1/2021,UKR,Sarawak,0,0,0,Ukraine
40729,12/1/2021,UKR,Selangor,85,81,4,Ukraine
40730,12/1/2021,UKR,W.P. Labuan,0,0,0,Ukraine
40731,12/1/2021,URY,Johor,0,0,0,Uruguay
40732,12/1/2021,URY,Kedah,0,0,0,Uruguay
40733,12/1/2021,URY,Kelantan,0,0,0,Uruguay
40734,12/1/2021,URY,Perak,0,0,0,Uruguay
40735,12/1/2021,URY,Perlis,0,0,0,Uruguay
40736,12/1/2021,URY,Pulau Pinang,0,0,0,Uruguay
40737,12/1/2021,URY,Sabah,0,0,0,Uruguay
40738,12/1/2021,URY,Sarawak,0,0,0,Uruguay
40739,12/1/2021,URY,Selangor,6,3,3,Uruguay
40740,12/1/2021,URY,W.P. Labuan,0,0,0,Uruguay
40741,12/1/2021,USA,Johor,0,0,0,United States Of America
40742,12/1/2021,USA,Kedah,7,7,0,United States Of America
40743,12/1/2021,USA,Kelantan,0,0,0,United States Of America
40744,12/1/2021,USA,Melaka,0,0,0,United States Of America
40745,12/1/2021,USA,Negeri Sembilan,0,0,0,United States Of America
40746,12/1/2021,USA,Pahang,0,0,0,United States Of America
40747,12/1/2021,USA,Perak,0,0,0,United States Of America
40748,12/1/2021,USA,Perlis,0,0,0,United States Of America
40749,12/1/2021,USA,Pulau Pinang,21,8,13,United States Of America
40750,12/1/2021,USA,Sabah,2,1,1,United States Of America
40751,12/1/2021,USA,Sarawak,7,5,2,United States Of America
40752,12/1/2021,USA,Selangor,704,453,251,United States Of America
40753,12/1/2021,USA,Terengganu,0,0,0,United States Of America
40754,12/1/2021,USA,W.P. Labuan,0,0,0,United States Of America
40755,12/1/2021,UZB,Johor,0,0,0,Uzbekistan
40756,12/1/2021,UZB,Kedah,0,0,0,Uzbekistan
40757,12/1/2021,UZB,Kelantan,0,0,0,Uzbekistan
40758,12/1/2021,UZB,Perak,0,0,0,Uzbekistan
40759,12/1/2021,UZB,Perlis,0,0,0,Uzbekistan
40760,12/1/2021,UZB,Pulau Pinang,0,0,0,Uzbekistan
40761,12/1/2021,UZB,Sabah,0,0,0,Uzbekistan
40762,12/1/2021,UZB,Sarawak,0,0,0,Uzbekistan
40763,12/1/2021,UZB,Selangor,45,30,15,Uzbekistan
40764,12/1/2021,VAT,Johor,0,0,0,Holy See (Vatican City State)
40765,12/1/2021,VAT,Sarawak,0,0,0,Holy See (Vatican City State)
40766,12/1/2021,VAT,Selangor,1,1,0,Holy See (Vatican City State)
40767,12/1/2021,VCT,Johor,0,0,0,Saint Vincent and the Grenadines
40768,12/1/2021,VCT,Kedah,0,0,0,Saint Vincent and the Grenadines
40769,12/1/2021,VCT,Pulau Pinang,0,0,0,Saint Vincent and the Grenadines
40770,12/1/2021,VCT,Sarawak,0,0,0,Saint Vincent and the Grenadines
40771,12/1/2021,VCT,Selangor,0,0,0,Saint Vincent and the Grenadines
40772,12/1/2021,VEN,Johor,0,0,0,Venezuela
40773,12/1/2021,VEN,Kedah,0,0,0,Venezuela
40774,12/1/2021,VEN,Kelantan,0,0,0,Venezuela
40775,12/1/2021,VEN,Melaka,0,0,0,Venezuela
40776,12/1/2021,VEN,Perak,0,0,0,Venezuela
40777,12/1/2021,VEN,Perlis,0,0,0,Venezuela
40778,12/1/2021,VEN,Pulau Pinang,0,0,0,Venezuela
40779,12/1/2021,VEN,Sabah,0,0,0,Venezuela
40780,12/1/2021,VEN,Sarawak,0,0,0,Venezuela
40781,12/1/2021,VEN,Selangor,4,4,0,Venezuela
40782,12/1/2021,VEN,W.P. Labuan,0,0,0,Venezuela
40783,12/1/2021,VNM,Johor,2,0,2,Vietnam
40784,12/1/2021,VNM,Kedah,9,2,7,Vietnam
40785,12/1/2021,VNM,Kelantan,0,0,0,Vietnam
40786,12/1/2021,VNM,Melaka,0,0,0,Vietnam
40787,12/1/2021,VNM,Negeri Sembilan,0,0,0,Vietnam
40788,12/1/2021,VNM,Pahang,0,0,0,Vietnam
40789,12/1/2021,VNM,Perak,1,0,1,Vietnam
40790,12/1/2021,VNM,Perlis,0,0,0,Vietnam
40791,12/1/2021,VNM,Pulau Pinang,3,1,2,Vietnam
40792,12/1/2021,VNM,Sabah,1,0,1,Vietnam
40793,12/1/2021,VNM,Sarawak,2,0,2,Vietnam
40794,12/1/2021,VNM,Selangor,240,63,177,Vietnam
40795,12/1/2021,VNM,Terengganu,0,0,0,Vietnam
40796,12/1/2021,VNM,W.P. Labuan,0,0,0,Vietnam
40797,12/1/2021,VUT,Johor,0,0,0,Vanuatu
40798,12/1/2021,VUT,Kedah,0,0,0,Vanuatu
40799,12/1/2021,VUT,Pulau Pinang,0,0,0,Vanuatu
40800,12/1/2021,VUT,Sabah,0,0,0,Vanuatu
40801,12/1/2021,VUT,Sarawak,0,0,0,Vanuatu
40802,12/1/2021,VUT,Selangor,6,4,2,Vanuatu
40803,12/1/2021,WSM,Johor,0,0,0,Samoa
40804,12/1/2021,WSM,Sarawak,0,0,0,Samoa
40805,12/1/2021,WSM,Selangor,0,0,0,Samoa
40806,12/1/2021,YEM,Johor,0,0,0,Yemen
40807,12/1/2021,YEM,Kedah,2,2,0,Yemen
40808,12/1/2021,YEM,Kelantan,0,0,0,Yemen
40809,12/1/2021,YEM,Melaka,0,0,0,Yemen
40810,12/1/2021,YEM,Pahang,0,0,0,Yemen
40811,12/1/2021,YEM,Perak,0,0,0,Yemen
40812,12/1/2021,YEM,Perlis,0,0,0,Yemen
40813,12/1/2021,YEM,Pulau Pinang,0,0,0,Yemen
40814,12/1/2021,YEM,Sabah,0,0,0,Yemen
40815,12/1/2021,YEM,Sarawak,0,0,0,Yemen
40816,12/1/2021,YEM,Selangor,283,202,81,Yemen
40817,12/1/2021,YEM,W.P. Labuan,0,0,0,Yemen
40818,12/1/2021,ZAF,Johor,0,0,0,South Africa
40819,12/1/2021,ZAF,Kedah,1,1,0,South Africa
40820,12/1/2021,ZAF,Kelantan,0,0,0,South Africa
40821,12/1/2021,ZAF,Melaka,0,0,0,South Africa
40822,12/1/2021,ZAF,Pahang,0,0,0,South Africa
40823,12/1/2021,ZAF,Perak,0,0,0,South Africa
40824,12/1/2021,ZAF,Perlis,0,0,0,South Africa
40825,12/1/2021,ZAF,Pulau Pinang,0,0,0,South Africa
40826,12/1/2021,ZAF,Sabah,0,0,0,South Africa
40827,12/1/2021,ZAF,Sarawak,0,0,0,South Africa
40828,12/1/2021,ZAF,Selangor,37,24,13,South Africa
40829,12/1/2021,ZAF,Terengganu,0,0,0,South Africa
40830,12/1/2021,ZAF,W.P. Labuan,0,0,0,South Africa
40831,12/1/2021,ZMB,Johor,0,0,0,Zambia
40832,12/1/2021,ZMB,Kedah,0,0,0,Zambia
40833,12/1/2021,ZMB,Perak,0,0,0,Zambia
40834,12/1/2021,ZMB,Perlis,0,0,0,Zambia
40835,12/1/2021,ZMB,Pulau Pinang,0,0,0,Zambia
40836,12/1/2021,ZMB,Sabah,0,0,0,Zambia
40837,12/1/2021,ZMB,Sarawak,0,0,0,Zambia
40838,12/1/2021,ZMB,Selangor,6,3,3,Zambia
40839,12/1/2021,ZWE,Johor,0,0,0,Zimbabwe
40840,12/1/2021,ZWE,Kedah,0,0,0,Zimbabwe
40841,12/1/2021,ZWE,Kelantan,0,0,0,Zimbabwe
40842,12/1/2021,ZWE,Perak,0,0,0,Zimbabwe
40843,12/1/2021,ZWE,Perlis,0,0,0,Zimbabwe
40844,12/1/2021,ZWE,Pulau Pinang,0,0,0,Zimbabwe
40845,12/1/2021,ZWE,Sabah,0,0,0,Zimbabwe
40846,12/1/2021,ZWE,Sarawak,0,0,0,Zimbabwe
40847,12/1/2021,ZWE,Selangor,1,0,1,Zimbabwe
40848,1/1/2022,ABW,Kedah,0,0,0,Aruba
40849,1/1/2022,ABW,Pulau Pinang,0,0,0,Aruba
40850,1/1/2022,AFG,Johor,0,0,0,Afghanistan
40851,1/1/2022,AFG,Kedah,0,0,0,Afghanistan
40852,1/1/2022,AFG,Perlis,0,0,0,Afghanistan
40853,1/1/2022,AFG,Pulau Pinang,0,0,0,Afghanistan
40854,1/1/2022,AFG,Sarawak,0,0,0,Afghanistan
40855,1/1/2022,AFG,Selangor,65,52,13,Afghanistan
40856,1/1/2022,AGO,Johor,0,0,0,Angola
40857,1/1/2022,AGO,Kedah,0,0,0,Angola
40858,1/1/2022,AGO,Sabah,0,0,0,Angola
40859,1/1/2022,AGO,Selangor,4,3,1,Angola
40860,1/1/2022,AIA,Selangor,0,0,0,Anguilla
40861,1/1/2022,ALB,Johor,0,0,0,Albania
40862,1/1/2022,ALB,Kedah,0,0,0,Albania
40863,1/1/2022,ALB,Perak,0,0,0,Albania
40864,1/1/2022,ALB,Perlis,0,0,0,Albania
40865,1/1/2022,ALB,Pulau Pinang,0,0,0,Albania
40866,1/1/2022,ALB,Sabah,0,0,0,Albania
40867,1/1/2022,ALB,Sarawak,0,0,0,Albania
40868,1/1/2022,ALB,Selangor,5,4,1,Albania
40869,1/1/2022,AND,Johor,0,0,0,Andorra
40870,1/1/2022,AND,Kedah,0,0,0,Andorra
40871,1/1/2022,AND,Perlis,0,0,0,Andorra
40872,1/1/2022,AND,Pulau Pinang,0,0,0,Andorra
40873,1/1/2022,AND,Selangor,0,0,0,Andorra
40874,1/1/2022,ANT,Selangor,0,0,0,Netherlands Antilles
40875,1/1/2022,ARE,Johor,0,0,0,United Arab Emirates
40876,1/1/2022,ARE,Kedah,0,0,0,United Arab Emirates
40877,1/1/2022,ARE,Kelantan,0,0,0,United Arab Emirates
40878,1/1/2022,ARE,Perak,0,0,0,United Arab Emirates
40879,1/1/2022,ARE,Perlis,0,0,0,United Arab Emirates
40880,1/1/2022,ARE,Pulau Pinang,0,0,0,United Arab Emirates
40881,1/1/2022,ARE,Sabah,0,0,0,United Arab Emirates
40882,1/1/2022,ARE,Sarawak,0,0,0,United Arab Emirates
40883,1/1/2022,ARE,Selangor,10,7,3,United Arab Emirates
40884,1/1/2022,ARG,Johor,0,0,0,Argentina
40885,1/1/2022,ARG,Kedah,0,0,0,Argentina
40886,1/1/2022,ARG,Kelantan,0,0,0,Argentina
40887,1/1/2022,ARG,Melaka,0,0,0,Argentina
40888,1/1/2022,ARG,Perak,0,0,0,Argentina
40889,1/1/2022,ARG,Perlis,0,0,0,Argentina
40890,1/1/2022,ARG,Pulau Pinang,0,0,0,Argentina
40891,1/1/2022,ARG,Sabah,0,0,0,Argentina
40892,1/1/2022,ARG,Sarawak,0,0,0,Argentina
40893,1/1/2022,ARG,Selangor,42,24,18,Argentina
40894,1/1/2022,ARG,W.P. Labuan,0,0,0,Argentina
40895,1/1/2022,ARM,Johor,0,0,0,Armenia
40896,1/1/2022,ARM,Kedah,0,0,0,Armenia
40897,1/1/2022,ARM,Kelantan,0,0,0,Armenia
40898,1/1/2022,ARM,Perak,0,0,0,Armenia
40899,1/1/2022,ARM,Perlis,0,0,0,Armenia
40900,1/1/2022,ARM,Pulau Pinang,0,0,0,Armenia
40901,1/1/2022,ARM,Sabah,0,0,0,Armenia
40902,1/1/2022,ARM,Sarawak,0,0,0,Armenia
40903,1/1/2022,ARM,Selangor,6,2,4,Armenia
40904,1/1/2022,ATA,Selangor,0,0,0,Antarctica
40905,1/1/2022,ATG,Johor,0,0,0,Antigua and Barbuda
40906,1/1/2022,ATG,Kedah,0,0,0,Antigua and Barbuda
40907,1/1/2022,ATG,Pulau Pinang,0,0,0,Antigua and Barbuda
40908,1/1/2022,ATG,Sarawak,0,0,0,Antigua and Barbuda
40909,1/1/2022,ATG,Selangor,0,0,0,Antigua and Barbuda
40910,1/1/2022,AUS,Johor,0,0,0,Australia
40911,1/1/2022,AUS,Kedah,45,29,16,Australia
40912,1/1/2022,AUS,Kelantan,0,0,0,Australia
40913,1/1/2022,AUS,Melaka,0,0,0,Australia
40914,1/1/2022,AUS,Negeri Sembilan,0,0,0,Australia
40915,1/1/2022,AUS,Pahang,0,0,0,Australia
40916,1/1/2022,AUS,Perak,0,0,0,Australia
40917,1/1/2022,AUS,Perlis,0,0,0,Australia
40918,1/1/2022,AUS,Pulau Pinang,20,11,9,Australia
40919,1/1/2022,AUS,Sabah,0,0,0,Australia
40920,1/1/2022,AUS,Sarawak,7,3,4,Australia
40921,1/1/2022,AUS,Selangor,901,569,332,Australia
40922,1/1/2022,AUS,Terengganu,0,0,0,Australia
40923,1/1/2022,AUS,W.P. Labuan,0,0,0,Australia
40924,1/1/2022,AUT,Johor,1,0,1,Austria
40925,1/1/2022,AUT,Kedah,1,1,0,Austria
40926,1/1/2022,AUT,Kelantan,0,0,0,Austria
40927,1/1/2022,AUT,Melaka,0,0,0,Austria
40928,1/1/2022,AUT,Negeri Sembilan,0,0,0,Austria
40929,1/1/2022,AUT,Pahang,0,0,0,Austria
40930,1/1/2022,AUT,Perak,0,0,0,Austria
40931,1/1/2022,AUT,Perlis,0,0,0,Austria
40932,1/1/2022,AUT,Pulau Pinang,0,0,0,Austria
40933,1/1/2022,AUT,Sabah,1,1,0,Austria
40934,1/1/2022,AUT,Sarawak,0,0,0,Austria
40935,1/1/2022,AUT,Selangor,63,52,11,Austria
40936,1/1/2022,AUT,Terengganu,0,0,0,Austria
40937,1/1/2022,AUT,W.P. Labuan,0,0,0,Austria
40938,1/1/2022,AZE,Johor,0,0,0,Azerbaijan
40939,1/1/2022,AZE,Kedah,0,0,0,Azerbaijan
40940,1/1/2022,AZE,Kelantan,0,0,0,Azerbaijan
40941,1/1/2022,AZE,Melaka,0,0,0,Azerbaijan
40942,1/1/2022,AZE,Perlis,0,0,0,Azerbaijan
40943,1/1/2022,AZE,Pulau Pinang,0,0,0,Azerbaijan
40944,1/1/2022,AZE,Sabah,0,0,0,Azerbaijan
40945,1/1/2022,AZE,Sarawak,0,0,0,Azerbaijan
40946,1/1/2022,AZE,Selangor,14,9,5,Azerbaijan
40947,1/1/2022,AZE,W.P. Labuan,0,0,0,Azerbaijan
40948,1/1/2022,BDI,Pulau Pinang,0,0,0,Burundi
40949,1/1/2022,BDI,Sarawak,0,0,0,Burundi
40950,1/1/2022,BDI,Selangor,2,2,0,Burundi
40951,1/1/2022,BEL,Johor,0,0,0,Belgium
40952,1/1/2022,BEL,Kedah,0,0,0,Belgium
40953,1/1/2022,BEL,Kelantan,0,0,0,Belgium
40954,1/1/2022,BEL,Melaka,0,0,0,Belgium
40955,1/1/2022,BEL,Negeri Sembilan,0,0,0,Belgium
40956,1/1/2022,BEL,Pahang,0,0,0,Belgium
40957,1/1/2022,BEL,Perak,0,0,0,Belgium
40958,1/1/2022,BEL,Perlis,0,0,0,Belgium
40959,1/1/2022,BEL,Pulau Pinang,0,0,0,Belgium
40960,1/1/2022,BEL,Sabah,0,0,0,Belgium
40961,1/1/2022,BEL,Sarawak,0,0,0,Belgium
40962,1/1/2022,BEL,Selangor,65,43,22,Belgium
40963,1/1/2022,BEL,W.P. Labuan,0,0,0,Belgium
40964,1/1/2022,BEN,Johor,0,0,0,Benin
40965,1/1/2022,BEN,Kedah,0,0,0,Benin
40966,1/1/2022,BEN,Perak,0,0,0,Benin
40967,1/1/2022,BEN,Pulau Pinang,0,0,0,Benin
40968,1/1/2022,BEN,Sabah,0,0,0,Benin
40969,1/1/2022,BEN,Sarawak,0,0,0,Benin
40970,1/1/2022,BEN,Selangor,1,1,0,Benin
40971,1/1/2022,BFA,Perak,0,0,0,Burkina Faso
40972,1/1/2022,BFA,Pulau Pinang,0,0,0,Burkina Faso
40973,1/1/2022,BFA,Selangor,2,2,0,Burkina Faso
40974,1/1/2022,BGD,Johor,11,9,2,Bangladesh
40975,1/1/2022,BGD,Kedah,0,0,0,Bangladesh
40976,1/1/2022,BGD,Kelantan,0,0,0,Bangladesh
40977,1/1/2022,BGD,Melaka,0,0,0,Bangladesh
40978,1/1/2022,BGD,Negeri Sembilan,0,0,0,Bangladesh
40979,1/1/2022,BGD,Pahang,0,0,0,Bangladesh
40980,1/1/2022,BGD,Perak,0,0,0,Bangladesh
40981,1/1/2022,BGD,Perlis,0,0,0,Bangladesh
40982,1/1/2022,BGD,Pulau Pinang,1,1,0,Bangladesh
40983,1/1/2022,BGD,Sabah,1,1,0,Bangladesh
40984,1/1/2022,BGD,Sarawak,0,0,0,Bangladesh
40985,1/1/2022,BGD,Selangor,5380,4995,385,Bangladesh
40986,1/1/2022,BGD,W.P. Labuan,0,0,0,Bangladesh
40987,1/1/2022,BGR,Johor,1,1,0,Bulgaria
40988,1/1/2022,BGR,Kedah,0,0,0,Bulgaria
40989,1/1/2022,BGR,Kelantan,0,0,0,Bulgaria
40990,1/1/2022,BGR,Pahang,0,0,0,Bulgaria
40991,1/1/2022,BGR,Perak,0,0,0,Bulgaria
40992,1/1/2022,BGR,Perlis,0,0,0,Bulgaria
40993,1/1/2022,BGR,Pulau Pinang,0,0,0,Bulgaria
40994,1/1/2022,BGR,Sabah,0,0,0,Bulgaria
40995,1/1/2022,BGR,Sarawak,0,0,0,Bulgaria
40996,1/1/2022,BGR,Selangor,17,15,2,Bulgaria
40997,1/1/2022,BGR,W.P. Labuan,0,0,0,Bulgaria
40998,1/1/2022,BHR,Johor,0,0,0,Bahrain
40999,1/1/2022,BHR,Kedah,0,0,0,Bahrain
41000,1/1/2022,BHR,Kelantan,0,0,0,Bahrain
41001,1/1/2022,BHR,Perlis,0,0,0,Bahrain
41002,1/1/2022,BHR,Pulau Pinang,0,0,0,Bahrain
41003,1/1/2022,BHR,Sabah,0,0,0,Bahrain
41004,1/1/2022,BHR,Sarawak,0,0,0,Bahrain
41005,1/1/2022,BHR,Selangor,8,7,1,Bahrain
41006,1/1/2022,BHS,Johor,0,0,0,Bahamas
41007,1/1/2022,BHS,Kedah,0,0,0,Bahamas
41008,1/1/2022,BHS,Perak,0,0,0,Bahamas
41009,1/1/2022,BHS,Sabah,0,0,0,Bahamas
41010,1/1/2022,BHS,Sarawak,0,0,0,Bahamas
41011,1/1/2022,BHS,Selangor,0,0,0,Bahamas
41012,1/1/2022,BIH,Johor,0,0,0,Bosnia and Herzegovina
41013,1/1/2022,BIH,Kedah,0,0,0,Bosnia and Herzegovina
41014,1/1/2022,BIH,Perlis,0,0,0,Bosnia and Herzegovina
41015,1/1/2022,BIH,Pulau Pinang,0,0,0,Bosnia and Herzegovina
41016,1/1/2022,BIH,Sabah,0,0,0,Bosnia and Herzegovina
41017,1/1/2022,BIH,Sarawak,0,0,0,Bosnia and Herzegovina
41018,1/1/2022,BIH,Selangor,6,5,1,Bosnia and Herzegovina
41019,1/1/2022,BLR,Johor,0,0,0,Belarus
41020,1/1/2022,BLR,Kedah,0,0,0,Belarus
41021,1/1/2022,BLR,Kelantan,0,0,0,Belarus
41022,1/1/2022,BLR,Pahang,0,0,0,Belarus
41023,1/1/2022,BLR,Perak,0,0,0,Belarus
41024,1/1/2022,BLR,Perlis,0,0,0,Belarus
41025,1/1/2022,BLR,Pulau Pinang,0,0,0,Belarus
41026,1/1/2022,BLR,Sabah,0,0,0,Belarus
41027,1/1/2022,BLR,Sarawak,0,0,0,Belarus
41028,1/1/2022,BLR,Selangor,3,3,0,Belarus
41029,1/1/2022,BLR,W.P. Labuan,0,0,0,Belarus
41030,1/1/2022,BLZ,Johor,0,0,0,Belize
41031,1/1/2022,BLZ,Pulau Pinang,0,0,0,Belize
41032,1/1/2022,BLZ,Sarawak,0,0,0,Belize
41033,1/1/2022,BLZ,Selangor,0,0,0,Belize
41034,1/1/2022,BMU,Selangor,0,0,0,Bermuda
41035,1/1/2022,BOL,Johor,0,0,0,Bolivia
41036,1/1/2022,BOL,Kedah,0,0,0,Bolivia
41037,1/1/2022,BOL,Melaka,0,0,0,Bolivia
41038,1/1/2022,BOL,Perak,0,0,0,Bolivia
41039,1/1/2022,BOL,Perlis,0,0,0,Bolivia
41040,1/1/2022,BOL,Pulau Pinang,0,0,0,Bolivia
41041,1/1/2022,BOL,Sabah,0,0,0,Bolivia
41042,1/1/2022,BOL,Sarawak,0,0,0,Bolivia
41043,1/1/2022,BOL,Selangor,0,0,0,Bolivia
41044,1/1/2022,BRA,Johor,0,0,0,Brazil
41045,1/1/2022,BRA,Kedah,3,2,1,Brazil
41046,1/1/2022,BRA,Kelantan,0,0,0,Brazil
41047,1/1/2022,BRA,Melaka,0,0,0,Brazil
41048,1/1/2022,BRA,Pahang,0,0,0,Brazil
41049,1/1/2022,BRA,Perak,0,0,0,Brazil
41050,1/1/2022,BRA,Perlis,0,0,0,Brazil
41051,1/1/2022,BRA,Pulau Pinang,0,0,0,Brazil
41052,1/1/2022,BRA,Sabah,0,0,0,Brazil
41053,1/1/2022,BRA,Sarawak,0,0,0,Brazil
41054,1/1/2022,BRA,Selangor,128,75,53,Brazil
41055,1/1/2022,BRA,W.P. Labuan,0,0,0,Brazil
41056,1/1/2022,BRB,Johor,0,0,0,Barbados
41057,1/1/2022,BRB,Kedah,0,0,0,Barbados
41058,1/1/2022,BRB,Perlis,0,0,0,Barbados
41059,1/1/2022,BRB,Pulau Pinang,0,0,0,Barbados
41060,1/1/2022,BRB,Selangor,1,1,0,Barbados
41061,1/1/2022,BRN,Johor,0,0,0,Brunei Darussalam
41062,1/1/2022,BRN,Kedah,0,0,0,Brunei Darussalam
41063,1/1/2022,BRN,Kelantan,0,0,0,Brunei Darussalam
41064,1/1/2022,BRN,Melaka,0,0,0,Brunei Darussalam
41065,1/1/2022,BRN,Pahang,0,0,0,Brunei Darussalam
41066,1/1/2022,BRN,Perak,0,0,0,Brunei Darussalam
41067,1/1/2022,BRN,Perlis,0,0,0,Brunei Darussalam
41068,1/1/2022,BRN,Pulau Pinang,0,0,0,Brunei Darussalam
41069,1/1/2022,BRN,Sabah,0,0,0,Brunei Darussalam
41070,1/1/2022,BRN,Sarawak,422,408,14,Brunei Darussalam
41071,1/1/2022,BRN,Selangor,81,51,30,Brunei Darussalam
41072,1/1/2022,BRN,W.P. Labuan,2,2,0,Brunei Darussalam
41073,1/1/2022,BTN,Johor,0,0,0,Bhutan
41074,1/1/2022,BTN,Kedah,0,0,0,Bhutan
41075,1/1/2022,BTN,Perak,0,0,0,Bhutan
41076,1/1/2022,BTN,Perlis,0,0,0,Bhutan
41077,1/1/2022,BTN,Pulau Pinang,0,0,0,Bhutan
41078,1/1/2022,BTN,Sabah,0,0,0,Bhutan
41079,1/1/2022,BTN,Sarawak,0,0,0,Bhutan
41080,1/1/2022,BTN,Selangor,2,0,2,Bhutan
41081,1/1/2022,BWA,Johor,0,0,0,Botswana
41082,1/1/2022,BWA,Kedah,0,0,0,Botswana
41083,1/1/2022,BWA,Perlis,0,0,0,Botswana
41084,1/1/2022,BWA,Pulau Pinang,0,0,0,Botswana
41085,1/1/2022,BWA,Sabah,0,0,0,Botswana
41086,1/1/2022,BWA,Sarawak,0,0,0,Botswana
41087,1/1/2022,BWA,Selangor,3,1,2,Botswana
41088,1/1/2022,CAF,Kedah,0,0,0,Central African Republic
41089,1/1/2022,CAF,Selangor,0,0,0,Central African Republic
41090,1/1/2022,CAN,Johor,1,1,0,Canada
41091,1/1/2022,CAN,Kedah,3,2,1,Canada
41092,1/1/2022,CAN,Kelantan,0,0,0,Canada
41093,1/1/2022,CAN,Melaka,0,0,0,Canada
41094,1/1/2022,CAN,Negeri Sembilan,0,0,0,Canada
41095,1/1/2022,CAN,Pahang,0,0,0,Canada
41096,1/1/2022,CAN,Perak,0,0,0,Canada
41097,1/1/2022,CAN,Perlis,0,0,0,Canada
41098,1/1/2022,CAN,Pulau Pinang,0,0,0,Canada
41099,1/1/2022,CAN,Sabah,1,1,0,Canada
41100,1/1/2022,CAN,Sarawak,1,0,1,Canada
41101,1/1/2022,CAN,Selangor,254,153,101,Canada
41102,1/1/2022,CAN,Terengganu,0,0,0,Canada
41103,1/1/2022,CAN,W.P. Labuan,0,0,0,Canada
41104,1/1/2022,CCK,Selangor,0,0,0,Cocos (Keeling) Islands
41105,1/1/2022,CHE,Johor,0,0,0,Switzerland
41106,1/1/2022,CHE,Kedah,3,2,1,Switzerland
41107,1/1/2022,CHE,Kelantan,0,0,0,Switzerland
41108,1/1/2022,CHE,Melaka,0,0,0,Switzerland
41109,1/1/2022,CHE,Negeri Sembilan,0,0,0,Switzerland
41110,1/1/2022,CHE,Pahang,0,0,0,Switzerland
41111,1/1/2022,CHE,Perak,0,0,0,Switzerland
41112,1/1/2022,CHE,Perlis,0,0,0,Switzerland
41113,1/1/2022,CHE,Pulau Pinang,3,3,0,Switzerland
41114,1/1/2022,CHE,Sabah,1,0,1,Switzerland
41115,1/1/2022,CHE,Sarawak,0,0,0,Switzerland
41116,1/1/2022,CHE,Selangor,111,67,44,Switzerland
41117,1/1/2022,CHE,W.P. Labuan,0,0,0,Switzerland
41118,1/1/2022,CHL,Johor,0,0,0,Chile
41119,1/1/2022,CHL,Kedah,0,0,0,Chile
41120,1/1/2022,CHL,Kelantan,0,0,0,Chile
41121,1/1/2022,CHL,Melaka,0,0,0,Chile
41122,1/1/2022,CHL,Pahang,0,0,0,Chile
41123,1/1/2022,CHL,Perak,0,0,0,Chile
41124,1/1/2022,CHL,Perlis,0,0,0,Chile
41125,1/1/2022,CHL,Pulau Pinang,0,0,0,Chile
41126,1/1/2022,CHL,Sabah,0,0,0,Chile
41127,1/1/2022,CHL,Sarawak,0,0,0,Chile
41128,1/1/2022,CHL,Selangor,18,6,12,Chile
41129,1/1/2022,CHN,Johor,154,145,9,China
41130,1/1/2022,CHN,Kedah,6,1,5,China
41131,1/1/2022,CHN,Kelantan,0,0,0,China
41132,1/1/2022,CHN,Melaka,0,0,0,China
41133,1/1/2022,CHN,Pahang,0,0,0,China
41134,1/1/2022,CHN,Perak,0,0,0,China
41135,1/1/2022,CHN,Perlis,0,0,0,China
41136,1/1/2022,CHN,Pulau Pinang,7,4,3,China
41137,1/1/2022,CHN,Sabah,4,3,1,China
41138,1/1/2022,CHN,Sarawak,37,33,4,China
41139,1/1/2022,CHN,Selangor,1844,1117,727,China
41140,1/1/2022,CHN,Terengganu,0,0,0,China
41141,1/1/2022,CHN,W.P. Labuan,0,0,0,China
41142,1/1/2022,CIV,Johor,0,0,0,C��te d'Iv
41143,1/1/2022,CIV,Kedah,0,0,0,C��te d'Iv
41144,1/1/2022,CIV,Pulau Pinang,0,0,0,C��te d'Iv
41145,1/1/2022,CIV,Sabah,0,0,0,C��te d'Iv
41146,1/1/2022,CIV,Sarawak,0,0,0,C��te d'Iv
41147,1/1/2022,CIV,Selangor,2,1,1,C��te d'Iv
41148,1/1/2022,CMR,Johor,0,0,0,Cameroon
41149,1/1/2022,CMR,Kedah,0,0,0,Cameroon
41150,1/1/2022,CMR,Pulau Pinang,0,0,0,Cameroon
41151,1/1/2022,CMR,Sabah,0,0,0,Cameroon
41152,1/1/2022,CMR,Sarawak,0,0,0,Cameroon
41153,1/1/2022,CMR,Selangor,4,2,2,Cameroon
41154,1/1/2022,COD,Johor,0,0,0,"Congo, the Democratic Republic of the"
41155,1/1/2022,COD,Pulau Pinang,0,0,0,"Congo, the Democratic Republic of the"
41156,1/1/2022,COD,Sarawak,0,0,0,"Congo, the Democratic Republic of the"
41157,1/1/2022,COD,Selangor,2,2,0,"Congo, the Democratic Republic of the"
41158,1/1/2022,COG,Johor,0,0,0,Congo
41159,1/1/2022,COG,Kedah,0,0,0,Congo
41160,1/1/2022,COG,Selangor,0,0,0,Congo
41161,1/1/2022,COK,Selangor,0,0,0,Cook Islands
41162,1/1/2022,COL,Johor,0,0,0,Colombia
41163,1/1/2022,COL,Kedah,0,0,0,Colombia
41164,1/1/2022,COL,Perak,0,0,0,Colombia
41165,1/1/2022,COL,Pulau Pinang,0,0,0,Colombia
41166,1/1/2022,COL,Sabah,0,0,0,Colombia
41167,1/1/2022,COL,Sarawak,0,0,0,Colombia
41168,1/1/2022,COL,Selangor,37,20,17,Colombia
41169,1/1/2022,COL,W.P. Labuan,0,0,0,Colombia
41170,1/1/2022,COM,Johor,0,0,0,Comoros
41171,1/1/2022,COM,Kedah,0,0,0,Comoros
41172,1/1/2022,COM,Selangor,1,1,0,Comoros
41173,1/1/2022,CPV,Johor,0,0,0,Cape Verde
41174,1/1/2022,CPV,Kedah,0,0,0,Cape Verde
41175,1/1/2022,CPV,Pulau Pinang,0,0,0,Cape Verde
41176,1/1/2022,CPV,Sabah,0,0,0,Cape Verde
41177,1/1/2022,CPV,Selangor,0,0,0,Cape Verde
41178,1/1/2022,CRI,Johor,0,0,0,Costa Rica
41179,1/1/2022,CRI,Kedah,0,0,0,Costa Rica
41180,1/1/2022,CRI,Perak,0,0,0,Costa Rica
41181,1/1/2022,CRI,Perlis,0,0,0,Costa Rica
41182,1/1/2022,CRI,Pulau Pinang,0,0,0,Costa Rica
41183,1/1/2022,CRI,Sabah,0,0,0,Costa Rica
41184,1/1/2022,CRI,Sarawak,0,0,0,Costa Rica
41185,1/1/2022,CRI,Selangor,17,6,11,Costa Rica
41186,1/1/2022,CUB,Johor,0,0,0,Cuba
41187,1/1/2022,CUB,Kedah,0,0,0,Cuba
41188,1/1/2022,CUB,Perlis,0,0,0,Cuba
41189,1/1/2022,CUB,Pulau Pinang,0,0,0,Cuba
41190,1/1/2022,CUB,Sabah,0,0,0,Cuba
41191,1/1/2022,CUB,Sarawak,0,0,0,Cuba
41192,1/1/2022,CUB,Selangor,5,2,3,Cuba
41193,1/1/2022,CYP,Johor,0,0,0,Cyprus
41194,1/1/2022,CYP,Kedah,6,6,0,Cyprus
41195,1/1/2022,CYP,Perak,0,0,0,Cyprus
41196,1/1/2022,CYP,Perlis,0,0,0,Cyprus
41197,1/1/2022,CYP,Pulau Pinang,0,0,0,Cyprus
41198,1/1/2022,CYP,Sabah,0,0,0,Cyprus
41199,1/1/2022,CYP,Sarawak,0,0,0,Cyprus
41200,1/1/2022,CYP,Selangor,4,2,2,Cyprus
41201,1/1/2022,CZE,Johor,0,0,0,Czech Republic
41202,1/1/2022,CZE,Kedah,0,0,0,Czech Republic
41203,1/1/2022,CZE,Kelantan,0,0,0,Czech Republic
41204,1/1/2022,CZE,Melaka,0,0,0,Czech Republic
41205,1/1/2022,CZE,Negeri Sembilan,0,0,0,Czech Republic
41206,1/1/2022,CZE,Perak,0,0,0,Czech Republic
41207,1/1/2022,CZE,Perlis,0,0,0,Czech Republic
41208,1/1/2022,CZE,Pulau Pinang,0,0,0,Czech Republic
41209,1/1/2022,CZE,Sabah,0,0,0,Czech Republic
41210,1/1/2022,CZE,Sarawak,2,2,0,Czech Republic
41211,1/1/2022,CZE,Selangor,18,13,5,Czech Republic
41212,1/1/2022,CZE,W.P. Labuan,0,0,0,Czech Republic
41213,1/1/2022,DEU,Johor,1,1,0,Germany
41214,1/1/2022,DEU,Kedah,8,7,1,Germany
41215,1/1/2022,DEU,Kelantan,0,0,0,Germany
41216,1/1/2022,DEU,Melaka,0,0,0,Germany
41217,1/1/2022,DEU,Negeri Sembilan,0,0,0,Germany
41218,1/1/2022,DEU,Pahang,0,0,0,Germany
41219,1/1/2022,DEU,Perak,0,0,0,Germany
41220,1/1/2022,DEU,Perlis,0,0,0,Germany
41221,1/1/2022,DEU,Pulau Pinang,7,5,2,Germany
41222,1/1/2022,DEU,Sabah,0,0,0,Germany
41223,1/1/2022,DEU,Sarawak,0,0,0,Germany
41224,1/1/2022,DEU,Selangor,433,332,101,Germany
41225,1/1/2022,DEU,Terengganu,0,0,0,Germany
41226,1/1/2022,DEU,W.P. Labuan,0,0,0,Germany
41227,1/1/2022,DJI,Johor,0,0,0,Djibouti
41228,1/1/2022,DJI,Selangor,6,3,3,Djibouti
41229,1/1/2022,DMA,Johor,0,0,0,Dominica
41230,1/1/2022,DMA,Kedah,0,0,0,Dominica
41231,1/1/2022,DMA,Pulau Pinang,0,0,0,Dominica
41232,1/1/2022,DMA,Sabah,0,0,0,Dominica
41233,1/1/2022,DMA,Sarawak,0,0,0,Dominica
41234,1/1/2022,DMA,Selangor,0,0,0,Dominica
41235,1/1/2022,DMA,W.P. Labuan,0,0,0,Dominica
41236,1/1/2022,DNK,Johor,2,2,0,Denmark
41237,1/1/2022,DNK,Kedah,2,1,1,Denmark
41238,1/1/2022,DNK,Kelantan,0,0,0,Denmark
41239,1/1/2022,DNK,Melaka,0,0,0,Denmark
41240,1/1/2022,DNK,Negeri Sembilan,0,0,0,Denmark
41241,1/1/2022,DNK,Pahang,0,0,0,Denmark
41242,1/1/2022,DNK,Perak,0,0,0,Denmark
41243,1/1/2022,DNK,Perlis,0,0,0,Denmark
41244,1/1/2022,DNK,Pulau Pinang,2,1,1,Denmark
41245,1/1/2022,DNK,Sabah,0,0,0,Denmark
41246,1/1/2022,DNK,Sarawak,0,0,0,Denmark
41247,1/1/2022,DNK,Selangor,121,89,32,Denmark
41248,1/1/2022,DNK,W.P. Labuan,0,0,0,Denmark
41249,1/1/2022,DOM,Johor,0,0,0,Dominican Republic
41250,1/1/2022,DOM,Kedah,0,0,0,Dominican Republic
41251,1/1/2022,DOM,Perak,0,0,0,Dominican Republic
41252,1/1/2022,DOM,Perlis,0,0,0,Dominican Republic
41253,1/1/2022,DOM,Pulau Pinang,0,0,0,Dominican Republic
41254,1/1/2022,DOM,Sabah,0,0,0,Dominican Republic
41255,1/1/2022,DOM,Sarawak,0,0,0,Dominican Republic
41256,1/1/2022,DOM,Selangor,1,1,0,Dominican Republic
41257,1/1/2022,DZA,Johor,0,0,0,Algeria
41258,1/1/2022,DZA,Kedah,0,0,0,Algeria
41259,1/1/2022,DZA,Kelantan,0,0,0,Algeria
41260,1/1/2022,DZA,Melaka,0,0,0,Algeria
41261,1/1/2022,DZA,Perak,0,0,0,Algeria
41262,1/1/2022,DZA,Perlis,0,0,0,Algeria
41263,1/1/2022,DZA,Pulau Pinang,0,0,0,Algeria
41264,1/1/2022,DZA,Sabah,0,0,0,Algeria
41265,1/1/2022,DZA,Sarawak,0,0,0,Algeria
41266,1/1/2022,DZA,Selangor,50,37,13,Algeria
41267,1/1/2022,DZA,W.P. Labuan,0,0,0,Algeria
41268,1/1/2022,ECU,Johor,0,0,0,Ecuador
41269,1/1/2022,ECU,Kedah,0,0,0,Ecuador
41270,1/1/2022,ECU,Perak,0,0,0,Ecuador
41271,1/1/2022,ECU,Perlis,0,0,0,Ecuador
41272,1/1/2022,ECU,Pulau Pinang,0,0,0,Ecuador
41273,1/1/2022,ECU,Sabah,0,0,0,Ecuador
41274,1/1/2022,ECU,Sarawak,0,0,0,Ecuador
41275,1/1/2022,ECU,Selangor,2,2,0,Ecuador
41276,1/1/2022,EGY,Johor,1,1,0,Egypt
41277,1/1/2022,EGY,Kedah,0,0,0,Egypt
41278,1/1/2022,EGY,Kelantan,0,0,0,Egypt
41279,1/1/2022,EGY,Melaka,0,0,0,Egypt
41280,1/1/2022,EGY,Pahang,0,0,0,Egypt
41281,1/1/2022,EGY,Perak,0,0,0,Egypt
41282,1/1/2022,EGY,Perlis,0,0,0,Egypt
41283,1/1/2022,EGY,Pulau Pinang,0,0,0,Egypt
41284,1/1/2022,EGY,Sabah,0,0,0,Egypt
41285,1/1/2022,EGY,Sarawak,1,1,0,Egypt
41286,1/1/2022,EGY,Selangor,340,246,94,Egypt
41287,1/1/2022,EGY,Terengganu,0,0,0,Egypt
41288,1/1/2022,EGY,W.P. Labuan,0,0,0,Egypt
41289,1/1/2022,ERI,Johor,0,0,0,Eritrea
41290,1/1/2022,ERI,Pulau Pinang,0,0,0,Eritrea
41291,1/1/2022,ERI,Sabah,0,0,0,Eritrea
41292,1/1/2022,ERI,Selangor,1,0,1,Eritrea
41293,1/1/2022,ESP,Johor,0,0,0,Spain
41294,1/1/2022,ESP,Kedah,3,2,1,Spain
41295,1/1/2022,ESP,Kelantan,0,0,0,Spain
41296,1/1/2022,ESP,Melaka,0,0,0,Spain
41297,1/1/2022,ESP,Negeri Sembilan,0,0,0,Spain
41298,1/1/2022,ESP,Pahang,0,0,0,Spain
41299,1/1/2022,ESP,Perak,0,0,0,Spain
41300,1/1/2022,ESP,Perlis,0,0,0,Spain
41301,1/1/2022,ESP,Pulau Pinang,0,0,0,Spain
41302,1/1/2022,ESP,Sabah,0,0,0,Spain
41303,1/1/2022,ESP,Sarawak,0,0,0,Spain
41304,1/1/2022,ESP,Selangor,271,198,73,Spain
41305,1/1/2022,ESP,W.P. Labuan,0,0,0,Spain
41306,1/1/2022,EST,Johor,0,0,0,Estonia
41307,1/1/2022,EST,Kedah,0,0,0,Estonia
41308,1/1/2022,EST,Kelantan,0,0,0,Estonia
41309,1/1/2022,EST,Pahang,0,0,0,Estonia
41310,1/1/2022,EST,Perak,0,0,0,Estonia
41311,1/1/2022,EST,Perlis,0,0,0,Estonia
41312,1/1/2022,EST,Pulau Pinang,0,0,0,Estonia
41313,1/1/2022,EST,Sabah,0,0,0,Estonia
41314,1/1/2022,EST,Sarawak,0,0,0,Estonia
41315,1/1/2022,EST,Selangor,7,4,3,Estonia
41316,1/1/2022,EST,W.P. Labuan,0,0,0,Estonia
41317,1/1/2022,ETH,Johor,1,1,0,Ethiopia
41318,1/1/2022,ETH,Kedah,0,0,0,Ethiopia
41319,1/1/2022,ETH,Pulau Pinang,0,0,0,Ethiopia
41320,1/1/2022,ETH,Sarawak,0,0,0,Ethiopia
41321,1/1/2022,ETH,Selangor,14,8,6,Ethiopia
41322,1/1/2022,FIN,Johor,0,0,0,Finland
41323,1/1/2022,FIN,Kedah,1,1,0,Finland
41324,1/1/2022,FIN,Kelantan,0,0,0,Finland
41325,1/1/2022,FIN,Melaka,0,0,0,Finland
41326,1/1/2022,FIN,Negeri Sembilan,0,0,0,Finland
41327,1/1/2022,FIN,Pahang,0,0,0,Finland
41328,1/1/2022,FIN,Perak,0,0,0,Finland
41329,1/1/2022,FIN,Perlis,0,0,0,Finland
41330,1/1/2022,FIN,Pulau Pinang,0,0,0,Finland
41331,1/1/2022,FIN,Sabah,0,0,0,Finland
41332,1/1/2022,FIN,Sarawak,0,0,0,Finland
41333,1/1/2022,FIN,Selangor,47,30,17,Finland
41334,1/1/2022,FIN,W.P. Labuan,0,0,0,Finland
41335,1/1/2022,FJI,Johor,0,0,0,Fiji
41336,1/1/2022,FJI,Kedah,0,0,0,Fiji
41337,1/1/2022,FJI,Kelantan,0,0,0,Fiji
41338,1/1/2022,FJI,Perak,0,0,0,Fiji
41339,1/1/2022,FJI,Perlis,0,0,0,Fiji
41340,1/1/2022,FJI,Pulau Pinang,0,0,0,Fiji
41341,1/1/2022,FJI,Sabah,0,0,0,Fiji
41342,1/1/2022,FJI,Sarawak,0,0,0,Fiji
41343,1/1/2022,FJI,Selangor,2,0,2,Fiji
41344,1/1/2022,FRA,Johor,5,5,0,France
41345,1/1/2022,FRA,Kedah,3,3,0,France
41346,1/1/2022,FRA,Kelantan,0,0,0,France
41347,1/1/2022,FRA,Melaka,0,0,0,France
41348,1/1/2022,FRA,Negeri Sembilan,0,0,0,France
41349,1/1/2022,FRA,Pahang,0,0,0,France
41350,1/1/2022,FRA,Perak,0,0,0,France
41351,1/1/2022,FRA,Perlis,0,0,0,France
41352,1/1/2022,FRA,Pulau Pinang,0,0,0,France
41353,1/1/2022,FRA,Sabah,0,0,0,France
41354,1/1/2022,FRA,Sarawak,1,1,0,France
41355,1/1/2022,FRA,Selangor,668,482,186,France
41356,1/1/2022,FRA,Terengganu,0,0,0,France
41357,1/1/2022,FRA,W.P. Labuan,0,0,0,France
41358,1/1/2022,FSM,Johor,0,0,0,"Micronesia, Federated States of"
41359,1/1/2022,FSM,Pulau Pinang,0,0,0,"Micronesia, Federated States of"
41360,1/1/2022,FSM,Selangor,0,0,0,"Micronesia, Federated States of"
41361,1/1/2022,GAB,Johor,0,0,0,Gabon
41362,1/1/2022,GAB,Pulau Pinang,0,0,0,Gabon
41363,1/1/2022,GAB,Sarawak,0,0,0,Gabon
41364,1/1/2022,GAB,Selangor,2,1,1,Gabon
41365,1/1/2022,GBR,Johor,8,4,4,United Kingdom
41366,1/1/2022,GBR,Kedah,34,23,11,United Kingdom
41367,1/1/2022,GBR,Kelantan,0,0,0,United Kingdom
41368,1/1/2022,GBR,Melaka,0,0,0,United Kingdom
41369,1/1/2022,GBR,Negeri Sembilan,0,0,0,United Kingdom
41370,1/1/2022,GBR,Pahang,0,0,0,United Kingdom
41371,1/1/2022,GBR,Perak,0,0,0,United Kingdom
41372,1/1/2022,GBR,Perlis,0,0,0,United Kingdom
41373,1/1/2022,GBR,Pulau Pinang,13,10,3,United Kingdom
41374,1/1/2022,GBR,Sabah,4,1,3,United Kingdom
41375,1/1/2022,GBR,Sarawak,4,3,1,United Kingdom
41376,1/1/2022,GBR,Selangor,1735,1116,619,United Kingdom
41377,1/1/2022,GBR,Terengganu,0,0,0,United Kingdom
41378,1/1/2022,GBR,W.P. Labuan,0,0,0,United Kingdom
41379,1/1/2022,GEO,Johor,0,0,0,Georgia
41380,1/1/2022,GEO,Kedah,0,0,0,Georgia
41381,1/1/2022,GEO,Melaka,0,0,0,Georgia
41382,1/1/2022,GEO,Perak,0,0,0,Georgia
41383,1/1/2022,GEO,Perlis,0,0,0,Georgia
41384,1/1/2022,GEO,Pulau Pinang,0,0,0,Georgia
41385,1/1/2022,GEO,Sabah,0,0,0,Georgia
41386,1/1/2022,GEO,Sarawak,0,0,0,Georgia
41387,1/1/2022,GEO,Selangor,10,10,0,Georgia
41388,1/1/2022,GHA,Johor,0,0,0,Ghana
41389,1/1/2022,GHA,Kedah,0,0,0,Ghana
41390,1/1/2022,GHA,Kelantan,0,0,0,Ghana
41391,1/1/2022,GHA,Pulau Pinang,0,0,0,Ghana
41392,1/1/2022,GHA,Sabah,0,0,0,Ghana
41393,1/1/2022,GHA,Sarawak,0,0,0,Ghana
41394,1/1/2022,GHA,Selangor,15,12,3,Ghana
41395,1/1/2022,GIB,Johor,0,0,0,Gibraltar
41396,1/1/2022,GIB,Sarawak,0,0,0,Gibraltar
41397,1/1/2022,GIN,Johor,0,0,0,Guinea
41398,1/1/2022,GIN,Kedah,0,0,0,Guinea
41399,1/1/2022,GIN,Kelantan,0,0,0,Guinea
41400,1/1/2022,GIN,Perlis,0,0,0,Guinea
41401,1/1/2022,GIN,Pulau Pinang,0,0,0,Guinea
41402,1/1/2022,GIN,Sabah,0,0,0,Guinea
41403,1/1/2022,GIN,Sarawak,0,0,0,Guinea
41404,1/1/2022,GIN,Selangor,16,11,5,Guinea
41405,1/1/2022,GLP,Selangor,0,0,0,Guadeloupe
41406,1/1/2022,GMB,Johor,0,0,0,Gambia
41407,1/1/2022,GMB,Kedah,0,0,0,Gambia
41408,1/1/2022,GMB,Kelantan,0,0,0,Gambia
41409,1/1/2022,GMB,Pulau Pinang,0,0,0,Gambia
41410,1/1/2022,GMB,Sabah,0,0,0,Gambia
41411,1/1/2022,GMB,Sarawak,0,0,0,Gambia
41412,1/1/2022,GMB,Selangor,5,4,1,Gambia
41413,1/1/2022,GNB,Johor,0,0,0,Guinea-Bissau
41414,1/1/2022,GNB,Selangor,0,0,0,Guinea-Bissau
41415,1/1/2022,GNQ,Johor,0,0,0,Equatorial Guinea
41416,1/1/2022,GNQ,Selangor,4,4,0,Equatorial Guinea
41417,1/1/2022,GRC,Johor,0,0,0,Greece
41418,1/1/2022,GRC,Kedah,0,0,0,Greece
41419,1/1/2022,GRC,Kelantan,0,0,0,Greece
41420,1/1/2022,GRC,Melaka,0,0,0,Greece
41421,1/1/2022,GRC,Negeri Sembilan,0,0,0,Greece
41422,1/1/2022,GRC,Pahang,0,0,0,Greece
41423,1/1/2022,GRC,Perak,0,0,0,Greece
41424,1/1/2022,GRC,Perlis,0,0,0,Greece
41425,1/1/2022,GRC,Pulau Pinang,0,0,0,Greece
41426,1/1/2022,GRC,Sabah,0,0,0,Greece
41427,1/1/2022,GRC,Sarawak,0,0,0,Greece
41428,1/1/2022,GRC,Selangor,9,6,3,Greece
41429,1/1/2022,GRD,Johor,0,0,0,Grenada
41430,1/1/2022,GRD,Kedah,0,0,0,Grenada
41431,1/1/2022,GRD,Pulau Pinang,0,0,0,Grenada
41432,1/1/2022,GRD,Sabah,0,0,0,Grenada
41433,1/1/2022,GRD,Sarawak,0,0,0,Grenada
41434,1/1/2022,GRD,Selangor,1,0,1,Grenada
41435,1/1/2022,GRL,Johor,0,0,0,Greenland
41436,1/1/2022,GRL,Selangor,0,0,0,Greenland
41437,1/1/2022,GTM,Johor,0,0,0,Guatemala
41438,1/1/2022,GTM,Kedah,0,0,0,Guatemala
41439,1/1/2022,GTM,Pahang,0,0,0,Guatemala
41440,1/1/2022,GTM,Perak,0,0,0,Guatemala
41441,1/1/2022,GTM,Pulau Pinang,0,0,0,Guatemala
41442,1/1/2022,GTM,Sabah,0,0,0,Guatemala
41443,1/1/2022,GTM,Sarawak,0,0,0,Guatemala
41444,1/1/2022,GTM,Selangor,1,1,0,Guatemala
41445,1/1/2022,GTM,W.P. Labuan,0,0,0,Guatemala
41446,1/1/2022,GUY,Johor,0,0,0,Guyana
41447,1/1/2022,GUY,Kedah,0,0,0,Guyana
41448,1/1/2022,GUY,Pulau Pinang,0,0,0,Guyana
41449,1/1/2022,GUY,Sarawak,0,0,0,Guyana
41450,1/1/2022,GUY,Selangor,0,0,0,Guyana
41451,1/1/2022,HKG,Johor,0,0,0,Hong Kong
41452,1/1/2022,HKG,Kedah,7,2,5,Hong Kong
41453,1/1/2022,HKG,Kelantan,0,0,0,Hong Kong
41454,1/1/2022,HKG,Pahang,0,0,0,Hong Kong
41455,1/1/2022,HKG,Perak,0,0,0,Hong Kong
41456,1/1/2022,HKG,Perlis,0,0,0,Hong Kong
41457,1/1/2022,HKG,Pulau Pinang,1,1,0,Hong Kong
41458,1/1/2022,HKG,Sabah,0,0,0,Hong Kong
41459,1/1/2022,HKG,Sarawak,19,15,4,Hong Kong
41460,1/1/2022,HKG,Selangor,4,4,0,Hong Kong
41461,1/1/2022,HKG,Terengganu,0,0,0,Hong Kong
41462,1/1/2022,HMD,Johor,0,0,0,Heard Island and McDonald Islands
41463,1/1/2022,HND,Johor,0,0,0,Honduras
41464,1/1/2022,HND,Kedah,0,0,0,Honduras
41465,1/1/2022,HND,Perak,0,0,0,Honduras
41466,1/1/2022,HND,Pulau Pinang,0,0,0,Honduras
41467,1/1/2022,HND,Sabah,0,0,0,Honduras
41468,1/1/2022,HND,Sarawak,0,0,0,Honduras
41469,1/1/2022,HND,Selangor,1,0,1,Honduras
41470,1/1/2022,HRV,Johor,0,0,0,Croatia
41471,1/1/2022,HRV,Kedah,0,0,0,Croatia
41472,1/1/2022,HRV,Kelantan,0,0,0,Croatia
41473,1/1/2022,HRV,Melaka,0,0,0,Croatia
41474,1/1/2022,HRV,Pahang,0,0,0,Croatia
41475,1/1/2022,HRV,Perak,0,0,0,Croatia
41476,1/1/2022,HRV,Perlis,0,0,0,Croatia
41477,1/1/2022,HRV,Pulau Pinang,0,0,0,Croatia
41478,1/1/2022,HRV,Sabah,0,0,0,Croatia
41479,1/1/2022,HRV,Sarawak,0,0,0,Croatia
41480,1/1/2022,HRV,Selangor,34,32,2,Croatia
41481,1/1/2022,HTI,Johor,0,0,0,Haiti
41482,1/1/2022,HTI,Kedah,0,0,0,Haiti
41483,1/1/2022,HTI,Kelantan,0,0,0,Haiti
41484,1/1/2022,HTI,Perak,0,0,0,Haiti
41485,1/1/2022,HTI,Pulau Pinang,0,0,0,Haiti
41486,1/1/2022,HTI,Sabah,0,0,0,Haiti
41487,1/1/2022,HTI,Selangor,1,1,0,Haiti
41488,1/1/2022,HUN,Johor,0,0,0,Hungary
41489,1/1/2022,HUN,Kedah,0,0,0,Hungary
41490,1/1/2022,HUN,Kelantan,0,0,0,Hungary
41491,1/1/2022,HUN,Pahang,0,0,0,Hungary
41492,1/1/2022,HUN,Perak,0,0,0,Hungary
41493,1/1/2022,HUN,Perlis,0,0,0,Hungary
41494,1/1/2022,HUN,Pulau Pinang,0,0,0,Hungary
41495,1/1/2022,HUN,Sabah,0,0,0,Hungary
41496,1/1/2022,HUN,Sarawak,0,0,0,Hungary
41497,1/1/2022,HUN,Selangor,19,13,6,Hungary
41498,1/1/2022,HUN,W.P. Labuan,0,0,0,Hungary
41499,1/1/2022,IDN,Johor,1078,341,737,Indonesia
41500,1/1/2022,IDN,Kedah,58,23,35,Indonesia
41501,1/1/2022,IDN,Kelantan,0,0,0,Indonesia
41502,1/1/2022,IDN,Melaka,0,0,0,Indonesia
41503,1/1/2022,IDN,Negeri Sembilan,0,0,0,Indonesia
41504,1/1/2022,IDN,Pahang,0,0,0,Indonesia
41505,1/1/2022,IDN,Perak,0,0,0,Indonesia
41506,1/1/2022,IDN,Perlis,0,0,0,Indonesia
41507,1/1/2022,IDN,Pulau Pinang,24,9,15,Indonesia
41508,1/1/2022,IDN,Sabah,8,3,5,Indonesia
41509,1/1/2022,IDN,Sarawak,395,364,31,Indonesia
41510,1/1/2022,IDN,Selangor,2943,1651,1292,Indonesia
41511,1/1/2022,IDN,Terengganu,0,0,0,Indonesia
41512,1/1/2022,IDN,W.P. Labuan,4,4,0,Indonesia
41513,1/1/2022,IND,Johor,48,46,2,India
41514,1/1/2022,IND,Kedah,2,1,1,India
41515,1/1/2022,IND,Kelantan,0,0,0,India
41516,1/1/2022,IND,Melaka,0,0,0,India
41517,1/1/2022,IND,Negeri Sembilan,0,0,0,India
41518,1/1/2022,IND,Pahang,0,0,0,India
41519,1/1/2022,IND,Perak,0,0,0,India
41520,1/1/2022,IND,Perlis,0,0,0,India
41521,1/1/2022,IND,Pulau Pinang,0,0,0,India
41522,1/1/2022,IND,Sabah,0,0,0,India
41523,1/1/2022,IND,Sarawak,5,5,0,India
41524,1/1/2022,IND,Selangor,6829,4696,2133,India
41525,1/1/2022,IND,Terengganu,0,0,0,India
41526,1/1/2022,IND,W.P. Labuan,0,0,0,India
41527,1/1/2022,IOT,Pulau Pinang,0,0,0,British Indian Ocean Territory
41528,1/1/2022,IOT,Selangor,0,0,0,British Indian Ocean Territory
41529,1/1/2022,IRL,Johor,0,0,0,Ireland
41530,1/1/2022,IRL,Kedah,1,1,0,Ireland
41531,1/1/2022,IRL,Kelantan,0,0,0,Ireland
41532,1/1/2022,IRL,Negeri Sembilan,0,0,0,Ireland
41533,1/1/2022,IRL,Pahang,0,0,0,Ireland
41534,1/1/2022,IRL,Perak,0,0,0,Ireland
41535,1/1/2022,IRL,Perlis,0,0,0,Ireland
41536,1/1/2022,IRL,Pulau Pinang,0,0,0,Ireland
41537,1/1/2022,IRL,Sabah,0,0,0,Ireland
41538,1/1/2022,IRL,Sarawak,0,0,0,Ireland
41539,1/1/2022,IRL,Selangor,118,83,35,Ireland
41540,1/1/2022,IRL,Terengganu,0,0,0,Ireland
41541,1/1/2022,IRL,W.P. Labuan,0,0,0,Ireland
41542,1/1/2022,IRN,Johor,0,0,0,Iran
41543,1/1/2022,IRN,Kedah,0,0,0,Iran
41544,1/1/2022,IRN,Kelantan,0,0,0,Iran
41545,1/1/2022,IRN,Perak,0,0,0,Iran
41546,1/1/2022,IRN,Perlis,0,0,0,Iran
41547,1/1/2022,IRN,Pulau Pinang,0,0,0,Iran
41548,1/1/2022,IRN,Sabah,1,1,0,Iran
41549,1/1/2022,IRN,Sarawak,0,0,0,Iran
41550,1/1/2022,IRN,Selangor,189,110,79,Iran
41551,1/1/2022,IRN,W.P. Labuan,0,0,0,Iran
41552,1/1/2022,IRQ,Johor,0,0,0,Iraq
41553,1/1/2022,IRQ,Kedah,0,0,0,Iraq
41554,1/1/2022,IRQ,Kelantan,0,0,0,Iraq
41555,1/1/2022,IRQ,Melaka,0,0,0,Iraq
41556,1/1/2022,IRQ,Pahang,0,0,0,Iraq
41557,1/1/2022,IRQ,Perak,0,0,0,Iraq
41558,1/1/2022,IRQ,Perlis,0,0,0,Iraq
41559,1/1/2022,IRQ,Pulau Pinang,0,0,0,Iraq
41560,1/1/2022,IRQ,Sabah,0,0,0,Iraq
41561,1/1/2022,IRQ,Sarawak,0,0,0,Iraq
41562,1/1/2022,IRQ,Selangor,194,127,67,Iraq
41563,1/1/2022,ISL,Johor,0,0,0,Iceland
41564,1/1/2022,ISL,Kedah,0,0,0,Iceland
41565,1/1/2022,ISL,Kelantan,0,0,0,Iceland
41566,1/1/2022,ISL,Perak,0,0,0,Iceland
41567,1/1/2022,ISL,Perlis,0,0,0,Iceland
41568,1/1/2022,ISL,Pulau Pinang,0,0,0,Iceland
41569,1/1/2022,ISL,Sabah,0,0,0,Iceland
41570,1/1/2022,ISL,Sarawak,0,0,0,Iceland
41571,1/1/2022,ISL,Selangor,4,2,2,Iceland
41572,1/1/2022,ISL,W.P. Labuan,0,0,0,Iceland
41573,1/1/2022,ISR,Pulau Pinang,0,0,0,Israel
41574,1/1/2022,ITA,Johor,2,1,1,Italy
41575,1/1/2022,ITA,Kedah,1,1,0,Italy
41576,1/1/2022,ITA,Kelantan,0,0,0,Italy
41577,1/1/2022,ITA,Melaka,0,0,0,Italy
41578,1/1/2022,ITA,Negeri Sembilan,0,0,0,Italy
41579,1/1/2022,ITA,Pahang,0,0,0,Italy
41580,1/1/2022,ITA,Perak,0,0,0,Italy
41581,1/1/2022,ITA,Perlis,0,0,0,Italy
41582,1/1/2022,ITA,Pulau Pinang,1,1,0,Italy
41583,1/1/2022,ITA,Sabah,0,0,0,Italy
41584,1/1/2022,ITA,Sarawak,1,0,1,Italy
41585,1/1/2022,ITA,Selangor,343,277,66,Italy
41586,1/1/2022,ITA,W.P. Labuan,0,0,0,Italy
41587,1/1/2022,JAM,Johor,0,0,0,Jamaica
41588,1/1/2022,JAM,Kedah,0,0,0,Jamaica
41589,1/1/2022,JAM,Perak,0,0,0,Jamaica
41590,1/1/2022,JAM,Pulau Pinang,0,0,0,Jamaica
41591,1/1/2022,JAM,Sabah,0,0,0,Jamaica
41592,1/1/2022,JAM,Sarawak,0,0,0,Jamaica
41593,1/1/2022,JAM,Selangor,2,1,1,Jamaica
41594,1/1/2022,JAM,W.P. Labuan,0,0,0,Jamaica
41595,1/1/2022,JOR,Johor,0,0,0,Jordan
41596,1/1/2022,JOR,Kedah,0,0,0,Jordan
41597,1/1/2022,JOR,Kelantan,0,0,0,Jordan
41598,1/1/2022,JOR,Melaka,0,0,0,Jordan
41599,1/1/2022,JOR,Perlis,0,0,0,Jordan
41600,1/1/2022,JOR,Pulau Pinang,0,0,0,Jordan
41601,1/1/2022,JOR,Sabah,0,0,0,Jordan
41602,1/1/2022,JOR,Sarawak,0,0,0,Jordan
41603,1/1/2022,JOR,Selangor,65,49,16,Jordan
41604,1/1/2022,JOR,W.P. Labuan,0,0,0,Jordan
41605,1/1/2022,JPN,Johor,1,1,0,Japan
41606,1/1/2022,JPN,Kedah,4,3,1,Japan
41607,1/1/2022,JPN,Kelantan,0,0,0,Japan
41608,1/1/2022,JPN,Melaka,0,0,0,Japan
41609,1/1/2022,JPN,Negeri Sembilan,0,0,0,Japan
41610,1/1/2022,JPN,Pahang,0,0,0,Japan
41611,1/1/2022,JPN,Perak,0,0,0,Japan
41612,1/1/2022,JPN,Perlis,0,0,0,Japan
41613,1/1/2022,JPN,Pulau Pinang,75,52,23,Japan
41614,1/1/2022,JPN,Sabah,4,3,1,Japan
41615,1/1/2022,JPN,Sarawak,18,16,2,Japan
41616,1/1/2022,JPN,Selangor,1256,845,411,Japan
41617,1/1/2022,JPN,W.P. Labuan,0,0,0,Japan
41618,1/1/2022,KAZ,Johor,0,0,0,Kazakhstan
41619,1/1/2022,KAZ,Kedah,0,0,0,Kazakhstan
41620,1/1/2022,KAZ,Kelantan,0,0,0,Kazakhstan
41621,1/1/2022,KAZ,Melaka,0,0,0,Kazakhstan
41622,1/1/2022,KAZ,Perak,0,0,0,Kazakhstan
41623,1/1/2022,KAZ,Perlis,0,0,0,Kazakhstan
41624,1/1/2022,KAZ,Pulau Pinang,0,0,0,Kazakhstan
41625,1/1/2022,KAZ,Sabah,0,0,0,Kazakhstan
41626,1/1/2022,KAZ,Sarawak,0,0,0,Kazakhstan
41627,1/1/2022,KAZ,Selangor,62,22,40,Kazakhstan
41628,1/1/2022,KAZ,W.P. Labuan,0,0,0,Kazakhstan
41629,1/1/2022,KEN,Johor,0,0,0,Kenya
41630,1/1/2022,KEN,Kedah,0,0,0,Kenya
41631,1/1/2022,KEN,Kelantan,0,0,0,Kenya
41632,1/1/2022,KEN,Perak,0,0,0,Kenya
41633,1/1/2022,KEN,Perlis,0,0,0,Kenya
41634,1/1/2022,KEN,Pulau Pinang,0,0,0,Kenya
41635,1/1/2022,KEN,Sabah,0,0,0,Kenya
41636,1/1/2022,KEN,Sarawak,0,0,0,Kenya
41637,1/1/2022,KEN,Selangor,115,50,65,Kenya
41638,1/1/2022,KGZ,Johor,0,0,0,Kyrgyzstan
41639,1/1/2022,KGZ,Kedah,0,0,0,Kyrgyzstan
41640,1/1/2022,KGZ,Kelantan,0,0,0,Kyrgyzstan
41641,1/1/2022,KGZ,Perak,0,0,0,Kyrgyzstan
41642,1/1/2022,KGZ,Perlis,0,0,0,Kyrgyzstan
41643,1/1/2022,KGZ,Pulau Pinang,0,0,0,Kyrgyzstan
41644,1/1/2022,KGZ,Sabah,0,0,0,Kyrgyzstan
41645,1/1/2022,KGZ,Sarawak,0,0,0,Kyrgyzstan
41646,1/1/2022,KGZ,Selangor,31,18,13,Kyrgyzstan
41647,1/1/2022,KHM,Johor,0,0,0,Cambodia
41648,1/1/2022,KHM,Kedah,0,0,0,Cambodia
41649,1/1/2022,KHM,Kelantan,0,0,0,Cambodia
41650,1/1/2022,KHM,Melaka,0,0,0,Cambodia
41651,1/1/2022,KHM,Negeri Sembilan,0,0,0,Cambodia
41652,1/1/2022,KHM,Pahang,0,0,0,Cambodia
41653,1/1/2022,KHM,Perak,0,0,0,Cambodia
41654,1/1/2022,KHM,Perlis,0,0,0,Cambodia
41655,1/1/2022,KHM,Pulau Pinang,1,1,0,Cambodia
41656,1/1/2022,KHM,Sabah,0,0,0,Cambodia
41657,1/1/2022,KHM,Sarawak,1,0,1,Cambodia
41658,1/1/2022,KHM,Selangor,85,49,36,Cambodia
41659,1/1/2022,KHM,W.P. Labuan,0,0,0,Cambodia
41660,1/1/2022,KIR,Johor,0,0,0,Kiribati
41661,1/1/2022,KIR,Sabah,0,0,0,Kiribati
41662,1/1/2022,KIR,Selangor,0,0,0,Kiribati
41663,1/1/2022,KNA,Johor,0,0,0,Saint Kitts and Nevis
41664,1/1/2022,KNA,Kedah,0,0,0,Saint Kitts and Nevis
41665,1/1/2022,KNA,Perlis,0,0,0,Saint Kitts and Nevis
41666,1/1/2022,KNA,Pulau Pinang,0,0,0,Saint Kitts and Nevis
41667,1/1/2022,KNA,Sabah,0,0,0,Saint Kitts and Nevis
41668,1/1/2022,KNA,Selangor,2,2,0,Saint Kitts and Nevis
41669,1/1/2022,KNA,W.P. Labuan,0,0,0,Saint Kitts and Nevis
41670,1/1/2022,KOR,Johor,0,0,0,"Korea, Republic of (South Korea)"
41671,1/1/2022,KOR,Kedah,2,2,0,"Korea, Republic of (South Korea)"
41672,1/1/2022,KOR,Kelantan,0,0,0,"Korea, Republic of (South Korea)"
41673,1/1/2022,KOR,Melaka,0,0,0,"Korea, Republic of (South Korea)"
41674,1/1/2022,KOR,Negeri Sembilan,0,0,0,"Korea, Republic of (South Korea)"
41675,1/1/2022,KOR,Pahang,0,0,0,"Korea, Republic of (South Korea)"
41676,1/1/2022,KOR,Perak,0,0,0,"Korea, Republic of (South Korea)"
41677,1/1/2022,KOR,Perlis,0,0,0,"Korea, Republic of (South Korea)"
41678,1/1/2022,KOR,Pulau Pinang,16,6,10,"Korea, Republic of (South Korea)"
41679,1/1/2022,KOR,Sabah,1,0,1,"Korea, Republic of (South Korea)"
41680,1/1/2022,KOR,Sarawak,25,16,9,"Korea, Republic of (South Korea)"
41681,1/1/2022,KOR,Selangor,1179,685,494,"Korea, Republic of (South Korea)"
41682,1/1/2022,KOR,Terengganu,0,0,0,"Korea, Republic of (South Korea)"
41683,1/1/2022,KOR,W.P. Labuan,0,0,0,"Korea, Republic of (South Korea)"
41684,1/1/2022,KWT,Johor,0,0,0,Kuwait
41685,1/1/2022,KWT,Kedah,0,0,0,Kuwait
41686,1/1/2022,KWT,Kelantan,0,0,0,Kuwait
41687,1/1/2022,KWT,Perak,0,0,0,Kuwait
41688,1/1/2022,KWT,Perlis,0,0,0,Kuwait
41689,1/1/2022,KWT,Pulau Pinang,0,0,0,Kuwait
41690,1/1/2022,KWT,Sabah,0,0,0,Kuwait
41691,1/1/2022,KWT,Sarawak,0,0,0,Kuwait
41692,1/1/2022,KWT,Selangor,27,19,8,Kuwait
41693,1/1/2022,KWT,W.P. Labuan,0,0,0,Kuwait
41694,1/1/2022,LAO,Johor,0,0,0,Lao People's Democratic Republic
41695,1/1/2022,LAO,Kedah,0,0,0,Lao People's Democratic Republic
41696,1/1/2022,LAO,Kelantan,0,0,0,Lao People's Democratic Republic
41697,1/1/2022,LAO,Melaka,0,0,0,Lao People's Democratic Republic
41698,1/1/2022,LAO,Perak,0,0,0,Lao People's Democratic Republic
41699,1/1/2022,LAO,Perlis,0,0,0,Lao People's Democratic Republic
41700,1/1/2022,LAO,Pulau Pinang,0,0,0,Lao People's Democratic Republic
41701,1/1/2022,LAO,Sabah,0,0,0,Lao People's Democratic Republic
41702,1/1/2022,LAO,Sarawak,0,0,0,Lao People's Democratic Republic
41703,1/1/2022,LAO,Selangor,19,13,6,Lao People's Democratic Republic
41704,1/1/2022,LAO,W.P. Labuan,0,0,0,Lao People's Democratic Republic
41705,1/1/2022,LBN,Johor,0,0,0,Lebanon
41706,1/1/2022,LBN,Kedah,1,1,0,Lebanon
41707,1/1/2022,LBN,Kelantan,0,0,0,Lebanon
41708,1/1/2022,LBN,Pahang,0,0,0,Lebanon
41709,1/1/2022,LBN,Perak,0,0,0,Lebanon
41710,1/1/2022,LBN,Perlis,0,0,0,Lebanon
41711,1/1/2022,LBN,Pulau Pinang,0,0,0,Lebanon
41712,1/1/2022,LBN,Sabah,0,0,0,Lebanon
41713,1/1/2022,LBN,Sarawak,0,0,0,Lebanon
41714,1/1/2022,LBN,Selangor,27,16,11,Lebanon
41715,1/1/2022,LBN,W.P. Labuan,0,0,0,Lebanon
41716,1/1/2022,LBR,Johor,0,0,0,Liberia
41717,1/1/2022,LBR,Kedah,0,0,0,Liberia
41718,1/1/2022,LBR,Sabah,0,0,0,Liberia
41719,1/1/2022,LBR,Sarawak,0,0,0,Liberia
41720,1/1/2022,LBR,Selangor,3,2,1,Liberia
41721,1/1/2022,LBY,Johor,0,0,0,Libyan Arab Jamahiriya
41722,1/1/2022,LBY,Kedah,0,0,0,Libyan Arab Jamahiriya
41723,1/1/2022,LBY,Perlis,0,0,0,Libyan Arab Jamahiriya
41724,1/1/2022,LBY,Pulau Pinang,0,0,0,Libyan Arab Jamahiriya
41725,1/1/2022,LBY,Sabah,0,0,0,Libyan Arab Jamahiriya
41726,1/1/2022,LBY,Sarawak,0,0,0,Libyan Arab Jamahiriya
41727,1/1/2022,LBY,Selangor,135,92,43,Libyan Arab Jamahiriya
41728,1/1/2022,LCA,Johor,0,0,0,Saint Lucia
41729,1/1/2022,LCA,Kedah,0,0,0,Saint Lucia
41730,1/1/2022,LCA,Pulau Pinang,0,0,0,Saint Lucia
41731,1/1/2022,LCA,Sarawak,0,0,0,Saint Lucia
41732,1/1/2022,LCA,Selangor,2,2,0,Saint Lucia
41733,1/1/2022,LIE,Johor,0,0,0,Liechtenstein
41734,1/1/2022,LIE,Kedah,0,0,0,Liechtenstein
41735,1/1/2022,LIE,Perlis,0,0,0,Liechtenstein
41736,1/1/2022,LIE,Pulau Pinang,0,0,0,Liechtenstein
41737,1/1/2022,LIE,Sabah,0,0,0,Liechtenstein
41738,1/1/2022,LIE,Sarawak,0,0,0,Liechtenstein
41739,1/1/2022,LIE,Selangor,0,0,0,Liechtenstein
41740,1/1/2022,LKA,Johor,6,6,0,Sri Lanka
41741,1/1/2022,LKA,Kedah,3,3,0,Sri Lanka
41742,1/1/2022,LKA,Kelantan,0,0,0,Sri Lanka
41743,1/1/2022,LKA,Melaka,0,0,0,Sri Lanka
41744,1/1/2022,LKA,Pahang,0,0,0,Sri Lanka
41745,1/1/2022,LKA,Perak,0,0,0,Sri Lanka
41746,1/1/2022,LKA,Perlis,0,0,0,Sri Lanka
41747,1/1/2022,LKA,Pulau Pinang,0,0,0,Sri Lanka
41748,1/1/2022,LKA,Sabah,0,0,0,Sri Lanka
41749,1/1/2022,LKA,Sarawak,0,0,0,Sri Lanka
41750,1/1/2022,LKA,Selangor,431,234,197,Sri Lanka
41751,1/1/2022,LKA,W.P. Labuan,0,0,0,Sri Lanka
41752,1/1/2022,LSO,Johor,0,0,0,Lesotho
41753,1/1/2022,LSO,Kedah,0,0,0,Lesotho
41754,1/1/2022,LSO,Pulau Pinang,0,0,0,Lesotho
41755,1/1/2022,LSO,Sarawak,0,0,0,Lesotho
41756,1/1/2022,LSO,Selangor,0,0,0,Lesotho
41757,1/1/2022,LTU,Johor,0,0,0,Lithuania
41758,1/1/2022,LTU,Kedah,0,0,0,Lithuania
41759,1/1/2022,LTU,Kelantan,0,0,0,Lithuania
41760,1/1/2022,LTU,Pahang,0,0,0,Lithuania
41761,1/1/2022,LTU,Perak,0,0,0,Lithuania
41762,1/1/2022,LTU,Perlis,0,0,0,Lithuania
41763,1/1/2022,LTU,Pulau Pinang,0,0,0,Lithuania
41764,1/1/2022,LTU,Sabah,0,0,0,Lithuania
41765,1/1/2022,LTU,Sarawak,0,0,0,Lithuania
41766,1/1/2022,LTU,Selangor,14,8,6,Lithuania
41767,1/1/2022,LTU,W.P. Labuan,0,0,0,Lithuania
41768,1/1/2022,LUX,Johor,0,0,0,Luxembourg
41769,1/1/2022,LUX,Kedah,0,0,0,Luxembourg
41770,1/1/2022,LUX,Kelantan,0,0,0,Luxembourg
41771,1/1/2022,LUX,Perak,0,0,0,Luxembourg
41772,1/1/2022,LUX,Perlis,0,0,0,Luxembourg
41773,1/1/2022,LUX,Pulau Pinang,0,0,0,Luxembourg
41774,1/1/2022,LUX,Sabah,0,0,0,Luxembourg
41775,1/1/2022,LUX,Sarawak,0,0,0,Luxembourg
41776,1/1/2022,LUX,Selangor,0,0,0,Luxembourg
41777,1/1/2022,LVA,Johor,0,0,0,Latvia
41778,1/1/2022,LVA,Kedah,0,0,0,Latvia
41779,1/1/2022,LVA,Kelantan,0,0,0,Latvia
41780,1/1/2022,LVA,Pahang,0,0,0,Latvia
41781,1/1/2022,LVA,Perak,0,0,0,Latvia
41782,1/1/2022,LVA,Perlis,0,0,0,Latvia
41783,1/1/2022,LVA,Pulau Pinang,0,0,0,Latvia
41784,1/1/2022,LVA,Sabah,0,0,0,Latvia
41785,1/1/2022,LVA,Sarawak,0,0,0,Latvia
41786,1/1/2022,LVA,Selangor,4,4,0,Latvia
41787,1/1/2022,LVA,W.P. Labuan,0,0,0,Latvia
41788,1/1/2022,MAC,Johor,0,0,0,Macao
41789,1/1/2022,MAC,Pahang,0,0,0,Macao
41790,1/1/2022,MAC,Perak,0,0,0,Macao
41791,1/1/2022,MAC,Selangor,0,0,0,Macao
41792,1/1/2022,MAC,W.P. Labuan,0,0,0,Macao
41793,1/1/2022,MAR,Johor,0,0,0,Morocco
41794,1/1/2022,MAR,Kedah,0,0,0,Morocco
41795,1/1/2022,MAR,Kelantan,0,0,0,Morocco
41796,1/1/2022,MAR,Melaka,0,0,0,Morocco
41797,1/1/2022,MAR,Pahang,0,0,0,Morocco
41798,1/1/2022,MAR,Perak,0,0,0,Morocco
41799,1/1/2022,MAR,Perlis,0,0,0,Morocco
41800,1/1/2022,MAR,Pulau Pinang,0,0,0,Morocco
41801,1/1/2022,MAR,Sabah,0,0,0,Morocco
41802,1/1/2022,MAR,Sarawak,0,0,0,Morocco
41803,1/1/2022,MAR,Selangor,30,13,17,Morocco
41804,1/1/2022,MAR,W.P. Labuan,0,0,0,Morocco
41805,1/1/2022,MCO,Johor,0,0,0,Monaco
41806,1/1/2022,MCO,Kedah,0,0,0,Monaco
41807,1/1/2022,MCO,Sabah,0,0,0,Monaco
41808,1/1/2022,MCO,Selangor,0,0,0,Monaco
41809,1/1/2022,MDA,Johor,0,0,0,"Moldova, Republic of"
41810,1/1/2022,MDA,Kedah,0,0,0,"Moldova, Republic of"
41811,1/1/2022,MDA,Kelantan,0,0,0,"Moldova, Republic of"
41812,1/1/2022,MDA,Negeri Sembilan,0,0,0,"Moldova, Republic of"
41813,1/1/2022,MDA,Perlis,0,0,0,"Moldova, Republic of"
41814,1/1/2022,MDA,Pulau Pinang,0,0,0,"Moldova, Republic of"
41815,1/1/2022,MDA,Sabah,0,0,0,"Moldova, Republic of"
41816,1/1/2022,MDA,Sarawak,0,0,0,"Moldova, Republic of"
41817,1/1/2022,MDA,Selangor,0,0,0,"Moldova, Republic of"
41818,1/1/2022,MDG,Johor,0,0,0,Madagascar
41819,1/1/2022,MDG,Kedah,0,0,0,Madagascar
41820,1/1/2022,MDG,Perak,0,0,0,Madagascar
41821,1/1/2022,MDG,Perlis,0,0,0,Madagascar
41822,1/1/2022,MDG,Pulau Pinang,0,0,0,Madagascar
41823,1/1/2022,MDG,Sabah,0,0,0,Madagascar
41824,1/1/2022,MDG,Sarawak,0,0,0,Madagascar
41825,1/1/2022,MDG,Selangor,2,0,2,Madagascar
41826,1/1/2022,MDV,Johor,0,0,0,Maldives
41827,1/1/2022,MDV,Kedah,17,10,7,Maldives
41828,1/1/2022,MDV,Kelantan,0,0,0,Maldives
41829,1/1/2022,MDV,Perak,0,0,0,Maldives
41830,1/1/2022,MDV,Perlis,0,0,0,Maldives
41831,1/1/2022,MDV,Pulau Pinang,1,1,0,Maldives
41832,1/1/2022,MDV,Sabah,0,0,0,Maldives
41833,1/1/2022,MDV,Sarawak,0,0,0,Maldives
41834,1/1/2022,MDV,Selangor,329,147,182,Maldives
41835,1/1/2022,MEX,Johor,2,0,2,Mexico
41836,1/1/2022,MEX,Kedah,0,0,0,Mexico
41837,1/1/2022,MEX,Kelantan,0,0,0,Mexico
41838,1/1/2022,MEX,Pahang,0,0,0,Mexico
41839,1/1/2022,MEX,Perak,0,0,0,Mexico
41840,1/1/2022,MEX,Perlis,0,0,0,Mexico
41841,1/1/2022,MEX,Pulau Pinang,0,0,0,Mexico
41842,1/1/2022,MEX,Sabah,0,0,0,Mexico
41843,1/1/2022,MEX,Sarawak,0,0,0,Mexico
41844,1/1/2022,MEX,Selangor,84,49,35,Mexico
41845,1/1/2022,MEX,W.P. Labuan,0,0,0,Mexico
41846,1/1/2022,MHL,Johor,0,0,0,Marshall Islands
41847,1/1/2022,MHL,Kedah,0,0,0,Marshall Islands
41848,1/1/2022,MHL,Perak,0,0,0,Marshall Islands
41849,1/1/2022,MHL,Pulau Pinang,0,0,0,Marshall Islands
41850,1/1/2022,MHL,Sabah,0,0,0,Marshall Islands
41851,1/1/2022,MHL,Selangor,0,0,0,Marshall Islands
41852,1/1/2022,MKD,Johor,0,0,0,"Macedonia, the former Yugoslav Republic of"
41853,1/1/2022,MKD,Kedah,0,0,0,"Macedonia, the former Yugoslav Republic of"
41854,1/1/2022,MKD,Perak,0,0,0,"Macedonia, the former Yugoslav Republic of"
41855,1/1/2022,MKD,Pulau Pinang,0,0,0,"Macedonia, the former Yugoslav Republic of"
41856,1/1/2022,MKD,Sabah,0,0,0,"Macedonia, the former Yugoslav Republic of"
41857,1/1/2022,MKD,Sarawak,0,0,0,"Macedonia, the former Yugoslav Republic of"
41858,1/1/2022,MKD,Selangor,0,0,0,"Macedonia, the former Yugoslav Republic of"
41859,1/1/2022,MLI,Johor,0,0,0,Mali
41860,1/1/2022,MLI,Sabah,0,0,0,Mali
41861,1/1/2022,MLI,Selangor,1,1,0,Mali
41862,1/1/2022,MLT,Johor,0,0,0,Malta
41863,1/1/2022,MLT,Kedah,0,0,0,Malta
41864,1/1/2022,MLT,Kelantan,0,0,0,Malta
41865,1/1/2022,MLT,Perak,0,0,0,Malta
41866,1/1/2022,MLT,Perlis,0,0,0,Malta
41867,1/1/2022,MLT,Pulau Pinang,0,0,0,Malta
41868,1/1/2022,MLT,Sabah,0,0,0,Malta
41869,1/1/2022,MLT,Sarawak,0,0,0,Malta
41870,1/1/2022,MLT,Selangor,3,3,0,Malta
41871,1/1/2022,MLT,W.P. Labuan,0,0,0,Malta
41872,1/1/2022,MMR,Johor,16,15,1,Myanmar
41873,1/1/2022,MMR,Kedah,0,0,0,Myanmar
41874,1/1/2022,MMR,Kelantan,0,0,0,Myanmar
41875,1/1/2022,MMR,Negeri Sembilan,0,0,0,Myanmar
41876,1/1/2022,MMR,Pahang,0,0,0,Myanmar
41877,1/1/2022,MMR,Perak,0,0,0,Myanmar
41878,1/1/2022,MMR,Perlis,0,0,0,Myanmar
41879,1/1/2022,MMR,Pulau Pinang,0,0,0,Myanmar
41880,1/1/2022,MMR,Sabah,0,0,0,Myanmar
41881,1/1/2022,MMR,Sarawak,1,0,1,Myanmar
41882,1/1/2022,MMR,Selangor,357,305,52,Myanmar
41883,1/1/2022,MMR,Terengganu,0,0,0,Myanmar
41884,1/1/2022,MMR,W.P. Labuan,0,0,0,Myanmar
41885,1/1/2022,MNE,Johor,1,1,0,Montenegro
41886,1/1/2022,MNE,Kedah,0,0,0,Montenegro
41887,1/1/2022,MNE,Pulau Pinang,0,0,0,Montenegro
41888,1/1/2022,MNE,Sabah,0,0,0,Montenegro
41889,1/1/2022,MNE,Sarawak,0,0,0,Montenegro
41890,1/1/2022,MNE,Selangor,4,4,0,Montenegro
41891,1/1/2022,MNG,Johor,0,0,0,Mongolia
41892,1/1/2022,MNG,Kedah,0,0,0,Mongolia
41893,1/1/2022,MNG,Kelantan,0,0,0,Mongolia
41894,1/1/2022,MNG,Perak,0,0,0,Mongolia
41895,1/1/2022,MNG,Perlis,0,0,0,Mongolia
41896,1/1/2022,MNG,Pulau Pinang,0,0,0,Mongolia
41897,1/1/2022,MNG,Sabah,0,0,0,Mongolia
41898,1/1/2022,MNG,Sarawak,0,0,0,Mongolia
41899,1/1/2022,MNG,Selangor,9,3,6,Mongolia
41900,1/1/2022,MNP,Selangor,0,0,0,Northern Mariana Islands
41901,1/1/2022,MOZ,Johor,0,0,0,Mozambique
41902,1/1/2022,MOZ,Kedah,0,0,0,Mozambique
41903,1/1/2022,MOZ,Perak,0,0,0,Mozambique
41904,1/1/2022,MOZ,Pulau Pinang,0,0,0,Mozambique
41905,1/1/2022,MOZ,Sabah,0,0,0,Mozambique
41906,1/1/2022,MOZ,Sarawak,0,0,0,Mozambique
41907,1/1/2022,MOZ,Selangor,14,7,7,Mozambique
41908,1/1/2022,MRT,Johor,0,0,0,Mauritania
41909,1/1/2022,MRT,Kedah,0,0,0,Mauritania
41910,1/1/2022,MRT,Pulau Pinang,0,0,0,Mauritania
41911,1/1/2022,MRT,Sabah,0,0,0,Mauritania
41912,1/1/2022,MRT,Sarawak,0,0,0,Mauritania
41913,1/1/2022,MRT,Selangor,18,15,3,Mauritania
41914,1/1/2022,MUS,Johor,0,0,0,Mauritius
41915,1/1/2022,MUS,Kedah,0,0,0,Mauritius
41916,1/1/2022,MUS,Kelantan,0,0,0,Mauritius
41917,1/1/2022,MUS,Pahang,0,0,0,Mauritius
41918,1/1/2022,MUS,Perak,0,0,0,Mauritius
41919,1/1/2022,MUS,Perlis,0,0,0,Mauritius
41920,1/1/2022,MUS,Pulau Pinang,0,0,0,Mauritius
41921,1/1/2022,MUS,Sabah,0,0,0,Mauritius
41922,1/1/2022,MUS,Sarawak,0,0,0,Mauritius
41923,1/1/2022,MUS,Selangor,47,16,31,Mauritius
41924,1/1/2022,MWI,Johor,0,0,0,Malawi
41925,1/1/2022,MWI,Pulau Pinang,0,0,0,Malawi
41926,1/1/2022,MWI,Sabah,0,0,0,Malawi
41927,1/1/2022,MWI,Sarawak,0,0,0,Malawi
41928,1/1/2022,MWI,Selangor,7,3,4,Malawi
41929,1/1/2022,MYT,Selangor,0,0,0,Mayotte
41930,1/1/2022,NAM,Johor,0,0,0,Namibia
41931,1/1/2022,NAM,Kedah,0,0,0,Namibia
41932,1/1/2022,NAM,Perak,0,0,0,Namibia
41933,1/1/2022,NAM,Perlis,0,0,0,Namibia
41934,1/1/2022,NAM,Pulau Pinang,0,0,0,Namibia
41935,1/1/2022,NAM,Sabah,0,0,0,Namibia
41936,1/1/2022,NAM,Sarawak,0,0,0,Namibia
41937,1/1/2022,NAM,Selangor,1,1,0,Namibia
41938,1/1/2022,NCL,Selangor,0,0,0,New Caledonia
41939,1/1/2022,NER,Johor,0,0,0,Niger
41940,1/1/2022,NER,Sabah,0,0,0,Niger
41941,1/1/2022,NER,Selangor,0,0,0,Niger
41942,1/1/2022,NGA,Johor,0,0,0,Nigeria
41943,1/1/2022,NGA,Kedah,0,0,0,Nigeria
41944,1/1/2022,NGA,Perlis,0,0,0,Nigeria
41945,1/1/2022,NGA,Pulau Pinang,0,0,0,Nigeria
41946,1/1/2022,NGA,Sabah,0,0,0,Nigeria
41947,1/1/2022,NGA,Sarawak,0,0,0,Nigeria
41948,1/1/2022,NGA,Selangor,202,157,45,Nigeria
41949,1/1/2022,NIC,Johor,0,0,0,Nicaragua
41950,1/1/2022,NIC,Kedah,0,0,0,Nicaragua
41951,1/1/2022,NIC,Pulau Pinang,0,0,0,Nicaragua
41952,1/1/2022,NIC,Sabah,0,0,0,Nicaragua
41953,1/1/2022,NIC,Selangor,1,1,0,Nicaragua
41954,1/1/2022,NLD,Johor,1,1,0,Netherlands
41955,1/1/2022,NLD,Kedah,10,8,2,Netherlands
41956,1/1/2022,NLD,Kelantan,0,0,0,Netherlands
41957,1/1/2022,NLD,Melaka,0,0,0,Netherlands
41958,1/1/2022,NLD,Negeri Sembilan,0,0,0,Netherlands
41959,1/1/2022,NLD,Pahang,0,0,0,Netherlands
41960,1/1/2022,NLD,Perak,0,0,0,Netherlands
41961,1/1/2022,NLD,Perlis,0,0,0,Netherlands
41962,1/1/2022,NLD,Pulau Pinang,3,2,1,Netherlands
41963,1/1/2022,NLD,Sabah,0,0,0,Netherlands
41964,1/1/2022,NLD,Sarawak,0,0,0,Netherlands
41965,1/1/2022,NLD,Selangor,262,183,79,Netherlands
41966,1/1/2022,NLD,Terengganu,0,0,0,Netherlands
41967,1/1/2022,NLD,W.P. Labuan,0,0,0,Netherlands
41968,1/1/2022,NOR,Johor,0,0,0,Norway
41969,1/1/2022,NOR,Kedah,0,0,0,Norway
41970,1/1/2022,NOR,Kelantan,0,0,0,Norway
41971,1/1/2022,NOR,Melaka,0,0,0,Norway
41972,1/1/2022,NOR,Pahang,0,0,0,Norway
41973,1/1/2022,NOR,Perak,0,0,0,Norway
41974,1/1/2022,NOR,Perlis,0,0,0,Norway
41975,1/1/2022,NOR,Pulau Pinang,0,0,0,Norway
41976,1/1/2022,NOR,Sabah,0,0,0,Norway
41977,1/1/2022,NOR,Sarawak,1,1,0,Norway
41978,1/1/2022,NOR,Selangor,66,45,21,Norway
41979,1/1/2022,NOR,W.P. Labuan,0,0,0,Norway
41980,1/1/2022,NPL,Johor,0,0,0,Nepal
41981,1/1/2022,NPL,Kedah,0,0,0,Nepal
41982,1/1/2022,NPL,Pahang,0,0,0,Nepal
41983,1/1/2022,NPL,Perak,0,0,0,Nepal
41984,1/1/2022,NPL,Perlis,0,0,0,Nepal
41985,1/1/2022,NPL,Pulau Pinang,7,7,0,Nepal
41986,1/1/2022,NPL,Sabah,0,0,0,Nepal
41987,1/1/2022,NPL,Sarawak,0,0,0,Nepal
41988,1/1/2022,NPL,Selangor,647,615,32,Nepal
41989,1/1/2022,NPL,W.P. Labuan,0,0,0,Nepal
41990,1/1/2022,NRU,Johor,0,0,0,Nauru
41991,1/1/2022,NRU,Pulau Pinang,0,0,0,Nauru
41992,1/1/2022,NRU,Selangor,0,0,0,Nauru
41993,1/1/2022,NZL,Johor,3,1,2,New Zealand
41994,1/1/2022,NZL,Kedah,3,2,1,New Zealand
41995,1/1/2022,NZL,Kelantan,0,0,0,New Zealand
41996,1/1/2022,NZL,Melaka,0,0,0,New Zealand
41997,1/1/2022,NZL,Negeri Sembilan,0,0,0,New Zealand
41998,1/1/2022,NZL,Pahang,0,0,0,New Zealand
41999,1/1/2022,NZL,Perak,0,0,0,New Zealand
42000,1/1/2022,NZL,Perlis,0,0,0,New Zealand
42001,1/1/2022,NZL,Pulau Pinang,9,5,4,New Zealand
42002,1/1/2022,NZL,Sabah,1,0,1,New Zealand
42003,1/1/2022,NZL,Sarawak,0,0,0,New Zealand
42004,1/1/2022,NZL,Selangor,140,89,51,New Zealand
42005,1/1/2022,NZL,Terengganu,0,0,0,New Zealand
42006,1/1/2022,NZL,W.P. Labuan,0,0,0,New Zealand
42007,1/1/2022,OMN,Johor,0,0,0,Oman
42008,1/1/2022,OMN,Kedah,0,0,0,Oman
42009,1/1/2022,OMN,Kelantan,0,0,0,Oman
42010,1/1/2022,OMN,Melaka,0,0,0,Oman
42011,1/1/2022,OMN,Perak,0,0,0,Oman
42012,1/1/2022,OMN,Perlis,0,0,0,Oman
42013,1/1/2022,OMN,Pulau Pinang,0,0,0,Oman
42014,1/1/2022,OMN,Sabah,0,0,0,Oman
42015,1/1/2022,OMN,Sarawak,0,0,0,Oman
42016,1/1/2022,OMN,Selangor,82,57,25,Oman
42017,1/1/2022,PAK,Johor,9,9,0,Pakistan
42018,1/1/2022,PAK,Kedah,0,0,0,Pakistan
42019,1/1/2022,PAK,Kelantan,0,0,0,Pakistan
42020,1/1/2022,PAK,Melaka,0,0,0,Pakistan
42021,1/1/2022,PAK,Negeri Sembilan,0,0,0,Pakistan
42022,1/1/2022,PAK,Pahang,0,0,0,Pakistan
42023,1/1/2022,PAK,Perak,0,0,0,Pakistan
42024,1/1/2022,PAK,Perlis,0,0,0,Pakistan
42025,1/1/2022,PAK,Pulau Pinang,0,0,0,Pakistan
42026,1/1/2022,PAK,Sabah,2,2,0,Pakistan
42027,1/1/2022,PAK,Sarawak,2,1,1,Pakistan
42028,1/1/2022,PAK,Selangor,3086,2663,423,Pakistan
42029,1/1/2022,PAK,W.P. Labuan,0,0,0,Pakistan
42030,1/1/2022,PAN,Johor,0,0,0,Panama
42031,1/1/2022,PAN,Kedah,0,0,0,Panama
42032,1/1/2022,PAN,Perak,0,0,0,Panama
42033,1/1/2022,PAN,Perlis,0,0,0,Panama
42034,1/1/2022,PAN,Pulau Pinang,0,0,0,Panama
42035,1/1/2022,PAN,Sabah,0,0,0,Panama
42036,1/1/2022,PAN,Sarawak,0,0,0,Panama
42037,1/1/2022,PAN,Selangor,1,1,0,Panama
42038,1/1/2022,PER,Johor,0,0,0,Peru
42039,1/1/2022,PER,Kedah,0,0,0,Peru
42040,1/1/2022,PER,Kelantan,0,0,0,Peru
42041,1/1/2022,PER,Pahang,0,0,0,Peru
42042,1/1/2022,PER,Perak,0,0,0,Peru
42043,1/1/2022,PER,Perlis,0,0,0,Peru
42044,1/1/2022,PER,Pulau Pinang,0,0,0,Peru
42045,1/1/2022,PER,Sabah,0,0,0,Peru
42046,1/1/2022,PER,Sarawak,0,0,0,Peru
42047,1/1/2022,PER,Selangor,8,5,3,Peru
42048,1/1/2022,PER,W.P. Labuan,0,0,0,Peru
42049,1/1/2022,PHL,Johor,121,116,5,Philippines
42050,1/1/2022,PHL,Kedah,3,1,2,Philippines
42051,1/1/2022,PHL,Kelantan,0,0,0,Philippines
42052,1/1/2022,PHL,Melaka,0,0,0,Philippines
42053,1/1/2022,PHL,Negeri Sembilan,0,0,0,Philippines
42054,1/1/2022,PHL,Pahang,0,0,0,Philippines
42055,1/1/2022,PHL,Perak,0,0,0,Philippines
42056,1/1/2022,PHL,Perlis,0,0,0,Philippines
42057,1/1/2022,PHL,Pulau Pinang,3,2,1,Philippines
42058,1/1/2022,PHL,Sabah,4,1,3,Philippines
42059,1/1/2022,PHL,Sarawak,13,10,3,Philippines
42060,1/1/2022,PHL,Selangor,1336,676,660,Philippines
42061,1/1/2022,PHL,Terengganu,0,0,0,Philippines
42062,1/1/2022,PHL,W.P. Labuan,4,4,0,Philippines
42063,1/1/2022,PLW,Johor,0,0,0,Palau
42064,1/1/2022,PLW,Pulau Pinang,0,0,0,Palau
42065,1/1/2022,PLW,Selangor,0,0,0,Palau
42066,1/1/2022,PNG,Johor,0,0,0,Papua New Guinea
42067,1/1/2022,PNG,Kedah,0,0,0,Papua New Guinea
42068,1/1/2022,PNG,Kelantan,0,0,0,Papua New Guinea
42069,1/1/2022,PNG,Perak,0,0,0,Papua New Guinea
42070,1/1/2022,PNG,Pulau Pinang,0,0,0,Papua New Guinea
42071,1/1/2022,PNG,Sabah,0,0,0,Papua New Guinea
42072,1/1/2022,PNG,Sarawak,0,0,0,Papua New Guinea
42073,1/1/2022,PNG,Selangor,0,0,0,Papua New Guinea
42074,1/1/2022,POL,Johor,0,0,0,Poland
42075,1/1/2022,POL,Kedah,0,0,0,Poland
42076,1/1/2022,POL,Kelantan,0,0,0,Poland
42077,1/1/2022,POL,Melaka,0,0,0,Poland
42078,1/1/2022,POL,Negeri Sembilan,0,0,0,Poland
42079,1/1/2022,POL,Pahang,0,0,0,Poland
42080,1/1/2022,POL,Perak,0,0,0,Poland
42081,1/1/2022,POL,Perlis,0,0,0,Poland
42082,1/1/2022,POL,Pulau Pinang,0,0,0,Poland
42083,1/1/2022,POL,Sabah,0,0,0,Poland
42084,1/1/2022,POL,Sarawak,0,0,0,Poland
42085,1/1/2022,POL,Selangor,74,51,23,Poland
42086,1/1/2022,POL,Terengganu,0,0,0,Poland
42087,1/1/2022,POL,W.P. Labuan,0,0,0,Poland
42088,1/1/2022,PRK,Selangor,0,0,0,"Korea, Democratic People's Republic of"
42089,1/1/2022,PRT,Johor,1,0,1,Portugal
42090,1/1/2022,PRT,Kedah,0,0,0,Portugal
42091,1/1/2022,PRT,Kelantan,0,0,0,Portugal
42092,1/1/2022,PRT,Melaka,0,0,0,Portugal
42093,1/1/2022,PRT,Pahang,0,0,0,Portugal
42094,1/1/2022,PRT,Perak,0,0,0,Portugal
42095,1/1/2022,PRT,Perlis,0,0,0,Portugal
42096,1/1/2022,PRT,Pulau Pinang,0,0,0,Portugal
42097,1/1/2022,PRT,Sabah,0,0,0,Portugal
42098,1/1/2022,PRT,Sarawak,0,0,0,Portugal
42099,1/1/2022,PRT,Selangor,40,27,13,Portugal
42100,1/1/2022,PRT,W.P. Labuan,0,0,0,Portugal
42101,1/1/2022,PRY,Johor,0,0,0,Paraguay
42102,1/1/2022,PRY,Kedah,0,0,0,Paraguay
42103,1/1/2022,PRY,Perak,0,0,0,Paraguay
42104,1/1/2022,PRY,Perlis,0,0,0,Paraguay
42105,1/1/2022,PRY,Pulau Pinang,0,0,0,Paraguay
42106,1/1/2022,PRY,Sabah,0,0,0,Paraguay
42107,1/1/2022,PRY,Sarawak,0,0,0,Paraguay
42108,1/1/2022,PRY,Selangor,0,0,0,Paraguay
42109,1/1/2022,PSE,Johor,0,0,0,"Palestinian Territory, Occupied"
42110,1/1/2022,PSE,Kedah,0,0,0,"Palestinian Territory, Occupied"
42111,1/1/2022,PSE,Kelantan,0,0,0,"Palestinian Territory, Occupied"
42112,1/1/2022,PSE,Melaka,0,0,0,"Palestinian Territory, Occupied"
42113,1/1/2022,PSE,Perak,0,0,0,"Palestinian Territory, Occupied"
42114,1/1/2022,PSE,Perlis,0,0,0,"Palestinian Territory, Occupied"
42115,1/1/2022,PSE,Pulau Pinang,0,0,0,"Palestinian Territory, Occupied"
42116,1/1/2022,PSE,Sabah,0,0,0,"Palestinian Territory, Occupied"
42117,1/1/2022,PSE,Sarawak,0,0,0,"Palestinian Territory, Occupied"
42118,1/1/2022,PSE,Selangor,56,40,16,"Palestinian Territory, Occupied"
42119,1/1/2022,QAT,Johor,0,0,0,Qatar
42120,1/1/2022,QAT,Kedah,0,0,0,Qatar
42121,1/1/2022,QAT,Perlis,0,0,0,Qatar
42122,1/1/2022,QAT,Pulau Pinang,0,0,0,Qatar
42123,1/1/2022,QAT,Sabah,0,0,0,Qatar
42124,1/1/2022,QAT,Sarawak,0,0,0,Qatar
42125,1/1/2022,QAT,Selangor,6,5,1,Qatar
42126,1/1/2022,REU,Johor,0,0,0,Reunion
42127,1/1/2022,REU,Sarawak,0,0,0,Reunion
42128,1/1/2022,ROU,Johor,3,3,0,Romania
42129,1/1/2022,ROU,Kedah,3,1,2,Romania
42130,1/1/2022,ROU,Kelantan,0,0,0,Romania
42131,1/1/2022,ROU,Negeri Sembilan,0,0,0,Romania
42132,1/1/2022,ROU,Pahang,0,0,0,Romania
42133,1/1/2022,ROU,Perak,0,0,0,Romania
42134,1/1/2022,ROU,Perlis,0,0,0,Romania
42135,1/1/2022,ROU,Pulau Pinang,0,0,0,Romania
42136,1/1/2022,ROU,Sabah,0,0,0,Romania
42137,1/1/2022,ROU,Sarawak,2,1,1,Romania
42138,1/1/2022,ROU,Selangor,46,31,15,Romania
42139,1/1/2022,ROU,W.P. Labuan,0,0,0,Romania
42140,1/1/2022,RUS,Johor,14,14,0,Russia
42141,1/1/2022,RUS,Kedah,1,1,0,Russia
42142,1/1/2022,RUS,Kelantan,0,0,0,Russia
42143,1/1/2022,RUS,Melaka,0,0,0,Russia
42144,1/1/2022,RUS,Negeri Sembilan,0,0,0,Russia
42145,1/1/2022,RUS,Pahang,0,0,0,Russia
42146,1/1/2022,RUS,Perak,0,0,0,Russia
42147,1/1/2022,RUS,Perlis,0,0,0,Russia
42148,1/1/2022,RUS,Pulau Pinang,1,1,0,Russia
42149,1/1/2022,RUS,Sabah,0,0,0,Russia
42150,1/1/2022,RUS,Sarawak,0,0,0,Russia
42151,1/1/2022,RUS,Selangor,111,48,63,Russia
42152,1/1/2022,RUS,W.P. Labuan,0,0,0,Russia
42153,1/1/2022,RWA,Johor,0,0,0,Rwanda
42154,1/1/2022,RWA,Kedah,0,0,0,Rwanda
42155,1/1/2022,RWA,Pulau Pinang,0,0,0,Rwanda
42156,1/1/2022,RWA,Selangor,4,1,3,Rwanda
42157,1/1/2022,SAU,Johor,0,0,0,Saudi Arabia
42158,1/1/2022,SAU,Kedah,4,3,1,Saudi Arabia
42159,1/1/2022,SAU,Kelantan,0,0,0,Saudi Arabia
42160,1/1/2022,SAU,Melaka,0,0,0,Saudi Arabia
42161,1/1/2022,SAU,Perak,0,0,0,Saudi Arabia
42162,1/1/2022,SAU,Perlis,0,0,0,Saudi Arabia
42163,1/1/2022,SAU,Pulau Pinang,0,0,0,Saudi Arabia
42164,1/1/2022,SAU,Sabah,0,0,0,Saudi Arabia
42165,1/1/2022,SAU,Sarawak,0,0,0,Saudi Arabia
42166,1/1/2022,SAU,Selangor,240,157,83,Saudi Arabia
42167,1/1/2022,SAU,W.P. Labuan,0,0,0,Saudi Arabia
42168,1/1/2022,SDN,Johor,0,0,0,Sudan
42169,1/1/2022,SDN,Kedah,0,0,0,Sudan
42170,1/1/2022,SDN,Kelantan,0,0,0,Sudan
42171,1/1/2022,SDN,Perlis,0,0,0,Sudan
42172,1/1/2022,SDN,Pulau Pinang,0,0,0,Sudan
42173,1/1/2022,SDN,Sabah,0,0,0,Sudan
42174,1/1/2022,SDN,Sarawak,0,0,0,Sudan
42175,1/1/2022,SDN,Selangor,143,104,39,Sudan
42176,1/1/2022,SDN,W.P. Labuan,0,0,0,Sudan
42177,1/1/2022,SEN,Johor,0,0,0,Senegal
42178,1/1/2022,SEN,Kedah,0,0,0,Senegal
42179,1/1/2022,SEN,Kelantan,0,0,0,Senegal
42180,1/1/2022,SEN,Perak,0,0,0,Senegal
42181,1/1/2022,SEN,Perlis,0,0,0,Senegal
42182,1/1/2022,SEN,Pulau Pinang,0,0,0,Senegal
42183,1/1/2022,SEN,Sabah,0,0,0,Senegal
42184,1/1/2022,SEN,Sarawak,0,0,0,Senegal
42185,1/1/2022,SEN,Selangor,2,2,0,Senegal
42186,1/1/2022,SGP,Johor,3211,1801,1410,Singapore
42187,1/1/2022,SGP,Kedah,12,8,4,Singapore
42188,1/1/2022,SGP,Kelantan,0,0,0,Singapore
42189,1/1/2022,SGP,Melaka,0,0,0,Singapore
42190,1/1/2022,SGP,Negeri Sembilan,0,0,0,Singapore
42191,1/1/2022,SGP,Pahang,0,0,0,Singapore
42192,1/1/2022,SGP,Perak,12,5,7,Singapore
42193,1/1/2022,SGP,Perlis,0,0,0,Singapore
42194,1/1/2022,SGP,Pulau Pinang,14,9,5,Singapore
42195,1/1/2022,SGP,Sabah,1,0,1,Singapore
42196,1/1/2022,SGP,Sarawak,22,13,9,Singapore
42197,1/1/2022,SGP,Selangor,4312,2308,2004,Singapore
42198,1/1/2022,SGP,Terengganu,0,0,0,Singapore
42199,1/1/2022,SGP,W.P. Labuan,0,0,0,Singapore
42200,1/1/2022,SGS,Johor,0,0,0,South Georgia and the South Sandwich Islands
42201,1/1/2022,SGS,Sabah,0,0,0,South Georgia and the South Sandwich Islands
42202,1/1/2022,SGS,Selangor,0,0,0,South Georgia and the South Sandwich Islands
42203,1/1/2022,SHN,Sarawak,0,0,0,"Saint Helena, Ascension and Tristan da Cunha"
42204,1/1/2022,SLB,Johor,0,0,0,Solomon Islands
42205,1/1/2022,SLB,Perlis,0,0,0,Solomon Islands
42206,1/1/2022,SLB,Pulau Pinang,0,0,0,Solomon Islands
42207,1/1/2022,SLB,Sabah,0,0,0,Solomon Islands
42208,1/1/2022,SLB,Sarawak,0,0,0,Solomon Islands
42209,1/1/2022,SLB,Selangor,0,0,0,Solomon Islands
42210,1/1/2022,SLB,W.P. Labuan,0,0,0,Solomon Islands
42211,1/1/2022,SLE,Johor,0,0,0,Sierra Leone
42212,1/1/2022,SLE,Kedah,0,0,0,Sierra Leone
42213,1/1/2022,SLE,Perak,0,0,0,Sierra Leone
42214,1/1/2022,SLE,Pulau Pinang,0,0,0,Sierra Leone
42215,1/1/2022,SLE,Sabah,0,0,0,Sierra Leone
42216,1/1/2022,SLE,Selangor,2,2,0,Sierra Leone
42217,1/1/2022,SLV,Johor,0,0,0,El Salvador
42218,1/1/2022,SLV,Kedah,0,0,0,El Salvador
42219,1/1/2022,SLV,Perak,0,0,0,El Salvador
42220,1/1/2022,SLV,Perlis,0,0,0,El Salvador
42221,1/1/2022,SLV,Pulau Pinang,0,0,0,El Salvador
42222,1/1/2022,SLV,Sabah,0,0,0,El Salvador
42223,1/1/2022,SLV,Selangor,0,0,0,El Salvador
42224,1/1/2022,SLV,W.P. Labuan,0,0,0,El Salvador
42225,1/1/2022,SMR,Johor,0,0,0,San Marino
42226,1/1/2022,SMR,Selangor,1,1,0,San Marino
42227,1/1/2022,SOM,Johor,0,0,0,Somalia
42228,1/1/2022,SOM,Kedah,0,0,0,Somalia
42229,1/1/2022,SOM,Kelantan,0,0,0,Somalia
42230,1/1/2022,SOM,Perlis,0,0,0,Somalia
42231,1/1/2022,SOM,Sabah,0,0,0,Somalia
42232,1/1/2022,SOM,Sarawak,0,0,0,Somalia
42233,1/1/2022,SOM,Selangor,77,52,25,Somalia
42234,1/1/2022,SRB,Johor,0,0,0,Serbia
42235,1/1/2022,SRB,Kedah,0,0,0,Serbia
42236,1/1/2022,SRB,Kelantan,0,0,0,Serbia
42237,1/1/2022,SRB,Pahang,0,0,0,Serbia
42238,1/1/2022,SRB,Perak,0,0,0,Serbia
42239,1/1/2022,SRB,Perlis,0,0,0,Serbia
42240,1/1/2022,SRB,Pulau Pinang,0,0,0,Serbia
42241,1/1/2022,SRB,Sabah,0,0,0,Serbia
42242,1/1/2022,SRB,Sarawak,0,0,0,Serbia
42243,1/1/2022,SRB,Selangor,4,3,1,Serbia
42244,1/1/2022,STP,Selangor,0,0,0,Sao Tome and Principe
42245,1/1/2022,SUR,Johor,0,0,0,Suriname
42246,1/1/2022,SUR,Kedah,0,0,0,Suriname
42247,1/1/2022,SUR,Kelantan,0,0,0,Suriname
42248,1/1/2022,SUR,Perak,0,0,0,Suriname
42249,1/1/2022,SUR,Perlis,0,0,0,Suriname
42250,1/1/2022,SUR,Pulau Pinang,0,0,0,Suriname
42251,1/1/2022,SUR,Sabah,0,0,0,Suriname
42252,1/1/2022,SUR,Sarawak,0,0,0,Suriname
42253,1/1/2022,SUR,Selangor,0,0,0,Suriname
42254,1/1/2022,SVK,Johor,0,0,0,Slovakia
42255,1/1/2022,SVK,Kedah,0,0,0,Slovakia
42256,1/1/2022,SVK,Kelantan,0,0,0,Slovakia
42257,1/1/2022,SVK,Negeri Sembilan,0,0,0,Slovakia
42258,1/1/2022,SVK,Pahang,0,0,0,Slovakia
42259,1/1/2022,SVK,Perak,0,0,0,Slovakia
42260,1/1/2022,SVK,Perlis,0,0,0,Slovakia
42261,1/1/2022,SVK,Pulau Pinang,0,0,0,Slovakia
42262,1/1/2022,SVK,Sabah,0,0,0,Slovakia
42263,1/1/2022,SVK,Sarawak,1,1,0,Slovakia
42264,1/1/2022,SVK,Selangor,33,27,6,Slovakia
42265,1/1/2022,SVK,W.P. Labuan,0,0,0,Slovakia
42266,1/1/2022,SVN,Johor,0,0,0,Slovenia
42267,1/1/2022,SVN,Kedah,0,0,0,Slovenia
42268,1/1/2022,SVN,Kelantan,0,0,0,Slovenia
42269,1/1/2022,SVN,Perak,0,0,0,Slovenia
42270,1/1/2022,SVN,Perlis,0,0,0,Slovenia
42271,1/1/2022,SVN,Pulau Pinang,0,0,0,Slovenia
42272,1/1/2022,SVN,Sabah,0,0,0,Slovenia
42273,1/1/2022,SVN,Sarawak,0,0,0,Slovenia
42274,1/1/2022,SVN,Selangor,3,3,0,Slovenia
42275,1/1/2022,SVN,W.P. Labuan,0,0,0,Slovenia
42276,1/1/2022,SWE,Johor,0,0,0,Sweden
42277,1/1/2022,SWE,Kedah,1,1,0,Sweden
42278,1/1/2022,SWE,Kelantan,0,0,0,Sweden
42279,1/1/2022,SWE,Melaka,0,0,0,Sweden
42280,1/1/2022,SWE,Negeri Sembilan,0,0,0,Sweden
42281,1/1/2022,SWE,Pahang,0,0,0,Sweden
42282,1/1/2022,SWE,Perak,0,0,0,Sweden
42283,1/1/2022,SWE,Perlis,0,0,0,Sweden
42284,1/1/2022,SWE,Pulau Pinang,0,0,0,Sweden
42285,1/1/2022,SWE,Sabah,0,0,0,Sweden
42286,1/1/2022,SWE,Sarawak,0,0,0,Sweden
42287,1/1/2022,SWE,Selangor,86,59,27,Sweden
42288,1/1/2022,SWE,W.P. Labuan,0,0,0,Sweden
42289,1/1/2022,SWZ,Johor,0,0,0,Swaziland
42290,1/1/2022,SWZ,Kedah,0,0,0,Swaziland
42291,1/1/2022,SWZ,Pulau Pinang,0,0,0,Swaziland
42292,1/1/2022,SWZ,Sabah,0,0,0,Swaziland
42293,1/1/2022,SWZ,Selangor,3,1,2,Swaziland
42294,1/1/2022,SYC,Johor,0,0,0,Seychelles
42295,1/1/2022,SYC,Kedah,0,0,0,Seychelles
42296,1/1/2022,SYC,Pulau Pinang,0,0,0,Seychelles
42297,1/1/2022,SYC,Sabah,0,0,0,Seychelles
42298,1/1/2022,SYC,Sarawak,0,0,0,Seychelles
42299,1/1/2022,SYC,Selangor,19,6,13,Seychelles
42300,1/1/2022,SYR,Johor,0,0,0,Syrian Arab Republic
42301,1/1/2022,SYR,Kedah,0,0,0,Syrian Arab Republic
42302,1/1/2022,SYR,Kelantan,0,0,0,Syrian Arab Republic
42303,1/1/2022,SYR,Pahang,0,0,0,Syrian Arab Republic
42304,1/1/2022,SYR,Perlis,0,0,0,Syrian Arab Republic
42305,1/1/2022,SYR,Pulau Pinang,0,0,0,Syrian Arab Republic
42306,1/1/2022,SYR,Sabah,0,0,0,Syrian Arab Republic
42307,1/1/2022,SYR,Sarawak,0,0,0,Syrian Arab Republic
42308,1/1/2022,SYR,Selangor,98,66,32,Syrian Arab Republic
42309,1/1/2022,SYR,W.P. Labuan,0,0,0,Syrian Arab Republic
42310,1/1/2022,TCA,Perlis,0,0,0,Turks and Caicos
42311,1/1/2022,TCD,Johor,0,0,0,Chad
42312,1/1/2022,TCD,Kedah,0,0,0,Chad
42313,1/1/2022,TCD,Perlis,0,0,0,Chad
42314,1/1/2022,TCD,Selangor,8,8,0,Chad
42315,1/1/2022,TGO,Johor,0,0,0,Togo
42316,1/1/2022,TGO,Perak,0,0,0,Togo
42317,1/1/2022,TGO,Pulau Pinang,0,0,0,Togo
42318,1/1/2022,TGO,Selangor,0,0,0,Togo
42319,1/1/2022,THA,Johor,70,68,2,Thailand
42320,1/1/2022,THA,Kedah,18304,18252,52,Thailand
42321,1/1/2022,THA,Kelantan,2,1,1,Thailand
42322,1/1/2022,THA,Melaka,0,0,0,Thailand
42323,1/1/2022,THA,Negeri Sembilan,0,0,0,Thailand
42324,1/1/2022,THA,Pahang,0,0,0,Thailand
42325,1/1/2022,THA,Perak,0,0,0,Thailand
42326,1/1/2022,THA,Perlis,9168,9012,156,Thailand
42327,1/1/2022,THA,Pulau Pinang,16,11,5,Thailand
42328,1/1/2022,THA,Sabah,3,1,2,Thailand
42329,1/1/2022,THA,Sarawak,13,12,1,Thailand
42330,1/1/2022,THA,Selangor,1071,401,670,Thailand
42331,1/1/2022,THA,Terengganu,0,0,0,Thailand
42332,1/1/2022,THA,W.P. Labuan,0,0,0,Thailand
42333,1/1/2022,TJK,Johor,0,0,0,Tajikistan
42334,1/1/2022,TJK,Kedah,0,0,0,Tajikistan
42335,1/1/2022,TJK,Perlis,0,0,0,Tajikistan
42336,1/1/2022,TJK,Pulau Pinang,0,0,0,Tajikistan
42337,1/1/2022,TJK,Sabah,0,0,0,Tajikistan
42338,1/1/2022,TJK,Selangor,6,5,1,Tajikistan
42339,1/1/2022,TKL,Selangor,0,0,0,Tokelau
42340,1/1/2022,TKM,Johor,0,0,0,Turkmenistan
42341,1/1/2022,TKM,Kedah,0,0,0,Turkmenistan
42342,1/1/2022,TKM,Kelantan,0,0,0,Turkmenistan
42343,1/1/2022,TKM,Perlis,0,0,0,Turkmenistan
42344,1/1/2022,TKM,Pulau Pinang,0,0,0,Turkmenistan
42345,1/1/2022,TKM,Sabah,0,0,0,Turkmenistan
42346,1/1/2022,TKM,Sarawak,0,0,0,Turkmenistan
42347,1/1/2022,TKM,Selangor,10,4,6,Turkmenistan
42348,1/1/2022,TLS,Johor,0,0,0,Timor-Leste
42349,1/1/2022,TLS,Kedah,0,0,0,Timor-Leste
42350,1/1/2022,TLS,Perlis,0,0,0,Timor-Leste
42351,1/1/2022,TLS,Pulau Pinang,0,0,0,Timor-Leste
42352,1/1/2022,TLS,Sabah,0,0,0,Timor-Leste
42353,1/1/2022,TLS,Sarawak,0,0,0,Timor-Leste
42354,1/1/2022,TLS,Selangor,13,7,6,Timor-Leste
42355,1/1/2022,TON,Johor,0,0,0,Tonga
42356,1/1/2022,TON,Pulau Pinang,0,0,0,Tonga
42357,1/1/2022,TON,Sarawak,0,0,0,Tonga
42358,1/1/2022,TON,Selangor,0,0,0,Tonga
42359,1/1/2022,TTO,Johor,0,0,0,Trinidad and Tobago
42360,1/1/2022,TTO,Kedah,0,0,0,Trinidad and Tobago
42361,1/1/2022,TTO,Pahang,0,0,0,Trinidad and Tobago
42362,1/1/2022,TTO,Pulau Pinang,0,0,0,Trinidad and Tobago
42363,1/1/2022,TTO,Sabah,0,0,0,Trinidad and Tobago
42364,1/1/2022,TTO,Sarawak,0,0,0,Trinidad and Tobago
42365,1/1/2022,TTO,Selangor,7,5,2,Trinidad and Tobago
42366,1/1/2022,TUN,Johor,0,0,0,Tunisia
42367,1/1/2022,TUN,Kedah,0,0,0,Tunisia
42368,1/1/2022,TUN,Kelantan,0,0,0,Tunisia
42369,1/1/2022,TUN,Melaka,0,0,0,Tunisia
42370,1/1/2022,TUN,Perak,0,0,0,Tunisia
42371,1/1/2022,TUN,Perlis,0,0,0,Tunisia
42372,1/1/2022,TUN,Pulau Pinang,0,0,0,Tunisia
42373,1/1/2022,TUN,Sabah,0,0,0,Tunisia
42374,1/1/2022,TUN,Sarawak,0,0,0,Tunisia
42375,1/1/2022,TUN,Selangor,24,15,9,Tunisia
42376,1/1/2022,TUN,W.P. Labuan,0,0,0,Tunisia
42377,1/1/2022,TUR,Johor,9,9,0,Turkey
42378,1/1/2022,TUR,Kedah,0,0,0,Turkey
42379,1/1/2022,TUR,Kelantan,0,0,0,Turkey
42380,1/1/2022,TUR,Melaka,0,0,0,Turkey
42381,1/1/2022,TUR,Negeri Sembilan,0,0,0,Turkey
42382,1/1/2022,TUR,Pahang,0,0,0,Turkey
42383,1/1/2022,TUR,Perak,0,0,0,Turkey
42384,1/1/2022,TUR,Perlis,0,0,0,Turkey
42385,1/1/2022,TUR,Pulau Pinang,0,0,0,Turkey
42386,1/1/2022,TUR,Sabah,0,0,0,Turkey
42387,1/1/2022,TUR,Sarawak,0,0,0,Turkey
42388,1/1/2022,TUR,Selangor,131,92,39,Turkey
42389,1/1/2022,TUR,W.P. Labuan,0,0,0,Turkey
42390,1/1/2022,TUV,Selangor,0,0,0,Tuvalu
42391,1/1/2022,TWN,Johor,1,1,0,Taiwan
42392,1/1/2022,TWN,Kedah,2,0,2,Taiwan
42393,1/1/2022,TWN,Kelantan,0,0,0,Taiwan
42394,1/1/2022,TWN,Melaka,0,0,0,Taiwan
42395,1/1/2022,TWN,Negeri Sembilan,0,0,0,Taiwan
42396,1/1/2022,TWN,Pahang,0,0,0,Taiwan
42397,1/1/2022,TWN,Perak,0,0,0,Taiwan
42398,1/1/2022,TWN,Perlis,0,0,0,Taiwan
42399,1/1/2022,TWN,Pulau Pinang,26,13,13,Taiwan
42400,1/1/2022,TWN,Sabah,1,1,0,Taiwan
42401,1/1/2022,TWN,Sarawak,3,2,1,Taiwan
42402,1/1/2022,TWN,Selangor,205,117,88,Taiwan
42403,1/1/2022,TWN,W.P. Labuan,0,0,0,Taiwan
42404,1/1/2022,TZA,Johor,0,0,0,"Tanzania, United Republic of"
42405,1/1/2022,TZA,Kedah,0,0,0,"Tanzania, United Republic of"
42406,1/1/2022,TZA,Perak,0,0,0,"Tanzania, United Republic of"
42407,1/1/2022,TZA,Perlis,0,0,0,"Tanzania, United Republic of"
42408,1/1/2022,TZA,Pulau Pinang,0,0,0,"Tanzania, United Republic of"
42409,1/1/2022,TZA,Sabah,0,0,0,"Tanzania, United Republic of"
42410,1/1/2022,TZA,Sarawak,0,0,0,"Tanzania, United Republic of"
42411,1/1/2022,TZA,Selangor,41,20,21,"Tanzania, United Republic of"
42412,1/1/2022,UGA,Johor,0,0,0,Uganda
42413,1/1/2022,UGA,Kedah,0,0,0,Uganda
42414,1/1/2022,UGA,Perak,0,0,0,Uganda
42415,1/1/2022,UGA,Perlis,0,0,0,Uganda
42416,1/1/2022,UGA,Pulau Pinang,0,0,0,Uganda
42417,1/1/2022,UGA,Sabah,0,0,0,Uganda
42418,1/1/2022,UGA,Sarawak,0,0,0,Uganda
42419,1/1/2022,UGA,Selangor,17,7,10,Uganda
42420,1/1/2022,UKR,Johor,17,17,0,Ukraine
42421,1/1/2022,UKR,Kedah,2,0,2,Ukraine
42422,1/1/2022,UKR,Kelantan,0,0,0,Ukraine
42423,1/1/2022,UKR,Melaka,0,0,0,Ukraine
42424,1/1/2022,UKR,Negeri Sembilan,0,0,0,Ukraine
42425,1/1/2022,UKR,Pahang,0,0,0,Ukraine
42426,1/1/2022,UKR,Perak,0,0,0,Ukraine
42427,1/1/2022,UKR,Perlis,0,0,0,Ukraine
42428,1/1/2022,UKR,Pulau Pinang,2,2,0,Ukraine
42429,1/1/2022,UKR,Sabah,0,0,0,Ukraine
42430,1/1/2022,UKR,Sarawak,1,1,0,Ukraine
42431,1/1/2022,UKR,Selangor,81,62,19,Ukraine
42432,1/1/2022,UKR,W.P. Labuan,0,0,0,Ukraine
42433,1/1/2022,URY,Johor,0,0,0,Uruguay
42434,1/1/2022,URY,Kedah,0,0,0,Uruguay
42435,1/1/2022,URY,Kelantan,0,0,0,Uruguay
42436,1/1/2022,URY,Perak,0,0,0,Uruguay
42437,1/1/2022,URY,Perlis,0,0,0,Uruguay
42438,1/1/2022,URY,Pulau Pinang,0,0,0,Uruguay
42439,1/1/2022,URY,Sabah,0,0,0,Uruguay
42440,1/1/2022,URY,Sarawak,0,0,0,Uruguay
42441,1/1/2022,URY,Selangor,0,0,0,Uruguay
42442,1/1/2022,URY,W.P. Labuan,0,0,0,Uruguay
42443,1/1/2022,USA,Johor,3,2,1,United States Of America
42444,1/1/2022,USA,Kedah,33,20,13,United States Of America
42445,1/1/2022,USA,Kelantan,0,0,0,United States Of America
42446,1/1/2022,USA,Melaka,0,0,0,United States Of America
42447,1/1/2022,USA,Negeri Sembilan,0,0,0,United States Of America
42448,1/1/2022,USA,Pahang,0,0,0,United States Of America
42449,1/1/2022,USA,Perak,1,0,1,United States Of America
42450,1/1/2022,USA,Perlis,0,0,0,United States Of America
42451,1/1/2022,USA,Pulau Pinang,10,7,3,United States Of America
42452,1/1/2022,USA,Sabah,1,0,1,United States Of America
42453,1/1/2022,USA,Sarawak,3,1,2,United States Of America
42454,1/1/2022,USA,Selangor,1045,635,410,United States Of America
42455,1/1/2022,USA,Terengganu,0,0,0,United States Of America
42456,1/1/2022,USA,W.P. Labuan,0,0,0,United States Of America
42457,1/1/2022,UZB,Johor,0,0,0,Uzbekistan
42458,1/1/2022,UZB,Kedah,0,0,0,Uzbekistan
42459,1/1/2022,UZB,Kelantan,0,0,0,Uzbekistan
42460,1/1/2022,UZB,Perak,0,0,0,Uzbekistan
42461,1/1/2022,UZB,Perlis,0,0,0,Uzbekistan
42462,1/1/2022,UZB,Pulau Pinang,0,0,0,Uzbekistan
42463,1/1/2022,UZB,Sabah,0,0,0,Uzbekistan
42464,1/1/2022,UZB,Sarawak,0,0,0,Uzbekistan
42465,1/1/2022,UZB,Selangor,45,27,18,Uzbekistan
42466,1/1/2022,VAT,Johor,0,0,0,Holy See (Vatican City State)
42467,1/1/2022,VAT,Sarawak,0,0,0,Holy See (Vatican City State)
42468,1/1/2022,VAT,Selangor,0,0,0,Holy See (Vatican City State)
42469,1/1/2022,VCT,Johor,0,0,0,Saint Vincent and the Grenadines
42470,1/1/2022,VCT,Kedah,0,0,0,Saint Vincent and the Grenadines
42471,1/1/2022,VCT,Pulau Pinang,0,0,0,Saint Vincent and the Grenadines
42472,1/1/2022,VCT,Sarawak,0,0,0,Saint Vincent and the Grenadines
42473,1/1/2022,VCT,Selangor,0,0,0,Saint Vincent and the Grenadines
42474,1/1/2022,VEN,Johor,0,0,0,Venezuela
42475,1/1/2022,VEN,Kedah,0,0,0,Venezuela
42476,1/1/2022,VEN,Kelantan,0,0,0,Venezuela
42477,1/1/2022,VEN,Melaka,0,0,0,Venezuela
42478,1/1/2022,VEN,Perak,0,0,0,Venezuela
42479,1/1/2022,VEN,Perlis,0,0,0,Venezuela
42480,1/1/2022,VEN,Pulau Pinang,0,0,0,Venezuela
42481,1/1/2022,VEN,Sabah,0,0,0,Venezuela
42482,1/1/2022,VEN,Sarawak,0,0,0,Venezuela
42483,1/1/2022,VEN,Selangor,19,9,10,Venezuela
42484,1/1/2022,VEN,W.P. Labuan,0,0,0,Venezuela
42485,1/1/2022,VNM,Johor,12,9,3,Vietnam
42486,1/1/2022,VNM,Kedah,11,2,9,Vietnam
42487,1/1/2022,VNM,Kelantan,2,0,2,Vietnam
42488,1/1/2022,VNM,Melaka,0,0,0,Vietnam
42489,1/1/2022,VNM,Negeri Sembilan,0,0,0,Vietnam
42490,1/1/2022,VNM,Pahang,0,0,0,Vietnam
42491,1/1/2022,VNM,Perak,0,0,0,Vietnam
42492,1/1/2022,VNM,Perlis,0,0,0,Vietnam
42493,1/1/2022,VNM,Pulau Pinang,2,1,1,Vietnam
42494,1/1/2022,VNM,Sabah,1,0,1,Vietnam
42495,1/1/2022,VNM,Sarawak,3,0,3,Vietnam
42496,1/1/2022,VNM,Selangor,255,55,200,Vietnam
42497,1/1/2022,VNM,Terengganu,0,0,0,Vietnam
42498,1/1/2022,VNM,W.P. Labuan,2,2,0,Vietnam
42499,1/1/2022,VUT,Johor,0,0,0,Vanuatu
42500,1/1/2022,VUT,Kedah,0,0,0,Vanuatu
42501,1/1/2022,VUT,Pulau Pinang,0,0,0,Vanuatu
42502,1/1/2022,VUT,Sabah,0,0,0,Vanuatu
42503,1/1/2022,VUT,Sarawak,0,0,0,Vanuatu
42504,1/1/2022,VUT,Selangor,1,1,0,Vanuatu
42505,1/1/2022,WSM,Johor,0,0,0,Samoa
42506,1/1/2022,WSM,Sarawak,0,0,0,Samoa
42507,1/1/2022,WSM,Selangor,0,0,0,Samoa
42508,1/1/2022,YEM,Johor,0,0,0,Yemen
42509,1/1/2022,YEM,Kedah,1,1,0,Yemen
42510,1/1/2022,YEM,Kelantan,0,0,0,Yemen
42511,1/1/2022,YEM,Melaka,0,0,0,Yemen
42512,1/1/2022,YEM,Pahang,0,0,0,Yemen
42513,1/1/2022,YEM,Perak,0,0,0,Yemen
42514,1/1/2022,YEM,Perlis,0,0,0,Yemen
42515,1/1/2022,YEM,Pulau Pinang,0,0,0,Yemen
42516,1/1/2022,YEM,Sabah,0,0,0,Yemen
42517,1/1/2022,YEM,Sarawak,0,0,0,Yemen
42518,1/1/2022,YEM,Selangor,315,215,100,Yemen
42519,1/1/2022,YEM,W.P. Labuan,0,0,0,Yemen
42520,1/1/2022,ZAF,Johor,0,0,0,South Africa
42521,1/1/2022,ZAF,Kedah,1,1,0,South Africa
42522,1/1/2022,ZAF,Kelantan,0,0,0,South Africa
42523,1/1/2022,ZAF,Melaka,0,0,0,South Africa
42524,1/1/2022,ZAF,Pahang,0,0,0,South Africa
42525,1/1/2022,ZAF,Perak,0,0,0,South Africa
42526,1/1/2022,ZAF,Perlis,0,0,0,South Africa
42527,1/1/2022,ZAF,Pulau Pinang,1,1,0,South Africa
42528,1/1/2022,ZAF,Sabah,0,0,0,South Africa
42529,1/1/2022,ZAF,Sarawak,4,3,1,South Africa
42530,1/1/2022,ZAF,Selangor,102,64,38,South Africa
42531,1/1/2022,ZAF,Terengganu,0,0,0,South Africa
42532,1/1/2022,ZAF,W.P. Labuan,0,0,0,South Africa
42533,1/1/2022,ZMB,Johor,0,0,0,Zambia
42534,1/1/2022,ZMB,Kedah,0,0,0,Zambia
42535,1/1/2022,ZMB,Perak,0,0,0,Zambia
42536,1/1/2022,ZMB,Perlis,0,0,0,Zambia
42537,1/1/2022,ZMB,Pulau Pinang,0,0,0,Zambia
42538,1/1/2022,ZMB,Sabah,0,0,0,Zambia
42539,1/1/2022,ZMB,Sarawak,0,0,0,Zambia
42540,1/1/2022,ZMB,Selangor,8,5,3,Zambia
42541,1/1/2022,ZWE,Johor,0,0,0,Zimbabwe
42542,1/1/2022,ZWE,Kedah,0,0,0,Zimbabwe
42543,1/1/2022,ZWE,Kelantan,0,0,0,Zimbabwe
42544,1/1/2022,ZWE,Perak,0,0,0,Zimbabwe
42545,1/1/2022,ZWE,Perlis,0,0,0,Zimbabwe
42546,1/1/2022,ZWE,Pulau Pinang,0,0,0,Zimbabwe
42547,1/1/2022,ZWE,Sabah,0,0,0,Zimbabwe
42548,1/1/2022,ZWE,Sarawak,0,0,0,Zimbabwe
42549,1/1/2022,ZWE,Selangor,25,9,16,Zimbabwe
42550,2/1/2022,ABW,Kedah,0,0,0,Aruba
42551,2/1/2022,ABW,Pulau Pinang,0,0,0,Aruba
42552,2/1/2022,AFG,Johor,0,0,0,Afghanistan
42553,2/1/2022,AFG,Kedah,0,0,0,Afghanistan
42554,2/1/2022,AFG,Perlis,0,0,0,Afghanistan
42555,2/1/2022,AFG,Pulau Pinang,0,0,0,Afghanistan
42556,2/1/2022,AFG,Sarawak,0,0,0,Afghanistan
42557,2/1/2022,AFG,Selangor,76,53,23,Afghanistan
42558,2/1/2022,AGO,Johor,0,0,0,Angola
42559,2/1/2022,AGO,Kedah,0,0,0,Angola
42560,2/1/2022,AGO,Sabah,0,0,0,Angola
42561,2/1/2022,AGO,Selangor,0,0,0,Angola
42562,2/1/2022,AIA,Selangor,0,0,0,Anguilla
42563,2/1/2022,ALB,Johor,0,0,0,Albania
42564,2/1/2022,ALB,Kedah,0,0,0,Albania
42565,2/1/2022,ALB,Perak,0,0,0,Albania
42566,2/1/2022,ALB,Perlis,0,0,0,Albania
42567,2/1/2022,ALB,Pulau Pinang,0,0,0,Albania
42568,2/1/2022,ALB,Sabah,0,0,0,Albania
42569,2/1/2022,ALB,Sarawak,0,0,0,Albania
42570,2/1/2022,ALB,Selangor,3,2,1,Albania
42571,2/1/2022,AND,Johor,0,0,0,Andorra
42572,2/1/2022,AND,Kedah,0,0,0,Andorra
42573,2/1/2022,AND,Perlis,0,0,0,Andorra
42574,2/1/2022,AND,Pulau Pinang,0,0,0,Andorra
42575,2/1/2022,AND,Selangor,0,0,0,Andorra
42576,2/1/2022,ANT,Selangor,0,0,0,Netherlands Antilles
42577,2/1/2022,ARE,Johor,0,0,0,United Arab Emirates
42578,2/1/2022,ARE,Kedah,0,0,0,United Arab Emirates
42579,2/1/2022,ARE,Kelantan,1,1,0,United Arab Emirates
42580,2/1/2022,ARE,Perak,0,0,0,United Arab Emirates
42581,2/1/2022,ARE,Perlis,0,0,0,United Arab Emirates
42582,2/1/2022,ARE,Pulau Pinang,0,0,0,United Arab Emirates
42583,2/1/2022,ARE,Sabah,0,0,0,United Arab Emirates
42584,2/1/2022,ARE,Sarawak,0,0,0,United Arab Emirates
42585,2/1/2022,ARE,Selangor,5,4,1,United Arab Emirates
42586,2/1/2022,ARG,Johor,0,0,0,Argentina
42587,2/1/2022,ARG,Kedah,0,0,0,Argentina
42588,2/1/2022,ARG,Kelantan,0,0,0,Argentina
42589,2/1/2022,ARG,Melaka,0,0,0,Argentina
42590,2/1/2022,ARG,Perak,0,0,0,Argentina
42591,2/1/2022,ARG,Perlis,0,0,0,Argentina
42592,2/1/2022,ARG,Pulau Pinang,0,0,0,Argentina
42593,2/1/2022,ARG,Sabah,0,0,0,Argentina
42594,2/1/2022,ARG,Sarawak,0,0,0,Argentina
42595,2/1/2022,ARG,Selangor,19,13,6,Argentina
42596,2/1/2022,ARG,W.P. Labuan,0,0,0,Argentina
42597,2/1/2022,ARM,Johor,0,0,0,Armenia
42598,2/1/2022,ARM,Kedah,0,0,0,Armenia
42599,2/1/2022,ARM,Kelantan,0,0,0,Armenia
42600,2/1/2022,ARM,Perak,0,0,0,Armenia
42601,2/1/2022,ARM,Perlis,0,0,0,Armenia
42602,2/1/2022,ARM,Pulau Pinang,0,0,0,Armenia
42603,2/1/2022,ARM,Sabah,0,0,0,Armenia
42604,2/1/2022,ARM,Sarawak,0,0,0,Armenia
42605,2/1/2022,ARM,Selangor,1,0,1,Armenia
42606,2/1/2022,ATA,Selangor,0,0,0,Antarctica
42607,2/1/2022,ATG,Johor,0,0,0,Antigua and Barbuda
42608,2/1/2022,ATG,Kedah,0,0,0,Antigua and Barbuda
42609,2/1/2022,ATG,Pulau Pinang,0,0,0,Antigua and Barbuda
42610,2/1/2022,ATG,Sarawak,0,0,0,Antigua and Barbuda
42611,2/1/2022,ATG,Selangor,5,2,3,Antigua and Barbuda
42612,2/1/2022,AUS,Johor,0,0,0,Australia
42613,2/1/2022,AUS,Kedah,68,44,24,Australia
42614,2/1/2022,AUS,Kelantan,0,0,0,Australia
42615,2/1/2022,AUS,Melaka,0,0,0,Australia
42616,2/1/2022,AUS,Negeri Sembilan,0,0,0,Australia
42617,2/1/2022,AUS,Pahang,0,0,0,Australia
42618,2/1/2022,AUS,Perak,3,0,3,Australia
42619,2/1/2022,AUS,Perlis,0,0,0,Australia
42620,2/1/2022,AUS,Pulau Pinang,18,7,11,Australia
42621,2/1/2022,AUS,Sabah,0,0,0,Australia
42622,2/1/2022,AUS,Sarawak,7,4,3,Australia
42623,2/1/2022,AUS,Selangor,474,319,155,Australia
42624,2/1/2022,AUS,Terengganu,0,0,0,Australia
42625,2/1/2022,AUS,W.P. Labuan,0,0,0,Australia
42626,2/1/2022,AUT,Johor,0,0,0,Austria
42627,2/1/2022,AUT,Kedah,1,1,0,Austria
42628,2/1/2022,AUT,Kelantan,0,0,0,Austria
42629,2/1/2022,AUT,Melaka,0,0,0,Austria
42630,2/1/2022,AUT,Negeri Sembilan,0,0,0,Austria
42631,2/1/2022,AUT,Pahang,0,0,0,Austria
42632,2/1/2022,AUT,Perak,0,0,0,Austria
42633,2/1/2022,AUT,Perlis,0,0,0,Austria
42634,2/1/2022,AUT,Pulau Pinang,0,0,0,Austria
42635,2/1/2022,AUT,Sabah,0,0,0,Austria
42636,2/1/2022,AUT,Sarawak,0,0,0,Austria
42637,2/1/2022,AUT,Selangor,45,38,7,Austria
42638,2/1/2022,AUT,Terengganu,0,0,0,Austria
42639,2/1/2022,AUT,W.P. Labuan,0,0,0,Austria
42640,2/1/2022,AZE,Johor,0,0,0,Azerbaijan
42641,2/1/2022,AZE,Kedah,0,0,0,Azerbaijan
42642,2/1/2022,AZE,Kelantan,0,0,0,Azerbaijan
42643,2/1/2022,AZE,Melaka,0,0,0,Azerbaijan
42644,2/1/2022,AZE,Perlis,0,0,0,Azerbaijan
42645,2/1/2022,AZE,Pulau Pinang,0,0,0,Azerbaijan
42646,2/1/2022,AZE,Sabah,0,0,0,Azerbaijan
42647,2/1/2022,AZE,Sarawak,0,0,0,Azerbaijan
42648,2/1/2022,AZE,Selangor,3,3,0,Azerbaijan
42649,2/1/2022,AZE,W.P. Labuan,0,0,0,Azerbaijan
42650,2/1/2022,BDI,Pulau Pinang,0,0,0,Burundi
42651,2/1/2022,BDI,Sarawak,0,0,0,Burundi
42652,2/1/2022,BDI,Selangor,1,1,0,Burundi
42653,2/1/2022,BEL,Johor,0,0,0,Belgium
42654,2/1/2022,BEL,Kedah,0,0,0,Belgium
42655,2/1/2022,BEL,Kelantan,0,0,0,Belgium
42656,2/1/2022,BEL,Melaka,0,0,0,Belgium
42657,2/1/2022,BEL,Negeri Sembilan,0,0,0,Belgium
42658,2/1/2022,BEL,Pahang,0,0,0,Belgium
42659,2/1/2022,BEL,Perak,0,0,0,Belgium
42660,2/1/2022,BEL,Perlis,0,0,0,Belgium
42661,2/1/2022,BEL,Pulau Pinang,1,1,0,Belgium
42662,2/1/2022,BEL,Sabah,0,0,0,Belgium
42663,2/1/2022,BEL,Sarawak,1,1,0,Belgium
42664,2/1/2022,BEL,Selangor,51,36,15,Belgium
42665,2/1/2022,BEL,W.P. Labuan,0,0,0,Belgium
42666,2/1/2022,BEN,Johor,0,0,0,Benin
42667,2/1/2022,BEN,Kedah,1,1,0,Benin
42668,2/1/2022,BEN,Perak,0,0,0,Benin
42669,2/1/2022,BEN,Pulau Pinang,0,0,0,Benin
42670,2/1/2022,BEN,Sabah,0,0,0,Benin
42671,2/1/2022,BEN,Sarawak,0,0,0,Benin
42672,2/1/2022,BEN,Selangor,0,0,0,Benin
42673,2/1/2022,BFA,Perak,0,0,0,Burkina Faso
42674,2/1/2022,BFA,Pulau Pinang,0,0,0,Burkina Faso
42675,2/1/2022,BFA,Selangor,0,0,0,Burkina Faso
42676,2/1/2022,BGD,Johor,15,13,2,Bangladesh
42677,2/1/2022,BGD,Kedah,0,0,0,Bangladesh
42678,2/1/2022,BGD,Kelantan,0,0,0,Bangladesh
42679,2/1/2022,BGD,Melaka,0,0,0,Bangladesh
42680,2/1/2022,BGD,Negeri Sembilan,0,0,0,Bangladesh
42681,2/1/2022,BGD,Pahang,0,0,0,Bangladesh
42682,2/1/2022,BGD,Perak,0,0,0,Bangladesh
42683,2/1/2022,BGD,Perlis,0,0,0,Bangladesh
42684,2/1/2022,BGD,Pulau Pinang,2,2,0,Bangladesh
42685,2/1/2022,BGD,Sabah,0,0,0,Bangladesh
42686,2/1/2022,BGD,Sarawak,0,0,0,Bangladesh
42687,2/1/2022,BGD,Selangor,5698,5346,352,Bangladesh
42688,2/1/2022,BGD,W.P. Labuan,0,0,0,Bangladesh
42689,2/1/2022,BGR,Johor,0,0,0,Bulgaria
42690,2/1/2022,BGR,Kedah,0,0,0,Bulgaria
42691,2/1/2022,BGR,Kelantan,0,0,0,Bulgaria
42692,2/1/2022,BGR,Pahang,0,0,0,Bulgaria
42693,2/1/2022,BGR,Perak,0,0,0,Bulgaria
42694,2/1/2022,BGR,Perlis,0,0,0,Bulgaria
42695,2/1/2022,BGR,Pulau Pinang,0,0,0,Bulgaria
42696,2/1/2022,BGR,Sabah,0,0,0,Bulgaria
42697,2/1/2022,BGR,Sarawak,0,0,0,Bulgaria
42698,2/1/2022,BGR,Selangor,17,14,3,Bulgaria
42699,2/1/2022,BGR,W.P. Labuan,0,0,0,Bulgaria
42700,2/1/2022,BHR,Johor,0,0,0,Bahrain
42701,2/1/2022,BHR,Kedah,0,0,0,Bahrain
42702,2/1/2022,BHR,Kelantan,0,0,0,Bahrain
42703,2/1/2022,BHR,Perlis,0,0,0,Bahrain
42704,2/1/2022,BHR,Pulau Pinang,0,0,0,Bahrain
42705,2/1/2022,BHR,Sabah,0,0,0,Bahrain
42706,2/1/2022,BHR,Sarawak,0,0,0,Bahrain
42707,2/1/2022,BHR,Selangor,4,4,0,Bahrain
42708,2/1/2022,BHS,Johor,0,0,0,Bahamas
42709,2/1/2022,BHS,Kedah,0,0,0,Bahamas
42710,2/1/2022,BHS,Perak,0,0,0,Bahamas
42711,2/1/2022,BHS,Sabah,0,0,0,Bahamas
42712,2/1/2022,BHS,Sarawak,0,0,0,Bahamas
42713,2/1/2022,BHS,Selangor,0,0,0,Bahamas
42714,2/1/2022,BIH,Johor,0,0,0,Bosnia and Herzegovina
42715,2/1/2022,BIH,Kedah,0,0,0,Bosnia and Herzegovina
42716,2/1/2022,BIH,Perlis,0,0,0,Bosnia and Herzegovina
42717,2/1/2022,BIH,Pulau Pinang,0,0,0,Bosnia and Herzegovina
42718,2/1/2022,BIH,Sabah,0,0,0,Bosnia and Herzegovina
42719,2/1/2022,BIH,Sarawak,0,0,0,Bosnia and Herzegovina
42720,2/1/2022,BIH,Selangor,11,10,1,Bosnia and Herzegovina
42721,2/1/2022,BLR,Johor,1,1,0,Belarus
42722,2/1/2022,BLR,Kedah,0,0,0,Belarus
42723,2/1/2022,BLR,Kelantan,0,0,0,Belarus
42724,2/1/2022,BLR,Pahang,0,0,0,Belarus
42725,2/1/2022,BLR,Perak,0,0,0,Belarus
42726,2/1/2022,BLR,Perlis,0,0,0,Belarus
42727,2/1/2022,BLR,Pulau Pinang,0,0,0,Belarus
42728,2/1/2022,BLR,Sabah,0,0,0,Belarus
42729,2/1/2022,BLR,Sarawak,0,0,0,Belarus
42730,2/1/2022,BLR,Selangor,5,3,2,Belarus
42731,2/1/2022,BLR,W.P. Labuan,0,0,0,Belarus
42732,2/1/2022,BLZ,Johor,0,0,0,Belize
42733,2/1/2022,BLZ,Pulau Pinang,0,0,0,Belize
42734,2/1/2022,BLZ,Sarawak,0,0,0,Belize
42735,2/1/2022,BLZ,Selangor,0,0,0,Belize
42736,2/1/2022,BMU,Selangor,0,0,0,Bermuda
42737,2/1/2022,BOL,Johor,0,0,0,Bolivia
42738,2/1/2022,BOL,Kedah,0,0,0,Bolivia
42739,2/1/2022,BOL,Melaka,0,0,0,Bolivia
42740,2/1/2022,BOL,Perak,0,0,0,Bolivia
42741,2/1/2022,BOL,Perlis,0,0,0,Bolivia
42742,2/1/2022,BOL,Pulau Pinang,0,0,0,Bolivia
42743,2/1/2022,BOL,Sabah,0,0,0,Bolivia
42744,2/1/2022,BOL,Sarawak,0,0,0,Bolivia
42745,2/1/2022,BOL,Selangor,1,1,0,Bolivia
42746,2/1/2022,BRA,Johor,0,0,0,Brazil
42747,2/1/2022,BRA,Kedah,1,1,0,Brazil
42748,2/1/2022,BRA,Kelantan,0,0,0,Brazil
42749,2/1/2022,BRA,Melaka,0,0,0,Brazil
42750,2/1/2022,BRA,Pahang,0,0,0,Brazil
42751,2/1/2022,BRA,Perak,0,0,0,Brazil
42752,2/1/2022,BRA,Perlis,0,0,0,Brazil
42753,2/1/2022,BRA,Pulau Pinang,0,0,0,Brazil
42754,2/1/2022,BRA,Sabah,0,0,0,Brazil
42755,2/1/2022,BRA,Sarawak,0,0,0,Brazil
42756,2/1/2022,BRA,Selangor,62,42,20,Brazil
42757,2/1/2022,BRA,W.P. Labuan,0,0,0,Brazil
42758,2/1/2022,BRB,Johor,0,0,0,Barbados
42759,2/1/2022,BRB,Kedah,0,0,0,Barbados
42760,2/1/2022,BRB,Perlis,0,0,0,Barbados
42761,2/1/2022,BRB,Pulau Pinang,0,0,0,Barbados
42762,2/1/2022,BRB,Selangor,1,0,1,Barbados
42763,2/1/2022,BRN,Johor,1,0,1,Brunei Darussalam
42764,2/1/2022,BRN,Kedah,0,0,0,Brunei Darussalam
42765,2/1/2022,BRN,Kelantan,0,0,0,Brunei Darussalam
42766,2/1/2022,BRN,Melaka,0,0,0,Brunei Darussalam
42767,2/1/2022,BRN,Pahang,0,0,0,Brunei Darussalam
42768,2/1/2022,BRN,Perak,0,0,0,Brunei Darussalam
42769,2/1/2022,BRN,Perlis,0,0,0,Brunei Darussalam
42770,2/1/2022,BRN,Pulau Pinang,0,0,0,Brunei Darussalam
42771,2/1/2022,BRN,Sabah,0,0,0,Brunei Darussalam
42772,2/1/2022,BRN,Sarawak,312,299,13,Brunei Darussalam
42773,2/1/2022,BRN,Selangor,57,27,30,Brunei Darussalam
42774,2/1/2022,BRN,W.P. Labuan,1,1,0,Brunei Darussalam
42775,2/1/2022,BTN,Johor,0,0,0,Bhutan
42776,2/1/2022,BTN,Kedah,0,0,0,Bhutan
42777,2/1/2022,BTN,Perak,0,0,0,Bhutan
42778,2/1/2022,BTN,Perlis,0,0,0,Bhutan
42779,2/1/2022,BTN,Pulau Pinang,0,0,0,Bhutan
42780,2/1/2022,BTN,Sabah,0,0,0,Bhutan
42781,2/1/2022,BTN,Sarawak,0,0,0,Bhutan
42782,2/1/2022,BTN,Selangor,1,1,0,Bhutan
42783,2/1/2022,BWA,Johor,0,0,0,Botswana
42784,2/1/2022,BWA,Kedah,0,0,0,Botswana
42785,2/1/2022,BWA,Perlis,0,0,0,Botswana
42786,2/1/2022,BWA,Pulau Pinang,0,0,0,Botswana
42787,2/1/2022,BWA,Sabah,0,0,0,Botswana
42788,2/1/2022,BWA,Sarawak,0,0,0,Botswana
42789,2/1/2022,BWA,Selangor,4,3,1,Botswana
42790,2/1/2022,CAF,Kedah,0,0,0,Central African Republic
42791,2/1/2022,CAF,Selangor,0,0,0,Central African Republic
42792,2/1/2022,CAN,Johor,0,0,0,Canada
42793,2/1/2022,CAN,Kedah,5,3,2,Canada
42794,2/1/2022,CAN,Kelantan,0,0,0,Canada
42795,2/1/2022,CAN,Melaka,0,0,0,Canada
42796,2/1/2022,CAN,Negeri Sembilan,0,0,0,Canada
42797,2/1/2022,CAN,Pahang,0,0,0,Canada
42798,2/1/2022,CAN,Perak,0,0,0,Canada
42799,2/1/2022,CAN,Perlis,0,0,0,Canada
42800,2/1/2022,CAN,Pulau Pinang,0,0,0,Canada
42801,2/1/2022,CAN,Sabah,0,0,0,Canada
42802,2/1/2022,CAN,Sarawak,3,2,1,Canada
42803,2/1/2022,CAN,Selangor,157,114,43,Canada
42804,2/1/2022,CAN,Terengganu,0,0,0,Canada
42805,2/1/2022,CAN,W.P. Labuan,0,0,0,Canada
42806,2/1/2022,CCK,Selangor,0,0,0,Cocos (Keeling) Islands
42807,2/1/2022,CHE,Johor,0,0,0,Switzerland
42808,2/1/2022,CHE,Kedah,2,1,1,Switzerland
42809,2/1/2022,CHE,Kelantan,0,0,0,Switzerland
42810,2/1/2022,CHE,Melaka,0,0,0,Switzerland
42811,2/1/2022,CHE,Negeri Sembilan,0,0,0,Switzerland
42812,2/1/2022,CHE,Pahang,0,0,0,Switzerland
42813,2/1/2022,CHE,Perak,0,0,0,Switzerland
42814,2/1/2022,CHE,Perlis,0,0,0,Switzerland
42815,2/1/2022,CHE,Pulau Pinang,4,4,0,Switzerland
42816,2/1/2022,CHE,Sabah,0,0,0,Switzerland
42817,2/1/2022,CHE,Sarawak,0,0,0,Switzerland
42818,2/1/2022,CHE,Selangor,54,39,15,Switzerland
42819,2/1/2022,CHE,W.P. Labuan,0,0,0,Switzerland
42820,2/1/2022,CHL,Johor,0,0,0,Chile
42821,2/1/2022,CHL,Kedah,0,0,0,Chile
42822,2/1/2022,CHL,Kelantan,0,0,0,Chile
42823,2/1/2022,CHL,Melaka,0,0,0,Chile
42824,2/1/2022,CHL,Pahang,0,0,0,Chile
42825,2/1/2022,CHL,Perak,0,0,0,Chile
42826,2/1/2022,CHL,Perlis,0,0,0,Chile
42827,2/1/2022,CHL,Pulau Pinang,0,0,0,Chile
42828,2/1/2022,CHL,Sabah,0,0,0,Chile
42829,2/1/2022,CHL,Sarawak,0,0,0,Chile
42830,2/1/2022,CHL,Selangor,3,1,2,Chile
42831,2/1/2022,CHN,Johor,107,103,4,China
42832,2/1/2022,CHN,Kedah,5,3,2,China
42833,2/1/2022,CHN,Kelantan,0,0,0,China
42834,2/1/2022,CHN,Melaka,0,0,0,China
42835,2/1/2022,CHN,Pahang,0,0,0,China
42836,2/1/2022,CHN,Perak,0,0,0,China
42837,2/1/2022,CHN,Perlis,0,0,0,China
42838,2/1/2022,CHN,Pulau Pinang,4,1,3,China
42839,2/1/2022,CHN,Sabah,2,1,1,China
42840,2/1/2022,CHN,Sarawak,34,31,3,China
42841,2/1/2022,CHN,Selangor,3033,2127,906,China
42842,2/1/2022,CHN,Terengganu,0,0,0,China
42843,2/1/2022,CHN,W.P. Labuan,0,0,0,China
42844,2/1/2022,CIV,Johor,0,0,0,C��te d'Iv
42845,2/1/2022,CIV,Kedah,0,0,0,C��te d'Iv
42846,2/1/2022,CIV,Pulau Pinang,0,0,0,C��te d'Iv
42847,2/1/2022,CIV,Sabah,0,0,0,C��te d'Iv
42848,2/1/2022,CIV,Sarawak,0,0,0,C��te d'Iv
42849,2/1/2022,CIV,Selangor,8,7,1,C��te d'Iv
42850,2/1/2022,CMR,Johor,0,0,0,Cameroon
42851,2/1/2022,CMR,Kedah,0,0,0,Cameroon
42852,2/1/2022,CMR,Pulau Pinang,0,0,0,Cameroon
42853,2/1/2022,CMR,Sabah,0,0,0,Cameroon
42854,2/1/2022,CMR,Sarawak,0,0,0,Cameroon
42855,2/1/2022,CMR,Selangor,1,0,1,Cameroon
42856,2/1/2022,COD,Johor,0,0,0,"Congo, the Democratic Republic of the"
42857,2/1/2022,COD,Pulau Pinang,0,0,0,"Congo, the Democratic Republic of the"
42858,2/1/2022,COD,Sarawak,0,0,0,"Congo, the Democratic Republic of the"
42859,2/1/2022,COD,Selangor,2,1,1,"Congo, the Democratic Republic of the"
42860,2/1/2022,COG,Johor,0,0,0,Congo
42861,2/1/2022,COG,Kedah,0,0,0,Congo
42862,2/1/2022,COG,Selangor,0,0,0,Congo
42863,2/1/2022,COK,Selangor,0,0,0,Cook Islands
42864,2/1/2022,COL,Johor,0,0,0,Colombia
42865,2/1/2022,COL,Kedah,0,0,0,Colombia
42866,2/1/2022,COL,Perak,0,0,0,Colombia
42867,2/1/2022,COL,Pulau Pinang,0,0,0,Colombia
42868,2/1/2022,COL,Sabah,0,0,0,Colombia
42869,2/1/2022,COL,Sarawak,0,0,0,Colombia
42870,2/1/2022,COL,Selangor,10,2,8,Colombia
42871,2/1/2022,COL,W.P. Labuan,0,0,0,Colombia
42872,2/1/2022,COM,Johor,0,0,0,Comoros
42873,2/1/2022,COM,Kedah,0,0,0,Comoros
42874,2/1/2022,COM,Selangor,8,2,6,Comoros
42875,2/1/2022,CPV,Johor,0,0,0,Cape Verde
42876,2/1/2022,CPV,Kedah,0,0,0,Cape Verde
42877,2/1/2022,CPV,Pulau Pinang,0,0,0,Cape Verde
42878,2/1/2022,CPV,Sabah,0,0,0,Cape Verde
42879,2/1/2022,CPV,Selangor,0,0,0,Cape Verde
42880,2/1/2022,CRI,Johor,0,0,0,Costa Rica
42881,2/1/2022,CRI,Kedah,0,0,0,Costa Rica
42882,2/1/2022,CRI,Perak,0,0,0,Costa Rica
42883,2/1/2022,CRI,Perlis,0,0,0,Costa Rica
42884,2/1/2022,CRI,Pulau Pinang,0,0,0,Costa Rica
42885,2/1/2022,CRI,Sabah,0,0,0,Costa Rica
42886,2/1/2022,CRI,Sarawak,0,0,0,Costa Rica
42887,2/1/2022,CRI,Selangor,5,4,1,Costa Rica
42888,2/1/2022,CUB,Johor,0,0,0,Cuba
42889,2/1/2022,CUB,Kedah,0,0,0,Cuba
42890,2/1/2022,CUB,Perlis,0,0,0,Cuba
42891,2/1/2022,CUB,Pulau Pinang,0,0,0,Cuba
42892,2/1/2022,CUB,Sabah,0,0,0,Cuba
42893,2/1/2022,CUB,Sarawak,0,0,0,Cuba
42894,2/1/2022,CUB,Selangor,0,0,0,Cuba
42895,2/1/2022,CYP,Johor,0,0,0,Cyprus
42896,2/1/2022,CYP,Kedah,1,1,0,Cyprus
42897,2/1/2022,CYP,Perak,0,0,0,Cyprus
42898,2/1/2022,CYP,Perlis,0,0,0,Cyprus
42899,2/1/2022,CYP,Pulau Pinang,0,0,0,Cyprus
42900,2/1/2022,CYP,Sabah,0,0,0,Cyprus
42901,2/1/2022,CYP,Sarawak,0,0,0,Cyprus
42902,2/1/2022,CYP,Selangor,7,4,3,Cyprus
42903,2/1/2022,CZE,Johor,0,0,0,Czech Republic
42904,2/1/2022,CZE,Kedah,0,0,0,Czech Republic
42905,2/1/2022,CZE,Kelantan,4,3,1,Czech Republic
42906,2/1/2022,CZE,Melaka,0,0,0,Czech Republic
42907,2/1/2022,CZE,Negeri Sembilan,0,0,0,Czech Republic
42908,2/1/2022,CZE,Perak,0,0,0,Czech Republic
42909,2/1/2022,CZE,Perlis,0,0,0,Czech Republic
42910,2/1/2022,CZE,Pulau Pinang,0,0,0,Czech Republic
42911,2/1/2022,CZE,Sabah,0,0,0,Czech Republic
42912,2/1/2022,CZE,Sarawak,0,0,0,Czech Republic
42913,2/1/2022,CZE,Selangor,20,15,5,Czech Republic
42914,2/1/2022,CZE,W.P. Labuan,0,0,0,Czech Republic
42915,2/1/2022,DEU,Johor,3,3,0,Germany
42916,2/1/2022,DEU,Kedah,11,8,3,Germany
42917,2/1/2022,DEU,Kelantan,0,0,0,Germany
42918,2/1/2022,DEU,Melaka,0,0,0,Germany
42919,2/1/2022,DEU,Negeri Sembilan,0,0,0,Germany
42920,2/1/2022,DEU,Pahang,0,0,0,Germany
42921,2/1/2022,DEU,Perak,0,0,0,Germany
42922,2/1/2022,DEU,Perlis,0,0,0,Germany
42923,2/1/2022,DEU,Pulau Pinang,15,14,1,Germany
42924,2/1/2022,DEU,Sabah,0,0,0,Germany
42925,2/1/2022,DEU,Sarawak,0,0,0,Germany
42926,2/1/2022,DEU,Selangor,322,266,56,Germany
42927,2/1/2022,DEU,Terengganu,0,0,0,Germany
42928,2/1/2022,DEU,W.P. Labuan,0,0,0,Germany
42929,2/1/2022,DJI,Johor,0,0,0,Djibouti
42930,2/1/2022,DJI,Selangor,3,1,2,Djibouti
42931,2/1/2022,DMA,Johor,0,0,0,Dominica
42932,2/1/2022,DMA,Kedah,0,0,0,Dominica
42933,2/1/2022,DMA,Pulau Pinang,0,0,0,Dominica
42934,2/1/2022,DMA,Sabah,0,0,0,Dominica
42935,2/1/2022,DMA,Sarawak,0,0,0,Dominica
42936,2/1/2022,DMA,Selangor,3,3,0,Dominica
42937,2/1/2022,DMA,W.P. Labuan,0,0,0,Dominica
42938,2/1/2022,DNK,Johor,1,1,0,Denmark
42939,2/1/2022,DNK,Kedah,1,0,1,Denmark
42940,2/1/2022,DNK,Kelantan,0,0,0,Denmark
42941,2/1/2022,DNK,Melaka,0,0,0,Denmark
42942,2/1/2022,DNK,Negeri Sembilan,0,0,0,Denmark
42943,2/1/2022,DNK,Pahang,0,0,0,Denmark
42944,2/1/2022,DNK,Perak,0,0,0,Denmark
42945,2/1/2022,DNK,Perlis,0,0,0,Denmark
42946,2/1/2022,DNK,Pulau Pinang,4,2,2,Denmark
42947,2/1/2022,DNK,Sabah,0,0,0,Denmark
42948,2/1/2022,DNK,Sarawak,0,0,0,Denmark
42949,2/1/2022,DNK,Selangor,53,45,8,Denmark
42950,2/1/2022,DNK,W.P. Labuan,0,0,0,Denmark
42951,2/1/2022,DOM,Johor,0,0,0,Dominican Republic
42952,2/1/2022,DOM,Kedah,0,0,0,Dominican Republic
42953,2/1/2022,DOM,Perak,0,0,0,Dominican Republic
42954,2/1/2022,DOM,Perlis,0,0,0,Dominican Republic
42955,2/1/2022,DOM,Pulau Pinang,0,0,0,Dominican Republic
42956,2/1/2022,DOM,Sabah,0,0,0,Dominican Republic
42957,2/1/2022,DOM,Sarawak,0,0,0,Dominican Republic
42958,2/1/2022,DOM,Selangor,0,0,0,Dominican Republic
42959,2/1/2022,DZA,Johor,0,0,0,Algeria
42960,2/1/2022,DZA,Kedah,0,0,0,Algeria
42961,2/1/2022,DZA,Kelantan,0,0,0,Algeria
42962,2/1/2022,DZA,Melaka,0,0,0,Algeria
42963,2/1/2022,DZA,Perak,0,0,0,Algeria
42964,2/1/2022,DZA,Perlis,0,0,0,Algeria
42965,2/1/2022,DZA,Pulau Pinang,0,0,0,Algeria
42966,2/1/2022,DZA,Sabah,0,0,0,Algeria
42967,2/1/2022,DZA,Sarawak,0,0,0,Algeria
42968,2/1/2022,DZA,Selangor,47,32,15,Algeria
42969,2/1/2022,DZA,W.P. Labuan,0,0,0,Algeria
42970,2/1/2022,ECU,Johor,0,0,0,Ecuador
42971,2/1/2022,ECU,Kedah,0,0,0,Ecuador
42972,2/1/2022,ECU,Perak,0,0,0,Ecuador
42973,2/1/2022,ECU,Perlis,0,0,0,Ecuador
42974,2/1/2022,ECU,Pulau Pinang,0,0,0,Ecuador
42975,2/1/2022,ECU,Sabah,0,0,0,Ecuador
42976,2/1/2022,ECU,Sarawak,0,0,0,Ecuador
42977,2/1/2022,ECU,Selangor,0,0,0,Ecuador
42978,2/1/2022,EGY,Johor,0,0,0,Egypt
42979,2/1/2022,EGY,Kedah,0,0,0,Egypt
42980,2/1/2022,EGY,Kelantan,0,0,0,Egypt
42981,2/1/2022,EGY,Melaka,0,0,0,Egypt
42982,2/1/2022,EGY,Pahang,0,0,0,Egypt
42983,2/1/2022,EGY,Perak,0,0,0,Egypt
42984,2/1/2022,EGY,Perlis,0,0,0,Egypt
42985,2/1/2022,EGY,Pulau Pinang,0,0,0,Egypt
42986,2/1/2022,EGY,Sabah,0,0,0,Egypt
42987,2/1/2022,EGY,Sarawak,0,0,0,Egypt
42988,2/1/2022,EGY,Selangor,270,210,60,Egypt
42989,2/1/2022,EGY,Terengganu,0,0,0,Egypt
42990,2/1/2022,EGY,W.P. Labuan,0,0,0,Egypt
42991,2/1/2022,ERI,Johor,0,0,0,Eritrea
42992,2/1/2022,ERI,Pulau Pinang,0,0,0,Eritrea
42993,2/1/2022,ERI,Sabah,0,0,0,Eritrea
42994,2/1/2022,ERI,Selangor,3,0,3,Eritrea
42995,2/1/2022,ESP,Johor,0,0,0,Spain
42996,2/1/2022,ESP,Kedah,2,2,0,Spain
42997,2/1/2022,ESP,Kelantan,1,0,1,Spain
42998,2/1/2022,ESP,Melaka,0,0,0,Spain
42999,2/1/2022,ESP,Negeri Sembilan,0,0,0,Spain
43000,2/1/2022,ESP,Pahang,0,0,0,Spain
43001,2/1/2022,ESP,Perak,0,0,0,Spain
43002,2/1/2022,ESP,Perlis,0,0,0,Spain
43003,2/1/2022,ESP,Pulau Pinang,0,0,0,Spain
43004,2/1/2022,ESP,Sabah,0,0,0,Spain
43005,2/1/2022,ESP,Sarawak,0,0,0,Spain
43006,2/1/2022,ESP,Selangor,131,108,23,Spain
43007,2/1/2022,ESP,W.P. Labuan,0,0,0,Spain
43008,2/1/2022,EST,Johor,0,0,0,Estonia
43009,2/1/2022,EST,Kedah,0,0,0,Estonia
43010,2/1/2022,EST,Kelantan,0,0,0,Estonia
43011,2/1/2022,EST,Pahang,0,0,0,Estonia
43012,2/1/2022,EST,Perak,0,0,0,Estonia
43013,2/1/2022,EST,Perlis,0,0,0,Estonia
43014,2/1/2022,EST,Pulau Pinang,0,0,0,Estonia
43015,2/1/2022,EST,Sabah,0,0,0,Estonia
43016,2/1/2022,EST,Sarawak,0,0,0,Estonia
43017,2/1/2022,EST,Selangor,4,2,2,Estonia
43018,2/1/2022,EST,W.P. Labuan,0,0,0,Estonia
43019,2/1/2022,ETH,Johor,0,0,0,Ethiopia
43020,2/1/2022,ETH,Kedah,0,0,0,Ethiopia
43021,2/1/2022,ETH,Pulau Pinang,0,0,0,Ethiopia
43022,2/1/2022,ETH,Sarawak,0,0,0,Ethiopia
43023,2/1/2022,ETH,Selangor,5,5,0,Ethiopia
43024,2/1/2022,FIN,Johor,0,0,0,Finland
43025,2/1/2022,FIN,Kedah,1,1,0,Finland
43026,2/1/2022,FIN,Kelantan,0,0,0,Finland
43027,2/1/2022,FIN,Melaka,0,0,0,Finland
43028,2/1/2022,FIN,Negeri Sembilan,0,0,0,Finland
43029,2/1/2022,FIN,Pahang,0,0,0,Finland
43030,2/1/2022,FIN,Perak,0,0,0,Finland
43031,2/1/2022,FIN,Perlis,0,0,0,Finland
43032,2/1/2022,FIN,Pulau Pinang,0,0,0,Finland
43033,2/1/2022,FIN,Sabah,0,0,0,Finland
43034,2/1/2022,FIN,Sarawak,0,0,0,Finland
43035,2/1/2022,FIN,Selangor,23,19,4,Finland
43036,2/1/2022,FIN,W.P. Labuan,0,0,0,Finland
43037,2/1/2022,FJI,Johor,0,0,0,Fiji
43038,2/1/2022,FJI,Kedah,0,0,0,Fiji
43039,2/1/2022,FJI,Kelantan,0,0,0,Fiji
43040,2/1/2022,FJI,Perak,0,0,0,Fiji
43041,2/1/2022,FJI,Perlis,0,0,0,Fiji
43042,2/1/2022,FJI,Pulau Pinang,0,0,0,Fiji
43043,2/1/2022,FJI,Sabah,0,0,0,Fiji
43044,2/1/2022,FJI,Sarawak,0,0,0,Fiji
43045,2/1/2022,FJI,Selangor,4,3,1,Fiji
43046,2/1/2022,FRA,Johor,2,2,0,France
43047,2/1/2022,FRA,Kedah,10,6,4,France
43048,2/1/2022,FRA,Kelantan,1,1,0,France
43049,2/1/2022,FRA,Melaka,0,0,0,France
43050,2/1/2022,FRA,Negeri Sembilan,0,0,0,France
43051,2/1/2022,FRA,Pahang,0,0,0,France
43052,2/1/2022,FRA,Perak,0,0,0,France
43053,2/1/2022,FRA,Perlis,0,0,0,France
43054,2/1/2022,FRA,Pulau Pinang,1,1,0,France
43055,2/1/2022,FRA,Sabah,0,0,0,France
43056,2/1/2022,FRA,Sarawak,0,0,0,France
43057,2/1/2022,FRA,Selangor,399,277,122,France
43058,2/1/2022,FRA,Terengganu,0,0,0,France
43059,2/1/2022,FRA,W.P. Labuan,0,0,0,France
43060,2/1/2022,FSM,Johor,0,0,0,"Micronesia, Federated States of"
43061,2/1/2022,FSM,Pulau Pinang,0,0,0,"Micronesia, Federated States of"
43062,2/1/2022,FSM,Selangor,0,0,0,"Micronesia, Federated States of"
43063,2/1/2022,GAB,Johor,0,0,0,Gabon
43064,2/1/2022,GAB,Pulau Pinang,0,0,0,Gabon
43065,2/1/2022,GAB,Sarawak,0,0,0,Gabon
43066,2/1/2022,GAB,Selangor,1,0,1,Gabon
43067,2/1/2022,GBR,Johor,0,0,0,United Kingdom
43068,2/1/2022,GBR,Kedah,39,24,15,United Kingdom
43069,2/1/2022,GBR,Kelantan,1,0,1,United Kingdom
43070,2/1/2022,GBR,Melaka,0,0,0,United Kingdom
43071,2/1/2022,GBR,Negeri Sembilan,0,0,0,United Kingdom
43072,2/1/2022,GBR,Pahang,0,0,0,United Kingdom
43073,2/1/2022,GBR,Perak,1,0,1,United Kingdom
43074,2/1/2022,GBR,Perlis,0,0,0,United Kingdom
43075,2/1/2022,GBR,Pulau Pinang,19,10,9,United Kingdom
43076,2/1/2022,GBR,Sabah,1,1,0,United Kingdom
43077,2/1/2022,GBR,Sarawak,3,2,1,United Kingdom
43078,2/1/2022,GBR,Selangor,925,642,283,United Kingdom
43079,2/1/2022,GBR,Terengganu,0,0,0,United Kingdom
43080,2/1/2022,GBR,W.P. Labuan,0,0,0,United Kingdom
43081,2/1/2022,GEO,Johor,0,0,0,Georgia
43082,2/1/2022,GEO,Kedah,0,0,0,Georgia
43083,2/1/2022,GEO,Melaka,0,0,0,Georgia
43084,2/1/2022,GEO,Perak,0,0,0,Georgia
43085,2/1/2022,GEO,Perlis,0,0,0,Georgia
43086,2/1/2022,GEO,Pulau Pinang,0,0,0,Georgia
43087,2/1/2022,GEO,Sabah,0,0,0,Georgia
43088,2/1/2022,GEO,Sarawak,0,0,0,Georgia
43089,2/1/2022,GEO,Selangor,1,1,0,Georgia
43090,2/1/2022,GHA,Johor,0,0,0,Ghana
43091,2/1/2022,GHA,Kedah,0,0,0,Ghana
43092,2/1/2022,GHA,Kelantan,0,0,0,Ghana
43093,2/1/2022,GHA,Pulau Pinang,0,0,0,Ghana
43094,2/1/2022,GHA,Sabah,0,0,0,Ghana
43095,2/1/2022,GHA,Sarawak,0,0,0,Ghana
43096,2/1/2022,GHA,Selangor,11,8,3,Ghana
43097,2/1/2022,GIB,Johor,0,0,0,Gibraltar
43098,2/1/2022,GIB,Sarawak,0,0,0,Gibraltar
43099,2/1/2022,GIN,Johor,0,0,0,Guinea
43100,2/1/2022,GIN,Kedah,0,0,0,Guinea
43101,2/1/2022,GIN,Kelantan,0,0,0,Guinea
43102,2/1/2022,GIN,Perlis,0,0,0,Guinea
43103,2/1/2022,GIN,Pulau Pinang,0,0,0,Guinea
43104,2/1/2022,GIN,Sabah,0,0,0,Guinea
43105,2/1/2022,GIN,Sarawak,0,0,0,Guinea
43106,2/1/2022,GIN,Selangor,18,16,2,Guinea
43107,2/1/2022,GLP,Selangor,0,0,0,Guadeloupe
43108,2/1/2022,GMB,Johor,0,0,0,Gambia
43109,2/1/2022,GMB,Kedah,0,0,0,Gambia
43110,2/1/2022,GMB,Kelantan,0,0,0,Gambia
43111,2/1/2022,GMB,Pulau Pinang,0,0,0,Gambia
43112,2/1/2022,GMB,Sabah,0,0,0,Gambia
43113,2/1/2022,GMB,Sarawak,0,0,0,Gambia
43114,2/1/2022,GMB,Selangor,3,1,2,Gambia
43115,2/1/2022,GNB,Johor,0,0,0,Guinea-Bissau
43116,2/1/2022,GNB,Selangor,0,0,0,Guinea-Bissau
43117,2/1/2022,GNQ,Johor,0,0,0,Equatorial Guinea
43118,2/1/2022,GNQ,Selangor,0,0,0,Equatorial Guinea
43119,2/1/2022,GRC,Johor,1,1,0,Greece
43120,2/1/2022,GRC,Kedah,0,0,0,Greece
43121,2/1/2022,GRC,Kelantan,0,0,0,Greece
43122,2/1/2022,GRC,Melaka,0,0,0,Greece
43123,2/1/2022,GRC,Negeri Sembilan,0,0,0,Greece
43124,2/1/2022,GRC,Pahang,0,0,0,Greece
43125,2/1/2022,GRC,Perak,0,0,0,Greece
43126,2/1/2022,GRC,Perlis,0,0,0,Greece
43127,2/1/2022,GRC,Pulau Pinang,0,0,0,Greece
43128,2/1/2022,GRC,Sabah,0,0,0,Greece
43129,2/1/2022,GRC,Sarawak,0,0,0,Greece
43130,2/1/2022,GRC,Selangor,9,9,0,Greece
43131,2/1/2022,GRD,Johor,0,0,0,Grenada
43132,2/1/2022,GRD,Kedah,0,0,0,Grenada
43133,2/1/2022,GRD,Pulau Pinang,0,0,0,Grenada
43134,2/1/2022,GRD,Sabah,0,0,0,Grenada
43135,2/1/2022,GRD,Sarawak,0,0,0,Grenada
43136,2/1/2022,GRD,Selangor,0,0,0,Grenada
43137,2/1/2022,GRL,Johor,0,0,0,Greenland
43138,2/1/2022,GRL,Selangor,0,0,0,Greenland
43139,2/1/2022,GTM,Johor,0,0,0,Guatemala
43140,2/1/2022,GTM,Kedah,0,0,0,Guatemala
43141,2/1/2022,GTM,Pahang,0,0,0,Guatemala
43142,2/1/2022,GTM,Perak,0,0,0,Guatemala
43143,2/1/2022,GTM,Pulau Pinang,0,0,0,Guatemala
43144,2/1/2022,GTM,Sabah,0,0,0,Guatemala
43145,2/1/2022,GTM,Sarawak,0,0,0,Guatemala
43146,2/1/2022,GTM,Selangor,1,0,1,Guatemala
43147,2/1/2022,GTM,W.P. Labuan,0,0,0,Guatemala
43148,2/1/2022,GUY,Johor,0,0,0,Guyana
43149,2/1/2022,GUY,Kedah,0,0,0,Guyana
43150,2/1/2022,GUY,Pulau Pinang,0,0,0,Guyana
43151,2/1/2022,GUY,Sarawak,0,0,0,Guyana
43152,2/1/2022,GUY,Selangor,0,0,0,Guyana
43153,2/1/2022,HKG,Johor,0,0,0,Hong Kong
43154,2/1/2022,HKG,Kedah,3,2,1,Hong Kong
43155,2/1/2022,HKG,Kelantan,0,0,0,Hong Kong
43156,2/1/2022,HKG,Pahang,0,0,0,Hong Kong
43157,2/1/2022,HKG,Perak,0,0,0,Hong Kong
43158,2/1/2022,HKG,Perlis,0,0,0,Hong Kong
43159,2/1/2022,HKG,Pulau Pinang,2,2,0,Hong Kong
43160,2/1/2022,HKG,Sabah,0,0,0,Hong Kong
43161,2/1/2022,HKG,Sarawak,35,32,3,Hong Kong
43162,2/1/2022,HKG,Selangor,1,0,1,Hong Kong
43163,2/1/2022,HKG,Terengganu,0,0,0,Hong Kong
43164,2/1/2022,HMD,Johor,0,0,0,Heard Island and McDonald Islands
43165,2/1/2022,HND,Johor,0,0,0,Honduras
43166,2/1/2022,HND,Kedah,0,0,0,Honduras
43167,2/1/2022,HND,Perak,0,0,0,Honduras
43168,2/1/2022,HND,Pulau Pinang,0,0,0,Honduras
43169,2/1/2022,HND,Sabah,0,0,0,Honduras
43170,2/1/2022,HND,Sarawak,0,0,0,Honduras
43171,2/1/2022,HND,Selangor,0,0,0,Honduras
43172,2/1/2022,HRV,Johor,0,0,0,Croatia
43173,2/1/2022,HRV,Kedah,0,0,0,Croatia
43174,2/1/2022,HRV,Kelantan,0,0,0,Croatia
43175,2/1/2022,HRV,Melaka,0,0,0,Croatia
43176,2/1/2022,HRV,Pahang,0,0,0,Croatia
43177,2/1/2022,HRV,Perak,0,0,0,Croatia
43178,2/1/2022,HRV,Perlis,0,0,0,Croatia
43179,2/1/2022,HRV,Pulau Pinang,0,0,0,Croatia
43180,2/1/2022,HRV,Sabah,0,0,0,Croatia
43181,2/1/2022,HRV,Sarawak,0,0,0,Croatia
43182,2/1/2022,HRV,Selangor,31,30,1,Croatia
43183,2/1/2022,HTI,Johor,0,0,0,Haiti
43184,2/1/2022,HTI,Kedah,0,0,0,Haiti
43185,2/1/2022,HTI,Kelantan,0,0,0,Haiti
43186,2/1/2022,HTI,Perak,0,0,0,Haiti
43187,2/1/2022,HTI,Pulau Pinang,0,0,0,Haiti
43188,2/1/2022,HTI,Sabah,0,0,0,Haiti
43189,2/1/2022,HTI,Selangor,1,1,0,Haiti
43190,2/1/2022,HUN,Johor,1,1,0,Hungary
43191,2/1/2022,HUN,Kedah,0,0,0,Hungary
43192,2/1/2022,HUN,Kelantan,0,0,0,Hungary
43193,2/1/2022,HUN,Pahang,0,0,0,Hungary
43194,2/1/2022,HUN,Perak,0,0,0,Hungary
43195,2/1/2022,HUN,Perlis,0,0,0,Hungary
43196,2/1/2022,HUN,Pulau Pinang,0,0,0,Hungary
43197,2/1/2022,HUN,Sabah,0,0,0,Hungary
43198,2/1/2022,HUN,Sarawak,0,0,0,Hungary
43199,2/1/2022,HUN,Selangor,10,6,4,Hungary
43200,2/1/2022,HUN,W.P. Labuan,0,0,0,Hungary
43201,2/1/2022,IDN,Johor,607,259,348,Indonesia
43202,2/1/2022,IDN,Kedah,37,13,24,Indonesia
43203,2/1/2022,IDN,Kelantan,0,0,0,Indonesia
43204,2/1/2022,IDN,Melaka,0,0,0,Indonesia
43205,2/1/2022,IDN,Negeri Sembilan,0,0,0,Indonesia
43206,2/1/2022,IDN,Pahang,0,0,0,Indonesia
43207,2/1/2022,IDN,Perak,0,0,0,Indonesia
43208,2/1/2022,IDN,Perlis,0,0,0,Indonesia
43209,2/1/2022,IDN,Pulau Pinang,13,7,6,Indonesia
43210,2/1/2022,IDN,Sabah,3,1,2,Indonesia
43211,2/1/2022,IDN,Sarawak,245,221,24,Indonesia
43212,2/1/2022,IDN,Selangor,3047,1469,1578,Indonesia
43213,2/1/2022,IDN,Terengganu,0,0,0,Indonesia
43214,2/1/2022,IDN,W.P. Labuan,2,2,0,Indonesia
43215,2/1/2022,IND,Johor,44,42,2,India
43216,2/1/2022,IND,Kedah,2,2,0,India
43217,2/1/2022,IND,Kelantan,0,0,0,India
43218,2/1/2022,IND,Melaka,0,0,0,India
43219,2/1/2022,IND,Negeri Sembilan,0,0,0,India
43220,2/1/2022,IND,Pahang,0,0,0,India
43221,2/1/2022,IND,Perak,0,0,0,India
43222,2/1/2022,IND,Perlis,0,0,0,India
43223,2/1/2022,IND,Pulau Pinang,1,0,1,India
43224,2/1/2022,IND,Sabah,2,2,0,India
43225,2/1/2022,IND,Sarawak,6,6,0,India
43226,2/1/2022,IND,Selangor,5140,3707,1433,India
43227,2/1/2022,IND,Terengganu,0,0,0,India
43228,2/1/2022,IND,W.P. Labuan,0,0,0,India
43229,2/1/2022,IOT,Pulau Pinang,0,0,0,British Indian Ocean Territory
43230,2/1/2022,IOT,Selangor,0,0,0,British Indian Ocean Territory
43231,2/1/2022,IRL,Johor,0,0,0,Ireland
43232,2/1/2022,IRL,Kedah,2,1,1,Ireland
43233,2/1/2022,IRL,Kelantan,0,0,0,Ireland
43234,2/1/2022,IRL,Negeri Sembilan,0,0,0,Ireland
43235,2/1/2022,IRL,Pahang,0,0,0,Ireland
43236,2/1/2022,IRL,Perak,0,0,0,Ireland
43237,2/1/2022,IRL,Perlis,0,0,0,Ireland
43238,2/1/2022,IRL,Pulau Pinang,0,0,0,Ireland
43239,2/1/2022,IRL,Sabah,0,0,0,Ireland
43240,2/1/2022,IRL,Sarawak,0,0,0,Ireland
43241,2/1/2022,IRL,Selangor,65,41,24,Ireland
43242,2/1/2022,IRL,Terengganu,0,0,0,Ireland
43243,2/1/2022,IRL,W.P. Labuan,0,0,0,Ireland
43244,2/1/2022,IRN,Johor,0,0,0,Iran
43245,2/1/2022,IRN,Kedah,0,0,0,Iran
43246,2/1/2022,IRN,Kelantan,0,0,0,Iran
43247,2/1/2022,IRN,Perak,0,0,0,Iran
43248,2/1/2022,IRN,Perlis,0,0,0,Iran
43249,2/1/2022,IRN,Pulau Pinang,0,0,0,Iran
43250,2/1/2022,IRN,Sabah,0,0,0,Iran
43251,2/1/2022,IRN,Sarawak,0,0,0,Iran
43252,2/1/2022,IRN,Selangor,185,106,79,Iran
43253,2/1/2022,IRN,W.P. Labuan,0,0,0,Iran
43254,2/1/2022,IRQ,Johor,0,0,0,Iraq
43255,2/1/2022,IRQ,Kedah,0,0,0,Iraq
43256,2/1/2022,IRQ,Kelantan,0,0,0,Iraq
43257,2/1/2022,IRQ,Melaka,0,0,0,Iraq
43258,2/1/2022,IRQ,Pahang,0,0,0,Iraq
43259,2/1/2022,IRQ,Perak,0,0,0,Iraq
43260,2/1/2022,IRQ,Perlis,0,0,0,Iraq
43261,2/1/2022,IRQ,Pulau Pinang,0,0,0,Iraq
43262,2/1/2022,IRQ,Sabah,0,0,0,Iraq
43263,2/1/2022,IRQ,Sarawak,1,1,0,Iraq
43264,2/1/2022,IRQ,Selangor,174,113,61,Iraq
43265,2/1/2022,ISL,Johor,0,0,0,Iceland
43266,2/1/2022,ISL,Kedah,0,0,0,Iceland
43267,2/1/2022,ISL,Kelantan,0,0,0,Iceland
43268,2/1/2022,ISL,Perak,0,0,0,Iceland
43269,2/1/2022,ISL,Perlis,0,0,0,Iceland
43270,2/1/2022,ISL,Pulau Pinang,0,0,0,Iceland
43271,2/1/2022,ISL,Sabah,0,0,0,Iceland
43272,2/1/2022,ISL,Sarawak,0,0,0,Iceland
43273,2/1/2022,ISL,Selangor,2,2,0,Iceland
43274,2/1/2022,ISL,W.P. Labuan,0,0,0,Iceland
43275,2/1/2022,ISR,Pulau Pinang,0,0,0,Israel
43276,2/1/2022,ITA,Johor,0,0,0,Italy
43277,2/1/2022,ITA,Kedah,1,1,0,Italy
43278,2/1/2022,ITA,Kelantan,0,0,0,Italy
43279,2/1/2022,ITA,Melaka,0,0,0,Italy
43280,2/1/2022,ITA,Negeri Sembilan,0,0,0,Italy
43281,2/1/2022,ITA,Pahang,0,0,0,Italy
43282,2/1/2022,ITA,Perak,0,0,0,Italy
43283,2/1/2022,ITA,Perlis,0,0,0,Italy
43284,2/1/2022,ITA,Pulau Pinang,2,2,0,Italy
43285,2/1/2022,ITA,Sabah,0,0,0,Italy
43286,2/1/2022,ITA,Sarawak,1,1,0,Italy
43287,2/1/2022,ITA,Selangor,171,144,27,Italy
43288,2/1/2022,ITA,W.P. Labuan,0,0,0,Italy
43289,2/1/2022,JAM,Johor,0,0,0,Jamaica
43290,2/1/2022,JAM,Kedah,0,0,0,Jamaica
43291,2/1/2022,JAM,Perak,0,0,0,Jamaica
43292,2/1/2022,JAM,Pulau Pinang,0,0,0,Jamaica
43293,2/1/2022,JAM,Sabah,0,0,0,Jamaica
43294,2/1/2022,JAM,Sarawak,1,1,0,Jamaica
43295,2/1/2022,JAM,Selangor,1,0,1,Jamaica
43296,2/1/2022,JAM,W.P. Labuan,0,0,0,Jamaica
43297,2/1/2022,JOR,Johor,0,0,0,Jordan
43298,2/1/2022,JOR,Kedah,0,0,0,Jordan
43299,2/1/2022,JOR,Kelantan,0,0,0,Jordan
43300,2/1/2022,JOR,Melaka,0,0,0,Jordan
43301,2/1/2022,JOR,Perlis,0,0,0,Jordan
43302,2/1/2022,JOR,Pulau Pinang,0,0,0,Jordan
43303,2/1/2022,JOR,Sabah,0,0,0,Jordan
43304,2/1/2022,JOR,Sarawak,1,1,0,Jordan
43305,2/1/2022,JOR,Selangor,78,49,29,Jordan
43306,2/1/2022,JOR,W.P. Labuan,0,0,0,Jordan
43307,2/1/2022,JPN,Johor,2,2,0,Japan
43308,2/1/2022,JPN,Kedah,8,6,2,Japan
43309,2/1/2022,JPN,Kelantan,0,0,0,Japan
43310,2/1/2022,JPN,Melaka,0,0,0,Japan
43311,2/1/2022,JPN,Negeri Sembilan,0,0,0,Japan
43312,2/1/2022,JPN,Pahang,0,0,0,Japan
43313,2/1/2022,JPN,Perak,0,0,0,Japan
43314,2/1/2022,JPN,Perlis,0,0,0,Japan
43315,2/1/2022,JPN,Pulau Pinang,43,28,15,Japan
43316,2/1/2022,JPN,Sabah,0,0,0,Japan
43317,2/1/2022,JPN,Sarawak,9,8,1,Japan
43318,2/1/2022,JPN,Selangor,971,663,308,Japan
43319,2/1/2022,JPN,W.P. Labuan,0,0,0,Japan
43320,2/1/2022,KAZ,Johor,1,1,0,Kazakhstan
43321,2/1/2022,KAZ,Kedah,0,0,0,Kazakhstan
43322,2/1/2022,KAZ,Kelantan,0,0,0,Kazakhstan
43323,2/1/2022,KAZ,Melaka,0,0,0,Kazakhstan
43324,2/1/2022,KAZ,Perak,0,0,0,Kazakhstan
43325,2/1/2022,KAZ,Perlis,0,0,0,Kazakhstan
43326,2/1/2022,KAZ,Pulau Pinang,0,0,0,Kazakhstan
43327,2/1/2022,KAZ,Sabah,0,0,0,Kazakhstan
43328,2/1/2022,KAZ,Sarawak,0,0,0,Kazakhstan
43329,2/1/2022,KAZ,Selangor,60,35,25,Kazakhstan
43330,2/1/2022,KAZ,W.P. Labuan,0,0,0,Kazakhstan
43331,2/1/2022,KEN,Johor,0,0,0,Kenya
43332,2/1/2022,KEN,Kedah,0,0,0,Kenya
43333,2/1/2022,KEN,Kelantan,0,0,0,Kenya
43334,2/1/2022,KEN,Perak,0,0,0,Kenya
43335,2/1/2022,KEN,Perlis,0,0,0,Kenya
43336,2/1/2022,KEN,Pulau Pinang,0,0,0,Kenya
43337,2/1/2022,KEN,Sabah,0,0,0,Kenya
43338,2/1/2022,KEN,Sarawak,0,0,0,Kenya
43339,2/1/2022,KEN,Selangor,57,33,24,Kenya
43340,2/1/2022,KGZ,Johor,0,0,0,Kyrgyzstan
43341,2/1/2022,KGZ,Kedah,0,0,0,Kyrgyzstan
43342,2/1/2022,KGZ,Kelantan,0,0,0,Kyrgyzstan
43343,2/1/2022,KGZ,Perak,0,0,0,Kyrgyzstan
43344,2/1/2022,KGZ,Perlis,0,0,0,Kyrgyzstan
43345,2/1/2022,KGZ,Pulau Pinang,0,0,0,Kyrgyzstan
43346,2/1/2022,KGZ,Sabah,0,0,0,Kyrgyzstan
43347,2/1/2022,KGZ,Sarawak,0,0,0,Kyrgyzstan
43348,2/1/2022,KGZ,Selangor,19,11,8,Kyrgyzstan
43349,2/1/2022,KHM,Johor,0,0,0,Cambodia
43350,2/1/2022,KHM,Kedah,0,0,0,Cambodia
43351,2/1/2022,KHM,Kelantan,0,0,0,Cambodia
43352,2/1/2022,KHM,Melaka,0,0,0,Cambodia
43353,2/1/2022,KHM,Negeri Sembilan,0,0,0,Cambodia
43354,2/1/2022,KHM,Pahang,0,0,0,Cambodia
43355,2/1/2022,KHM,Perak,0,0,0,Cambodia
43356,2/1/2022,KHM,Perlis,0,0,0,Cambodia
43357,2/1/2022,KHM,Pulau Pinang,29,28,1,Cambodia
43358,2/1/2022,KHM,Sabah,0,0,0,Cambodia
43359,2/1/2022,KHM,Sarawak,1,1,0,Cambodia
43360,2/1/2022,KHM,Selangor,138,109,29,Cambodia
43361,2/1/2022,KHM,W.P. Labuan,0,0,0,Cambodia
43362,2/1/2022,KIR,Johor,0,0,0,Kiribati
43363,2/1/2022,KIR,Sabah,0,0,0,Kiribati
43364,2/1/2022,KIR,Selangor,0,0,0,Kiribati
43365,2/1/2022,KNA,Johor,0,0,0,Saint Kitts and Nevis
43366,2/1/2022,KNA,Kedah,0,0,0,Saint Kitts and Nevis
43367,2/1/2022,KNA,Perlis,0,0,0,Saint Kitts and Nevis
43368,2/1/2022,KNA,Pulau Pinang,0,0,0,Saint Kitts and Nevis
43369,2/1/2022,KNA,Sabah,0,0,0,Saint Kitts and Nevis
43370,2/1/2022,KNA,Selangor,2,2,0,Saint Kitts and Nevis
43371,2/1/2022,KNA,W.P. Labuan,0,0,0,Saint Kitts and Nevis
43372,2/1/2022,KOR,Johor,4,2,2,"Korea, Republic of (South Korea)"
43373,2/1/2022,KOR,Kedah,2,1,1,"Korea, Republic of (South Korea)"
43374,2/1/2022,KOR,Kelantan,0,0,0,"Korea, Republic of (South Korea)"
43375,2/1/2022,KOR,Melaka,0,0,0,"Korea, Republic of (South Korea)"
43376,2/1/2022,KOR,Negeri Sembilan,0,0,0,"Korea, Republic of (South Korea)"
43377,2/1/2022,KOR,Pahang,0,0,0,"Korea, Republic of (South Korea)"
43378,2/1/2022,KOR,Perak,0,0,0,"Korea, Republic of (South Korea)"
43379,2/1/2022,KOR,Perlis,0,0,0,"Korea, Republic of (South Korea)"
43380,2/1/2022,KOR,Pulau Pinang,9,4,5,"Korea, Republic of (South Korea)"
43381,2/1/2022,KOR,Sabah,0,0,0,"Korea, Republic of (South Korea)"
43382,2/1/2022,KOR,Sarawak,39,34,5,"Korea, Republic of (South Korea)"
43383,2/1/2022,KOR,Selangor,837,576,261,"Korea, Republic of (South Korea)"
43384,2/1/2022,KOR,Terengganu,0,0,0,"Korea, Republic of (South Korea)"
43385,2/1/2022,KOR,W.P. Labuan,0,0,0,"Korea, Republic of (South Korea)"
43386,2/1/2022,KWT,Johor,0,0,0,Kuwait
43387,2/1/2022,KWT,Kedah,0,0,0,Kuwait
43388,2/1/2022,KWT,Kelantan,0,0,0,Kuwait
43389,2/1/2022,KWT,Perak,0,0,0,Kuwait
43390,2/1/2022,KWT,Perlis,0,0,0,Kuwait
43391,2/1/2022,KWT,Pulau Pinang,0,0,0,Kuwait
43392,2/1/2022,KWT,Sabah,0,0,0,Kuwait
43393,2/1/2022,KWT,Sarawak,0,0,0,Kuwait
43394,2/1/2022,KWT,Selangor,19,8,11,Kuwait
43395,2/1/2022,KWT,W.P. Labuan,0,0,0,Kuwait
43396,2/1/2022,LAO,Johor,0,0,0,Lao People's Democratic Republic
43397,2/1/2022,LAO,Kedah,0,0,0,Lao People's Democratic Republic
43398,2/1/2022,LAO,Kelantan,0,0,0,Lao People's Democratic Republic
43399,2/1/2022,LAO,Melaka,0,0,0,Lao People's Democratic Republic
43400,2/1/2022,LAO,Perak,0,0,0,Lao People's Democratic Republic
43401,2/1/2022,LAO,Perlis,0,0,0,Lao People's Democratic Republic
43402,2/1/2022,LAO,Pulau Pinang,0,0,0,Lao People's Democratic Republic
43403,2/1/2022,LAO,Sabah,0,0,0,Lao People's Democratic Republic
43404,2/1/2022,LAO,Sarawak,0,0,0,Lao People's Democratic Republic
43405,2/1/2022,LAO,Selangor,42,36,6,Lao People's Democratic Republic
43406,2/1/2022,LAO,W.P. Labuan,0,0,0,Lao People's Democratic Republic
43407,2/1/2022,LBN,Johor,0,0,0,Lebanon
43408,2/1/2022,LBN,Kedah,0,0,0,Lebanon
43409,2/1/2022,LBN,Kelantan,0,0,0,Lebanon
43410,2/1/2022,LBN,Pahang,0,0,0,Lebanon
43411,2/1/2022,LBN,Perak,0,0,0,Lebanon
43412,2/1/2022,LBN,Perlis,0,0,0,Lebanon
43413,2/1/2022,LBN,Pulau Pinang,0,0,0,Lebanon
43414,2/1/2022,LBN,Sabah,0,0,0,Lebanon
43415,2/1/2022,LBN,Sarawak,0,0,0,Lebanon
43416,2/1/2022,LBN,Selangor,22,15,7,Lebanon
43417,2/1/2022,LBN,W.P. Labuan,0,0,0,Lebanon
43418,2/1/2022,LBR,Johor,0,0,0,Liberia
43419,2/1/2022,LBR,Kedah,1,1,0,Liberia
43420,2/1/2022,LBR,Sabah,0,0,0,Liberia
43421,2/1/2022,LBR,Sarawak,0,0,0,Liberia
43422,2/1/2022,LBR,Selangor,7,5,2,Liberia
43423,2/1/2022,LBY,Johor,0,0,0,Libyan Arab Jamahiriya
43424,2/1/2022,LBY,Kedah,0,0,0,Libyan Arab Jamahiriya
43425,2/1/2022,LBY,Perlis,0,0,0,Libyan Arab Jamahiriya
43426,2/1/2022,LBY,Pulau Pinang,0,0,0,Libyan Arab Jamahiriya
43427,2/1/2022,LBY,Sabah,0,0,0,Libyan Arab Jamahiriya
43428,2/1/2022,LBY,Sarawak,0,0,0,Libyan Arab Jamahiriya
43429,2/1/2022,LBY,Selangor,148,108,40,Libyan Arab Jamahiriya
43430,2/1/2022,LCA,Johor,0,0,0,Saint Lucia
43431,2/1/2022,LCA,Kedah,0,0,0,Saint Lucia
43432,2/1/2022,LCA,Pulau Pinang,0,0,0,Saint Lucia
43433,2/1/2022,LCA,Sarawak,0,0,0,Saint Lucia
43434,2/1/2022,LCA,Selangor,0,0,0,Saint Lucia
43435,2/1/2022,LIE,Johor,0,0,0,Liechtenstein
43436,2/1/2022,LIE,Kedah,0,0,0,Liechtenstein
43437,2/1/2022,LIE,Perlis,0,0,0,Liechtenstein
43438,2/1/2022,LIE,Pulau Pinang,0,0,0,Liechtenstein
43439,2/1/2022,LIE,Sabah,0,0,0,Liechtenstein
43440,2/1/2022,LIE,Sarawak,0,0,0,Liechtenstein
43441,2/1/2022,LIE,Selangor,1,1,0,Liechtenstein
43442,2/1/2022,LKA,Johor,1,1,0,Sri Lanka
43443,2/1/2022,LKA,Kedah,0,0,0,Sri Lanka
43444,2/1/2022,LKA,Kelantan,0,0,0,Sri Lanka
43445,2/1/2022,LKA,Melaka,0,0,0,Sri Lanka
43446,2/1/2022,LKA,Pahang,0,0,0,Sri Lanka
43447,2/1/2022,LKA,Perak,0,0,0,Sri Lanka
43448,2/1/2022,LKA,Perlis,0,0,0,Sri Lanka
43449,2/1/2022,LKA,Pulau Pinang,1,1,0,Sri Lanka
43450,2/1/2022,LKA,Sabah,0,0,0,Sri Lanka
43451,2/1/2022,LKA,Sarawak,0,0,0,Sri Lanka
43452,2/1/2022,LKA,Selangor,369,206,163,Sri Lanka
43453,2/1/2022,LKA,W.P. Labuan,0,0,0,Sri Lanka
43454,2/1/2022,LSO,Johor,0,0,0,Lesotho
43455,2/1/2022,LSO,Kedah,0,0,0,Lesotho
43456,2/1/2022,LSO,Pulau Pinang,0,0,0,Lesotho
43457,2/1/2022,LSO,Sarawak,0,0,0,Lesotho
43458,2/1/2022,LSO,Selangor,7,3,4,Lesotho
43459,2/1/2022,LTU,Johor,0,0,0,Lithuania
43460,2/1/2022,LTU,Kedah,1,0,1,Lithuania
43461,2/1/2022,LTU,Kelantan,0,0,0,Lithuania
43462,2/1/2022,LTU,Pahang,0,0,0,Lithuania
43463,2/1/2022,LTU,Perak,0,0,0,Lithuania
43464,2/1/2022,LTU,Perlis,0,0,0,Lithuania
43465,2/1/2022,LTU,Pulau Pinang,0,0,0,Lithuania
43466,2/1/2022,LTU,Sabah,0,0,0,Lithuania
43467,2/1/2022,LTU,Sarawak,0,0,0,Lithuania
43468,2/1/2022,LTU,Selangor,12,12,0,Lithuania
43469,2/1/2022,LTU,W.P. Labuan,0,0,0,Lithuania
43470,2/1/2022,LUX,Johor,0,0,0,Luxembourg
43471,2/1/2022,LUX,Kedah,0,0,0,Luxembourg
43472,2/1/2022,LUX,Kelantan,0,0,0,Luxembourg
43473,2/1/2022,LUX,Perak,0,0,0,Luxembourg
43474,2/1/2022,LUX,Perlis,0,0,0,Luxembourg
43475,2/1/2022,LUX,Pulau Pinang,0,0,0,Luxembourg
43476,2/1/2022,LUX,Sabah,0,0,0,Luxembourg
43477,2/1/2022,LUX,Sarawak,0,0,0,Luxembourg
43478,2/1/2022,LUX,Selangor,3,2,1,Luxembourg
43479,2/1/2022,LVA,Johor,0,0,0,Latvia
43480,2/1/2022,LVA,Kedah,0,0,0,Latvia
43481,2/1/2022,LVA,Kelantan,0,0,0,Latvia
43482,2/1/2022,LVA,Pahang,0,0,0,Latvia
43483,2/1/2022,LVA,Perak,0,0,0,Latvia
43484,2/1/2022,LVA,Perlis,0,0,0,Latvia
43485,2/1/2022,LVA,Pulau Pinang,0,0,0,Latvia
43486,2/1/2022,LVA,Sabah,0,0,0,Latvia
43487,2/1/2022,LVA,Sarawak,0,0,0,Latvia
43488,2/1/2022,LVA,Selangor,6,5,1,Latvia
43489,2/1/2022,LVA,W.P. Labuan,0,0,0,Latvia
43490,2/1/2022,MAC,Johor,0,0,0,Macao
43491,2/1/2022,MAC,Pahang,0,0,0,Macao
43492,2/1/2022,MAC,Perak,0,0,0,Macao
43493,2/1/2022,MAC,Selangor,0,0,0,Macao
43494,2/1/2022,MAC,W.P. Labuan,0,0,0,Macao
43495,2/1/2022,MAR,Johor,0,0,0,Morocco
43496,2/1/2022,MAR,Kedah,0,0,0,Morocco
43497,2/1/2022,MAR,Kelantan,0,0,0,Morocco
43498,2/1/2022,MAR,Melaka,0,0,0,Morocco
43499,2/1/2022,MAR,Pahang,0,0,0,Morocco
43500,2/1/2022,MAR,Perak,0,0,0,Morocco
43501,2/1/2022,MAR,Perlis,0,0,0,Morocco
43502,2/1/2022,MAR,Pulau Pinang,0,0,0,Morocco
43503,2/1/2022,MAR,Sabah,0,0,0,Morocco
43504,2/1/2022,MAR,Sarawak,0,0,0,Morocco
43505,2/1/2022,MAR,Selangor,32,7,25,Morocco
43506,2/1/2022,MAR,W.P. Labuan,0,0,0,Morocco
43507,2/1/2022,MCO,Johor,0,0,0,Monaco
43508,2/1/2022,MCO,Kedah,0,0,0,Monaco
43509,2/1/2022,MCO,Sabah,0,0,0,Monaco
43510,2/1/2022,MCO,Selangor,2,1,1,Monaco
43511,2/1/2022,MDA,Johor,0,0,0,"Moldova, Republic of"
43512,2/1/2022,MDA,Kedah,0,0,0,"Moldova, Republic of"
43513,2/1/2022,MDA,Kelantan,0,0,0,"Moldova, Republic of"
43514,2/1/2022,MDA,Negeri Sembilan,0,0,0,"Moldova, Republic of"
43515,2/1/2022,MDA,Perlis,0,0,0,"Moldova, Republic of"
43516,2/1/2022,MDA,Pulau Pinang,0,0,0,"Moldova, Republic of"
43517,2/1/2022,MDA,Sabah,0,0,0,"Moldova, Republic of"
43518,2/1/2022,MDA,Sarawak,0,0,0,"Moldova, Republic of"
43519,2/1/2022,MDA,Selangor,1,0,1,"Moldova, Republic of"
43520,2/1/2022,MDG,Johor,0,0,0,Madagascar
43521,2/1/2022,MDG,Kedah,0,0,0,Madagascar
43522,2/1/2022,MDG,Perak,0,0,0,Madagascar
43523,2/1/2022,MDG,Perlis,0,0,0,Madagascar
43524,2/1/2022,MDG,Pulau Pinang,0,0,0,Madagascar
43525,2/1/2022,MDG,Sabah,0,0,0,Madagascar
43526,2/1/2022,MDG,Sarawak,0,0,0,Madagascar
43527,2/1/2022,MDG,Selangor,0,0,0,Madagascar
43528,2/1/2022,MDV,Johor,0,0,0,Maldives
43529,2/1/2022,MDV,Kedah,41,17,24,Maldives
43530,2/1/2022,MDV,Kelantan,0,0,0,Maldives
43531,2/1/2022,MDV,Perak,0,0,0,Maldives
43532,2/1/2022,MDV,Perlis,0,0,0,Maldives
43533,2/1/2022,MDV,Pulau Pinang,0,0,0,Maldives
43534,2/1/2022,MDV,Sabah,0,0,0,Maldives
43535,2/1/2022,MDV,Sarawak,0,0,0,Maldives
43536,2/1/2022,MDV,Selangor,212,97,115,Maldives
43537,2/1/2022,MEX,Johor,0,0,0,Mexico
43538,2/1/2022,MEX,Kedah,0,0,0,Mexico
43539,2/1/2022,MEX,Kelantan,0,0,0,Mexico
43540,2/1/2022,MEX,Pahang,0,0,0,Mexico
43541,2/1/2022,MEX,Perak,0,0,0,Mexico
43542,2/1/2022,MEX,Perlis,0,0,0,Mexico
43543,2/1/2022,MEX,Pulau Pinang,0,0,0,Mexico
43544,2/1/2022,MEX,Sabah,0,0,0,Mexico
43545,2/1/2022,MEX,Sarawak,0,0,0,Mexico
43546,2/1/2022,MEX,Selangor,32,19,13,Mexico
43547,2/1/2022,MEX,W.P. Labuan,0,0,0,Mexico
43548,2/1/2022,MHL,Johor,0,0,0,Marshall Islands
43549,2/1/2022,MHL,Kedah,0,0,0,Marshall Islands
43550,2/1/2022,MHL,Perak,0,0,0,Marshall Islands
43551,2/1/2022,MHL,Pulau Pinang,0,0,0,Marshall Islands
43552,2/1/2022,MHL,Sabah,0,0,0,Marshall Islands
43553,2/1/2022,MHL,Selangor,0,0,0,Marshall Islands
43554,2/1/2022,MKD,Johor,0,0,0,"Macedonia, the former Yugoslav Republic of"
43555,2/1/2022,MKD,Kedah,0,0,0,"Macedonia, the former Yugoslav Republic of"
43556,2/1/2022,MKD,Perak,0,0,0,"Macedonia, the former Yugoslav Republic of"
43557,2/1/2022,MKD,Pulau Pinang,0,0,0,"Macedonia, the former Yugoslav Republic of"
43558,2/1/2022,MKD,Sabah,0,0,0,"Macedonia, the former Yugoslav Republic of"
43559,2/1/2022,MKD,Sarawak,0,0,0,"Macedonia, the former Yugoslav Republic of"
43560,2/1/2022,MKD,Selangor,1,1,0,"Macedonia, the former Yugoslav Republic of"
43561,2/1/2022,MLI,Johor,0,0,0,Mali
43562,2/1/2022,MLI,Sabah,0,0,0,Mali
43563,2/1/2022,MLI,Selangor,3,2,1,Mali
43564,2/1/2022,MLT,Johor,0,0,0,Malta
43565,2/1/2022,MLT,Kedah,0,0,0,Malta
43566,2/1/2022,MLT,Kelantan,0,0,0,Malta
43567,2/1/2022,MLT,Perak,0,0,0,Malta
43568,2/1/2022,MLT,Perlis,0,0,0,Malta
43569,2/1/2022,MLT,Pulau Pinang,0,0,0,Malta
43570,2/1/2022,MLT,Sabah,0,0,0,Malta
43571,2/1/2022,MLT,Sarawak,0,0,0,Malta
43572,2/1/2022,MLT,Selangor,2,2,0,Malta
43573,2/1/2022,MLT,W.P. Labuan,0,0,0,Malta
43574,2/1/2022,MMR,Johor,26,26,0,Myanmar
43575,2/1/2022,MMR,Kedah,0,0,0,Myanmar
43576,2/1/2022,MMR,Kelantan,0,0,0,Myanmar
43577,2/1/2022,MMR,Negeri Sembilan,0,0,0,Myanmar
43578,2/1/2022,MMR,Pahang,0,0,0,Myanmar
43579,2/1/2022,MMR,Perak,0,0,0,Myanmar
43580,2/1/2022,MMR,Perlis,0,0,0,Myanmar
43581,2/1/2022,MMR,Pulau Pinang,1,0,1,Myanmar
43582,2/1/2022,MMR,Sabah,0,0,0,Myanmar
43583,2/1/2022,MMR,Sarawak,2,0,2,Myanmar
43584,2/1/2022,MMR,Selangor,272,209,63,Myanmar
43585,2/1/2022,MMR,Terengganu,0,0,0,Myanmar
43586,2/1/2022,MMR,W.P. Labuan,0,0,0,Myanmar
43587,2/1/2022,MNE,Johor,0,0,0,Montenegro
43588,2/1/2022,MNE,Kedah,0,0,0,Montenegro
43589,2/1/2022,MNE,Pulau Pinang,0,0,0,Montenegro
43590,2/1/2022,MNE,Sabah,0,0,0,Montenegro
43591,2/1/2022,MNE,Sarawak,0,0,0,Montenegro
43592,2/1/2022,MNE,Selangor,9,9,0,Montenegro
43593,2/1/2022,MNG,Johor,0,0,0,Mongolia
43594,2/1/2022,MNG,Kedah,1,0,1,Mongolia
43595,2/1/2022,MNG,Kelantan,0,0,0,Mongolia
43596,2/1/2022,MNG,Perak,0,0,0,Mongolia
43597,2/1/2022,MNG,Perlis,0,0,0,Mongolia
43598,2/1/2022,MNG,Pulau Pinang,0,0,0,Mongolia
43599,2/1/2022,MNG,Sabah,0,0,0,Mongolia
43600,2/1/2022,MNG,Sarawak,0,0,0,Mongolia
43601,2/1/2022,MNG,Selangor,12,7,5,Mongolia
43602,2/1/2022,MNP,Selangor,0,0,0,Northern Mariana Islands
43603,2/1/2022,MOZ,Johor,0,0,0,Mozambique
43604,2/1/2022,MOZ,Kedah,0,0,0,Mozambique
43605,2/1/2022,MOZ,Perak,0,0,0,Mozambique
43606,2/1/2022,MOZ,Pulau Pinang,0,0,0,Mozambique
43607,2/1/2022,MOZ,Sabah,0,0,0,Mozambique
43608,2/1/2022,MOZ,Sarawak,0,0,0,Mozambique
43609,2/1/2022,MOZ,Selangor,6,2,4,Mozambique
43610,2/1/2022,MRT,Johor,0,0,0,Mauritania
43611,2/1/2022,MRT,Kedah,0,0,0,Mauritania
43612,2/1/2022,MRT,Pulau Pinang,0,0,0,Mauritania
43613,2/1/2022,MRT,Sabah,0,0,0,Mauritania
43614,2/1/2022,MRT,Sarawak,0,0,0,Mauritania
43615,2/1/2022,MRT,Selangor,7,5,2,Mauritania
43616,2/1/2022,MUS,Johor,0,0,0,Mauritius
43617,2/1/2022,MUS,Kedah,0,0,0,Mauritius
43618,2/1/2022,MUS,Kelantan,0,0,0,Mauritius
43619,2/1/2022,MUS,Pahang,0,0,0,Mauritius
43620,2/1/2022,MUS,Perak,0,0,0,Mauritius
43621,2/1/2022,MUS,Perlis,0,0,0,Mauritius
43622,2/1/2022,MUS,Pulau Pinang,0,0,0,Mauritius
43623,2/1/2022,MUS,Sabah,0,0,0,Mauritius
43624,2/1/2022,MUS,Sarawak,0,0,0,Mauritius
43625,2/1/2022,MUS,Selangor,44,20,24,Mauritius
43626,2/1/2022,MWI,Johor,0,0,0,Malawi
43627,2/1/2022,MWI,Pulau Pinang,0,0,0,Malawi
43628,2/1/2022,MWI,Sabah,0,0,0,Malawi
43629,2/1/2022,MWI,Sarawak,0,0,0,Malawi
43630,2/1/2022,MWI,Selangor,3,2,1,Malawi
43631,2/1/2022,MYT,Selangor,0,0,0,Mayotte
43632,2/1/2022,NAM,Johor,0,0,0,Namibia
43633,2/1/2022,NAM,Kedah,0,0,0,Namibia
43634,2/1/2022,NAM,Perak,0,0,0,Namibia
43635,2/1/2022,NAM,Perlis,0,0,0,Namibia
43636,2/1/2022,NAM,Pulau Pinang,0,0,0,Namibia
43637,2/1/2022,NAM,Sabah,0,0,0,Namibia
43638,2/1/2022,NAM,Sarawak,0,0,0,Namibia
43639,2/1/2022,NAM,Selangor,2,1,1,Namibia
43640,2/1/2022,NCL,Selangor,0,0,0,New Caledonia
43641,2/1/2022,NER,Johor,0,0,0,Niger
43642,2/1/2022,NER,Sabah,0,0,0,Niger
43643,2/1/2022,NER,Selangor,1,0,1,Niger
43644,2/1/2022,NGA,Johor,0,0,0,Nigeria
43645,2/1/2022,NGA,Kedah,0,0,0,Nigeria
43646,2/1/2022,NGA,Perlis,0,0,0,Nigeria
43647,2/1/2022,NGA,Pulau Pinang,0,0,0,Nigeria
43648,2/1/2022,NGA,Sabah,0,0,0,Nigeria
43649,2/1/2022,NGA,Sarawak,0,0,0,Nigeria
43650,2/1/2022,NGA,Selangor,244,209,35,Nigeria
43651,2/1/2022,NIC,Johor,0,0,0,Nicaragua
43652,2/1/2022,NIC,Kedah,0,0,0,Nicaragua
43653,2/1/2022,NIC,Pulau Pinang,0,0,0,Nicaragua
43654,2/1/2022,NIC,Sabah,0,0,0,Nicaragua
43655,2/1/2022,NIC,Selangor,0,0,0,Nicaragua
43656,2/1/2022,NLD,Johor,2,2,0,Netherlands
43657,2/1/2022,NLD,Kedah,19,11,8,Netherlands
43658,2/1/2022,NLD,Kelantan,0,0,0,Netherlands
43659,2/1/2022,NLD,Melaka,0,0,0,Netherlands
43660,2/1/2022,NLD,Negeri Sembilan,0,0,0,Netherlands
43661,2/1/2022,NLD,Pahang,0,0,0,Netherlands
43662,2/1/2022,NLD,Perak,0,0,0,Netherlands
43663,2/1/2022,NLD,Perlis,0,0,0,Netherlands
43664,2/1/2022,NLD,Pulau Pinang,3,1,2,Netherlands
43665,2/1/2022,NLD,Sabah,0,0,0,Netherlands
43666,2/1/2022,NLD,Sarawak,0,0,0,Netherlands
43667,2/1/2022,NLD,Selangor,185,148,37,Netherlands
43668,2/1/2022,NLD,Terengganu,0,0,0,Netherlands
43669,2/1/2022,NLD,W.P. Labuan,0,0,0,Netherlands
43670,2/1/2022,NOR,Johor,0,0,0,Norway
43671,2/1/2022,NOR,Kedah,0,0,0,Norway
43672,2/1/2022,NOR,Kelantan,0,0,0,Norway
43673,2/1/2022,NOR,Melaka,0,0,0,Norway
43674,2/1/2022,NOR,Pahang,0,0,0,Norway
43675,2/1/2022,NOR,Perak,0,0,0,Norway
43676,2/1/2022,NOR,Perlis,0,0,0,Norway
43677,2/1/2022,NOR,Pulau Pinang,0,0,0,Norway
43678,2/1/2022,NOR,Sabah,0,0,0,Norway
43679,2/1/2022,NOR,Sarawak,0,0,0,Norway
43680,2/1/2022,NOR,Selangor,28,23,5,Norway
43681,2/1/2022,NOR,W.P. Labuan,0,0,0,Norway
43682,2/1/2022,NPL,Johor,0,0,0,Nepal
43683,2/1/2022,NPL,Kedah,0,0,0,Nepal
43684,2/1/2022,NPL,Pahang,0,0,0,Nepal
43685,2/1/2022,NPL,Perak,0,0,0,Nepal
43686,2/1/2022,NPL,Perlis,0,0,0,Nepal
43687,2/1/2022,NPL,Pulau Pinang,21,20,1,Nepal
43688,2/1/2022,NPL,Sabah,0,0,0,Nepal
43689,2/1/2022,NPL,Sarawak,1,1,0,Nepal
43690,2/1/2022,NPL,Selangor,576,552,24,Nepal
43691,2/1/2022,NPL,W.P. Labuan,0,0,0,Nepal
43692,2/1/2022,NRU,Johor,0,0,0,Nauru
43693,2/1/2022,NRU,Pulau Pinang,0,0,0,Nauru
43694,2/1/2022,NRU,Selangor,0,0,0,Nauru
43695,2/1/2022,NZL,Johor,0,0,0,New Zealand
43696,2/1/2022,NZL,Kedah,12,10,2,New Zealand
43697,2/1/2022,NZL,Kelantan,0,0,0,New Zealand
43698,2/1/2022,NZL,Melaka,0,0,0,New Zealand
43699,2/1/2022,NZL,Negeri Sembilan,0,0,0,New Zealand
43700,2/1/2022,NZL,Pahang,0,0,0,New Zealand
43701,2/1/2022,NZL,Perak,0,0,0,New Zealand
43702,2/1/2022,NZL,Perlis,0,0,0,New Zealand
43703,2/1/2022,NZL,Pulau Pinang,2,1,1,New Zealand
43704,2/1/2022,NZL,Sabah,0,0,0,New Zealand
43705,2/1/2022,NZL,Sarawak,2,2,0,New Zealand
43706,2/1/2022,NZL,Selangor,63,39,24,New Zealand
43707,2/1/2022,NZL,Terengganu,0,0,0,New Zealand
43708,2/1/2022,NZL,W.P. Labuan,0,0,0,New Zealand
43709,2/1/2022,OMN,Johor,0,0,0,Oman
43710,2/1/2022,OMN,Kedah,0,0,0,Oman
43711,2/1/2022,OMN,Kelantan,0,0,0,Oman
43712,2/1/2022,OMN,Melaka,0,0,0,Oman
43713,2/1/2022,OMN,Perak,0,0,0,Oman
43714,2/1/2022,OMN,Perlis,0,0,0,Oman
43715,2/1/2022,OMN,Pulau Pinang,0,0,0,Oman
43716,2/1/2022,OMN,Sabah,0,0,0,Oman
43717,2/1/2022,OMN,Sarawak,0,0,0,Oman
43718,2/1/2022,OMN,Selangor,62,45,17,Oman
43719,2/1/2022,PAK,Johor,0,0,0,Pakistan
43720,2/1/2022,PAK,Kedah,0,0,0,Pakistan
43721,2/1/2022,PAK,Kelantan,0,0,0,Pakistan
43722,2/1/2022,PAK,Melaka,0,0,0,Pakistan
43723,2/1/2022,PAK,Negeri Sembilan,0,0,0,Pakistan
43724,2/1/2022,PAK,Pahang,0,0,0,Pakistan
43725,2/1/2022,PAK,Perak,0,0,0,Pakistan
43726,2/1/2022,PAK,Perlis,0,0,0,Pakistan
43727,2/1/2022,PAK,Pulau Pinang,0,0,0,Pakistan
43728,2/1/2022,PAK,Sabah,1,1,0,Pakistan
43729,2/1/2022,PAK,Sarawak,3,3,0,Pakistan
43730,2/1/2022,PAK,Selangor,3094,2779,315,Pakistan
43731,2/1/2022,PAK,W.P. Labuan,0,0,0,Pakistan
43732,2/1/2022,PAN,Johor,0,0,0,Panama
43733,2/1/2022,PAN,Kedah,0,0,0,Panama
43734,2/1/2022,PAN,Perak,0,0,0,Panama
43735,2/1/2022,PAN,Perlis,0,0,0,Panama
43736,2/1/2022,PAN,Pulau Pinang,0,0,0,Panama
43737,2/1/2022,PAN,Sabah,0,0,0,Panama
43738,2/1/2022,PAN,Sarawak,0,0,0,Panama
43739,2/1/2022,PAN,Selangor,0,0,0,Panama
43740,2/1/2022,PER,Johor,0,0,0,Peru
43741,2/1/2022,PER,Kedah,1,1,0,Peru
43742,2/1/2022,PER,Kelantan,0,0,0,Peru
43743,2/1/2022,PER,Pahang,0,0,0,Peru
43744,2/1/2022,PER,Perak,0,0,0,Peru
43745,2/1/2022,PER,Perlis,0,0,0,Peru
43746,2/1/2022,PER,Pulau Pinang,0,0,0,Peru
43747,2/1/2022,PER,Sabah,0,0,0,Peru
43748,2/1/2022,PER,Sarawak,0,0,0,Peru
43749,2/1/2022,PER,Selangor,2,0,2,Peru
43750,2/1/2022,PER,W.P. Labuan,0,0,0,Peru
43751,2/1/2022,PHL,Johor,91,87,4,Philippines
43752,2/1/2022,PHL,Kedah,1,0,1,Philippines
43753,2/1/2022,PHL,Kelantan,1,1,0,Philippines
43754,2/1/2022,PHL,Melaka,0,0,0,Philippines
43755,2/1/2022,PHL,Negeri Sembilan,0,0,0,Philippines
43756,2/1/2022,PHL,Pahang,0,0,0,Philippines
43757,2/1/2022,PHL,Perak,0,0,0,Philippines
43758,2/1/2022,PHL,Perlis,0,0,0,Philippines
43759,2/1/2022,PHL,Pulau Pinang,6,5,1,Philippines
43760,2/1/2022,PHL,Sabah,5,2,3,Philippines
43761,2/1/2022,PHL,Sarawak,20,19,1,Philippines
43762,2/1/2022,PHL,Selangor,1456,852,604,Philippines
43763,2/1/2022,PHL,Terengganu,0,0,0,Philippines
43764,2/1/2022,PHL,W.P. Labuan,14,14,0,Philippines
43765,2/1/2022,PLW,Johor,0,0,0,Palau
43766,2/1/2022,PLW,Pulau Pinang,0,0,0,Palau
43767,2/1/2022,PLW,Selangor,0,0,0,Palau
43768,2/1/2022,PNG,Johor,0,0,0,Papua New Guinea
43769,2/1/2022,PNG,Kedah,0,0,0,Papua New Guinea
43770,2/1/2022,PNG,Kelantan,0,0,0,Papua New Guinea
43771,2/1/2022,PNG,Perak,0,0,0,Papua New Guinea
43772,2/1/2022,PNG,Pulau Pinang,0,0,0,Papua New Guinea
43773,2/1/2022,PNG,Sabah,0,0,0,Papua New Guinea
43774,2/1/2022,PNG,Sarawak,0,0,0,Papua New Guinea
43775,2/1/2022,PNG,Selangor,2,1,1,Papua New Guinea
43776,2/1/2022,POL,Johor,0,0,0,Poland
43777,2/1/2022,POL,Kedah,0,0,0,Poland
43778,2/1/2022,POL,Kelantan,0,0,0,Poland
43779,2/1/2022,POL,Melaka,0,0,0,Poland
43780,2/1/2022,POL,Negeri Sembilan,0,0,0,Poland
43781,2/1/2022,POL,Pahang,0,0,0,Poland
43782,2/1/2022,POL,Perak,0,0,0,Poland
43783,2/1/2022,POL,Perlis,0,0,0,Poland
43784,2/1/2022,POL,Pulau Pinang,0,0,0,Poland
43785,2/1/2022,POL,Sabah,0,0,0,Poland
43786,2/1/2022,POL,Sarawak,0,0,0,Poland
43787,2/1/2022,POL,Selangor,62,53,9,Poland
43788,2/1/2022,POL,Terengganu,0,0,0,Poland
43789,2/1/2022,POL,W.P. Labuan,0,0,0,Poland
43790,2/1/2022,PRK,Selangor,0,0,0,"Korea, Democratic People's Republic of"
43791,2/1/2022,PRT,Johor,0,0,0,Portugal
43792,2/1/2022,PRT,Kedah,0,0,0,Portugal
43793,2/1/2022,PRT,Kelantan,0,0,0,Portugal
43794,2/1/2022,PRT,Melaka,0,0,0,Portugal
43795,2/1/2022,PRT,Pahang,0,0,0,Portugal
43796,2/1/2022,PRT,Perak,0,0,0,Portugal
43797,2/1/2022,PRT,Perlis,0,0,0,Portugal
43798,2/1/2022,PRT,Pulau Pinang,0,0,0,Portugal
43799,2/1/2022,PRT,Sabah,0,0,0,Portugal
43800,2/1/2022,PRT,Sarawak,0,0,0,Portugal
43801,2/1/2022,PRT,Selangor,35,25,10,Portugal
43802,2/1/2022,PRT,W.P. Labuan,0,0,0,Portugal
43803,2/1/2022,PRY,Johor,0,0,0,Paraguay
43804,2/1/2022,PRY,Kedah,0,0,0,Paraguay
43805,2/1/2022,PRY,Perak,0,0,0,Paraguay
43806,2/1/2022,PRY,Perlis,0,0,0,Paraguay
43807,2/1/2022,PRY,Pulau Pinang,0,0,0,Paraguay
43808,2/1/2022,PRY,Sabah,0,0,0,Paraguay
43809,2/1/2022,PRY,Sarawak,0,0,0,Paraguay
43810,2/1/2022,PRY,Selangor,0,0,0,Paraguay
43811,2/1/2022,PSE,Johor,0,0,0,"Palestinian Territory, Occupied"
43812,2/1/2022,PSE,Kedah,0,0,0,"Palestinian Territory, Occupied"
43813,2/1/2022,PSE,Kelantan,0,0,0,"Palestinian Territory, Occupied"
43814,2/1/2022,PSE,Melaka,0,0,0,"Palestinian Territory, Occupied"
43815,2/1/2022,PSE,Perak,0,0,0,"Palestinian Territory, Occupied"
43816,2/1/2022,PSE,Perlis,0,0,0,"Palestinian Territory, Occupied"
43817,2/1/2022,PSE,Pulau Pinang,0,0,0,"Palestinian Territory, Occupied"
43818,2/1/2022,PSE,Sabah,0,0,0,"Palestinian Territory, Occupied"
43819,2/1/2022,PSE,Sarawak,0,0,0,"Palestinian Territory, Occupied"
43820,2/1/2022,PSE,Selangor,53,43,10,"Palestinian Territory, Occupied"
43821,2/1/2022,QAT,Johor,0,0,0,Qatar
43822,2/1/2022,QAT,Kedah,0,0,0,Qatar
43823,2/1/2022,QAT,Perlis,0,0,0,Qatar
43824,2/1/2022,QAT,Pulau Pinang,0,0,0,Qatar
43825,2/1/2022,QAT,Sabah,0,0,0,Qatar
43826,2/1/2022,QAT,Sarawak,0,0,0,Qatar
43827,2/1/2022,QAT,Selangor,7,1,6,Qatar
43828,2/1/2022,REU,Johor,0,0,0,Reunion
43829,2/1/2022,REU,Sarawak,0,0,0,Reunion
43830,2/1/2022,ROU,Johor,6,6,0,Romania
43831,2/1/2022,ROU,Kedah,4,0,4,Romania
43832,2/1/2022,ROU,Kelantan,1,0,1,Romania
43833,2/1/2022,ROU,Negeri Sembilan,0,0,0,Romania
43834,2/1/2022,ROU,Pahang,0,0,0,Romania
43835,2/1/2022,ROU,Perak,0,0,0,Romania
43836,2/1/2022,ROU,Perlis,0,0,0,Romania
43837,2/1/2022,ROU,Pulau Pinang,0,0,0,Romania
43838,2/1/2022,ROU,Sabah,0,0,0,Romania
43839,2/1/2022,ROU,Sarawak,0,0,0,Romania
43840,2/1/2022,ROU,Selangor,31,26,5,Romania
43841,2/1/2022,ROU,W.P. Labuan,0,0,0,Romania
43842,2/1/2022,RUS,Johor,7,6,1,Russia
43843,2/1/2022,RUS,Kedah,0,0,0,Russia
43844,2/1/2022,RUS,Kelantan,0,0,0,Russia
43845,2/1/2022,RUS,Melaka,0,0,0,Russia
43846,2/1/2022,RUS,Negeri Sembilan,0,0,0,Russia
43847,2/1/2022,RUS,Pahang,0,0,0,Russia
43848,2/1/2022,RUS,Perak,0,0,0,Russia
43849,2/1/2022,RUS,Perlis,0,0,0,Russia
43850,2/1/2022,RUS,Pulau Pinang,0,0,0,Russia
43851,2/1/2022,RUS,Sabah,1,0,1,Russia
43852,2/1/2022,RUS,Sarawak,0,0,0,Russia
43853,2/1/2022,RUS,Selangor,104,68,36,Russia
43854,2/1/2022,RUS,W.P. Labuan,0,0,0,Russia
43855,2/1/2022,RWA,Johor,0,0,0,Rwanda
43856,2/1/2022,RWA,Kedah,0,0,0,Rwanda
43857,2/1/2022,RWA,Pulau Pinang,0,0,0,Rwanda
43858,2/1/2022,RWA,Selangor,0,0,0,Rwanda
43859,2/1/2022,SAU,Johor,0,0,0,Saudi Arabia
43860,2/1/2022,SAU,Kedah,0,0,0,Saudi Arabia
43861,2/1/2022,SAU,Kelantan,0,0,0,Saudi Arabia
43862,2/1/2022,SAU,Melaka,0,0,0,Saudi Arabia
43863,2/1/2022,SAU,Perak,0,0,0,Saudi Arabia
43864,2/1/2022,SAU,Perlis,0,0,0,Saudi Arabia
43865,2/1/2022,SAU,Pulau Pinang,0,0,0,Saudi Arabia
43866,2/1/2022,SAU,Sabah,0,0,0,Saudi Arabia
43867,2/1/2022,SAU,Sarawak,0,0,0,Saudi Arabia
43868,2/1/2022,SAU,Selangor,142,89,53,Saudi Arabia
43869,2/1/2022,SAU,W.P. Labuan,0,0,0,Saudi Arabia
43870,2/1/2022,SDN,Johor,0,0,0,Sudan
43871,2/1/2022,SDN,Kedah,0,0,0,Sudan
43872,2/1/2022,SDN,Kelantan,0,0,0,Sudan
43873,2/1/2022,SDN,Perlis,0,0,0,Sudan
43874,2/1/2022,SDN,Pulau Pinang,0,0,0,Sudan
43875,2/1/2022,SDN,Sabah,0,0,0,Sudan
43876,2/1/2022,SDN,Sarawak,0,0,0,Sudan
43877,2/1/2022,SDN,Selangor,184,134,50,Sudan
43878,2/1/2022,SDN,W.P. Labuan,0,0,0,Sudan
43879,2/1/2022,SEN,Johor,0,0,0,Senegal
43880,2/1/2022,SEN,Kedah,0,0,0,Senegal
43881,2/1/2022,SEN,Kelantan,0,0,0,Senegal
43882,2/1/2022,SEN,Perak,0,0,0,Senegal
43883,2/1/2022,SEN,Perlis,0,0,0,Senegal
43884,2/1/2022,SEN,Pulau Pinang,0,0,0,Senegal
43885,2/1/2022,SEN,Sabah,0,0,0,Senegal
43886,2/1/2022,SEN,Sarawak,0,0,0,Senegal
43887,2/1/2022,SEN,Selangor,3,3,0,Senegal
43888,2/1/2022,SGP,Johor,2230,1240,990,Singapore
43889,2/1/2022,SGP,Kedah,16,8,8,Singapore
43890,2/1/2022,SGP,Kelantan,0,0,0,Singapore
43891,2/1/2022,SGP,Melaka,0,0,0,Singapore
43892,2/1/2022,SGP,Negeri Sembilan,0,0,0,Singapore
43893,2/1/2022,SGP,Pahang,0,0,0,Singapore
43894,2/1/2022,SGP,Perak,7,2,5,Singapore
43895,2/1/2022,SGP,Perlis,1,1,0,Singapore
43896,2/1/2022,SGP,Pulau Pinang,15,9,6,Singapore
43897,2/1/2022,SGP,Sabah,1,1,0,Singapore
43898,2/1/2022,SGP,Sarawak,28,18,10,Singapore
43899,2/1/2022,SGP,Selangor,4594,2801,1793,Singapore
43900,2/1/2022,SGP,Terengganu,0,0,0,Singapore
43901,2/1/2022,SGP,W.P. Labuan,0,0,0,Singapore
43902,2/1/2022,SGS,Johor,0,0,0,South Georgia and the South Sandwich Islands
43903,2/1/2022,SGS,Sabah,0,0,0,South Georgia and the South Sandwich Islands
43904,2/1/2022,SGS,Selangor,0,0,0,South Georgia and the South Sandwich Islands
43905,2/1/2022,SHN,Sarawak,0,0,0,"Saint Helena, Ascension and Tristan da Cunha"
43906,2/1/2022,SLB,Johor,0,0,0,Solomon Islands
43907,2/1/2022,SLB,Perlis,0,0,0,Solomon Islands
43908,2/1/2022,SLB,Pulau Pinang,0,0,0,Solomon Islands
43909,2/1/2022,SLB,Sabah,0,0,0,Solomon Islands
43910,2/1/2022,SLB,Sarawak,0,0,0,Solomon Islands
43911,2/1/2022,SLB,Selangor,0,0,0,Solomon Islands
43912,2/1/2022,SLB,W.P. Labuan,0,0,0,Solomon Islands
43913,2/1/2022,SLE,Johor,0,0,0,Sierra Leone
43914,2/1/2022,SLE,Kedah,0,0,0,Sierra Leone
43915,2/1/2022,SLE,Perak,0,0,0,Sierra Leone
43916,2/1/2022,SLE,Pulau Pinang,0,0,0,Sierra Leone
43917,2/1/2022,SLE,Sabah,0,0,0,Sierra Leone
43918,2/1/2022,SLE,Selangor,5,3,2,Sierra Leone
43919,2/1/2022,SLV,Johor,0,0,0,El Salvador
43920,2/1/2022,SLV,Kedah,0,0,0,El Salvador
43921,2/1/2022,SLV,Perak,0,0,0,El Salvador
43922,2/1/2022,SLV,Perlis,0,0,0,El Salvador
43923,2/1/2022,SLV,Pulau Pinang,0,0,0,El Salvador
43924,2/1/2022,SLV,Sabah,0,0,0,El Salvador
43925,2/1/2022,SLV,Selangor,1,0,1,El Salvador
43926,2/1/2022,SLV,W.P. Labuan,0,0,0,El Salvador
43927,2/1/2022,SMR,Johor,0,0,0,San Marino
43928,2/1/2022,SMR,Selangor,2,2,0,San Marino
43929,2/1/2022,SOM,Johor,0,0,0,Somalia
43930,2/1/2022,SOM,Kedah,0,0,0,Somalia
43931,2/1/2022,SOM,Kelantan,0,0,0,Somalia
43932,2/1/2022,SOM,Perlis,0,0,0,Somalia
43933,2/1/2022,SOM,Sabah,0,0,0,Somalia
43934,2/1/2022,SOM,Sarawak,0,0,0,Somalia
43935,2/1/2022,SOM,Selangor,54,31,23,Somalia
43936,2/1/2022,SRB,Johor,0,0,0,Serbia
43937,2/1/2022,SRB,Kedah,0,0,0,Serbia
43938,2/1/2022,SRB,Kelantan,0,0,0,Serbia
43939,2/1/2022,SRB,Pahang,0,0,0,Serbia
43940,2/1/2022,SRB,Perak,0,0,0,Serbia
43941,2/1/2022,SRB,Perlis,0,0,0,Serbia
43942,2/1/2022,SRB,Pulau Pinang,0,0,0,Serbia
43943,2/1/2022,SRB,Sabah,0,0,0,Serbia
43944,2/1/2022,SRB,Sarawak,0,0,0,Serbia
43945,2/1/2022,SRB,Selangor,5,3,2,Serbia
43946,2/1/2022,STP,Selangor,0,0,0,Sao Tome and Principe
43947,2/1/2022,SUR,Johor,0,0,0,Suriname
43948,2/1/2022,SUR,Kedah,0,0,0,Suriname
43949,2/1/2022,SUR,Kelantan,0,0,0,Suriname
43950,2/1/2022,SUR,Perak,0,0,0,Suriname
43951,2/1/2022,SUR,Perlis,0,0,0,Suriname
43952,2/1/2022,SUR,Pulau Pinang,0,0,0,Suriname
43953,2/1/2022,SUR,Sabah,0,0,0,Suriname
43954,2/1/2022,SUR,Sarawak,0,0,0,Suriname
43955,2/1/2022,SUR,Selangor,0,0,0,Suriname
43956,2/1/2022,SVK,Johor,0,0,0,Slovakia
43957,2/1/2022,SVK,Kedah,0,0,0,Slovakia
43958,2/1/2022,SVK,Kelantan,0,0,0,Slovakia
43959,2/1/2022,SVK,Negeri Sembilan,0,0,0,Slovakia
43960,2/1/2022,SVK,Pahang,0,0,0,Slovakia
43961,2/1/2022,SVK,Perak,0,0,0,Slovakia
43962,2/1/2022,SVK,Perlis,0,0,0,Slovakia
43963,2/1/2022,SVK,Pulau Pinang,0,0,0,Slovakia
43964,2/1/2022,SVK,Sabah,0,0,0,Slovakia
43965,2/1/2022,SVK,Sarawak,0,0,0,Slovakia
43966,2/1/2022,SVK,Selangor,13,10,3,Slovakia
43967,2/1/2022,SVK,W.P. Labuan,0,0,0,Slovakia
43968,2/1/2022,SVN,Johor,0,0,0,Slovenia
43969,2/1/2022,SVN,Kedah,0,0,0,Slovenia
43970,2/1/2022,SVN,Kelantan,0,0,0,Slovenia
43971,2/1/2022,SVN,Perak,0,0,0,Slovenia
43972,2/1/2022,SVN,Perlis,0,0,0,Slovenia
43973,2/1/2022,SVN,Pulau Pinang,0,0,0,Slovenia
43974,2/1/2022,SVN,Sabah,0,0,0,Slovenia
43975,2/1/2022,SVN,Sarawak,0,0,0,Slovenia
43976,2/1/2022,SVN,Selangor,8,5,3,Slovenia
43977,2/1/2022,SVN,W.P. Labuan,0,0,0,Slovenia
43978,2/1/2022,SWE,Johor,0,0,0,Sweden
43979,2/1/2022,SWE,Kedah,1,1,0,Sweden
43980,2/1/2022,SWE,Kelantan,0,0,0,Sweden
43981,2/1/2022,SWE,Melaka,0,0,0,Sweden
43982,2/1/2022,SWE,Negeri Sembilan,0,0,0,Sweden
43983,2/1/2022,SWE,Pahang,0,0,0,Sweden
43984,2/1/2022,SWE,Perak,0,0,0,Sweden
43985,2/1/2022,SWE,Perlis,0,0,0,Sweden
43986,2/1/2022,SWE,Pulau Pinang,0,0,0,Sweden
43987,2/1/2022,SWE,Sabah,0,0,0,Sweden
43988,2/1/2022,SWE,Sarawak,0,0,0,Sweden
43989,2/1/2022,SWE,Selangor,70,52,18,Sweden
43990,2/1/2022,SWE,W.P. Labuan,0,0,0,Sweden
43991,2/1/2022,SWZ,Johor,0,0,0,Swaziland
43992,2/1/2022,SWZ,Kedah,0,0,0,Swaziland
43993,2/1/2022,SWZ,Pulau Pinang,0,0,0,Swaziland
43994,2/1/2022,SWZ,Sabah,0,0,0,Swaziland
43995,2/1/2022,SWZ,Selangor,2,0,2,Swaziland
43996,2/1/2022,SYC,Johor,0,0,0,Seychelles
43997,2/1/2022,SYC,Kedah,0,0,0,Seychelles
43998,2/1/2022,SYC,Pulau Pinang,0,0,0,Seychelles
43999,2/1/2022,SYC,Sabah,0,0,0,Seychelles
44000,2/1/2022,SYC,Sarawak,0,0,0,Seychelles
44001,2/1/2022,SYC,Selangor,6,1,5,Seychelles
44002,2/1/2022,SYR,Johor,0,0,0,Syrian Arab Republic
44003,2/1/2022,SYR,Kedah,0,0,0,Syrian Arab Republic
44004,2/1/2022,SYR,Kelantan,0,0,0,Syrian Arab Republic
44005,2/1/2022,SYR,Pahang,0,0,0,Syrian Arab Republic
44006,2/1/2022,SYR,Perlis,0,0,0,Syrian Arab Republic
44007,2/1/2022,SYR,Pulau Pinang,0,0,0,Syrian Arab Republic
44008,2/1/2022,SYR,Sabah,0,0,0,Syrian Arab Republic
44009,2/1/2022,SYR,Sarawak,1,1,0,Syrian Arab Republic
44010,2/1/2022,SYR,Selangor,146,105,41,Syrian Arab Republic
44011,2/1/2022,SYR,W.P. Labuan,0,0,0,Syrian Arab Republic
44012,2/1/2022,TCA,Perlis,0,0,0,Turks and Caicos
44013,2/1/2022,TCD,Johor,0,0,0,Chad
44014,2/1/2022,TCD,Kedah,0,0,0,Chad
44015,2/1/2022,TCD,Perlis,0,0,0,Chad
44016,2/1/2022,TCD,Selangor,4,3,1,Chad
44017,2/1/2022,TGO,Johor,0,0,0,Togo
44018,2/1/2022,TGO,Perak,0,0,0,Togo
44019,2/1/2022,TGO,Pulau Pinang,0,0,0,Togo
44020,2/1/2022,TGO,Selangor,1,1,0,Togo
44021,2/1/2022,THA,Johor,55,55,0,Thailand
44022,2/1/2022,THA,Kedah,16556,16500,56,Thailand
44023,2/1/2022,THA,Kelantan,5,0,5,Thailand
44024,2/1/2022,THA,Melaka,0,0,0,Thailand
44025,2/1/2022,THA,Negeri Sembilan,0,0,0,Thailand
44026,2/1/2022,THA,Pahang,0,0,0,Thailand
44027,2/1/2022,THA,Perak,0,0,0,Thailand
44028,2/1/2022,THA,Perlis,8532,8415,117,Thailand
44029,2/1/2022,THA,Pulau Pinang,187,182,5,Thailand
44030,2/1/2022,THA,Sabah,1,0,1,Thailand
44031,2/1/2022,THA,Sarawak,9,9,0,Thailand
44032,2/1/2022,THA,Selangor,931,520,411,Thailand
44033,2/1/2022,THA,Terengganu,0,0,0,Thailand
44034,2/1/2022,THA,W.P. Labuan,0,0,0,Thailand
44035,2/1/2022,TJK,Johor,0,0,0,Tajikistan
44036,2/1/2022,TJK,Kedah,0,0,0,Tajikistan
44037,2/1/2022,TJK,Perlis,0,0,0,Tajikistan
44038,2/1/2022,TJK,Pulau Pinang,0,0,0,Tajikistan
44039,2/1/2022,TJK,Sabah,0,0,0,Tajikistan
44040,2/1/2022,TJK,Selangor,4,2,2,Tajikistan
44041,2/1/2022,TKL,Selangor,0,0,0,Tokelau
44042,2/1/2022,TKM,Johor,0,0,0,Turkmenistan
44043,2/1/2022,TKM,Kedah,0,0,0,Turkmenistan
44044,2/1/2022,TKM,Kelantan,0,0,0,Turkmenistan
44045,2/1/2022,TKM,Perlis,0,0,0,Turkmenistan
44046,2/1/2022,TKM,Pulau Pinang,0,0,0,Turkmenistan
44047,2/1/2022,TKM,Sabah,0,0,0,Turkmenistan
44048,2/1/2022,TKM,Sarawak,0,0,0,Turkmenistan
44049,2/1/2022,TKM,Selangor,6,2,4,Turkmenistan
44050,2/1/2022,TLS,Johor,0,0,0,Timor-Leste
44051,2/1/2022,TLS,Kedah,0,0,0,Timor-Leste
44052,2/1/2022,TLS,Perlis,0,0,0,Timor-Leste
44053,2/1/2022,TLS,Pulau Pinang,0,0,0,Timor-Leste
44054,2/1/2022,TLS,Sabah,0,0,0,Timor-Leste
44055,2/1/2022,TLS,Sarawak,0,0,0,Timor-Leste
44056,2/1/2022,TLS,Selangor,8,6,2,Timor-Leste
44057,2/1/2022,TON,Johor,0,0,0,Tonga
44058,2/1/2022,TON,Pulau Pinang,0,0,0,Tonga
44059,2/1/2022,TON,Sarawak,0,0,0,Tonga
44060,2/1/2022,TON,Selangor,0,0,0,Tonga
44061,2/1/2022,TTO,Johor,0,0,0,Trinidad and Tobago
44062,2/1/2022,TTO,Kedah,0,0,0,Trinidad and Tobago
44063,2/1/2022,TTO,Pahang,0,0,0,Trinidad and Tobago
44064,2/1/2022,TTO,Pulau Pinang,0,0,0,Trinidad and Tobago
44065,2/1/2022,TTO,Sabah,0,0,0,Trinidad and Tobago
44066,2/1/2022,TTO,Sarawak,0,0,0,Trinidad and Tobago
44067,2/1/2022,TTO,Selangor,1,1,0,Trinidad and Tobago
44068,2/1/2022,TUN,Johor,0,0,0,Tunisia
44069,2/1/2022,TUN,Kedah,0,0,0,Tunisia
44070,2/1/2022,TUN,Kelantan,0,0,0,Tunisia
44071,2/1/2022,TUN,Melaka,0,0,0,Tunisia
44072,2/1/2022,TUN,Perak,0,0,0,Tunisia
44073,2/1/2022,TUN,Perlis,0,0,0,Tunisia
44074,2/1/2022,TUN,Pulau Pinang,0,0,0,Tunisia
44075,2/1/2022,TUN,Sabah,0,0,0,Tunisia
44076,2/1/2022,TUN,Sarawak,0,0,0,Tunisia
44077,2/1/2022,TUN,Selangor,19,13,6,Tunisia
44078,2/1/2022,TUN,W.P. Labuan,0,0,0,Tunisia
44079,2/1/2022,TUR,Johor,12,12,0,Turkey
44080,2/1/2022,TUR,Kedah,0,0,0,Turkey
44081,2/1/2022,TUR,Kelantan,0,0,0,Turkey
44082,2/1/2022,TUR,Melaka,0,0,0,Turkey
44083,2/1/2022,TUR,Negeri Sembilan,0,0,0,Turkey
44084,2/1/2022,TUR,Pahang,0,0,0,Turkey
44085,2/1/2022,TUR,Perak,0,0,0,Turkey
44086,2/1/2022,TUR,Perlis,0,0,0,Turkey
44087,2/1/2022,TUR,Pulau Pinang,0,0,0,Turkey
44088,2/1/2022,TUR,Sabah,1,1,0,Turkey
44089,2/1/2022,TUR,Sarawak,0,0,0,Turkey
44090,2/1/2022,TUR,Selangor,74,62,12,Turkey
44091,2/1/2022,TUR,W.P. Labuan,0,0,0,Turkey
44092,2/1/2022,TUV,Selangor,0,0,0,Tuvalu
44093,2/1/2022,TWN,Johor,4,1,3,Taiwan
44094,2/1/2022,TWN,Kedah,4,3,1,Taiwan
44095,2/1/2022,TWN,Kelantan,0,0,0,Taiwan
44096,2/1/2022,TWN,Melaka,0,0,0,Taiwan
44097,2/1/2022,TWN,Negeri Sembilan,0,0,0,Taiwan
44098,2/1/2022,TWN,Pahang,0,0,0,Taiwan
44099,2/1/2022,TWN,Perak,0,0,0,Taiwan
44100,2/1/2022,TWN,Perlis,0,0,0,Taiwan
44101,2/1/2022,TWN,Pulau Pinang,50,41,9,Taiwan
44102,2/1/2022,TWN,Sabah,0,0,0,Taiwan
44103,2/1/2022,TWN,Sarawak,4,4,0,Taiwan
44104,2/1/2022,TWN,Selangor,279,169,110,Taiwan
44105,2/1/2022,TWN,W.P. Labuan,0,0,0,Taiwan
44106,2/1/2022,TZA,Johor,0,0,0,"Tanzania, United Republic of"
44107,2/1/2022,TZA,Kedah,0,0,0,"Tanzania, United Republic of"
44108,2/1/2022,TZA,Perak,0,0,0,"Tanzania, United Republic of"
44109,2/1/2022,TZA,Perlis,0,0,0,"Tanzania, United Republic of"
44110,2/1/2022,TZA,Pulau Pinang,0,0,0,"Tanzania, United Republic of"
44111,2/1/2022,TZA,Sabah,0,0,0,"Tanzania, United Republic of"
44112,2/1/2022,TZA,Sarawak,0,0,0,"Tanzania, United Republic of"
44113,2/1/2022,TZA,Selangor,22,13,9,"Tanzania, United Republic of"
44114,2/1/2022,UGA,Johor,0,0,0,Uganda
44115,2/1/2022,UGA,Kedah,0,0,0,Uganda
44116,2/1/2022,UGA,Perak,0,0,0,Uganda
44117,2/1/2022,UGA,Perlis,0,0,0,Uganda
44118,2/1/2022,UGA,Pulau Pinang,0,0,0,Uganda
44119,2/1/2022,UGA,Sabah,0,0,0,Uganda
44120,2/1/2022,UGA,Sarawak,0,0,0,Uganda
44121,2/1/2022,UGA,Selangor,12,7,5,Uganda
44122,2/1/2022,UKR,Johor,8,8,0,Ukraine
44123,2/1/2022,UKR,Kedah,0,0,0,Ukraine
44124,2/1/2022,UKR,Kelantan,0,0,0,Ukraine
44125,2/1/2022,UKR,Melaka,0,0,0,Ukraine
44126,2/1/2022,UKR,Negeri Sembilan,0,0,0,Ukraine
44127,2/1/2022,UKR,Pahang,0,0,0,Ukraine
44128,2/1/2022,UKR,Perak,0,0,0,Ukraine
44129,2/1/2022,UKR,Perlis,0,0,0,Ukraine
44130,2/1/2022,UKR,Pulau Pinang,0,0,0,Ukraine
44131,2/1/2022,UKR,Sabah,0,0,0,Ukraine
44132,2/1/2022,UKR,Sarawak,0,0,0,Ukraine
44133,2/1/2022,UKR,Selangor,69,61,8,Ukraine
44134,2/1/2022,UKR,W.P. Labuan,0,0,0,Ukraine
44135,2/1/2022,URY,Johor,0,0,0,Uruguay
44136,2/1/2022,URY,Kedah,0,0,0,Uruguay
44137,2/1/2022,URY,Kelantan,0,0,0,Uruguay
44138,2/1/2022,URY,Perak,0,0,0,Uruguay
44139,2/1/2022,URY,Perlis,0,0,0,Uruguay
44140,2/1/2022,URY,Pulau Pinang,0,0,0,Uruguay
44141,2/1/2022,URY,Sabah,0,0,0,Uruguay
44142,2/1/2022,URY,Sarawak,0,0,0,Uruguay
44143,2/1/2022,URY,Selangor,1,0,1,Uruguay
44144,2/1/2022,URY,W.P. Labuan,0,0,0,Uruguay
44145,2/1/2022,USA,Johor,1,1,0,United States Of America
44146,2/1/2022,USA,Kedah,26,16,10,United States Of America
44147,2/1/2022,USA,Kelantan,0,0,0,United States Of America
44148,2/1/2022,USA,Melaka,0,0,0,United States Of America
44149,2/1/2022,USA,Negeri Sembilan,0,0,0,United States Of America
44150,2/1/2022,USA,Pahang,0,0,0,United States Of America
44151,2/1/2022,USA,Perak,2,1,1,United States Of America
44152,2/1/2022,USA,Perlis,0,0,0,United States Of America
44153,2/1/2022,USA,Pulau Pinang,16,12,4,United States Of America
44154,2/1/2022,USA,Sabah,0,0,0,United States Of America
44155,2/1/2022,USA,Sarawak,5,4,1,United States Of America
44156,2/1/2022,USA,Selangor,642,424,218,United States Of America
44157,2/1/2022,USA,Terengganu,0,0,0,United States Of America
44158,2/1/2022,USA,W.P. Labuan,0,0,0,United States Of America
44159,2/1/2022,UZB,Johor,0,0,0,Uzbekistan
44160,2/1/2022,UZB,Kedah,0,0,0,Uzbekistan
44161,2/1/2022,UZB,Kelantan,0,0,0,Uzbekistan
44162,2/1/2022,UZB,Perak,0,0,0,Uzbekistan
44163,2/1/2022,UZB,Perlis,0,0,0,Uzbekistan
44164,2/1/2022,UZB,Pulau Pinang,0,0,0,Uzbekistan
44165,2/1/2022,UZB,Sabah,0,0,0,Uzbekistan
44166,2/1/2022,UZB,Sarawak,0,0,0,Uzbekistan
44167,2/1/2022,UZB,Selangor,39,26,13,Uzbekistan
44168,2/1/2022,VAT,Johor,0,0,0,Holy See (Vatican City State)
44169,2/1/2022,VAT,Sarawak,0,0,0,Holy See (Vatican City State)
44170,2/1/2022,VAT,Selangor,1,1,0,Holy See (Vatican City State)
44171,2/1/2022,VCT,Johor,0,0,0,Saint Vincent and the Grenadines
44172,2/1/2022,VCT,Kedah,0,0,0,Saint Vincent and the Grenadines
44173,2/1/2022,VCT,Pulau Pinang,0,0,0,Saint Vincent and the Grenadines
44174,2/1/2022,VCT,Sarawak,0,0,0,Saint Vincent and the Grenadines
44175,2/1/2022,VCT,Selangor,0,0,0,Saint Vincent and the Grenadines
44176,2/1/2022,VEN,Johor,0,0,0,Venezuela
44177,2/1/2022,VEN,Kedah,0,0,0,Venezuela
44178,2/1/2022,VEN,Kelantan,0,0,0,Venezuela
44179,2/1/2022,VEN,Melaka,0,0,0,Venezuela
44180,2/1/2022,VEN,Perak,0,0,0,Venezuela
44181,2/1/2022,VEN,Perlis,0,0,0,Venezuela
44182,2/1/2022,VEN,Pulau Pinang,0,0,0,Venezuela
44183,2/1/2022,VEN,Sabah,0,0,0,Venezuela
44184,2/1/2022,VEN,Sarawak,0,0,0,Venezuela
44185,2/1/2022,VEN,Selangor,6,4,2,Venezuela
44186,2/1/2022,VEN,W.P. Labuan,0,0,0,Venezuela
44187,2/1/2022,VNM,Johor,3,0,3,Vietnam
44188,2/1/2022,VNM,Kedah,29,12,17,Vietnam
44189,2/1/2022,VNM,Kelantan,0,0,0,Vietnam
44190,2/1/2022,VNM,Melaka,0,0,0,Vietnam
44191,2/1/2022,VNM,Negeri Sembilan,0,0,0,Vietnam
44192,2/1/2022,VNM,Pahang,0,0,0,Vietnam
44193,2/1/2022,VNM,Perak,0,0,0,Vietnam
44194,2/1/2022,VNM,Perlis,0,0,0,Vietnam
44195,2/1/2022,VNM,Pulau Pinang,2,2,0,Vietnam
44196,2/1/2022,VNM,Sabah,0,0,0,Vietnam
44197,2/1/2022,VNM,Sarawak,2,0,2,Vietnam
44198,2/1/2022,VNM,Selangor,495,136,359,Vietnam
44199,2/1/2022,VNM,Terengganu,0,0,0,Vietnam
44200,2/1/2022,VNM,W.P. Labuan,0,0,0,Vietnam
44201,2/1/2022,VUT,Johor,0,0,0,Vanuatu
44202,2/1/2022,VUT,Kedah,0,0,0,Vanuatu
44203,2/1/2022,VUT,Pulau Pinang,0,0,0,Vanuatu
44204,2/1/2022,VUT,Sabah,0,0,0,Vanuatu
44205,2/1/2022,VUT,Sarawak,0,0,0,Vanuatu
44206,2/1/2022,VUT,Selangor,4,4,0,Vanuatu
44207,2/1/2022,WSM,Johor,0,0,0,Samoa
44208,2/1/2022,WSM,Sarawak,0,0,0,Samoa
44209,2/1/2022,WSM,Selangor,0,0,0,Samoa
44210,2/1/2022,YEM,Johor,0,0,0,Yemen
44211,2/1/2022,YEM,Kedah,1,1,0,Yemen
44212,2/1/2022,YEM,Kelantan,0,0,0,Yemen
44213,2/1/2022,YEM,Melaka,0,0,0,Yemen
44214,2/1/2022,YEM,Pahang,0,0,0,Yemen
44215,2/1/2022,YEM,Perak,0,0,0,Yemen
44216,2/1/2022,YEM,Perlis,0,0,0,Yemen
44217,2/1/2022,YEM,Pulau Pinang,0,0,0,Yemen
44218,2/1/2022,YEM,Sabah,0,0,0,Yemen
44219,2/1/2022,YEM,Sarawak,1,1,0,Yemen
44220,2/1/2022,YEM,Selangor,374,258,116,Yemen
44221,2/1/2022,YEM,W.P. Labuan,0,0,0,Yemen
44222,2/1/2022,ZAF,Johor,0,0,0,South Africa
44223,2/1/2022,ZAF,Kedah,2,1,1,South Africa
44224,2/1/2022,ZAF,Kelantan,0,0,0,South Africa
44225,2/1/2022,ZAF,Melaka,0,0,0,South Africa
44226,2/1/2022,ZAF,Pahang,0,0,0,South Africa
44227,2/1/2022,ZAF,Perak,0,0,0,South Africa
44228,2/1/2022,ZAF,Perlis,0,0,0,South Africa
44229,2/1/2022,ZAF,Pulau Pinang,0,0,0,South Africa
44230,2/1/2022,ZAF,Sabah,0,0,0,South Africa
44231,2/1/2022,ZAF,Sarawak,0,0,0,South Africa
44232,2/1/2022,ZAF,Selangor,69,41,28,South Africa
44233,2/1/2022,ZAF,Terengganu,0,0,0,South Africa
44234,2/1/2022,ZAF,W.P. Labuan,0,0,0,South Africa
44235,2/1/2022,ZMB,Johor,0,0,0,Zambia
44236,2/1/2022,ZMB,Kedah,0,0,0,Zambia
44237,2/1/2022,ZMB,Perak,0,0,0,Zambia
44238,2/1/2022,ZMB,Perlis,0,0,0,Zambia
44239,2/1/2022,ZMB,Pulau Pinang,0,0,0,Zambia
44240,2/1/2022,ZMB,Sabah,0,0,0,Zambia
44241,2/1/2022,ZMB,Sarawak,1,0,1,Zambia
44242,2/1/2022,ZMB,Selangor,23,11,12,Zambia
44243,2/1/2022,ZWE,Johor,0,0,0,Zimbabwe
44244,2/1/2022,ZWE,Kedah,0,0,0,Zimbabwe
44245,2/1/2022,ZWE,Kelantan,0,0,0,Zimbabwe
44246,2/1/2022,ZWE,Perak,0,0,0,Zimbabwe
44247,2/1/2022,ZWE,Perlis,0,0,0,Zimbabwe
44248,2/1/2022,ZWE,Pulau Pinang,0,0,0,Zimbabwe
44249,2/1/2022,ZWE,Sabah,0,0,0,Zimbabwe
44250,2/1/2022,ZWE,Sarawak,0,0,0,Zimbabwe
44251,2/1/2022,ZWE,Selangor,44,19,25,Zimbabwe
44252,3/1/2022,ABW,Kedah,0,0,0,Aruba
44253,3/1/2022,ABW,Pulau Pinang,0,0,0,Aruba
44254,3/1/2022,AFG,Johor,0,0,0,Afghanistan
44255,3/1/2022,AFG,Kedah,0,0,0,Afghanistan
44256,3/1/2022,AFG,Perlis,0,0,0,Afghanistan
44257,3/1/2022,AFG,Pulau Pinang,0,0,0,Afghanistan
44258,3/1/2022,AFG,Sarawak,0,0,0,Afghanistan
44259,3/1/2022,AFG,Selangor,94,64,30,Afghanistan
44260,3/1/2022,AGO,Johor,0,0,0,Angola
44261,3/1/2022,AGO,Kedah,0,0,0,Angola
44262,3/1/2022,AGO,Sabah,0,0,0,Angola
44263,3/1/2022,AGO,Selangor,0,0,0,Angola
44264,3/1/2022,AIA,Selangor,0,0,0,Anguilla
44265,3/1/2022,ALB,Johor,0,0,0,Albania
44266,3/1/2022,ALB,Kedah,0,0,0,Albania
44267,3/1/2022,ALB,Perak,0,0,0,Albania
44268,3/1/2022,ALB,Perlis,0,0,0,Albania
44269,3/1/2022,ALB,Pulau Pinang,0,0,0,Albania
44270,3/1/2022,ALB,Sabah,0,0,0,Albania
44271,3/1/2022,ALB,Sarawak,0,0,0,Albania
44272,3/1/2022,ALB,Selangor,3,2,1,Albania
44273,3/1/2022,AND,Johor,0,0,0,Andorra
44274,3/1/2022,AND,Kedah,0,0,0,Andorra
44275,3/1/2022,AND,Perlis,0,0,0,Andorra
44276,3/1/2022,AND,Pulau Pinang,0,0,0,Andorra
44277,3/1/2022,AND,Selangor,0,0,0,Andorra
44278,3/1/2022,ANT,Selangor,0,0,0,Netherlands Antilles
44279,3/1/2022,ARE,Johor,0,0,0,United Arab Emirates
44280,3/1/2022,ARE,Kedah,0,0,0,United Arab Emirates
44281,3/1/2022,ARE,Kelantan,0,0,0,United Arab Emirates
44282,3/1/2022,ARE,Perak,0,0,0,United Arab Emirates
44283,3/1/2022,ARE,Perlis,0,0,0,United Arab Emirates
44284,3/1/2022,ARE,Pulau Pinang,0,0,0,United Arab Emirates
44285,3/1/2022,ARE,Sabah,0,0,0,United Arab Emirates
44286,3/1/2022,ARE,Sarawak,0,0,0,United Arab Emirates
44287,3/1/2022,ARE,Selangor,34,19,15,United Arab Emirates
44288,3/1/2022,ARG,Johor,0,0,0,Argentina
44289,3/1/2022,ARG,Kedah,0,0,0,Argentina
44290,3/1/2022,ARG,Kelantan,0,0,0,Argentina
44291,3/1/2022,ARG,Melaka,0,0,0,Argentina
44292,3/1/2022,ARG,Perak,0,0,0,Argentina
44293,3/1/2022,ARG,Perlis,0,0,0,Argentina
44294,3/1/2022,ARG,Pulau Pinang,0,0,0,Argentina
44295,3/1/2022,ARG,Sabah,0,0,0,Argentina
44296,3/1/2022,ARG,Sarawak,0,0,0,Argentina
44297,3/1/2022,ARG,Selangor,25,15,10,Argentina
44298,3/1/2022,ARG,W.P. Labuan,0,0,0,Argentina
44299,3/1/2022,ARM,Johor,0,0,0,Armenia
44300,3/1/2022,ARM,Kedah,0,0,0,Armenia
44301,3/1/2022,ARM,Kelantan,0,0,0,Armenia
44302,3/1/2022,ARM,Perak,0,0,0,Armenia
44303,3/1/2022,ARM,Perlis,0,0,0,Armenia
44304,3/1/2022,ARM,Pulau Pinang,0,0,0,Armenia
44305,3/1/2022,ARM,Sabah,0,0,0,Armenia
44306,3/1/2022,ARM,Sarawak,0,0,0,Armenia
44307,3/1/2022,ARM,Selangor,2,0,2,Armenia
44308,3/1/2022,ATA,Selangor,0,0,0,Antarctica
44309,3/1/2022,ATG,Johor,0,0,0,Antigua and Barbuda
44310,3/1/2022,ATG,Kedah,0,0,0,Antigua and Barbuda
44311,3/1/2022,ATG,Pulau Pinang,0,0,0,Antigua and Barbuda
44312,3/1/2022,ATG,Sarawak,0,0,0,Antigua and Barbuda
44313,3/1/2022,ATG,Selangor,6,4,2,Antigua and Barbuda
44314,3/1/2022,AUS,Johor,5,5,0,Australia
44315,3/1/2022,AUS,Kedah,59,32,27,Australia
44316,3/1/2022,AUS,Kelantan,0,0,0,Australia
44317,3/1/2022,AUS,Melaka,0,0,0,Australia
44318,3/1/2022,AUS,Negeri Sembilan,0,0,0,Australia
44319,3/1/2022,AUS,Pahang,0,0,0,Australia
44320,3/1/2022,AUS,Perak,2,1,1,Australia
44321,3/1/2022,AUS,Perlis,0,0,0,Australia
44322,3/1/2022,AUS,Pulau Pinang,26,21,5,Australia
44323,3/1/2022,AUS,Sabah,1,0,1,Australia
44324,3/1/2022,AUS,Sarawak,3,2,1,Australia
44325,3/1/2022,AUS,Selangor,738,492,246,Australia
44326,3/1/2022,AUS,Terengganu,0,0,0,Australia
44327,3/1/2022,AUS,W.P. Labuan,0,0,0,Australia
44328,3/1/2022,AUT,Johor,0,0,0,Austria
44329,3/1/2022,AUT,Kedah,2,2,0,Austria
44330,3/1/2022,AUT,Kelantan,0,0,0,Austria
44331,3/1/2022,AUT,Melaka,0,0,0,Austria
44332,3/1/2022,AUT,Negeri Sembilan,0,0,0,Austria
44333,3/1/2022,AUT,Pahang,0,0,0,Austria
44334,3/1/2022,AUT,Perak,0,0,0,Austria
44335,3/1/2022,AUT,Perlis,0,0,0,Austria
44336,3/1/2022,AUT,Pulau Pinang,2,1,1,Austria
44337,3/1/2022,AUT,Sabah,0,0,0,Austria
44338,3/1/2022,AUT,Sarawak,0,0,0,Austria
44339,3/1/2022,AUT,Selangor,80,73,7,Austria
44340,3/1/2022,AUT,Terengganu,0,0,0,Austria
44341,3/1/2022,AUT,W.P. Labuan,0,0,0,Austria
44342,3/1/2022,AZE,Johor,0,0,0,Azerbaijan
44343,3/1/2022,AZE,Kedah,0,0,0,Azerbaijan
44344,3/1/2022,AZE,Kelantan,0,0,0,Azerbaijan
44345,3/1/2022,AZE,Melaka,0,0,0,Azerbaijan
44346,3/1/2022,AZE,Perlis,0,0,0,Azerbaijan
44347,3/1/2022,AZE,Pulau Pinang,0,0,0,Azerbaijan
44348,3/1/2022,AZE,Sabah,0,0,0,Azerbaijan
44349,3/1/2022,AZE,Sarawak,0,0,0,Azerbaijan
44350,3/1/2022,AZE,Selangor,12,10,2,Azerbaijan
44351,3/1/2022,AZE,W.P. Labuan,0,0,0,Azerbaijan
44352,3/1/2022,BDI,Pulau Pinang,0,0,0,Burundi
44353,3/1/2022,BDI,Sarawak,0,0,0,Burundi
44354,3/1/2022,BDI,Selangor,0,0,0,Burundi
44355,3/1/2022,BEL,Johor,1,1,0,Belgium
44356,3/1/2022,BEL,Kedah,0,0,0,Belgium
44357,3/1/2022,BEL,Kelantan,0,0,0,Belgium
44358,3/1/2022,BEL,Melaka,0,0,0,Belgium
44359,3/1/2022,BEL,Negeri Sembilan,0,0,0,Belgium
44360,3/1/2022,BEL,Pahang,0,0,0,Belgium
44361,3/1/2022,BEL,Perak,0,0,0,Belgium
44362,3/1/2022,BEL,Perlis,0,0,0,Belgium
44363,3/1/2022,BEL,Pulau Pinang,1,1,0,Belgium
44364,3/1/2022,BEL,Sabah,0,0,0,Belgium
44365,3/1/2022,BEL,Sarawak,0,0,0,Belgium
44366,3/1/2022,BEL,Selangor,83,58,25,Belgium
44367,3/1/2022,BEL,W.P. Labuan,0,0,0,Belgium
44368,3/1/2022,BEN,Johor,0,0,0,Benin
44369,3/1/2022,BEN,Kedah,0,0,0,Benin
44370,3/1/2022,BEN,Perak,0,0,0,Benin
44371,3/1/2022,BEN,Pulau Pinang,0,0,0,Benin
44372,3/1/2022,BEN,Sabah,0,0,0,Benin
44373,3/1/2022,BEN,Sarawak,0,0,0,Benin
44374,3/1/2022,BEN,Selangor,1,0,1,Benin
44375,3/1/2022,BFA,Perak,0,0,0,Burkina Faso
44376,3/1/2022,BFA,Pulau Pinang,0,0,0,Burkina Faso
44377,3/1/2022,BFA,Selangor,1,1,0,Burkina Faso
44378,3/1/2022,BGD,Johor,22,19,3,Bangladesh
44379,3/1/2022,BGD,Kedah,0,0,0,Bangladesh
44380,3/1/2022,BGD,Kelantan,0,0,0,Bangladesh
44381,3/1/2022,BGD,Melaka,0,0,0,Bangladesh
44382,3/1/2022,BGD,Negeri Sembilan,0,0,0,Bangladesh
44383,3/1/2022,BGD,Pahang,0,0,0,Bangladesh
44384,3/1/2022,BGD,Perak,0,0,0,Bangladesh
44385,3/1/2022,BGD,Perlis,0,0,0,Bangladesh
44386,3/1/2022,BGD,Pulau Pinang,5,5,0,Bangladesh
44387,3/1/2022,BGD,Sabah,0,0,0,Bangladesh
44388,3/1/2022,BGD,Sarawak,0,0,0,Bangladesh
44389,3/1/2022,BGD,Selangor,8928,8566,362,Bangladesh
44390,3/1/2022,BGD,W.P. Labuan,0,0,0,Bangladesh
44391,3/1/2022,BGR,Johor,0,0,0,Bulgaria
44392,3/1/2022,BGR,Kedah,0,0,0,Bulgaria
44393,3/1/2022,BGR,Kelantan,0,0,0,Bulgaria
44394,3/1/2022,BGR,Pahang,0,0,0,Bulgaria
44395,3/1/2022,BGR,Perak,0,0,0,Bulgaria
44396,3/1/2022,BGR,Perlis,0,0,0,Bulgaria
44397,3/1/2022,BGR,Pulau Pinang,0,0,0,Bulgaria
44398,3/1/2022,BGR,Sabah,0,0,0,Bulgaria
44399,3/1/2022,BGR,Sarawak,0,0,0,Bulgaria
44400,3/1/2022,BGR,Selangor,35,31,4,Bulgaria
44401,3/1/2022,BGR,W.P. Labuan,0,0,0,Bulgaria
44402,3/1/2022,BHR,Johor,0,0,0,Bahrain
44403,3/1/2022,BHR,Kedah,0,0,0,Bahrain
44404,3/1/2022,BHR,Kelantan,0,0,0,Bahrain
44405,3/1/2022,BHR,Perlis,0,0,0,Bahrain
44406,3/1/2022,BHR,Pulau Pinang,0,0,0,Bahrain
44407,3/1/2022,BHR,Sabah,0,0,0,Bahrain
44408,3/1/2022,BHR,Sarawak,0,0,0,Bahrain
44409,3/1/2022,BHR,Selangor,6,4,2,Bahrain
44410,3/1/2022,BHS,Johor,0,0,0,Bahamas
44411,3/1/2022,BHS,Kedah,0,0,0,Bahamas
44412,3/1/2022,BHS,Perak,0,0,0,Bahamas
44413,3/1/2022,BHS,Sabah,0,0,0,Bahamas
44414,3/1/2022,BHS,Sarawak,0,0,0,Bahamas
44415,3/1/2022,BHS,Selangor,1,1,0,Bahamas
44416,3/1/2022,BIH,Johor,0,0,0,Bosnia and Herzegovina
44417,3/1/2022,BIH,Kedah,0,0,0,Bosnia and Herzegovina
44418,3/1/2022,BIH,Perlis,0,0,0,Bosnia and Herzegovina
44419,3/1/2022,BIH,Pulau Pinang,0,0,0,Bosnia and Herzegovina
44420,3/1/2022,BIH,Sabah,0,0,0,Bosnia and Herzegovina
44421,3/1/2022,BIH,Sarawak,0,0,0,Bosnia and Herzegovina
44422,3/1/2022,BIH,Selangor,19,9,10,Bosnia and Herzegovina
44423,3/1/2022,BLR,Johor,1,1,0,Belarus
44424,3/1/2022,BLR,Kedah,0,0,0,Belarus
44425,3/1/2022,BLR,Kelantan,0,0,0,Belarus
44426,3/1/2022,BLR,Pahang,0,0,0,Belarus
44427,3/1/2022,BLR,Perak,0,0,0,Belarus
44428,3/1/2022,BLR,Perlis,0,0,0,Belarus
44429,3/1/2022,BLR,Pulau Pinang,1,0,1,Belarus
44430,3/1/2022,BLR,Sabah,0,0,0,Belarus
44431,3/1/2022,BLR,Sarawak,0,0,0,Belarus
44432,3/1/2022,BLR,Selangor,12,7,5,Belarus
44433,3/1/2022,BLR,W.P. Labuan,0,0,0,Belarus
44434,3/1/2022,BLZ,Johor,0,0,0,Belize
44435,3/1/2022,BLZ,Pulau Pinang,0,0,0,Belize
44436,3/1/2022,BLZ,Sarawak,0,0,0,Belize
44437,3/1/2022,BLZ,Selangor,0,0,0,Belize
44438,3/1/2022,BMU,Selangor,0,0,0,Bermuda
44439,3/1/2022,BOL,Johor,0,0,0,Bolivia
44440,3/1/2022,BOL,Kedah,0,0,0,Bolivia
44441,3/1/2022,BOL,Melaka,0,0,0,Bolivia
44442,3/1/2022,BOL,Perak,0,0,0,Bolivia
44443,3/1/2022,BOL,Perlis,0,0,0,Bolivia
44444,3/1/2022,BOL,Pulau Pinang,0,0,0,Bolivia
44445,3/1/2022,BOL,Sabah,0,0,0,Bolivia
44446,3/1/2022,BOL,Sarawak,0,0,0,Bolivia
44447,3/1/2022,BOL,Selangor,1,1,0,Bolivia
44448,3/1/2022,BRA,Johor,0,0,0,Brazil
44449,3/1/2022,BRA,Kedah,0,0,0,Brazil
44450,3/1/2022,BRA,Kelantan,0,0,0,Brazil
44451,3/1/2022,BRA,Melaka,0,0,0,Brazil
44452,3/1/2022,BRA,Pahang,0,0,0,Brazil
44453,3/1/2022,BRA,Perak,0,0,0,Brazil
44454,3/1/2022,BRA,Perlis,0,0,0,Brazil
44455,3/1/2022,BRA,Pulau Pinang,1,1,0,Brazil
44456,3/1/2022,BRA,Sabah,0,0,0,Brazil
44457,3/1/2022,BRA,Sarawak,1,1,0,Brazil
44458,3/1/2022,BRA,Selangor,64,40,24,Brazil
44459,3/1/2022,BRA,W.P. Labuan,0,0,0,Brazil
44460,3/1/2022,BRB,Johor,0,0,0,Barbados
44461,3/1/2022,BRB,Kedah,0,0,0,Barbados
44462,3/1/2022,BRB,Perlis,0,0,0,Barbados
44463,3/1/2022,BRB,Pulau Pinang,0,0,0,Barbados
44464,3/1/2022,BRB,Selangor,2,1,1,Barbados
44465,3/1/2022,BRN,Johor,0,0,0,Brunei Darussalam
44466,3/1/2022,BRN,Kedah,0,0,0,Brunei Darussalam
44467,3/1/2022,BRN,Kelantan,0,0,0,Brunei Darussalam
44468,3/1/2022,BRN,Melaka,0,0,0,Brunei Darussalam
44469,3/1/2022,BRN,Pahang,0,0,0,Brunei Darussalam
44470,3/1/2022,BRN,Perak,0,0,0,Brunei Darussalam
44471,3/1/2022,BRN,Perlis,0,0,0,Brunei Darussalam
44472,3/1/2022,BRN,Pulau Pinang,0,0,0,Brunei Darussalam
44473,3/1/2022,BRN,Sabah,0,0,0,Brunei Darussalam
44474,3/1/2022,BRN,Sarawak,391,386,5,Brunei Darussalam
44475,3/1/2022,BRN,Selangor,129,76,53,Brunei Darussalam
44476,3/1/2022,BRN,W.P. Labuan,2,2,0,Brunei Darussalam
44477,3/1/2022,BTN,Johor,0,0,0,Bhutan
44478,3/1/2022,BTN,Kedah,0,0,0,Bhutan
44479,3/1/2022,BTN,Perak,0,0,0,Bhutan
44480,3/1/2022,BTN,Perlis,0,0,0,Bhutan
44481,3/1/2022,BTN,Pulau Pinang,0,0,0,Bhutan
44482,3/1/2022,BTN,Sabah,0,0,0,Bhutan
44483,3/1/2022,BTN,Sarawak,0,0,0,Bhutan
44484,3/1/2022,BTN,Selangor,4,3,1,Bhutan
44485,3/1/2022,BWA,Johor,0,0,0,Botswana
44486,3/1/2022,BWA,Kedah,0,0,0,Botswana
44487,3/1/2022,BWA,Perlis,0,0,0,Botswana
44488,3/1/2022,BWA,Pulau Pinang,0,0,0,Botswana
44489,3/1/2022,BWA,Sabah,0,0,0,Botswana
44490,3/1/2022,BWA,Sarawak,0,0,0,Botswana
44491,3/1/2022,BWA,Selangor,2,1,1,Botswana
44492,3/1/2022,CAF,Kedah,0,0,0,Central African Republic
44493,3/1/2022,CAF,Selangor,0,0,0,Central African Republic
44494,3/1/2022,CAN,Johor,0,0,0,Canada
44495,3/1/2022,CAN,Kedah,15,10,5,Canada
44496,3/1/2022,CAN,Kelantan,0,0,0,Canada
44497,3/1/2022,CAN,Melaka,0,0,0,Canada
44498,3/1/2022,CAN,Negeri Sembilan,0,0,0,Canada
44499,3/1/2022,CAN,Pahang,0,0,0,Canada
44500,3/1/2022,CAN,Perak,0,0,0,Canada
44501,3/1/2022,CAN,Perlis,0,0,0,Canada
44502,3/1/2022,CAN,Pulau Pinang,9,5,4,Canada
44503,3/1/2022,CAN,Sabah,1,1,0,Canada
44504,3/1/2022,CAN,Sarawak,1,1,0,Canada
44505,3/1/2022,CAN,Selangor,249,161,88,Canada
44506,3/1/2022,CAN,Terengganu,0,0,0,Canada
44507,3/1/2022,CAN,W.P. Labuan,0,0,0,Canada
44508,3/1/2022,CCK,Selangor,0,0,0,Cocos (Keeling) Islands
44509,3/1/2022,CHE,Johor,0,0,0,Switzerland
44510,3/1/2022,CHE,Kedah,3,3,0,Switzerland
44511,3/1/2022,CHE,Kelantan,0,0,0,Switzerland
44512,3/1/2022,CHE,Melaka,0,0,0,Switzerland
44513,3/1/2022,CHE,Negeri Sembilan,0,0,0,Switzerland
44514,3/1/2022,CHE,Pahang,0,0,0,Switzerland
44515,3/1/2022,CHE,Perak,0,0,0,Switzerland
44516,3/1/2022,CHE,Perlis,0,0,0,Switzerland
44517,3/1/2022,CHE,Pulau Pinang,5,3,2,Switzerland
44518,3/1/2022,CHE,Sabah,1,1,0,Switzerland
44519,3/1/2022,CHE,Sarawak,0,0,0,Switzerland
44520,3/1/2022,CHE,Selangor,80,63,17,Switzerland
44521,3/1/2022,CHE,W.P. Labuan,0,0,0,Switzerland
44522,3/1/2022,CHL,Johor,0,0,0,Chile
44523,3/1/2022,CHL,Kedah,0,0,0,Chile
44524,3/1/2022,CHL,Kelantan,0,0,0,Chile
44525,3/1/2022,CHL,Melaka,0,0,0,Chile
44526,3/1/2022,CHL,Pahang,0,0,0,Chile
44527,3/1/2022,CHL,Perak,0,0,0,Chile
44528,3/1/2022,CHL,Perlis,0,0,0,Chile
44529,3/1/2022,CHL,Pulau Pinang,0,0,0,Chile
44530,3/1/2022,CHL,Sabah,0,0,0,Chile
44531,3/1/2022,CHL,Sarawak,0,0,0,Chile
44532,3/1/2022,CHL,Selangor,9,6,3,Chile
44533,3/1/2022,CHN,Johor,254,240,14,China
44534,3/1/2022,CHN,Kedah,14,8,6,China
44535,3/1/2022,CHN,Kelantan,0,0,0,China
44536,3/1/2022,CHN,Melaka,0,0,0,China
44537,3/1/2022,CHN,Pahang,0,0,0,China
44538,3/1/2022,CHN,Perak,0,0,0,China
44539,3/1/2022,CHN,Perlis,0,0,0,China
44540,3/1/2022,CHN,Pulau Pinang,16,9,7,China
44541,3/1/2022,CHN,Sabah,2,2,0,China
44542,3/1/2022,CHN,Sarawak,38,38,0,China
44543,3/1/2022,CHN,Selangor,3088,2200,888,China
44544,3/1/2022,CHN,Terengganu,0,0,0,China
44545,3/1/2022,CHN,W.P. Labuan,0,0,0,China
44546,3/1/2022,CIV,Johor,0,0,0,C��te d'Iv
44547,3/1/2022,CIV,Kedah,0,0,0,C��te d'Iv
44548,3/1/2022,CIV,Pulau Pinang,0,0,0,C��te d'Iv
44549,3/1/2022,CIV,Sabah,0,0,0,C��te d'Iv
44550,3/1/2022,CIV,Sarawak,0,0,0,C��te d'Iv
44551,3/1/2022,CIV,Selangor,0,0,0,C��te d'Iv
44552,3/1/2022,CMR,Johor,0,0,0,Cameroon
44553,3/1/2022,CMR,Kedah,0,0,0,Cameroon
44554,3/1/2022,CMR,Pulau Pinang,0,0,0,Cameroon
44555,3/1/2022,CMR,Sabah,0,0,0,Cameroon
44556,3/1/2022,CMR,Sarawak,0,0,0,Cameroon
44557,3/1/2022,CMR,Selangor,6,6,0,Cameroon
44558,3/1/2022,COD,Johor,0,0,0,"Congo, the Democratic Republic of the"
44559,3/1/2022,COD,Pulau Pinang,0,0,0,"Congo, the Democratic Republic of the"
44560,3/1/2022,COD,Sarawak,0,0,0,"Congo, the Democratic Republic of the"
44561,3/1/2022,COD,Selangor,2,1,1,"Congo, the Democratic Republic of the"
44562,3/1/2022,COG,Johor,0,0,0,Congo
44563,3/1/2022,COG,Kedah,0,0,0,Congo
44564,3/1/2022,COG,Selangor,0,0,0,Congo
44565,3/1/2022,COK,Selangor,0,0,0,Cook Islands
44566,3/1/2022,COL,Johor,0,0,0,Colombia
44567,3/1/2022,COL,Kedah,0,0,0,Colombia
44568,3/1/2022,COL,Perak,0,0,0,Colombia
44569,3/1/2022,COL,Pulau Pinang,0,0,0,Colombia
44570,3/1/2022,COL,Sabah,0,0,0,Colombia
44571,3/1/2022,COL,Sarawak,0,0,0,Colombia
44572,3/1/2022,COL,Selangor,14,10,4,Colombia
44573,3/1/2022,COL,W.P. Labuan,0,0,0,Colombia
44574,3/1/2022,COM,Johor,0,0,0,Comoros
44575,3/1/2022,COM,Kedah,0,0,0,Comoros
44576,3/1/2022,COM,Selangor,9,8,1,Comoros
44577,3/1/2022,CPV,Johor,0,0,0,Cape Verde
44578,3/1/2022,CPV,Kedah,0,0,0,Cape Verde
44579,3/1/2022,CPV,Pulau Pinang,0,0,0,Cape Verde
44580,3/1/2022,CPV,Sabah,0,0,0,Cape Verde
44581,3/1/2022,CPV,Selangor,0,0,0,Cape Verde
44582,3/1/2022,CRI,Johor,0,0,0,Costa Rica
44583,3/1/2022,CRI,Kedah,0,0,0,Costa Rica
44584,3/1/2022,CRI,Perak,0,0,0,Costa Rica
44585,3/1/2022,CRI,Perlis,0,0,0,Costa Rica
44586,3/1/2022,CRI,Pulau Pinang,0,0,0,Costa Rica
44587,3/1/2022,CRI,Sabah,0,0,0,Costa Rica
44588,3/1/2022,CRI,Sarawak,0,0,0,Costa Rica
44589,3/1/2022,CRI,Selangor,4,4,0,Costa Rica
44590,3/1/2022,CUB,Johor,0,0,0,Cuba
44591,3/1/2022,CUB,Kedah,0,0,0,Cuba
44592,3/1/2022,CUB,Perlis,0,0,0,Cuba
44593,3/1/2022,CUB,Pulau Pinang,0,0,0,Cuba
44594,3/1/2022,CUB,Sabah,0,0,0,Cuba
44595,3/1/2022,CUB,Sarawak,0,0,0,Cuba
44596,3/1/2022,CUB,Selangor,0,0,0,Cuba
44597,3/1/2022,CYP,Johor,0,0,0,Cyprus
44598,3/1/2022,CYP,Kedah,0,0,0,Cyprus
44599,3/1/2022,CYP,Perak,0,0,0,Cyprus
44600,3/1/2022,CYP,Perlis,0,0,0,Cyprus
44601,3/1/2022,CYP,Pulau Pinang,0,0,0,Cyprus
44602,3/1/2022,CYP,Sabah,0,0,0,Cyprus
44603,3/1/2022,CYP,Sarawak,0,0,0,Cyprus
44604,3/1/2022,CYP,Selangor,3,2,1,Cyprus
44605,3/1/2022,CZE,Johor,0,0,0,Czech Republic
44606,3/1/2022,CZE,Kedah,0,0,0,Czech Republic
44607,3/1/2022,CZE,Kelantan,1,0,1,Czech Republic
44608,3/1/2022,CZE,Melaka,0,0,0,Czech Republic
44609,3/1/2022,CZE,Negeri Sembilan,0,0,0,Czech Republic
44610,3/1/2022,CZE,Perak,0,0,0,Czech Republic
44611,3/1/2022,CZE,Perlis,0,0,0,Czech Republic
44612,3/1/2022,CZE,Pulau Pinang,0,0,0,Czech Republic
44613,3/1/2022,CZE,Sabah,0,0,0,Czech Republic
44614,3/1/2022,CZE,Sarawak,0,0,0,Czech Republic
44615,3/1/2022,CZE,Selangor,38,30,8,Czech Republic
44616,3/1/2022,CZE,W.P. Labuan,0,0,0,Czech Republic
44617,3/1/2022,DEU,Johor,3,2,1,Germany
44618,3/1/2022,DEU,Kedah,14,11,3,Germany
44619,3/1/2022,DEU,Kelantan,0,0,0,Germany
44620,3/1/2022,DEU,Melaka,0,0,0,Germany
44621,3/1/2022,DEU,Negeri Sembilan,0,0,0,Germany
44622,3/1/2022,DEU,Pahang,0,0,0,Germany
44623,3/1/2022,DEU,Perak,0,0,0,Germany
44624,3/1/2022,DEU,Perlis,0,0,0,Germany
44625,3/1/2022,DEU,Pulau Pinang,19,14,5,Germany
44626,3/1/2022,DEU,Sabah,0,0,0,Germany
44627,3/1/2022,DEU,Sarawak,0,0,0,Germany
44628,3/1/2022,DEU,Selangor,476,374,102,Germany
44629,3/1/2022,DEU,Terengganu,0,0,0,Germany
44630,3/1/2022,DEU,W.P. Labuan,0,0,0,Germany
44631,3/1/2022,DJI,Johor,0,0,0,Djibouti
44632,3/1/2022,DJI,Selangor,10,6,4,Djibouti
44633,3/1/2022,DMA,Johor,0,0,0,Dominica
44634,3/1/2022,DMA,Kedah,0,0,0,Dominica
44635,3/1/2022,DMA,Pulau Pinang,0,0,0,Dominica
44636,3/1/2022,DMA,Sabah,0,0,0,Dominica
44637,3/1/2022,DMA,Sarawak,0,0,0,Dominica
44638,3/1/2022,DMA,Selangor,5,4,1,Dominica
44639,3/1/2022,DMA,W.P. Labuan,0,0,0,Dominica
44640,3/1/2022,DNK,Johor,3,3,0,Denmark
44641,3/1/2022,DNK,Kedah,4,3,1,Denmark
44642,3/1/2022,DNK,Kelantan,0,0,0,Denmark
44643,3/1/2022,DNK,Melaka,0,0,0,Denmark
44644,3/1/2022,DNK,Negeri Sembilan,0,0,0,Denmark
44645,3/1/2022,DNK,Pahang,0,0,0,Denmark
44646,3/1/2022,DNK,Perak,0,0,0,Denmark
44647,3/1/2022,DNK,Perlis,0,0,0,Denmark
44648,3/1/2022,DNK,Pulau Pinang,5,3,2,Denmark
44649,3/1/2022,DNK,Sabah,1,0,1,Denmark
44650,3/1/2022,DNK,Sarawak,0,0,0,Denmark
44651,3/1/2022,DNK,Selangor,93,71,22,Denmark
44652,3/1/2022,DNK,W.P. Labuan,0,0,0,Denmark
44653,3/1/2022,DOM,Johor,0,0,0,Dominican Republic
44654,3/1/2022,DOM,Kedah,0,0,0,Dominican Republic
44655,3/1/2022,DOM,Perak,0,0,0,Dominican Republic
44656,3/1/2022,DOM,Perlis,0,0,0,Dominican Republic
44657,3/1/2022,DOM,Pulau Pinang,0,0,0,Dominican Republic
44658,3/1/2022,DOM,Sabah,0,0,0,Dominican Republic
44659,3/1/2022,DOM,Sarawak,0,0,0,Dominican Republic
44660,3/1/2022,DOM,Selangor,0,0,0,Dominican Republic
44661,3/1/2022,DZA,Johor,0,0,0,Algeria
44662,3/1/2022,DZA,Kedah,0,0,0,Algeria
44663,3/1/2022,DZA,Kelantan,0,0,0,Algeria
44664,3/1/2022,DZA,Melaka,0,0,0,Algeria
44665,3/1/2022,DZA,Perak,0,0,0,Algeria
44666,3/1/2022,DZA,Perlis,0,0,0,Algeria
44667,3/1/2022,DZA,Pulau Pinang,0,0,0,Algeria
44668,3/1/2022,DZA,Sabah,0,0,0,Algeria
44669,3/1/2022,DZA,Sarawak,0,0,0,Algeria
44670,3/1/2022,DZA,Selangor,54,36,18,Algeria
44671,3/1/2022,DZA,W.P. Labuan,0,0,0,Algeria
44672,3/1/2022,ECU,Johor,0,0,0,Ecuador
44673,3/1/2022,ECU,Kedah,0,0,0,Ecuador
44674,3/1/2022,ECU,Perak,0,0,0,Ecuador
44675,3/1/2022,ECU,Perlis,0,0,0,Ecuador
44676,3/1/2022,ECU,Pulau Pinang,0,0,0,Ecuador
44677,3/1/2022,ECU,Sabah,0,0,0,Ecuador
44678,3/1/2022,ECU,Sarawak,0,0,0,Ecuador
44679,3/1/2022,ECU,Selangor,2,1,1,Ecuador
44680,3/1/2022,EGY,Johor,1,1,0,Egypt
44681,3/1/2022,EGY,Kedah,0,0,0,Egypt
44682,3/1/2022,EGY,Kelantan,0,0,0,Egypt
44683,3/1/2022,EGY,Melaka,0,0,0,Egypt
44684,3/1/2022,EGY,Pahang,0,0,0,Egypt
44685,3/1/2022,EGY,Perak,0,0,0,Egypt
44686,3/1/2022,EGY,Perlis,0,0,0,Egypt
44687,3/1/2022,EGY,Pulau Pinang,0,0,0,Egypt
44688,3/1/2022,EGY,Sabah,0,0,0,Egypt
44689,3/1/2022,EGY,Sarawak,0,0,0,Egypt
44690,3/1/2022,EGY,Selangor,233,176,57,Egypt
44691,3/1/2022,EGY,Terengganu,0,0,0,Egypt
44692,3/1/2022,EGY,W.P. Labuan,0,0,0,Egypt
44693,3/1/2022,ERI,Johor,0,0,0,Eritrea
44694,3/1/2022,ERI,Pulau Pinang,0,0,0,Eritrea
44695,3/1/2022,ERI,Sabah,0,0,0,Eritrea
44696,3/1/2022,ERI,Selangor,5,4,1,Eritrea
44697,3/1/2022,ESP,Johor,0,0,0,Spain
44698,3/1/2022,ESP,Kedah,3,1,2,Spain
44699,3/1/2022,ESP,Kelantan,0,0,0,Spain
44700,3/1/2022,ESP,Melaka,0,0,0,Spain
44701,3/1/2022,ESP,Negeri Sembilan,0,0,0,Spain
44702,3/1/2022,ESP,Pahang,0,0,0,Spain
44703,3/1/2022,ESP,Perak,0,0,0,Spain
44704,3/1/2022,ESP,Perlis,0,0,0,Spain
44705,3/1/2022,ESP,Pulau Pinang,1,0,1,Spain
44706,3/1/2022,ESP,Sabah,0,0,0,Spain
44707,3/1/2022,ESP,Sarawak,0,0,0,Spain
44708,3/1/2022,ESP,Selangor,117,87,30,Spain
44709,3/1/2022,ESP,W.P. Labuan,0,0,0,Spain
44710,3/1/2022,EST,Johor,0,0,0,Estonia
44711,3/1/2022,EST,Kedah,0,0,0,Estonia
44712,3/1/2022,EST,Kelantan,0,0,0,Estonia
44713,3/1/2022,EST,Pahang,0,0,0,Estonia
44714,3/1/2022,EST,Perak,0,0,0,Estonia
44715,3/1/2022,EST,Perlis,0,0,0,Estonia
44716,3/1/2022,EST,Pulau Pinang,0,0,0,Estonia
44717,3/1/2022,EST,Sabah,0,0,0,Estonia
44718,3/1/2022,EST,Sarawak,0,0,0,Estonia
44719,3/1/2022,EST,Selangor,9,8,1,Estonia
44720,3/1/2022,EST,W.P. Labuan,0,0,0,Estonia
44721,3/1/2022,ETH,Johor,1,1,0,Ethiopia
44722,3/1/2022,ETH,Kedah,0,0,0,Ethiopia
44723,3/1/2022,ETH,Pulau Pinang,0,0,0,Ethiopia
44724,3/1/2022,ETH,Sarawak,0,0,0,Ethiopia
44725,3/1/2022,ETH,Selangor,12,7,5,Ethiopia
44726,3/1/2022,FIN,Johor,0,0,0,Finland
44727,3/1/2022,FIN,Kedah,0,0,0,Finland
44728,3/1/2022,FIN,Kelantan,0,0,0,Finland
44729,3/1/2022,FIN,Melaka,0,0,0,Finland
44730,3/1/2022,FIN,Negeri Sembilan,0,0,0,Finland
44731,3/1/2022,FIN,Pahang,0,0,0,Finland
44732,3/1/2022,FIN,Perak,0,0,0,Finland
44733,3/1/2022,FIN,Perlis,0,0,0,Finland
44734,3/1/2022,FIN,Pulau Pinang,1,0,1,Finland
44735,3/1/2022,FIN,Sabah,0,0,0,Finland
44736,3/1/2022,FIN,Sarawak,0,0,0,Finland
44737,3/1/2022,FIN,Selangor,58,35,23,Finland
44738,3/1/2022,FIN,W.P. Labuan,0,0,0,Finland
44739,3/1/2022,FJI,Johor,0,0,0,Fiji
44740,3/1/2022,FJI,Kedah,1,0,1,Fiji
44741,3/1/2022,FJI,Kelantan,0,0,0,Fiji
44742,3/1/2022,FJI,Perak,0,0,0,Fiji
44743,3/1/2022,FJI,Perlis,0,0,0,Fiji
44744,3/1/2022,FJI,Pulau Pinang,0,0,0,Fiji
44745,3/1/2022,FJI,Sabah,0,0,0,Fiji
44746,3/1/2022,FJI,Sarawak,0,0,0,Fiji
44747,3/1/2022,FJI,Selangor,2,1,1,Fiji
44748,3/1/2022,FRA,Johor,5,5,0,France
44749,3/1/2022,FRA,Kedah,6,4,2,France
44750,3/1/2022,FRA,Kelantan,0,0,0,France
44751,3/1/2022,FRA,Melaka,0,0,0,France
44752,3/1/2022,FRA,Negeri Sembilan,0,0,0,France
44753,3/1/2022,FRA,Pahang,0,0,0,France
44754,3/1/2022,FRA,Perak,0,0,0,France
44755,3/1/2022,FRA,Perlis,0,0,0,France
44756,3/1/2022,FRA,Pulau Pinang,14,10,4,France
44757,3/1/2022,FRA,Sabah,0,0,0,France
44758,3/1/2022,FRA,Sarawak,0,0,0,France
44759,3/1/2022,FRA,Selangor,605,450,155,France
44760,3/1/2022,FRA,Terengganu,0,0,0,France
44761,3/1/2022,FRA,W.P. Labuan,0,0,0,France
44762,3/1/2022,FSM,Johor,0,0,0,"Micronesia, Federated States of"
44763,3/1/2022,FSM,Pulau Pinang,0,0,0,"Micronesia, Federated States of"
44764,3/1/2022,FSM,Selangor,0,0,0,"Micronesia, Federated States of"
44765,3/1/2022,GAB,Johor,0,0,0,Gabon
44766,3/1/2022,GAB,Pulau Pinang,0,0,0,Gabon
44767,3/1/2022,GAB,Sarawak,0,0,0,Gabon
44768,3/1/2022,GAB,Selangor,1,0,1,Gabon
44769,3/1/2022,GBR,Johor,7,6,1,United Kingdom
44770,3/1/2022,GBR,Kedah,38,20,18,United Kingdom
44771,3/1/2022,GBR,Kelantan,0,0,0,United Kingdom
44772,3/1/2022,GBR,Melaka,0,0,0,United Kingdom
44773,3/1/2022,GBR,Negeri Sembilan,0,0,0,United Kingdom
44774,3/1/2022,GBR,Pahang,0,0,0,United Kingdom
44775,3/1/2022,GBR,Perak,0,0,0,United Kingdom
44776,3/1/2022,GBR,Perlis,0,0,0,United Kingdom
44777,3/1/2022,GBR,Pulau Pinang,48,40,8,United Kingdom
44778,3/1/2022,GBR,Sabah,0,0,0,United Kingdom
44779,3/1/2022,GBR,Sarawak,4,3,1,United Kingdom
44780,3/1/2022,GBR,Selangor,1260,924,336,United Kingdom
44781,3/1/2022,GBR,Terengganu,0,0,0,United Kingdom
44782,3/1/2022,GBR,W.P. Labuan,0,0,0,United Kingdom
44783,3/1/2022,GEO,Johor,0,0,0,Georgia
44784,3/1/2022,GEO,Kedah,0,0,0,Georgia
44785,3/1/2022,GEO,Melaka,0,0,0,Georgia
44786,3/1/2022,GEO,Perak,0,0,0,Georgia
44787,3/1/2022,GEO,Perlis,0,0,0,Georgia
44788,3/1/2022,GEO,Pulau Pinang,0,0,0,Georgia
44789,3/1/2022,GEO,Sabah,0,0,0,Georgia
44790,3/1/2022,GEO,Sarawak,0,0,0,Georgia
44791,3/1/2022,GEO,Selangor,14,14,0,Georgia
44792,3/1/2022,GHA,Johor,0,0,0,Ghana
44793,3/1/2022,GHA,Kedah,0,0,0,Ghana
44794,3/1/2022,GHA,Kelantan,0,0,0,Ghana
44795,3/1/2022,GHA,Pulau Pinang,0,0,0,Ghana
44796,3/1/2022,GHA,Sabah,0,0,0,Ghana
44797,3/1/2022,GHA,Sarawak,0,0,0,Ghana
44798,3/1/2022,GHA,Selangor,5,4,1,Ghana
44799,3/1/2022,GIB,Johor,0,0,0,Gibraltar
44800,3/1/2022,GIB,Sarawak,0,0,0,Gibraltar
44801,3/1/2022,GIN,Johor,0,0,0,Guinea
44802,3/1/2022,GIN,Kedah,0,0,0,Guinea
44803,3/1/2022,GIN,Kelantan,0,0,0,Guinea
44804,3/1/2022,GIN,Perlis,0,0,0,Guinea
44805,3/1/2022,GIN,Pulau Pinang,0,0,0,Guinea
44806,3/1/2022,GIN,Sabah,0,0,0,Guinea
44807,3/1/2022,GIN,Sarawak,0,0,0,Guinea
44808,3/1/2022,GIN,Selangor,11,8,3,Guinea
44809,3/1/2022,GLP,Selangor,0,0,0,Guadeloupe
44810,3/1/2022,GMB,Johor,0,0,0,Gambia
44811,3/1/2022,GMB,Kedah,0,0,0,Gambia
44812,3/1/2022,GMB,Kelantan,0,0,0,Gambia
44813,3/1/2022,GMB,Pulau Pinang,0,0,0,Gambia
44814,3/1/2022,GMB,Sabah,0,0,0,Gambia
44815,3/1/2022,GMB,Sarawak,0,0,0,Gambia
44816,3/1/2022,GMB,Selangor,10,3,7,Gambia
44817,3/1/2022,GNB,Johor,0,0,0,Guinea-Bissau
44818,3/1/2022,GNB,Selangor,1,1,0,Guinea-Bissau
44819,3/1/2022,GNQ,Johor,0,0,0,Equatorial Guinea
44820,3/1/2022,GNQ,Selangor,0,0,0,Equatorial Guinea
44821,3/1/2022,GRC,Johor,2,2,0,Greece
44822,3/1/2022,GRC,Kedah,2,1,1,Greece
44823,3/1/2022,GRC,Kelantan,0,0,0,Greece
44824,3/1/2022,GRC,Melaka,0,0,0,Greece
44825,3/1/2022,GRC,Negeri Sembilan,0,0,0,Greece
44826,3/1/2022,GRC,Pahang,0,0,0,Greece
44827,3/1/2022,GRC,Perak,0,0,0,Greece
44828,3/1/2022,GRC,Perlis,0,0,0,Greece
44829,3/1/2022,GRC,Pulau Pinang,0,0,0,Greece
44830,3/1/2022,GRC,Sabah,0,0,0,Greece
44831,3/1/2022,GRC,Sarawak,0,0,0,Greece
44832,3/1/2022,GRC,Selangor,22,19,3,Greece
44833,3/1/2022,GRD,Johor,0,0,0,Grenada
44834,3/1/2022,GRD,Kedah,0,0,0,Grenada
44835,3/1/2022,GRD,Pulau Pinang,0,0,0,Grenada
44836,3/1/2022,GRD,Sabah,0,0,0,Grenada
44837,3/1/2022,GRD,Sarawak,0,0,0,Grenada
44838,3/1/2022,GRD,Selangor,4,3,1,Grenada
44839,3/1/2022,GRL,Johor,0,0,0,Greenland
44840,3/1/2022,GRL,Selangor,0,0,0,Greenland
44841,3/1/2022,GTM,Johor,0,0,0,Guatemala
44842,3/1/2022,GTM,Kedah,0,0,0,Guatemala
44843,3/1/2022,GTM,Pahang,0,0,0,Guatemala
44844,3/1/2022,GTM,Perak,0,0,0,Guatemala
44845,3/1/2022,GTM,Pulau Pinang,0,0,0,Guatemala
44846,3/1/2022,GTM,Sabah,0,0,0,Guatemala
44847,3/1/2022,GTM,Sarawak,0,0,0,Guatemala
44848,3/1/2022,GTM,Selangor,2,1,1,Guatemala
44849,3/1/2022,GTM,W.P. Labuan,0,0,0,Guatemala
44850,3/1/2022,GUY,Johor,0,0,0,Guyana
44851,3/1/2022,GUY,Kedah,0,0,0,Guyana
44852,3/1/2022,GUY,Pulau Pinang,0,0,0,Guyana
44853,3/1/2022,GUY,Sarawak,0,0,0,Guyana
44854,3/1/2022,GUY,Selangor,0,0,0,Guyana
44855,3/1/2022,HKG,Johor,0,0,0,Hong Kong
44856,3/1/2022,HKG,Kedah,18,8,10,Hong Kong
44857,3/1/2022,HKG,Kelantan,0,0,0,Hong Kong
44858,3/1/2022,HKG,Pahang,0,0,0,Hong Kong
44859,3/1/2022,HKG,Perak,0,0,0,Hong Kong
44860,3/1/2022,HKG,Perlis,0,0,0,Hong Kong
44861,3/1/2022,HKG,Pulau Pinang,4,0,4,Hong Kong
44862,3/1/2022,HKG,Sabah,0,0,0,Hong Kong
44863,3/1/2022,HKG,Sarawak,26,25,1,Hong Kong
44864,3/1/2022,HKG,Selangor,2,0,2,Hong Kong
44865,3/1/2022,HKG,Terengganu,0,0,0,Hong Kong
44866,3/1/2022,HMD,Johor,0,0,0,Heard Island and McDonald Islands
44867,3/1/2022,HND,Johor,0,0,0,Honduras
44868,3/1/2022,HND,Kedah,0,0,0,Honduras
44869,3/1/2022,HND,Perak,0,0,0,Honduras
44870,3/1/2022,HND,Pulau Pinang,0,0,0,Honduras
44871,3/1/2022,HND,Sabah,0,0,0,Honduras
44872,3/1/2022,HND,Sarawak,0,0,0,Honduras
44873,3/1/2022,HND,Selangor,0,0,0,Honduras
44874,3/1/2022,HRV,Johor,3,3,0,Croatia
44875,3/1/2022,HRV,Kedah,0,0,0,Croatia
44876,3/1/2022,HRV,Kelantan,0,0,0,Croatia
44877,3/1/2022,HRV,Melaka,0,0,0,Croatia
44878,3/1/2022,HRV,Pahang,0,0,0,Croatia
44879,3/1/2022,HRV,Perak,0,0,0,Croatia
44880,3/1/2022,HRV,Perlis,0,0,0,Croatia
44881,3/1/2022,HRV,Pulau Pinang,0,0,0,Croatia
44882,3/1/2022,HRV,Sabah,0,0,0,Croatia
44883,3/1/2022,HRV,Sarawak,0,0,0,Croatia
44884,3/1/2022,HRV,Selangor,33,29,4,Croatia
44885,3/1/2022,HTI,Johor,0,0,0,Haiti
44886,3/1/2022,HTI,Kedah,0,0,0,Haiti
44887,3/1/2022,HTI,Kelantan,0,0,0,Haiti
44888,3/1/2022,HTI,Perak,0,0,0,Haiti
44889,3/1/2022,HTI,Pulau Pinang,0,0,0,Haiti
44890,3/1/2022,HTI,Sabah,0,0,0,Haiti
44891,3/1/2022,HTI,Selangor,0,0,0,Haiti
44892,3/1/2022,HUN,Johor,0,0,0,Hungary
44893,3/1/2022,HUN,Kedah,0,0,0,Hungary
44894,3/1/2022,HUN,Kelantan,0,0,0,Hungary
44895,3/1/2022,HUN,Pahang,0,0,0,Hungary
44896,3/1/2022,HUN,Perak,0,0,0,Hungary
44897,3/1/2022,HUN,Perlis,0,0,0,Hungary
44898,3/1/2022,HUN,Pulau Pinang,0,0,0,Hungary
44899,3/1/2022,HUN,Sabah,0,0,0,Hungary
44900,3/1/2022,HUN,Sarawak,0,0,0,Hungary
44901,3/1/2022,HUN,Selangor,11,6,5,Hungary
44902,3/1/2022,HUN,W.P. Labuan,0,0,0,Hungary
44903,3/1/2022,IDN,Johor,628,444,184,Indonesia
44904,3/1/2022,IDN,Kedah,44,18,26,Indonesia
44905,3/1/2022,IDN,Kelantan,1,1,0,Indonesia
44906,3/1/2022,IDN,Melaka,13,0,13,Indonesia
44907,3/1/2022,IDN,Negeri Sembilan,0,0,0,Indonesia
44908,3/1/2022,IDN,Pahang,0,0,0,Indonesia
44909,3/1/2022,IDN,Perak,0,0,0,Indonesia
44910,3/1/2022,IDN,Perlis,0,0,0,Indonesia
44911,3/1/2022,IDN,Pulau Pinang,49,21,28,Indonesia
44912,3/1/2022,IDN,Sabah,6,1,5,Indonesia
44913,3/1/2022,IDN,Sarawak,331,307,24,Indonesia
44914,3/1/2022,IDN,Selangor,5438,2088,3350,Indonesia
44915,3/1/2022,IDN,Terengganu,0,0,0,Indonesia
44916,3/1/2022,IDN,W.P. Labuan,1,1,0,Indonesia
44917,3/1/2022,IND,Johor,99,98,1,India
44918,3/1/2022,IND,Kedah,3,3,0,India
44919,3/1/2022,IND,Kelantan,0,0,0,India
44920,3/1/2022,IND,Melaka,0,0,0,India
44921,3/1/2022,IND,Negeri Sembilan,0,0,0,India
44922,3/1/2022,IND,Pahang,0,0,0,India
44923,3/1/2022,IND,Perak,0,0,0,India
44924,3/1/2022,IND,Perlis,0,0,0,India
44925,3/1/2022,IND,Pulau Pinang,22,17,5,India
44926,3/1/2022,IND,Sabah,4,4,0,India
44927,3/1/2022,IND,Sarawak,6,5,1,India
44928,3/1/2022,IND,Selangor,4248,3182,1066,India
44929,3/1/2022,IND,Terengganu,0,0,0,India
44930,3/1/2022,IND,W.P. Labuan,0,0,0,India
44931,3/1/2022,IOT,Pulau Pinang,0,0,0,British Indian Ocean Territory
44932,3/1/2022,IOT,Selangor,0,0,0,British Indian Ocean Territory
44933,3/1/2022,IRL,Johor,0,0,0,Ireland
44934,3/1/2022,IRL,Kedah,2,2,0,Ireland
44935,3/1/2022,IRL,Kelantan,0,0,0,Ireland
44936,3/1/2022,IRL,Negeri Sembilan,0,0,0,Ireland
44937,3/1/2022,IRL,Pahang,0,0,0,Ireland
44938,3/1/2022,IRL,Perak,0,0,0,Ireland
44939,3/1/2022,IRL,Perlis,0,0,0,Ireland
44940,3/1/2022,IRL,Pulau Pinang,0,0,0,Ireland
44941,3/1/2022,IRL,Sabah,0,0,0,Ireland
44942,3/1/2022,IRL,Sarawak,0,0,0,Ireland
44943,3/1/2022,IRL,Selangor,71,52,19,Ireland
44944,3/1/2022,IRL,Terengganu,0,0,0,Ireland
44945,3/1/2022,IRL,W.P. Labuan,0,0,0,Ireland
44946,3/1/2022,IRN,Johor,0,0,0,Iran
44947,3/1/2022,IRN,Kedah,0,0,0,Iran
44948,3/1/2022,IRN,Kelantan,0,0,0,Iran
44949,3/1/2022,IRN,Perak,0,0,0,Iran
44950,3/1/2022,IRN,Perlis,0,0,0,Iran
44951,3/1/2022,IRN,Pulau Pinang,0,0,0,Iran
44952,3/1/2022,IRN,Sabah,0,0,0,Iran
44953,3/1/2022,IRN,Sarawak,0,0,0,Iran
44954,3/1/2022,IRN,Selangor,217,121,96,Iran
44955,3/1/2022,IRN,W.P. Labuan,0,0,0,Iran
44956,3/1/2022,IRQ,Johor,0,0,0,Iraq
44957,3/1/2022,IRQ,Kedah,0,0,0,Iraq
44958,3/1/2022,IRQ,Kelantan,0,0,0,Iraq
44959,3/1/2022,IRQ,Melaka,0,0,0,Iraq
44960,3/1/2022,IRQ,Pahang,0,0,0,Iraq
44961,3/1/2022,IRQ,Perak,0,0,0,Iraq
44962,3/1/2022,IRQ,Perlis,0,0,0,Iraq
44963,3/1/2022,IRQ,Pulau Pinang,0,0,0,Iraq
44964,3/1/2022,IRQ,Sabah,0,0,0,Iraq
44965,3/1/2022,IRQ,Sarawak,0,0,0,Iraq
44966,3/1/2022,IRQ,Selangor,228,151,77,Iraq
44967,3/1/2022,ISL,Johor,0,0,0,Iceland
44968,3/1/2022,ISL,Kedah,0,0,0,Iceland
44969,3/1/2022,ISL,Kelantan,0,0,0,Iceland
44970,3/1/2022,ISL,Perak,0,0,0,Iceland
44971,3/1/2022,ISL,Perlis,0,0,0,Iceland
44972,3/1/2022,ISL,Pulau Pinang,0,0,0,Iceland
44973,3/1/2022,ISL,Sabah,0,0,0,Iceland
44974,3/1/2022,ISL,Sarawak,0,0,0,Iceland
44975,3/1/2022,ISL,Selangor,1,0,1,Iceland
44976,3/1/2022,ISL,W.P. Labuan,0,0,0,Iceland
44977,3/1/2022,ISR,Pulau Pinang,0,0,0,Israel
44978,3/1/2022,ITA,Johor,1,1,0,Italy
44979,3/1/2022,ITA,Kedah,7,5,2,Italy
44980,3/1/2022,ITA,Kelantan,0,0,0,Italy
44981,3/1/2022,ITA,Melaka,0,0,0,Italy
44982,3/1/2022,ITA,Negeri Sembilan,0,0,0,Italy
44983,3/1/2022,ITA,Pahang,0,0,0,Italy
44984,3/1/2022,ITA,Perak,0,0,0,Italy
44985,3/1/2022,ITA,Perlis,0,0,0,Italy
44986,3/1/2022,ITA,Pulau Pinang,4,4,0,Italy
44987,3/1/2022,ITA,Sabah,0,0,0,Italy
44988,3/1/2022,ITA,Sarawak,1,1,0,Italy
44989,3/1/2022,ITA,Selangor,212,168,44,Italy
44990,3/1/2022,ITA,W.P. Labuan,0,0,0,Italy
44991,3/1/2022,JAM,Johor,0,0,0,Jamaica
44992,3/1/2022,JAM,Kedah,0,0,0,Jamaica
44993,3/1/2022,JAM,Perak,0,0,0,Jamaica
44994,3/1/2022,JAM,Pulau Pinang,0,0,0,Jamaica
44995,3/1/2022,JAM,Sabah,0,0,0,Jamaica
44996,3/1/2022,JAM,Sarawak,0,0,0,Jamaica
44997,3/1/2022,JAM,Selangor,2,1,1,Jamaica
44998,3/1/2022,JAM,W.P. Labuan,0,0,0,Jamaica
44999,3/1/2022,JOR,Johor,0,0,0,Jordan
45000,3/1/2022,JOR,Kedah,0,0,0,Jordan
45001,3/1/2022,JOR,Kelantan,0,0,0,Jordan
45002,3/1/2022,JOR,Melaka,0,0,0,Jordan
45003,3/1/2022,JOR,Perlis,0,0,0,Jordan
45004,3/1/2022,JOR,Pulau Pinang,0,0,0,Jordan
45005,3/1/2022,JOR,Sabah,0,0,0,Jordan
45006,3/1/2022,JOR,Sarawak,0,0,0,Jordan
45007,3/1/2022,JOR,Selangor,71,51,20,Jordan
45008,3/1/2022,JOR,W.P. Labuan,0,0,0,Jordan
45009,3/1/2022,JPN,Johor,6,3,3,Japan
45010,3/1/2022,JPN,Kedah,8,2,6,Japan
45011,3/1/2022,JPN,Kelantan,0,0,0,Japan
45012,3/1/2022,JPN,Melaka,0,0,0,Japan
45013,3/1/2022,JPN,Negeri Sembilan,0,0,0,Japan
45014,3/1/2022,JPN,Pahang,0,0,0,Japan
45015,3/1/2022,JPN,Perak,0,0,0,Japan
45016,3/1/2022,JPN,Perlis,0,0,0,Japan
45017,3/1/2022,JPN,Pulau Pinang,50,29,21,Japan
45018,3/1/2022,JPN,Sabah,1,0,1,Japan
45019,3/1/2022,JPN,Sarawak,17,14,3,Japan
45020,3/1/2022,JPN,Selangor,1082,736,346,Japan
45021,3/1/2022,JPN,W.P. Labuan,0,0,0,Japan
45022,3/1/2022,KAZ,Johor,0,0,0,Kazakhstan
45023,3/1/2022,KAZ,Kedah,0,0,0,Kazakhstan
45024,3/1/2022,KAZ,Kelantan,0,0,0,Kazakhstan
45025,3/1/2022,KAZ,Melaka,0,0,0,Kazakhstan
45026,3/1/2022,KAZ,Perak,0,0,0,Kazakhstan
45027,3/1/2022,KAZ,Perlis,0,0,0,Kazakhstan
45028,3/1/2022,KAZ,Pulau Pinang,0,0,0,Kazakhstan
45029,3/1/2022,KAZ,Sabah,0,0,0,Kazakhstan
45030,3/1/2022,KAZ,Sarawak,0,0,0,Kazakhstan
45031,3/1/2022,KAZ,Selangor,40,18,22,Kazakhstan
45032,3/1/2022,KAZ,W.P. Labuan,0,0,0,Kazakhstan
45033,3/1/2022,KEN,Johor,0,0,0,Kenya
45034,3/1/2022,KEN,Kedah,0,0,0,Kenya
45035,3/1/2022,KEN,Kelantan,0,0,0,Kenya
45036,3/1/2022,KEN,Perak,0,0,0,Kenya
45037,3/1/2022,KEN,Perlis,0,0,0,Kenya
45038,3/1/2022,KEN,Pulau Pinang,0,0,0,Kenya
45039,3/1/2022,KEN,Sabah,0,0,0,Kenya
45040,3/1/2022,KEN,Sarawak,0,0,0,Kenya
45041,3/1/2022,KEN,Selangor,46,19,27,Kenya
45042,3/1/2022,KGZ,Johor,0,0,0,Kyrgyzstan
45043,3/1/2022,KGZ,Kedah,0,0,0,Kyrgyzstan
45044,3/1/2022,KGZ,Kelantan,0,0,0,Kyrgyzstan
45045,3/1/2022,KGZ,Perak,0,0,0,Kyrgyzstan
45046,3/1/2022,KGZ,Perlis,0,0,0,Kyrgyzstan
45047,3/1/2022,KGZ,Pulau Pinang,0,0,0,Kyrgyzstan
45048,3/1/2022,KGZ,Sabah,0,0,0,Kyrgyzstan
45049,3/1/2022,KGZ,Sarawak,0,0,0,Kyrgyzstan
45050,3/1/2022,KGZ,Selangor,25,17,8,Kyrgyzstan
45051,3/1/2022,KHM,Johor,1,0,1,Cambodia
45052,3/1/2022,KHM,Kedah,0,0,0,Cambodia
45053,3/1/2022,KHM,Kelantan,0,0,0,Cambodia
45054,3/1/2022,KHM,Melaka,0,0,0,Cambodia
45055,3/1/2022,KHM,Negeri Sembilan,0,0,0,Cambodia
45056,3/1/2022,KHM,Pahang,0,0,0,Cambodia
45057,3/1/2022,KHM,Perak,0,0,0,Cambodia
45058,3/1/2022,KHM,Perlis,0,0,0,Cambodia
45059,3/1/2022,KHM,Pulau Pinang,0,0,0,Cambodia
45060,3/1/2022,KHM,Sabah,0,0,0,Cambodia
45061,3/1/2022,KHM,Sarawak,0,0,0,Cambodia
45062,3/1/2022,KHM,Selangor,212,173,39,Cambodia
45063,3/1/2022,KHM,W.P. Labuan,0,0,0,Cambodia
45064,3/1/2022,KIR,Johor,0,0,0,Kiribati
45065,3/1/2022,KIR,Sabah,0,0,0,Kiribati
45066,3/1/2022,KIR,Selangor,0,0,0,Kiribati
45067,3/1/2022,KNA,Johor,0,0,0,Saint Kitts and Nevis
45068,3/1/2022,KNA,Kedah,0,0,0,Saint Kitts and Nevis
45069,3/1/2022,KNA,Perlis,0,0,0,Saint Kitts and Nevis
45070,3/1/2022,KNA,Pulau Pinang,0,0,0,Saint Kitts and Nevis
45071,3/1/2022,KNA,Sabah,0,0,0,Saint Kitts and Nevis
45072,3/1/2022,KNA,Selangor,2,2,0,Saint Kitts and Nevis
45073,3/1/2022,KNA,W.P. Labuan,0,0,0,Saint Kitts and Nevis
45074,3/1/2022,KOR,Johor,3,2,1,"Korea, Republic of (South Korea)"
45075,3/1/2022,KOR,Kedah,7,4,3,"Korea, Republic of (South Korea)"
45076,3/1/2022,KOR,Kelantan,0,0,0,"Korea, Republic of (South Korea)"
45077,3/1/2022,KOR,Melaka,0,0,0,"Korea, Republic of (South Korea)"
45078,3/1/2022,KOR,Negeri Sembilan,0,0,0,"Korea, Republic of (South Korea)"
45079,3/1/2022,KOR,Pahang,0,0,0,"Korea, Republic of (South Korea)"
45080,3/1/2022,KOR,Perak,0,0,0,"Korea, Republic of (South Korea)"
45081,3/1/2022,KOR,Perlis,0,0,0,"Korea, Republic of (South Korea)"
45082,3/1/2022,KOR,Pulau Pinang,15,11,4,"Korea, Republic of (South Korea)"
45083,3/1/2022,KOR,Sabah,5,2,3,"Korea, Republic of (South Korea)"
45084,3/1/2022,KOR,Sarawak,32,26,6,"Korea, Republic of (South Korea)"
45085,3/1/2022,KOR,Selangor,949,656,293,"Korea, Republic of (South Korea)"
45086,3/1/2022,KOR,Terengganu,0,0,0,"Korea, Republic of (South Korea)"
45087,3/1/2022,KOR,W.P. Labuan,0,0,0,"Korea, Republic of (South Korea)"
45088,3/1/2022,KWT,Johor,0,0,0,Kuwait
45089,3/1/2022,KWT,Kedah,0,0,0,Kuwait
45090,3/1/2022,KWT,Kelantan,0,0,0,Kuwait
45091,3/1/2022,KWT,Perak,0,0,0,Kuwait
45092,3/1/2022,KWT,Perlis,0,0,0,Kuwait
45093,3/1/2022,KWT,Pulau Pinang,0,0,0,Kuwait
45094,3/1/2022,KWT,Sabah,0,0,0,Kuwait
45095,3/1/2022,KWT,Sarawak,0,0,0,Kuwait
45096,3/1/2022,KWT,Selangor,19,12,7,Kuwait
45097,3/1/2022,KWT,W.P. Labuan,0,0,0,Kuwait
45098,3/1/2022,LAO,Johor,0,0,0,Lao People's Democratic Republic
45099,3/1/2022,LAO,Kedah,0,0,0,Lao People's Democratic Republic
45100,3/1/2022,LAO,Kelantan,0,0,0,Lao People's Democratic Republic
45101,3/1/2022,LAO,Melaka,0,0,0,Lao People's Democratic Republic
45102,3/1/2022,LAO,Perak,0,0,0,Lao People's Democratic Republic
45103,3/1/2022,LAO,Perlis,0,0,0,Lao People's Democratic Republic
45104,3/1/2022,LAO,Pulau Pinang,0,0,0,Lao People's Democratic Republic
45105,3/1/2022,LAO,Sabah,0,0,0,Lao People's Democratic Republic
45106,3/1/2022,LAO,Sarawak,0,0,0,Lao People's Democratic Republic
45107,3/1/2022,LAO,Selangor,117,114,3,Lao People's Democratic Republic
45108,3/1/2022,LAO,W.P. Labuan,0,0,0,Lao People's Democratic Republic
45109,3/1/2022,LBN,Johor,0,0,0,Lebanon
45110,3/1/2022,LBN,Kedah,1,0,1,Lebanon
45111,3/1/2022,LBN,Kelantan,0,0,0,Lebanon
45112,3/1/2022,LBN,Pahang,0,0,0,Lebanon
45113,3/1/2022,LBN,Perak,0,0,0,Lebanon
45114,3/1/2022,LBN,Perlis,0,0,0,Lebanon
45115,3/1/2022,LBN,Pulau Pinang,0,0,0,Lebanon
45116,3/1/2022,LBN,Sabah,0,0,0,Lebanon
45117,3/1/2022,LBN,Sarawak,0,0,0,Lebanon
45118,3/1/2022,LBN,Selangor,23,17,6,Lebanon
45119,3/1/2022,LBN,W.P. Labuan,0,0,0,Lebanon
45120,3/1/2022,LBR,Johor,0,0,0,Liberia
45121,3/1/2022,LBR,Kedah,0,0,0,Liberia
45122,3/1/2022,LBR,Sabah,0,0,0,Liberia
45123,3/1/2022,LBR,Sarawak,0,0,0,Liberia
45124,3/1/2022,LBR,Selangor,2,2,0,Liberia
45125,3/1/2022,LBY,Johor,0,0,0,Libyan Arab Jamahiriya
45126,3/1/2022,LBY,Kedah,0,0,0,Libyan Arab Jamahiriya
45127,3/1/2022,LBY,Perlis,0,0,0,Libyan Arab Jamahiriya
45128,3/1/2022,LBY,Pulau Pinang,0,0,0,Libyan Arab Jamahiriya
45129,3/1/2022,LBY,Sabah,0,0,0,Libyan Arab Jamahiriya
45130,3/1/2022,LBY,Sarawak,0,0,0,Libyan Arab Jamahiriya
45131,3/1/2022,LBY,Selangor,188,122,66,Libyan Arab Jamahiriya
45132,3/1/2022,LCA,Johor,0,0,0,Saint Lucia
45133,3/1/2022,LCA,Kedah,0,0,0,Saint Lucia
45134,3/1/2022,LCA,Pulau Pinang,0,0,0,Saint Lucia
45135,3/1/2022,LCA,Sarawak,0,0,0,Saint Lucia
45136,3/1/2022,LCA,Selangor,1,1,0,Saint Lucia
45137,3/1/2022,LIE,Johor,0,0,0,Liechtenstein
45138,3/1/2022,LIE,Kedah,0,0,0,Liechtenstein
45139,3/1/2022,LIE,Perlis,0,0,0,Liechtenstein
45140,3/1/2022,LIE,Pulau Pinang,0,0,0,Liechtenstein
45141,3/1/2022,LIE,Sabah,0,0,0,Liechtenstein
45142,3/1/2022,LIE,Sarawak,0,0,0,Liechtenstein
45143,3/1/2022,LIE,Selangor,0,0,0,Liechtenstein
45144,3/1/2022,LKA,Johor,3,3,0,Sri Lanka
45145,3/1/2022,LKA,Kedah,2,2,0,Sri Lanka
45146,3/1/2022,LKA,Kelantan,0,0,0,Sri Lanka
45147,3/1/2022,LKA,Melaka,0,0,0,Sri Lanka
45148,3/1/2022,LKA,Pahang,0,0,0,Sri Lanka
45149,3/1/2022,LKA,Perak,0,0,0,Sri Lanka
45150,3/1/2022,LKA,Perlis,0,0,0,Sri Lanka
45151,3/1/2022,LKA,Pulau Pinang,0,0,0,Sri Lanka
45152,3/1/2022,LKA,Sabah,0,0,0,Sri Lanka
45153,3/1/2022,LKA,Sarawak,2,1,1,Sri Lanka
45154,3/1/2022,LKA,Selangor,353,203,150,Sri Lanka
45155,3/1/2022,LKA,W.P. Labuan,0,0,0,Sri Lanka
45156,3/1/2022,LSO,Johor,0,0,0,Lesotho
45157,3/1/2022,LSO,Kedah,0,0,0,Lesotho
45158,3/1/2022,LSO,Pulau Pinang,0,0,0,Lesotho
45159,3/1/2022,LSO,Sarawak,0,0,0,Lesotho
45160,3/1/2022,LSO,Selangor,4,1,3,Lesotho
45161,3/1/2022,LTU,Johor,0,0,0,Lithuania
45162,3/1/2022,LTU,Kedah,0,0,0,Lithuania
45163,3/1/2022,LTU,Kelantan,0,0,0,Lithuania
45164,3/1/2022,LTU,Pahang,0,0,0,Lithuania
45165,3/1/2022,LTU,Perak,0,0,0,Lithuania
45166,3/1/2022,LTU,Perlis,0,0,0,Lithuania
45167,3/1/2022,LTU,Pulau Pinang,0,0,0,Lithuania
45168,3/1/2022,LTU,Sabah,0,0,0,Lithuania
45169,3/1/2022,LTU,Sarawak,0,0,0,Lithuania
45170,3/1/2022,LTU,Selangor,19,13,6,Lithuania
45171,3/1/2022,LTU,W.P. Labuan,0,0,0,Lithuania
45172,3/1/2022,LUX,Johor,0,0,0,Luxembourg
45173,3/1/2022,LUX,Kedah,0,0,0,Luxembourg
45174,3/1/2022,LUX,Kelantan,0,0,0,Luxembourg
45175,3/1/2022,LUX,Perak,0,0,0,Luxembourg
45176,3/1/2022,LUX,Perlis,0,0,0,Luxembourg
45177,3/1/2022,LUX,Pulau Pinang,0,0,0,Luxembourg
45178,3/1/2022,LUX,Sabah,0,0,0,Luxembourg
45179,3/1/2022,LUX,Sarawak,0,0,0,Luxembourg
45180,3/1/2022,LUX,Selangor,1,1,0,Luxembourg
45181,3/1/2022,LVA,Johor,0,0,0,Latvia
45182,3/1/2022,LVA,Kedah,0,0,0,Latvia
45183,3/1/2022,LVA,Kelantan,0,0,0,Latvia
45184,3/1/2022,LVA,Pahang,0,0,0,Latvia
45185,3/1/2022,LVA,Perak,0,0,0,Latvia
45186,3/1/2022,LVA,Perlis,0,0,0,Latvia
45187,3/1/2022,LVA,Pulau Pinang,0,0,0,Latvia
45188,3/1/2022,LVA,Sabah,0,0,0,Latvia
45189,3/1/2022,LVA,Sarawak,0,0,0,Latvia
45190,3/1/2022,LVA,Selangor,3,2,1,Latvia
45191,3/1/2022,LVA,W.P. Labuan,0,0,0,Latvia
45192,3/1/2022,MAC,Johor,0,0,0,Macao
45193,3/1/2022,MAC,Pahang,0,0,0,Macao
45194,3/1/2022,MAC,Perak,0,0,0,Macao
45195,3/1/2022,MAC,Selangor,0,0,0,Macao
45196,3/1/2022,MAC,W.P. Labuan,0,0,0,Macao
45197,3/1/2022,MAR,Johor,0,0,0,Morocco
45198,3/1/2022,MAR,Kedah,0,0,0,Morocco
45199,3/1/2022,MAR,Kelantan,0,0,0,Morocco
45200,3/1/2022,MAR,Melaka,0,0,0,Morocco
45201,3/1/2022,MAR,Pahang,0,0,0,Morocco
45202,3/1/2022,MAR,Perak,0,0,0,Morocco
45203,3/1/2022,MAR,Perlis,0,0,0,Morocco
45204,3/1/2022,MAR,Pulau Pinang,0,0,0,Morocco
45205,3/1/2022,MAR,Sabah,0,0,0,Morocco
45206,3/1/2022,MAR,Sarawak,0,0,0,Morocco
45207,3/1/2022,MAR,Selangor,37,16,21,Morocco
45208,3/1/2022,MAR,W.P. Labuan,0,0,0,Morocco
45209,3/1/2022,MCO,Johor,0,0,0,Monaco
45210,3/1/2022,MCO,Kedah,0,0,0,Monaco
45211,3/1/2022,MCO,Sabah,0,0,0,Monaco
45212,3/1/2022,MCO,Selangor,0,0,0,Monaco
45213,3/1/2022,MDA,Johor,0,0,0,"Moldova, Republic of"
45214,3/1/2022,MDA,Kedah,0,0,0,"Moldova, Republic of"
45215,3/1/2022,MDA,Kelantan,0,0,0,"Moldova, Republic of"
45216,3/1/2022,MDA,Negeri Sembilan,0,0,0,"Moldova, Republic of"
45217,3/1/2022,MDA,Perlis,0,0,0,"Moldova, Republic of"
45218,3/1/2022,MDA,Pulau Pinang,0,0,0,"Moldova, Republic of"
45219,3/1/2022,MDA,Sabah,0,0,0,"Moldova, Republic of"
45220,3/1/2022,MDA,Sarawak,0,0,0,"Moldova, Republic of"
45221,3/1/2022,MDA,Selangor,0,0,0,"Moldova, Republic of"
45222,3/1/2022,MDG,Johor,0,0,0,Madagascar
45223,3/1/2022,MDG,Kedah,0,0,0,Madagascar
45224,3/1/2022,MDG,Perak,0,0,0,Madagascar
45225,3/1/2022,MDG,Perlis,0,0,0,Madagascar
45226,3/1/2022,MDG,Pulau Pinang,0,0,0,Madagascar
45227,3/1/2022,MDG,Sabah,0,0,0,Madagascar
45228,3/1/2022,MDG,Sarawak,0,0,0,Madagascar
45229,3/1/2022,MDG,Selangor,1,1,0,Madagascar
45230,3/1/2022,MDV,Johor,0,0,0,Maldives
45231,3/1/2022,MDV,Kedah,26,14,12,Maldives
45232,3/1/2022,MDV,Kelantan,0,0,0,Maldives
45233,3/1/2022,MDV,Perak,0,0,0,Maldives
45234,3/1/2022,MDV,Perlis,0,0,0,Maldives
45235,3/1/2022,MDV,Pulau Pinang,0,0,0,Maldives
45236,3/1/2022,MDV,Sabah,0,0,0,Maldives
45237,3/1/2022,MDV,Sarawak,0,0,0,Maldives
45238,3/1/2022,MDV,Selangor,211,115,96,Maldives
45239,3/1/2022,MEX,Johor,0,0,0,Mexico
45240,3/1/2022,MEX,Kedah,0,0,0,Mexico
45241,3/1/2022,MEX,Kelantan,0,0,0,Mexico
45242,3/1/2022,MEX,Pahang,0,0,0,Mexico
45243,3/1/2022,MEX,Perak,0,0,0,Mexico
45244,3/1/2022,MEX,Perlis,0,0,0,Mexico
45245,3/1/2022,MEX,Pulau Pinang,0,0,0,Mexico
45246,3/1/2022,MEX,Sabah,0,0,0,Mexico
45247,3/1/2022,MEX,Sarawak,0,0,0,Mexico
45248,3/1/2022,MEX,Selangor,24,14,10,Mexico
45249,3/1/2022,MEX,W.P. Labuan,0,0,0,Mexico
45250,3/1/2022,MHL,Johor,0,0,0,Marshall Islands
45251,3/1/2022,MHL,Kedah,0,0,0,Marshall Islands
45252,3/1/2022,MHL,Perak,0,0,0,Marshall Islands
45253,3/1/2022,MHL,Pulau Pinang,0,0,0,Marshall Islands
45254,3/1/2022,MHL,Sabah,0,0,0,Marshall Islands
45255,3/1/2022,MHL,Selangor,0,0,0,Marshall Islands
45256,3/1/2022,MKD,Johor,0,0,0,"Macedonia, the former Yugoslav Republic of"
45257,3/1/2022,MKD,Kedah,0,0,0,"Macedonia, the former Yugoslav Republic of"
45258,3/1/2022,MKD,Perak,0,0,0,"Macedonia, the former Yugoslav Republic of"
45259,3/1/2022,MKD,Pulau Pinang,0,0,0,"Macedonia, the former Yugoslav Republic of"
45260,3/1/2022,MKD,Sabah,0,0,0,"Macedonia, the former Yugoslav Republic of"
45261,3/1/2022,MKD,Sarawak,0,0,0,"Macedonia, the former Yugoslav Republic of"
45262,3/1/2022,MKD,Selangor,1,0,1,"Macedonia, the former Yugoslav Republic of"
45263,3/1/2022,MLI,Johor,0,0,0,Mali
45264,3/1/2022,MLI,Sabah,0,0,0,Mali
45265,3/1/2022,MLI,Selangor,2,1,1,Mali
45266,3/1/2022,MLT,Johor,0,0,0,Malta
45267,3/1/2022,MLT,Kedah,0,0,0,Malta
45268,3/1/2022,MLT,Kelantan,0,0,0,Malta
45269,3/1/2022,MLT,Perak,0,0,0,Malta
45270,3/1/2022,MLT,Perlis,0,0,0,Malta
45271,3/1/2022,MLT,Pulau Pinang,0,0,0,Malta
45272,3/1/2022,MLT,Sabah,0,0,0,Malta
45273,3/1/2022,MLT,Sarawak,0,0,0,Malta
45274,3/1/2022,MLT,Selangor,1,0,1,Malta
45275,3/1/2022,MLT,W.P. Labuan,0,0,0,Malta
45276,3/1/2022,MMR,Johor,24,23,1,Myanmar
45277,3/1/2022,MMR,Kedah,0,0,0,Myanmar
45278,3/1/2022,MMR,Kelantan,0,0,0,Myanmar
45279,3/1/2022,MMR,Negeri Sembilan,0,0,0,Myanmar
45280,3/1/2022,MMR,Pahang,0,0,0,Myanmar
45281,3/1/2022,MMR,Perak,0,0,0,Myanmar
45282,3/1/2022,MMR,Perlis,0,0,0,Myanmar
45283,3/1/2022,MMR,Pulau Pinang,1,1,0,Myanmar
45284,3/1/2022,MMR,Sabah,0,0,0,Myanmar
45285,3/1/2022,MMR,Sarawak,0,0,0,Myanmar
45286,3/1/2022,MMR,Selangor,425,348,77,Myanmar
45287,3/1/2022,MMR,Terengganu,0,0,0,Myanmar
45288,3/1/2022,MMR,W.P. Labuan,0,0,0,Myanmar
45289,3/1/2022,MNE,Johor,0,0,0,Montenegro
45290,3/1/2022,MNE,Kedah,0,0,0,Montenegro
45291,3/1/2022,MNE,Pulau Pinang,0,0,0,Montenegro
45292,3/1/2022,MNE,Sabah,0,0,0,Montenegro
45293,3/1/2022,MNE,Sarawak,0,0,0,Montenegro
45294,3/1/2022,MNE,Selangor,5,4,1,Montenegro
45295,3/1/2022,MNG,Johor,0,0,0,Mongolia
45296,3/1/2022,MNG,Kedah,0,0,0,Mongolia
45297,3/1/2022,MNG,Kelantan,0,0,0,Mongolia
45298,3/1/2022,MNG,Perak,0,0,0,Mongolia
45299,3/1/2022,MNG,Perlis,0,0,0,Mongolia
45300,3/1/2022,MNG,Pulau Pinang,0,0,0,Mongolia
45301,3/1/2022,MNG,Sabah,0,0,0,Mongolia
45302,3/1/2022,MNG,Sarawak,0,0,0,Mongolia
45303,3/1/2022,MNG,Selangor,14,3,11,Mongolia
45304,3/1/2022,MNP,Selangor,0,0,0,Northern Mariana Islands
45305,3/1/2022,MOZ,Johor,0,0,0,Mozambique
45306,3/1/2022,MOZ,Kedah,0,0,0,Mozambique
45307,3/1/2022,MOZ,Perak,0,0,0,Mozambique
45308,3/1/2022,MOZ,Pulau Pinang,0,0,0,Mozambique
45309,3/1/2022,MOZ,Sabah,0,0,0,Mozambique
45310,3/1/2022,MOZ,Sarawak,0,0,0,Mozambique
45311,3/1/2022,MOZ,Selangor,12,5,7,Mozambique
45312,3/1/2022,MRT,Johor,0,0,0,Mauritania
45313,3/1/2022,MRT,Kedah,0,0,0,Mauritania
45314,3/1/2022,MRT,Pulau Pinang,0,0,0,Mauritania
45315,3/1/2022,MRT,Sabah,0,0,0,Mauritania
45316,3/1/2022,MRT,Sarawak,0,0,0,Mauritania
45317,3/1/2022,MRT,Selangor,2,2,0,Mauritania
45318,3/1/2022,MUS,Johor,0,0,0,Mauritius
45319,3/1/2022,MUS,Kedah,0,0,0,Mauritius
45320,3/1/2022,MUS,Kelantan,0,0,0,Mauritius
45321,3/1/2022,MUS,Pahang,0,0,0,Mauritius
45322,3/1/2022,MUS,Perak,0,0,0,Mauritius
45323,3/1/2022,MUS,Perlis,0,0,0,Mauritius
45324,3/1/2022,MUS,Pulau Pinang,0,0,0,Mauritius
45325,3/1/2022,MUS,Sabah,0,0,0,Mauritius
45326,3/1/2022,MUS,Sarawak,0,0,0,Mauritius
45327,3/1/2022,MUS,Selangor,43,25,18,Mauritius
45328,3/1/2022,MWI,Johor,0,0,0,Malawi
45329,3/1/2022,MWI,Pulau Pinang,0,0,0,Malawi
45330,3/1/2022,MWI,Sabah,0,0,0,Malawi
45331,3/1/2022,MWI,Sarawak,0,0,0,Malawi
45332,3/1/2022,MWI,Selangor,7,4,3,Malawi
45333,3/1/2022,MYT,Selangor,0,0,0,Mayotte
45334,3/1/2022,NAM,Johor,0,0,0,Namibia
45335,3/1/2022,NAM,Kedah,0,0,0,Namibia
45336,3/1/2022,NAM,Perak,0,0,0,Namibia
45337,3/1/2022,NAM,Perlis,0,0,0,Namibia
45338,3/1/2022,NAM,Pulau Pinang,0,0,0,Namibia
45339,3/1/2022,NAM,Sabah,0,0,0,Namibia
45340,3/1/2022,NAM,Sarawak,0,0,0,Namibia
45341,3/1/2022,NAM,Selangor,1,1,0,Namibia
45342,3/1/2022,NCL,Selangor,0,0,0,New Caledonia
45343,3/1/2022,NER,Johor,0,0,0,Niger
45344,3/1/2022,NER,Sabah,0,0,0,Niger
45345,3/1/2022,NER,Selangor,0,0,0,Niger
45346,3/1/2022,NGA,Johor,0,0,0,Nigeria
45347,3/1/2022,NGA,Kedah,0,0,0,Nigeria
45348,3/1/2022,NGA,Perlis,0,0,0,Nigeria
45349,3/1/2022,NGA,Pulau Pinang,1,1,0,Nigeria
45350,3/1/2022,NGA,Sabah,0,0,0,Nigeria
45351,3/1/2022,NGA,Sarawak,0,0,0,Nigeria
45352,3/1/2022,NGA,Selangor,290,234,56,Nigeria
45353,3/1/2022,NIC,Johor,0,0,0,Nicaragua
45354,3/1/2022,NIC,Kedah,0,0,0,Nicaragua
45355,3/1/2022,NIC,Pulau Pinang,0,0,0,Nicaragua
45356,3/1/2022,NIC,Sabah,0,0,0,Nicaragua
45357,3/1/2022,NIC,Selangor,2,2,0,Nicaragua
45358,3/1/2022,NLD,Johor,1,1,0,Netherlands
45359,3/1/2022,NLD,Kedah,6,3,3,Netherlands
45360,3/1/2022,NLD,Kelantan,0,0,0,Netherlands
45361,3/1/2022,NLD,Melaka,0,0,0,Netherlands
45362,3/1/2022,NLD,Negeri Sembilan,0,0,0,Netherlands
45363,3/1/2022,NLD,Pahang,0,0,0,Netherlands
45364,3/1/2022,NLD,Perak,0,0,0,Netherlands
45365,3/1/2022,NLD,Perlis,0,0,0,Netherlands
45366,3/1/2022,NLD,Pulau Pinang,4,2,2,Netherlands
45367,3/1/2022,NLD,Sabah,0,0,0,Netherlands
45368,3/1/2022,NLD,Sarawak,1,1,0,Netherlands
45369,3/1/2022,NLD,Selangor,252,198,54,Netherlands
45370,3/1/2022,NLD,Terengganu,0,0,0,Netherlands
45371,3/1/2022,NLD,W.P. Labuan,0,0,0,Netherlands
45372,3/1/2022,NOR,Johor,0,0,0,Norway
45373,3/1/2022,NOR,Kedah,0,0,0,Norway
45374,3/1/2022,NOR,Kelantan,0,0,0,Norway
45375,3/1/2022,NOR,Melaka,0,0,0,Norway
45376,3/1/2022,NOR,Pahang,0,0,0,Norway
45377,3/1/2022,NOR,Perak,0,0,0,Norway
45378,3/1/2022,NOR,Perlis,0,0,0,Norway
45379,3/1/2022,NOR,Pulau Pinang,5,2,3,Norway
45380,3/1/2022,NOR,Sabah,0,0,0,Norway
45381,3/1/2022,NOR,Sarawak,0,0,0,Norway
45382,3/1/2022,NOR,Selangor,50,44,6,Norway
45383,3/1/2022,NOR,W.P. Labuan,0,0,0,Norway
45384,3/1/2022,NPL,Johor,0,0,0,Nepal
45385,3/1/2022,NPL,Kedah,0,0,0,Nepal
45386,3/1/2022,NPL,Pahang,0,0,0,Nepal
45387,3/1/2022,NPL,Perak,0,0,0,Nepal
45388,3/1/2022,NPL,Perlis,0,0,0,Nepal
45389,3/1/2022,NPL,Pulau Pinang,3,3,0,Nepal
45390,3/1/2022,NPL,Sabah,0,0,0,Nepal
45391,3/1/2022,NPL,Sarawak,0,0,0,Nepal
45392,3/1/2022,NPL,Selangor,830,809,21,Nepal
45393,3/1/2022,NPL,W.P. Labuan,0,0,0,Nepal
45394,3/1/2022,NRU,Johor,0,0,0,Nauru
45395,3/1/2022,NRU,Pulau Pinang,0,0,0,Nauru
45396,3/1/2022,NRU,Selangor,0,0,0,Nauru
45397,3/1/2022,NZL,Johor,0,0,0,New Zealand
45398,3/1/2022,NZL,Kedah,11,7,4,New Zealand
45399,3/1/2022,NZL,Kelantan,0,0,0,New Zealand
45400,3/1/2022,NZL,Melaka,0,0,0,New Zealand
45401,3/1/2022,NZL,Negeri Sembilan,0,0,0,New Zealand
45402,3/1/2022,NZL,Pahang,0,0,0,New Zealand
45403,3/1/2022,NZL,Perak,0,0,0,New Zealand
45404,3/1/2022,NZL,Perlis,0,0,0,New Zealand
45405,3/1/2022,NZL,Pulau Pinang,10,7,3,New Zealand
45406,3/1/2022,NZL,Sabah,0,0,0,New Zealand
45407,3/1/2022,NZL,Sarawak,0,0,0,New Zealand
45408,3/1/2022,NZL,Selangor,91,62,29,New Zealand
45409,3/1/2022,NZL,Terengganu,0,0,0,New Zealand
45410,3/1/2022,NZL,W.P. Labuan,0,0,0,New Zealand
45411,3/1/2022,OMN,Johor,0,0,0,Oman
45412,3/1/2022,OMN,Kedah,0,0,0,Oman
45413,3/1/2022,OMN,Kelantan,0,0,0,Oman
45414,3/1/2022,OMN,Melaka,0,0,0,Oman
45415,3/1/2022,OMN,Perak,0,0,0,Oman
45416,3/1/2022,OMN,Perlis,0,0,0,Oman
45417,3/1/2022,OMN,Pulau Pinang,0,0,0,Oman
45418,3/1/2022,OMN,Sabah,0,0,0,Oman
45419,3/1/2022,OMN,Sarawak,0,0,0,Oman
45420,3/1/2022,OMN,Selangor,74,62,12,Oman
45421,3/1/2022,PAK,Johor,0,0,0,Pakistan
45422,3/1/2022,PAK,Kedah,0,0,0,Pakistan
45423,3/1/2022,PAK,Kelantan,0,0,0,Pakistan
45424,3/1/2022,PAK,Melaka,0,0,0,Pakistan
45425,3/1/2022,PAK,Negeri Sembilan,0,0,0,Pakistan
45426,3/1/2022,PAK,Pahang,0,0,0,Pakistan
45427,3/1/2022,PAK,Perak,0,0,0,Pakistan
45428,3/1/2022,PAK,Perlis,0,0,0,Pakistan
45429,3/1/2022,PAK,Pulau Pinang,0,0,0,Pakistan
45430,3/1/2022,PAK,Sabah,0,0,0,Pakistan
45431,3/1/2022,PAK,Sarawak,1,1,0,Pakistan
45432,3/1/2022,PAK,Selangor,3137,2815,322,Pakistan
45433,3/1/2022,PAK,W.P. Labuan,0,0,0,Pakistan
45434,3/1/2022,PAN,Johor,0,0,0,Panama
45435,3/1/2022,PAN,Kedah,0,0,0,Panama
45436,3/1/2022,PAN,Perak,0,0,0,Panama
45437,3/1/2022,PAN,Perlis,0,0,0,Panama
45438,3/1/2022,PAN,Pulau Pinang,0,0,0,Panama
45439,3/1/2022,PAN,Sabah,0,0,0,Panama
45440,3/1/2022,PAN,Sarawak,0,0,0,Panama
45441,3/1/2022,PAN,Selangor,1,1,0,Panama
45442,3/1/2022,PER,Johor,0,0,0,Peru
45443,3/1/2022,PER,Kedah,0,0,0,Peru
45444,3/1/2022,PER,Kelantan,0,0,0,Peru
45445,3/1/2022,PER,Pahang,0,0,0,Peru
45446,3/1/2022,PER,Perak,0,0,0,Peru
45447,3/1/2022,PER,Perlis,0,0,0,Peru
45448,3/1/2022,PER,Pulau Pinang,0,0,0,Peru
45449,3/1/2022,PER,Sabah,0,0,0,Peru
45450,3/1/2022,PER,Sarawak,0,0,0,Peru
45451,3/1/2022,PER,Selangor,5,4,1,Peru
45452,3/1/2022,PER,W.P. Labuan,0,0,0,Peru
45453,3/1/2022,PHL,Johor,223,212,11,Philippines
45454,3/1/2022,PHL,Kedah,6,0,6,Philippines
45455,3/1/2022,PHL,Kelantan,0,0,0,Philippines
45456,3/1/2022,PHL,Melaka,0,0,0,Philippines
45457,3/1/2022,PHL,Negeri Sembilan,0,0,0,Philippines
45458,3/1/2022,PHL,Pahang,0,0,0,Philippines
45459,3/1/2022,PHL,Perak,0,0,0,Philippines
45460,3/1/2022,PHL,Perlis,0,0,0,Philippines
45461,3/1/2022,PHL,Pulau Pinang,22,7,15,Philippines
45462,3/1/2022,PHL,Sabah,2,1,1,Philippines
45463,3/1/2022,PHL,Sarawak,23,20,3,Philippines
45464,3/1/2022,PHL,Selangor,1594,927,667,Philippines
45465,3/1/2022,PHL,Terengganu,0,0,0,Philippines
45466,3/1/2022,PHL,W.P. Labuan,8,8,0,Philippines
45467,3/1/2022,PLW,Johor,0,0,0,Palau
45468,3/1/2022,PLW,Pulau Pinang,0,0,0,Palau
45469,3/1/2022,PLW,Selangor,0,0,0,Palau
45470,3/1/2022,PNG,Johor,0,0,0,Papua New Guinea
45471,3/1/2022,PNG,Kedah,0,0,0,Papua New Guinea
45472,3/1/2022,PNG,Kelantan,0,0,0,Papua New Guinea
45473,3/1/2022,PNG,Perak,0,0,0,Papua New Guinea
45474,3/1/2022,PNG,Pulau Pinang,0,0,0,Papua New Guinea
45475,3/1/2022,PNG,Sabah,0,0,0,Papua New Guinea
45476,3/1/2022,PNG,Sarawak,0,0,0,Papua New Guinea
45477,3/1/2022,PNG,Selangor,3,3,0,Papua New Guinea
45478,3/1/2022,POL,Johor,1,1,0,Poland
45479,3/1/2022,POL,Kedah,3,0,3,Poland
45480,3/1/2022,POL,Kelantan,0,0,0,Poland
45481,3/1/2022,POL,Melaka,0,0,0,Poland
45482,3/1/2022,POL,Negeri Sembilan,0,0,0,Poland
45483,3/1/2022,POL,Pahang,0,0,0,Poland
45484,3/1/2022,POL,Perak,0,0,0,Poland
45485,3/1/2022,POL,Perlis,0,0,0,Poland
45486,3/1/2022,POL,Pulau Pinang,1,1,0,Poland
45487,3/1/2022,POL,Sabah,0,0,0,Poland
45488,3/1/2022,POL,Sarawak,1,1,0,Poland
45489,3/1/2022,POL,Selangor,64,47,17,Poland
45490,3/1/2022,POL,Terengganu,0,0,0,Poland
45491,3/1/2022,POL,W.P. Labuan,0,0,0,Poland
45492,3/1/2022,PRK,Selangor,0,0,0,"Korea, Democratic People's Republic of"
45493,3/1/2022,PRT,Johor,0,0,0,Portugal
45494,3/1/2022,PRT,Kedah,1,1,0,Portugal
45495,3/1/2022,PRT,Kelantan,0,0,0,Portugal
45496,3/1/2022,PRT,Melaka,0,0,0,Portugal
45497,3/1/2022,PRT,Pahang,0,0,0,Portugal
45498,3/1/2022,PRT,Perak,0,0,0,Portugal
45499,3/1/2022,PRT,Perlis,0,0,0,Portugal
45500,3/1/2022,PRT,Pulau Pinang,1,1,0,Portugal
45501,3/1/2022,PRT,Sabah,0,0,0,Portugal
45502,3/1/2022,PRT,Sarawak,0,0,0,Portugal
45503,3/1/2022,PRT,Selangor,40,25,15,Portugal
45504,3/1/2022,PRT,W.P. Labuan,0,0,0,Portugal
45505,3/1/2022,PRY,Johor,0,0,0,Paraguay
45506,3/1/2022,PRY,Kedah,0,0,0,Paraguay
45507,3/1/2022,PRY,Perak,0,0,0,Paraguay
45508,3/1/2022,PRY,Perlis,0,0,0,Paraguay
45509,3/1/2022,PRY,Pulau Pinang,0,0,0,Paraguay
45510,3/1/2022,PRY,Sabah,0,0,0,Paraguay
45511,3/1/2022,PRY,Sarawak,0,0,0,Paraguay
45512,3/1/2022,PRY,Selangor,1,0,1,Paraguay
45513,3/1/2022,PSE,Johor,0,0,0,"Palestinian Territory, Occupied"
45514,3/1/2022,PSE,Kedah,0,0,0,"Palestinian Territory, Occupied"
45515,3/1/2022,PSE,Kelantan,0,0,0,"Palestinian Territory, Occupied"
45516,3/1/2022,PSE,Melaka,0,0,0,"Palestinian Territory, Occupied"
45517,3/1/2022,PSE,Perak,0,0,0,"Palestinian Territory, Occupied"
45518,3/1/2022,PSE,Perlis,0,0,0,"Palestinian Territory, Occupied"
45519,3/1/2022,PSE,Pulau Pinang,0,0,0,"Palestinian Territory, Occupied"
45520,3/1/2022,PSE,Sabah,0,0,0,"Palestinian Territory, Occupied"
45521,3/1/2022,PSE,Sarawak,0,0,0,"Palestinian Territory, Occupied"
45522,3/1/2022,PSE,Selangor,76,55,21,"Palestinian Territory, Occupied"
45523,3/1/2022,QAT,Johor,0,0,0,Qatar
45524,3/1/2022,QAT,Kedah,0,0,0,Qatar
45525,3/1/2022,QAT,Perlis,0,0,0,Qatar
45526,3/1/2022,QAT,Pulau Pinang,0,0,0,Qatar
45527,3/1/2022,QAT,Sabah,0,0,0,Qatar
45528,3/1/2022,QAT,Sarawak,0,0,0,Qatar
45529,3/1/2022,QAT,Selangor,14,14,0,Qatar
45530,3/1/2022,REU,Johor,0,0,0,Reunion
45531,3/1/2022,REU,Sarawak,0,0,0,Reunion
45532,3/1/2022,ROU,Johor,2,2,0,Romania
45533,3/1/2022,ROU,Kedah,1,0,1,Romania
45534,3/1/2022,ROU,Kelantan,0,0,0,Romania
45535,3/1/2022,ROU,Negeri Sembilan,0,0,0,Romania
45536,3/1/2022,ROU,Pahang,0,0,0,Romania
45537,3/1/2022,ROU,Perak,0,0,0,Romania
45538,3/1/2022,ROU,Perlis,0,0,0,Romania
45539,3/1/2022,ROU,Pulau Pinang,0,0,0,Romania
45540,3/1/2022,ROU,Sabah,0,0,0,Romania
45541,3/1/2022,ROU,Sarawak,0,0,0,Romania
45542,3/1/2022,ROU,Selangor,33,27,6,Romania
45543,3/1/2022,ROU,W.P. Labuan,0,0,0,Romania
45544,3/1/2022,RUS,Johor,5,5,0,Russia
45545,3/1/2022,RUS,Kedah,3,2,1,Russia
45546,3/1/2022,RUS,Kelantan,0,0,0,Russia
45547,3/1/2022,RUS,Melaka,0,0,0,Russia
45548,3/1/2022,RUS,Negeri Sembilan,0,0,0,Russia
45549,3/1/2022,RUS,Pahang,0,0,0,Russia
45550,3/1/2022,RUS,Perak,0,0,0,Russia
45551,3/1/2022,RUS,Perlis,0,0,0,Russia
45552,3/1/2022,RUS,Pulau Pinang,1,0,1,Russia
45553,3/1/2022,RUS,Sabah,0,0,0,Russia
45554,3/1/2022,RUS,Sarawak,0,0,0,Russia
45555,3/1/2022,RUS,Selangor,218,137,81,Russia
45556,3/1/2022,RUS,W.P. Labuan,0,0,0,Russia
45557,3/1/2022,RWA,Johor,0,0,0,Rwanda
45558,3/1/2022,RWA,Kedah,0,0,0,Rwanda
45559,3/1/2022,RWA,Pulau Pinang,0,0,0,Rwanda
45560,3/1/2022,RWA,Selangor,4,3,1,Rwanda
45561,3/1/2022,SAU,Johor,0,0,0,Saudi Arabia
45562,3/1/2022,SAU,Kedah,0,0,0,Saudi Arabia
45563,3/1/2022,SAU,Kelantan,0,0,0,Saudi Arabia
45564,3/1/2022,SAU,Melaka,0,0,0,Saudi Arabia
45565,3/1/2022,SAU,Perak,0,0,0,Saudi Arabia
45566,3/1/2022,SAU,Perlis,0,0,0,Saudi Arabia
45567,3/1/2022,SAU,Pulau Pinang,0,0,0,Saudi Arabia
45568,3/1/2022,SAU,Sabah,0,0,0,Saudi Arabia
45569,3/1/2022,SAU,Sarawak,0,0,0,Saudi Arabia
45570,3/1/2022,SAU,Selangor,318,212,106,Saudi Arabia
45571,3/1/2022,SAU,W.P. Labuan,0,0,0,Saudi Arabia
45572,3/1/2022,SDN,Johor,0,0,0,Sudan
45573,3/1/2022,SDN,Kedah,1,1,0,Sudan
45574,3/1/2022,SDN,Kelantan,0,0,0,Sudan
45575,3/1/2022,SDN,Perlis,0,0,0,Sudan
45576,3/1/2022,SDN,Pulau Pinang,0,0,0,Sudan
45577,3/1/2022,SDN,Sabah,0,0,0,Sudan
45578,3/1/2022,SDN,Sarawak,0,0,0,Sudan
45579,3/1/2022,SDN,Selangor,217,131,86,Sudan
45580,3/1/2022,SDN,W.P. Labuan,1,1,0,Sudan
45581,3/1/2022,SEN,Johor,0,0,0,Senegal
45582,3/1/2022,SEN,Kedah,0,0,0,Senegal
45583,3/1/2022,SEN,Kelantan,0,0,0,Senegal
45584,3/1/2022,SEN,Perak,0,0,0,Senegal
45585,3/1/2022,SEN,Perlis,0,0,0,Senegal
45586,3/1/2022,SEN,Pulau Pinang,0,0,0,Senegal
45587,3/1/2022,SEN,Sabah,0,0,0,Senegal
45588,3/1/2022,SEN,Sarawak,0,0,0,Senegal
45589,3/1/2022,SEN,Selangor,11,7,4,Senegal
45590,3/1/2022,SGP,Johor,6932,3759,3173,Singapore
45591,3/1/2022,SGP,Kedah,23,11,12,Singapore
45592,3/1/2022,SGP,Kelantan,0,0,0,Singapore
45593,3/1/2022,SGP,Melaka,0,0,0,Singapore
45594,3/1/2022,SGP,Negeri Sembilan,0,0,0,Singapore
45595,3/1/2022,SGP,Pahang,0,0,0,Singapore
45596,3/1/2022,SGP,Perak,6,5,1,Singapore
45597,3/1/2022,SGP,Perlis,0,0,0,Singapore
45598,3/1/2022,SGP,Pulau Pinang,1061,555,506,Singapore
45599,3/1/2022,SGP,Sabah,2,1,1,Singapore
45600,3/1/2022,SGP,Sarawak,39,19,20,Singapore
45601,3/1/2022,SGP,Selangor,8282,4891,3391,Singapore
45602,3/1/2022,SGP,Terengganu,0,0,0,Singapore
45603,3/1/2022,SGP,W.P. Labuan,0,0,0,Singapore
45604,3/1/2022,SGS,Johor,0,0,0,South Georgia and the South Sandwich Islands
45605,3/1/2022,SGS,Sabah,0,0,0,South Georgia and the South Sandwich Islands
45606,3/1/2022,SGS,Selangor,0,0,0,South Georgia and the South Sandwich Islands
45607,3/1/2022,SHN,Sarawak,0,0,0,"Saint Helena, Ascension and Tristan da Cunha"
45608,3/1/2022,SLB,Johor,0,0,0,Solomon Islands
45609,3/1/2022,SLB,Perlis,0,0,0,Solomon Islands
45610,3/1/2022,SLB,Pulau Pinang,0,0,0,Solomon Islands
45611,3/1/2022,SLB,Sabah,0,0,0,Solomon Islands
45612,3/1/2022,SLB,Sarawak,0,0,0,Solomon Islands
45613,3/1/2022,SLB,Selangor,2,0,2,Solomon Islands
45614,3/1/2022,SLB,W.P. Labuan,0,0,0,Solomon Islands
45615,3/1/2022,SLE,Johor,0,0,0,Sierra Leone
45616,3/1/2022,SLE,Kedah,0,0,0,Sierra Leone
45617,3/1/2022,SLE,Perak,0,0,0,Sierra Leone
45618,3/1/2022,SLE,Pulau Pinang,0,0,0,Sierra Leone
45619,3/1/2022,SLE,Sabah,0,0,0,Sierra Leone
45620,3/1/2022,SLE,Selangor,1,1,0,Sierra Leone
45621,3/1/2022,SLV,Johor,0,0,0,El Salvador
45622,3/1/2022,SLV,Kedah,0,0,0,El Salvador
45623,3/1/2022,SLV,Perak,0,0,0,El Salvador
45624,3/1/2022,SLV,Perlis,0,0,0,El Salvador
45625,3/1/2022,SLV,Pulau Pinang,0,0,0,El Salvador
45626,3/1/2022,SLV,Sabah,0,0,0,El Salvador
45627,3/1/2022,SLV,Selangor,0,0,0,El Salvador
45628,3/1/2022,SLV,W.P. Labuan,0,0,0,El Salvador
45629,3/1/2022,SMR,Johor,0,0,0,San Marino
45630,3/1/2022,SMR,Selangor,0,0,0,San Marino
45631,3/1/2022,SOM,Johor,0,0,0,Somalia
45632,3/1/2022,SOM,Kedah,0,0,0,Somalia
45633,3/1/2022,SOM,Kelantan,0,0,0,Somalia
45634,3/1/2022,SOM,Perlis,0,0,0,Somalia
45635,3/1/2022,SOM,Sabah,0,0,0,Somalia
45636,3/1/2022,SOM,Sarawak,0,0,0,Somalia
45637,3/1/2022,SOM,Selangor,94,70,24,Somalia
45638,3/1/2022,SRB,Johor,0,0,0,Serbia
45639,3/1/2022,SRB,Kedah,0,0,0,Serbia
45640,3/1/2022,SRB,Kelantan,0,0,0,Serbia
45641,3/1/2022,SRB,Pahang,0,0,0,Serbia
45642,3/1/2022,SRB,Perak,0,0,0,Serbia
45643,3/1/2022,SRB,Perlis,0,0,0,Serbia
45644,3/1/2022,SRB,Pulau Pinang,0,0,0,Serbia
45645,3/1/2022,SRB,Sabah,0,0,0,Serbia
45646,3/1/2022,SRB,Sarawak,0,0,0,Serbia
45647,3/1/2022,SRB,Selangor,14,11,3,Serbia
45648,3/1/2022,STP,Selangor,0,0,0,Sao Tome and Principe
45649,3/1/2022,SUR,Johor,0,0,0,Suriname
45650,3/1/2022,SUR,Kedah,0,0,0,Suriname
45651,3/1/2022,SUR,Kelantan,0,0,0,Suriname
45652,3/1/2022,SUR,Perak,0,0,0,Suriname
45653,3/1/2022,SUR,Perlis,0,0,0,Suriname
45654,3/1/2022,SUR,Pulau Pinang,0,0,0,Suriname
45655,3/1/2022,SUR,Sabah,0,0,0,Suriname
45656,3/1/2022,SUR,Sarawak,0,0,0,Suriname
45657,3/1/2022,SUR,Selangor,0,0,0,Suriname
45658,3/1/2022,SVK,Johor,0,0,0,Slovakia
45659,3/1/2022,SVK,Kedah,0,0,0,Slovakia
45660,3/1/2022,SVK,Kelantan,0,0,0,Slovakia
45661,3/1/2022,SVK,Negeri Sembilan,0,0,0,Slovakia
45662,3/1/2022,SVK,Pahang,0,0,0,Slovakia
45663,3/1/2022,SVK,Perak,0,0,0,Slovakia
45664,3/1/2022,SVK,Perlis,0,0,0,Slovakia
45665,3/1/2022,SVK,Pulau Pinang,0,0,0,Slovakia
45666,3/1/2022,SVK,Sabah,0,0,0,Slovakia
45667,3/1/2022,SVK,Sarawak,0,0,0,Slovakia
45668,3/1/2022,SVK,Selangor,44,25,19,Slovakia
45669,3/1/2022,SVK,W.P. Labuan,0,0,0,Slovakia
45670,3/1/2022,SVN,Johor,0,0,0,Slovenia
45671,3/1/2022,SVN,Kedah,0,0,0,Slovenia
45672,3/1/2022,SVN,Kelantan,0,0,0,Slovenia
45673,3/1/2022,SVN,Perak,0,0,0,Slovenia
45674,3/1/2022,SVN,Perlis,0,0,0,Slovenia
45675,3/1/2022,SVN,Pulau Pinang,0,0,0,Slovenia
45676,3/1/2022,SVN,Sabah,0,0,0,Slovenia
45677,3/1/2022,SVN,Sarawak,0,0,0,Slovenia
45678,3/1/2022,SVN,Selangor,3,2,1,Slovenia
45679,3/1/2022,SVN,W.P. Labuan,0,0,0,Slovenia
45680,3/1/2022,SWE,Johor,0,0,0,Sweden
45681,3/1/2022,SWE,Kedah,0,0,0,Sweden
45682,3/1/2022,SWE,Kelantan,0,0,0,Sweden
45683,3/1/2022,SWE,Melaka,0,0,0,Sweden
45684,3/1/2022,SWE,Negeri Sembilan,0,0,0,Sweden
45685,3/1/2022,SWE,Pahang,0,0,0,Sweden
45686,3/1/2022,SWE,Perak,0,0,0,Sweden
45687,3/1/2022,SWE,Perlis,0,0,0,Sweden
45688,3/1/2022,SWE,Pulau Pinang,0,0,0,Sweden
45689,3/1/2022,SWE,Sabah,0,0,0,Sweden
45690,3/1/2022,SWE,Sarawak,0,0,0,Sweden
45691,3/1/2022,SWE,Selangor,92,72,20,Sweden
45692,3/1/2022,SWE,W.P. Labuan,0,0,0,Sweden
45693,3/1/2022,SWZ,Johor,0,0,0,Swaziland
45694,3/1/2022,SWZ,Kedah,0,0,0,Swaziland
45695,3/1/2022,SWZ,Pulau Pinang,0,0,0,Swaziland
45696,3/1/2022,SWZ,Sabah,0,0,0,Swaziland
45697,3/1/2022,SWZ,Selangor,15,5,10,Swaziland
45698,3/1/2022,SYC,Johor,0,0,0,Seychelles
45699,3/1/2022,SYC,Kedah,0,0,0,Seychelles
45700,3/1/2022,SYC,Pulau Pinang,0,0,0,Seychelles
45701,3/1/2022,SYC,Sabah,0,0,0,Seychelles
45702,3/1/2022,SYC,Sarawak,1,1,0,Seychelles
45703,3/1/2022,SYC,Selangor,17,4,13,Seychelles
45704,3/1/2022,SYR,Johor,0,0,0,Syrian Arab Republic
45705,3/1/2022,SYR,Kedah,0,0,0,Syrian Arab Republic
45706,3/1/2022,SYR,Kelantan,0,0,0,Syrian Arab Republic
45707,3/1/2022,SYR,Pahang,0,0,0,Syrian Arab Republic
45708,3/1/2022,SYR,Perlis,0,0,0,Syrian Arab Republic
45709,3/1/2022,SYR,Pulau Pinang,0,0,0,Syrian Arab Republic
45710,3/1/2022,SYR,Sabah,0,0,0,Syrian Arab Republic
45711,3/1/2022,SYR,Sarawak,0,0,0,Syrian Arab Republic
45712,3/1/2022,SYR,Selangor,132,81,51,Syrian Arab Republic
45713,3/1/2022,SYR,W.P. Labuan,0,0,0,Syrian Arab Republic
45714,3/1/2022,TCA,Perlis,0,0,0,Turks and Caicos
45715,3/1/2022,TCD,Johor,0,0,0,Chad
45716,3/1/2022,TCD,Kedah,0,0,0,Chad
45717,3/1/2022,TCD,Perlis,0,0,0,Chad
45718,3/1/2022,TCD,Selangor,10,9,1,Chad
45719,3/1/2022,TGO,Johor,0,0,0,Togo
45720,3/1/2022,TGO,Perak,0,0,0,Togo
45721,3/1/2022,TGO,Pulau Pinang,0,0,0,Togo
45722,3/1/2022,TGO,Selangor,1,1,0,Togo
45723,3/1/2022,THA,Johor,69,67,2,Thailand
45724,3/1/2022,THA,Kedah,19836,19768,68,Thailand
45725,3/1/2022,THA,Kelantan,12,12,0,Thailand
45726,3/1/2022,THA,Melaka,0,0,0,Thailand
45727,3/1/2022,THA,Negeri Sembilan,0,0,0,Thailand
45728,3/1/2022,THA,Pahang,0,0,0,Thailand
45729,3/1/2022,THA,Perak,0,0,0,Thailand
45730,3/1/2022,THA,Perlis,10164,10007,157,Thailand
45731,3/1/2022,THA,Pulau Pinang,97,92,5,Thailand
45732,3/1/2022,THA,Sabah,2,0,2,Thailand
45733,3/1/2022,THA,Sarawak,20,20,0,Thailand
45734,3/1/2022,THA,Selangor,927,414,513,Thailand
45735,3/1/2022,THA,Terengganu,0,0,0,Thailand
45736,3/1/2022,THA,W.P. Labuan,0,0,0,Thailand
45737,3/1/2022,TJK,Johor,0,0,0,Tajikistan
45738,3/1/2022,TJK,Kedah,0,0,0,Tajikistan
45739,3/1/2022,TJK,Perlis,0,0,0,Tajikistan
45740,3/1/2022,TJK,Pulau Pinang,0,0,0,Tajikistan
45741,3/1/2022,TJK,Sabah,0,0,0,Tajikistan
45742,3/1/2022,TJK,Selangor,3,2,1,Tajikistan
45743,3/1/2022,TKL,Selangor,0,0,0,Tokelau
45744,3/1/2022,TKM,Johor,0,0,0,Turkmenistan
45745,3/1/2022,TKM,Kedah,0,0,0,Turkmenistan
45746,3/1/2022,TKM,Kelantan,0,0,0,Turkmenistan
45747,3/1/2022,TKM,Perlis,0,0,0,Turkmenistan
45748,3/1/2022,TKM,Pulau Pinang,0,0,0,Turkmenistan
45749,3/1/2022,TKM,Sabah,0,0,0,Turkmenistan
45750,3/1/2022,TKM,Sarawak,0,0,0,Turkmenistan
45751,3/1/2022,TKM,Selangor,10,5,5,Turkmenistan
45752,3/1/2022,TLS,Johor,0,0,0,Timor-Leste
45753,3/1/2022,TLS,Kedah,0,0,0,Timor-Leste
45754,3/1/2022,TLS,Perlis,0,0,0,Timor-Leste
45755,3/1/2022,TLS,Pulau Pinang,0,0,0,Timor-Leste
45756,3/1/2022,TLS,Sabah,0,0,0,Timor-Leste
45757,3/1/2022,TLS,Sarawak,0,0,0,Timor-Leste
45758,3/1/2022,TLS,Selangor,23,10,13,Timor-Leste
45759,3/1/2022,TON,Johor,0,0,0,Tonga
45760,3/1/2022,TON,Pulau Pinang,0,0,0,Tonga
45761,3/1/2022,TON,Sarawak,0,0,0,Tonga
45762,3/1/2022,TON,Selangor,1,1,0,Tonga
45763,3/1/2022,TTO,Johor,0,0,0,Trinidad and Tobago
45764,3/1/2022,TTO,Kedah,0,0,0,Trinidad and Tobago
45765,3/1/2022,TTO,Pahang,0,0,0,Trinidad and Tobago
45766,3/1/2022,TTO,Pulau Pinang,0,0,0,Trinidad and Tobago
45767,3/1/2022,TTO,Sabah,0,0,0,Trinidad and Tobago
45768,3/1/2022,TTO,Sarawak,0,0,0,Trinidad and Tobago
45769,3/1/2022,TTO,Selangor,5,4,1,Trinidad and Tobago
45770,3/1/2022,TUN,Johor,0,0,0,Tunisia
45771,3/1/2022,TUN,Kedah,0,0,0,Tunisia
45772,3/1/2022,TUN,Kelantan,0,0,0,Tunisia
45773,3/1/2022,TUN,Melaka,0,0,0,Tunisia
45774,3/1/2022,TUN,Perak,0,0,0,Tunisia
45775,3/1/2022,TUN,Perlis,0,0,0,Tunisia
45776,3/1/2022,TUN,Pulau Pinang,0,0,0,Tunisia
45777,3/1/2022,TUN,Sabah,1,1,0,Tunisia
45778,3/1/2022,TUN,Sarawak,0,0,0,Tunisia
45779,3/1/2022,TUN,Selangor,19,5,14,Tunisia
45780,3/1/2022,TUN,W.P. Labuan,0,0,0,Tunisia
45781,3/1/2022,TUR,Johor,6,4,2,Turkey
45782,3/1/2022,TUR,Kedah,2,2,0,Turkey
45783,3/1/2022,TUR,Kelantan,0,0,0,Turkey
45784,3/1/2022,TUR,Melaka,0,0,0,Turkey
45785,3/1/2022,TUR,Negeri Sembilan,0,0,0,Turkey
45786,3/1/2022,TUR,Pahang,0,0,0,Turkey
45787,3/1/2022,TUR,Perak,0,0,0,Turkey
45788,3/1/2022,TUR,Perlis,0,0,0,Turkey
45789,3/1/2022,TUR,Pulau Pinang,0,0,0,Turkey
45790,3/1/2022,TUR,Sabah,0,0,0,Turkey
45791,3/1/2022,TUR,Sarawak,0,0,0,Turkey
45792,3/1/2022,TUR,Selangor,270,212,58,Turkey
45793,3/1/2022,TUR,W.P. Labuan,0,0,0,Turkey
45794,3/1/2022,TUV,Selangor,0,0,0,Tuvalu
45795,3/1/2022,TWN,Johor,6,4,2,Taiwan
45796,3/1/2022,TWN,Kedah,4,3,1,Taiwan
45797,3/1/2022,TWN,Kelantan,0,0,0,Taiwan
45798,3/1/2022,TWN,Melaka,0,0,0,Taiwan
45799,3/1/2022,TWN,Negeri Sembilan,0,0,0,Taiwan
45800,3/1/2022,TWN,Pahang,0,0,0,Taiwan
45801,3/1/2022,TWN,Perak,0,0,0,Taiwan
45802,3/1/2022,TWN,Perlis,0,0,0,Taiwan
45803,3/1/2022,TWN,Pulau Pinang,36,28,8,Taiwan
45804,3/1/2022,TWN,Sabah,0,0,0,Taiwan
45805,3/1/2022,TWN,Sarawak,1,1,0,Taiwan
45806,3/1/2022,TWN,Selangor,228,137,91,Taiwan
45807,3/1/2022,TWN,W.P. Labuan,0,0,0,Taiwan
45808,3/1/2022,TZA,Johor,0,0,0,"Tanzania, United Republic of"
45809,3/1/2022,TZA,Kedah,0,0,0,"Tanzania, United Republic of"
45810,3/1/2022,TZA,Perak,0,0,0,"Tanzania, United Republic of"
45811,3/1/2022,TZA,Perlis,0,0,0,"Tanzania, United Republic of"
45812,3/1/2022,TZA,Pulau Pinang,0,0,0,"Tanzania, United Republic of"
45813,3/1/2022,TZA,Sabah,0,0,0,"Tanzania, United Republic of"
45814,3/1/2022,TZA,Sarawak,0,0,0,"Tanzania, United Republic of"
45815,3/1/2022,TZA,Selangor,43,26,17,"Tanzania, United Republic of"
45816,3/1/2022,UGA,Johor,0,0,0,Uganda
45817,3/1/2022,UGA,Kedah,0,0,0,Uganda
45818,3/1/2022,UGA,Perak,0,0,0,Uganda
45819,3/1/2022,UGA,Perlis,0,0,0,Uganda
45820,3/1/2022,UGA,Pulau Pinang,0,0,0,Uganda
45821,3/1/2022,UGA,Sabah,0,0,0,Uganda
45822,3/1/2022,UGA,Sarawak,0,0,0,Uganda
45823,3/1/2022,UGA,Selangor,20,17,3,Uganda
45824,3/1/2022,UKR,Johor,11,11,0,Ukraine
45825,3/1/2022,UKR,Kedah,0,0,0,Ukraine
45826,3/1/2022,UKR,Kelantan,0,0,0,Ukraine
45827,3/1/2022,UKR,Melaka,0,0,0,Ukraine
45828,3/1/2022,UKR,Negeri Sembilan,0,0,0,Ukraine
45829,3/1/2022,UKR,Pahang,0,0,0,Ukraine
45830,3/1/2022,UKR,Perak,0,0,0,Ukraine
45831,3/1/2022,UKR,Perlis,0,0,0,Ukraine
45832,3/1/2022,UKR,Pulau Pinang,0,0,0,Ukraine
45833,3/1/2022,UKR,Sabah,0,0,0,Ukraine
45834,3/1/2022,UKR,Sarawak,1,1,0,Ukraine
45835,3/1/2022,UKR,Selangor,40,20,20,Ukraine
45836,3/1/2022,UKR,W.P. Labuan,0,0,0,Ukraine
45837,3/1/2022,URY,Johor,0,0,0,Uruguay
45838,3/1/2022,URY,Kedah,0,0,0,Uruguay
45839,3/1/2022,URY,Kelantan,0,0,0,Uruguay
45840,3/1/2022,URY,Perak,0,0,0,Uruguay
45841,3/1/2022,URY,Perlis,0,0,0,Uruguay
45842,3/1/2022,URY,Pulau Pinang,0,0,0,Uruguay
45843,3/1/2022,URY,Sabah,0,0,0,Uruguay
45844,3/1/2022,URY,Sarawak,0,0,0,Uruguay
45845,3/1/2022,URY,Selangor,1,1,0,Uruguay
45846,3/1/2022,URY,W.P. Labuan,0,0,0,Uruguay
45847,3/1/2022,USA,Johor,4,2,2,United States Of America
45848,3/1/2022,USA,Kedah,37,22,15,United States Of America
45849,3/1/2022,USA,Kelantan,0,0,0,United States Of America
45850,3/1/2022,USA,Melaka,0,0,0,United States Of America
45851,3/1/2022,USA,Negeri Sembilan,0,0,0,United States Of America
45852,3/1/2022,USA,Pahang,0,0,0,United States Of America
45853,3/1/2022,USA,Perak,0,0,0,United States Of America
45854,3/1/2022,USA,Perlis,0,0,0,United States Of America
45855,3/1/2022,USA,Pulau Pinang,58,35,23,United States Of America
45856,3/1/2022,USA,Sabah,1,1,0,United States Of America
45857,3/1/2022,USA,Sarawak,4,4,0,United States Of America
45858,3/1/2022,USA,Selangor,823,569,254,United States Of America
45859,3/1/2022,USA,Terengganu,0,0,0,United States Of America
45860,3/1/2022,USA,W.P. Labuan,0,0,0,United States Of America
45861,3/1/2022,UZB,Johor,0,0,0,Uzbekistan
45862,3/1/2022,UZB,Kedah,0,0,0,Uzbekistan
45863,3/1/2022,UZB,Kelantan,0,0,0,Uzbekistan
45864,3/1/2022,UZB,Perak,0,0,0,Uzbekistan
45865,3/1/2022,UZB,Perlis,0,0,0,Uzbekistan
45866,3/1/2022,UZB,Pulau Pinang,0,0,0,Uzbekistan
45867,3/1/2022,UZB,Sabah,0,0,0,Uzbekistan
45868,3/1/2022,UZB,Sarawak,1,1,0,Uzbekistan
45869,3/1/2022,UZB,Selangor,23,19,4,Uzbekistan
45870,3/1/2022,VAT,Johor,0,0,0,Holy See (Vatican City State)
45871,3/1/2022,VAT,Sarawak,0,0,0,Holy See (Vatican City State)
45872,3/1/2022,VAT,Selangor,0,0,0,Holy See (Vatican City State)
45873,3/1/2022,VCT,Johor,0,0,0,Saint Vincent and the Grenadines
45874,3/1/2022,VCT,Kedah,0,0,0,Saint Vincent and the Grenadines
45875,3/1/2022,VCT,Pulau Pinang,0,0,0,Saint Vincent and the Grenadines
45876,3/1/2022,VCT,Sarawak,0,0,0,Saint Vincent and the Grenadines
45877,3/1/2022,VCT,Selangor,0,0,0,Saint Vincent and the Grenadines
45878,3/1/2022,VEN,Johor,0,0,0,Venezuela
45879,3/1/2022,VEN,Kedah,0,0,0,Venezuela
45880,3/1/2022,VEN,Kelantan,0,0,0,Venezuela
45881,3/1/2022,VEN,Melaka,0,0,0,Venezuela
45882,3/1/2022,VEN,Perak,0,0,0,Venezuela
45883,3/1/2022,VEN,Perlis,0,0,0,Venezuela
45884,3/1/2022,VEN,Pulau Pinang,0,0,0,Venezuela
45885,3/1/2022,VEN,Sabah,0,0,0,Venezuela
45886,3/1/2022,VEN,Sarawak,0,0,0,Venezuela
45887,3/1/2022,VEN,Selangor,14,10,4,Venezuela
45888,3/1/2022,VEN,W.P. Labuan,0,0,0,Venezuela
45889,3/1/2022,VNM,Johor,5,0,5,Vietnam
45890,3/1/2022,VNM,Kedah,62,6,56,Vietnam
45891,3/1/2022,VNM,Kelantan,0,0,0,Vietnam
45892,3/1/2022,VNM,Melaka,0,0,0,Vietnam
45893,3/1/2022,VNM,Negeri Sembilan,0,0,0,Vietnam
45894,3/1/2022,VNM,Pahang,0,0,0,Vietnam
45895,3/1/2022,VNM,Perak,0,0,0,Vietnam
45896,3/1/2022,VNM,Perlis,0,0,0,Vietnam
45897,3/1/2022,VNM,Pulau Pinang,18,4,14,Vietnam
45898,3/1/2022,VNM,Sabah,0,0,0,Vietnam
45899,3/1/2022,VNM,Sarawak,4,0,4,Vietnam
45900,3/1/2022,VNM,Selangor,774,235,539,Vietnam
45901,3/1/2022,VNM,Terengganu,0,0,0,Vietnam
45902,3/1/2022,VNM,W.P. Labuan,0,0,0,Vietnam
45903,3/1/2022,VUT,Johor,0,0,0,Vanuatu
45904,3/1/2022,VUT,Kedah,0,0,0,Vanuatu
45905,3/1/2022,VUT,Pulau Pinang,0,0,0,Vanuatu
45906,3/1/2022,VUT,Sabah,0,0,0,Vanuatu
45907,3/1/2022,VUT,Sarawak,0,0,0,Vanuatu
45908,3/1/2022,VUT,Selangor,3,3,0,Vanuatu
45909,3/1/2022,WSM,Johor,0,0,0,Samoa
45910,3/1/2022,WSM,Sarawak,0,0,0,Samoa
45911,3/1/2022,WSM,Selangor,0,0,0,Samoa
45912,3/1/2022,YEM,Johor,0,0,0,Yemen
45913,3/1/2022,YEM,Kedah,1,1,0,Yemen
45914,3/1/2022,YEM,Kelantan,0,0,0,Yemen
45915,3/1/2022,YEM,Melaka,0,0,0,Yemen
45916,3/1/2022,YEM,Pahang,0,0,0,Yemen
45917,3/1/2022,YEM,Perak,0,0,0,Yemen
45918,3/1/2022,YEM,Perlis,0,0,0,Yemen
45919,3/1/2022,YEM,Pulau Pinang,0,0,0,Yemen
45920,3/1/2022,YEM,Sabah,0,0,0,Yemen
45921,3/1/2022,YEM,Sarawak,0,0,0,Yemen
45922,3/1/2022,YEM,Selangor,359,258,101,Yemen
45923,3/1/2022,YEM,W.P. Labuan,0,0,0,Yemen
45924,3/1/2022,ZAF,Johor,0,0,0,South Africa
45925,3/1/2022,ZAF,Kedah,1,0,1,South Africa
45926,3/1/2022,ZAF,Kelantan,0,0,0,South Africa
45927,3/1/2022,ZAF,Melaka,0,0,0,South Africa
45928,3/1/2022,ZAF,Pahang,0,0,0,South Africa
45929,3/1/2022,ZAF,Perak,0,0,0,South Africa
45930,3/1/2022,ZAF,Perlis,0,0,0,South Africa
45931,3/1/2022,ZAF,Pulau Pinang,1,0,1,South Africa
45932,3/1/2022,ZAF,Sabah,0,0,0,South Africa
45933,3/1/2022,ZAF,Sarawak,0,0,0,South Africa
45934,3/1/2022,ZAF,Selangor,95,64,31,South Africa
45935,3/1/2022,ZAF,Terengganu,0,0,0,South Africa
45936,3/1/2022,ZAF,W.P. Labuan,0,0,0,South Africa
45937,3/1/2022,ZMB,Johor,0,0,0,Zambia
45938,3/1/2022,ZMB,Kedah,0,0,0,Zambia
45939,3/1/2022,ZMB,Perak,0,0,0,Zambia
45940,3/1/2022,ZMB,Perlis,0,0,0,Zambia
45941,3/1/2022,ZMB,Pulau Pinang,0,0,0,Zambia
45942,3/1/2022,ZMB,Sabah,0,0,0,Zambia
45943,3/1/2022,ZMB,Sarawak,0,0,0,Zambia
45944,3/1/2022,ZMB,Selangor,24,13,11,Zambia
45945,3/1/2022,ZWE,Johor,0,0,0,Zimbabwe
45946,3/1/2022,ZWE,Kedah,0,0,0,Zimbabwe
45947,3/1/2022,ZWE,Kelantan,0,0,0,Zimbabwe
45948,3/1/2022,ZWE,Perak,0,0,0,Zimbabwe
45949,3/1/2022,ZWE,Perlis,0,0,0,Zimbabwe
45950,3/1/2022,ZWE,Pulau Pinang,0,0,0,Zimbabwe
45951,3/1/2022,ZWE,Sabah,0,0,0,Zimbabwe
45952,3/1/2022,ZWE,Sarawak,0,0,0,Zimbabwe
45953,3/1/2022,ZWE,Selangor,26,8,18,Zimbabwe
45954,4/1/2022,ABW,Kedah,1,0,1,Aruba
45955,4/1/2022,ABW,Pulau Pinang,0,0,0,Aruba
45956,4/1/2022,AFG,Johor,0,0,0,Afghanistan
45957,4/1/2022,AFG,Kedah,0,0,0,Afghanistan
45958,4/1/2022,AFG,Perlis,0,0,0,Afghanistan
45959,4/1/2022,AFG,Pulau Pinang,0,0,0,Afghanistan
45960,4/1/2022,AFG,Sarawak,0,0,0,Afghanistan
45961,4/1/2022,AFG,Selangor,103,78,25,Afghanistan
45962,4/1/2022,AGO,Johor,0,0,0,Angola
45963,4/1/2022,AGO,Kedah,0,0,0,Angola
45964,4/1/2022,AGO,Sabah,0,0,0,Angola
45965,4/1/2022,AGO,Selangor,3,2,1,Angola
45966,4/1/2022,AIA,Selangor,0,0,0,Anguilla
45967,4/1/2022,ALB,Johor,3,2,1,Albania
45968,4/1/2022,ALB,Kedah,0,0,0,Albania
45969,4/1/2022,ALB,Perak,0,0,0,Albania
45970,4/1/2022,ALB,Perlis,0,0,0,Albania
45971,4/1/2022,ALB,Pulau Pinang,0,0,0,Albania
45972,4/1/2022,ALB,Sabah,0,0,0,Albania
45973,4/1/2022,ALB,Sarawak,0,0,0,Albania
45974,4/1/2022,ALB,Selangor,16,9,7,Albania
45975,4/1/2022,AND,Johor,0,0,0,Andorra
45976,4/1/2022,AND,Kedah,0,0,0,Andorra
45977,4/1/2022,AND,Perlis,0,0,0,Andorra
45978,4/1/2022,AND,Pulau Pinang,0,0,0,Andorra
45979,4/1/2022,AND,Selangor,2,2,0,Andorra
45980,4/1/2022,ANT,Selangor,0,0,0,Netherlands Antilles
45981,4/1/2022,ARE,Johor,4,3,1,United Arab Emirates
45982,4/1/2022,ARE,Kedah,0,0,0,United Arab Emirates
45983,4/1/2022,ARE,Kelantan,0,0,0,United Arab Emirates
45984,4/1/2022,ARE,Perak,0,0,0,United Arab Emirates
45985,4/1/2022,ARE,Perlis,0,0,0,United Arab Emirates
45986,4/1/2022,ARE,Pulau Pinang,0,0,0,United Arab Emirates
45987,4/1/2022,ARE,Sabah,0,0,0,United Arab Emirates
45988,4/1/2022,ARE,Sarawak,0,0,0,United Arab Emirates
45989,4/1/2022,ARE,Selangor,61,35,26,United Arab Emirates
45990,4/1/2022,ARG,Johor,20,20,0,Argentina
45991,4/1/2022,ARG,Kedah,0,0,0,Argentina
45992,4/1/2022,ARG,Kelantan,0,0,0,Argentina
45993,4/1/2022,ARG,Melaka,0,0,0,Argentina
45994,4/1/2022,ARG,Perak,0,0,0,Argentina
45995,4/1/2022,ARG,Perlis,0,0,0,Argentina
45996,4/1/2022,ARG,Pulau Pinang,0,0,0,Argentina
45997,4/1/2022,ARG,Sabah,0,0,0,Argentina
45998,4/1/2022,ARG,Sarawak,1,1,0,Argentina
45999,4/1/2022,ARG,Selangor,79,51,28,Argentina
46000,4/1/2022,ARG,W.P. Labuan,0,0,0,Argentina
46001,4/1/2022,ARM,Johor,4,2,2,Armenia
46002,4/1/2022,ARM,Kedah,0,0,0,Armenia
46003,4/1/2022,ARM,Kelantan,0,0,0,Armenia
46004,4/1/2022,ARM,Perak,0,0,0,Armenia
46005,4/1/2022,ARM,Perlis,0,0,0,Armenia
46006,4/1/2022,ARM,Pulau Pinang,0,0,0,Armenia
46007,4/1/2022,ARM,Sabah,0,0,0,Armenia
46008,4/1/2022,ARM,Sarawak,0,0,0,Armenia
46009,4/1/2022,ARM,Selangor,6,1,5,Armenia
46010,4/1/2022,ATA,Selangor,1,0,1,Antarctica
46011,4/1/2022,ATG,Johor,0,0,0,Antigua and Barbuda
46012,4/1/2022,ATG,Kedah,0,0,0,Antigua and Barbuda
46013,4/1/2022,ATG,Pulau Pinang,0,0,0,Antigua and Barbuda
46014,4/1/2022,ATG,Sarawak,0,0,0,Antigua and Barbuda
46015,4/1/2022,ATG,Selangor,7,5,2,Antigua and Barbuda
46016,4/1/2022,AUS,Johor,1385,872,513,Australia
46017,4/1/2022,AUS,Kedah,180,104,76,Australia
46018,4/1/2022,AUS,Kelantan,0,0,0,Australia
46019,4/1/2022,AUS,Melaka,0,0,0,Australia
46020,4/1/2022,AUS,Negeri Sembilan,0,0,0,Australia
46021,4/1/2022,AUS,Pahang,1,1,0,Australia
46022,4/1/2022,AUS,Perak,58,29,29,Australia
46023,4/1/2022,AUS,Perlis,0,0,0,Australia
46024,4/1/2022,AUS,Pulau Pinang,507,288,219,Australia
46025,4/1/2022,AUS,Sabah,38,19,19,Australia
46026,4/1/2022,AUS,Sarawak,72,38,34,Australia
46027,4/1/2022,AUS,Selangor,4906,2956,1950,Australia
46028,4/1/2022,AUS,Terengganu,1,1,0,Australia
46029,4/1/2022,AUS,W.P. Labuan,0,0,0,Australia
46030,4/1/2022,AUT,Johor,61,36,25,Austria
46031,4/1/2022,AUT,Kedah,8,4,4,Austria
46032,4/1/2022,AUT,Kelantan,0,0,0,Austria
46033,4/1/2022,AUT,Melaka,0,0,0,Austria
46034,4/1/2022,AUT,Negeri Sembilan,0,0,0,Austria
46035,4/1/2022,AUT,Pahang,0,0,0,Austria
46036,4/1/2022,AUT,Perak,1,0,1,Austria
46037,4/1/2022,AUT,Perlis,0,0,0,Austria
46038,4/1/2022,AUT,Pulau Pinang,19,17,2,Austria
46039,4/1/2022,AUT,Sabah,7,4,3,Austria
46040,4/1/2022,AUT,Sarawak,2,2,0,Austria
46041,4/1/2022,AUT,Selangor,236,168,68,Austria
46042,4/1/2022,AUT,Terengganu,0,0,0,Austria
46043,4/1/2022,AUT,W.P. Labuan,0,0,0,Austria
46044,4/1/2022,AZE,Johor,2,2,0,Azerbaijan
46045,4/1/2022,AZE,Kedah,0,0,0,Azerbaijan
46046,4/1/2022,AZE,Kelantan,0,0,0,Azerbaijan
46047,4/1/2022,AZE,Melaka,0,0,0,Azerbaijan
46048,4/1/2022,AZE,Perlis,0,0,0,Azerbaijan
46049,4/1/2022,AZE,Pulau Pinang,0,0,0,Azerbaijan
46050,4/1/2022,AZE,Sabah,0,0,0,Azerbaijan
46051,4/1/2022,AZE,Sarawak,0,0,0,Azerbaijan
46052,4/1/2022,AZE,Selangor,19,14,5,Azerbaijan
46053,4/1/2022,AZE,W.P. Labuan,0,0,0,Azerbaijan
46054,4/1/2022,BDI,Pulau Pinang,0,0,0,Burundi
46055,4/1/2022,BDI,Sarawak,0,0,0,Burundi
46056,4/1/2022,BDI,Selangor,6,3,3,Burundi
46057,4/1/2022,BEL,Johor,67,49,18,Belgium
46058,4/1/2022,BEL,Kedah,6,1,5,Belgium
46059,4/1/2022,BEL,Kelantan,0,0,0,Belgium
46060,4/1/2022,BEL,Melaka,0,0,0,Belgium
46061,4/1/2022,BEL,Negeri Sembilan,0,0,0,Belgium
46062,4/1/2022,BEL,Pahang,0,0,0,Belgium
46063,4/1/2022,BEL,Perak,1,1,0,Belgium
46064,4/1/2022,BEL,Perlis,0,0,0,Belgium
46065,4/1/2022,BEL,Pulau Pinang,19,13,6,Belgium
46066,4/1/2022,BEL,Sabah,5,2,3,Belgium
46067,4/1/2022,BEL,Sarawak,1,1,0,Belgium
46068,4/1/2022,BEL,Selangor,228,156,72,Belgium
46069,4/1/2022,BEL,W.P. Labuan,0,0,0,Belgium
46070,4/1/2022,BEN,Johor,0,0,0,Benin
46071,4/1/2022,BEN,Kedah,0,0,0,Benin
46072,4/1/2022,BEN,Perak,0,0,0,Benin
46073,4/1/2022,BEN,Pulau Pinang,0,0,0,Benin
46074,4/1/2022,BEN,Sabah,0,0,0,Benin
46075,4/1/2022,BEN,Sarawak,0,0,0,Benin
46076,4/1/2022,BEN,Selangor,1,1,0,Benin
46077,4/1/2022,BFA,Perak,0,0,0,Burkina Faso
46078,4/1/2022,BFA,Pulau Pinang,0,0,0,Burkina Faso
46079,4/1/2022,BFA,Selangor,0,0,0,Burkina Faso
46080,4/1/2022,BGD,Johor,289,247,42,Bangladesh
46081,4/1/2022,BGD,Kedah,0,0,0,Bangladesh
46082,4/1/2022,BGD,Kelantan,0,0,0,Bangladesh
46083,4/1/2022,BGD,Melaka,0,0,0,Bangladesh
46084,4/1/2022,BGD,Negeri Sembilan,0,0,0,Bangladesh
46085,4/1/2022,BGD,Pahang,0,0,0,Bangladesh
46086,4/1/2022,BGD,Perak,0,0,0,Bangladesh
46087,4/1/2022,BGD,Perlis,0,0,0,Bangladesh
46088,4/1/2022,BGD,Pulau Pinang,7,7,0,Bangladesh
46089,4/1/2022,BGD,Sabah,0,0,0,Bangladesh
46090,4/1/2022,BGD,Sarawak,2,2,0,Bangladesh
46091,4/1/2022,BGD,Selangor,8825,8242,583,Bangladesh
46092,4/1/2022,BGD,W.P. Labuan,0,0,0,Bangladesh
46093,4/1/2022,BGR,Johor,25,19,6,Bulgaria
46094,4/1/2022,BGR,Kedah,4,2,2,Bulgaria
46095,4/1/2022,BGR,Kelantan,0,0,0,Bulgaria
46096,4/1/2022,BGR,Pahang,0,0,0,Bulgaria
46097,4/1/2022,BGR,Perak,0,0,0,Bulgaria
46098,4/1/2022,BGR,Perlis,0,0,0,Bulgaria
46099,4/1/2022,BGR,Pulau Pinang,2,1,1,Bulgaria
46100,4/1/2022,BGR,Sabah,0,0,0,Bulgaria
46101,4/1/2022,BGR,Sarawak,0,0,0,Bulgaria
46102,4/1/2022,BGR,Selangor,45,29,16,Bulgaria
46103,4/1/2022,BGR,W.P. Labuan,0,0,0,Bulgaria
46104,4/1/2022,BHR,Johor,0,0,0,Bahrain
46105,4/1/2022,BHR,Kedah,0,0,0,Bahrain
46106,4/1/2022,BHR,Kelantan,0,0,0,Bahrain
46107,4/1/2022,BHR,Perlis,0,0,0,Bahrain
46108,4/1/2022,BHR,Pulau Pinang,0,0,0,Bahrain
46109,4/1/2022,BHR,Sabah,0,0,0,Bahrain
46110,4/1/2022,BHR,Sarawak,0,0,0,Bahrain
46111,4/1/2022,BHR,Selangor,17,13,4,Bahrain
46112,4/1/2022,BHS,Johor,0,0,0,Bahamas
46113,4/1/2022,BHS,Kedah,0,0,0,Bahamas
46114,4/1/2022,BHS,Perak,0,0,0,Bahamas
46115,4/1/2022,BHS,Sabah,0,0,0,Bahamas
46116,4/1/2022,BHS,Sarawak,0,0,0,Bahamas
46117,4/1/2022,BHS,Selangor,2,0,2,Bahamas
46118,4/1/2022,BIH,Johor,1,1,0,Bosnia and Herzegovina
46119,4/1/2022,BIH,Kedah,0,0,0,Bosnia and Herzegovina
46120,4/1/2022,BIH,Perlis,0,0,0,Bosnia and Herzegovina
46121,4/1/2022,BIH,Pulau Pinang,0,0,0,Bosnia and Herzegovina
46122,4/1/2022,BIH,Sabah,0,0,0,Bosnia and Herzegovina
46123,4/1/2022,BIH,Sarawak,0,0,0,Bosnia and Herzegovina
46124,4/1/2022,BIH,Selangor,23,12,11,Bosnia and Herzegovina
46125,4/1/2022,BLR,Johor,5,1,4,Belarus
46126,4/1/2022,BLR,Kedah,2,0,2,Belarus
46127,4/1/2022,BLR,Kelantan,0,0,0,Belarus
46128,4/1/2022,BLR,Pahang,0,0,0,Belarus
46129,4/1/2022,BLR,Perak,0,0,0,Belarus
46130,4/1/2022,BLR,Perlis,0,0,0,Belarus
46131,4/1/2022,BLR,Pulau Pinang,1,1,0,Belarus
46132,4/1/2022,BLR,Sabah,0,0,0,Belarus
46133,4/1/2022,BLR,Sarawak,0,0,0,Belarus
46134,4/1/2022,BLR,Selangor,45,24,21,Belarus
46135,4/1/2022,BLR,W.P. Labuan,0,0,0,Belarus
46136,4/1/2022,BLZ,Johor,0,0,0,Belize
46137,4/1/2022,BLZ,Pulau Pinang,0,0,0,Belize
46138,4/1/2022,BLZ,Sarawak,0,0,0,Belize
46139,4/1/2022,BLZ,Selangor,2,1,1,Belize
46140,4/1/2022,BMU,Selangor,0,0,0,Bermuda
46141,4/1/2022,BOL,Johor,0,0,0,Bolivia
46142,4/1/2022,BOL,Kedah,0,0,0,Bolivia
46143,4/1/2022,BOL,Melaka,0,0,0,Bolivia
46144,4/1/2022,BOL,Perak,0,0,0,Bolivia
46145,4/1/2022,BOL,Perlis,0,0,0,Bolivia
46146,4/1/2022,BOL,Pulau Pinang,0,0,0,Bolivia
46147,4/1/2022,BOL,Sabah,0,0,0,Bolivia
46148,4/1/2022,BOL,Sarawak,0,0,0,Bolivia
46149,4/1/2022,BOL,Selangor,2,1,1,Bolivia
46150,4/1/2022,BRA,Johor,113,62,51,Brazil
46151,4/1/2022,BRA,Kedah,15,5,10,Brazil
46152,4/1/2022,BRA,Kelantan,0,0,0,Brazil
46153,4/1/2022,BRA,Melaka,0,0,0,Brazil
46154,4/1/2022,BRA,Pahang,0,0,0,Brazil
46155,4/1/2022,BRA,Perak,0,0,0,Brazil
46156,4/1/2022,BRA,Perlis,0,0,0,Brazil
46157,4/1/2022,BRA,Pulau Pinang,7,4,3,Brazil
46158,4/1/2022,BRA,Sabah,3,1,2,Brazil
46159,4/1/2022,BRA,Sarawak,0,0,0,Brazil
46160,4/1/2022,BRA,Selangor,223,130,93,Brazil
46161,4/1/2022,BRA,W.P. Labuan,0,0,0,Brazil
46162,4/1/2022,BRB,Johor,0,0,0,Barbados
46163,4/1/2022,BRB,Kedah,0,0,0,Barbados
46164,4/1/2022,BRB,Perlis,0,0,0,Barbados
46165,4/1/2022,BRB,Pulau Pinang,0,0,0,Barbados
46166,4/1/2022,BRB,Selangor,2,1,1,Barbados
46167,4/1/2022,BRN,Johor,36,20,16,Brunei Darussalam
46168,4/1/2022,BRN,Kedah,0,0,0,Brunei Darussalam
46169,4/1/2022,BRN,Kelantan,0,0,0,Brunei Darussalam
46170,4/1/2022,BRN,Melaka,0,0,0,Brunei Darussalam
46171,4/1/2022,BRN,Pahang,0,0,0,Brunei Darussalam
46172,4/1/2022,BRN,Perak,0,0,0,Brunei Darussalam
46173,4/1/2022,BRN,Perlis,0,0,0,Brunei Darussalam
46174,4/1/2022,BRN,Pulau Pinang,0,0,0,Brunei Darussalam
46175,4/1/2022,BRN,Sabah,1,0,1,Brunei Darussalam
46176,4/1/2022,BRN,Sarawak,593,553,40,Brunei Darussalam
46177,4/1/2022,BRN,Selangor,605,325,280,Brunei Darussalam
46178,4/1/2022,BRN,W.P. Labuan,12,9,3,Brunei Darussalam
46179,4/1/2022,BTN,Johor,0,0,0,Bhutan
46180,4/1/2022,BTN,Kedah,0,0,0,Bhutan
46181,4/1/2022,BTN,Perak,0,0,0,Bhutan
46182,4/1/2022,BTN,Perlis,0,0,0,Bhutan
46183,4/1/2022,BTN,Pulau Pinang,0,0,0,Bhutan
46184,4/1/2022,BTN,Sabah,0,0,0,Bhutan
46185,4/1/2022,BTN,Sarawak,0,0,0,Bhutan
46186,4/1/2022,BTN,Selangor,3,1,2,Bhutan
46187,4/1/2022,BWA,Johor,0,0,0,Botswana
46188,4/1/2022,BWA,Kedah,0,0,0,Botswana
46189,4/1/2022,BWA,Perlis,0,0,0,Botswana
46190,4/1/2022,BWA,Pulau Pinang,0,0,0,Botswana
46191,4/1/2022,BWA,Sabah,0,0,0,Botswana
46192,4/1/2022,BWA,Sarawak,0,0,0,Botswana
46193,4/1/2022,BWA,Selangor,4,1,3,Botswana
46194,4/1/2022,CAF,Kedah,0,0,0,Central African Republic
46195,4/1/2022,CAF,Selangor,0,0,0,Central African Republic
46196,4/1/2022,CAN,Johor,423,266,157,Canada
46197,4/1/2022,CAN,Kedah,22,11,11,Canada
46198,4/1/2022,CAN,Kelantan,0,0,0,Canada
46199,4/1/2022,CAN,Melaka,0,0,0,Canada
46200,4/1/2022,CAN,Negeri Sembilan,0,0,0,Canada
46201,4/1/2022,CAN,Pahang,0,0,0,Canada
46202,4/1/2022,CAN,Perak,3,2,1,Canada
46203,4/1/2022,CAN,Perlis,0,0,0,Canada
46204,4/1/2022,CAN,Pulau Pinang,74,44,30,Canada
46205,4/1/2022,CAN,Sabah,10,5,5,Canada
46206,4/1/2022,CAN,Sarawak,11,8,3,Canada
46207,4/1/2022,CAN,Selangor,1066,665,401,Canada
46208,4/1/2022,CAN,Terengganu,0,0,0,Canada
46209,4/1/2022,CAN,W.P. Labuan,0,0,0,Canada
46210,4/1/2022,CCK,Selangor,0,0,0,Cocos (Keeling) Islands
46211,4/1/2022,CHE,Johor,121,80,41,Switzerland
46212,4/1/2022,CHE,Kedah,11,6,5,Switzerland
46213,4/1/2022,CHE,Kelantan,0,0,0,Switzerland
46214,4/1/2022,CHE,Melaka,0,0,0,Switzerland
46215,4/1/2022,CHE,Negeri Sembilan,0,0,0,Switzerland
46216,4/1/2022,CHE,Pahang,0,0,0,Switzerland
46217,4/1/2022,CHE,Perak,2,2,0,Switzerland
46218,4/1/2022,CHE,Perlis,0,0,0,Switzerland
46219,4/1/2022,CHE,Pulau Pinang,41,29,12,Switzerland
46220,4/1/2022,CHE,Sabah,4,3,1,Switzerland
46221,4/1/2022,CHE,Sarawak,5,1,4,Switzerland
46222,4/1/2022,CHE,Selangor,385,245,140,Switzerland
46223,4/1/2022,CHE,W.P. Labuan,0,0,0,Switzerland
46224,4/1/2022,CHL,Johor,7,5,2,Chile
46225,4/1/2022,CHL,Kedah,0,0,0,Chile
46226,4/1/2022,CHL,Kelantan,0,0,0,Chile
46227,4/1/2022,CHL,Melaka,0,0,0,Chile
46228,4/1/2022,CHL,Pahang,0,0,0,Chile
46229,4/1/2022,CHL,Perak,0,0,0,Chile
46230,4/1/2022,CHL,Perlis,0,0,0,Chile
46231,4/1/2022,CHL,Pulau Pinang,0,0,0,Chile
46232,4/1/2022,CHL,Sabah,0,0,0,Chile
46233,4/1/2022,CHL,Sarawak,0,0,0,Chile
46234,4/1/2022,CHL,Selangor,39,30,9,Chile
46235,4/1/2022,CHN,Johor,3993,1819,2174,China
46236,4/1/2022,CHN,Kedah,39,19,20,China
46237,4/1/2022,CHN,Kelantan,0,0,0,China
46238,4/1/2022,CHN,Melaka,0,0,0,China
46239,4/1/2022,CHN,Pahang,5,0,5,China
46240,4/1/2022,CHN,Perak,23,14,9,China
46241,4/1/2022,CHN,Perlis,0,0,0,China
46242,4/1/2022,CHN,Pulau Pinang,170,72,98,China
46243,4/1/2022,CHN,Sabah,51,21,30,China
46244,4/1/2022,CHN,Sarawak,63,50,13,China
46245,4/1/2022,CHN,Selangor,5200,3512,1688,China
46246,4/1/2022,CHN,Terengganu,0,0,0,China
46247,4/1/2022,CHN,W.P. Labuan,1,0,1,China
46248,4/1/2022,CIV,Johor,0,0,0,C��te d'Iv
46249,4/1/2022,CIV,Kedah,0,0,0,C��te d'Iv
46250,4/1/2022,CIV,Pulau Pinang,0,0,0,C��te d'Iv
46251,4/1/2022,CIV,Sabah,0,0,0,C��te d'Iv
46252,4/1/2022,CIV,Sarawak,0,0,0,C��te d'Iv
46253,4/1/2022,CIV,Selangor,3,0,3,C��te d'Iv
46254,4/1/2022,CMR,Johor,0,0,0,Cameroon
46255,4/1/2022,CMR,Kedah,0,0,0,Cameroon
46256,4/1/2022,CMR,Pulau Pinang,1,1,0,Cameroon
46257,4/1/2022,CMR,Sabah,0,0,0,Cameroon
46258,4/1/2022,CMR,Sarawak,0,0,0,Cameroon
46259,4/1/2022,CMR,Selangor,7,5,2,Cameroon
46260,4/1/2022,COD,Johor,0,0,0,"Congo, the Democratic Republic of the"
46261,4/1/2022,COD,Pulau Pinang,0,0,0,"Congo, the Democratic Republic of the"
46262,4/1/2022,COD,Sarawak,0,0,0,"Congo, the Democratic Republic of the"
46263,4/1/2022,COD,Selangor,2,2,0,"Congo, the Democratic Republic of the"
46264,4/1/2022,COG,Johor,0,0,0,Congo
46265,4/1/2022,COG,Kedah,0,0,0,Congo
46266,4/1/2022,COG,Selangor,1,1,0,Congo
46267,4/1/2022,COK,Selangor,0,0,0,Cook Islands
46268,4/1/2022,COL,Johor,15,4,11,Colombia
46269,4/1/2022,COL,Kedah,0,0,0,Colombia
46270,4/1/2022,COL,Perak,0,0,0,Colombia
46271,4/1/2022,COL,Pulau Pinang,3,1,2,Colombia
46272,4/1/2022,COL,Sabah,0,0,0,Colombia
46273,4/1/2022,COL,Sarawak,0,0,0,Colombia
46274,4/1/2022,COL,Selangor,34,17,17,Colombia
46275,4/1/2022,COL,W.P. Labuan,0,0,0,Colombia
46276,4/1/2022,COM,Johor,0,0,0,Comoros
46277,4/1/2022,COM,Kedah,0,0,0,Comoros
46278,4/1/2022,COM,Selangor,13,6,7,Comoros
46279,4/1/2022,CPV,Johor,0,0,0,Cape Verde
46280,4/1/2022,CPV,Kedah,0,0,0,Cape Verde
46281,4/1/2022,CPV,Pulau Pinang,0,0,0,Cape Verde
46282,4/1/2022,CPV,Sabah,0,0,0,Cape Verde
46283,4/1/2022,CPV,Selangor,2,0,2,Cape Verde
46284,4/1/2022,CRI,Johor,2,1,1,Costa Rica
46285,4/1/2022,CRI,Kedah,0,0,0,Costa Rica
46286,4/1/2022,CRI,Perak,0,0,0,Costa Rica
46287,4/1/2022,CRI,Perlis,0,0,0,Costa Rica
46288,4/1/2022,CRI,Pulau Pinang,1,0,1,Costa Rica
46289,4/1/2022,CRI,Sabah,0,0,0,Costa Rica
46290,4/1/2022,CRI,Sarawak,0,0,0,Costa Rica
46291,4/1/2022,CRI,Selangor,18,9,9,Costa Rica
46292,4/1/2022,CUB,Johor,0,0,0,Cuba
46293,4/1/2022,CUB,Kedah,0,0,0,Cuba
46294,4/1/2022,CUB,Perlis,0,0,0,Cuba
46295,4/1/2022,CUB,Pulau Pinang,0,0,0,Cuba
46296,4/1/2022,CUB,Sabah,0,0,0,Cuba
46297,4/1/2022,CUB,Sarawak,0,0,0,Cuba
46298,4/1/2022,CUB,Selangor,5,4,1,Cuba
46299,4/1/2022,CYP,Johor,5,4,1,Cyprus
46300,4/1/2022,CYP,Kedah,0,0,0,Cyprus
46301,4/1/2022,CYP,Perak,0,0,0,Cyprus
46302,4/1/2022,CYP,Perlis,0,0,0,Cyprus
46303,4/1/2022,CYP,Pulau Pinang,1,1,0,Cyprus
46304,4/1/2022,CYP,Sabah,0,0,0,Cyprus
46305,4/1/2022,CYP,Sarawak,0,0,0,Cyprus
46306,4/1/2022,CYP,Selangor,7,6,1,Cyprus
46307,4/1/2022,CZE,Johor,40,27,13,Czech Republic
46308,4/1/2022,CZE,Kedah,9,7,2,Czech Republic
46309,4/1/2022,CZE,Kelantan,0,0,0,Czech Republic
46310,4/1/2022,CZE,Melaka,0,0,0,Czech Republic
46311,4/1/2022,CZE,Negeri Sembilan,0,0,0,Czech Republic
46312,4/1/2022,CZE,Perak,0,0,0,Czech Republic
46313,4/1/2022,CZE,Perlis,0,0,0,Czech Republic
46314,4/1/2022,CZE,Pulau Pinang,10,5,5,Czech Republic
46315,4/1/2022,CZE,Sabah,1,0,1,Czech Republic
46316,4/1/2022,CZE,Sarawak,0,0,0,Czech Republic
46317,4/1/2022,CZE,Selangor,95,63,32,Czech Republic
46318,4/1/2022,CZE,W.P. Labuan,0,0,0,Czech Republic
46319,4/1/2022,DEU,Johor,645,472,173,Germany
46320,4/1/2022,DEU,Kedah,60,36,24,Germany
46321,4/1/2022,DEU,Kelantan,0,0,0,Germany
46322,4/1/2022,DEU,Melaka,0,0,0,Germany
46323,4/1/2022,DEU,Negeri Sembilan,2,1,1,Germany
46324,4/1/2022,DEU,Pahang,0,0,0,Germany
46325,4/1/2022,DEU,Perak,8,6,2,Germany
46326,4/1/2022,DEU,Perlis,0,0,0,Germany
46327,4/1/2022,DEU,Pulau Pinang,205,139,66,Germany
46328,4/1/2022,DEU,Sabah,39,24,15,Germany
46329,4/1/2022,DEU,Sarawak,11,9,2,Germany
46330,4/1/2022,DEU,Selangor,1826,1326,500,Germany
46331,4/1/2022,DEU,Terengganu,0,0,0,Germany
46332,4/1/2022,DEU,W.P. Labuan,0,0,0,Germany
46333,4/1/2022,DJI,Johor,0,0,0,Djibouti
46334,4/1/2022,DJI,Selangor,6,3,3,Djibouti
46335,4/1/2022,DMA,Johor,0,0,0,Dominica
46336,4/1/2022,DMA,Kedah,0,0,0,Dominica
46337,4/1/2022,DMA,Pulau Pinang,0,0,0,Dominica
46338,4/1/2022,DMA,Sabah,0,0,0,Dominica
46339,4/1/2022,DMA,Sarawak,0,0,0,Dominica
46340,4/1/2022,DMA,Selangor,14,11,3,Dominica
46341,4/1/2022,DMA,W.P. Labuan,0,0,0,Dominica
46342,4/1/2022,DNK,Johor,97,67,30,Denmark
46343,4/1/2022,DNK,Kedah,18,14,4,Denmark
46344,4/1/2022,DNK,Kelantan,0,0,0,Denmark
46345,4/1/2022,DNK,Melaka,0,0,0,Denmark
46346,4/1/2022,DNK,Negeri Sembilan,0,0,0,Denmark
46347,4/1/2022,DNK,Pahang,0,0,0,Denmark
46348,4/1/2022,DNK,Perak,1,1,0,Denmark
46349,4/1/2022,DNK,Perlis,0,0,0,Denmark
46350,4/1/2022,DNK,Pulau Pinang,28,20,8,Denmark
46351,4/1/2022,DNK,Sabah,0,0,0,Denmark
46352,4/1/2022,DNK,Sarawak,2,2,0,Denmark
46353,4/1/2022,DNK,Selangor,373,254,119,Denmark
46354,4/1/2022,DNK,W.P. Labuan,0,0,0,Denmark
46355,4/1/2022,DOM,Johor,0,0,0,Dominican Republic
46356,4/1/2022,DOM,Kedah,0,0,0,Dominican Republic
46357,4/1/2022,DOM,Perak,0,0,0,Dominican Republic
46358,4/1/2022,DOM,Perlis,0,0,0,Dominican Republic
46359,4/1/2022,DOM,Pulau Pinang,0,0,0,Dominican Republic
46360,4/1/2022,DOM,Sabah,0,0,0,Dominican Republic
46361,4/1/2022,DOM,Sarawak,0,0,0,Dominican Republic
46362,4/1/2022,DOM,Selangor,0,0,0,Dominican Republic
46363,4/1/2022,DZA,Johor,5,5,0,Algeria
46364,4/1/2022,DZA,Kedah,2,2,0,Algeria
46365,4/1/2022,DZA,Kelantan,0,0,0,Algeria
46366,4/1/2022,DZA,Melaka,0,0,0,Algeria
46367,4/1/2022,DZA,Perak,0,0,0,Algeria
46368,4/1/2022,DZA,Perlis,0,0,0,Algeria
46369,4/1/2022,DZA,Pulau Pinang,0,0,0,Algeria
46370,4/1/2022,DZA,Sabah,0,0,0,Algeria
46371,4/1/2022,DZA,Sarawak,0,0,0,Algeria
46372,4/1/2022,DZA,Selangor,112,80,32,Algeria
46373,4/1/2022,DZA,W.P. Labuan,0,0,0,Algeria
46374,4/1/2022,ECU,Johor,5,1,4,Ecuador
46375,4/1/2022,ECU,Kedah,0,0,0,Ecuador
46376,4/1/2022,ECU,Perak,0,0,0,Ecuador
46377,4/1/2022,ECU,Perlis,0,0,0,Ecuador
46378,4/1/2022,ECU,Pulau Pinang,0,0,0,Ecuador
46379,4/1/2022,ECU,Sabah,0,0,0,Ecuador
46380,4/1/2022,ECU,Sarawak,0,0,0,Ecuador
46381,4/1/2022,ECU,Selangor,23,15,8,Ecuador
46382,4/1/2022,EGY,Johor,37,35,2,Egypt
46383,4/1/2022,EGY,Kedah,1,1,0,Egypt
46384,4/1/2022,EGY,Kelantan,0,0,0,Egypt
46385,4/1/2022,EGY,Melaka,0,0,0,Egypt
46386,4/1/2022,EGY,Pahang,0,0,0,Egypt
46387,4/1/2022,EGY,Perak,0,0,0,Egypt
46388,4/1/2022,EGY,Perlis,0,0,0,Egypt
46389,4/1/2022,EGY,Pulau Pinang,2,2,0,Egypt
46390,4/1/2022,EGY,Sabah,0,0,0,Egypt
46391,4/1/2022,EGY,Sarawak,0,0,0,Egypt
46392,4/1/2022,EGY,Selangor,608,420,188,Egypt
46393,4/1/2022,EGY,Terengganu,0,0,0,Egypt
46394,4/1/2022,EGY,W.P. Labuan,0,0,0,Egypt
46395,4/1/2022,ERI,Johor,0,0,0,Eritrea
46396,4/1/2022,ERI,Pulau Pinang,0,0,0,Eritrea
46397,4/1/2022,ERI,Sabah,0,0,0,Eritrea
46398,4/1/2022,ERI,Selangor,9,6,3,Eritrea
46399,4/1/2022,ESP,Johor,115,68,47,Spain
46400,4/1/2022,ESP,Kedah,17,9,8,Spain
46401,4/1/2022,ESP,Kelantan,0,0,0,Spain
46402,4/1/2022,ESP,Melaka,0,0,0,Spain
46403,4/1/2022,ESP,Negeri Sembilan,0,0,0,Spain
46404,4/1/2022,ESP,Pahang,0,0,0,Spain
46405,4/1/2022,ESP,Perak,0,0,0,Spain
46406,4/1/2022,ESP,Perlis,0,0,0,Spain
46407,4/1/2022,ESP,Pulau Pinang,7,4,3,Spain
46408,4/1/2022,ESP,Sabah,2,0,2,Spain
46409,4/1/2022,ESP,Sarawak,2,0,2,Spain
46410,4/1/2022,ESP,Selangor,456,285,171,Spain
46411,4/1/2022,ESP,W.P. Labuan,0,0,0,Spain
46412,4/1/2022,EST,Johor,5,2,3,Estonia
46413,4/1/2022,EST,Kedah,0,0,0,Estonia
46414,4/1/2022,EST,Kelantan,0,0,0,Estonia
46415,4/1/2022,EST,Pahang,0,0,0,Estonia
46416,4/1/2022,EST,Perak,0,0,0,Estonia
46417,4/1/2022,EST,Perlis,0,0,0,Estonia
46418,4/1/2022,EST,Pulau Pinang,2,2,0,Estonia
46419,4/1/2022,EST,Sabah,0,0,0,Estonia
46420,4/1/2022,EST,Sarawak,1,1,0,Estonia
46421,4/1/2022,EST,Selangor,24,12,12,Estonia
46422,4/1/2022,EST,W.P. Labuan,0,0,0,Estonia
46423,4/1/2022,ETH,Johor,0,0,0,Ethiopia
46424,4/1/2022,ETH,Kedah,0,0,0,Ethiopia
46425,4/1/2022,ETH,Pulau Pinang,0,0,0,Ethiopia
46426,4/1/2022,ETH,Sarawak,0,0,0,Ethiopia
46427,4/1/2022,ETH,Selangor,6,4,2,Ethiopia
46428,4/1/2022,FIN,Johor,92,59,33,Finland
46429,4/1/2022,FIN,Kedah,6,3,3,Finland
46430,4/1/2022,FIN,Kelantan,0,0,0,Finland
46431,4/1/2022,FIN,Melaka,0,0,0,Finland
46432,4/1/2022,FIN,Negeri Sembilan,0,0,0,Finland
46433,4/1/2022,FIN,Pahang,0,0,0,Finland
46434,4/1/2022,FIN,Perak,0,0,0,Finland
46435,4/1/2022,FIN,Perlis,0,0,0,Finland
46436,4/1/2022,FIN,Pulau Pinang,6,3,3,Finland
46437,4/1/2022,FIN,Sabah,3,0,3,Finland
46438,4/1/2022,FIN,Sarawak,0,0,0,Finland
46439,4/1/2022,FIN,Selangor,170,115,55,Finland
46440,4/1/2022,FIN,W.P. Labuan,0,0,0,Finland
46441,4/1/2022,FJI,Johor,6,2,4,Fiji
46442,4/1/2022,FJI,Kedah,1,0,1,Fiji
46443,4/1/2022,FJI,Kelantan,0,0,0,Fiji
46444,4/1/2022,FJI,Perak,0,0,0,Fiji
46445,4/1/2022,FJI,Perlis,0,0,0,Fiji
46446,4/1/2022,FJI,Pulau Pinang,0,0,0,Fiji
46447,4/1/2022,FJI,Sabah,0,0,0,Fiji
46448,4/1/2022,FJI,Sarawak,1,0,1,Fiji
46449,4/1/2022,FJI,Selangor,21,11,10,Fiji
46450,4/1/2022,FRA,Johor,956,602,354,France
46451,4/1/2022,FRA,Kedah,74,45,29,France
46452,4/1/2022,FRA,Kelantan,0,0,0,France
46453,4/1/2022,FRA,Melaka,0,0,0,France
46454,4/1/2022,FRA,Negeri Sembilan,0,0,0,France
46455,4/1/2022,FRA,Pahang,0,0,0,France
46456,4/1/2022,FRA,Perak,4,2,2,France
46457,4/1/2022,FRA,Perlis,2,2,0,France
46458,4/1/2022,FRA,Pulau Pinang,151,93,58,France
46459,4/1/2022,FRA,Sabah,32,18,14,France
46460,4/1/2022,FRA,Sarawak,11,8,3,France
46461,4/1/2022,FRA,Selangor,1898,1268,630,France
46462,4/1/2022,FRA,Terengganu,0,0,0,France
46463,4/1/2022,FRA,W.P. Labuan,1,1,0,France
46464,4/1/2022,FSM,Johor,0,0,0,"Micronesia, Federated States of"
46465,4/1/2022,FSM,Pulau Pinang,0,0,0,"Micronesia, Federated States of"
46466,4/1/2022,FSM,Selangor,0,0,0,"Micronesia, Federated States of"
46467,4/1/2022,GAB,Johor,4,0,4,Gabon
46468,4/1/2022,GAB,Pulau Pinang,0,0,0,Gabon
46469,4/1/2022,GAB,Sarawak,0,0,0,Gabon
46470,4/1/2022,GAB,Selangor,4,1,3,Gabon
46471,4/1/2022,GBR,Johor,1787,1174,613,United Kingdom
46472,4/1/2022,GBR,Kedah,194,107,87,United Kingdom
46473,4/1/2022,GBR,Kelantan,0,0,0,United Kingdom
46474,4/1/2022,GBR,Melaka,0,0,0,United Kingdom
46475,4/1/2022,GBR,Negeri Sembilan,0,0,0,United Kingdom
46476,4/1/2022,GBR,Pahang,3,3,0,United Kingdom
46477,4/1/2022,GBR,Perak,12,8,4,United Kingdom
46478,4/1/2022,GBR,Perlis,1,1,0,United Kingdom
46479,4/1/2022,GBR,Pulau Pinang,434,241,193,United Kingdom
46480,4/1/2022,GBR,Sabah,61,35,26,United Kingdom
46481,4/1/2022,GBR,Sarawak,26,21,5,United Kingdom
46482,4/1/2022,GBR,Selangor,5778,3741,2037,United Kingdom
46483,4/1/2022,GBR,Terengganu,1,1,0,United Kingdom
46484,4/1/2022,GBR,W.P. Labuan,0,0,0,United Kingdom
46485,4/1/2022,GEO,Johor,3,1,2,Georgia
46486,4/1/2022,GEO,Kedah,0,0,0,Georgia
46487,4/1/2022,GEO,Melaka,0,0,0,Georgia
46488,4/1/2022,GEO,Perak,0,0,0,Georgia
46489,4/1/2022,GEO,Perlis,0,0,0,Georgia
46490,4/1/2022,GEO,Pulau Pinang,0,0,0,Georgia
46491,4/1/2022,GEO,Sabah,0,0,0,Georgia
46492,4/1/2022,GEO,Sarawak,0,0,0,Georgia
46493,4/1/2022,GEO,Selangor,9,7,2,Georgia
46494,4/1/2022,GHA,Johor,3,0,3,Ghana
46495,4/1/2022,GHA,Kedah,0,0,0,Ghana
46496,4/1/2022,GHA,Kelantan,0,0,0,Ghana
46497,4/1/2022,GHA,Pulau Pinang,0,0,0,Ghana
46498,4/1/2022,GHA,Sabah,0,0,0,Ghana
46499,4/1/2022,GHA,Sarawak,0,0,0,Ghana
46500,4/1/2022,GHA,Selangor,13,11,2,Ghana
46501,4/1/2022,GIB,Johor,0,0,0,Gibraltar
46502,4/1/2022,GIB,Sarawak,0,0,0,Gibraltar
46503,4/1/2022,GIN,Johor,0,0,0,Guinea
46504,4/1/2022,GIN,Kedah,0,0,0,Guinea
46505,4/1/2022,GIN,Kelantan,0,0,0,Guinea
46506,4/1/2022,GIN,Perlis,0,0,0,Guinea
46507,4/1/2022,GIN,Pulau Pinang,0,0,0,Guinea
46508,4/1/2022,GIN,Sabah,0,0,0,Guinea
46509,4/1/2022,GIN,Sarawak,0,0,0,Guinea
46510,4/1/2022,GIN,Selangor,14,10,4,Guinea
46511,4/1/2022,GLP,Selangor,0,0,0,Guadeloupe
46512,4/1/2022,GMB,Johor,0,0,0,Gambia
46513,4/1/2022,GMB,Kedah,0,0,0,Gambia
46514,4/1/2022,GMB,Kelantan,0,0,0,Gambia
46515,4/1/2022,GMB,Pulau Pinang,0,0,0,Gambia
46516,4/1/2022,GMB,Sabah,0,0,0,Gambia
46517,4/1/2022,GMB,Sarawak,0,0,0,Gambia
46518,4/1/2022,GMB,Selangor,13,5,8,Gambia
46519,4/1/2022,GNB,Johor,0,0,0,Guinea-Bissau
46520,4/1/2022,GNB,Selangor,0,0,0,Guinea-Bissau
46521,4/1/2022,GNQ,Johor,0,0,0,Equatorial Guinea
46522,4/1/2022,GNQ,Selangor,0,0,0,Equatorial Guinea
46523,4/1/2022,GRC,Johor,22,16,6,Greece
46524,4/1/2022,GRC,Kedah,3,2,1,Greece
46525,4/1/2022,GRC,Kelantan,0,0,0,Greece
46526,4/1/2022,GRC,Melaka,0,0,0,Greece
46527,4/1/2022,GRC,Negeri Sembilan,0,0,0,Greece
46528,4/1/2022,GRC,Pahang,0,0,0,Greece
46529,4/1/2022,GRC,Perak,0,0,0,Greece
46530,4/1/2022,GRC,Perlis,0,0,0,Greece
46531,4/1/2022,GRC,Pulau Pinang,1,1,0,Greece
46532,4/1/2022,GRC,Sabah,0,0,0,Greece
46533,4/1/2022,GRC,Sarawak,0,0,0,Greece
46534,4/1/2022,GRC,Selangor,59,48,11,Greece
46535,4/1/2022,GRD,Johor,4,3,1,Grenada
46536,4/1/2022,GRD,Kedah,0,0,0,Grenada
46537,4/1/2022,GRD,Pulau Pinang,0,0,0,Grenada
46538,4/1/2022,GRD,Sabah,0,0,0,Grenada
46539,4/1/2022,GRD,Sarawak,0,0,0,Grenada
46540,4/1/2022,GRD,Selangor,6,5,1,Grenada
46541,4/1/2022,GRL,Johor,0,0,0,Greenland
46542,4/1/2022,GRL,Selangor,0,0,0,Greenland
46543,4/1/2022,GTM,Johor,0,0,0,Guatemala
46544,4/1/2022,GTM,Kedah,0,0,0,Guatemala
46545,4/1/2022,GTM,Pahang,0,0,0,Guatemala
46546,4/1/2022,GTM,Perak,0,0,0,Guatemala
46547,4/1/2022,GTM,Pulau Pinang,0,0,0,Guatemala
46548,4/1/2022,GTM,Sabah,0,0,0,Guatemala
46549,4/1/2022,GTM,Sarawak,0,0,0,Guatemala
46550,4/1/2022,GTM,Selangor,7,5,2,Guatemala
46551,4/1/2022,GTM,W.P. Labuan,0,0,0,Guatemala
46552,4/1/2022,GUY,Johor,0,0,0,Guyana
46553,4/1/2022,GUY,Kedah,0,0,0,Guyana
46554,4/1/2022,GUY,Pulau Pinang,0,0,0,Guyana
46555,4/1/2022,GUY,Sarawak,0,0,0,Guyana
46556,4/1/2022,GUY,Selangor,0,0,0,Guyana
46557,4/1/2022,HKG,Johor,2,2,0,Hong Kong
46558,4/1/2022,HKG,Kedah,12,3,9,Hong Kong
46559,4/1/2022,HKG,Kelantan,0,0,0,Hong Kong
46560,4/1/2022,HKG,Pahang,0,0,0,Hong Kong
46561,4/1/2022,HKG,Perak,3,1,2,Hong Kong
46562,4/1/2022,HKG,Perlis,0,0,0,Hong Kong
46563,4/1/2022,HKG,Pulau Pinang,60,32,28,Hong Kong
46564,4/1/2022,HKG,Sabah,3,1,2,Hong Kong
46565,4/1/2022,HKG,Sarawak,24,15,9,Hong Kong
46566,4/1/2022,HKG,Selangor,5,4,1,Hong Kong
46567,4/1/2022,HKG,Terengganu,0,0,0,Hong Kong
46568,4/1/2022,HMD,Johor,0,0,0,Heard Island and McDonald Islands
46569,4/1/2022,HND,Johor,3,2,1,Honduras
46570,4/1/2022,HND,Kedah,0,0,0,Honduras
46571,4/1/2022,HND,Perak,0,0,0,Honduras
46572,4/1/2022,HND,Pulau Pinang,0,0,0,Honduras
46573,4/1/2022,HND,Sabah,0,0,0,Honduras
46574,4/1/2022,HND,Sarawak,0,0,0,Honduras
46575,4/1/2022,HND,Selangor,10,6,4,Honduras
46576,4/1/2022,HRV,Johor,8,6,2,Croatia
46577,4/1/2022,HRV,Kedah,0,0,0,Croatia
46578,4/1/2022,HRV,Kelantan,0,0,0,Croatia
46579,4/1/2022,HRV,Melaka,0,0,0,Croatia
46580,4/1/2022,HRV,Pahang,0,0,0,Croatia
46581,4/1/2022,HRV,Perak,0,0,0,Croatia
46582,4/1/2022,HRV,Perlis,0,0,0,Croatia
46583,4/1/2022,HRV,Pulau Pinang,2,0,2,Croatia
46584,4/1/2022,HRV,Sabah,0,0,0,Croatia
46585,4/1/2022,HRV,Sarawak,0,0,0,Croatia
46586,4/1/2022,HRV,Selangor,48,34,14,Croatia
46587,4/1/2022,HTI,Johor,0,0,0,Haiti
46588,4/1/2022,HTI,Kedah,0,0,0,Haiti
46589,4/1/2022,HTI,Kelantan,0,0,0,Haiti
46590,4/1/2022,HTI,Perak,0,0,0,Haiti
46591,4/1/2022,HTI,Pulau Pinang,0,0,0,Haiti
46592,4/1/2022,HTI,Sabah,0,0,0,Haiti
46593,4/1/2022,HTI,Selangor,0,0,0,Haiti
46594,4/1/2022,HUN,Johor,36,20,16,Hungary
46595,4/1/2022,HUN,Kedah,5,3,2,Hungary
46596,4/1/2022,HUN,Kelantan,0,0,0,Hungary
46597,4/1/2022,HUN,Pahang,0,0,0,Hungary
46598,4/1/2022,HUN,Perak,0,0,0,Hungary
46599,4/1/2022,HUN,Perlis,0,0,0,Hungary
46600,4/1/2022,HUN,Pulau Pinang,1,0,1,Hungary
46601,4/1/2022,HUN,Sabah,10,5,5,Hungary
46602,4/1/2022,HUN,Sarawak,2,2,0,Hungary
46603,4/1/2022,HUN,Selangor,73,40,33,Hungary
46604,4/1/2022,HUN,W.P. Labuan,0,0,0,Hungary
46605,4/1/2022,IDN,Johor,13063,4386,8677,Indonesia
46606,4/1/2022,IDN,Kedah,33,17,16,Indonesia
46607,4/1/2022,IDN,Kelantan,0,0,0,Indonesia
46608,4/1/2022,IDN,Melaka,10,10,0,Indonesia
46609,4/1/2022,IDN,Negeri Sembilan,0,0,0,Indonesia
46610,4/1/2022,IDN,Pahang,9,9,0,Indonesia
46611,4/1/2022,IDN,Perak,16,4,12,Indonesia
46612,4/1/2022,IDN,Perlis,0,0,0,Indonesia
46613,4/1/2022,IDN,Pulau Pinang,2382,999,1383,Indonesia
46614,4/1/2022,IDN,Sabah,953,516,437,Indonesia
46615,4/1/2022,IDN,Sarawak,1670,1087,583,Indonesia
46616,4/1/2022,IDN,Selangor,17630,8318,9312,Indonesia
46617,4/1/2022,IDN,Terengganu,0,0,0,Indonesia
46618,4/1/2022,IDN,W.P. Labuan,10,9,1,Indonesia
46619,4/1/2022,IND,Johor,2938,2074,864,India
46620,4/1/2022,IND,Kedah,87,44,43,India
46621,4/1/2022,IND,Kelantan,0,0,0,India
46622,4/1/2022,IND,Melaka,0,0,0,India
46623,4/1/2022,IND,Negeri Sembilan,0,0,0,India
46624,4/1/2022,IND,Pahang,0,0,0,India
46625,4/1/2022,IND,Perak,9,7,2,India
46626,4/1/2022,IND,Perlis,0,0,0,India
46627,4/1/2022,IND,Pulau Pinang,180,125,55,India
46628,4/1/2022,IND,Sabah,64,34,30,India
46629,4/1/2022,IND,Sarawak,13,10,3,India
46630,4/1/2022,IND,Selangor,13641,9834,3807,India
46631,4/1/2022,IND,Terengganu,0,0,0,India
46632,4/1/2022,IND,W.P. Labuan,1,1,0,India
46633,4/1/2022,IOT,Pulau Pinang,0,0,0,British Indian Ocean Territory
46634,4/1/2022,IOT,Selangor,0,0,0,British Indian Ocean Territory
46635,4/1/2022,IRL,Johor,109,81,28,Ireland
46636,4/1/2022,IRL,Kedah,7,2,5,Ireland
46637,4/1/2022,IRL,Kelantan,0,0,0,Ireland
46638,4/1/2022,IRL,Negeri Sembilan,0,0,0,Ireland
46639,4/1/2022,IRL,Pahang,0,0,0,Ireland
46640,4/1/2022,IRL,Perak,1,0,1,Ireland
46641,4/1/2022,IRL,Perlis,0,0,0,Ireland
46642,4/1/2022,IRL,Pulau Pinang,37,28,9,Ireland
46643,4/1/2022,IRL,Sabah,4,2,2,Ireland
46644,4/1/2022,IRL,Sarawak,0,0,0,Ireland
46645,4/1/2022,IRL,Selangor,371,250,121,Ireland
46646,4/1/2022,IRL,Terengganu,0,0,0,Ireland
46647,4/1/2022,IRL,W.P. Labuan,0,0,0,Ireland
46648,4/1/2022,IRN,Johor,25,17,8,Iran
46649,4/1/2022,IRN,Kedah,0,0,0,Iran
46650,4/1/2022,IRN,Kelantan,0,0,0,Iran
46651,4/1/2022,IRN,Perak,0,0,0,Iran
46652,4/1/2022,IRN,Perlis,0,0,0,Iran
46653,4/1/2022,IRN,Pulau Pinang,1,1,0,Iran
46654,4/1/2022,IRN,Sabah,0,0,0,Iran
46655,4/1/2022,IRN,Sarawak,0,0,0,Iran
46656,4/1/2022,IRN,Selangor,704,396,308,Iran
46657,4/1/2022,IRN,W.P. Labuan,0,0,0,Iran
46658,4/1/2022,IRQ,Johor,4,4,0,Iraq
46659,4/1/2022,IRQ,Kedah,0,0,0,Iraq
46660,4/1/2022,IRQ,Kelantan,0,0,0,Iraq
46661,4/1/2022,IRQ,Melaka,0,0,0,Iraq
46662,4/1/2022,IRQ,Pahang,0,0,0,Iraq
46663,4/1/2022,IRQ,Perak,0,0,0,Iraq
46664,4/1/2022,IRQ,Perlis,0,0,0,Iraq
46665,4/1/2022,IRQ,Pulau Pinang,0,0,0,Iraq
46666,4/1/2022,IRQ,Sabah,0,0,0,Iraq
46667,4/1/2022,IRQ,Sarawak,0,0,0,Iraq
46668,4/1/2022,IRQ,Selangor,443,296,147,Iraq
46669,4/1/2022,ISL,Johor,1,0,1,Iceland
46670,4/1/2022,ISL,Kedah,0,0,0,Iceland
46671,4/1/2022,ISL,Kelantan,0,0,0,Iceland
46672,4/1/2022,ISL,Perak,0,0,0,Iceland
46673,4/1/2022,ISL,Perlis,0,0,0,Iceland
46674,4/1/2022,ISL,Pulau Pinang,5,4,1,Iceland
46675,4/1/2022,ISL,Sabah,0,0,0,Iceland
46676,4/1/2022,ISL,Sarawak,0,0,0,Iceland
46677,4/1/2022,ISL,Selangor,7,4,3,Iceland
46678,4/1/2022,ISL,W.P. Labuan,0,0,0,Iceland
46679,4/1/2022,ISR,Pulau Pinang,0,0,0,Israel
46680,4/1/2022,ITA,Johor,250,162,88,Italy
46681,4/1/2022,ITA,Kedah,10,5,5,Italy
46682,4/1/2022,ITA,Kelantan,0,0,0,Italy
46683,4/1/2022,ITA,Melaka,0,0,0,Italy
46684,4/1/2022,ITA,Negeri Sembilan,0,0,0,Italy
46685,4/1/2022,ITA,Pahang,0,0,0,Italy
46686,4/1/2022,ITA,Perak,1,0,1,Italy
46687,4/1/2022,ITA,Perlis,0,0,0,Italy
46688,4/1/2022,ITA,Pulau Pinang,33,29,4,Italy
46689,4/1/2022,ITA,Sabah,4,3,1,Italy
46690,4/1/2022,ITA,Sarawak,3,3,0,Italy
46691,4/1/2022,ITA,Selangor,551,433,118,Italy
46692,4/1/2022,ITA,W.P. Labuan,0,0,0,Italy
46693,4/1/2022,JAM,Johor,0,0,0,Jamaica
46694,4/1/2022,JAM,Kedah,0,0,0,Jamaica
46695,4/1/2022,JAM,Perak,0,0,0,Jamaica
46696,4/1/2022,JAM,Pulau Pinang,2,0,2,Jamaica
46697,4/1/2022,JAM,Sabah,0,0,0,Jamaica
46698,4/1/2022,JAM,Sarawak,0,0,0,Jamaica
46699,4/1/2022,JAM,Selangor,2,1,1,Jamaica
46700,4/1/2022,JAM,W.P. Labuan,0,0,0,Jamaica
46701,4/1/2022,JOR,Johor,5,3,2,Jordan
46702,4/1/2022,JOR,Kedah,0,0,0,Jordan
46703,4/1/2022,JOR,Kelantan,0,0,0,Jordan
46704,4/1/2022,JOR,Melaka,0,0,0,Jordan
46705,4/1/2022,JOR,Perlis,0,0,0,Jordan
46706,4/1/2022,JOR,Pulau Pinang,0,0,0,Jordan
46707,4/1/2022,JOR,Sabah,0,0,0,Jordan
46708,4/1/2022,JOR,Sarawak,0,0,0,Jordan
46709,4/1/2022,JOR,Selangor,286,179,107,Jordan
46710,4/1/2022,JOR,W.P. Labuan,0,0,0,Jordan
46711,4/1/2022,JPN,Johor,1387,964,423,Japan
46712,4/1/2022,JPN,Kedah,17,8,9,Japan
46713,4/1/2022,JPN,Kelantan,0,0,0,Japan
46714,4/1/2022,JPN,Melaka,0,0,0,Japan
46715,4/1/2022,JPN,Negeri Sembilan,0,0,0,Japan
46716,4/1/2022,JPN,Pahang,0,0,0,Japan
46717,4/1/2022,JPN,Perak,1,1,0,Japan
46718,4/1/2022,JPN,Perlis,0,0,0,Japan
46719,4/1/2022,JPN,Pulau Pinang,228,148,80,Japan
46720,4/1/2022,JPN,Sabah,41,23,18,Japan
46721,4/1/2022,JPN,Sarawak,8,5,3,Japan
46722,4/1/2022,JPN,Selangor,3673,2445,1228,Japan
46723,4/1/2022,JPN,W.P. Labuan,0,0,0,Japan
46724,4/1/2022,KAZ,Johor,14,6,8,Kazakhstan
46725,4/1/2022,KAZ,Kedah,1,0,1,Kazakhstan
46726,4/1/2022,KAZ,Kelantan,0,0,0,Kazakhstan
46727,4/1/2022,KAZ,Melaka,0,0,0,Kazakhstan
46728,4/1/2022,KAZ,Perak,0,0,0,Kazakhstan
46729,4/1/2022,KAZ,Perlis,0,0,0,Kazakhstan
46730,4/1/2022,KAZ,Pulau Pinang,2,2,0,Kazakhstan
46731,4/1/2022,KAZ,Sabah,0,0,0,Kazakhstan
46732,4/1/2022,KAZ,Sarawak,1,0,1,Kazakhstan
46733,4/1/2022,KAZ,Selangor,173,69,104,Kazakhstan
46734,4/1/2022,KAZ,W.P. Labuan,0,0,0,Kazakhstan
46735,4/1/2022,KEN,Johor,5,4,1,Kenya
46736,4/1/2022,KEN,Kedah,1,0,1,Kenya
46737,4/1/2022,KEN,Kelantan,0,0,0,Kenya
46738,4/1/2022,KEN,Perak,0,0,0,Kenya
46739,4/1/2022,KEN,Perlis,0,0,0,Kenya
46740,4/1/2022,KEN,Pulau Pinang,0,0,0,Kenya
46741,4/1/2022,KEN,Sabah,1,0,1,Kenya
46742,4/1/2022,KEN,Sarawak,0,0,0,Kenya
46743,4/1/2022,KEN,Selangor,111,57,54,Kenya
46744,4/1/2022,KGZ,Johor,3,1,2,Kyrgyzstan
46745,4/1/2022,KGZ,Kedah,0,0,0,Kyrgyzstan
46746,4/1/2022,KGZ,Kelantan,0,0,0,Kyrgyzstan
46747,4/1/2022,KGZ,Perak,0,0,0,Kyrgyzstan
46748,4/1/2022,KGZ,Perlis,0,0,0,Kyrgyzstan
46749,4/1/2022,KGZ,Pulau Pinang,0,0,0,Kyrgyzstan
46750,4/1/2022,KGZ,Sabah,0,0,0,Kyrgyzstan
46751,4/1/2022,KGZ,Sarawak,0,0,0,Kyrgyzstan
46752,4/1/2022,KGZ,Selangor,108,70,38,Kyrgyzstan
46753,4/1/2022,KHM,Johor,41,17,24,Cambodia
46754,4/1/2022,KHM,Kedah,2,2,0,Cambodia
46755,4/1/2022,KHM,Kelantan,0,0,0,Cambodia
46756,4/1/2022,KHM,Melaka,6,0,6,Cambodia
46757,4/1/2022,KHM,Negeri Sembilan,0,0,0,Cambodia
46758,4/1/2022,KHM,Pahang,0,0,0,Cambodia
46759,4/1/2022,KHM,Perak,0,0,0,Cambodia
46760,4/1/2022,KHM,Perlis,0,0,0,Cambodia
46761,4/1/2022,KHM,Pulau Pinang,7,4,3,Cambodia
46762,4/1/2022,KHM,Sabah,0,0,0,Cambodia
46763,4/1/2022,KHM,Sarawak,0,0,0,Cambodia
46764,4/1/2022,KHM,Selangor,942,600,342,Cambodia
46765,4/1/2022,KHM,W.P. Labuan,0,0,0,Cambodia
46766,4/1/2022,KIR,Johor,0,0,0,Kiribati
46767,4/1/2022,KIR,Sabah,0,0,0,Kiribati
46768,4/1/2022,KIR,Selangor,0,0,0,Kiribati
46769,4/1/2022,KNA,Johor,10,8,2,Saint Kitts and Nevis
46770,4/1/2022,KNA,Kedah,0,0,0,Saint Kitts and Nevis
46771,4/1/2022,KNA,Perlis,0,0,0,Saint Kitts and Nevis
46772,4/1/2022,KNA,Pulau Pinang,0,0,0,Saint Kitts and Nevis
46773,4/1/2022,KNA,Sabah,0,0,0,Saint Kitts and Nevis
46774,4/1/2022,KNA,Selangor,19,13,6,Saint Kitts and Nevis
46775,4/1/2022,KNA,W.P. Labuan,0,0,0,Saint Kitts and Nevis
46776,4/1/2022,KOR,Johor,2176,1330,846,"Korea, Republic of (South Korea)"
46777,4/1/2022,KOR,Kedah,21,7,14,"Korea, Republic of (South Korea)"
46778,4/1/2022,KOR,Kelantan,0,0,0,"Korea, Republic of (South Korea)"
46779,4/1/2022,KOR,Melaka,0,0,0,"Korea, Republic of (South Korea)"
46780,4/1/2022,KOR,Negeri Sembilan,0,0,0,"Korea, Republic of (South Korea)"
46781,4/1/2022,KOR,Pahang,0,0,0,"Korea, Republic of (South Korea)"
46782,4/1/2022,KOR,Perak,2,2,0,"Korea, Republic of (South Korea)"
46783,4/1/2022,KOR,Perlis,0,0,0,"Korea, Republic of (South Korea)"
46784,4/1/2022,KOR,Pulau Pinang,78,46,32,"Korea, Republic of (South Korea)"
46785,4/1/2022,KOR,Sabah,30,13,17,"Korea, Republic of (South Korea)"
46786,4/1/2022,KOR,Sarawak,35,30,5,"Korea, Republic of (South Korea)"
46787,4/1/2022,KOR,Selangor,3246,2236,1010,"Korea, Republic of (South Korea)"
46788,4/1/2022,KOR,Terengganu,0,0,0,"Korea, Republic of (South Korea)"
46789,4/1/2022,KOR,W.P. Labuan,0,0,0,"Korea, Republic of (South Korea)"
46790,4/1/2022,KWT,Johor,0,0,0,Kuwait
46791,4/1/2022,KWT,Kedah,0,0,0,Kuwait
46792,4/1/2022,KWT,Kelantan,0,0,0,Kuwait
46793,4/1/2022,KWT,Perak,0,0,0,Kuwait
46794,4/1/2022,KWT,Perlis,0,0,0,Kuwait
46795,4/1/2022,KWT,Pulau Pinang,0,0,0,Kuwait
46796,4/1/2022,KWT,Sabah,0,0,0,Kuwait
46797,4/1/2022,KWT,Sarawak,0,0,0,Kuwait
46798,4/1/2022,KWT,Selangor,89,48,41,Kuwait
46799,4/1/2022,KWT,W.P. Labuan,0,0,0,Kuwait
46800,4/1/2022,LAO,Johor,6,0,6,Lao People's Democratic Republic
46801,4/1/2022,LAO,Kedah,16,3,13,Lao People's Democratic Republic
46802,4/1/2022,LAO,Kelantan,0,0,0,Lao People's Democratic Republic
46803,4/1/2022,LAO,Melaka,0,0,0,Lao People's Democratic Republic
46804,4/1/2022,LAO,Perak,0,0,0,Lao People's Democratic Republic
46805,4/1/2022,LAO,Perlis,0,0,0,Lao People's Democratic Republic
46806,4/1/2022,LAO,Pulau Pinang,1,0,1,Lao People's Democratic Republic
46807,4/1/2022,LAO,Sabah,0,0,0,Lao People's Democratic Republic
46808,4/1/2022,LAO,Sarawak,0,0,0,Lao People's Democratic Republic
46809,4/1/2022,LAO,Selangor,270,248,22,Lao People's Democratic Republic
46810,4/1/2022,LAO,W.P. Labuan,0,0,0,Lao People's Democratic Republic
46811,4/1/2022,LBN,Johor,5,3,2,Lebanon
46812,4/1/2022,LBN,Kedah,1,1,0,Lebanon
46813,4/1/2022,LBN,Kelantan,0,0,0,Lebanon
46814,4/1/2022,LBN,Pahang,0,0,0,Lebanon
46815,4/1/2022,LBN,Perak,0,0,0,Lebanon
46816,4/1/2022,LBN,Perlis,0,0,0,Lebanon
46817,4/1/2022,LBN,Pulau Pinang,5,1,4,Lebanon
46818,4/1/2022,LBN,Sabah,0,0,0,Lebanon
46819,4/1/2022,LBN,Sarawak,0,0,0,Lebanon
46820,4/1/2022,LBN,Selangor,91,57,34,Lebanon
46821,4/1/2022,LBN,W.P. Labuan,0,0,0,Lebanon
46822,4/1/2022,LBR,Johor,0,0,0,Liberia
46823,4/1/2022,LBR,Kedah,0,0,0,Liberia
46824,4/1/2022,LBR,Sabah,0,0,0,Liberia
46825,4/1/2022,LBR,Sarawak,0,0,0,Liberia
46826,4/1/2022,LBR,Selangor,0,0,0,Liberia
46827,4/1/2022,LBY,Johor,0,0,0,Libyan Arab Jamahiriya
46828,4/1/2022,LBY,Kedah,0,0,0,Libyan Arab Jamahiriya
46829,4/1/2022,LBY,Perlis,0,0,0,Libyan Arab Jamahiriya
46830,4/1/2022,LBY,Pulau Pinang,0,0,0,Libyan Arab Jamahiriya
46831,4/1/2022,LBY,Sabah,0,0,0,Libyan Arab Jamahiriya
46832,4/1/2022,LBY,Sarawak,0,0,0,Libyan Arab Jamahiriya
46833,4/1/2022,LBY,Selangor,133,84,49,Libyan Arab Jamahiriya
46834,4/1/2022,LCA,Johor,2,2,0,Saint Lucia
46835,4/1/2022,LCA,Kedah,0,0,0,Saint Lucia
46836,4/1/2022,LCA,Pulau Pinang,0,0,0,Saint Lucia
46837,4/1/2022,LCA,Sarawak,0,0,0,Saint Lucia
46838,4/1/2022,LCA,Selangor,1,1,0,Saint Lucia
46839,4/1/2022,LIE,Johor,0,0,0,Liechtenstein
46840,4/1/2022,LIE,Kedah,0,0,0,Liechtenstein
46841,4/1/2022,LIE,Perlis,0,0,0,Liechtenstein
46842,4/1/2022,LIE,Pulau Pinang,0,0,0,Liechtenstein
46843,4/1/2022,LIE,Sabah,0,0,0,Liechtenstein
46844,4/1/2022,LIE,Sarawak,0,0,0,Liechtenstein
46845,4/1/2022,LIE,Selangor,1,1,0,Liechtenstein
46846,4/1/2022,LKA,Johor,189,132,57,Sri Lanka
46847,4/1/2022,LKA,Kedah,0,0,0,Sri Lanka
46848,4/1/2022,LKA,Kelantan,0,0,0,Sri Lanka
46849,4/1/2022,LKA,Melaka,0,0,0,Sri Lanka
46850,4/1/2022,LKA,Pahang,0,0,0,Sri Lanka
46851,4/1/2022,LKA,Perak,0,0,0,Sri Lanka
46852,4/1/2022,LKA,Perlis,0,0,0,Sri Lanka
46853,4/1/2022,LKA,Pulau Pinang,4,3,1,Sri Lanka
46854,4/1/2022,LKA,Sabah,0,0,0,Sri Lanka
46855,4/1/2022,LKA,Sarawak,1,0,1,Sri Lanka
46856,4/1/2022,LKA,Selangor,1035,605,430,Sri Lanka
46857,4/1/2022,LKA,W.P. Labuan,0,0,0,Sri Lanka
46858,4/1/2022,LSO,Johor,0,0,0,Lesotho
46859,4/1/2022,LSO,Kedah,0,0,0,Lesotho
46860,4/1/2022,LSO,Pulau Pinang,0,0,0,Lesotho
46861,4/1/2022,LSO,Sarawak,0,0,0,Lesotho
46862,4/1/2022,LSO,Selangor,5,0,5,Lesotho
46863,4/1/2022,LTU,Johor,5,4,1,Lithuania
46864,4/1/2022,LTU,Kedah,2,0,2,Lithuania
46865,4/1/2022,LTU,Kelantan,0,0,0,Lithuania
46866,4/1/2022,LTU,Pahang,0,0,0,Lithuania
46867,4/1/2022,LTU,Perak,0,0,0,Lithuania
46868,4/1/2022,LTU,Perlis,0,0,0,Lithuania
46869,4/1/2022,LTU,Pulau Pinang,0,0,0,Lithuania
46870,4/1/2022,LTU,Sabah,0,0,0,Lithuania
46871,4/1/2022,LTU,Sarawak,2,1,1,Lithuania
46872,4/1/2022,LTU,Selangor,54,28,26,Lithuania
46873,4/1/2022,LTU,W.P. Labuan,0,0,0,Lithuania
46874,4/1/2022,LUX,Johor,2,1,1,Luxembourg
46875,4/1/2022,LUX,Kedah,0,0,0,Luxembourg
46876,4/1/2022,LUX,Kelantan,0,0,0,Luxembourg
46877,4/1/2022,LUX,Perak,0,0,0,Luxembourg
46878,4/1/2022,LUX,Perlis,0,0,0,Luxembourg
46879,4/1/2022,LUX,Pulau Pinang,1,1,0,Luxembourg
46880,4/1/2022,LUX,Sabah,0,0,0,Luxembourg
46881,4/1/2022,LUX,Sarawak,0,0,0,Luxembourg
46882,4/1/2022,LUX,Selangor,10,8,2,Luxembourg
46883,4/1/2022,LVA,Johor,4,1,3,Latvia
46884,4/1/2022,LVA,Kedah,1,1,0,Latvia
46885,4/1/2022,LVA,Kelantan,0,0,0,Latvia
46886,4/1/2022,LVA,Pahang,0,0,0,Latvia
46887,4/1/2022,LVA,Perak,0,0,0,Latvia
46888,4/1/2022,LVA,Perlis,0,0,0,Latvia
46889,4/1/2022,LVA,Pulau Pinang,2,0,2,Latvia
46890,4/1/2022,LVA,Sabah,1,0,1,Latvia
46891,4/1/2022,LVA,Sarawak,0,0,0,Latvia
46892,4/1/2022,LVA,Selangor,24,13,11,Latvia
46893,4/1/2022,LVA,W.P. Labuan,0,0,0,Latvia
46894,4/1/2022,MAC,Johor,0,0,0,Macao
46895,4/1/2022,MAC,Pahang,0,0,0,Macao
46896,4/1/2022,MAC,Perak,0,0,0,Macao
46897,4/1/2022,MAC,Selangor,0,0,0,Macao
46898,4/1/2022,MAC,W.P. Labuan,0,0,0,Macao
46899,4/1/2022,MAR,Johor,26,15,11,Morocco
46900,4/1/2022,MAR,Kedah,1,1,0,Morocco
46901,4/1/2022,MAR,Kelantan,0,0,0,Morocco
46902,4/1/2022,MAR,Melaka,0,0,0,Morocco
46903,4/1/2022,MAR,Pahang,0,0,0,Morocco
46904,4/1/2022,MAR,Perak,0,0,0,Morocco
46905,4/1/2022,MAR,Perlis,0,0,0,Morocco
46906,4/1/2022,MAR,Pulau Pinang,1,1,0,Morocco
46907,4/1/2022,MAR,Sabah,0,0,0,Morocco
46908,4/1/2022,MAR,Sarawak,0,0,0,Morocco
46909,4/1/2022,MAR,Selangor,108,46,62,Morocco
46910,4/1/2022,MAR,W.P. Labuan,0,0,0,Morocco
46911,4/1/2022,MCO,Johor,0,0,0,Monaco
46912,4/1/2022,MCO,Kedah,0,0,0,Monaco
46913,4/1/2022,MCO,Sabah,0,0,0,Monaco
46914,4/1/2022,MCO,Selangor,0,0,0,Monaco
46915,4/1/2022,MDA,Johor,0,0,0,"Moldova, Republic of"
46916,4/1/2022,MDA,Kedah,0,0,0,"Moldova, Republic of"
46917,4/1/2022,MDA,Kelantan,0,0,0,"Moldova, Republic of"
46918,4/1/2022,MDA,Negeri Sembilan,0,0,0,"Moldova, Republic of"
46919,4/1/2022,MDA,Perlis,0,0,0,"Moldova, Republic of"
46920,4/1/2022,MDA,Pulau Pinang,0,0,0,"Moldova, Republic of"
46921,4/1/2022,MDA,Sabah,0,0,0,"Moldova, Republic of"
46922,4/1/2022,MDA,Sarawak,0,0,0,"Moldova, Republic of"
46923,4/1/2022,MDA,Selangor,12,3,9,"Moldova, Republic of"
46924,4/1/2022,MDG,Johor,0,0,0,Madagascar
46925,4/1/2022,MDG,Kedah,0,0,0,Madagascar
46926,4/1/2022,MDG,Perak,0,0,0,Madagascar
46927,4/1/2022,MDG,Perlis,0,0,0,Madagascar
46928,4/1/2022,MDG,Pulau Pinang,0,0,0,Madagascar
46929,4/1/2022,MDG,Sabah,0,0,0,Madagascar
46930,4/1/2022,MDG,Sarawak,0,0,0,Madagascar
46931,4/1/2022,MDG,Selangor,3,1,2,Madagascar
46932,4/1/2022,MDV,Johor,32,24,8,Maldives
46933,4/1/2022,MDV,Kedah,1,1,0,Maldives
46934,4/1/2022,MDV,Kelantan,0,0,0,Maldives
46935,4/1/2022,MDV,Perak,0,0,0,Maldives
46936,4/1/2022,MDV,Perlis,0,0,0,Maldives
46937,4/1/2022,MDV,Pulau Pinang,0,0,0,Maldives
46938,4/1/2022,MDV,Sabah,0,0,0,Maldives
46939,4/1/2022,MDV,Sarawak,0,0,0,Maldives
46940,4/1/2022,MDV,Selangor,1020,535,485,Maldives
46941,4/1/2022,MEX,Johor,34,20,14,Mexico
46942,4/1/2022,MEX,Kedah,2,1,1,Mexico
46943,4/1/2022,MEX,Kelantan,0,0,0,Mexico
46944,4/1/2022,MEX,Pahang,0,0,0,Mexico
46945,4/1/2022,MEX,Perak,0,0,0,Mexico
46946,4/1/2022,MEX,Perlis,0,0,0,Mexico
46947,4/1/2022,MEX,Pulau Pinang,9,7,2,Mexico
46948,4/1/2022,MEX,Sabah,4,3,1,Mexico
46949,4/1/2022,MEX,Sarawak,1,1,0,Mexico
46950,4/1/2022,MEX,Selangor,115,71,44,Mexico
46951,4/1/2022,MEX,W.P. Labuan,0,0,0,Mexico
46952,4/1/2022,MHL,Johor,2,2,0,Marshall Islands
46953,4/1/2022,MHL,Kedah,0,0,0,Marshall Islands
46954,4/1/2022,MHL,Perak,0,0,0,Marshall Islands
46955,4/1/2022,MHL,Pulau Pinang,0,0,0,Marshall Islands
46956,4/1/2022,MHL,Sabah,0,0,0,Marshall Islands
46957,4/1/2022,MHL,Selangor,0,0,0,Marshall Islands
46958,4/1/2022,MKD,Johor,1,0,1,"Macedonia, the former Yugoslav Republic of"
46959,4/1/2022,MKD,Kedah,0,0,0,"Macedonia, the former Yugoslav Republic of"
46960,4/1/2022,MKD,Perak,0,0,0,"Macedonia, the former Yugoslav Republic of"
46961,4/1/2022,MKD,Pulau Pinang,2,2,0,"Macedonia, the former Yugoslav Republic of"
46962,4/1/2022,MKD,Sabah,0,0,0,"Macedonia, the former Yugoslav Republic of"
46963,4/1/2022,MKD,Sarawak,0,0,0,"Macedonia, the former Yugoslav Republic of"
46964,4/1/2022,MKD,Selangor,7,2,5,"Macedonia, the former Yugoslav Republic of"
46965,4/1/2022,MLI,Johor,0,0,0,Mali
46966,4/1/2022,MLI,Sabah,0,0,0,Mali
46967,4/1/2022,MLI,Selangor,2,2,0,Mali
46968,4/1/2022,MLT,Johor,1,1,0,Malta
46969,4/1/2022,MLT,Kedah,0,0,0,Malta
46970,4/1/2022,MLT,Kelantan,0,0,0,Malta
46971,4/1/2022,MLT,Perak,0,0,0,Malta
46972,4/1/2022,MLT,Perlis,0,0,0,Malta
46973,4/1/2022,MLT,Pulau Pinang,0,0,0,Malta
46974,4/1/2022,MLT,Sabah,0,0,0,Malta
46975,4/1/2022,MLT,Sarawak,0,0,0,Malta
46976,4/1/2022,MLT,Selangor,10,7,3,Malta
46977,4/1/2022,MLT,W.P. Labuan,0,0,0,Malta
46978,4/1/2022,MMR,Johor,542,164,378,Myanmar
46979,4/1/2022,MMR,Kedah,3,2,1,Myanmar
46980,4/1/2022,MMR,Kelantan,0,0,0,Myanmar
46981,4/1/2022,MMR,Negeri Sembilan,0,0,0,Myanmar
46982,4/1/2022,MMR,Pahang,0,0,0,Myanmar
46983,4/1/2022,MMR,Perak,2,1,1,Myanmar
46984,4/1/2022,MMR,Perlis,0,0,0,Myanmar
46985,4/1/2022,MMR,Pulau Pinang,14,2,12,Myanmar
46986,4/1/2022,MMR,Sabah,3,1,2,Myanmar
46987,4/1/2022,MMR,Sarawak,3,1,2,Myanmar
46988,4/1/2022,MMR,Selangor,634,410,224,Myanmar
46989,4/1/2022,MMR,Terengganu,0,0,0,Myanmar
46990,4/1/2022,MMR,W.P. Labuan,0,0,0,Myanmar
46991,4/1/2022,MNE,Johor,0,0,0,Montenegro
46992,4/1/2022,MNE,Kedah,0,0,0,Montenegro
46993,4/1/2022,MNE,Pulau Pinang,0,0,0,Montenegro
46994,4/1/2022,MNE,Sabah,0,0,0,Montenegro
46995,4/1/2022,MNE,Sarawak,0,0,0,Montenegro
46996,4/1/2022,MNE,Selangor,4,3,1,Montenegro
46997,4/1/2022,MNG,Johor,14,5,9,Mongolia
46998,4/1/2022,MNG,Kedah,0,0,0,Mongolia
46999,4/1/2022,MNG,Kelantan,0,0,0,Mongolia
47000,4/1/2022,MNG,Perak,1,0,1,Mongolia
47001,4/1/2022,MNG,Perlis,0,0,0,Mongolia
47002,4/1/2022,MNG,Pulau Pinang,0,0,0,Mongolia
47003,4/1/2022,MNG,Sabah,0,0,0,Mongolia
47004,4/1/2022,MNG,Sarawak,0,0,0,Mongolia
47005,4/1/2022,MNG,Selangor,73,27,46,Mongolia
47006,4/1/2022,MNP,Selangor,0,0,0,Northern Mariana Islands
47007,4/1/2022,MOZ,Johor,0,0,0,Mozambique
47008,4/1/2022,MOZ,Kedah,0,0,0,Mozambique
47009,4/1/2022,MOZ,Perak,0,0,0,Mozambique
47010,4/1/2022,MOZ,Pulau Pinang,0,0,0,Mozambique
47011,4/1/2022,MOZ,Sabah,0,0,0,Mozambique
47012,4/1/2022,MOZ,Sarawak,0,0,0,Mozambique
47013,4/1/2022,MOZ,Selangor,9,7,2,Mozambique
47014,4/1/2022,MRT,Johor,0,0,0,Mauritania
47015,4/1/2022,MRT,Kedah,0,0,0,Mauritania
47016,4/1/2022,MRT,Pulau Pinang,0,0,0,Mauritania
47017,4/1/2022,MRT,Sabah,0,0,0,Mauritania
47018,4/1/2022,MRT,Sarawak,0,0,0,Mauritania
47019,4/1/2022,MRT,Selangor,9,9,0,Mauritania
47020,4/1/2022,MUS,Johor,21,9,12,Mauritius
47021,4/1/2022,MUS,Kedah,0,0,0,Mauritius
47022,4/1/2022,MUS,Kelantan,0,0,0,Mauritius
47023,4/1/2022,MUS,Pahang,0,0,0,Mauritius
47024,4/1/2022,MUS,Perak,0,0,0,Mauritius
47025,4/1/2022,MUS,Perlis,0,0,0,Mauritius
47026,4/1/2022,MUS,Pulau Pinang,0,0,0,Mauritius
47027,4/1/2022,MUS,Sabah,0,0,0,Mauritius
47028,4/1/2022,MUS,Sarawak,0,0,0,Mauritius
47029,4/1/2022,MUS,Selangor,73,40,33,Mauritius
47030,4/1/2022,MWI,Johor,0,0,0,Malawi
47031,4/1/2022,MWI,Pulau Pinang,0,0,0,Malawi
47032,4/1/2022,MWI,Sabah,0,0,0,Malawi
47033,4/1/2022,MWI,Sarawak,0,0,0,Malawi
47034,4/1/2022,MWI,Selangor,4,3,1,Malawi
47035,4/1/2022,MYT,Selangor,0,0,0,Mayotte
47036,4/1/2022,NAM,Johor,0,0,0,Namibia
47037,4/1/2022,NAM,Kedah,0,0,0,Namibia
47038,4/1/2022,NAM,Perak,0,0,0,Namibia
47039,4/1/2022,NAM,Perlis,0,0,0,Namibia
47040,4/1/2022,NAM,Pulau Pinang,0,0,0,Namibia
47041,4/1/2022,NAM,Sabah,0,0,0,Namibia
47042,4/1/2022,NAM,Sarawak,0,0,0,Namibia
47043,4/1/2022,NAM,Selangor,8,4,4,Namibia
47044,4/1/2022,NCL,Selangor,0,0,0,New Caledonia
47045,4/1/2022,NER,Johor,0,0,0,Niger
47046,4/1/2022,NER,Sabah,0,0,0,Niger
47047,4/1/2022,NER,Selangor,3,3,0,Niger
47048,4/1/2022,NGA,Johor,10,6,4,Nigeria
47049,4/1/2022,NGA,Kedah,0,0,0,Nigeria
47050,4/1/2022,NGA,Perlis,0,0,0,Nigeria
47051,4/1/2022,NGA,Pulau Pinang,2,2,0,Nigeria
47052,4/1/2022,NGA,Sabah,0,0,0,Nigeria
47053,4/1/2022,NGA,Sarawak,2,2,0,Nigeria
47054,4/1/2022,NGA,Selangor,249,192,57,Nigeria
47055,4/1/2022,NIC,Johor,1,0,1,Nicaragua
47056,4/1/2022,NIC,Kedah,0,0,0,Nicaragua
47057,4/1/2022,NIC,Pulau Pinang,0,0,0,Nicaragua
47058,4/1/2022,NIC,Sabah,0,0,0,Nicaragua
47059,4/1/2022,NIC,Selangor,4,1,3,Nicaragua
47060,4/1/2022,NLD,Johor,316,217,99,Netherlands
47061,4/1/2022,NLD,Kedah,34,21,13,Netherlands
47062,4/1/2022,NLD,Kelantan,0,0,0,Netherlands
47063,4/1/2022,NLD,Melaka,0,0,0,Netherlands
47064,4/1/2022,NLD,Negeri Sembilan,0,0,0,Netherlands
47065,4/1/2022,NLD,Pahang,0,0,0,Netherlands
47066,4/1/2022,NLD,Perak,0,0,0,Netherlands
47067,4/1/2022,NLD,Perlis,2,2,0,Netherlands
47068,4/1/2022,NLD,Pulau Pinang,65,48,17,Netherlands
47069,4/1/2022,NLD,Sabah,8,6,2,Netherlands
47070,4/1/2022,NLD,Sarawak,6,5,1,Netherlands
47071,4/1/2022,NLD,Selangor,1164,783,381,Netherlands
47072,4/1/2022,NLD,Terengganu,0,0,0,Netherlands
47073,4/1/2022,NLD,W.P. Labuan,0,0,0,Netherlands
47074,4/1/2022,NOR,Johor,65,44,21,Norway
47075,4/1/2022,NOR,Kedah,1,1,0,Norway
47076,4/1/2022,NOR,Kelantan,0,0,0,Norway
47077,4/1/2022,NOR,Melaka,0,0,0,Norway
47078,4/1/2022,NOR,Pahang,0,0,0,Norway
47079,4/1/2022,NOR,Perak,0,0,0,Norway
47080,4/1/2022,NOR,Perlis,0,0,0,Norway
47081,4/1/2022,NOR,Pulau Pinang,9,5,4,Norway
47082,4/1/2022,NOR,Sabah,0,0,0,Norway
47083,4/1/2022,NOR,Sarawak,0,0,0,Norway
47084,4/1/2022,NOR,Selangor,309,178,131,Norway
47085,4/1/2022,NOR,W.P. Labuan,0,0,0,Norway
47086,4/1/2022,NPL,Johor,18,16,2,Nepal
47087,4/1/2022,NPL,Kedah,2,1,1,Nepal
47088,4/1/2022,NPL,Pahang,0,0,0,Nepal
47089,4/1/2022,NPL,Perak,0,0,0,Nepal
47090,4/1/2022,NPL,Perlis,0,0,0,Nepal
47091,4/1/2022,NPL,Pulau Pinang,1,1,0,Nepal
47092,4/1/2022,NPL,Sabah,0,0,0,Nepal
47093,4/1/2022,NPL,Sarawak,0,0,0,Nepal
47094,4/1/2022,NPL,Selangor,2635,2464,171,Nepal
47095,4/1/2022,NPL,W.P. Labuan,0,0,0,Nepal
47096,4/1/2022,NRU,Johor,0,0,0,Nauru
47097,4/1/2022,NRU,Pulau Pinang,0,0,0,Nauru
47098,4/1/2022,NRU,Selangor,0,0,0,Nauru
47099,4/1/2022,NZL,Johor,177,119,58,New Zealand
47100,4/1/2022,NZL,Kedah,15,9,6,New Zealand
47101,4/1/2022,NZL,Kelantan,0,0,0,New Zealand
47102,4/1/2022,NZL,Melaka,0,0,0,New Zealand
47103,4/1/2022,NZL,Negeri Sembilan,0,0,0,New Zealand
47104,4/1/2022,NZL,Pahang,0,0,0,New Zealand
47105,4/1/2022,NZL,Perak,5,1,4,New Zealand
47106,4/1/2022,NZL,Perlis,0,0,0,New Zealand
47107,4/1/2022,NZL,Pulau Pinang,53,33,20,New Zealand
47108,4/1/2022,NZL,Sabah,5,2,3,New Zealand
47109,4/1/2022,NZL,Sarawak,12,10,2,New Zealand
47110,4/1/2022,NZL,Selangor,502,316,186,New Zealand
47111,4/1/2022,NZL,Terengganu,0,0,0,New Zealand
47112,4/1/2022,NZL,W.P. Labuan,0,0,0,New Zealand
47113,4/1/2022,OMN,Johor,0,0,0,Oman
47114,4/1/2022,OMN,Kedah,0,0,0,Oman
47115,4/1/2022,OMN,Kelantan,0,0,0,Oman
47116,4/1/2022,OMN,Melaka,0,0,0,Oman
47117,4/1/2022,OMN,Perak,0,0,0,Oman
47118,4/1/2022,OMN,Perlis,0,0,0,Oman
47119,4/1/2022,OMN,Pulau Pinang,0,0,0,Oman
47120,4/1/2022,OMN,Sabah,0,0,0,Oman
47121,4/1/2022,OMN,Sarawak,0,0,0,Oman
47122,4/1/2022,OMN,Selangor,149,88,61,Oman
47123,4/1/2022,PAK,Johor,140,119,21,Pakistan
47124,4/1/2022,PAK,Kedah,22,16,6,Pakistan
47125,4/1/2022,PAK,Kelantan,0,0,0,Pakistan
47126,4/1/2022,PAK,Melaka,0,0,0,Pakistan
47127,4/1/2022,PAK,Negeri Sembilan,0,0,0,Pakistan
47128,4/1/2022,PAK,Pahang,0,0,0,Pakistan
47129,4/1/2022,PAK,Perak,0,0,0,Pakistan
47130,4/1/2022,PAK,Perlis,0,0,0,Pakistan
47131,4/1/2022,PAK,Pulau Pinang,2,2,0,Pakistan
47132,4/1/2022,PAK,Sabah,0,0,0,Pakistan
47133,4/1/2022,PAK,Sarawak,1,1,0,Pakistan
47134,4/1/2022,PAK,Selangor,3638,3113,525,Pakistan
47135,4/1/2022,PAK,W.P. Labuan,0,0,0,Pakistan
47136,4/1/2022,PAN,Johor,2,1,1,Panama
47137,4/1/2022,PAN,Kedah,0,0,0,Panama
47138,4/1/2022,PAN,Perak,0,0,0,Panama
47139,4/1/2022,PAN,Perlis,0,0,0,Panama
47140,4/1/2022,PAN,Pulau Pinang,0,0,0,Panama
47141,4/1/2022,PAN,Sabah,0,0,0,Panama
47142,4/1/2022,PAN,Sarawak,0,0,0,Panama
47143,4/1/2022,PAN,Selangor,4,3,1,Panama
47144,4/1/2022,PER,Johor,8,5,3,Peru
47145,4/1/2022,PER,Kedah,0,0,0,Peru
47146,4/1/2022,PER,Kelantan,0,0,0,Peru
47147,4/1/2022,PER,Pahang,0,0,0,Peru
47148,4/1/2022,PER,Perak,0,0,0,Peru
47149,4/1/2022,PER,Perlis,0,0,0,Peru
47150,4/1/2022,PER,Pulau Pinang,5,2,3,Peru
47151,4/1/2022,PER,Sabah,0,0,0,Peru
47152,4/1/2022,PER,Sarawak,0,0,0,Peru
47153,4/1/2022,PER,Selangor,34,22,12,Peru
47154,4/1/2022,PER,W.P. Labuan,0,0,0,Peru
47155,4/1/2022,PHL,Johor,3228,845,2383,Philippines
47156,4/1/2022,PHL,Kedah,25,6,19,Philippines
47157,4/1/2022,PHL,Kelantan,0,0,0,Philippines
47158,4/1/2022,PHL,Melaka,0,0,0,Philippines
47159,4/1/2022,PHL,Negeri Sembilan,0,0,0,Philippines
47160,4/1/2022,PHL,Pahang,2,2,0,Philippines
47161,4/1/2022,PHL,Perak,7,4,3,Philippines
47162,4/1/2022,PHL,Perlis,0,0,0,Philippines
47163,4/1/2022,PHL,Pulau Pinang,108,49,59,Philippines
47164,4/1/2022,PHL,Sabah,9,4,5,Philippines
47165,4/1/2022,PHL,Sarawak,41,35,6,Philippines
47166,4/1/2022,PHL,Selangor,3792,1739,2053,Philippines
47167,4/1/2022,PHL,Terengganu,0,0,0,Philippines
47168,4/1/2022,PHL,W.P. Labuan,6,2,4,Philippines
47169,4/1/2022,PLW,Johor,0,0,0,Palau
47170,4/1/2022,PLW,Pulau Pinang,0,0,0,Palau
47171,4/1/2022,PLW,Selangor,0,0,0,Palau
47172,4/1/2022,PNG,Johor,2,1,1,Papua New Guinea
47173,4/1/2022,PNG,Kedah,0,0,0,Papua New Guinea
47174,4/1/2022,PNG,Kelantan,0,0,0,Papua New Guinea
47175,4/1/2022,PNG,Perak,0,0,0,Papua New Guinea
47176,4/1/2022,PNG,Pulau Pinang,1,1,0,Papua New Guinea
47177,4/1/2022,PNG,Sabah,0,0,0,Papua New Guinea
47178,4/1/2022,PNG,Sarawak,1,0,1,Papua New Guinea
47179,4/1/2022,PNG,Selangor,8,7,1,Papua New Guinea
47180,4/1/2022,POL,Johor,93,57,36,Poland
47181,4/1/2022,POL,Kedah,6,2,4,Poland
47182,4/1/2022,POL,Kelantan,0,0,0,Poland
47183,4/1/2022,POL,Melaka,0,0,0,Poland
47184,4/1/2022,POL,Negeri Sembilan,0,0,0,Poland
47185,4/1/2022,POL,Pahang,0,0,0,Poland
47186,4/1/2022,POL,Perak,0,0,0,Poland
47187,4/1/2022,POL,Perlis,0,0,0,Poland
47188,4/1/2022,POL,Pulau Pinang,11,5,6,Poland
47189,4/1/2022,POL,Sabah,1,1,0,Poland
47190,4/1/2022,POL,Sarawak,0,0,0,Poland
47191,4/1/2022,POL,Selangor,209,133,76,Poland
47192,4/1/2022,POL,Terengganu,0,0,0,Poland
47193,4/1/2022,POL,W.P. Labuan,0,0,0,Poland
47194,4/1/2022,PRK,Selangor,0,0,0,"Korea, Democratic People's Republic of"
47195,4/1/2022,PRT,Johor,79,48,31,Portugal
47196,4/1/2022,PRT,Kedah,13,9,4,Portugal
47197,4/1/2022,PRT,Kelantan,0,0,0,Portugal
47198,4/1/2022,PRT,Melaka,0,0,0,Portugal
47199,4/1/2022,PRT,Pahang,0,0,0,Portugal
47200,4/1/2022,PRT,Perak,0,0,0,Portugal
47201,4/1/2022,PRT,Perlis,0,0,0,Portugal
47202,4/1/2022,PRT,Pulau Pinang,14,5,9,Portugal
47203,4/1/2022,PRT,Sabah,1,0,1,Portugal
47204,4/1/2022,PRT,Sarawak,0,0,0,Portugal
47205,4/1/2022,PRT,Selangor,184,121,63,Portugal
47206,4/1/2022,PRT,W.P. Labuan,0,0,0,Portugal
47207,4/1/2022,PRY,Johor,1,0,1,Paraguay
47208,4/1/2022,PRY,Kedah,0,0,0,Paraguay
47209,4/1/2022,PRY,Perak,0,0,0,Paraguay
47210,4/1/2022,PRY,Perlis,0,0,0,Paraguay
47211,4/1/2022,PRY,Pulau Pinang,0,0,0,Paraguay
47212,4/1/2022,PRY,Sabah,0,0,0,Paraguay
47213,4/1/2022,PRY,Sarawak,0,0,0,Paraguay
47214,4/1/2022,PRY,Selangor,3,1,2,Paraguay
47215,4/1/2022,PSE,Johor,4,4,0,"Palestinian Territory, Occupied"
47216,4/1/2022,PSE,Kedah,0,0,0,"Palestinian Territory, Occupied"
47217,4/1/2022,PSE,Kelantan,0,0,0,"Palestinian Territory, Occupied"
47218,4/1/2022,PSE,Melaka,0,0,0,"Palestinian Territory, Occupied"
47219,4/1/2022,PSE,Perak,0,0,0,"Palestinian Territory, Occupied"
47220,4/1/2022,PSE,Perlis,0,0,0,"Palestinian Territory, Occupied"
47221,4/1/2022,PSE,Pulau Pinang,0,0,0,"Palestinian Territory, Occupied"
47222,4/1/2022,PSE,Sabah,0,0,0,"Palestinian Territory, Occupied"
47223,4/1/2022,PSE,Sarawak,0,0,0,"Palestinian Territory, Occupied"
47224,4/1/2022,PSE,Selangor,142,111,31,"Palestinian Territory, Occupied"
47225,4/1/2022,QAT,Johor,0,0,0,Qatar
47226,4/1/2022,QAT,Kedah,0,0,0,Qatar
47227,4/1/2022,QAT,Perlis,0,0,0,Qatar
47228,4/1/2022,QAT,Pulau Pinang,0,0,0,Qatar
47229,4/1/2022,QAT,Sabah,0,0,0,Qatar
47230,4/1/2022,QAT,Sarawak,0,0,0,Qatar
47231,4/1/2022,QAT,Selangor,21,13,8,Qatar
47232,4/1/2022,REU,Johor,0,0,0,Reunion
47233,4/1/2022,REU,Sarawak,0,0,0,Reunion
47234,4/1/2022,ROU,Johor,30,17,13,Romania
47235,4/1/2022,ROU,Kedah,1,0,1,Romania
47236,4/1/2022,ROU,Kelantan,0,0,0,Romania
47237,4/1/2022,ROU,Negeri Sembilan,0,0,0,Romania
47238,4/1/2022,ROU,Pahang,0,0,0,Romania
47239,4/1/2022,ROU,Perak,0,0,0,Romania
47240,4/1/2022,ROU,Perlis,0,0,0,Romania
47241,4/1/2022,ROU,Pulau Pinang,3,1,2,Romania
47242,4/1/2022,ROU,Sabah,0,0,0,Romania
47243,4/1/2022,ROU,Sarawak,1,1,0,Romania
47244,4/1/2022,ROU,Selangor,126,73,53,Romania
47245,4/1/2022,ROU,W.P. Labuan,0,0,0,Romania
47246,4/1/2022,RUS,Johor,102,58,44,Russia
47247,4/1/2022,RUS,Kedah,26,15,11,Russia
47248,4/1/2022,RUS,Kelantan,0,0,0,Russia
47249,4/1/2022,RUS,Melaka,0,0,0,Russia
47250,4/1/2022,RUS,Negeri Sembilan,0,0,0,Russia
47251,4/1/2022,RUS,Pahang,0,0,0,Russia
47252,4/1/2022,RUS,Perak,0,0,0,Russia
47253,4/1/2022,RUS,Perlis,0,0,0,Russia
47254,4/1/2022,RUS,Pulau Pinang,13,6,7,Russia
47255,4/1/2022,RUS,Sabah,3,1,2,Russia
47256,4/1/2022,RUS,Sarawak,1,1,0,Russia
47257,4/1/2022,RUS,Selangor,674,377,297,Russia
47258,4/1/2022,RUS,W.P. Labuan,0,0,0,Russia
47259,4/1/2022,RWA,Johor,2,1,1,Rwanda
47260,4/1/2022,RWA,Kedah,0,0,0,Rwanda
47261,4/1/2022,RWA,Pulau Pinang,0,0,0,Rwanda
47262,4/1/2022,RWA,Selangor,3,2,1,Rwanda
47263,4/1/2022,SAU,Johor,36,22,14,Saudi Arabia
47264,4/1/2022,SAU,Kedah,0,0,0,Saudi Arabia
47265,4/1/2022,SAU,Kelantan,0,0,0,Saudi Arabia
47266,4/1/2022,SAU,Melaka,0,0,0,Saudi Arabia
47267,4/1/2022,SAU,Perak,0,0,0,Saudi Arabia
47268,4/1/2022,SAU,Perlis,0,0,0,Saudi Arabia
47269,4/1/2022,SAU,Pulau Pinang,0,0,0,Saudi Arabia
47270,4/1/2022,SAU,Sabah,0,0,0,Saudi Arabia
47271,4/1/2022,SAU,Sarawak,0,0,0,Saudi Arabia
47272,4/1/2022,SAU,Selangor,812,455,357,Saudi Arabia
47273,4/1/2022,SAU,W.P. Labuan,0,0,0,Saudi Arabia
47274,4/1/2022,SDN,Johor,1,1,0,Sudan
47275,4/1/2022,SDN,Kedah,0,0,0,Sudan
47276,4/1/2022,SDN,Kelantan,0,0,0,Sudan
47277,4/1/2022,SDN,Perlis,0,0,0,Sudan
47278,4/1/2022,SDN,Pulau Pinang,0,0,0,Sudan
47279,4/1/2022,SDN,Sabah,0,0,0,Sudan
47280,4/1/2022,SDN,Sarawak,0,0,0,Sudan
47281,4/1/2022,SDN,Selangor,298,203,95,Sudan
47282,4/1/2022,SDN,W.P. Labuan,0,0,0,Sudan
47283,4/1/2022,SEN,Johor,0,0,0,Senegal
47284,4/1/2022,SEN,Kedah,0,0,0,Senegal
47285,4/1/2022,SEN,Kelantan,0,0,0,Senegal
47286,4/1/2022,SEN,Perak,0,0,0,Senegal
47287,4/1/2022,SEN,Perlis,0,0,0,Senegal
47288,4/1/2022,SEN,Pulau Pinang,0,0,0,Senegal
47289,4/1/2022,SEN,Sabah,0,0,0,Senegal
47290,4/1/2022,SEN,Sarawak,0,0,0,Senegal
47291,4/1/2022,SEN,Selangor,6,2,4,Senegal
47292,4/1/2022,SGP,Johor,394144,249335,144809,Singapore
47293,4/1/2022,SGP,Kedah,175,82,93,Singapore
47294,4/1/2022,SGP,Kelantan,0,0,0,Singapore
47295,4/1/2022,SGP,Melaka,0,0,0,Singapore
47296,4/1/2022,SGP,Negeri Sembilan,0,0,0,Singapore
47297,4/1/2022,SGP,Pahang,16,14,2,Singapore
47298,4/1/2022,SGP,Perak,1058,486,572,Singapore
47299,4/1/2022,SGP,Perlis,1,1,0,Singapore
47300,4/1/2022,SGP,Pulau Pinang,4202,2328,1874,Singapore
47301,4/1/2022,SGP,Sabah,282,165,117,Singapore
47302,4/1/2022,SGP,Sarawak,378,201,177,Singapore
47303,4/1/2022,SGP,Selangor,11595,6702,4893,Singapore
47304,4/1/2022,SGP,Terengganu,0,0,0,Singapore
47305,4/1/2022,SGP,W.P. Labuan,0,0,0,Singapore
47306,4/1/2022,SGS,Johor,0,0,0,South Georgia and the South Sandwich Islands
47307,4/1/2022,SGS,Sabah,0,0,0,South Georgia and the South Sandwich Islands
47308,4/1/2022,SGS,Selangor,0,0,0,South Georgia and the South Sandwich Islands
47309,4/1/2022,SHN,Sarawak,0,0,0,"Saint Helena, Ascension and Tristan da Cunha"
47310,4/1/2022,SLB,Johor,0,0,0,Solomon Islands
47311,4/1/2022,SLB,Perlis,0,0,0,Solomon Islands
47312,4/1/2022,SLB,Pulau Pinang,0,0,0,Solomon Islands
47313,4/1/2022,SLB,Sabah,0,0,0,Solomon Islands
47314,4/1/2022,SLB,Sarawak,0,0,0,Solomon Islands
47315,4/1/2022,SLB,Selangor,1,0,1,Solomon Islands
47316,4/1/2022,SLB,W.P. Labuan,0,0,0,Solomon Islands
47317,4/1/2022,SLE,Johor,0,0,0,Sierra Leone
47318,4/1/2022,SLE,Kedah,0,0,0,Sierra Leone
47319,4/1/2022,SLE,Perak,0,0,0,Sierra Leone
47320,4/1/2022,SLE,Pulau Pinang,0,0,0,Sierra Leone
47321,4/1/2022,SLE,Sabah,0,0,0,Sierra Leone
47322,4/1/2022,SLE,Selangor,9,5,4,Sierra Leone
47323,4/1/2022,SLV,Johor,0,0,0,El Salvador
47324,4/1/2022,SLV,Kedah,0,0,0,El Salvador
47325,4/1/2022,SLV,Perak,0,0,0,El Salvador
47326,4/1/2022,SLV,Perlis,0,0,0,El Salvador
47327,4/1/2022,SLV,Pulau Pinang,1,1,0,El Salvador
47328,4/1/2022,SLV,Sabah,0,0,0,El Salvador
47329,4/1/2022,SLV,Selangor,0,0,0,El Salvador
47330,4/1/2022,SLV,W.P. Labuan,0,0,0,El Salvador
47331,4/1/2022,SMR,Johor,0,0,0,San Marino
47332,4/1/2022,SMR,Selangor,0,0,0,San Marino
47333,4/1/2022,SOM,Johor,0,0,0,Somalia
47334,4/1/2022,SOM,Kedah,0,0,0,Somalia
47335,4/1/2022,SOM,Kelantan,0,0,0,Somalia
47336,4/1/2022,SOM,Perlis,0,0,0,Somalia
47337,4/1/2022,SOM,Sabah,0,0,0,Somalia
47338,4/1/2022,SOM,Sarawak,0,0,0,Somalia
47339,4/1/2022,SOM,Selangor,121,84,37,Somalia
47340,4/1/2022,SRB,Johor,1,0,1,Serbia
47341,4/1/2022,SRB,Kedah,0,0,0,Serbia
47342,4/1/2022,SRB,Kelantan,0,0,0,Serbia
47343,4/1/2022,SRB,Pahang,1,1,0,Serbia
47344,4/1/2022,SRB,Perak,0,0,0,Serbia
47345,4/1/2022,SRB,Perlis,0,0,0,Serbia
47346,4/1/2022,SRB,Pulau Pinang,0,0,0,Serbia
47347,4/1/2022,SRB,Sabah,0,0,0,Serbia
47348,4/1/2022,SRB,Sarawak,0,0,0,Serbia
47349,4/1/2022,SRB,Selangor,12,5,7,Serbia
47350,4/1/2022,STP,Selangor,2,2,0,Sao Tome and Principe
47351,4/1/2022,SUR,Johor,0,0,0,Suriname
47352,4/1/2022,SUR,Kedah,0,0,0,Suriname
47353,4/1/2022,SUR,Kelantan,0,0,0,Suriname
47354,4/1/2022,SUR,Perak,0,0,0,Suriname
47355,4/1/2022,SUR,Perlis,0,0,0,Suriname
47356,4/1/2022,SUR,Pulau Pinang,0,0,0,Suriname
47357,4/1/2022,SUR,Sabah,0,0,0,Suriname
47358,4/1/2022,SUR,Sarawak,0,0,0,Suriname
47359,4/1/2022,SUR,Selangor,1,1,0,Suriname
47360,4/1/2022,SVK,Johor,7,5,2,Slovakia
47361,4/1/2022,SVK,Kedah,1,0,1,Slovakia
47362,4/1/2022,SVK,Kelantan,0,0,0,Slovakia
47363,4/1/2022,SVK,Negeri Sembilan,0,0,0,Slovakia
47364,4/1/2022,SVK,Pahang,0,0,0,Slovakia
47365,4/1/2022,SVK,Perak,0,0,0,Slovakia
47366,4/1/2022,SVK,Perlis,0,0,0,Slovakia
47367,4/1/2022,SVK,Pulau Pinang,8,7,1,Slovakia
47368,4/1/2022,SVK,Sabah,0,0,0,Slovakia
47369,4/1/2022,SVK,Sarawak,0,0,0,Slovakia
47370,4/1/2022,SVK,Selangor,64,39,25,Slovakia
47371,4/1/2022,SVK,W.P. Labuan,0,0,0,Slovakia
47372,4/1/2022,SVN,Johor,7,3,4,Slovenia
47373,4/1/2022,SVN,Kedah,0,0,0,Slovenia
47374,4/1/2022,SVN,Kelantan,0,0,0,Slovenia
47375,4/1/2022,SVN,Perak,0,0,0,Slovenia
47376,4/1/2022,SVN,Perlis,0,0,0,Slovenia
47377,4/1/2022,SVN,Pulau Pinang,0,0,0,Slovenia
47378,4/1/2022,SVN,Sabah,0,0,0,Slovenia
47379,4/1/2022,SVN,Sarawak,0,0,0,Slovenia
47380,4/1/2022,SVN,Selangor,17,13,4,Slovenia
47381,4/1/2022,SVN,W.P. Labuan,0,0,0,Slovenia
47382,4/1/2022,SWE,Johor,123,75,48,Sweden
47383,4/1/2022,SWE,Kedah,4,4,0,Sweden
47384,4/1/2022,SWE,Kelantan,0,0,0,Sweden
47385,4/1/2022,SWE,Melaka,0,0,0,Sweden
47386,4/1/2022,SWE,Negeri Sembilan,0,0,0,Sweden
47387,4/1/2022,SWE,Pahang,0,0,0,Sweden
47388,4/1/2022,SWE,Perak,1,1,0,Sweden
47389,4/1/2022,SWE,Perlis,1,1,0,Sweden
47390,4/1/2022,SWE,Pulau Pinang,20,16,4,Sweden
47391,4/1/2022,SWE,Sabah,1,1,0,Sweden
47392,4/1/2022,SWE,Sarawak,1,1,0,Sweden
47393,4/1/2022,SWE,Selangor,392,256,136,Sweden
47394,4/1/2022,SWE,W.P. Labuan,0,0,0,Sweden
47395,4/1/2022,SWZ,Johor,0,0,0,Swaziland
47396,4/1/2022,SWZ,Kedah,0,0,0,Swaziland
47397,4/1/2022,SWZ,Pulau Pinang,0,0,0,Swaziland
47398,4/1/2022,SWZ,Sabah,0,0,0,Swaziland
47399,4/1/2022,SWZ,Selangor,3,2,1,Swaziland
47400,4/1/2022,SYC,Johor,0,0,0,Seychelles
47401,4/1/2022,SYC,Kedah,0,0,0,Seychelles
47402,4/1/2022,SYC,Pulau Pinang,0,0,0,Seychelles
47403,4/1/2022,SYC,Sabah,0,0,0,Seychelles
47404,4/1/2022,SYC,Sarawak,0,0,0,Seychelles
47405,4/1/2022,SYC,Selangor,42,18,24,Seychelles
47406,4/1/2022,SYR,Johor,3,1,2,Syrian Arab Republic
47407,4/1/2022,SYR,Kedah,0,0,0,Syrian Arab Republic
47408,4/1/2022,SYR,Kelantan,0,0,0,Syrian Arab Republic
47409,4/1/2022,SYR,Pahang,0,0,0,Syrian Arab Republic
47410,4/1/2022,SYR,Perlis,0,0,0,Syrian Arab Republic
47411,4/1/2022,SYR,Pulau Pinang,0,0,0,Syrian Arab Republic
47412,4/1/2022,SYR,Sabah,0,0,0,Syrian Arab Republic
47413,4/1/2022,SYR,Sarawak,0,0,0,Syrian Arab Republic
47414,4/1/2022,SYR,Selangor,352,222,130,Syrian Arab Republic
47415,4/1/2022,SYR,W.P. Labuan,0,0,0,Syrian Arab Republic
47416,4/1/2022,TCA,Perlis,0,0,0,Turks and Caicos
47417,4/1/2022,TCD,Johor,0,0,0,Chad
47418,4/1/2022,TCD,Kedah,0,0,0,Chad
47419,4/1/2022,TCD,Perlis,0,0,0,Chad
47420,4/1/2022,TCD,Selangor,13,9,4,Chad
47421,4/1/2022,TGO,Johor,3,3,0,Togo
47422,4/1/2022,TGO,Perak,0,0,0,Togo
47423,4/1/2022,TGO,Pulau Pinang,0,0,0,Togo
47424,4/1/2022,TGO,Selangor,0,0,0,Togo
47425,4/1/2022,THA,Johor,890,143,747,Thailand
47426,4/1/2022,THA,Kedah,19821,17791,2030,Thailand
47427,4/1/2022,THA,Kelantan,6,5,1,Thailand
47428,4/1/2022,THA,Melaka,0,0,0,Thailand
47429,4/1/2022,THA,Negeri Sembilan,0,0,0,Thailand
47430,4/1/2022,THA,Pahang,2,0,2,Thailand
47431,4/1/2022,THA,Perak,1,0,1,Thailand
47432,4/1/2022,THA,Perlis,10082,9807,275,Thailand
47433,4/1/2022,THA,Pulau Pinang,131,59,72,Thailand
47434,4/1/2022,THA,Sabah,5,4,1,Thailand
47435,4/1/2022,THA,Sarawak,13,10,3,Thailand
47436,4/1/2022,THA,Selangor,2718,920,1798,Thailand
47437,4/1/2022,THA,Terengganu,0,0,0,Thailand
47438,4/1/2022,THA,W.P. Labuan,0,0,0,Thailand
47439,4/1/2022,TJK,Johor,0,0,0,Tajikistan
47440,4/1/2022,TJK,Kedah,0,0,0,Tajikistan
47441,4/1/2022,TJK,Perlis,0,0,0,Tajikistan
47442,4/1/2022,TJK,Pulau Pinang,0,0,0,Tajikistan
47443,4/1/2022,TJK,Sabah,0,0,0,Tajikistan
47444,4/1/2022,TJK,Selangor,14,9,5,Tajikistan
47445,4/1/2022,TKL,Selangor,0,0,0,Tokelau
47446,4/1/2022,TKM,Johor,1,0,1,Turkmenistan
47447,4/1/2022,TKM,Kedah,0,0,0,Turkmenistan
47448,4/1/2022,TKM,Kelantan,0,0,0,Turkmenistan
47449,4/1/2022,TKM,Perlis,0,0,0,Turkmenistan
47450,4/1/2022,TKM,Pulau Pinang,0,0,0,Turkmenistan
47451,4/1/2022,TKM,Sabah,0,0,0,Turkmenistan
47452,4/1/2022,TKM,Sarawak,0,0,0,Turkmenistan
47453,4/1/2022,TKM,Selangor,18,9,9,Turkmenistan
47454,4/1/2022,TLS,Johor,0,0,0,Timor-Leste
47455,4/1/2022,TLS,Kedah,0,0,0,Timor-Leste
47456,4/1/2022,TLS,Perlis,0,0,0,Timor-Leste
47457,4/1/2022,TLS,Pulau Pinang,1,0,1,Timor-Leste
47458,4/1/2022,TLS,Sabah,0,0,0,Timor-Leste
47459,4/1/2022,TLS,Sarawak,0,0,0,Timor-Leste
47460,4/1/2022,TLS,Selangor,99,73,26,Timor-Leste
47461,4/1/2022,TON,Johor,0,0,0,Tonga
47462,4/1/2022,TON,Pulau Pinang,0,0,0,Tonga
47463,4/1/2022,TON,Sarawak,0,0,0,Tonga
47464,4/1/2022,TON,Selangor,13,6,7,Tonga
47465,4/1/2022,TTO,Johor,3,3,0,Trinidad and Tobago
47466,4/1/2022,TTO,Kedah,0,0,0,Trinidad and Tobago
47467,4/1/2022,TTO,Pahang,0,0,0,Trinidad and Tobago
47468,4/1/2022,TTO,Pulau Pinang,0,0,0,Trinidad and Tobago
47469,4/1/2022,TTO,Sabah,0,0,0,Trinidad and Tobago
47470,4/1/2022,TTO,Sarawak,0,0,0,Trinidad and Tobago
47471,4/1/2022,TTO,Selangor,13,8,5,Trinidad and Tobago
47472,4/1/2022,TUN,Johor,5,2,3,Tunisia
47473,4/1/2022,TUN,Kedah,0,0,0,Tunisia
47474,4/1/2022,TUN,Kelantan,0,0,0,Tunisia
47475,4/1/2022,TUN,Melaka,0,0,0,Tunisia
47476,4/1/2022,TUN,Perak,0,0,0,Tunisia
47477,4/1/2022,TUN,Perlis,0,0,0,Tunisia
47478,4/1/2022,TUN,Pulau Pinang,0,0,0,Tunisia
47479,4/1/2022,TUN,Sabah,0,0,0,Tunisia
47480,4/1/2022,TUN,Sarawak,0,0,0,Tunisia
47481,4/1/2022,TUN,Selangor,72,46,26,Tunisia
47482,4/1/2022,TUN,W.P. Labuan,0,0,0,Tunisia
47483,4/1/2022,TUR,Johor,68,48,20,Turkey
47484,4/1/2022,TUR,Kedah,6,3,3,Turkey
47485,4/1/2022,TUR,Kelantan,0,0,0,Turkey
47486,4/1/2022,TUR,Melaka,0,0,0,Turkey
47487,4/1/2022,TUR,Negeri Sembilan,3,3,0,Turkey
47488,4/1/2022,TUR,Pahang,0,0,0,Turkey
47489,4/1/2022,TUR,Perak,1,1,0,Turkey
47490,4/1/2022,TUR,Perlis,0,0,0,Turkey
47491,4/1/2022,TUR,Pulau Pinang,16,9,7,Turkey
47492,4/1/2022,TUR,Sabah,0,0,0,Turkey
47493,4/1/2022,TUR,Sarawak,1,0,1,Turkey
47494,4/1/2022,TUR,Selangor,362,283,79,Turkey
47495,4/1/2022,TUR,W.P. Labuan,0,0,0,Turkey
47496,4/1/2022,TUV,Selangor,0,0,0,Tuvalu
47497,4/1/2022,TWN,Johor,891,363,528,Taiwan
47498,4/1/2022,TWN,Kedah,12,6,6,Taiwan
47499,4/1/2022,TWN,Kelantan,0,0,0,Taiwan
47500,4/1/2022,TWN,Melaka,0,0,0,Taiwan
47501,4/1/2022,TWN,Negeri Sembilan,0,0,0,Taiwan
47502,4/1/2022,TWN,Pahang,0,0,0,Taiwan
47503,4/1/2022,TWN,Perak,4,2,2,Taiwan
47504,4/1/2022,TWN,Perlis,0,0,0,Taiwan
47505,4/1/2022,TWN,Pulau Pinang,164,115,49,Taiwan
47506,4/1/2022,TWN,Sabah,3,2,1,Taiwan
47507,4/1/2022,TWN,Sarawak,15,14,1,Taiwan
47508,4/1/2022,TWN,Selangor,781,484,297,Taiwan
47509,4/1/2022,TWN,W.P. Labuan,0,0,0,Taiwan
47510,4/1/2022,TZA,Johor,2,2,0,"Tanzania, United Republic of"
47511,4/1/2022,TZA,Kedah,0,0,0,"Tanzania, United Republic of"
47512,4/1/2022,TZA,Perak,0,0,0,"Tanzania, United Republic of"
47513,4/1/2022,TZA,Perlis,0,0,0,"Tanzania, United Republic of"
47514,4/1/2022,TZA,Pulau Pinang,0,0,0,"Tanzania, United Republic of"
47515,4/1/2022,TZA,Sabah,0,0,0,"Tanzania, United Republic of"
47516,4/1/2022,TZA,Sarawak,0,0,0,"Tanzania, United Republic of"
47517,4/1/2022,TZA,Selangor,44,20,24,"Tanzania, United Republic of"
47518,4/1/2022,UGA,Johor,0,0,0,Uganda
47519,4/1/2022,UGA,Kedah,0,0,0,Uganda
47520,4/1/2022,UGA,Perak,0,0,0,Uganda
47521,4/1/2022,UGA,Perlis,0,0,0,Uganda
47522,4/1/2022,UGA,Pulau Pinang,0,0,0,Uganda
47523,4/1/2022,UGA,Sabah,0,0,0,Uganda
47524,4/1/2022,UGA,Sarawak,0,0,0,Uganda
47525,4/1/2022,UGA,Selangor,24,14,10,Uganda
47526,4/1/2022,UKR,Johor,34,20,14,Ukraine
47527,4/1/2022,UKR,Kedah,2,0,2,Ukraine
47528,4/1/2022,UKR,Kelantan,0,0,0,Ukraine
47529,4/1/2022,UKR,Melaka,0,0,0,Ukraine
47530,4/1/2022,UKR,Negeri Sembilan,0,0,0,Ukraine
47531,4/1/2022,UKR,Pahang,0,0,0,Ukraine
47532,4/1/2022,UKR,Perak,0,0,0,Ukraine
47533,4/1/2022,UKR,Perlis,0,0,0,Ukraine
47534,4/1/2022,UKR,Pulau Pinang,4,1,3,Ukraine
47535,4/1/2022,UKR,Sabah,0,0,0,Ukraine
47536,4/1/2022,UKR,Sarawak,0,0,0,Ukraine
47537,4/1/2022,UKR,Selangor,166,76,90,Ukraine
47538,4/1/2022,UKR,W.P. Labuan,0,0,0,Ukraine
47539,4/1/2022,URY,Johor,10,5,5,Uruguay
47540,4/1/2022,URY,Kedah,0,0,0,Uruguay
47541,4/1/2022,URY,Kelantan,0,0,0,Uruguay
47542,4/1/2022,URY,Perak,0,0,0,Uruguay
47543,4/1/2022,URY,Perlis,0,0,0,Uruguay
47544,4/1/2022,URY,Pulau Pinang,0,0,0,Uruguay
47545,4/1/2022,URY,Sabah,0,0,0,Uruguay
47546,4/1/2022,URY,Sarawak,0,0,0,Uruguay
47547,4/1/2022,URY,Selangor,8,3,5,Uruguay
47548,4/1/2022,URY,W.P. Labuan,0,0,0,Uruguay
47549,4/1/2022,USA,Johor,1105,724,381,United States Of America
47550,4/1/2022,USA,Kedah,103,54,49,United States Of America
47551,4/1/2022,USA,Kelantan,2,2,0,United States Of America
47552,4/1/2022,USA,Melaka,0,0,0,United States Of America
47553,4/1/2022,USA,Negeri Sembilan,1,1,0,United States Of America
47554,4/1/2022,USA,Pahang,2,1,1,United States Of America
47555,4/1/2022,USA,Perak,13,8,5,United States Of America
47556,4/1/2022,USA,Perlis,0,0,0,United States Of America
47557,4/1/2022,USA,Pulau Pinang,471,321,150,United States Of America
47558,4/1/2022,USA,Sabah,32,17,15,United States Of America
47559,4/1/2022,USA,Sarawak,24,16,8,United States Of America
47560,4/1/2022,USA,Selangor,3296,2105,1191,United States Of America
47561,4/1/2022,USA,Terengganu,0,0,0,United States Of America
47562,4/1/2022,USA,W.P. Labuan,0,0,0,United States Of America
47563,4/1/2022,UZB,Johor,18,4,14,Uzbekistan
47564,4/1/2022,UZB,Kedah,0,0,0,Uzbekistan
47565,4/1/2022,UZB,Kelantan,0,0,0,Uzbekistan
47566,4/1/2022,UZB,Perak,0,0,0,Uzbekistan
47567,4/1/2022,UZB,Perlis,0,0,0,Uzbekistan
47568,4/1/2022,UZB,Pulau Pinang,1,0,1,Uzbekistan
47569,4/1/2022,UZB,Sabah,0,0,0,Uzbekistan
47570,4/1/2022,UZB,Sarawak,0,0,0,Uzbekistan
47571,4/1/2022,UZB,Selangor,92,52,40,Uzbekistan
47572,4/1/2022,VAT,Johor,0,0,0,Holy See (Vatican City State)
47573,4/1/2022,VAT,Sarawak,0,0,0,Holy See (Vatican City State)
47574,4/1/2022,VAT,Selangor,0,0,0,Holy See (Vatican City State)
47575,4/1/2022,VCT,Johor,0,0,0,Saint Vincent and the Grenadines
47576,4/1/2022,VCT,Kedah,0,0,0,Saint Vincent and the Grenadines
47577,4/1/2022,VCT,Pulau Pinang,0,0,0,Saint Vincent and the Grenadines
47578,4/1/2022,VCT,Sarawak,0,0,0,Saint Vincent and the Grenadines
47579,4/1/2022,VCT,Selangor,0,0,0,Saint Vincent and the Grenadines
47580,4/1/2022,VEN,Johor,3,0,3,Venezuela
47581,4/1/2022,VEN,Kedah,0,0,0,Venezuela
47582,4/1/2022,VEN,Kelantan,0,0,0,Venezuela
47583,4/1/2022,VEN,Melaka,0,0,0,Venezuela
47584,4/1/2022,VEN,Perak,0,0,0,Venezuela
47585,4/1/2022,VEN,Perlis,0,0,0,Venezuela
47586,4/1/2022,VEN,Pulau Pinang,2,0,2,Venezuela
47587,4/1/2022,VEN,Sabah,0,0,0,Venezuela
47588,4/1/2022,VEN,Sarawak,0,0,0,Venezuela
47589,4/1/2022,VEN,Selangor,18,13,5,Venezuela
47590,4/1/2022,VEN,W.P. Labuan,0,0,0,Venezuela
47591,4/1/2022,VNM,Johor,2487,659,1828,Vietnam
47592,4/1/2022,VNM,Kedah,3,1,2,Vietnam
47593,4/1/2022,VNM,Kelantan,0,0,0,Vietnam
47594,4/1/2022,VNM,Melaka,0,0,0,Vietnam
47595,4/1/2022,VNM,Negeri Sembilan,0,0,0,Vietnam
47596,4/1/2022,VNM,Pahang,0,0,0,Vietnam
47597,4/1/2022,VNM,Perak,1,0,1,Vietnam
47598,4/1/2022,VNM,Perlis,0,0,0,Vietnam
47599,4/1/2022,VNM,Pulau Pinang,389,104,285,Vietnam
47600,4/1/2022,VNM,Sabah,3,1,2,Vietnam
47601,4/1/2022,VNM,Sarawak,13,6,7,Vietnam
47602,4/1/2022,VNM,Selangor,4837,1612,3225,Vietnam
47603,4/1/2022,VNM,Terengganu,0,0,0,Vietnam
47604,4/1/2022,VNM,W.P. Labuan,0,0,0,Vietnam
47605,4/1/2022,VUT,Johor,5,5,0,Vanuatu
47606,4/1/2022,VUT,Kedah,0,0,0,Vanuatu
47607,4/1/2022,VUT,Pulau Pinang,0,0,0,Vanuatu
47608,4/1/2022,VUT,Sabah,0,0,0,Vanuatu
47609,4/1/2022,VUT,Sarawak,0,0,0,Vanuatu
47610,4/1/2022,VUT,Selangor,8,8,0,Vanuatu
47611,4/1/2022,WSM,Johor,0,0,0,Samoa
47612,4/1/2022,WSM,Sarawak,0,0,0,Samoa
47613,4/1/2022,WSM,Selangor,0,0,0,Samoa
47614,4/1/2022,YEM,Johor,25,15,10,Yemen
47615,4/1/2022,YEM,Kedah,0,0,0,Yemen
47616,4/1/2022,YEM,Kelantan,0,0,0,Yemen
47617,4/1/2022,YEM,Melaka,0,0,0,Yemen
47618,4/1/2022,YEM,Pahang,0,0,0,Yemen
47619,4/1/2022,YEM,Perak,0,0,0,Yemen
47620,4/1/2022,YEM,Perlis,0,0,0,Yemen
47621,4/1/2022,YEM,Pulau Pinang,0,0,0,Yemen
47622,4/1/2022,YEM,Sabah,0,0,0,Yemen
47623,4/1/2022,YEM,Sarawak,0,0,0,Yemen
47624,4/1/2022,YEM,Selangor,695,482,213,Yemen
47625,4/1/2022,YEM,W.P. Labuan,0,0,0,Yemen
47626,4/1/2022,ZAF,Johor,102,62,40,South Africa
47627,4/1/2022,ZAF,Kedah,7,4,3,South Africa
47628,4/1/2022,ZAF,Kelantan,0,0,0,South Africa
47629,4/1/2022,ZAF,Melaka,0,0,0,South Africa
47630,4/1/2022,ZAF,Pahang,0,0,0,South Africa
47631,4/1/2022,ZAF,Perak,1,1,0,South Africa
47632,4/1/2022,ZAF,Perlis,0,0,0,South Africa
47633,4/1/2022,ZAF,Pulau Pinang,21,12,9,South Africa
47634,4/1/2022,ZAF,Sabah,3,2,1,South Africa
47635,4/1/2022,ZAF,Sarawak,5,5,0,South Africa
47636,4/1/2022,ZAF,Selangor,386,231,155,South Africa
47637,4/1/2022,ZAF,Terengganu,0,0,0,South Africa
47638,4/1/2022,ZAF,W.P. Labuan,0,0,0,South Africa
47639,4/1/2022,ZMB,Johor,0,0,0,Zambia
47640,4/1/2022,ZMB,Kedah,0,0,0,Zambia
47641,4/1/2022,ZMB,Perak,0,0,0,Zambia
47642,4/1/2022,ZMB,Perlis,0,0,0,Zambia
47643,4/1/2022,ZMB,Pulau Pinang,0,0,0,Zambia
47644,4/1/2022,ZMB,Sabah,1,1,0,Zambia
47645,4/1/2022,ZMB,Sarawak,0,0,0,Zambia
47646,4/1/2022,ZMB,Selangor,13,8,5,Zambia
47647,4/1/2022,ZWE,Johor,2,1,1,Zimbabwe
47648,4/1/2022,ZWE,Kedah,0,0,0,Zimbabwe
47649,4/1/2022,ZWE,Kelantan,0,0,0,Zimbabwe
47650,4/1/2022,ZWE,Perak,0,0,0,Zimbabwe
47651,4/1/2022,ZWE,Perlis,0,0,0,Zimbabwe
47652,4/1/2022,ZWE,Pulau Pinang,0,0,0,Zimbabwe
47653,4/1/2022,ZWE,Sabah,0,0,0,Zimbabwe
47654,4/1/2022,ZWE,Sarawak,0,0,0,Zimbabwe
47655,4/1/2022,ZWE,Selangor,51,26,25,Zimbabwe
47656,5/1/2022,ABW,Kedah,0,0,0,Aruba
47657,5/1/2022,ABW,Pulau Pinang,0,0,0,Aruba
47658,5/1/2022,AFG,Johor,1,1,0,Afghanistan
47659,5/1/2022,AFG,Kedah,0,0,0,Afghanistan
47660,5/1/2022,AFG,Perlis,0,0,0,Afghanistan
47661,5/1/2022,AFG,Pulau Pinang,0,0,0,Afghanistan
47662,5/1/2022,AFG,Sarawak,0,0,0,Afghanistan
47663,5/1/2022,AFG,Selangor,126,93,33,Afghanistan
47664,5/1/2022,AGO,Johor,0,0,0,Angola
47665,5/1/2022,AGO,Kedah,0,0,0,Angola
47666,5/1/2022,AGO,Sabah,0,0,0,Angola
47667,5/1/2022,AGO,Selangor,2,2,0,Angola
47668,5/1/2022,AIA,Selangor,0,0,0,Anguilla
47669,5/1/2022,ALB,Johor,2,2,0,Albania
47670,5/1/2022,ALB,Kedah,0,0,0,Albania
47671,5/1/2022,ALB,Perak,0,0,0,Albania
47672,5/1/2022,ALB,Perlis,1,1,0,Albania
47673,5/1/2022,ALB,Pulau Pinang,0,0,0,Albania
47674,5/1/2022,ALB,Sabah,0,0,0,Albania
47675,5/1/2022,ALB,Sarawak,0,0,0,Albania
47676,5/1/2022,ALB,Selangor,17,12,5,Albania
47677,5/1/2022,AND,Johor,0,0,0,Andorra
47678,5/1/2022,AND,Kedah,0,0,0,Andorra
47679,5/1/2022,AND,Perlis,0,0,0,Andorra
47680,5/1/2022,AND,Pulau Pinang,0,0,0,Andorra
47681,5/1/2022,AND,Selangor,2,1,1,Andorra
47682,5/1/2022,ANT,Selangor,0,0,0,Netherlands Antilles
47683,5/1/2022,ARE,Johor,11,9,2,United Arab Emirates
47684,5/1/2022,ARE,Kedah,0,0,0,United Arab Emirates
47685,5/1/2022,ARE,Kelantan,0,0,0,United Arab Emirates
47686,5/1/2022,ARE,Perak,0,0,0,United Arab Emirates
47687,5/1/2022,ARE,Perlis,0,0,0,United Arab Emirates
47688,5/1/2022,ARE,Pulau Pinang,0,0,0,United Arab Emirates
47689,5/1/2022,ARE,Sabah,0,0,0,United Arab Emirates
47690,5/1/2022,ARE,Sarawak,0,0,0,United Arab Emirates
47691,5/1/2022,ARE,Selangor,219,149,70,United Arab Emirates
47692,5/1/2022,ARG,Johor,36,23,13,Argentina
47693,5/1/2022,ARG,Kedah,4,3,1,Argentina
47694,5/1/2022,ARG,Kelantan,0,0,0,Argentina
47695,5/1/2022,ARG,Melaka,0,0,0,Argentina
47696,5/1/2022,ARG,Perak,1,1,0,Argentina
47697,5/1/2022,ARG,Perlis,6,4,2,Argentina
47698,5/1/2022,ARG,Pulau Pinang,3,1,2,Argentina
47699,5/1/2022,ARG,Sabah,1,0,1,Argentina
47700,5/1/2022,ARG,Sarawak,0,0,0,Argentina
47701,5/1/2022,ARG,Selangor,121,73,48,Argentina
47702,5/1/2022,ARG,W.P. Labuan,0,0,0,Argentina
47703,5/1/2022,ARM,Johor,1,1,0,Armenia
47704,5/1/2022,ARM,Kedah,0,0,0,Armenia
47705,5/1/2022,ARM,Kelantan,0,0,0,Armenia
47706,5/1/2022,ARM,Perak,0,0,0,Armenia
47707,5/1/2022,ARM,Perlis,0,0,0,Armenia
47708,5/1/2022,ARM,Pulau Pinang,0,0,0,Armenia
47709,5/1/2022,ARM,Sabah,0,0,0,Armenia
47710,5/1/2022,ARM,Sarawak,0,0,0,Armenia
47711,5/1/2022,ARM,Selangor,10,3,7,Armenia
47712,5/1/2022,ATA,Selangor,1,1,0,Antarctica
47713,5/1/2022,ATG,Johor,0,0,0,Antigua and Barbuda
47714,5/1/2022,ATG,Kedah,2,2,0,Antigua and Barbuda
47715,5/1/2022,ATG,Pulau Pinang,0,0,0,Antigua and Barbuda
47716,5/1/2022,ATG,Sarawak,0,0,0,Antigua and Barbuda
47717,5/1/2022,ATG,Selangor,3,3,0,Antigua and Barbuda
47718,5/1/2022,AUS,Johor,2184,1440,744,Australia
47719,5/1/2022,AUS,Kedah,140,87,53,Australia
47720,5/1/2022,AUS,Kelantan,0,0,0,Australia
47721,5/1/2022,AUS,Melaka,0,0,0,Australia
47722,5/1/2022,AUS,Negeri Sembilan,0,0,0,Australia
47723,5/1/2022,AUS,Pahang,1,1,0,Australia
47724,5/1/2022,AUS,Perak,64,39,25,Australia
47725,5/1/2022,AUS,Perlis,10,10,0,Australia
47726,5/1/2022,AUS,Pulau Pinang,640,368,272,Australia
47727,5/1/2022,AUS,Sabah,144,79,65,Australia
47728,5/1/2022,AUS,Sarawak,145,83,62,Australia
47729,5/1/2022,AUS,Selangor,6141,3970,2171,Australia
47730,5/1/2022,AUS,Terengganu,0,0,0,Australia
47731,5/1/2022,AUS,W.P. Labuan,0,0,0,Australia
47732,5/1/2022,AUT,Johor,78,52,26,Austria
47733,5/1/2022,AUT,Kedah,6,6,0,Austria
47734,5/1/2022,AUT,Kelantan,0,0,0,Austria
47735,5/1/2022,AUT,Melaka,0,0,0,Austria
47736,5/1/2022,AUT,Negeri Sembilan,1,1,0,Austria
47737,5/1/2022,AUT,Pahang,0,0,0,Austria
47738,5/1/2022,AUT,Perak,2,2,0,Austria
47739,5/1/2022,AUT,Perlis,3,1,2,Austria
47740,5/1/2022,AUT,Pulau Pinang,36,29,7,Austria
47741,5/1/2022,AUT,Sabah,3,3,0,Austria
47742,5/1/2022,AUT,Sarawak,3,2,1,Austria
47743,5/1/2022,AUT,Selangor,306,214,92,Austria
47744,5/1/2022,AUT,Terengganu,0,0,0,Austria
47745,5/1/2022,AUT,W.P. Labuan,0,0,0,Austria
47746,5/1/2022,AZE,Johor,1,0,1,Azerbaijan
47747,5/1/2022,AZE,Kedah,1,0,1,Azerbaijan
47748,5/1/2022,AZE,Kelantan,0,0,0,Azerbaijan
47749,5/1/2022,AZE,Melaka,0,0,0,Azerbaijan
47750,5/1/2022,AZE,Perlis,0,0,0,Azerbaijan
47751,5/1/2022,AZE,Pulau Pinang,0,0,0,Azerbaijan
47752,5/1/2022,AZE,Sabah,0,0,0,Azerbaijan
47753,5/1/2022,AZE,Sarawak,0,0,0,Azerbaijan
47754,5/1/2022,AZE,Selangor,31,20,11,Azerbaijan
47755,5/1/2022,AZE,W.P. Labuan,0,0,0,Azerbaijan
47756,5/1/2022,BDI,Pulau Pinang,0,0,0,Burundi
47757,5/1/2022,BDI,Sarawak,0,0,0,Burundi
47758,5/1/2022,BDI,Selangor,0,0,0,Burundi
47759,5/1/2022,BEL,Johor,148,110,38,Belgium
47760,5/1/2022,BEL,Kedah,10,8,2,Belgium
47761,5/1/2022,BEL,Kelantan,0,0,0,Belgium
47762,5/1/2022,BEL,Melaka,0,0,0,Belgium
47763,5/1/2022,BEL,Negeri Sembilan,0,0,0,Belgium
47764,5/1/2022,BEL,Pahang,0,0,0,Belgium
47765,5/1/2022,BEL,Perak,3,3,0,Belgium
47766,5/1/2022,BEL,Perlis,3,2,1,Belgium
47767,5/1/2022,BEL,Pulau Pinang,22,14,8,Belgium
47768,5/1/2022,BEL,Sabah,3,2,1,Belgium
47769,5/1/2022,BEL,Sarawak,0,0,0,Belgium
47770,5/1/2022,BEL,Selangor,356,256,100,Belgium
47771,5/1/2022,BEL,W.P. Labuan,0,0,0,Belgium
47772,5/1/2022,BEN,Johor,0,0,0,Benin
47773,5/1/2022,BEN,Kedah,0,0,0,Benin
47774,5/1/2022,BEN,Perak,0,0,0,Benin
47775,5/1/2022,BEN,Pulau Pinang,0,0,0,Benin
47776,5/1/2022,BEN,Sabah,0,0,0,Benin
47777,5/1/2022,BEN,Sarawak,0,0,0,Benin
47778,5/1/2022,BEN,Selangor,0,0,0,Benin
47779,5/1/2022,BFA,Perak,0,0,0,Burkina Faso
47780,5/1/2022,BFA,Pulau Pinang,0,0,0,Burkina Faso
47781,5/1/2022,BFA,Selangor,1,0,1,Burkina Faso
47782,5/1/2022,BGD,Johor,645,535,110,Bangladesh
47783,5/1/2022,BGD,Kedah,5,3,2,Bangladesh
47784,5/1/2022,BGD,Kelantan,0,0,0,Bangladesh
47785,5/1/2022,BGD,Melaka,0,0,0,Bangladesh
47786,5/1/2022,BGD,Negeri Sembilan,0,0,0,Bangladesh
47787,5/1/2022,BGD,Pahang,0,0,0,Bangladesh
47788,5/1/2022,BGD,Perak,0,0,0,Bangladesh
47789,5/1/2022,BGD,Perlis,2,2,0,Bangladesh
47790,5/1/2022,BGD,Pulau Pinang,40,33,7,Bangladesh
47791,5/1/2022,BGD,Sabah,0,0,0,Bangladesh
47792,5/1/2022,BGD,Sarawak,5,5,0,Bangladesh
47793,5/1/2022,BGD,Selangor,12646,11636,1010,Bangladesh
47794,5/1/2022,BGD,W.P. Labuan,0,0,0,Bangladesh
47795,5/1/2022,BGR,Johor,21,9,12,Bulgaria
47796,5/1/2022,BGR,Kedah,8,4,4,Bulgaria
47797,5/1/2022,BGR,Kelantan,0,0,0,Bulgaria
47798,5/1/2022,BGR,Pahang,0,0,0,Bulgaria
47799,5/1/2022,BGR,Perak,0,0,0,Bulgaria
47800,5/1/2022,BGR,Perlis,0,0,0,Bulgaria
47801,5/1/2022,BGR,Pulau Pinang,3,1,2,Bulgaria
47802,5/1/2022,BGR,Sabah,0,0,0,Bulgaria
47803,5/1/2022,BGR,Sarawak,0,0,0,Bulgaria
47804,5/1/2022,BGR,Selangor,69,47,22,Bulgaria
47805,5/1/2022,BGR,W.P. Labuan,0,0,0,Bulgaria
47806,5/1/2022,BHR,Johor,1,0,1,Bahrain
47807,5/1/2022,BHR,Kedah,0,0,0,Bahrain
47808,5/1/2022,BHR,Kelantan,0,0,0,Bahrain
47809,5/1/2022,BHR,Perlis,0,0,0,Bahrain
47810,5/1/2022,BHR,Pulau Pinang,0,0,0,Bahrain
47811,5/1/2022,BHR,Sabah,0,0,0,Bahrain
47812,5/1/2022,BHR,Sarawak,0,0,0,Bahrain
47813,5/1/2022,BHR,Selangor,86,51,35,Bahrain
47814,5/1/2022,BHS,Johor,1,0,1,Bahamas
47815,5/1/2022,BHS,Kedah,0,0,0,Bahamas
47816,5/1/2022,BHS,Perak,0,0,0,Bahamas
47817,5/1/2022,BHS,Sabah,0,0,0,Bahamas
47818,5/1/2022,BHS,Sarawak,0,0,0,Bahamas
47819,5/1/2022,BHS,Selangor,2,1,1,Bahamas
47820,5/1/2022,BIH,Johor,3,3,0,Bosnia and Herzegovina
47821,5/1/2022,BIH,Kedah,0,0,0,Bosnia and Herzegovina
47822,5/1/2022,BIH,Perlis,0,0,0,Bosnia and Herzegovina
47823,5/1/2022,BIH,Pulau Pinang,0,0,0,Bosnia and Herzegovina
47824,5/1/2022,BIH,Sabah,0,0,0,Bosnia and Herzegovina
47825,5/1/2022,BIH,Sarawak,0,0,0,Bosnia and Herzegovina
47826,5/1/2022,BIH,Selangor,25,16,9,Bosnia and Herzegovina
47827,5/1/2022,BLR,Johor,8,5,3,Belarus
47828,5/1/2022,BLR,Kedah,0,0,0,Belarus
47829,5/1/2022,BLR,Kelantan,0,0,0,Belarus
47830,5/1/2022,BLR,Pahang,0,0,0,Belarus
47831,5/1/2022,BLR,Perak,0,0,0,Belarus
47832,5/1/2022,BLR,Perlis,1,0,1,Belarus
47833,5/1/2022,BLR,Pulau Pinang,8,5,3,Belarus
47834,5/1/2022,BLR,Sabah,2,1,1,Belarus
47835,5/1/2022,BLR,Sarawak,1,1,0,Belarus
47836,5/1/2022,BLR,Selangor,59,28,31,Belarus
47837,5/1/2022,BLR,W.P. Labuan,0,0,0,Belarus
47838,5/1/2022,BLZ,Johor,0,0,0,Belize
47839,5/1/2022,BLZ,Pulau Pinang,0,0,0,Belize
47840,5/1/2022,BLZ,Sarawak,0,0,0,Belize
47841,5/1/2022,BLZ,Selangor,1,1,0,Belize
47842,5/1/2022,BMU,Selangor,0,0,0,Bermuda
47843,5/1/2022,BOL,Johor,0,0,0,Bolivia
47844,5/1/2022,BOL,Kedah,0,0,0,Bolivia
47845,5/1/2022,BOL,Melaka,0,0,0,Bolivia
47846,5/1/2022,BOL,Perak,0,0,0,Bolivia
47847,5/1/2022,BOL,Perlis,0,0,0,Bolivia
47848,5/1/2022,BOL,Pulau Pinang,4,3,1,Bolivia
47849,5/1/2022,BOL,Sabah,0,0,0,Bolivia
47850,5/1/2022,BOL,Sarawak,0,0,0,Bolivia
47851,5/1/2022,BOL,Selangor,21,13,8,Bolivia
47852,5/1/2022,BRA,Johor,174,88,86,Brazil
47853,5/1/2022,BRA,Kedah,15,6,9,Brazil
47854,5/1/2022,BRA,Kelantan,1,1,0,Brazil
47855,5/1/2022,BRA,Melaka,0,0,0,Brazil
47856,5/1/2022,BRA,Pahang,0,0,0,Brazil
47857,5/1/2022,BRA,Perak,1,1,0,Brazil
47858,5/1/2022,BRA,Perlis,2,0,2,Brazil
47859,5/1/2022,BRA,Pulau Pinang,6,5,1,Brazil
47860,5/1/2022,BRA,Sabah,5,1,4,Brazil
47861,5/1/2022,BRA,Sarawak,1,1,0,Brazil
47862,5/1/2022,BRA,Selangor,365,217,148,Brazil
47863,5/1/2022,BRA,W.P. Labuan,0,0,0,Brazil
47864,5/1/2022,BRB,Johor,0,0,0,Barbados
47865,5/1/2022,BRB,Kedah,0,0,0,Barbados
47866,5/1/2022,BRB,Perlis,0,0,0,Barbados
47867,5/1/2022,BRB,Pulau Pinang,0,0,0,Barbados
47868,5/1/2022,BRB,Selangor,0,0,0,Barbados
47869,5/1/2022,BRN,Johor,104,59,45,Brunei Darussalam
47870,5/1/2022,BRN,Kedah,5,3,2,Brunei Darussalam
47871,5/1/2022,BRN,Kelantan,0,0,0,Brunei Darussalam
47872,5/1/2022,BRN,Melaka,0,0,0,Brunei Darussalam
47873,5/1/2022,BRN,Pahang,0,0,0,Brunei Darussalam
47874,5/1/2022,BRN,Perak,0,0,0,Brunei Darussalam
47875,5/1/2022,BRN,Perlis,0,0,0,Brunei Darussalam
47876,5/1/2022,BRN,Pulau Pinang,5,3,2,Brunei Darussalam
47877,5/1/2022,BRN,Sabah,318,172,146,Brunei Darussalam
47878,5/1/2022,BRN,Sarawak,861,684,177,Brunei Darussalam
47879,5/1/2022,BRN,Selangor,1777,974,803,Brunei Darussalam
47880,5/1/2022,BRN,W.P. Labuan,24,17,7,Brunei Darussalam
47881,5/1/2022,BTN,Johor,1,1,0,Bhutan
47882,5/1/2022,BTN,Kedah,0,0,0,Bhutan
47883,5/1/2022,BTN,Perak,0,0,0,Bhutan
47884,5/1/2022,BTN,Perlis,0,0,0,Bhutan
47885,5/1/2022,BTN,Pulau Pinang,0,0,0,Bhutan
47886,5/1/2022,BTN,Sabah,0,0,0,Bhutan
47887,5/1/2022,BTN,Sarawak,0,0,0,Bhutan
47888,5/1/2022,BTN,Selangor,20,6,14,Bhutan
47889,5/1/2022,BWA,Johor,1,0,1,Botswana
47890,5/1/2022,BWA,Kedah,1,1,0,Botswana
47891,5/1/2022,BWA,Perlis,0,0,0,Botswana
47892,5/1/2022,BWA,Pulau Pinang,0,0,0,Botswana
47893,5/1/2022,BWA,Sabah,0,0,0,Botswana
47894,5/1/2022,BWA,Sarawak,0,0,0,Botswana
47895,5/1/2022,BWA,Selangor,20,13,7,Botswana
47896,5/1/2022,CAF,Kedah,0,0,0,Central African Republic
47897,5/1/2022,CAF,Selangor,0,0,0,Central African Republic
47898,5/1/2022,CAN,Johor,569,353,216,Canada
47899,5/1/2022,CAN,Kedah,48,27,21,Canada
47900,5/1/2022,CAN,Kelantan,1,1,0,Canada
47901,5/1/2022,CAN,Melaka,1,1,0,Canada
47902,5/1/2022,CAN,Negeri Sembilan,0,0,0,Canada
47903,5/1/2022,CAN,Pahang,0,0,0,Canada
47904,5/1/2022,CAN,Perak,3,3,0,Canada
47905,5/1/2022,CAN,Perlis,6,5,1,Canada
47906,5/1/2022,CAN,Pulau Pinang,113,67,46,Canada
47907,5/1/2022,CAN,Sabah,26,14,12,Canada
47908,5/1/2022,CAN,Sarawak,22,8,14,Canada
47909,5/1/2022,CAN,Selangor,1552,961,591,Canada
47910,5/1/2022,CAN,Terengganu,0,0,0,Canada
47911,5/1/2022,CAN,W.P. Labuan,0,0,0,Canada
47912,5/1/2022,CCK,Selangor,0,0,0,Cocos (Keeling) Islands
47913,5/1/2022,CHE,Johor,234,158,76,Switzerland
47914,5/1/2022,CHE,Kedah,28,16,12,Switzerland
47915,5/1/2022,CHE,Kelantan,0,0,0,Switzerland
47916,5/1/2022,CHE,Melaka,0,0,0,Switzerland
47917,5/1/2022,CHE,Negeri Sembilan,0,0,0,Switzerland
47918,5/1/2022,CHE,Pahang,1,0,1,Switzerland
47919,5/1/2022,CHE,Perak,2,2,0,Switzerland
47920,5/1/2022,CHE,Perlis,1,1,0,Switzerland
47921,5/1/2022,CHE,Pulau Pinang,38,27,11,Switzerland
47922,5/1/2022,CHE,Sabah,7,5,2,Switzerland
47923,5/1/2022,CHE,Sarawak,11,7,4,Switzerland
47924,5/1/2022,CHE,Selangor,451,300,151,Switzerland
47925,5/1/2022,CHE,W.P. Labuan,0,0,0,Switzerland
47926,5/1/2022,CHL,Johor,17,8,9,Chile
47927,5/1/2022,CHL,Kedah,5,2,3,Chile
47928,5/1/2022,CHL,Kelantan,0,0,0,Chile
47929,5/1/2022,CHL,Melaka,0,0,0,Chile
47930,5/1/2022,CHL,Pahang,0,0,0,Chile
47931,5/1/2022,CHL,Perak,0,0,0,Chile
47932,5/1/2022,CHL,Perlis,2,2,0,Chile
47933,5/1/2022,CHL,Pulau Pinang,2,2,0,Chile
47934,5/1/2022,CHL,Sabah,0,0,0,Chile
47935,5/1/2022,CHL,Sarawak,0,0,0,Chile
47936,5/1/2022,CHL,Selangor,69,38,31,Chile
47937,5/1/2022,CHN,Johor,8874,3776,5098,China
47938,5/1/2022,CHN,Kedah,121,48,73,China
47939,5/1/2022,CHN,Kelantan,1,0,1,China
47940,5/1/2022,CHN,Melaka,1,1,0,China
47941,5/1/2022,CHN,Pahang,3,1,2,China
47942,5/1/2022,CHN,Perak,38,20,18,China
47943,5/1/2022,CHN,Perlis,1,0,1,China
47944,5/1/2022,CHN,Pulau Pinang,405,202,203,China
47945,5/1/2022,CHN,Sabah,128,59,69,China
47946,5/1/2022,CHN,Sarawak,79,46,33,China
47947,5/1/2022,CHN,Selangor,6684,4288,2396,China
47948,5/1/2022,CHN,Terengganu,0,0,0,China
47949,5/1/2022,CHN,W.P. Labuan,0,0,0,China
47950,5/1/2022,CIV,Johor,0,0,0,C��te d'Iv
47951,5/1/2022,CIV,Kedah,0,0,0,C��te d'Iv
47952,5/1/2022,CIV,Pulau Pinang,0,0,0,C��te d'Iv
47953,5/1/2022,CIV,Sabah,1,0,1,C��te d'Iv
47954,5/1/2022,CIV,Sarawak,0,0,0,C��te d'Iv
47955,5/1/2022,CIV,Selangor,7,5,2,C��te d'Iv
47956,5/1/2022,CMR,Johor,1,1,0,Cameroon
47957,5/1/2022,CMR,Kedah,0,0,0,Cameroon
47958,5/1/2022,CMR,Pulau Pinang,0,0,0,Cameroon
47959,5/1/2022,CMR,Sabah,0,0,0,Cameroon
47960,5/1/2022,CMR,Sarawak,1,0,1,Cameroon
47961,5/1/2022,CMR,Selangor,7,4,3,Cameroon
47962,5/1/2022,COD,Johor,0,0,0,"Congo, the Democratic Republic of the"
47963,5/1/2022,COD,Pulau Pinang,0,0,0,"Congo, the Democratic Republic of the"
47964,5/1/2022,COD,Sarawak,0,0,0,"Congo, the Democratic Republic of the"
47965,5/1/2022,COD,Selangor,6,5,1,"Congo, the Democratic Republic of the"
47966,5/1/2022,COG,Johor,0,0,0,Congo
47967,5/1/2022,COG,Kedah,0,0,0,Congo
47968,5/1/2022,COG,Selangor,0,0,0,Congo
47969,5/1/2022,COK,Selangor,0,0,0,Cook Islands
47970,5/1/2022,COL,Johor,21,11,10,Colombia
47971,5/1/2022,COL,Kedah,3,1,2,Colombia
47972,5/1/2022,COL,Perak,2,1,1,Colombia
47973,5/1/2022,COL,Pulau Pinang,2,0,2,Colombia
47974,5/1/2022,COL,Sabah,0,0,0,Colombia
47975,5/1/2022,COL,Sarawak,0,0,0,Colombia
47976,5/1/2022,COL,Selangor,99,54,45,Colombia
47977,5/1/2022,COL,W.P. Labuan,0,0,0,Colombia
47978,5/1/2022,COM,Johor,0,0,0,Comoros
47979,5/1/2022,COM,Kedah,0,0,0,Comoros
47980,5/1/2022,COM,Selangor,6,5,1,Comoros
47981,5/1/2022,CPV,Johor,0,0,0,Cape Verde
47982,5/1/2022,CPV,Kedah,0,0,0,Cape Verde
47983,5/1/2022,CPV,Pulau Pinang,0,0,0,Cape Verde
47984,5/1/2022,CPV,Sabah,0,0,0,Cape Verde
47985,5/1/2022,CPV,Selangor,3,2,1,Cape Verde
47986,5/1/2022,CRI,Johor,3,2,1,Costa Rica
47987,5/1/2022,CRI,Kedah,2,1,1,Costa Rica
47988,5/1/2022,CRI,Perak,0,0,0,Costa Rica
47989,5/1/2022,CRI,Perlis,1,1,0,Costa Rica
47990,5/1/2022,CRI,Pulau Pinang,2,0,2,Costa Rica
47991,5/1/2022,CRI,Sabah,0,0,0,Costa Rica
47992,5/1/2022,CRI,Sarawak,0,0,0,Costa Rica
47993,5/1/2022,CRI,Selangor,25,20,5,Costa Rica
47994,5/1/2022,CUB,Johor,2,2,0,Cuba
47995,5/1/2022,CUB,Kedah,0,0,0,Cuba
47996,5/1/2022,CUB,Perlis,0,0,0,Cuba
47997,5/1/2022,CUB,Pulau Pinang,0,0,0,Cuba
47998,5/1/2022,CUB,Sabah,0,0,0,Cuba
47999,5/1/2022,CUB,Sarawak,0,0,0,Cuba
48000,5/1/2022,CUB,Selangor,12,7,5,Cuba
48001,5/1/2022,CYP,Johor,8,8,0,Cyprus
48002,5/1/2022,CYP,Kedah,3,1,2,Cyprus
48003,5/1/2022,CYP,Perak,0,0,0,Cyprus
48004,5/1/2022,CYP,Perlis,0,0,0,Cyprus
48005,5/1/2022,CYP,Pulau Pinang,4,3,1,Cyprus
48006,5/1/2022,CYP,Sabah,0,0,0,Cyprus
48007,5/1/2022,CYP,Sarawak,0,0,0,Cyprus
48008,5/1/2022,CYP,Selangor,27,18,9,Cyprus
48009,5/1/2022,CZE,Johor,27,20,7,Czech Republic
48010,5/1/2022,CZE,Kedah,6,3,3,Czech Republic
48011,5/1/2022,CZE,Kelantan,1,1,0,Czech Republic
48012,5/1/2022,CZE,Melaka,0,0,0,Czech Republic
48013,5/1/2022,CZE,Negeri Sembilan,0,0,0,Czech Republic
48014,5/1/2022,CZE,Perak,0,0,0,Czech Republic
48015,5/1/2022,CZE,Perlis,0,0,0,Czech Republic
48016,5/1/2022,CZE,Pulau Pinang,1,0,1,Czech Republic
48017,5/1/2022,CZE,Sabah,0,0,0,Czech Republic
48018,5/1/2022,CZE,Sarawak,0,0,0,Czech Republic
48019,5/1/2022,CZE,Selangor,122,83,39,Czech Republic
48020,5/1/2022,CZE,W.P. Labuan,0,0,0,Czech Republic
48021,5/1/2022,DEU,Johor,973,665,308,Germany
48022,5/1/2022,DEU,Kedah,97,59,38,Germany
48023,5/1/2022,DEU,Kelantan,2,1,1,Germany
48024,5/1/2022,DEU,Melaka,1,1,0,Germany
48025,5/1/2022,DEU,Negeri Sembilan,0,0,0,Germany
48026,5/1/2022,DEU,Pahang,0,0,0,Germany
48027,5/1/2022,DEU,Perak,12,7,5,Germany
48028,5/1/2022,DEU,Perlis,27,18,9,Germany
48029,5/1/2022,DEU,Pulau Pinang,283,208,75,Germany
48030,5/1/2022,DEU,Sabah,36,22,14,Germany
48031,5/1/2022,DEU,Sarawak,57,36,21,Germany
48032,5/1/2022,DEU,Selangor,2906,1989,917,Germany
48033,5/1/2022,DEU,Terengganu,0,0,0,Germany
48034,5/1/2022,DEU,W.P. Labuan,0,0,0,Germany
48035,5/1/2022,DJI,Johor,0,0,0,Djibouti
48036,5/1/2022,DJI,Selangor,6,3,3,Djibouti
48037,5/1/2022,DMA,Johor,6,4,2,Dominica
48038,5/1/2022,DMA,Kedah,0,0,0,Dominica
48039,5/1/2022,DMA,Pulau Pinang,0,0,0,Dominica
48040,5/1/2022,DMA,Sabah,0,0,0,Dominica
48041,5/1/2022,DMA,Sarawak,0,0,0,Dominica
48042,5/1/2022,DMA,Selangor,21,17,4,Dominica
48043,5/1/2022,DMA,W.P. Labuan,0,0,0,Dominica
48044,5/1/2022,DNK,Johor,150,94,56,Denmark
48045,5/1/2022,DNK,Kedah,17,10,7,Denmark
48046,5/1/2022,DNK,Kelantan,0,0,0,Denmark
48047,5/1/2022,DNK,Melaka,0,0,0,Denmark
48048,5/1/2022,DNK,Negeri Sembilan,0,0,0,Denmark
48049,5/1/2022,DNK,Pahang,0,0,0,Denmark
48050,5/1/2022,DNK,Perak,0,0,0,Denmark
48051,5/1/2022,DNK,Perlis,0,0,0,Denmark
48052,5/1/2022,DNK,Pulau Pinang,25,16,9,Denmark
48053,5/1/2022,DNK,Sabah,4,2,2,Denmark
48054,5/1/2022,DNK,Sarawak,2,2,0,Denmark
48055,5/1/2022,DNK,Selangor,422,288,134,Denmark
48056,5/1/2022,DNK,W.P. Labuan,0,0,0,Denmark
48057,5/1/2022,DOM,Johor,2,1,1,Dominican Republic
48058,5/1/2022,DOM,Kedah,0,0,0,Dominican Republic
48059,5/1/2022,DOM,Perak,0,0,0,Dominican Republic
48060,5/1/2022,DOM,Perlis,0,0,0,Dominican Republic
48061,5/1/2022,DOM,Pulau Pinang,1,0,1,Dominican Republic
48062,5/1/2022,DOM,Sabah,0,0,0,Dominican Republic
48063,5/1/2022,DOM,Sarawak,0,0,0,Dominican Republic
48064,5/1/2022,DOM,Selangor,11,3,8,Dominican Republic
48065,5/1/2022,DZA,Johor,27,24,3,Algeria
48066,5/1/2022,DZA,Kedah,0,0,0,Algeria
48067,5/1/2022,DZA,Kelantan,0,0,0,Algeria
48068,5/1/2022,DZA,Melaka,1,1,0,Algeria
48069,5/1/2022,DZA,Perak,0,0,0,Algeria
48070,5/1/2022,DZA,Perlis,0,0,0,Algeria
48071,5/1/2022,DZA,Pulau Pinang,1,0,1,Algeria
48072,5/1/2022,DZA,Sabah,0,0,0,Algeria
48073,5/1/2022,DZA,Sarawak,0,0,0,Algeria
48074,5/1/2022,DZA,Selangor,196,133,63,Algeria
48075,5/1/2022,DZA,W.P. Labuan,0,0,0,Algeria
48076,5/1/2022,ECU,Johor,5,3,2,Ecuador
48077,5/1/2022,ECU,Kedah,1,0,1,Ecuador
48078,5/1/2022,ECU,Perak,0,0,0,Ecuador
48079,5/1/2022,ECU,Perlis,0,0,0,Ecuador
48080,5/1/2022,ECU,Pulau Pinang,3,1,2,Ecuador
48081,5/1/2022,ECU,Sabah,0,0,0,Ecuador
48082,5/1/2022,ECU,Sarawak,0,0,0,Ecuador
48083,5/1/2022,ECU,Selangor,22,10,12,Ecuador
48084,5/1/2022,EGY,Johor,147,109,38,Egypt
48085,5/1/2022,EGY,Kedah,2,2,0,Egypt
48086,5/1/2022,EGY,Kelantan,0,0,0,Egypt
48087,5/1/2022,EGY,Melaka,0,0,0,Egypt
48088,5/1/2022,EGY,Pahang,0,0,0,Egypt
48089,5/1/2022,EGY,Perak,0,0,0,Egypt
48090,5/1/2022,EGY,Perlis,1,1,0,Egypt
48091,5/1/2022,EGY,Pulau Pinang,0,0,0,Egypt
48092,5/1/2022,EGY,Sabah,4,4,0,Egypt
48093,5/1/2022,EGY,Sarawak,2,2,0,Egypt
48094,5/1/2022,EGY,Selangor,1110,776,334,Egypt
48095,5/1/2022,EGY,Terengganu,0,0,0,Egypt
48096,5/1/2022,EGY,W.P. Labuan,0,0,0,Egypt
48097,5/1/2022,ERI,Johor,0,0,0,Eritrea
48098,5/1/2022,ERI,Pulau Pinang,0,0,0,Eritrea
48099,5/1/2022,ERI,Sabah,0,0,0,Eritrea
48100,5/1/2022,ERI,Selangor,9,3,6,Eritrea
48101,5/1/2022,ESP,Johor,230,145,85,Spain
48102,5/1/2022,ESP,Kedah,10,8,2,Spain
48103,5/1/2022,ESP,Kelantan,0,0,0,Spain
48104,5/1/2022,ESP,Melaka,0,0,0,Spain
48105,5/1/2022,ESP,Negeri Sembilan,0,0,0,Spain
48106,5/1/2022,ESP,Pahang,0,0,0,Spain
48107,5/1/2022,ESP,Perak,1,1,0,Spain
48108,5/1/2022,ESP,Perlis,0,0,0,Spain
48109,5/1/2022,ESP,Pulau Pinang,27,18,9,Spain
48110,5/1/2022,ESP,Sabah,13,11,2,Spain
48111,5/1/2022,ESP,Sarawak,3,2,1,Spain
48112,5/1/2022,ESP,Selangor,712,467,245,Spain
48113,5/1/2022,ESP,W.P. Labuan,0,0,0,Spain
48114,5/1/2022,EST,Johor,10,7,3,Estonia
48115,5/1/2022,EST,Kedah,1,1,0,Estonia
48116,5/1/2022,EST,Kelantan,0,0,0,Estonia
48117,5/1/2022,EST,Pahang,0,0,0,Estonia
48118,5/1/2022,EST,Perak,0,0,0,Estonia
48119,5/1/2022,EST,Perlis,0,0,0,Estonia
48120,5/1/2022,EST,Pulau Pinang,2,0,2,Estonia
48121,5/1/2022,EST,Sabah,1,1,0,Estonia
48122,5/1/2022,EST,Sarawak,0,0,0,Estonia
48123,5/1/2022,EST,Selangor,36,22,14,Estonia
48124,5/1/2022,EST,W.P. Labuan,0,0,0,Estonia
48125,5/1/2022,ETH,Johor,1,0,1,Ethiopia
48126,5/1/2022,ETH,Kedah,0,0,0,Ethiopia
48127,5/1/2022,ETH,Pulau Pinang,0,0,0,Ethiopia
48128,5/1/2022,ETH,Sarawak,0,0,0,Ethiopia
48129,5/1/2022,ETH,Selangor,25,23,2,Ethiopia
48130,5/1/2022,FIN,Johor,153,97,56,Finland
48131,5/1/2022,FIN,Kedah,11,4,7,Finland
48132,5/1/2022,FIN,Kelantan,0,0,0,Finland
48133,5/1/2022,FIN,Melaka,0,0,0,Finland
48134,5/1/2022,FIN,Negeri Sembilan,0,0,0,Finland
48135,5/1/2022,FIN,Pahang,0,0,0,Finland
48136,5/1/2022,FIN,Perak,0,0,0,Finland
48137,5/1/2022,FIN,Perlis,0,0,0,Finland
48138,5/1/2022,FIN,Pulau Pinang,6,3,3,Finland
48139,5/1/2022,FIN,Sabah,7,5,2,Finland
48140,5/1/2022,FIN,Sarawak,1,0,1,Finland
48141,5/1/2022,FIN,Selangor,200,136,64,Finland
48142,5/1/2022,FIN,W.P. Labuan,0,0,0,Finland
48143,5/1/2022,FJI,Johor,8,3,5,Fiji
48144,5/1/2022,FJI,Kedah,0,0,0,Fiji
48145,5/1/2022,FJI,Kelantan,0,0,0,Fiji
48146,5/1/2022,FJI,Perak,0,0,0,Fiji
48147,5/1/2022,FJI,Perlis,0,0,0,Fiji
48148,5/1/2022,FJI,Pulau Pinang,0,0,0,Fiji
48149,5/1/2022,FJI,Sabah,0,0,0,Fiji
48150,5/1/2022,FJI,Sarawak,0,0,0,Fiji
48151,5/1/2022,FJI,Selangor,27,16,11,Fiji
48152,5/1/2022,FRA,Johor,1290,804,486,France
48153,5/1/2022,FRA,Kedah,129,73,56,France
48154,5/1/2022,FRA,Kelantan,1,0,1,France
48155,5/1/2022,FRA,Melaka,0,0,0,France
48156,5/1/2022,FRA,Negeri Sembilan,4,2,2,France
48157,5/1/2022,FRA,Pahang,0,0,0,France
48158,5/1/2022,FRA,Perak,9,5,4,France
48159,5/1/2022,FRA,Perlis,15,6,9,France
48160,5/1/2022,FRA,Pulau Pinang,169,104,65,France
48161,5/1/2022,FRA,Sabah,60,39,21,France
48162,5/1/2022,FRA,Sarawak,12,9,3,France
48163,5/1/2022,FRA,Selangor,3278,2103,1175,France
48164,5/1/2022,FRA,Terengganu,0,0,0,France
48165,5/1/2022,FRA,W.P. Labuan,0,0,0,France
48166,5/1/2022,FSM,Johor,0,0,0,"Micronesia, Federated States of"
48167,5/1/2022,FSM,Pulau Pinang,0,0,0,"Micronesia, Federated States of"
48168,5/1/2022,FSM,Selangor,0,0,0,"Micronesia, Federated States of"
48169,5/1/2022,GAB,Johor,0,0,0,Gabon
48170,5/1/2022,GAB,Pulau Pinang,0,0,0,Gabon
48171,5/1/2022,GAB,Sarawak,0,0,0,Gabon
48172,5/1/2022,GAB,Selangor,1,1,0,Gabon
48173,5/1/2022,GBR,Johor,2686,1794,892,United Kingdom
48174,5/1/2022,GBR,Kedah,219,124,95,United Kingdom
48175,5/1/2022,GBR,Kelantan,1,1,0,United Kingdom
48176,5/1/2022,GBR,Melaka,1,0,1,United Kingdom
48177,5/1/2022,GBR,Negeri Sembilan,0,0,0,United Kingdom
48178,5/1/2022,GBR,Pahang,7,7,0,United Kingdom
48179,5/1/2022,GBR,Perak,32,16,16,United Kingdom
48180,5/1/2022,GBR,Perlis,23,16,7,United Kingdom
48181,5/1/2022,GBR,Pulau Pinang,479,313,166,United Kingdom
48182,5/1/2022,GBR,Sabah,262,149,113,United Kingdom
48183,5/1/2022,GBR,Sarawak,88,53,35,United Kingdom
48184,5/1/2022,GBR,Selangor,7316,4837,2479,United Kingdom
48185,5/1/2022,GBR,Terengganu,0,0,0,United Kingdom
48186,5/1/2022,GBR,W.P. Labuan,0,0,0,United Kingdom
48187,5/1/2022,GEO,Johor,0,0,0,Georgia
48188,5/1/2022,GEO,Kedah,2,1,1,Georgia
48189,5/1/2022,GEO,Melaka,0,0,0,Georgia
48190,5/1/2022,GEO,Perak,0,0,0,Georgia
48191,5/1/2022,GEO,Perlis,0,0,0,Georgia
48192,5/1/2022,GEO,Pulau Pinang,0,0,0,Georgia
48193,5/1/2022,GEO,Sabah,0,0,0,Georgia
48194,5/1/2022,GEO,Sarawak,0,0,0,Georgia
48195,5/1/2022,GEO,Selangor,24,10,14,Georgia
48196,5/1/2022,GHA,Johor,1,1,0,Ghana
48197,5/1/2022,GHA,Kedah,0,0,0,Ghana
48198,5/1/2022,GHA,Kelantan,0,0,0,Ghana
48199,5/1/2022,GHA,Pulau Pinang,0,0,0,Ghana
48200,5/1/2022,GHA,Sabah,0,0,0,Ghana
48201,5/1/2022,GHA,Sarawak,0,0,0,Ghana
48202,5/1/2022,GHA,Selangor,19,14,5,Ghana
48203,5/1/2022,GIB,Johor,0,0,0,Gibraltar
48204,5/1/2022,GIB,Sarawak,0,0,0,Gibraltar
48205,5/1/2022,GIN,Johor,0,0,0,Guinea
48206,5/1/2022,GIN,Kedah,0,0,0,Guinea
48207,5/1/2022,GIN,Kelantan,0,0,0,Guinea
48208,5/1/2022,GIN,Perlis,0,0,0,Guinea
48209,5/1/2022,GIN,Pulau Pinang,0,0,0,Guinea
48210,5/1/2022,GIN,Sabah,0,0,0,Guinea
48211,5/1/2022,GIN,Sarawak,0,0,0,Guinea
48212,5/1/2022,GIN,Selangor,30,19,11,Guinea
48213,5/1/2022,GLP,Selangor,0,0,0,Guadeloupe
48214,5/1/2022,GMB,Johor,2,1,1,Gambia
48215,5/1/2022,GMB,Kedah,0,0,0,Gambia
48216,5/1/2022,GMB,Kelantan,0,0,0,Gambia
48217,5/1/2022,GMB,Pulau Pinang,0,0,0,Gambia
48218,5/1/2022,GMB,Sabah,0,0,0,Gambia
48219,5/1/2022,GMB,Sarawak,0,0,0,Gambia
48220,5/1/2022,GMB,Selangor,7,5,2,Gambia
48221,5/1/2022,GNB,Johor,0,0,0,Guinea-Bissau
48222,5/1/2022,GNB,Selangor,0,0,0,Guinea-Bissau
48223,5/1/2022,GNQ,Johor,0,0,0,Equatorial Guinea
48224,5/1/2022,GNQ,Selangor,0,0,0,Equatorial Guinea
48225,5/1/2022,GRC,Johor,13,11,2,Greece
48226,5/1/2022,GRC,Kedah,2,1,1,Greece
48227,5/1/2022,GRC,Kelantan,0,0,0,Greece
48228,5/1/2022,GRC,Melaka,0,0,0,Greece
48229,5/1/2022,GRC,Negeri Sembilan,0,0,0,Greece
48230,5/1/2022,GRC,Pahang,0,0,0,Greece
48231,5/1/2022,GRC,Perak,0,0,0,Greece
48232,5/1/2022,GRC,Perlis,0,0,0,Greece
48233,5/1/2022,GRC,Pulau Pinang,3,2,1,Greece
48234,5/1/2022,GRC,Sabah,0,0,0,Greece
48235,5/1/2022,GRC,Sarawak,1,0,1,Greece
48236,5/1/2022,GRC,Selangor,85,67,18,Greece
48237,5/1/2022,GRD,Johor,4,4,0,Grenada
48238,5/1/2022,GRD,Kedah,0,0,0,Grenada
48239,5/1/2022,GRD,Pulau Pinang,0,0,0,Grenada
48240,5/1/2022,GRD,Sabah,0,0,0,Grenada
48241,5/1/2022,GRD,Sarawak,0,0,0,Grenada
48242,5/1/2022,GRD,Selangor,3,1,2,Grenada
48243,5/1/2022,GRL,Johor,0,0,0,Greenland
48244,5/1/2022,GRL,Selangor,0,0,0,Greenland
48245,5/1/2022,GTM,Johor,3,0,3,Guatemala
48246,5/1/2022,GTM,Kedah,0,0,0,Guatemala
48247,5/1/2022,GTM,Pahang,0,0,0,Guatemala
48248,5/1/2022,GTM,Perak,0,0,0,Guatemala
48249,5/1/2022,GTM,Pulau Pinang,3,1,2,Guatemala
48250,5/1/2022,GTM,Sabah,0,0,0,Guatemala
48251,5/1/2022,GTM,Sarawak,0,0,0,Guatemala
48252,5/1/2022,GTM,Selangor,8,1,7,Guatemala
48253,5/1/2022,GTM,W.P. Labuan,0,0,0,Guatemala
48254,5/1/2022,GUY,Johor,0,0,0,Guyana
48255,5/1/2022,GUY,Kedah,0,0,0,Guyana
48256,5/1/2022,GUY,Pulau Pinang,0,0,0,Guyana
48257,5/1/2022,GUY,Sarawak,0,0,0,Guyana
48258,5/1/2022,GUY,Selangor,1,1,0,Guyana
48259,5/1/2022,HKG,Johor,9,5,4,Hong Kong
48260,5/1/2022,HKG,Kedah,5,1,4,Hong Kong
48261,5/1/2022,HKG,Kelantan,0,0,0,Hong Kong
48262,5/1/2022,HKG,Pahang,0,0,0,Hong Kong
48263,5/1/2022,HKG,Perak,7,5,2,Hong Kong
48264,5/1/2022,HKG,Perlis,0,0,0,Hong Kong
48265,5/1/2022,HKG,Pulau Pinang,150,93,57,Hong Kong
48266,5/1/2022,HKG,Sabah,36,17,19,Hong Kong
48267,5/1/2022,HKG,Sarawak,47,25,22,Hong Kong
48268,5/1/2022,HKG,Selangor,1,1,0,Hong Kong
48269,5/1/2022,HKG,Terengganu,0,0,0,Hong Kong
48270,5/1/2022,HMD,Johor,0,0,0,Heard Island and McDonald Islands
48271,5/1/2022,HND,Johor,3,2,1,Honduras
48272,5/1/2022,HND,Kedah,0,0,0,Honduras
48273,5/1/2022,HND,Perak,0,0,0,Honduras
48274,5/1/2022,HND,Pulau Pinang,0,0,0,Honduras
48275,5/1/2022,HND,Sabah,0,0,0,Honduras
48276,5/1/2022,HND,Sarawak,0,0,0,Honduras
48277,5/1/2022,HND,Selangor,2,0,2,Honduras
48278,5/1/2022,HRV,Johor,13,12,1,Croatia
48279,5/1/2022,HRV,Kedah,0,0,0,Croatia
48280,5/1/2022,HRV,Kelantan,0,0,0,Croatia
48281,5/1/2022,HRV,Melaka,0,0,0,Croatia
48282,5/1/2022,HRV,Pahang,0,0,0,Croatia
48283,5/1/2022,HRV,Perak,0,0,0,Croatia
48284,5/1/2022,HRV,Perlis,0,0,0,Croatia
48285,5/1/2022,HRV,Pulau Pinang,1,1,0,Croatia
48286,5/1/2022,HRV,Sabah,0,0,0,Croatia
48287,5/1/2022,HRV,Sarawak,1,1,0,Croatia
48288,5/1/2022,HRV,Selangor,73,61,12,Croatia
48289,5/1/2022,HTI,Johor,0,0,0,Haiti
48290,5/1/2022,HTI,Kedah,0,0,0,Haiti
48291,5/1/2022,HTI,Kelantan,0,0,0,Haiti
48292,5/1/2022,HTI,Perak,0,0,0,Haiti
48293,5/1/2022,HTI,Pulau Pinang,0,0,0,Haiti
48294,5/1/2022,HTI,Sabah,0,0,0,Haiti
48295,5/1/2022,HTI,Selangor,7,2,5,Haiti
48296,5/1/2022,HUN,Johor,72,55,17,Hungary
48297,5/1/2022,HUN,Kedah,7,3,4,Hungary
48298,5/1/2022,HUN,Kelantan,0,0,0,Hungary
48299,5/1/2022,HUN,Pahang,0,0,0,Hungary
48300,5/1/2022,HUN,Perak,0,0,0,Hungary
48301,5/1/2022,HUN,Perlis,0,0,0,Hungary
48302,5/1/2022,HUN,Pulau Pinang,3,3,0,Hungary
48303,5/1/2022,HUN,Sabah,3,2,1,Hungary
48304,5/1/2022,HUN,Sarawak,2,2,0,Hungary
48305,5/1/2022,HUN,Selangor,110,65,45,Hungary
48306,5/1/2022,HUN,W.P. Labuan,0,0,0,Hungary
48307,5/1/2022,IDN,Johor,33449,15578,17871,Indonesia
48308,5/1/2022,IDN,Kedah,170,65,105,Indonesia
48309,5/1/2022,IDN,Kelantan,7,2,5,Indonesia
48310,5/1/2022,IDN,Melaka,2968,1349,1619,Indonesia
48311,5/1/2022,IDN,Negeri Sembilan,2772,1802,970,Indonesia
48312,5/1/2022,IDN,Pahang,8,6,2,Indonesia
48313,5/1/2022,IDN,Perak,29,4,25,Indonesia
48314,5/1/2022,IDN,Perlis,35,24,11,Indonesia
48315,5/1/2022,IDN,Pulau Pinang,9946,4185,5761,Indonesia
48316,5/1/2022,IDN,Sabah,2035,966,1069,Indonesia
48317,5/1/2022,IDN,Sarawak,12522,8386,4136,Indonesia
48318,5/1/2022,IDN,Selangor,45170,21148,24022,Indonesia
48319,5/1/2022,IDN,Terengganu,0,0,0,Indonesia
48320,5/1/2022,IDN,W.P. Labuan,2,2,0,Indonesia
48321,5/1/2022,IND,Johor,6606,4593,2013,India
48322,5/1/2022,IND,Kedah,618,412,206,India
48323,5/1/2022,IND,Kelantan,1,1,0,India
48324,5/1/2022,IND,Melaka,0,0,0,India
48325,5/1/2022,IND,Negeri Sembilan,0,0,0,India
48326,5/1/2022,IND,Pahang,2,2,0,India
48327,5/1/2022,IND,Perak,20,14,6,India
48328,5/1/2022,IND,Perlis,106,90,16,India
48329,5/1/2022,IND,Pulau Pinang,345,243,102,India
48330,5/1/2022,IND,Sabah,80,54,26,India
48331,5/1/2022,IND,Sarawak,31,28,3,India
48332,5/1/2022,IND,Selangor,27249,19319,7930,India
48333,5/1/2022,IND,Terengganu,0,0,0,India
48334,5/1/2022,IND,W.P. Labuan,0,0,0,India
48335,5/1/2022,IOT,Pulau Pinang,0,0,0,British Indian Ocean Territory
48336,5/1/2022,IOT,Selangor,0,0,0,British Indian Ocean Territory
48337,5/1/2022,IRL,Johor,209,153,56,Ireland
48338,5/1/2022,IRL,Kedah,16,9,7,Ireland
48339,5/1/2022,IRL,Kelantan,0,0,0,Ireland
48340,5/1/2022,IRL,Negeri Sembilan,0,0,0,Ireland
48341,5/1/2022,IRL,Pahang,0,0,0,Ireland
48342,5/1/2022,IRL,Perak,1,0,1,Ireland
48343,5/1/2022,IRL,Perlis,3,2,1,Ireland
48344,5/1/2022,IRL,Pulau Pinang,25,17,8,Ireland
48345,5/1/2022,IRL,Sabah,6,4,2,Ireland
48346,5/1/2022,IRL,Sarawak,8,3,5,Ireland
48347,5/1/2022,IRL,Selangor,451,278,173,Ireland
48348,5/1/2022,IRL,Terengganu,0,0,0,Ireland
48349,5/1/2022,IRL,W.P. Labuan,0,0,0,Ireland
48350,5/1/2022,IRN,Johor,98,57,41,Iran
48351,5/1/2022,IRN,Kedah,1,1,0,Iran
48352,5/1/2022,IRN,Kelantan,0,0,0,Iran
48353,5/1/2022,IRN,Perak,1,1,0,Iran
48354,5/1/2022,IRN,Perlis,2,1,1,Iran
48355,5/1/2022,IRN,Pulau Pinang,3,1,2,Iran
48356,5/1/2022,IRN,Sabah,2,1,1,Iran
48357,5/1/2022,IRN,Sarawak,0,0,0,Iran
48358,5/1/2022,IRN,Selangor,842,486,356,Iran
48359,5/1/2022,IRN,W.P. Labuan,0,0,0,Iran
48360,5/1/2022,IRQ,Johor,7,5,2,Iraq
48361,5/1/2022,IRQ,Kedah,0,0,0,Iraq
48362,5/1/2022,IRQ,Kelantan,0,0,0,Iraq
48363,5/1/2022,IRQ,Melaka,0,0,0,Iraq
48364,5/1/2022,IRQ,Pahang,0,0,0,Iraq
48365,5/1/2022,IRQ,Perak,0,0,0,Iraq
48366,5/1/2022,IRQ,Perlis,0,0,0,Iraq
48367,5/1/2022,IRQ,Pulau Pinang,0,0,0,Iraq
48368,5/1/2022,IRQ,Sabah,0,0,0,Iraq
48369,5/1/2022,IRQ,Sarawak,0,0,0,Iraq
48370,5/1/2022,IRQ,Selangor,543,373,170,Iraq
48371,5/1/2022,ISL,Johor,29,9,20,Iceland
48372,5/1/2022,ISL,Kedah,0,0,0,Iceland
48373,5/1/2022,ISL,Kelantan,0,0,0,Iceland
48374,5/1/2022,ISL,Perak,0,0,0,Iceland
48375,5/1/2022,ISL,Perlis,0,0,0,Iceland
48376,5/1/2022,ISL,Pulau Pinang,0,0,0,Iceland
48377,5/1/2022,ISL,Sabah,0,0,0,Iceland
48378,5/1/2022,ISL,Sarawak,0,0,0,Iceland
48379,5/1/2022,ISL,Selangor,5,2,3,Iceland
48380,5/1/2022,ISL,W.P. Labuan,0,0,0,Iceland
48381,5/1/2022,ISR,Pulau Pinang,4,2,2,Israel
48382,5/1/2022,ITA,Johor,274,208,66,Italy
48383,5/1/2022,ITA,Kedah,28,18,10,Italy
48384,5/1/2022,ITA,Kelantan,0,0,0,Italy
48385,5/1/2022,ITA,Melaka,0,0,0,Italy
48386,5/1/2022,ITA,Negeri Sembilan,0,0,0,Italy
48387,5/1/2022,ITA,Pahang,1,1,0,Italy
48388,5/1/2022,ITA,Perak,2,2,0,Italy
48389,5/1/2022,ITA,Perlis,1,1,0,Italy
48390,5/1/2022,ITA,Pulau Pinang,38,33,5,Italy
48391,5/1/2022,ITA,Sabah,9,6,3,Italy
48392,5/1/2022,ITA,Sarawak,5,5,0,Italy
48393,5/1/2022,ITA,Selangor,955,696,259,Italy
48394,5/1/2022,ITA,W.P. Labuan,0,0,0,Italy
48395,5/1/2022,JAM,Johor,0,0,0,Jamaica
48396,5/1/2022,JAM,Kedah,0,0,0,Jamaica
48397,5/1/2022,JAM,Perak,0,0,0,Jamaica
48398,5/1/2022,JAM,Pulau Pinang,0,0,0,Jamaica
48399,5/1/2022,JAM,Sabah,0,0,0,Jamaica
48400,5/1/2022,JAM,Sarawak,0,0,0,Jamaica
48401,5/1/2022,JAM,Selangor,1,1,0,Jamaica
48402,5/1/2022,JAM,W.P. Labuan,0,0,0,Jamaica
48403,5/1/2022,JOR,Johor,15,6,9,Jordan
48404,5/1/2022,JOR,Kedah,8,4,4,Jordan
48405,5/1/2022,JOR,Kelantan,0,0,0,Jordan
48406,5/1/2022,JOR,Melaka,0,0,0,Jordan
48407,5/1/2022,JOR,Perlis,0,0,0,Jordan
48408,5/1/2022,JOR,Pulau Pinang,8,5,3,Jordan
48409,5/1/2022,JOR,Sabah,0,0,0,Jordan
48410,5/1/2022,JOR,Sarawak,0,0,0,Jordan
48411,5/1/2022,JOR,Selangor,517,326,191,Jordan
48412,5/1/2022,JOR,W.P. Labuan,0,0,0,Jordan
48413,5/1/2022,JPN,Johor,3507,2424,1083,Japan
48414,5/1/2022,JPN,Kedah,69,41,28,Japan
48415,5/1/2022,JPN,Kelantan,0,0,0,Japan
48416,5/1/2022,JPN,Melaka,0,0,0,Japan
48417,5/1/2022,JPN,Negeri Sembilan,0,0,0,Japan
48418,5/1/2022,JPN,Pahang,0,0,0,Japan
48419,5/1/2022,JPN,Perak,7,5,2,Japan
48420,5/1/2022,JPN,Perlis,0,0,0,Japan
48421,5/1/2022,JPN,Pulau Pinang,365,273,92,Japan
48422,5/1/2022,JPN,Sabah,73,42,31,Japan
48423,5/1/2022,JPN,Sarawak,34,23,11,Japan
48424,5/1/2022,JPN,Selangor,5015,3676,1339,Japan
48425,5/1/2022,JPN,W.P. Labuan,0,0,0,Japan
48426,5/1/2022,KAZ,Johor,11,8,3,Kazakhstan
48427,5/1/2022,KAZ,Kedah,0,0,0,Kazakhstan
48428,5/1/2022,KAZ,Kelantan,0,0,0,Kazakhstan
48429,5/1/2022,KAZ,Melaka,0,0,0,Kazakhstan
48430,5/1/2022,KAZ,Perak,0,0,0,Kazakhstan
48431,5/1/2022,KAZ,Perlis,0,0,0,Kazakhstan
48432,5/1/2022,KAZ,Pulau Pinang,0,0,0,Kazakhstan
48433,5/1/2022,KAZ,Sabah,2,1,1,Kazakhstan
48434,5/1/2022,KAZ,Sarawak,1,0,1,Kazakhstan
48435,5/1/2022,KAZ,Selangor,195,75,120,Kazakhstan
48436,5/1/2022,KAZ,W.P. Labuan,0,0,0,Kazakhstan
48437,5/1/2022,KEN,Johor,41,19,22,Kenya
48438,5/1/2022,KEN,Kedah,6,2,4,Kenya
48439,5/1/2022,KEN,Kelantan,0,0,0,Kenya
48440,5/1/2022,KEN,Perak,0,0,0,Kenya
48441,5/1/2022,KEN,Perlis,0,0,0,Kenya
48442,5/1/2022,KEN,Pulau Pinang,1,0,1,Kenya
48443,5/1/2022,KEN,Sabah,0,0,0,Kenya
48444,5/1/2022,KEN,Sarawak,1,1,0,Kenya
48445,5/1/2022,KEN,Selangor,133,75,58,Kenya
48446,5/1/2022,KGZ,Johor,13,5,8,Kyrgyzstan
48447,5/1/2022,KGZ,Kedah,0,0,0,Kyrgyzstan
48448,5/1/2022,KGZ,Kelantan,0,0,0,Kyrgyzstan
48449,5/1/2022,KGZ,Perak,0,0,0,Kyrgyzstan
48450,5/1/2022,KGZ,Perlis,0,0,0,Kyrgyzstan
48451,5/1/2022,KGZ,Pulau Pinang,0,0,0,Kyrgyzstan
48452,5/1/2022,KGZ,Sabah,0,0,0,Kyrgyzstan
48453,5/1/2022,KGZ,Sarawak,0,0,0,Kyrgyzstan
48454,5/1/2022,KGZ,Selangor,152,93,59,Kyrgyzstan
48455,5/1/2022,KHM,Johor,153,70,83,Cambodia
48456,5/1/2022,KHM,Kedah,345,299,46,Cambodia
48457,5/1/2022,KHM,Kelantan,6,6,0,Cambodia
48458,5/1/2022,KHM,Melaka,0,0,0,Cambodia
48459,5/1/2022,KHM,Negeri Sembilan,0,0,0,Cambodia
48460,5/1/2022,KHM,Pahang,0,0,0,Cambodia
48461,5/1/2022,KHM,Perak,1,1,0,Cambodia
48462,5/1/2022,KHM,Perlis,151,108,43,Cambodia
48463,5/1/2022,KHM,Pulau Pinang,30,20,10,Cambodia
48464,5/1/2022,KHM,Sabah,0,0,0,Cambodia
48465,5/1/2022,KHM,Sarawak,2,1,1,Cambodia
48466,5/1/2022,KHM,Selangor,2022,1203,819,Cambodia
48467,5/1/2022,KHM,W.P. Labuan,0,0,0,Cambodia
48468,5/1/2022,KIR,Johor,0,0,0,Kiribati
48469,5/1/2022,KIR,Sabah,0,0,0,Kiribati
48470,5/1/2022,KIR,Selangor,0,0,0,Kiribati
48471,5/1/2022,KNA,Johor,15,13,2,Saint Kitts and Nevis
48472,5/1/2022,KNA,Kedah,0,0,0,Saint Kitts and Nevis
48473,5/1/2022,KNA,Perlis,0,0,0,Saint Kitts and Nevis
48474,5/1/2022,KNA,Pulau Pinang,0,0,0,Saint Kitts and Nevis
48475,5/1/2022,KNA,Sabah,1,0,1,Saint Kitts and Nevis
48476,5/1/2022,KNA,Selangor,42,28,14,Saint Kitts and Nevis
48477,5/1/2022,KNA,W.P. Labuan,0,0,0,Saint Kitts and Nevis
48478,5/1/2022,KOR,Johor,5302,3243,2059,"Korea, Republic of (South Korea)"
48479,5/1/2022,KOR,Kedah,40,18,22,"Korea, Republic of (South Korea)"
48480,5/1/2022,KOR,Kelantan,0,0,0,"Korea, Republic of (South Korea)"
48481,5/1/2022,KOR,Melaka,1,1,0,"Korea, Republic of (South Korea)"
48482,5/1/2022,KOR,Negeri Sembilan,0,0,0,"Korea, Republic of (South Korea)"
48483,5/1/2022,KOR,Pahang,0,0,0,"Korea, Republic of (South Korea)"
48484,5/1/2022,KOR,Perak,6,4,2,"Korea, Republic of (South Korea)"
48485,5/1/2022,KOR,Perlis,7,5,2,"Korea, Republic of (South Korea)"
48486,5/1/2022,KOR,Pulau Pinang,154,98,56,"Korea, Republic of (South Korea)"
48487,5/1/2022,KOR,Sabah,382,191,191,"Korea, Republic of (South Korea)"
48488,5/1/2022,KOR,Sarawak,55,41,14,"Korea, Republic of (South Korea)"
48489,5/1/2022,KOR,Selangor,3906,2610,1296,"Korea, Republic of (South Korea)"
48490,5/1/2022,KOR,Terengganu,0,0,0,"Korea, Republic of (South Korea)"
48491,5/1/2022,KOR,W.P. Labuan,0,0,0,"Korea, Republic of (South Korea)"
48492,5/1/2022,KWT,Johor,21,10,11,Kuwait
48493,5/1/2022,KWT,Kedah,1,0,1,Kuwait
48494,5/1/2022,KWT,Kelantan,0,0,0,Kuwait
48495,5/1/2022,KWT,Perak,0,0,0,Kuwait
48496,5/1/2022,KWT,Perlis,0,0,0,Kuwait
48497,5/1/2022,KWT,Pulau Pinang,2,0,2,Kuwait
48498,5/1/2022,KWT,Sabah,0,0,0,Kuwait
48499,5/1/2022,KWT,Sarawak,0,0,0,Kuwait
48500,5/1/2022,KWT,Selangor,167,109,58,Kuwait
48501,5/1/2022,KWT,W.P. Labuan,0,0,0,Kuwait
48502,5/1/2022,LAO,Johor,8,1,7,Lao People's Democratic Republic
48503,5/1/2022,LAO,Kedah,188,57,131,Lao People's Democratic Republic
48504,5/1/2022,LAO,Kelantan,2,0,2,Lao People's Democratic Republic
48505,5/1/2022,LAO,Melaka,0,0,0,Lao People's Democratic Republic
48506,5/1/2022,LAO,Perak,0,0,0,Lao People's Democratic Republic
48507,5/1/2022,LAO,Perlis,2,1,1,Lao People's Democratic Republic
48508,5/1/2022,LAO,Pulau Pinang,3,2,1,Lao People's Democratic Republic
48509,5/1/2022,LAO,Sabah,1,0,1,Lao People's Democratic Republic
48510,5/1/2022,LAO,Sarawak,0,0,0,Lao People's Democratic Republic
48511,5/1/2022,LAO,Selangor,239,186,53,Lao People's Democratic Republic
48512,5/1/2022,LAO,W.P. Labuan,0,0,0,Lao People's Democratic Republic
48513,5/1/2022,LBN,Johor,10,6,4,Lebanon
48514,5/1/2022,LBN,Kedah,6,4,2,Lebanon
48515,5/1/2022,LBN,Kelantan,0,0,0,Lebanon
48516,5/1/2022,LBN,Pahang,0,0,0,Lebanon
48517,5/1/2022,LBN,Perak,0,0,0,Lebanon
48518,5/1/2022,LBN,Perlis,0,0,0,Lebanon
48519,5/1/2022,LBN,Pulau Pinang,3,1,2,Lebanon
48520,5/1/2022,LBN,Sabah,0,0,0,Lebanon
48521,5/1/2022,LBN,Sarawak,0,0,0,Lebanon
48522,5/1/2022,LBN,Selangor,146,99,47,Lebanon
48523,5/1/2022,LBN,W.P. Labuan,0,0,0,Lebanon
48524,5/1/2022,LBR,Johor,0,0,0,Liberia
48525,5/1/2022,LBR,Kedah,0,0,0,Liberia
48526,5/1/2022,LBR,Sabah,0,0,0,Liberia
48527,5/1/2022,LBR,Sarawak,0,0,0,Liberia
48528,5/1/2022,LBR,Selangor,3,1,2,Liberia
48529,5/1/2022,LBY,Johor,1,1,0,Libyan Arab Jamahiriya
48530,5/1/2022,LBY,Kedah,0,0,0,Libyan Arab Jamahiriya
48531,5/1/2022,LBY,Perlis,0,0,0,Libyan Arab Jamahiriya
48532,5/1/2022,LBY,Pulau Pinang,0,0,0,Libyan Arab Jamahiriya
48533,5/1/2022,LBY,Sabah,0,0,0,Libyan Arab Jamahiriya
48534,5/1/2022,LBY,Sarawak,0,0,0,Libyan Arab Jamahiriya
48535,5/1/2022,LBY,Selangor,239,169,70,Libyan Arab Jamahiriya
48536,5/1/2022,LCA,Johor,2,2,0,Saint Lucia
48537,5/1/2022,LCA,Kedah,0,0,0,Saint Lucia
48538,5/1/2022,LCA,Pulau Pinang,0,0,0,Saint Lucia
48539,5/1/2022,LCA,Sarawak,0,0,0,Saint Lucia
48540,5/1/2022,LCA,Selangor,3,3,0,Saint Lucia
48541,5/1/2022,LIE,Johor,0,0,0,Liechtenstein
48542,5/1/2022,LIE,Kedah,0,0,0,Liechtenstein
48543,5/1/2022,LIE,Perlis,0,0,0,Liechtenstein
48544,5/1/2022,LIE,Pulau Pinang,1,1,0,Liechtenstein
48545,5/1/2022,LIE,Sabah,0,0,0,Liechtenstein
48546,5/1/2022,LIE,Sarawak,0,0,0,Liechtenstein
48547,5/1/2022,LIE,Selangor,6,3,3,Liechtenstein
48548,5/1/2022,LKA,Johor,361,241,120,Sri Lanka
48549,5/1/2022,LKA,Kedah,3,2,1,Sri Lanka
48550,5/1/2022,LKA,Kelantan,0,0,0,Sri Lanka
48551,5/1/2022,LKA,Melaka,0,0,0,Sri Lanka
48552,5/1/2022,LKA,Pahang,0,0,0,Sri Lanka
48553,5/1/2022,LKA,Perak,0,0,0,Sri Lanka
48554,5/1/2022,LKA,Perlis,0,0,0,Sri Lanka
48555,5/1/2022,LKA,Pulau Pinang,17,13,4,Sri Lanka
48556,5/1/2022,LKA,Sabah,0,0,0,Sri Lanka
48557,5/1/2022,LKA,Sarawak,4,4,0,Sri Lanka
48558,5/1/2022,LKA,Selangor,1797,1119,678,Sri Lanka
48559,5/1/2022,LKA,W.P. Labuan,0,0,0,Sri Lanka
48560,5/1/2022,LSO,Johor,0,0,0,Lesotho
48561,5/1/2022,LSO,Kedah,0,0,0,Lesotho
48562,5/1/2022,LSO,Pulau Pinang,0,0,0,Lesotho
48563,5/1/2022,LSO,Sarawak,0,0,0,Lesotho
48564,5/1/2022,LSO,Selangor,6,3,3,Lesotho
48565,5/1/2022,LTU,Johor,13,4,9,Lithuania
48566,5/1/2022,LTU,Kedah,4,3,1,Lithuania
48567,5/1/2022,LTU,Kelantan,0,0,0,Lithuania
48568,5/1/2022,LTU,Pahang,1,0,1,Lithuania
48569,5/1/2022,LTU,Perak,0,0,0,Lithuania
48570,5/1/2022,LTU,Perlis,0,0,0,Lithuania
48571,5/1/2022,LTU,Pulau Pinang,4,2,2,Lithuania
48572,5/1/2022,LTU,Sabah,5,5,0,Lithuania
48573,5/1/2022,LTU,Sarawak,0,0,0,Lithuania
48574,5/1/2022,LTU,Selangor,73,42,31,Lithuania
48575,5/1/2022,LTU,W.P. Labuan,0,0,0,Lithuania
48576,5/1/2022,LUX,Johor,1,1,0,Luxembourg
48577,5/1/2022,LUX,Kedah,0,0,0,Luxembourg
48578,5/1/2022,LUX,Kelantan,0,0,0,Luxembourg
48579,5/1/2022,LUX,Perak,0,0,0,Luxembourg
48580,5/1/2022,LUX,Perlis,1,1,0,Luxembourg
48581,5/1/2022,LUX,Pulau Pinang,1,1,0,Luxembourg
48582,5/1/2022,LUX,Sabah,0,0,0,Luxembourg
48583,5/1/2022,LUX,Sarawak,0,0,0,Luxembourg
48584,5/1/2022,LUX,Selangor,12,11,1,Luxembourg
48585,5/1/2022,LVA,Johor,6,3,3,Latvia
48586,5/1/2022,LVA,Kedah,3,2,1,Latvia
48587,5/1/2022,LVA,Kelantan,0,0,0,Latvia
48588,5/1/2022,LVA,Pahang,0,0,0,Latvia
48589,5/1/2022,LVA,Perak,0,0,0,Latvia
48590,5/1/2022,LVA,Perlis,0,0,0,Latvia
48591,5/1/2022,LVA,Pulau Pinang,0,0,0,Latvia
48592,5/1/2022,LVA,Sabah,2,1,1,Latvia
48593,5/1/2022,LVA,Sarawak,0,0,0,Latvia
48594,5/1/2022,LVA,Selangor,28,16,12,Latvia
48595,5/1/2022,LVA,W.P. Labuan,0,0,0,Latvia
48596,5/1/2022,MAC,Johor,1,0,1,Macao
48597,5/1/2022,MAC,Pahang,0,0,0,Macao
48598,5/1/2022,MAC,Perak,0,0,0,Macao
48599,5/1/2022,MAC,Selangor,0,0,0,Macao
48600,5/1/2022,MAC,W.P. Labuan,0,0,0,Macao
48601,5/1/2022,MAR,Johor,40,24,16,Morocco
48602,5/1/2022,MAR,Kedah,3,2,1,Morocco
48603,5/1/2022,MAR,Kelantan,1,1,0,Morocco
48604,5/1/2022,MAR,Melaka,0,0,0,Morocco
48605,5/1/2022,MAR,Pahang,0,0,0,Morocco
48606,5/1/2022,MAR,Perak,0,0,0,Morocco
48607,5/1/2022,MAR,Perlis,0,0,0,Morocco
48608,5/1/2022,MAR,Pulau Pinang,0,0,0,Morocco
48609,5/1/2022,MAR,Sabah,1,1,0,Morocco
48610,5/1/2022,MAR,Sarawak,0,0,0,Morocco
48611,5/1/2022,MAR,Selangor,354,152,202,Morocco
48612,5/1/2022,MAR,W.P. Labuan,0,0,0,Morocco
48613,5/1/2022,MCO,Johor,1,1,0,Monaco
48614,5/1/2022,MCO,Kedah,0,0,0,Monaco
48615,5/1/2022,MCO,Sabah,0,0,0,Monaco
48616,5/1/2022,MCO,Selangor,5,1,4,Monaco
48617,5/1/2022,MDA,Johor,0,0,0,"Moldova, Republic of"
48618,5/1/2022,MDA,Kedah,0,0,0,"Moldova, Republic of"
48619,5/1/2022,MDA,Kelantan,0,0,0,"Moldova, Republic of"
48620,5/1/2022,MDA,Negeri Sembilan,0,0,0,"Moldova, Republic of"
48621,5/1/2022,MDA,Perlis,0,0,0,"Moldova, Republic of"
48622,5/1/2022,MDA,Pulau Pinang,0,0,0,"Moldova, Republic of"
48623,5/1/2022,MDA,Sabah,0,0,0,"Moldova, Republic of"
48624,5/1/2022,MDA,Sarawak,0,0,0,"Moldova, Republic of"
48625,5/1/2022,MDA,Selangor,12,5,7,"Moldova, Republic of"
48626,5/1/2022,MDG,Johor,2,1,1,Madagascar
48627,5/1/2022,MDG,Kedah,0,0,0,Madagascar
48628,5/1/2022,MDG,Perak,0,0,0,Madagascar
48629,5/1/2022,MDG,Perlis,0,0,0,Madagascar
48630,5/1/2022,MDG,Pulau Pinang,0,0,0,Madagascar
48631,5/1/2022,MDG,Sabah,0,0,0,Madagascar
48632,5/1/2022,MDG,Sarawak,0,0,0,Madagascar
48633,5/1/2022,MDG,Selangor,4,2,2,Madagascar
48634,5/1/2022,MDV,Johor,89,68,21,Maldives
48635,5/1/2022,MDV,Kedah,9,6,3,Maldives
48636,5/1/2022,MDV,Kelantan,0,0,0,Maldives
48637,5/1/2022,MDV,Perak,1,0,1,Maldives
48638,5/1/2022,MDV,Perlis,0,0,0,Maldives
48639,5/1/2022,MDV,Pulau Pinang,6,2,4,Maldives
48640,5/1/2022,MDV,Sabah,6,2,4,Maldives
48641,5/1/2022,MDV,Sarawak,1,1,0,Maldives
48642,5/1/2022,MDV,Selangor,1500,770,730,Maldives
48643,5/1/2022,MEX,Johor,41,24,17,Mexico
48644,5/1/2022,MEX,Kedah,8,5,3,Mexico
48645,5/1/2022,MEX,Kelantan,0,0,0,Mexico
48646,5/1/2022,MEX,Pahang,0,0,0,Mexico
48647,5/1/2022,MEX,Perak,0,0,0,Mexico
48648,5/1/2022,MEX,Perlis,0,0,0,Mexico
48649,5/1/2022,MEX,Pulau Pinang,35,29,6,Mexico
48650,5/1/2022,MEX,Sabah,1,0,1,Mexico
48651,5/1/2022,MEX,Sarawak,0,0,0,Mexico
48652,5/1/2022,MEX,Selangor,168,96,72,Mexico
48653,5/1/2022,MEX,W.P. Labuan,0,0,0,Mexico
48654,5/1/2022,MHL,Johor,0,0,0,Marshall Islands
48655,5/1/2022,MHL,Kedah,0,0,0,Marshall Islands
48656,5/1/2022,MHL,Perak,0,0,0,Marshall Islands
48657,5/1/2022,MHL,Pulau Pinang,0,0,0,Marshall Islands
48658,5/1/2022,MHL,Sabah,0,0,0,Marshall Islands
48659,5/1/2022,MHL,Selangor,0,0,0,Marshall Islands
48660,5/1/2022,MKD,Johor,1,0,1,"Macedonia, the former Yugoslav Republic of"
48661,5/1/2022,MKD,Kedah,4,2,2,"Macedonia, the former Yugoslav Republic of"
48662,5/1/2022,MKD,Perak,0,0,0,"Macedonia, the former Yugoslav Republic of"
48663,5/1/2022,MKD,Pulau Pinang,0,0,0,"Macedonia, the former Yugoslav Republic of"
48664,5/1/2022,MKD,Sabah,0,0,0,"Macedonia, the former Yugoslav Republic of"
48665,5/1/2022,MKD,Sarawak,0,0,0,"Macedonia, the former Yugoslav Republic of"
48666,5/1/2022,MKD,Selangor,7,2,5,"Macedonia, the former Yugoslav Republic of"
48667,5/1/2022,MLI,Johor,0,0,0,Mali
48668,5/1/2022,MLI,Sabah,0,0,0,Mali
48669,5/1/2022,MLI,Selangor,0,0,0,Mali
48670,5/1/2022,MLT,Johor,8,4,4,Malta
48671,5/1/2022,MLT,Kedah,0,0,0,Malta
48672,5/1/2022,MLT,Kelantan,0,0,0,Malta
48673,5/1/2022,MLT,Perak,0,0,0,Malta
48674,5/1/2022,MLT,Perlis,0,0,0,Malta
48675,5/1/2022,MLT,Pulau Pinang,3,3,0,Malta
48676,5/1/2022,MLT,Sabah,0,0,0,Malta
48677,5/1/2022,MLT,Sarawak,0,0,0,Malta
48678,5/1/2022,MLT,Selangor,19,13,6,Malta
48679,5/1/2022,MLT,W.P. Labuan,0,0,0,Malta
48680,5/1/2022,MMR,Johor,1485,525,960,Myanmar
48681,5/1/2022,MMR,Kedah,4,1,3,Myanmar
48682,5/1/2022,MMR,Kelantan,0,0,0,Myanmar
48683,5/1/2022,MMR,Negeri Sembilan,0,0,0,Myanmar
48684,5/1/2022,MMR,Pahang,0,0,0,Myanmar
48685,5/1/2022,MMR,Perak,6,2,4,Myanmar
48686,5/1/2022,MMR,Perlis,1,0,1,Myanmar
48687,5/1/2022,MMR,Pulau Pinang,31,15,16,Myanmar
48688,5/1/2022,MMR,Sabah,5,4,1,Myanmar
48689,5/1/2022,MMR,Sarawak,7,3,4,Myanmar
48690,5/1/2022,MMR,Selangor,1553,943,610,Myanmar
48691,5/1/2022,MMR,Terengganu,0,0,0,Myanmar
48692,5/1/2022,MMR,W.P. Labuan,0,0,0,Myanmar
48693,5/1/2022,MNE,Johor,0,0,0,Montenegro
48694,5/1/2022,MNE,Kedah,0,0,0,Montenegro
48695,5/1/2022,MNE,Pulau Pinang,0,0,0,Montenegro
48696,5/1/2022,MNE,Sabah,0,0,0,Montenegro
48697,5/1/2022,MNE,Sarawak,0,0,0,Montenegro
48698,5/1/2022,MNE,Selangor,8,7,1,Montenegro
48699,5/1/2022,MNG,Johor,32,10,22,Mongolia
48700,5/1/2022,MNG,Kedah,3,1,2,Mongolia
48701,5/1/2022,MNG,Kelantan,0,0,0,Mongolia
48702,5/1/2022,MNG,Perak,0,0,0,Mongolia
48703,5/1/2022,MNG,Perlis,0,0,0,Mongolia
48704,5/1/2022,MNG,Pulau Pinang,2,0,2,Mongolia
48705,5/1/2022,MNG,Sabah,0,0,0,Mongolia
48706,5/1/2022,MNG,Sarawak,0,0,0,Mongolia
48707,5/1/2022,MNG,Selangor,112,56,56,Mongolia
48708,5/1/2022,MNP,Selangor,0,0,0,Northern Mariana Islands
48709,5/1/2022,MOZ,Johor,0,0,0,Mozambique
48710,5/1/2022,MOZ,Kedah,0,0,0,Mozambique
48711,5/1/2022,MOZ,Perak,0,0,0,Mozambique
48712,5/1/2022,MOZ,Pulau Pinang,0,0,0,Mozambique
48713,5/1/2022,MOZ,Sabah,0,0,0,Mozambique
48714,5/1/2022,MOZ,Sarawak,0,0,0,Mozambique
48715,5/1/2022,MOZ,Selangor,10,6,4,Mozambique
48716,5/1/2022,MRT,Johor,0,0,0,Mauritania
48717,5/1/2022,MRT,Kedah,0,0,0,Mauritania
48718,5/1/2022,MRT,Pulau Pinang,0,0,0,Mauritania
48719,5/1/2022,MRT,Sabah,0,0,0,Mauritania
48720,5/1/2022,MRT,Sarawak,0,0,0,Mauritania
48721,5/1/2022,MRT,Selangor,17,14,3,Mauritania
48722,5/1/2022,MUS,Johor,29,17,12,Mauritius
48723,5/1/2022,MUS,Kedah,2,1,1,Mauritius
48724,5/1/2022,MUS,Kelantan,0,0,0,Mauritius
48725,5/1/2022,MUS,Pahang,0,0,0,Mauritius
48726,5/1/2022,MUS,Perak,0,0,0,Mauritius
48727,5/1/2022,MUS,Perlis,0,0,0,Mauritius
48728,5/1/2022,MUS,Pulau Pinang,2,2,0,Mauritius
48729,5/1/2022,MUS,Sabah,0,0,0,Mauritius
48730,5/1/2022,MUS,Sarawak,0,0,0,Mauritius
48731,5/1/2022,MUS,Selangor,140,74,66,Mauritius
48732,5/1/2022,MWI,Johor,0,0,0,Malawi
48733,5/1/2022,MWI,Pulau Pinang,0,0,0,Malawi
48734,5/1/2022,MWI,Sabah,0,0,0,Malawi
48735,5/1/2022,MWI,Sarawak,0,0,0,Malawi
48736,5/1/2022,MWI,Selangor,7,4,3,Malawi
48737,5/1/2022,MYT,Selangor,0,0,0,Mayotte
48738,5/1/2022,NAM,Johor,0,0,0,Namibia
48739,5/1/2022,NAM,Kedah,0,0,0,Namibia
48740,5/1/2022,NAM,Perak,0,0,0,Namibia
48741,5/1/2022,NAM,Perlis,0,0,0,Namibia
48742,5/1/2022,NAM,Pulau Pinang,0,0,0,Namibia
48743,5/1/2022,NAM,Sabah,0,0,0,Namibia
48744,5/1/2022,NAM,Sarawak,0,0,0,Namibia
48745,5/1/2022,NAM,Selangor,8,3,5,Namibia
48746,5/1/2022,NCL,Selangor,0,0,0,New Caledonia
48747,5/1/2022,NER,Johor,2,2,0,Niger
48748,5/1/2022,NER,Sabah,0,0,0,Niger
48749,5/1/2022,NER,Selangor,0,0,0,Niger
48750,5/1/2022,NGA,Johor,17,14,3,Nigeria
48751,5/1/2022,NGA,Kedah,0,0,0,Nigeria
48752,5/1/2022,NGA,Perlis,0,0,0,Nigeria
48753,5/1/2022,NGA,Pulau Pinang,0,0,0,Nigeria
48754,5/1/2022,NGA,Sabah,0,0,0,Nigeria
48755,5/1/2022,NGA,Sarawak,2,2,0,Nigeria
48756,5/1/2022,NGA,Selangor,283,249,34,Nigeria
48757,5/1/2022,NIC,Johor,1,0,1,Nicaragua
48758,5/1/2022,NIC,Kedah,0,0,0,Nicaragua
48759,5/1/2022,NIC,Pulau Pinang,1,1,0,Nicaragua
48760,5/1/2022,NIC,Sabah,0,0,0,Nicaragua
48761,5/1/2022,NIC,Selangor,3,2,1,Nicaragua
48762,5/1/2022,NLD,Johor,595,393,202,Netherlands
48763,5/1/2022,NLD,Kedah,42,25,17,Netherlands
48764,5/1/2022,NLD,Kelantan,0,0,0,Netherlands
48765,5/1/2022,NLD,Melaka,0,0,0,Netherlands
48766,5/1/2022,NLD,Negeri Sembilan,0,0,0,Netherlands
48767,5/1/2022,NLD,Pahang,1,1,0,Netherlands
48768,5/1/2022,NLD,Perak,0,0,0,Netherlands
48769,5/1/2022,NLD,Perlis,14,8,6,Netherlands
48770,5/1/2022,NLD,Pulau Pinang,94,63,31,Netherlands
48771,5/1/2022,NLD,Sabah,18,12,6,Netherlands
48772,5/1/2022,NLD,Sarawak,11,8,3,Netherlands
48773,5/1/2022,NLD,Selangor,1498,1030,468,Netherlands
48774,5/1/2022,NLD,Terengganu,0,0,0,Netherlands
48775,5/1/2022,NLD,W.P. Labuan,0,0,0,Netherlands
48776,5/1/2022,NOR,Johor,88,60,28,Norway
48777,5/1/2022,NOR,Kedah,7,2,5,Norway
48778,5/1/2022,NOR,Kelantan,0,0,0,Norway
48779,5/1/2022,NOR,Melaka,0,0,0,Norway
48780,5/1/2022,NOR,Pahang,0,0,0,Norway
48781,5/1/2022,NOR,Perak,1,1,0,Norway
48782,5/1/2022,NOR,Perlis,2,1,1,Norway
48783,5/1/2022,NOR,Pulau Pinang,4,2,2,Norway
48784,5/1/2022,NOR,Sabah,9,5,4,Norway
48785,5/1/2022,NOR,Sarawak,2,1,1,Norway
48786,5/1/2022,NOR,Selangor,266,188,78,Norway
48787,5/1/2022,NOR,W.P. Labuan,0,0,0,Norway
48788,5/1/2022,NPL,Johor,418,382,36,Nepal
48789,5/1/2022,NPL,Kedah,0,0,0,Nepal
48790,5/1/2022,NPL,Pahang,0,0,0,Nepal
48791,5/1/2022,NPL,Perak,0,0,0,Nepal
48792,5/1/2022,NPL,Perlis,0,0,0,Nepal
48793,5/1/2022,NPL,Pulau Pinang,6,5,1,Nepal
48794,5/1/2022,NPL,Sabah,6,4,2,Nepal
48795,5/1/2022,NPL,Sarawak,2,1,1,Nepal
48796,5/1/2022,NPL,Selangor,5458,5047,411,Nepal
48797,5/1/2022,NPL,W.P. Labuan,0,0,0,Nepal
48798,5/1/2022,NRU,Johor,0,0,0,Nauru
48799,5/1/2022,NRU,Pulau Pinang,0,0,0,Nauru
48800,5/1/2022,NRU,Selangor,0,0,0,Nauru
48801,5/1/2022,NZL,Johor,312,200,112,New Zealand
48802,5/1/2022,NZL,Kedah,36,21,15,New Zealand
48803,5/1/2022,NZL,Kelantan,0,0,0,New Zealand
48804,5/1/2022,NZL,Melaka,0,0,0,New Zealand
48805,5/1/2022,NZL,Negeri Sembilan,0,0,0,New Zealand
48806,5/1/2022,NZL,Pahang,0,0,0,New Zealand
48807,5/1/2022,NZL,Perak,4,2,2,New Zealand
48808,5/1/2022,NZL,Perlis,0,0,0,New Zealand
48809,5/1/2022,NZL,Pulau Pinang,66,32,34,New Zealand
48810,5/1/2022,NZL,Sabah,18,11,7,New Zealand
48811,5/1/2022,NZL,Sarawak,11,7,4,New Zealand
48812,5/1/2022,NZL,Selangor,682,455,227,New Zealand
48813,5/1/2022,NZL,Terengganu,0,0,0,New Zealand
48814,5/1/2022,NZL,W.P. Labuan,0,0,0,New Zealand
48815,5/1/2022,OMN,Johor,4,4,0,Oman
48816,5/1/2022,OMN,Kedah,6,4,2,Oman
48817,5/1/2022,OMN,Kelantan,0,0,0,Oman
48818,5/1/2022,OMN,Melaka,0,0,0,Oman
48819,5/1/2022,OMN,Perak,0,0,0,Oman
48820,5/1/2022,OMN,Perlis,0,0,0,Oman
48821,5/1/2022,OMN,Pulau Pinang,0,0,0,Oman
48822,5/1/2022,OMN,Sabah,0,0,0,Oman
48823,5/1/2022,OMN,Sarawak,1,1,0,Oman
48824,5/1/2022,OMN,Selangor,490,313,177,Oman
48825,5/1/2022,PAK,Johor,266,207,59,Pakistan
48826,5/1/2022,PAK,Kedah,17,15,2,Pakistan
48827,5/1/2022,PAK,Kelantan,6,6,0,Pakistan
48828,5/1/2022,PAK,Melaka,0,0,0,Pakistan
48829,5/1/2022,PAK,Negeri Sembilan,0,0,0,Pakistan
48830,5/1/2022,PAK,Pahang,0,0,0,Pakistan
48831,5/1/2022,PAK,Perak,5,5,0,Pakistan
48832,5/1/2022,PAK,Perlis,19,18,1,Pakistan
48833,5/1/2022,PAK,Pulau Pinang,16,14,2,Pakistan
48834,5/1/2022,PAK,Sabah,2,2,0,Pakistan
48835,5/1/2022,PAK,Sarawak,8,8,0,Pakistan
48836,5/1/2022,PAK,Selangor,5582,4561,1021,Pakistan
48837,5/1/2022,PAK,W.P. Labuan,0,0,0,Pakistan
48838,5/1/2022,PAN,Johor,5,3,2,Panama
48839,5/1/2022,PAN,Kedah,0,0,0,Panama
48840,5/1/2022,PAN,Perak,0,0,0,Panama
48841,5/1/2022,PAN,Perlis,0,0,0,Panama
48842,5/1/2022,PAN,Pulau Pinang,0,0,0,Panama
48843,5/1/2022,PAN,Sabah,0,0,0,Panama
48844,5/1/2022,PAN,Sarawak,0,0,0,Panama
48845,5/1/2022,PAN,Selangor,3,3,0,Panama
48846,5/1/2022,PER,Johor,22,13,9,Peru
48847,5/1/2022,PER,Kedah,2,1,1,Peru
48848,5/1/2022,PER,Kelantan,0,0,0,Peru
48849,5/1/2022,PER,Pahang,0,0,0,Peru
48850,5/1/2022,PER,Perak,0,0,0,Peru
48851,5/1/2022,PER,Perlis,0,0,0,Peru
48852,5/1/2022,PER,Pulau Pinang,0,0,0,Peru
48853,5/1/2022,PER,Sabah,0,0,0,Peru
48854,5/1/2022,PER,Sarawak,0,0,0,Peru
48855,5/1/2022,PER,Selangor,39,21,18,Peru
48856,5/1/2022,PER,W.P. Labuan,0,0,0,Peru
48857,5/1/2022,PHL,Johor,7206,2109,5097,Philippines
48858,5/1/2022,PHL,Kedah,50,16,34,Philippines
48859,5/1/2022,PHL,Kelantan,1,1,0,Philippines
48860,5/1/2022,PHL,Melaka,0,0,0,Philippines
48861,5/1/2022,PHL,Negeri Sembilan,0,0,0,Philippines
48862,5/1/2022,PHL,Pahang,4,4,0,Philippines
48863,5/1/2022,PHL,Perak,18,6,12,Philippines
48864,5/1/2022,PHL,Perlis,10,4,6,Philippines
48865,5/1/2022,PHL,Pulau Pinang,262,108,154,Philippines
48866,5/1/2022,PHL,Sabah,102,28,74,Philippines
48867,5/1/2022,PHL,Sarawak,68,33,35,Philippines
48868,5/1/2022,PHL,Selangor,6349,2706,3643,Philippines
48869,5/1/2022,PHL,Terengganu,0,0,0,Philippines
48870,5/1/2022,PHL,W.P. Labuan,2,2,0,Philippines
48871,5/1/2022,PLW,Johor,1,1,0,Palau
48872,5/1/2022,PLW,Pulau Pinang,0,0,0,Palau
48873,5/1/2022,PLW,Selangor,1,0,1,Palau
48874,5/1/2022,PNG,Johor,6,5,1,Papua New Guinea
48875,5/1/2022,PNG,Kedah,0,0,0,Papua New Guinea
48876,5/1/2022,PNG,Kelantan,0,0,0,Papua New Guinea
48877,5/1/2022,PNG,Perak,0,0,0,Papua New Guinea
48878,5/1/2022,PNG,Pulau Pinang,1,0,1,Papua New Guinea
48879,5/1/2022,PNG,Sabah,0,0,0,Papua New Guinea
48880,5/1/2022,PNG,Sarawak,0,0,0,Papua New Guinea
48881,5/1/2022,PNG,Selangor,33,24,9,Papua New Guinea
48882,5/1/2022,POL,Johor,109,71,38,Poland
48883,5/1/2022,POL,Kedah,10,7,3,Poland
48884,5/1/2022,POL,Kelantan,0,0,0,Poland
48885,5/1/2022,POL,Melaka,0,0,0,Poland
48886,5/1/2022,POL,Negeri Sembilan,0,0,0,Poland
48887,5/1/2022,POL,Pahang,0,0,0,Poland
48888,5/1/2022,POL,Perak,1,0,1,Poland
48889,5/1/2022,POL,Perlis,0,0,0,Poland
48890,5/1/2022,POL,Pulau Pinang,27,15,12,Poland
48891,5/1/2022,POL,Sabah,14,7,7,Poland
48892,5/1/2022,POL,Sarawak,9,6,3,Poland
48893,5/1/2022,POL,Selangor,339,219,120,Poland
48894,5/1/2022,POL,Terengganu,0,0,0,Poland
48895,5/1/2022,POL,W.P. Labuan,0,0,0,Poland
48896,5/1/2022,PRK,Selangor,0,0,0,"Korea, Democratic People's Republic of"
48897,5/1/2022,PRT,Johor,83,49,34,Portugal
48898,5/1/2022,PRT,Kedah,5,2,3,Portugal
48899,5/1/2022,PRT,Kelantan,0,0,0,Portugal
48900,5/1/2022,PRT,Melaka,0,0,0,Portugal
48901,5/1/2022,PRT,Pahang,0,0,0,Portugal
48902,5/1/2022,PRT,Perak,0,0,0,Portugal
48903,5/1/2022,PRT,Perlis,2,1,1,Portugal
48904,5/1/2022,PRT,Pulau Pinang,9,5,4,Portugal
48905,5/1/2022,PRT,Sabah,2,0,2,Portugal
48906,5/1/2022,PRT,Sarawak,2,1,1,Portugal
48907,5/1/2022,PRT,Selangor,271,190,81,Portugal
48908,5/1/2022,PRT,W.P. Labuan,0,0,0,Portugal
48909,5/1/2022,PRY,Johor,1,0,1,Paraguay
48910,5/1/2022,PRY,Kedah,0,0,0,Paraguay
48911,5/1/2022,PRY,Perak,0,0,0,Paraguay
48912,5/1/2022,PRY,Perlis,0,0,0,Paraguay
48913,5/1/2022,PRY,Pulau Pinang,0,0,0,Paraguay
48914,5/1/2022,PRY,Sabah,0,0,0,Paraguay
48915,5/1/2022,PRY,Sarawak,0,0,0,Paraguay
48916,5/1/2022,PRY,Selangor,4,2,2,Paraguay
48917,5/1/2022,PSE,Johor,2,2,0,"Palestinian Territory, Occupied"
48918,5/1/2022,PSE,Kedah,1,1,0,"Palestinian Territory, Occupied"
48919,5/1/2022,PSE,Kelantan,0,0,0,"Palestinian Territory, Occupied"
48920,5/1/2022,PSE,Melaka,0,0,0,"Palestinian Territory, Occupied"
48921,5/1/2022,PSE,Perak,0,0,0,"Palestinian Territory, Occupied"
48922,5/1/2022,PSE,Perlis,1,1,0,"Palestinian Territory, Occupied"
48923,5/1/2022,PSE,Pulau Pinang,0,0,0,"Palestinian Territory, Occupied"
48924,5/1/2022,PSE,Sabah,0,0,0,"Palestinian Territory, Occupied"
48925,5/1/2022,PSE,Sarawak,0,0,0,"Palestinian Territory, Occupied"
48926,5/1/2022,PSE,Selangor,266,179,87,"Palestinian Territory, Occupied"
48927,5/1/2022,QAT,Johor,16,9,7,Qatar
48928,5/1/2022,QAT,Kedah,0,0,0,Qatar
48929,5/1/2022,QAT,Perlis,0,0,0,Qatar
48930,5/1/2022,QAT,Pulau Pinang,0,0,0,Qatar
48931,5/1/2022,QAT,Sabah,0,0,0,Qatar
48932,5/1/2022,QAT,Sarawak,0,0,0,Qatar
48933,5/1/2022,QAT,Selangor,80,48,32,Qatar
48934,5/1/2022,REU,Johor,0,0,0,Reunion
48935,5/1/2022,REU,Sarawak,0,0,0,Reunion
48936,5/1/2022,ROU,Johor,61,31,30,Romania
48937,5/1/2022,ROU,Kedah,1,0,1,Romania
48938,5/1/2022,ROU,Kelantan,0,0,0,Romania
48939,5/1/2022,ROU,Negeri Sembilan,0,0,0,Romania
48940,5/1/2022,ROU,Pahang,0,0,0,Romania
48941,5/1/2022,ROU,Perak,1,0,1,Romania
48942,5/1/2022,ROU,Perlis,0,0,0,Romania
48943,5/1/2022,ROU,Pulau Pinang,5,4,1,Romania
48944,5/1/2022,ROU,Sabah,2,2,0,Romania
48945,5/1/2022,ROU,Sarawak,2,1,1,Romania
48946,5/1/2022,ROU,Selangor,185,112,73,Romania
48947,5/1/2022,ROU,W.P. Labuan,0,0,0,Romania
48948,5/1/2022,RUS,Johor,237,139,98,Russia
48949,5/1/2022,RUS,Kedah,31,20,11,Russia
48950,5/1/2022,RUS,Kelantan,0,0,0,Russia
48951,5/1/2022,RUS,Melaka,0,0,0,Russia
48952,5/1/2022,RUS,Negeri Sembilan,0,0,0,Russia
48953,5/1/2022,RUS,Pahang,0,0,0,Russia
48954,5/1/2022,RUS,Perak,0,0,0,Russia
48955,5/1/2022,RUS,Perlis,5,3,2,Russia
48956,5/1/2022,RUS,Pulau Pinang,15,10,5,Russia
48957,5/1/2022,RUS,Sabah,10,9,1,Russia
48958,5/1/2022,RUS,Sarawak,7,2,5,Russia
48959,5/1/2022,RUS,Selangor,1084,570,514,Russia
48960,5/1/2022,RUS,W.P. Labuan,0,0,0,Russia
48961,5/1/2022,RWA,Johor,0,0,0,Rwanda
48962,5/1/2022,RWA,Kedah,0,0,0,Rwanda
48963,5/1/2022,RWA,Pulau Pinang,0,0,0,Rwanda
48964,5/1/2022,RWA,Selangor,7,1,6,Rwanda
48965,5/1/2022,SAU,Johor,66,39,27,Saudi Arabia
48966,5/1/2022,SAU,Kedah,5,2,3,Saudi Arabia
48967,5/1/2022,SAU,Kelantan,0,0,0,Saudi Arabia
48968,5/1/2022,SAU,Melaka,0,0,0,Saudi Arabia
48969,5/1/2022,SAU,Perak,1,0,1,Saudi Arabia
48970,5/1/2022,SAU,Perlis,0,0,0,Saudi Arabia
48971,5/1/2022,SAU,Pulau Pinang,12,7,5,Saudi Arabia
48972,5/1/2022,SAU,Sabah,0,0,0,Saudi Arabia
48973,5/1/2022,SAU,Sarawak,0,0,0,Saudi Arabia
48974,5/1/2022,SAU,Selangor,4039,2282,1757,Saudi Arabia
48975,5/1/2022,SAU,W.P. Labuan,0,0,0,Saudi Arabia
48976,5/1/2022,SDN,Johor,4,4,0,Sudan
48977,5/1/2022,SDN,Kedah,0,0,0,Sudan
48978,5/1/2022,SDN,Kelantan,0,0,0,Sudan
48979,5/1/2022,SDN,Perlis,0,0,0,Sudan
48980,5/1/2022,SDN,Pulau Pinang,2,2,0,Sudan
48981,5/1/2022,SDN,Sabah,0,0,0,Sudan
48982,5/1/2022,SDN,Sarawak,0,0,0,Sudan
48983,5/1/2022,SDN,Selangor,662,402,260,Sudan
48984,5/1/2022,SDN,W.P. Labuan,0,0,0,Sudan
48985,5/1/2022,SEN,Johor,3,3,0,Senegal
48986,5/1/2022,SEN,Kedah,0,0,0,Senegal
48987,5/1/2022,SEN,Kelantan,0,0,0,Senegal
48988,5/1/2022,SEN,Perak,0,0,0,Senegal
48989,5/1/2022,SEN,Perlis,0,0,0,Senegal
48990,5/1/2022,SEN,Pulau Pinang,0,0,0,Senegal
48991,5/1/2022,SEN,Sabah,0,0,0,Senegal
48992,5/1/2022,SEN,Sarawak,0,0,0,Senegal
48993,5/1/2022,SEN,Selangor,34,23,11,Senegal
48994,5/1/2022,SGP,Johor,617144,385634,231510,Singapore
48995,5/1/2022,SGP,Kedah,921,503,418,Singapore
48996,5/1/2022,SGP,Kelantan,3,3,0,Singapore
48997,5/1/2022,SGP,Melaka,1,0,1,Singapore
48998,5/1/2022,SGP,Negeri Sembilan,1,1,0,Singapore
48999,5/1/2022,SGP,Pahang,41,33,8,Singapore
49000,5/1/2022,SGP,Perak,1921,900,1021,Singapore
49001,5/1/2022,SGP,Perlis,27,17,10,Singapore
49002,5/1/2022,SGP,Pulau Pinang,7700,4101,3599,Singapore
49003,5/1/2022,SGP,Sabah,1146,652,494,Singapore
49004,5/1/2022,SGP,Sarawak,1734,1029,705,Singapore
49005,5/1/2022,SGP,Selangor,19426,10889,8537,Singapore
49006,5/1/2022,SGP,Terengganu,0,0,0,Singapore
49007,5/1/2022,SGP,W.P. Labuan,0,0,0,Singapore
49008,5/1/2022,SGS,Johor,0,0,0,South Georgia and the South Sandwich Islands
49009,5/1/2022,SGS,Sabah,0,0,0,South Georgia and the South Sandwich Islands
49010,5/1/2022,SGS,Selangor,0,0,0,South Georgia and the South Sandwich Islands
49011,5/1/2022,SHN,Sarawak,0,0,0,"Saint Helena, Ascension and Tristan da Cunha"
49012,5/1/2022,SLB,Johor,0,0,0,Solomon Islands
49013,5/1/2022,SLB,Perlis,0,0,0,Solomon Islands
49014,5/1/2022,SLB,Pulau Pinang,0,0,0,Solomon Islands
49015,5/1/2022,SLB,Sabah,0,0,0,Solomon Islands
49016,5/1/2022,SLB,Sarawak,0,0,0,Solomon Islands
49017,5/1/2022,SLB,Selangor,0,0,0,Solomon Islands
49018,5/1/2022,SLB,W.P. Labuan,0,0,0,Solomon Islands
49019,5/1/2022,SLE,Johor,0,0,0,Sierra Leone
49020,5/1/2022,SLE,Kedah,0,0,0,Sierra Leone
49021,5/1/2022,SLE,Perak,0,0,0,Sierra Leone
49022,5/1/2022,SLE,Pulau Pinang,0,0,0,Sierra Leone
49023,5/1/2022,SLE,Sabah,0,0,0,Sierra Leone
49024,5/1/2022,SLE,Selangor,7,6,1,Sierra Leone
49025,5/1/2022,SLV,Johor,0,0,0,El Salvador
49026,5/1/2022,SLV,Kedah,2,0,2,El Salvador
49027,5/1/2022,SLV,Perak,0,0,0,El Salvador
49028,5/1/2022,SLV,Perlis,0,0,0,El Salvador
49029,5/1/2022,SLV,Pulau Pinang,0,0,0,El Salvador
49030,5/1/2022,SLV,Sabah,0,0,0,El Salvador
49031,5/1/2022,SLV,Selangor,4,1,3,El Salvador
49032,5/1/2022,SLV,W.P. Labuan,0,0,0,El Salvador
49033,5/1/2022,SMR,Johor,0,0,0,San Marino
49034,5/1/2022,SMR,Selangor,1,1,0,San Marino
49035,5/1/2022,SOM,Johor,0,0,0,Somalia
49036,5/1/2022,SOM,Kedah,0,0,0,Somalia
49037,5/1/2022,SOM,Kelantan,0,0,0,Somalia
49038,5/1/2022,SOM,Perlis,0,0,0,Somalia
49039,5/1/2022,SOM,Sabah,0,0,0,Somalia
49040,5/1/2022,SOM,Sarawak,0,0,0,Somalia
49041,5/1/2022,SOM,Selangor,132,80,52,Somalia
49042,5/1/2022,SRB,Johor,5,4,1,Serbia
49043,5/1/2022,SRB,Kedah,0,0,0,Serbia
49044,5/1/2022,SRB,Kelantan,0,0,0,Serbia
49045,5/1/2022,SRB,Pahang,0,0,0,Serbia
49046,5/1/2022,SRB,Perak,0,0,0,Serbia
49047,5/1/2022,SRB,Perlis,1,1,0,Serbia
49048,5/1/2022,SRB,Pulau Pinang,0,0,0,Serbia
49049,5/1/2022,SRB,Sabah,0,0,0,Serbia
49050,5/1/2022,SRB,Sarawak,1,0,1,Serbia
49051,5/1/2022,SRB,Selangor,21,12,9,Serbia
49052,5/1/2022,STP,Selangor,0,0,0,Sao Tome and Principe
49053,5/1/2022,SUR,Johor,0,0,0,Suriname
49054,5/1/2022,SUR,Kedah,0,0,0,Suriname
49055,5/1/2022,SUR,Kelantan,0,0,0,Suriname
49056,5/1/2022,SUR,Perak,0,0,0,Suriname
49057,5/1/2022,SUR,Perlis,0,0,0,Suriname
49058,5/1/2022,SUR,Pulau Pinang,0,0,0,Suriname
49059,5/1/2022,SUR,Sabah,0,0,0,Suriname
49060,5/1/2022,SUR,Sarawak,0,0,0,Suriname
49061,5/1/2022,SUR,Selangor,3,0,3,Suriname
49062,5/1/2022,SVK,Johor,14,8,6,Slovakia
49063,5/1/2022,SVK,Kedah,3,2,1,Slovakia
49064,5/1/2022,SVK,Kelantan,0,0,0,Slovakia
49065,5/1/2022,SVK,Negeri Sembilan,0,0,0,Slovakia
49066,5/1/2022,SVK,Pahang,0,0,0,Slovakia
49067,5/1/2022,SVK,Perak,0,0,0,Slovakia
49068,5/1/2022,SVK,Perlis,0,0,0,Slovakia
49069,5/1/2022,SVK,Pulau Pinang,4,4,0,Slovakia
49070,5/1/2022,SVK,Sabah,1,1,0,Slovakia
49071,5/1/2022,SVK,Sarawak,0,0,0,Slovakia
49072,5/1/2022,SVK,Selangor,111,74,37,Slovakia
49073,5/1/2022,SVK,W.P. Labuan,0,0,0,Slovakia
49074,5/1/2022,SVN,Johor,6,1,5,Slovenia
49075,5/1/2022,SVN,Kedah,0,0,0,Slovenia
49076,5/1/2022,SVN,Kelantan,0,0,0,Slovenia
49077,5/1/2022,SVN,Perak,0,0,0,Slovenia
49078,5/1/2022,SVN,Perlis,0,0,0,Slovenia
49079,5/1/2022,SVN,Pulau Pinang,3,1,2,Slovenia
49080,5/1/2022,SVN,Sabah,1,0,1,Slovenia
49081,5/1/2022,SVN,Sarawak,0,0,0,Slovenia
49082,5/1/2022,SVN,Selangor,25,12,13,Slovenia
49083,5/1/2022,SVN,W.P. Labuan,0,0,0,Slovenia
49084,5/1/2022,SWE,Johor,179,120,59,Sweden
49085,5/1/2022,SWE,Kedah,17,11,6,Sweden
49086,5/1/2022,SWE,Kelantan,1,0,1,Sweden
49087,5/1/2022,SWE,Melaka,0,0,0,Sweden
49088,5/1/2022,SWE,Negeri Sembilan,0,0,0,Sweden
49089,5/1/2022,SWE,Pahang,0,0,0,Sweden
49090,5/1/2022,SWE,Perak,0,0,0,Sweden
49091,5/1/2022,SWE,Perlis,5,4,1,Sweden
49092,5/1/2022,SWE,Pulau Pinang,14,12,2,Sweden
49093,5/1/2022,SWE,Sabah,14,9,5,Sweden
49094,5/1/2022,SWE,Sarawak,2,0,2,Sweden
49095,5/1/2022,SWE,Selangor,400,273,127,Sweden
49096,5/1/2022,SWE,W.P. Labuan,0,0,0,Sweden
49097,5/1/2022,SWZ,Johor,0,0,0,Swaziland
49098,5/1/2022,SWZ,Kedah,0,0,0,Swaziland
49099,5/1/2022,SWZ,Pulau Pinang,1,1,0,Swaziland
49100,5/1/2022,SWZ,Sabah,0,0,0,Swaziland
49101,5/1/2022,SWZ,Selangor,14,6,8,Swaziland
49102,5/1/2022,SYC,Johor,4,3,1,Seychelles
49103,5/1/2022,SYC,Kedah,0,0,0,Seychelles
49104,5/1/2022,SYC,Pulau Pinang,0,0,0,Seychelles
49105,5/1/2022,SYC,Sabah,0,0,0,Seychelles
49106,5/1/2022,SYC,Sarawak,1,0,1,Seychelles
49107,5/1/2022,SYC,Selangor,35,19,16,Seychelles
49108,5/1/2022,SYR,Johor,5,2,3,Syrian Arab Republic
49109,5/1/2022,SYR,Kedah,1,1,0,Syrian Arab Republic
49110,5/1/2022,SYR,Kelantan,0,0,0,Syrian Arab Republic
49111,5/1/2022,SYR,Pahang,0,0,0,Syrian Arab Republic
49112,5/1/2022,SYR,Perlis,0,0,0,Syrian Arab Republic
49113,5/1/2022,SYR,Pulau Pinang,0,0,0,Syrian Arab Republic
49114,5/1/2022,SYR,Sabah,0,0,0,Syrian Arab Republic
49115,5/1/2022,SYR,Sarawak,1,0,1,Syrian Arab Republic
49116,5/1/2022,SYR,Selangor,448,263,185,Syrian Arab Republic
49117,5/1/2022,SYR,W.P. Labuan,0,0,0,Syrian Arab Republic
49118,5/1/2022,TCA,Perlis,0,0,0,Turks and Caicos
49119,5/1/2022,TCD,Johor,5,5,0,Chad
49120,5/1/2022,TCD,Kedah,0,0,0,Chad
49121,5/1/2022,TCD,Perlis,0,0,0,Chad
49122,5/1/2022,TCD,Selangor,3,2,1,Chad
49123,5/1/2022,TGO,Johor,0,0,0,Togo
49124,5/1/2022,TGO,Perak,0,0,0,Togo
49125,5/1/2022,TGO,Pulau Pinang,0,0,0,Togo
49126,5/1/2022,TGO,Selangor,3,2,1,Togo
49127,5/1/2022,THA,Johor,1969,355,1614,Thailand
49128,5/1/2022,THA,Kedah,27841,20609,7232,Thailand
49129,5/1/2022,THA,Kelantan,3808,1902,1906,Thailand
49130,5/1/2022,THA,Melaka,0,0,0,Thailand
49131,5/1/2022,THA,Negeri Sembilan,0,0,0,Thailand
49132,5/1/2022,THA,Pahang,21,15,6,Thailand
49133,5/1/2022,THA,Perak,697,205,492,Thailand
49134,5/1/2022,THA,Perlis,24792,17411,7381,Thailand
49135,5/1/2022,THA,Pulau Pinang,637,299,338,Thailand
49136,5/1/2022,THA,Sabah,13,4,9,Thailand
49137,5/1/2022,THA,Sarawak,31,15,16,Thailand
49138,5/1/2022,THA,Selangor,4898,2038,2860,Thailand
49139,5/1/2022,THA,Terengganu,0,0,0,Thailand
49140,5/1/2022,THA,W.P. Labuan,0,0,0,Thailand
49141,5/1/2022,TJK,Johor,0,0,0,Tajikistan
49142,5/1/2022,TJK,Kedah,0,0,0,Tajikistan
49143,5/1/2022,TJK,Perlis,0,0,0,Tajikistan
49144,5/1/2022,TJK,Pulau Pinang,0,0,0,Tajikistan
49145,5/1/2022,TJK,Sabah,0,0,0,Tajikistan
49146,5/1/2022,TJK,Selangor,29,12,17,Tajikistan
49147,5/1/2022,TKL,Selangor,0,0,0,Tokelau
49148,5/1/2022,TKM,Johor,4,0,4,Turkmenistan
49149,5/1/2022,TKM,Kedah,0,0,0,Turkmenistan
49150,5/1/2022,TKM,Kelantan,0,0,0,Turkmenistan
49151,5/1/2022,TKM,Perlis,0,0,0,Turkmenistan
49152,5/1/2022,TKM,Pulau Pinang,0,0,0,Turkmenistan
49153,5/1/2022,TKM,Sabah,0,0,0,Turkmenistan
49154,5/1/2022,TKM,Sarawak,0,0,0,Turkmenistan
49155,5/1/2022,TKM,Selangor,34,24,10,Turkmenistan
49156,5/1/2022,TLS,Johor,3,1,2,Timor-Leste
49157,5/1/2022,TLS,Kedah,0,0,0,Timor-Leste
49158,5/1/2022,TLS,Perlis,0,0,0,Timor-Leste
49159,5/1/2022,TLS,Pulau Pinang,2,1,1,Timor-Leste
49160,5/1/2022,TLS,Sabah,0,0,0,Timor-Leste
49161,5/1/2022,TLS,Sarawak,0,0,0,Timor-Leste
49162,5/1/2022,TLS,Selangor,173,122,51,Timor-Leste
49163,5/1/2022,TON,Johor,0,0,0,Tonga
49164,5/1/2022,TON,Pulau Pinang,0,0,0,Tonga
49165,5/1/2022,TON,Sarawak,0,0,0,Tonga
49166,5/1/2022,TON,Selangor,3,1,2,Tonga
49167,5/1/2022,TTO,Johor,0,0,0,Trinidad and Tobago
49168,5/1/2022,TTO,Kedah,2,1,1,Trinidad and Tobago
49169,5/1/2022,TTO,Pahang,0,0,0,Trinidad and Tobago
49170,5/1/2022,TTO,Pulau Pinang,0,0,0,Trinidad and Tobago
49171,5/1/2022,TTO,Sabah,0,0,0,Trinidad and Tobago
49172,5/1/2022,TTO,Sarawak,0,0,0,Trinidad and Tobago
49173,5/1/2022,TTO,Selangor,9,5,4,Trinidad and Tobago
49174,5/1/2022,TUN,Johor,8,6,2,Tunisia
49175,5/1/2022,TUN,Kedah,0,0,0,Tunisia
49176,5/1/2022,TUN,Kelantan,0,0,0,Tunisia
49177,5/1/2022,TUN,Melaka,0,0,0,Tunisia
49178,5/1/2022,TUN,Perak,0,0,0,Tunisia
49179,5/1/2022,TUN,Perlis,0,0,0,Tunisia
49180,5/1/2022,TUN,Pulau Pinang,4,3,1,Tunisia
49181,5/1/2022,TUN,Sabah,1,0,1,Tunisia
49182,5/1/2022,TUN,Sarawak,0,0,0,Tunisia
49183,5/1/2022,TUN,Selangor,138,79,59,Tunisia
49184,5/1/2022,TUN,W.P. Labuan,0,0,0,Tunisia
49185,5/1/2022,TUR,Johor,134,87,47,Turkey
49186,5/1/2022,TUR,Kedah,9,5,4,Turkey
49187,5/1/2022,TUR,Kelantan,0,0,0,Turkey
49188,5/1/2022,TUR,Melaka,0,0,0,Turkey
49189,5/1/2022,TUR,Negeri Sembilan,0,0,0,Turkey
49190,5/1/2022,TUR,Pahang,0,0,0,Turkey
49191,5/1/2022,TUR,Perak,0,0,0,Turkey
49192,5/1/2022,TUR,Perlis,2,2,0,Turkey
49193,5/1/2022,TUR,Pulau Pinang,11,6,5,Turkey
49194,5/1/2022,TUR,Sabah,0,0,0,Turkey
49195,5/1/2022,TUR,Sarawak,1,1,0,Turkey
49196,5/1/2022,TUR,Selangor,607,452,155,Turkey
49197,5/1/2022,TUR,W.P. Labuan,0,0,0,Turkey
49198,5/1/2022,TUV,Selangor,0,0,0,Tuvalu
49199,5/1/2022,TWN,Johor,1863,762,1101,Taiwan
49200,5/1/2022,TWN,Kedah,32,13,19,Taiwan
49201,5/1/2022,TWN,Kelantan,0,0,0,Taiwan
49202,5/1/2022,TWN,Melaka,0,0,0,Taiwan
49203,5/1/2022,TWN,Negeri Sembilan,0,0,0,Taiwan
49204,5/1/2022,TWN,Pahang,0,0,0,Taiwan
49205,5/1/2022,TWN,Perak,5,1,4,Taiwan
49206,5/1/2022,TWN,Perlis,3,3,0,Taiwan
49207,5/1/2022,TWN,Pulau Pinang,233,143,90,Taiwan
49208,5/1/2022,TWN,Sabah,38,16,22,Taiwan
49209,5/1/2022,TWN,Sarawak,25,17,8,Taiwan
49210,5/1/2022,TWN,Selangor,881,537,344,Taiwan
49211,5/1/2022,TWN,W.P. Labuan,0,0,0,Taiwan
49212,5/1/2022,TZA,Johor,2,2,0,"Tanzania, United Republic of"
49213,5/1/2022,TZA,Kedah,0,0,0,"Tanzania, United Republic of"
49214,5/1/2022,TZA,Perak,0,0,0,"Tanzania, United Republic of"
49215,5/1/2022,TZA,Perlis,0,0,0,"Tanzania, United Republic of"
49216,5/1/2022,TZA,Pulau Pinang,0,0,0,"Tanzania, United Republic of"
49217,5/1/2022,TZA,Sabah,0,0,0,"Tanzania, United Republic of"
49218,5/1/2022,TZA,Sarawak,0,0,0,"Tanzania, United Republic of"
49219,5/1/2022,TZA,Selangor,72,32,40,"Tanzania, United Republic of"
49220,5/1/2022,UGA,Johor,0,0,0,Uganda
49221,5/1/2022,UGA,Kedah,0,0,0,Uganda
49222,5/1/2022,UGA,Perak,0,0,0,Uganda
49223,5/1/2022,UGA,Perlis,0,0,0,Uganda
49224,5/1/2022,UGA,Pulau Pinang,1,1,0,Uganda
49225,5/1/2022,UGA,Sabah,0,0,0,Uganda
49226,5/1/2022,UGA,Sarawak,0,0,0,Uganda
49227,5/1/2022,UGA,Selangor,49,22,27,Uganda
49228,5/1/2022,UKR,Johor,54,24,30,Ukraine
49229,5/1/2022,UKR,Kedah,6,3,3,Ukraine
49230,5/1/2022,UKR,Kelantan,0,0,0,Ukraine
49231,5/1/2022,UKR,Melaka,0,0,0,Ukraine
49232,5/1/2022,UKR,Negeri Sembilan,0,0,0,Ukraine
49233,5/1/2022,UKR,Pahang,0,0,0,Ukraine
49234,5/1/2022,UKR,Perak,0,0,0,Ukraine
49235,5/1/2022,UKR,Perlis,0,0,0,Ukraine
49236,5/1/2022,UKR,Pulau Pinang,7,2,5,Ukraine
49237,5/1/2022,UKR,Sabah,0,0,0,Ukraine
49238,5/1/2022,UKR,Sarawak,1,1,0,Ukraine
49239,5/1/2022,UKR,Selangor,257,131,126,Ukraine
49240,5/1/2022,UKR,W.P. Labuan,0,0,0,Ukraine
49241,5/1/2022,URY,Johor,5,1,4,Uruguay
49242,5/1/2022,URY,Kedah,0,0,0,Uruguay
49243,5/1/2022,URY,Kelantan,0,0,0,Uruguay
49244,5/1/2022,URY,Perak,0,0,0,Uruguay
49245,5/1/2022,URY,Perlis,0,0,0,Uruguay
49246,5/1/2022,URY,Pulau Pinang,0,0,0,Uruguay
49247,5/1/2022,URY,Sabah,0,0,0,Uruguay
49248,5/1/2022,URY,Sarawak,0,0,0,Uruguay
49249,5/1/2022,URY,Selangor,7,5,2,Uruguay
49250,5/1/2022,URY,W.P. Labuan,0,0,0,Uruguay
49251,5/1/2022,USA,Johor,1968,1234,734,United States Of America
49252,5/1/2022,USA,Kedah,108,52,56,United States Of America
49253,5/1/2022,USA,Kelantan,2,2,0,United States Of America
49254,5/1/2022,USA,Melaka,0,0,0,United States Of America
49255,5/1/2022,USA,Negeri Sembilan,0,0,0,United States Of America
49256,5/1/2022,USA,Pahang,0,0,0,United States Of America
49257,5/1/2022,USA,Perak,27,16,11,United States Of America
49258,5/1/2022,USA,Perlis,5,4,1,United States Of America
49259,5/1/2022,USA,Pulau Pinang,683,460,223,United States Of America
49260,5/1/2022,USA,Sabah,83,49,34,United States Of America
49261,5/1/2022,USA,Sarawak,72,41,31,United States Of America
49262,5/1/2022,USA,Selangor,5752,3628,2124,United States Of America
49263,5/1/2022,USA,Terengganu,0,0,0,United States Of America
49264,5/1/2022,USA,W.P. Labuan,0,0,0,United States Of America
49265,5/1/2022,UZB,Johor,20,12,8,Uzbekistan
49266,5/1/2022,UZB,Kedah,3,2,1,Uzbekistan
49267,5/1/2022,UZB,Kelantan,0,0,0,Uzbekistan
49268,5/1/2022,UZB,Perak,0,0,0,Uzbekistan
49269,5/1/2022,UZB,Perlis,0,0,0,Uzbekistan
49270,5/1/2022,UZB,Pulau Pinang,0,0,0,Uzbekistan
49271,5/1/2022,UZB,Sabah,0,0,0,Uzbekistan
49272,5/1/2022,UZB,Sarawak,0,0,0,Uzbekistan
49273,5/1/2022,UZB,Selangor,137,81,56,Uzbekistan
49274,5/1/2022,VAT,Johor,1,0,1,Holy See (Vatican City State)
49275,5/1/2022,VAT,Sarawak,0,0,0,Holy See (Vatican City State)
49276,5/1/2022,VAT,Selangor,0,0,0,Holy See (Vatican City State)
49277,5/1/2022,VCT,Johor,0,0,0,Saint Vincent and the Grenadines
49278,5/1/2022,VCT,Kedah,0,0,0,Saint Vincent and the Grenadines
49279,5/1/2022,VCT,Pulau Pinang,0,0,0,Saint Vincent and the Grenadines
49280,5/1/2022,VCT,Sarawak,0,0,0,Saint Vincent and the Grenadines
49281,5/1/2022,VCT,Selangor,1,1,0,Saint Vincent and the Grenadines
49282,5/1/2022,VEN,Johor,4,3,1,Venezuela
49283,5/1/2022,VEN,Kedah,0,0,0,Venezuela
49284,5/1/2022,VEN,Kelantan,0,0,0,Venezuela
49285,5/1/2022,VEN,Melaka,0,0,0,Venezuela
49286,5/1/2022,VEN,Perak,0,0,0,Venezuela
49287,5/1/2022,VEN,Perlis,0,0,0,Venezuela
49288,5/1/2022,VEN,Pulau Pinang,1,0,1,Venezuela
49289,5/1/2022,VEN,Sabah,0,0,0,Venezuela
49290,5/1/2022,VEN,Sarawak,0,0,0,Venezuela
49291,5/1/2022,VEN,Selangor,42,25,17,Venezuela
49292,5/1/2022,VEN,W.P. Labuan,0,0,0,Venezuela
49293,5/1/2022,VNM,Johor,5759,1587,4172,Vietnam
49294,5/1/2022,VNM,Kedah,108,14,94,Vietnam
49295,5/1/2022,VNM,Kelantan,0,0,0,Vietnam
49296,5/1/2022,VNM,Melaka,0,0,0,Vietnam
49297,5/1/2022,VNM,Negeri Sembilan,0,0,0,Vietnam
49298,5/1/2022,VNM,Pahang,0,0,0,Vietnam
49299,5/1/2022,VNM,Perak,11,0,11,Vietnam
49300,5/1/2022,VNM,Perlis,4,2,2,Vietnam
49301,5/1/2022,VNM,Pulau Pinang,651,160,491,Vietnam
49302,5/1/2022,VNM,Sabah,12,5,7,Vietnam
49303,5/1/2022,VNM,Sarawak,26,3,23,Vietnam
49304,5/1/2022,VNM,Selangor,7088,2200,4888,Vietnam
49305,5/1/2022,VNM,Terengganu,0,0,0,Vietnam
49306,5/1/2022,VNM,W.P. Labuan,0,0,0,Vietnam
49307,5/1/2022,VUT,Johor,30,20,10,Vanuatu
49308,5/1/2022,VUT,Kedah,3,3,0,Vanuatu
49309,5/1/2022,VUT,Pulau Pinang,1,1,0,Vanuatu
49310,5/1/2022,VUT,Sabah,0,0,0,Vanuatu
49311,5/1/2022,VUT,Sarawak,0,0,0,Vanuatu
49312,5/1/2022,VUT,Selangor,24,19,5,Vanuatu
49313,5/1/2022,WSM,Johor,0,0,0,Samoa
49314,5/1/2022,WSM,Sarawak,0,0,0,Samoa
49315,5/1/2022,WSM,Selangor,1,0,1,Samoa
49316,5/1/2022,YEM,Johor,19,15,4,Yemen
49317,5/1/2022,YEM,Kedah,1,1,0,Yemen
49318,5/1/2022,YEM,Kelantan,0,0,0,Yemen
49319,5/1/2022,YEM,Melaka,4,2,2,Yemen
49320,5/1/2022,YEM,Pahang,0,0,0,Yemen
49321,5/1/2022,YEM,Perak,0,0,0,Yemen
49322,5/1/2022,YEM,Perlis,1,1,0,Yemen
49323,5/1/2022,YEM,Pulau Pinang,2,2,0,Yemen
49324,5/1/2022,YEM,Sabah,0,0,0,Yemen
49325,5/1/2022,YEM,Sarawak,1,0,1,Yemen
49326,5/1/2022,YEM,Selangor,1031,690,341,Yemen
49327,5/1/2022,YEM,W.P. Labuan,0,0,0,Yemen
49328,5/1/2022,ZAF,Johor,136,85,51,South Africa
49329,5/1/2022,ZAF,Kedah,7,3,4,South Africa
49330,5/1/2022,ZAF,Kelantan,0,0,0,South Africa
49331,5/1/2022,ZAF,Melaka,0,0,0,South Africa
49332,5/1/2022,ZAF,Pahang,1,1,0,South Africa
49333,5/1/2022,ZAF,Perak,0,0,0,South Africa
49334,5/1/2022,ZAF,Perlis,2,1,1,South Africa
49335,5/1/2022,ZAF,Pulau Pinang,20,11,9,South Africa
49336,5/1/2022,ZAF,Sabah,4,2,2,South Africa
49337,5/1/2022,ZAF,Sarawak,6,5,1,South Africa
49338,5/1/2022,ZAF,Selangor,514,304,210,South Africa
49339,5/1/2022,ZAF,Terengganu,0,0,0,South Africa
49340,5/1/2022,ZAF,W.P. Labuan,0,0,0,South Africa
49341,5/1/2022,ZMB,Johor,3,3,0,Zambia
49342,5/1/2022,ZMB,Kedah,0,0,0,Zambia
49343,5/1/2022,ZMB,Perak,0,0,0,Zambia
49344,5/1/2022,ZMB,Perlis,0,0,0,Zambia
49345,5/1/2022,ZMB,Pulau Pinang,0,0,0,Zambia
49346,5/1/2022,ZMB,Sabah,0,0,0,Zambia
49347,5/1/2022,ZMB,Sarawak,0,0,0,Zambia
49348,5/1/2022,ZMB,Selangor,27,18,9,Zambia
49349,5/1/2022,ZWE,Johor,4,3,1,Zimbabwe
49350,5/1/2022,ZWE,Kedah,0,0,0,Zimbabwe
49351,5/1/2022,ZWE,Kelantan,0,0,0,Zimbabwe
49352,5/1/2022,ZWE,Perak,0,0,0,Zimbabwe
49353,5/1/2022,ZWE,Perlis,0,0,0,Zimbabwe
49354,5/1/2022,ZWE,Pulau Pinang,2,0,2,Zimbabwe
49355,5/1/2022,ZWE,Sabah,0,0,0,Zimbabwe
49356,5/1/2022,ZWE,Sarawak,0,0,0,Zimbabwe
49357,5/1/2022,ZWE,Selangor,63,40,23,Zimbabwe
49358,6/1/2022,ABW,Kedah,0,0,0,Aruba
49359,6/1/2022,ABW,Pulau Pinang,1,0,1,Aruba
49360,6/1/2022,AFG,Johor,1,1,0,Afghanistan
49361,6/1/2022,AFG,Kedah,0,0,0,Afghanistan
49362,6/1/2022,AFG,Perlis,0,0,0,Afghanistan
49363,6/1/2022,AFG,Pulau Pinang,0,0,0,Afghanistan
49364,6/1/2022,AFG,Sarawak,0,0,0,Afghanistan
49365,6/1/2022,AFG,Selangor,101,72,29,Afghanistan
49366,6/1/2022,AGO,Johor,0,0,0,Angola
49367,6/1/2022,AGO,Kedah,0,0,0,Angola
49368,6/1/2022,AGO,Sabah,0,0,0,Angola
49369,6/1/2022,AGO,Selangor,0,0,0,Angola
49370,6/1/2022,AIA,Selangor,0,0,0,Anguilla
49371,6/1/2022,ALB,Johor,3,1,2,Albania
49372,6/1/2022,ALB,Kedah,1,1,0,Albania
49373,6/1/2022,ALB,Perak,0,0,0,Albania
49374,6/1/2022,ALB,Perlis,0,0,0,Albania
49375,6/1/2022,ALB,Pulau Pinang,1,1,0,Albania
49376,6/1/2022,ALB,Sabah,0,0,0,Albania
49377,6/1/2022,ALB,Sarawak,0,0,0,Albania
49378,6/1/2022,ALB,Selangor,8,5,3,Albania
49379,6/1/2022,AND,Johor,0,0,0,Andorra
49380,6/1/2022,AND,Kedah,1,0,1,Andorra
49381,6/1/2022,AND,Perlis,0,0,0,Andorra
49382,6/1/2022,AND,Pulau Pinang,0,0,0,Andorra
49383,6/1/2022,AND,Selangor,2,1,1,Andorra
49384,6/1/2022,ANT,Selangor,0,0,0,Netherlands Antilles
49385,6/1/2022,ARE,Johor,20,12,8,United Arab Emirates
49386,6/1/2022,ARE,Kedah,2,1,1,United Arab Emirates
49387,6/1/2022,ARE,Kelantan,0,0,0,United Arab Emirates
49388,6/1/2022,ARE,Perak,0,0,0,United Arab Emirates
49389,6/1/2022,ARE,Perlis,0,0,0,United Arab Emirates
49390,6/1/2022,ARE,Pulau Pinang,0,0,0,United Arab Emirates
49391,6/1/2022,ARE,Sabah,0,0,0,United Arab Emirates
49392,6/1/2022,ARE,Sarawak,0,0,0,United Arab Emirates
49393,6/1/2022,ARE,Selangor,173,119,54,United Arab Emirates
49394,6/1/2022,ARG,Johor,33,23,10,Argentina
49395,6/1/2022,ARG,Kedah,4,2,2,Argentina
49396,6/1/2022,ARG,Kelantan,5,3,2,Argentina
49397,6/1/2022,ARG,Melaka,0,0,0,Argentina
49398,6/1/2022,ARG,Perak,0,0,0,Argentina
49399,6/1/2022,ARG,Perlis,3,1,2,Argentina
49400,6/1/2022,ARG,Pulau Pinang,0,0,0,Argentina
49401,6/1/2022,ARG,Sabah,7,3,4,Argentina
49402,6/1/2022,ARG,Sarawak,0,0,0,Argentina
49403,6/1/2022,ARG,Selangor,132,77,55,Argentina
49404,6/1/2022,ARG,W.P. Labuan,0,0,0,Argentina
49405,6/1/2022,ARM,Johor,2,0,2,Armenia
49406,6/1/2022,ARM,Kedah,1,0,1,Armenia
49407,6/1/2022,ARM,Kelantan,0,0,0,Armenia
49408,6/1/2022,ARM,Perak,0,0,0,Armenia
49409,6/1/2022,ARM,Perlis,0,0,0,Armenia
49410,6/1/2022,ARM,Pulau Pinang,0,0,0,Armenia
49411,6/1/2022,ARM,Sabah,0,0,0,Armenia
49412,6/1/2022,ARM,Sarawak,0,0,0,Armenia
49413,6/1/2022,ARM,Selangor,14,5,9,Armenia
49414,6/1/2022,ATA,Selangor,0,0,0,Antarctica
49415,6/1/2022,ATG,Johor,7,5,2,Antigua and Barbuda
49416,6/1/2022,ATG,Kedah,0,0,0,Antigua and Barbuda
49417,6/1/2022,ATG,Pulau Pinang,0,0,0,Antigua and Barbuda
49418,6/1/2022,ATG,Sarawak,0,0,0,Antigua and Barbuda
49419,6/1/2022,ATG,Selangor,8,5,3,Antigua and Barbuda
49420,6/1/2022,AUS,Johor,2835,1770,1065,Australia
49421,6/1/2022,AUS,Kedah,188,101,87,Australia
49422,6/1/2022,AUS,Kelantan,5,4,1,Australia
49423,6/1/2022,AUS,Melaka,3,2,1,Australia
49424,6/1/2022,AUS,Negeri Sembilan,0,0,0,Australia
49425,6/1/2022,AUS,Pahang,0,0,0,Australia
49426,6/1/2022,AUS,Perak,100,45,55,Australia
49427,6/1/2022,AUS,Perlis,6,4,2,Australia
49428,6/1/2022,AUS,Pulau Pinang,1042,582,460,Australia
49429,6/1/2022,AUS,Sabah,234,129,105,Australia
49430,6/1/2022,AUS,Sarawak,227,112,115,Australia
49431,6/1/2022,AUS,Selangor,8651,5218,3433,Australia
49432,6/1/2022,AUS,Terengganu,0,0,0,Australia
49433,6/1/2022,AUS,W.P. Labuan,1,1,0,Australia
49434,6/1/2022,AUT,Johor,75,57,18,Austria
49435,6/1/2022,AUT,Kedah,7,6,1,Austria
49436,6/1/2022,AUT,Kelantan,1,1,0,Austria
49437,6/1/2022,AUT,Melaka,0,0,0,Austria
49438,6/1/2022,AUT,Negeri Sembilan,0,0,0,Austria
49439,6/1/2022,AUT,Pahang,0,0,0,Austria
49440,6/1/2022,AUT,Perak,2,1,1,Austria
49441,6/1/2022,AUT,Perlis,2,2,0,Austria
49442,6/1/2022,AUT,Pulau Pinang,31,27,4,Austria
49443,6/1/2022,AUT,Sabah,8,2,6,Austria
49444,6/1/2022,AUT,Sarawak,3,2,1,Austria
49445,6/1/2022,AUT,Selangor,315,209,106,Austria
49446,6/1/2022,AUT,Terengganu,0,0,0,Austria
49447,6/1/2022,AUT,W.P. Labuan,0,0,0,Austria
49448,6/1/2022,AZE,Johor,8,8,0,Azerbaijan
49449,6/1/2022,AZE,Kedah,0,0,0,Azerbaijan
49450,6/1/2022,AZE,Kelantan,0,0,0,Azerbaijan
49451,6/1/2022,AZE,Melaka,0,0,0,Azerbaijan
49452,6/1/2022,AZE,Perlis,0,0,0,Azerbaijan
49453,6/1/2022,AZE,Pulau Pinang,0,0,0,Azerbaijan
49454,6/1/2022,AZE,Sabah,0,0,0,Azerbaijan
49455,6/1/2022,AZE,Sarawak,0,0,0,Azerbaijan
49456,6/1/2022,AZE,Selangor,34,19,15,Azerbaijan
49457,6/1/2022,AZE,W.P. Labuan,0,0,0,Azerbaijan
49458,6/1/2022,BDI,Pulau Pinang,0,0,0,Burundi
49459,6/1/2022,BDI,Sarawak,0,0,0,Burundi
49460,6/1/2022,BDI,Selangor,0,0,0,Burundi
49461,6/1/2022,BEL,Johor,123,91,32,Belgium
49462,6/1/2022,BEL,Kedah,10,4,6,Belgium
49463,6/1/2022,BEL,Kelantan,0,0,0,Belgium
49464,6/1/2022,BEL,Melaka,0,0,0,Belgium
49465,6/1/2022,BEL,Negeri Sembilan,0,0,0,Belgium
49466,6/1/2022,BEL,Pahang,0,0,0,Belgium
49467,6/1/2022,BEL,Perak,2,1,1,Belgium
49468,6/1/2022,BEL,Perlis,3,3,0,Belgium
49469,6/1/2022,BEL,Pulau Pinang,16,9,7,Belgium
49470,6/1/2022,BEL,Sabah,12,9,3,Belgium
49471,6/1/2022,BEL,Sarawak,11,7,4,Belgium
49472,6/1/2022,BEL,Selangor,496,341,155,Belgium
49473,6/1/2022,BEL,W.P. Labuan,0,0,0,Belgium
49474,6/1/2022,BEN,Johor,0,0,0,Benin
49475,6/1/2022,BEN,Kedah,0,0,0,Benin
49476,6/1/2022,BEN,Perak,0,0,0,Benin
49477,6/1/2022,BEN,Pulau Pinang,0,0,0,Benin
49478,6/1/2022,BEN,Sabah,0,0,0,Benin
49479,6/1/2022,BEN,Sarawak,0,0,0,Benin
49480,6/1/2022,BEN,Selangor,1,1,0,Benin
49481,6/1/2022,BFA,Perak,0,0,0,Burkina Faso
49482,6/1/2022,BFA,Pulau Pinang,0,0,0,Burkina Faso
49483,6/1/2022,BFA,Selangor,2,1,1,Burkina Faso
49484,6/1/2022,BGD,Johor,1012,823,189,Bangladesh
49485,6/1/2022,BGD,Kedah,24,16,8,Bangladesh
49486,6/1/2022,BGD,Kelantan,1,1,0,Bangladesh
49487,6/1/2022,BGD,Melaka,0,0,0,Bangladesh
49488,6/1/2022,BGD,Negeri Sembilan,0,0,0,Bangladesh
49489,6/1/2022,BGD,Pahang,0,0,0,Bangladesh
49490,6/1/2022,BGD,Perak,0,0,0,Bangladesh
49491,6/1/2022,BGD,Perlis,3,3,0,Bangladesh
49492,6/1/2022,BGD,Pulau Pinang,36,29,7,Bangladesh
49493,6/1/2022,BGD,Sabah,0,0,0,Bangladesh
49494,6/1/2022,BGD,Sarawak,22,22,0,Bangladesh
49495,6/1/2022,BGD,Selangor,13817,12880,937,Bangladesh
49496,6/1/2022,BGD,W.P. Labuan,0,0,0,Bangladesh
49497,6/1/2022,BGR,Johor,14,7,7,Bulgaria
49498,6/1/2022,BGR,Kedah,2,0,2,Bulgaria
49499,6/1/2022,BGR,Kelantan,0,0,0,Bulgaria
49500,6/1/2022,BGR,Pahang,0,0,0,Bulgaria
49501,6/1/2022,BGR,Perak,0,0,0,Bulgaria
49502,6/1/2022,BGR,Perlis,0,0,0,Bulgaria
49503,6/1/2022,BGR,Pulau Pinang,3,2,1,Bulgaria
49504,6/1/2022,BGR,Sabah,1,0,1,Bulgaria
49505,6/1/2022,BGR,Sarawak,1,0,1,Bulgaria
49506,6/1/2022,BGR,Selangor,104,58,46,Bulgaria
49507,6/1/2022,BGR,W.P. Labuan,0,0,0,Bulgaria
49508,6/1/2022,BHR,Johor,6,3,3,Bahrain
49509,6/1/2022,BHR,Kedah,2,1,1,Bahrain
49510,6/1/2022,BHR,Kelantan,0,0,0,Bahrain
49511,6/1/2022,BHR,Perlis,0,0,0,Bahrain
49512,6/1/2022,BHR,Pulau Pinang,2,1,1,Bahrain
49513,6/1/2022,BHR,Sabah,0,0,0,Bahrain
49514,6/1/2022,BHR,Sarawak,0,0,0,Bahrain
49515,6/1/2022,BHR,Selangor,219,139,80,Bahrain
49516,6/1/2022,BHS,Johor,0,0,0,Bahamas
49517,6/1/2022,BHS,Kedah,0,0,0,Bahamas
49518,6/1/2022,BHS,Perak,0,0,0,Bahamas
49519,6/1/2022,BHS,Sabah,0,0,0,Bahamas
49520,6/1/2022,BHS,Sarawak,0,0,0,Bahamas
49521,6/1/2022,BHS,Selangor,4,2,2,Bahamas
49522,6/1/2022,BIH,Johor,6,4,2,Bosnia and Herzegovina
49523,6/1/2022,BIH,Kedah,0,0,0,Bosnia and Herzegovina
49524,6/1/2022,BIH,Perlis,0,0,0,Bosnia and Herzegovina
49525,6/1/2022,BIH,Pulau Pinang,0,0,0,Bosnia and Herzegovina
49526,6/1/2022,BIH,Sabah,0,0,0,Bosnia and Herzegovina
49527,6/1/2022,BIH,Sarawak,0,0,0,Bosnia and Herzegovina
49528,6/1/2022,BIH,Selangor,29,18,11,Bosnia and Herzegovina
49529,6/1/2022,BLR,Johor,7,2,5,Belarus
49530,6/1/2022,BLR,Kedah,5,1,4,Belarus
49531,6/1/2022,BLR,Kelantan,0,0,0,Belarus
49532,6/1/2022,BLR,Pahang,0,0,0,Belarus
49533,6/1/2022,BLR,Perak,0,0,0,Belarus
49534,6/1/2022,BLR,Perlis,1,1,0,Belarus
49535,6/1/2022,BLR,Pulau Pinang,1,1,0,Belarus
49536,6/1/2022,BLR,Sabah,1,1,0,Belarus
49537,6/1/2022,BLR,Sarawak,0,0,0,Belarus
49538,6/1/2022,BLR,Selangor,70,32,38,Belarus
49539,6/1/2022,BLR,W.P. Labuan,0,0,0,Belarus
49540,6/1/2022,BLZ,Johor,1,0,1,Belize
49541,6/1/2022,BLZ,Pulau Pinang,0,0,0,Belize
49542,6/1/2022,BLZ,Sarawak,0,0,0,Belize
49543,6/1/2022,BLZ,Selangor,0,0,0,Belize
49544,6/1/2022,BMU,Selangor,0,0,0,Bermuda
49545,6/1/2022,BOL,Johor,1,0,1,Bolivia
49546,6/1/2022,BOL,Kedah,0,0,0,Bolivia
49547,6/1/2022,BOL,Melaka,0,0,0,Bolivia
49548,6/1/2022,BOL,Perak,0,0,0,Bolivia
49549,6/1/2022,BOL,Perlis,0,0,0,Bolivia
49550,6/1/2022,BOL,Pulau Pinang,0,0,0,Bolivia
49551,6/1/2022,BOL,Sabah,0,0,0,Bolivia
49552,6/1/2022,BOL,Sarawak,0,0,0,Bolivia
49553,6/1/2022,BOL,Selangor,9,6,3,Bolivia
49554,6/1/2022,BRA,Johor,113,80,33,Brazil
49555,6/1/2022,BRA,Kedah,5,2,3,Brazil
49556,6/1/2022,BRA,Kelantan,0,0,0,Brazil
49557,6/1/2022,BRA,Melaka,4,2,2,Brazil
49558,6/1/2022,BRA,Pahang,0,0,0,Brazil
49559,6/1/2022,BRA,Perak,0,0,0,Brazil
49560,6/1/2022,BRA,Perlis,1,1,0,Brazil
49561,6/1/2022,BRA,Pulau Pinang,4,3,1,Brazil
49562,6/1/2022,BRA,Sabah,3,0,3,Brazil
49563,6/1/2022,BRA,Sarawak,1,0,1,Brazil
49564,6/1/2022,BRA,Selangor,376,236,140,Brazil
49565,6/1/2022,BRA,W.P. Labuan,0,0,0,Brazil
49566,6/1/2022,BRB,Johor,0,0,0,Barbados
49567,6/1/2022,BRB,Kedah,0,0,0,Barbados
49568,6/1/2022,BRB,Perlis,0,0,0,Barbados
49569,6/1/2022,BRB,Pulau Pinang,0,0,0,Barbados
49570,6/1/2022,BRB,Selangor,3,1,2,Barbados
49571,6/1/2022,BRN,Johor,177,105,72,Brunei Darussalam
49572,6/1/2022,BRN,Kedah,1,0,1,Brunei Darussalam
49573,6/1/2022,BRN,Kelantan,2,2,0,Brunei Darussalam
49574,6/1/2022,BRN,Melaka,0,0,0,Brunei Darussalam
49575,6/1/2022,BRN,Pahang,0,0,0,Brunei Darussalam
49576,6/1/2022,BRN,Perak,1,0,1,Brunei Darussalam
49577,6/1/2022,BRN,Perlis,0,0,0,Brunei Darussalam
49578,6/1/2022,BRN,Pulau Pinang,9,2,7,Brunei Darussalam
49579,6/1/2022,BRN,Sabah,394,199,195,Brunei Darussalam
49580,6/1/2022,BRN,Sarawak,1622,1182,440,Brunei Darussalam
49581,6/1/2022,BRN,Selangor,1930,1020,910,Brunei Darussalam
49582,6/1/2022,BRN,W.P. Labuan,29,13,16,Brunei Darussalam
49583,6/1/2022,BTN,Johor,0,0,0,Bhutan
49584,6/1/2022,BTN,Kedah,0,0,0,Bhutan
49585,6/1/2022,BTN,Perak,0,0,0,Bhutan
49586,6/1/2022,BTN,Perlis,0,0,0,Bhutan
49587,6/1/2022,BTN,Pulau Pinang,1,1,0,Bhutan
49588,6/1/2022,BTN,Sabah,0,0,0,Bhutan
49589,6/1/2022,BTN,Sarawak,0,0,0,Bhutan
49590,6/1/2022,BTN,Selangor,44,25,19,Bhutan
49591,6/1/2022,BWA,Johor,0,0,0,Botswana
49592,6/1/2022,BWA,Kedah,1,1,0,Botswana
49593,6/1/2022,BWA,Perlis,0,0,0,Botswana
49594,6/1/2022,BWA,Pulau Pinang,0,0,0,Botswana
49595,6/1/2022,BWA,Sabah,0,0,0,Botswana
49596,6/1/2022,BWA,Sarawak,0,0,0,Botswana
49597,6/1/2022,BWA,Selangor,10,8,2,Botswana
49598,6/1/2022,CAF,Kedah,0,0,0,Central African Republic
49599,6/1/2022,CAF,Selangor,1,1,0,Central African Republic
49600,6/1/2022,CAN,Johor,660,412,248,Canada
49601,6/1/2022,CAN,Kedah,39,18,21,Canada
49602,6/1/2022,CAN,Kelantan,0,0,0,Canada
49603,6/1/2022,CAN,Melaka,0,0,0,Canada
49604,6/1/2022,CAN,Negeri Sembilan,0,0,0,Canada
49605,6/1/2022,CAN,Pahang,0,0,0,Canada
49606,6/1/2022,CAN,Perak,9,7,2,Canada
49607,6/1/2022,CAN,Perlis,6,5,1,Canada
49608,6/1/2022,CAN,Pulau Pinang,151,92,59,Canada
49609,6/1/2022,CAN,Sabah,55,27,28,Canada
49610,6/1/2022,CAN,Sarawak,44,22,22,Canada
49611,6/1/2022,CAN,Selangor,1675,1013,662,Canada
49612,6/1/2022,CAN,Terengganu,0,0,0,Canada
49613,6/1/2022,CAN,W.P. Labuan,0,0,0,Canada
49614,6/1/2022,CCK,Selangor,0,0,0,Cocos (Keeling) Islands
49615,6/1/2022,CHE,Johor,208,148,60,Switzerland
49616,6/1/2022,CHE,Kedah,23,10,13,Switzerland
49617,6/1/2022,CHE,Kelantan,0,0,0,Switzerland
49618,6/1/2022,CHE,Melaka,0,0,0,Switzerland
49619,6/1/2022,CHE,Negeri Sembilan,0,0,0,Switzerland
49620,6/1/2022,CHE,Pahang,0,0,0,Switzerland
49621,6/1/2022,CHE,Perak,3,2,1,Switzerland
49622,6/1/2022,CHE,Perlis,7,4,3,Switzerland
49623,6/1/2022,CHE,Pulau Pinang,61,43,18,Switzerland
49624,6/1/2022,CHE,Sabah,19,9,10,Switzerland
49625,6/1/2022,CHE,Sarawak,16,11,5,Switzerland
49626,6/1/2022,CHE,Selangor,528,327,201,Switzerland
49627,6/1/2022,CHE,W.P. Labuan,0,0,0,Switzerland
49628,6/1/2022,CHL,Johor,24,12,12,Chile
49629,6/1/2022,CHL,Kedah,2,1,1,Chile
49630,6/1/2022,CHL,Kelantan,1,1,0,Chile
49631,6/1/2022,CHL,Melaka,0,0,0,Chile
49632,6/1/2022,CHL,Pahang,0,0,0,Chile
49633,6/1/2022,CHL,Perak,0,0,0,Chile
49634,6/1/2022,CHL,Perlis,0,0,0,Chile
49635,6/1/2022,CHL,Pulau Pinang,0,0,0,Chile
49636,6/1/2022,CHL,Sabah,2,1,1,Chile
49637,6/1/2022,CHL,Sarawak,0,0,0,Chile
49638,6/1/2022,CHL,Selangor,103,52,51,Chile
49639,6/1/2022,CHN,Johor,13803,5571,8232,China
49640,6/1/2022,CHN,Kedah,227,104,123,China
49641,6/1/2022,CHN,Kelantan,4,1,3,China
49642,6/1/2022,CHN,Melaka,0,0,0,China
49643,6/1/2022,CHN,Pahang,1,1,0,China
49644,6/1/2022,CHN,Perak,89,35,54,China
49645,6/1/2022,CHN,Perlis,17,10,7,China
49646,6/1/2022,CHN,Pulau Pinang,704,333,371,China
49647,6/1/2022,CHN,Sabah,244,96,148,China
49648,6/1/2022,CHN,Sarawak,93,40,53,China
49649,6/1/2022,CHN,Selangor,7602,4605,2997,China
49650,6/1/2022,CHN,Terengganu,0,0,0,China
49651,6/1/2022,CHN,W.P. Labuan,0,0,0,China
49652,6/1/2022,CIV,Johor,0,0,0,C��te d'Iv
49653,6/1/2022,CIV,Kedah,0,0,0,C��te d'Iv
49654,6/1/2022,CIV,Pulau Pinang,0,0,0,C��te d'Iv
49655,6/1/2022,CIV,Sabah,0,0,0,C��te d'Iv
49656,6/1/2022,CIV,Sarawak,0,0,0,C��te d'Iv
49657,6/1/2022,CIV,Selangor,7,2,5,C��te d'Iv
49658,6/1/2022,CMR,Johor,1,1,0,Cameroon
49659,6/1/2022,CMR,Kedah,0,0,0,Cameroon
49660,6/1/2022,CMR,Pulau Pinang,1,1,0,Cameroon
49661,6/1/2022,CMR,Sabah,0,0,0,Cameroon
49662,6/1/2022,CMR,Sarawak,0,0,0,Cameroon
49663,6/1/2022,CMR,Selangor,10,9,1,Cameroon
49664,6/1/2022,COD,Johor,0,0,0,"Congo, the Democratic Republic of the"
49665,6/1/2022,COD,Pulau Pinang,0,0,0,"Congo, the Democratic Republic of the"
49666,6/1/2022,COD,Sarawak,0,0,0,"Congo, the Democratic Republic of the"
49667,6/1/2022,COD,Selangor,9,5,4,"Congo, the Democratic Republic of the"
49668,6/1/2022,COG,Johor,0,0,0,Congo
49669,6/1/2022,COG,Kedah,0,0,0,Congo
49670,6/1/2022,COG,Selangor,2,2,0,Congo
49671,6/1/2022,COK,Selangor,0,0,0,Cook Islands
49672,6/1/2022,COL,Johor,13,5,8,Colombia
49673,6/1/2022,COL,Kedah,1,0,1,Colombia
49674,6/1/2022,COL,Perak,0,0,0,Colombia
49675,6/1/2022,COL,Pulau Pinang,0,0,0,Colombia
49676,6/1/2022,COL,Sabah,1,1,0,Colombia
49677,6/1/2022,COL,Sarawak,2,1,1,Colombia
49678,6/1/2022,COL,Selangor,61,28,33,Colombia
49679,6/1/2022,COL,W.P. Labuan,0,0,0,Colombia
49680,6/1/2022,COM,Johor,0,0,0,Comoros
49681,6/1/2022,COM,Kedah,0,0,0,Comoros
49682,6/1/2022,COM,Selangor,9,5,4,Comoros
49683,6/1/2022,CPV,Johor,0,0,0,Cape Verde
49684,6/1/2022,CPV,Kedah,0,0,0,Cape Verde
49685,6/1/2022,CPV,Pulau Pinang,0,0,0,Cape Verde
49686,6/1/2022,CPV,Sabah,0,0,0,Cape Verde
49687,6/1/2022,CPV,Selangor,1,1,0,Cape Verde
49688,6/1/2022,CRI,Johor,8,7,1,Costa Rica
49689,6/1/2022,CRI,Kedah,0,0,0,Costa Rica
49690,6/1/2022,CRI,Perak,0,0,0,Costa Rica
49691,6/1/2022,CRI,Perlis,0,0,0,Costa Rica
49692,6/1/2022,CRI,Pulau Pinang,5,4,1,Costa Rica
49693,6/1/2022,CRI,Sabah,0,0,0,Costa Rica
49694,6/1/2022,CRI,Sarawak,1,0,1,Costa Rica
49695,6/1/2022,CRI,Selangor,17,8,9,Costa Rica
49696,6/1/2022,CUB,Johor,2,2,0,Cuba
49697,6/1/2022,CUB,Kedah,0,0,0,Cuba
49698,6/1/2022,CUB,Perlis,0,0,0,Cuba
49699,6/1/2022,CUB,Pulau Pinang,0,0,0,Cuba
49700,6/1/2022,CUB,Sabah,0,0,0,Cuba
49701,6/1/2022,CUB,Sarawak,0,0,0,Cuba
49702,6/1/2022,CUB,Selangor,4,3,1,Cuba
49703,6/1/2022,CYP,Johor,9,7,2,Cyprus
49704,6/1/2022,CYP,Kedah,0,0,0,Cyprus
49705,6/1/2022,CYP,Perak,0,0,0,Cyprus
49706,6/1/2022,CYP,Perlis,0,0,0,Cyprus
49707,6/1/2022,CYP,Pulau Pinang,1,1,0,Cyprus
49708,6/1/2022,CYP,Sabah,0,0,0,Cyprus
49709,6/1/2022,CYP,Sarawak,0,0,0,Cyprus
49710,6/1/2022,CYP,Selangor,29,22,7,Cyprus
49711,6/1/2022,CZE,Johor,33,21,12,Czech Republic
49712,6/1/2022,CZE,Kedah,10,8,2,Czech Republic
49713,6/1/2022,CZE,Kelantan,2,2,0,Czech Republic
49714,6/1/2022,CZE,Melaka,0,0,0,Czech Republic
49715,6/1/2022,CZE,Negeri Sembilan,0,0,0,Czech Republic
49716,6/1/2022,CZE,Perak,0,0,0,Czech Republic
49717,6/1/2022,CZE,Perlis,2,2,0,Czech Republic
49718,6/1/2022,CZE,Pulau Pinang,7,6,1,Czech Republic
49719,6/1/2022,CZE,Sabah,3,1,2,Czech Republic
49720,6/1/2022,CZE,Sarawak,1,1,0,Czech Republic
49721,6/1/2022,CZE,Selangor,233,134,99,Czech Republic
49722,6/1/2022,CZE,W.P. Labuan,0,0,0,Czech Republic
49723,6/1/2022,DEU,Johor,1010,716,294,Germany
49724,6/1/2022,DEU,Kedah,103,61,42,Germany
49725,6/1/2022,DEU,Kelantan,3,2,1,Germany
49726,6/1/2022,DEU,Melaka,0,0,0,Germany
49727,6/1/2022,DEU,Negeri Sembilan,0,0,0,Germany
49728,6/1/2022,DEU,Pahang,0,0,0,Germany
49729,6/1/2022,DEU,Perak,14,10,4,Germany
49730,6/1/2022,DEU,Perlis,29,15,14,Germany
49731,6/1/2022,DEU,Pulau Pinang,309,239,70,Germany
49732,6/1/2022,DEU,Sabah,48,26,22,Germany
49733,6/1/2022,DEU,Sarawak,49,34,15,Germany
49734,6/1/2022,DEU,Selangor,3499,2308,1191,Germany
49735,6/1/2022,DEU,Terengganu,0,0,0,Germany
49736,6/1/2022,DEU,W.P. Labuan,0,0,0,Germany
49737,6/1/2022,DJI,Johor,1,1,0,Djibouti
49738,6/1/2022,DJI,Selangor,4,3,1,Djibouti
49739,6/1/2022,DMA,Johor,1,1,0,Dominica
49740,6/1/2022,DMA,Kedah,0,0,0,Dominica
49741,6/1/2022,DMA,Pulau Pinang,0,0,0,Dominica
49742,6/1/2022,DMA,Sabah,0,0,0,Dominica
49743,6/1/2022,DMA,Sarawak,0,0,0,Dominica
49744,6/1/2022,DMA,Selangor,15,12,3,Dominica
49745,6/1/2022,DMA,W.P. Labuan,0,0,0,Dominica
49746,6/1/2022,DNK,Johor,143,118,25,Denmark
49747,6/1/2022,DNK,Kedah,10,5,5,Denmark
49748,6/1/2022,DNK,Kelantan,2,1,1,Denmark
49749,6/1/2022,DNK,Melaka,0,0,0,Denmark
49750,6/1/2022,DNK,Negeri Sembilan,0,0,0,Denmark
49751,6/1/2022,DNK,Pahang,0,0,0,Denmark
49752,6/1/2022,DNK,Perak,0,0,0,Denmark
49753,6/1/2022,DNK,Perlis,3,3,0,Denmark
49754,6/1/2022,DNK,Pulau Pinang,24,17,7,Denmark
49755,6/1/2022,DNK,Sabah,26,17,9,Denmark
49756,6/1/2022,DNK,Sarawak,13,9,4,Denmark
49757,6/1/2022,DNK,Selangor,520,333,187,Denmark
49758,6/1/2022,DNK,W.P. Labuan,0,0,0,Denmark
49759,6/1/2022,DOM,Johor,1,1,0,Dominican Republic
49760,6/1/2022,DOM,Kedah,0,0,0,Dominican Republic
49761,6/1/2022,DOM,Perak,0,0,0,Dominican Republic
49762,6/1/2022,DOM,Perlis,0,0,0,Dominican Republic
49763,6/1/2022,DOM,Pulau Pinang,0,0,0,Dominican Republic
49764,6/1/2022,DOM,Sabah,0,0,0,Dominican Republic
49765,6/1/2022,DOM,Sarawak,1,0,1,Dominican Republic
49766,6/1/2022,DOM,Selangor,7,4,3,Dominican Republic
49767,6/1/2022,DZA,Johor,23,21,2,Algeria
49768,6/1/2022,DZA,Kedah,3,3,0,Algeria
49769,6/1/2022,DZA,Kelantan,0,0,0,Algeria
49770,6/1/2022,DZA,Melaka,0,0,0,Algeria
49771,6/1/2022,DZA,Perak,0,0,0,Algeria
49772,6/1/2022,DZA,Perlis,0,0,0,Algeria
49773,6/1/2022,DZA,Pulau Pinang,0,0,0,Algeria
49774,6/1/2022,DZA,Sabah,0,0,0,Algeria
49775,6/1/2022,DZA,Sarawak,0,0,0,Algeria
49776,6/1/2022,DZA,Selangor,196,112,84,Algeria
49777,6/1/2022,DZA,W.P. Labuan,0,0,0,Algeria
49778,6/1/2022,ECU,Johor,9,4,5,Ecuador
49779,6/1/2022,ECU,Kedah,1,0,1,Ecuador
49780,6/1/2022,ECU,Perak,0,0,0,Ecuador
49781,6/1/2022,ECU,Perlis,0,0,0,Ecuador
49782,6/1/2022,ECU,Pulau Pinang,0,0,0,Ecuador
49783,6/1/2022,ECU,Sabah,0,0,0,Ecuador
49784,6/1/2022,ECU,Sarawak,0,0,0,Ecuador
49785,6/1/2022,ECU,Selangor,19,12,7,Ecuador
49786,6/1/2022,EGY,Johor,117,99,18,Egypt
49787,6/1/2022,EGY,Kedah,5,3,2,Egypt
49788,6/1/2022,EGY,Kelantan,2,2,0,Egypt
49789,6/1/2022,EGY,Melaka,0,0,0,Egypt
49790,6/1/2022,EGY,Pahang,0,0,0,Egypt
49791,6/1/2022,EGY,Perak,0,0,0,Egypt
49792,6/1/2022,EGY,Perlis,0,0,0,Egypt
49793,6/1/2022,EGY,Pulau Pinang,1,1,0,Egypt
49794,6/1/2022,EGY,Sabah,3,1,2,Egypt
49795,6/1/2022,EGY,Sarawak,2,2,0,Egypt
49796,6/1/2022,EGY,Selangor,1006,667,339,Egypt
49797,6/1/2022,EGY,Terengganu,0,0,0,Egypt
49798,6/1/2022,EGY,W.P. Labuan,0,0,0,Egypt
49799,6/1/2022,ERI,Johor,1,1,0,Eritrea
49800,6/1/2022,ERI,Pulau Pinang,0,0,0,Eritrea
49801,6/1/2022,ERI,Sabah,0,0,0,Eritrea
49802,6/1/2022,ERI,Selangor,5,1,4,Eritrea
49803,6/1/2022,ESP,Johor,279,168,111,Spain
49804,6/1/2022,ESP,Kedah,17,8,9,Spain
49805,6/1/2022,ESP,Kelantan,1,1,0,Spain
49806,6/1/2022,ESP,Melaka,2,1,1,Spain
49807,6/1/2022,ESP,Negeri Sembilan,1,1,0,Spain
49808,6/1/2022,ESP,Pahang,0,0,0,Spain
49809,6/1/2022,ESP,Perak,2,2,0,Spain
49810,6/1/2022,ESP,Perlis,5,2,3,Spain
49811,6/1/2022,ESP,Pulau Pinang,19,10,9,Spain
49812,6/1/2022,ESP,Sabah,25,11,14,Spain
49813,6/1/2022,ESP,Sarawak,6,5,1,Spain
49814,6/1/2022,ESP,Selangor,1133,734,399,Spain
49815,6/1/2022,ESP,W.P. Labuan,0,0,0,Spain
49816,6/1/2022,EST,Johor,11,7,4,Estonia
49817,6/1/2022,EST,Kedah,0,0,0,Estonia
49818,6/1/2022,EST,Kelantan,0,0,0,Estonia
49819,6/1/2022,EST,Pahang,0,0,0,Estonia
49820,6/1/2022,EST,Perak,0,0,0,Estonia
49821,6/1/2022,EST,Perlis,0,0,0,Estonia
49822,6/1/2022,EST,Pulau Pinang,3,1,2,Estonia
49823,6/1/2022,EST,Sabah,0,0,0,Estonia
49824,6/1/2022,EST,Sarawak,0,0,0,Estonia
49825,6/1/2022,EST,Selangor,33,14,19,Estonia
49826,6/1/2022,EST,W.P. Labuan,0,0,0,Estonia
49827,6/1/2022,ETH,Johor,3,2,1,Ethiopia
49828,6/1/2022,ETH,Kedah,0,0,0,Ethiopia
49829,6/1/2022,ETH,Pulau Pinang,1,1,0,Ethiopia
49830,6/1/2022,ETH,Sarawak,0,0,0,Ethiopia
49831,6/1/2022,ETH,Selangor,16,11,5,Ethiopia
49832,6/1/2022,FIN,Johor,136,87,49,Finland
49833,6/1/2022,FIN,Kedah,1,0,1,Finland
49834,6/1/2022,FIN,Kelantan,0,0,0,Finland
49835,6/1/2022,FIN,Melaka,0,0,0,Finland
49836,6/1/2022,FIN,Negeri Sembilan,0,0,0,Finland
49837,6/1/2022,FIN,Pahang,4,2,2,Finland
49838,6/1/2022,FIN,Perak,5,4,1,Finland
49839,6/1/2022,FIN,Perlis,2,1,1,Finland
49840,6/1/2022,FIN,Pulau Pinang,25,20,5,Finland
49841,6/1/2022,FIN,Sabah,5,1,4,Finland
49842,6/1/2022,FIN,Sarawak,1,1,0,Finland
49843,6/1/2022,FIN,Selangor,195,135,60,Finland
49844,6/1/2022,FIN,W.P. Labuan,0,0,0,Finland
49845,6/1/2022,FJI,Johor,19,13,6,Fiji
49846,6/1/2022,FJI,Kedah,1,1,0,Fiji
49847,6/1/2022,FJI,Kelantan,0,0,0,Fiji
49848,6/1/2022,FJI,Perak,0,0,0,Fiji
49849,6/1/2022,FJI,Perlis,0,0,0,Fiji
49850,6/1/2022,FJI,Pulau Pinang,2,2,0,Fiji
49851,6/1/2022,FJI,Sabah,1,0,1,Fiji
49852,6/1/2022,FJI,Sarawak,0,0,0,Fiji
49853,6/1/2022,FJI,Selangor,49,35,14,Fiji
49854,6/1/2022,FRA,Johor,1095,704,391,France
49855,6/1/2022,FRA,Kedah,110,64,46,France
49856,6/1/2022,FRA,Kelantan,2,0,2,France
49857,6/1/2022,FRA,Melaka,5,3,2,France
49858,6/1/2022,FRA,Negeri Sembilan,1,0,1,France
49859,6/1/2022,FRA,Pahang,1,1,0,France
49860,6/1/2022,FRA,Perak,10,7,3,France
49861,6/1/2022,FRA,Perlis,29,17,12,France
49862,6/1/2022,FRA,Pulau Pinang,144,105,39,France
49863,6/1/2022,FRA,Sabah,74,40,34,France
49864,6/1/2022,FRA,Sarawak,38,23,15,France
49865,6/1/2022,FRA,Selangor,3398,2148,1250,France
49866,6/1/2022,FRA,Terengganu,1,1,0,France
49867,6/1/2022,FRA,W.P. Labuan,0,0,0,France
49868,6/1/2022,FSM,Johor,0,0,0,"Micronesia, Federated States of"
49869,6/1/2022,FSM,Pulau Pinang,0,0,0,"Micronesia, Federated States of"
49870,6/1/2022,FSM,Selangor,0,0,0,"Micronesia, Federated States of"
49871,6/1/2022,GAB,Johor,1,1,0,Gabon
49872,6/1/2022,GAB,Pulau Pinang,0,0,0,Gabon
49873,6/1/2022,GAB,Sarawak,0,0,0,Gabon
49874,6/1/2022,GAB,Selangor,1,1,0,Gabon
49875,6/1/2022,GBR,Johor,2907,2017,890,United Kingdom
49876,6/1/2022,GBR,Kedah,328,179,149,United Kingdom
49877,6/1/2022,GBR,Kelantan,7,5,2,United Kingdom
49878,6/1/2022,GBR,Melaka,0,0,0,United Kingdom
49879,6/1/2022,GBR,Negeri Sembilan,0,0,0,United Kingdom
49880,6/1/2022,GBR,Pahang,7,7,0,United Kingdom
49881,6/1/2022,GBR,Perak,32,16,16,United Kingdom
49882,6/1/2022,GBR,Perlis,40,25,15,United Kingdom
49883,6/1/2022,GBR,Pulau Pinang,532,348,184,United Kingdom
49884,6/1/2022,GBR,Sabah,197,109,88,United Kingdom
49885,6/1/2022,GBR,Sarawak,119,73,46,United Kingdom
49886,6/1/2022,GBR,Selangor,8474,5417,3057,United Kingdom
49887,6/1/2022,GBR,Terengganu,3,3,0,United Kingdom
49888,6/1/2022,GBR,W.P. Labuan,0,0,0,United Kingdom
49889,6/1/2022,GEO,Johor,9,6,3,Georgia
49890,6/1/2022,GEO,Kedah,2,1,1,Georgia
49891,6/1/2022,GEO,Melaka,0,0,0,Georgia
49892,6/1/2022,GEO,Perak,0,0,0,Georgia
49893,6/1/2022,GEO,Perlis,0,0,0,Georgia
49894,6/1/2022,GEO,Pulau Pinang,1,1,0,Georgia
49895,6/1/2022,GEO,Sabah,0,0,0,Georgia
49896,6/1/2022,GEO,Sarawak,0,0,0,Georgia
49897,6/1/2022,GEO,Selangor,18,13,5,Georgia
49898,6/1/2022,GHA,Johor,3,1,2,Ghana
49899,6/1/2022,GHA,Kedah,0,0,0,Ghana
49900,6/1/2022,GHA,Kelantan,0,0,0,Ghana
49901,6/1/2022,GHA,Pulau Pinang,0,0,0,Ghana
49902,6/1/2022,GHA,Sabah,0,0,0,Ghana
49903,6/1/2022,GHA,Sarawak,1,0,1,Ghana
49904,6/1/2022,GHA,Selangor,22,13,9,Ghana
49905,6/1/2022,GIB,Johor,0,0,0,Gibraltar
49906,6/1/2022,GIB,Sarawak,0,0,0,Gibraltar
49907,6/1/2022,GIN,Johor,4,4,0,Guinea
49908,6/1/2022,GIN,Kedah,0,0,0,Guinea
49909,6/1/2022,GIN,Kelantan,0,0,0,Guinea
49910,6/1/2022,GIN,Perlis,0,0,0,Guinea
49911,6/1/2022,GIN,Pulau Pinang,0,0,0,Guinea
49912,6/1/2022,GIN,Sabah,0,0,0,Guinea
49913,6/1/2022,GIN,Sarawak,0,0,0,Guinea
49914,6/1/2022,GIN,Selangor,19,14,5,Guinea
49915,6/1/2022,GLP,Selangor,0,0,0,Guadeloupe
49916,6/1/2022,GMB,Johor,0,0,0,Gambia
49917,6/1/2022,GMB,Kedah,0,0,0,Gambia
49918,6/1/2022,GMB,Kelantan,0,0,0,Gambia
49919,6/1/2022,GMB,Pulau Pinang,0,0,0,Gambia
49920,6/1/2022,GMB,Sabah,0,0,0,Gambia
49921,6/1/2022,GMB,Sarawak,0,0,0,Gambia
49922,6/1/2022,GMB,Selangor,10,6,4,Gambia
49923,6/1/2022,GNB,Johor,0,0,0,Guinea-Bissau
49924,6/1/2022,GNB,Selangor,0,0,0,Guinea-Bissau
49925,6/1/2022,GNQ,Johor,0,0,0,Equatorial Guinea
49926,6/1/2022,GNQ,Selangor,1,1,0,Equatorial Guinea
49927,6/1/2022,GRC,Johor,24,22,2,Greece
49928,6/1/2022,GRC,Kedah,2,1,1,Greece
49929,6/1/2022,GRC,Kelantan,0,0,0,Greece
49930,6/1/2022,GRC,Melaka,0,0,0,Greece
49931,6/1/2022,GRC,Negeri Sembilan,1,1,0,Greece
49932,6/1/2022,GRC,Pahang,3,3,0,Greece
49933,6/1/2022,GRC,Perak,0,0,0,Greece
49934,6/1/2022,GRC,Perlis,0,0,0,Greece
49935,6/1/2022,GRC,Pulau Pinang,1,0,1,Greece
49936,6/1/2022,GRC,Sabah,0,0,0,Greece
49937,6/1/2022,GRC,Sarawak,2,1,1,Greece
49938,6/1/2022,GRC,Selangor,94,73,21,Greece
49939,6/1/2022,GRD,Johor,1,0,1,Grenada
49940,6/1/2022,GRD,Kedah,0,0,0,Grenada
49941,6/1/2022,GRD,Pulau Pinang,2,2,0,Grenada
49942,6/1/2022,GRD,Sabah,0,0,0,Grenada
49943,6/1/2022,GRD,Sarawak,0,0,0,Grenada
49944,6/1/2022,GRD,Selangor,6,6,0,Grenada
49945,6/1/2022,GRL,Johor,0,0,0,Greenland
49946,6/1/2022,GRL,Selangor,0,0,0,Greenland
49947,6/1/2022,GTM,Johor,2,0,2,Guatemala
49948,6/1/2022,GTM,Kedah,0,0,0,Guatemala
49949,6/1/2022,GTM,Pahang,0,0,0,Guatemala
49950,6/1/2022,GTM,Perak,0,0,0,Guatemala
49951,6/1/2022,GTM,Pulau Pinang,0,0,0,Guatemala
49952,6/1/2022,GTM,Sabah,0,0,0,Guatemala
49953,6/1/2022,GTM,Sarawak,0,0,0,Guatemala
49954,6/1/2022,GTM,Selangor,13,5,8,Guatemala
49955,6/1/2022,GTM,W.P. Labuan,0,0,0,Guatemala
49956,6/1/2022,GUY,Johor,0,0,0,Guyana
49957,6/1/2022,GUY,Kedah,0,0,0,Guyana
49958,6/1/2022,GUY,Pulau Pinang,0,0,0,Guyana
49959,6/1/2022,GUY,Sarawak,0,0,0,Guyana
49960,6/1/2022,GUY,Selangor,5,4,1,Guyana
49961,6/1/2022,HKG,Johor,9,3,6,Hong Kong
49962,6/1/2022,HKG,Kedah,1,1,0,Hong Kong
49963,6/1/2022,HKG,Kelantan,0,0,0,Hong Kong
49964,6/1/2022,HKG,Pahang,0,0,0,Hong Kong
49965,6/1/2022,HKG,Perak,8,5,3,Hong Kong
49966,6/1/2022,HKG,Perlis,1,1,0,Hong Kong
49967,6/1/2022,HKG,Pulau Pinang,137,84,53,Hong Kong
49968,6/1/2022,HKG,Sabah,70,23,47,Hong Kong
49969,6/1/2022,HKG,Sarawak,53,23,30,Hong Kong
49970,6/1/2022,HKG,Selangor,11,4,7,Hong Kong
49971,6/1/2022,HKG,Terengganu,0,0,0,Hong Kong
49972,6/1/2022,HMD,Johor,0,0,0,Heard Island and McDonald Islands
49973,6/1/2022,HND,Johor,1,0,1,Honduras
49974,6/1/2022,HND,Kedah,0,0,0,Honduras
49975,6/1/2022,HND,Perak,0,0,0,Honduras
49976,6/1/2022,HND,Pulau Pinang,0,0,0,Honduras
49977,6/1/2022,HND,Sabah,0,0,0,Honduras
49978,6/1/2022,HND,Sarawak,0,0,0,Honduras
49979,6/1/2022,HND,Selangor,7,5,2,Honduras
49980,6/1/2022,HRV,Johor,11,11,0,Croatia
49981,6/1/2022,HRV,Kedah,0,0,0,Croatia
49982,6/1/2022,HRV,Kelantan,0,0,0,Croatia
49983,6/1/2022,HRV,Melaka,0,0,0,Croatia
49984,6/1/2022,HRV,Pahang,1,1,0,Croatia
49985,6/1/2022,HRV,Perak,0,0,0,Croatia
49986,6/1/2022,HRV,Perlis,0,0,0,Croatia
49987,6/1/2022,HRV,Pulau Pinang,2,1,1,Croatia
49988,6/1/2022,HRV,Sabah,1,0,1,Croatia
49989,6/1/2022,HRV,Sarawak,0,0,0,Croatia
49990,6/1/2022,HRV,Selangor,62,51,11,Croatia
49991,6/1/2022,HTI,Johor,0,0,0,Haiti
49992,6/1/2022,HTI,Kedah,0,0,0,Haiti
49993,6/1/2022,HTI,Kelantan,0,0,0,Haiti
49994,6/1/2022,HTI,Perak,0,0,0,Haiti
49995,6/1/2022,HTI,Pulau Pinang,0,0,0,Haiti
49996,6/1/2022,HTI,Sabah,0,0,0,Haiti
49997,6/1/2022,HTI,Selangor,1,1,0,Haiti
49998,6/1/2022,HUN,Johor,51,40,11,Hungary
49999,6/1/2022,HUN,Kedah,5,4,1,Hungary
50000,6/1/2022,HUN,Kelantan,0,0,0,Hungary
50001,6/1/2022,HUN,Pahang,0,0,0,Hungary
50002,6/1/2022,HUN,Perak,0,0,0,Hungary
50003,6/1/2022,HUN,Perlis,0,0,0,Hungary
50004,6/1/2022,HUN,Pulau Pinang,8,1,7,Hungary
50005,6/1/2022,HUN,Sabah,6,1,5,Hungary
50006,6/1/2022,HUN,Sarawak,1,0,1,Hungary
50007,6/1/2022,HUN,Selangor,134,75,59,Hungary
50008,6/1/2022,HUN,W.P. Labuan,0,0,0,Hungary
50009,6/1/2022,IDN,Johor,69380,35949,33431,Indonesia
50010,6/1/2022,IDN,Kedah,577,207,370,Indonesia
50011,6/1/2022,IDN,Kelantan,33,15,18,Indonesia
50012,6/1/2022,IDN,Melaka,5685,2555,3130,Indonesia
50013,6/1/2022,IDN,Negeri Sembilan,5752,4019,1733,Indonesia
50014,6/1/2022,IDN,Pahang,0,0,0,Indonesia
50015,6/1/2022,IDN,Perak,58,14,44,Indonesia
50016,6/1/2022,IDN,Perlis,77,37,40,Indonesia
50017,6/1/2022,IDN,Pulau Pinang,15595,6352,9243,Indonesia
50018,6/1/2022,IDN,Sabah,3148,1492,1656,Indonesia
50019,6/1/2022,IDN,Sarawak,23177,14458,8719,Indonesia
50020,6/1/2022,IDN,Selangor,39776,19320,20456,Indonesia
50021,6/1/2022,IDN,Terengganu,0,0,0,Indonesia
50022,6/1/2022,IDN,W.P. Labuan,7,7,0,Indonesia
50023,6/1/2022,IND,Johor,9893,6559,3334,India
50024,6/1/2022,IND,Kedah,1420,1095,325,India
50025,6/1/2022,IND,Kelantan,12,11,1,India
50026,6/1/2022,IND,Melaka,1,1,0,India
50027,6/1/2022,IND,Negeri Sembilan,0,0,0,India
50028,6/1/2022,IND,Pahang,1,1,0,India
50029,6/1/2022,IND,Perak,209,153,56,India
50030,6/1/2022,IND,Perlis,40,39,1,India
50031,6/1/2022,IND,Pulau Pinang,472,327,145,India
50032,6/1/2022,IND,Sabah,163,99,64,India
50033,6/1/2022,IND,Sarawak,55,39,16,India
50034,6/1/2022,IND,Selangor,34418,24965,9453,India
50035,6/1/2022,IND,Terengganu,0,0,0,India
50036,6/1/2022,IND,W.P. Labuan,0,0,0,India
50037,6/1/2022,IOT,Pulau Pinang,0,0,0,British Indian Ocean Territory
50038,6/1/2022,IOT,Selangor,0,0,0,British Indian Ocean Territory
50039,6/1/2022,IRL,Johor,213,155,58,Ireland
50040,6/1/2022,IRL,Kedah,36,21,15,Ireland
50041,6/1/2022,IRL,Kelantan,0,0,0,Ireland
50042,6/1/2022,IRL,Negeri Sembilan,0,0,0,Ireland
50043,6/1/2022,IRL,Pahang,0,0,0,Ireland
50044,6/1/2022,IRL,Perak,4,1,3,Ireland
50045,6/1/2022,IRL,Perlis,8,3,5,Ireland
50046,6/1/2022,IRL,Pulau Pinang,49,31,18,Ireland
50047,6/1/2022,IRL,Sabah,9,2,7,Ireland
50048,6/1/2022,IRL,Sarawak,0,0,0,Ireland
50049,6/1/2022,IRL,Selangor,643,411,232,Ireland
50050,6/1/2022,IRL,Terengganu,0,0,0,Ireland
50051,6/1/2022,IRL,W.P. Labuan,0,0,0,Ireland
50052,6/1/2022,IRN,Johor,132,74,58,Iran
50053,6/1/2022,IRN,Kedah,8,6,2,Iran
50054,6/1/2022,IRN,Kelantan,0,0,0,Iran
50055,6/1/2022,IRN,Perak,0,0,0,Iran
50056,6/1/2022,IRN,Perlis,0,0,0,Iran
50057,6/1/2022,IRN,Pulau Pinang,2,1,1,Iran
50058,6/1/2022,IRN,Sabah,0,0,0,Iran
50059,6/1/2022,IRN,Sarawak,1,1,0,Iran
50060,6/1/2022,IRN,Selangor,1132,612,520,Iran
50061,6/1/2022,IRN,W.P. Labuan,0,0,0,Iran
50062,6/1/2022,IRQ,Johor,15,9,6,Iraq
50063,6/1/2022,IRQ,Kedah,0,0,0,Iraq
50064,6/1/2022,IRQ,Kelantan,0,0,0,Iraq
50065,6/1/2022,IRQ,Melaka,0,0,0,Iraq
50066,6/1/2022,IRQ,Pahang,0,0,0,Iraq
50067,6/1/2022,IRQ,Perak,0,0,0,Iraq
50068,6/1/2022,IRQ,Perlis,0,0,0,Iraq
50069,6/1/2022,IRQ,Pulau Pinang,0,0,0,Iraq
50070,6/1/2022,IRQ,Sabah,0,0,0,Iraq
50071,6/1/2022,IRQ,Sarawak,0,0,0,Iraq
50072,6/1/2022,IRQ,Selangor,645,445,200,Iraq
50073,6/1/2022,ISL,Johor,5,2,3,Iceland
50074,6/1/2022,ISL,Kedah,0,0,0,Iceland
50075,6/1/2022,ISL,Kelantan,0,0,0,Iceland
50076,6/1/2022,ISL,Perak,0,0,0,Iceland
50077,6/1/2022,ISL,Perlis,0,0,0,Iceland
50078,6/1/2022,ISL,Pulau Pinang,0,0,0,Iceland
50079,6/1/2022,ISL,Sabah,0,0,0,Iceland
50080,6/1/2022,ISL,Sarawak,0,0,0,Iceland
50081,6/1/2022,ISL,Selangor,25,11,14,Iceland
50082,6/1/2022,ISL,W.P. Labuan,0,0,0,Iceland
50083,6/1/2022,ISR,Pulau Pinang,0,0,0,Israel
50084,6/1/2022,ITA,Johor,333,257,76,Italy
50085,6/1/2022,ITA,Kedah,23,10,13,Italy
50086,6/1/2022,ITA,Kelantan,1,1,0,Italy
50087,6/1/2022,ITA,Melaka,0,0,0,Italy
50088,6/1/2022,ITA,Negeri Sembilan,0,0,0,Italy
50089,6/1/2022,ITA,Pahang,0,0,0,Italy
50090,6/1/2022,ITA,Perak,1,1,0,Italy
50091,6/1/2022,ITA,Perlis,0,0,0,Italy
50092,6/1/2022,ITA,Pulau Pinang,43,35,8,Italy
50093,6/1/2022,ITA,Sabah,15,11,4,Italy
50094,6/1/2022,ITA,Sarawak,10,7,3,Italy
50095,6/1/2022,ITA,Selangor,1027,740,287,Italy
50096,6/1/2022,ITA,W.P. Labuan,0,0,0,Italy
50097,6/1/2022,JAM,Johor,1,1,0,Jamaica
50098,6/1/2022,JAM,Kedah,1,0,1,Jamaica
50099,6/1/2022,JAM,Perak,0,0,0,Jamaica
50100,6/1/2022,JAM,Pulau Pinang,0,0,0,Jamaica
50101,6/1/2022,JAM,Sabah,0,0,0,Jamaica
50102,6/1/2022,JAM,Sarawak,0,0,0,Jamaica
50103,6/1/2022,JAM,Selangor,7,4,3,Jamaica
50104,6/1/2022,JAM,W.P. Labuan,0,0,0,Jamaica
50105,6/1/2022,JOR,Johor,3,1,2,Jordan
50106,6/1/2022,JOR,Kedah,3,2,1,Jordan
50107,6/1/2022,JOR,Kelantan,0,0,0,Jordan
50108,6/1/2022,JOR,Melaka,0,0,0,Jordan
50109,6/1/2022,JOR,Perlis,1,1,0,Jordan
50110,6/1/2022,JOR,Pulau Pinang,0,0,0,Jordan
50111,6/1/2022,JOR,Sabah,0,0,0,Jordan
50112,6/1/2022,JOR,Sarawak,0,0,0,Jordan
50113,6/1/2022,JOR,Selangor,569,338,231,Jordan
50114,6/1/2022,JOR,W.P. Labuan,0,0,0,Jordan
50115,6/1/2022,JPN,Johor,3081,2282,799,Japan
50116,6/1/2022,JPN,Kedah,88,44,44,Japan
50117,6/1/2022,JPN,Kelantan,1,1,0,Japan
50118,6/1/2022,JPN,Melaka,0,0,0,Japan
50119,6/1/2022,JPN,Negeri Sembilan,0,0,0,Japan
50120,6/1/2022,JPN,Pahang,1,0,1,Japan
50121,6/1/2022,JPN,Perak,15,12,3,Japan
50122,6/1/2022,JPN,Perlis,6,6,0,Japan
50123,6/1/2022,JPN,Pulau Pinang,491,383,108,Japan
50124,6/1/2022,JPN,Sabah,60,31,29,Japan
50125,6/1/2022,JPN,Sarawak,51,38,13,Japan
50126,6/1/2022,JPN,Selangor,5495,4016,1479,Japan
50127,6/1/2022,JPN,W.P. Labuan,1,1,0,Japan
50128,6/1/2022,KAZ,Johor,14,8,6,Kazakhstan
50129,6/1/2022,KAZ,Kedah,3,1,2,Kazakhstan
50130,6/1/2022,KAZ,Kelantan,0,0,0,Kazakhstan
50131,6/1/2022,KAZ,Melaka,0,0,0,Kazakhstan
50132,6/1/2022,KAZ,Perak,0,0,0,Kazakhstan
50133,6/1/2022,KAZ,Perlis,0,0,0,Kazakhstan
50134,6/1/2022,KAZ,Pulau Pinang,1,0,1,Kazakhstan
50135,6/1/2022,KAZ,Sabah,0,0,0,Kazakhstan
50136,6/1/2022,KAZ,Sarawak,0,0,0,Kazakhstan
50137,6/1/2022,KAZ,Selangor,205,82,123,Kazakhstan
50138,6/1/2022,KAZ,W.P. Labuan,0,0,0,Kazakhstan
50139,6/1/2022,KEN,Johor,22,9,13,Kenya
50140,6/1/2022,KEN,Kedah,0,0,0,Kenya
50141,6/1/2022,KEN,Kelantan,0,0,0,Kenya
50142,6/1/2022,KEN,Perak,0,0,0,Kenya
50143,6/1/2022,KEN,Perlis,1,1,0,Kenya
50144,6/1/2022,KEN,Pulau Pinang,0,0,0,Kenya
50145,6/1/2022,KEN,Sabah,0,0,0,Kenya
50146,6/1/2022,KEN,Sarawak,1,0,1,Kenya
50147,6/1/2022,KEN,Selangor,163,94,69,Kenya
50148,6/1/2022,KGZ,Johor,17,11,6,Kyrgyzstan
50149,6/1/2022,KGZ,Kedah,0,0,0,Kyrgyzstan
50150,6/1/2022,KGZ,Kelantan,0,0,0,Kyrgyzstan
50151,6/1/2022,KGZ,Perak,0,0,0,Kyrgyzstan
50152,6/1/2022,KGZ,Perlis,0,0,0,Kyrgyzstan
50153,6/1/2022,KGZ,Pulau Pinang,1,0,1,Kyrgyzstan
50154,6/1/2022,KGZ,Sabah,0,0,0,Kyrgyzstan
50155,6/1/2022,KGZ,Sarawak,0,0,0,Kyrgyzstan
50156,6/1/2022,KGZ,Selangor,138,86,52,Kyrgyzstan
50157,6/1/2022,KHM,Johor,644,274,370,Cambodia
50158,6/1/2022,KHM,Kedah,385,253,132,Cambodia
50159,6/1/2022,KHM,Kelantan,35,21,14,Cambodia
50160,6/1/2022,KHM,Melaka,0,0,0,Cambodia
50161,6/1/2022,KHM,Negeri Sembilan,0,0,0,Cambodia
50162,6/1/2022,KHM,Pahang,0,0,0,Cambodia
50163,6/1/2022,KHM,Perak,4,3,1,Cambodia
50164,6/1/2022,KHM,Perlis,605,431,174,Cambodia
50165,6/1/2022,KHM,Pulau Pinang,18,3,15,Cambodia
50166,6/1/2022,KHM,Sabah,0,0,0,Cambodia
50167,6/1/2022,KHM,Sarawak,3,2,1,Cambodia
50168,6/1/2022,KHM,Selangor,2407,1272,1135,Cambodia
50169,6/1/2022,KHM,W.P. Labuan,0,0,0,Cambodia
50170,6/1/2022,KIR,Johor,0,0,0,Kiribati
50171,6/1/2022,KIR,Sabah,0,0,0,Kiribati
50172,6/1/2022,KIR,Selangor,0,0,0,Kiribati
50173,6/1/2022,KNA,Johor,18,14,4,Saint Kitts and Nevis
50174,6/1/2022,KNA,Kedah,0,0,0,Saint Kitts and Nevis
50175,6/1/2022,KNA,Perlis,0,0,0,Saint Kitts and Nevis
50176,6/1/2022,KNA,Pulau Pinang,1,1,0,Saint Kitts and Nevis
50177,6/1/2022,KNA,Sabah,0,0,0,Saint Kitts and Nevis
50178,6/1/2022,KNA,Selangor,29,23,6,Saint Kitts and Nevis
50179,6/1/2022,KNA,W.P. Labuan,0,0,0,Saint Kitts and Nevis
50180,6/1/2022,KOR,Johor,5453,3265,2188,"Korea, Republic of (South Korea)"
50181,6/1/2022,KOR,Kedah,45,24,21,"Korea, Republic of (South Korea)"
50182,6/1/2022,KOR,Kelantan,0,0,0,"Korea, Republic of (South Korea)"
50183,6/1/2022,KOR,Melaka,1,1,0,"Korea, Republic of (South Korea)"
50184,6/1/2022,KOR,Negeri Sembilan,0,0,0,"Korea, Republic of (South Korea)"
50185,6/1/2022,KOR,Pahang,0,0,0,"Korea, Republic of (South Korea)"
50186,6/1/2022,KOR,Perak,13,7,6,"Korea, Republic of (South Korea)"
50187,6/1/2022,KOR,Perlis,20,17,3,"Korea, Republic of (South Korea)"
50188,6/1/2022,KOR,Pulau Pinang,189,122,67,"Korea, Republic of (South Korea)"
50189,6/1/2022,KOR,Sabah,1976,901,1075,"Korea, Republic of (South Korea)"
50190,6/1/2022,KOR,Sarawak,76,50,26,"Korea, Republic of (South Korea)"
50191,6/1/2022,KOR,Selangor,5050,3145,1905,"Korea, Republic of (South Korea)"
50192,6/1/2022,KOR,Terengganu,0,0,0,"Korea, Republic of (South Korea)"
50193,6/1/2022,KOR,W.P. Labuan,0,0,0,"Korea, Republic of (South Korea)"
50194,6/1/2022,KWT,Johor,20,10,10,Kuwait
50195,6/1/2022,KWT,Kedah,11,5,6,Kuwait
50196,6/1/2022,KWT,Kelantan,0,0,0,Kuwait
50197,6/1/2022,KWT,Perak,0,0,0,Kuwait
50198,6/1/2022,KWT,Perlis,0,0,0,Kuwait
50199,6/1/2022,KWT,Pulau Pinang,4,3,1,Kuwait
50200,6/1/2022,KWT,Sabah,1,0,1,Kuwait
50201,6/1/2022,KWT,Sarawak,5,3,2,Kuwait
50202,6/1/2022,KWT,Selangor,323,170,153,Kuwait
50203,6/1/2022,KWT,W.P. Labuan,0,0,0,Kuwait
50204,6/1/2022,LAO,Johor,27,7,20,Lao People's Democratic Republic
50205,6/1/2022,LAO,Kedah,295,39,256,Lao People's Democratic Republic
50206,6/1/2022,LAO,Kelantan,25,1,24,Lao People's Democratic Republic
50207,6/1/2022,LAO,Melaka,0,0,0,Lao People's Democratic Republic
50208,6/1/2022,LAO,Perak,0,0,0,Lao People's Democratic Republic
50209,6/1/2022,LAO,Perlis,36,26,10,Lao People's Democratic Republic
50210,6/1/2022,LAO,Pulau Pinang,6,0,6,Lao People's Democratic Republic
50211,6/1/2022,LAO,Sabah,0,0,0,Lao People's Democratic Republic
50212,6/1/2022,LAO,Sarawak,1,1,0,Lao People's Democratic Republic
50213,6/1/2022,LAO,Selangor,100,43,57,Lao People's Democratic Republic
50214,6/1/2022,LAO,W.P. Labuan,0,0,0,Lao People's Democratic Republic
50215,6/1/2022,LBN,Johor,6,4,2,Lebanon
50216,6/1/2022,LBN,Kedah,0,0,0,Lebanon
50217,6/1/2022,LBN,Kelantan,0,0,0,Lebanon
50218,6/1/2022,LBN,Pahang,0,0,0,Lebanon
50219,6/1/2022,LBN,Perak,0,0,0,Lebanon
50220,6/1/2022,LBN,Perlis,0,0,0,Lebanon
50221,6/1/2022,LBN,Pulau Pinang,3,2,1,Lebanon
50222,6/1/2022,LBN,Sabah,1,0,1,Lebanon
50223,6/1/2022,LBN,Sarawak,0,0,0,Lebanon
50224,6/1/2022,LBN,Selangor,127,81,46,Lebanon
50225,6/1/2022,LBN,W.P. Labuan,0,0,0,Lebanon
50226,6/1/2022,LBR,Johor,1,1,0,Liberia
50227,6/1/2022,LBR,Kedah,0,0,0,Liberia
50228,6/1/2022,LBR,Sabah,0,0,0,Liberia
50229,6/1/2022,LBR,Sarawak,0,0,0,Liberia
50230,6/1/2022,LBR,Selangor,4,4,0,Liberia
50231,6/1/2022,LBY,Johor,0,0,0,Libyan Arab Jamahiriya
50232,6/1/2022,LBY,Kedah,0,0,0,Libyan Arab Jamahiriya
50233,6/1/2022,LBY,Perlis,0,0,0,Libyan Arab Jamahiriya
50234,6/1/2022,LBY,Pulau Pinang,0,0,0,Libyan Arab Jamahiriya
50235,6/1/2022,LBY,Sabah,0,0,0,Libyan Arab Jamahiriya
50236,6/1/2022,LBY,Sarawak,0,0,0,Libyan Arab Jamahiriya
50237,6/1/2022,LBY,Selangor,242,172,70,Libyan Arab Jamahiriya
50238,6/1/2022,LCA,Johor,5,5,0,Saint Lucia
50239,6/1/2022,LCA,Kedah,0,0,0,Saint Lucia
50240,6/1/2022,LCA,Pulau Pinang,0,0,0,Saint Lucia
50241,6/1/2022,LCA,Sarawak,0,0,0,Saint Lucia
50242,6/1/2022,LCA,Selangor,0,0,0,Saint Lucia
50243,6/1/2022,LIE,Johor,1,0,1,Liechtenstein
50244,6/1/2022,LIE,Kedah,0,0,0,Liechtenstein
50245,6/1/2022,LIE,Perlis,0,0,0,Liechtenstein
50246,6/1/2022,LIE,Pulau Pinang,0,0,0,Liechtenstein
50247,6/1/2022,LIE,Sabah,2,1,1,Liechtenstein
50248,6/1/2022,LIE,Sarawak,0,0,0,Liechtenstein
50249,6/1/2022,LIE,Selangor,1,1,0,Liechtenstein
50250,6/1/2022,LKA,Johor,535,338,197,Sri Lanka
50251,6/1/2022,LKA,Kedah,33,18,15,Sri Lanka
50252,6/1/2022,LKA,Kelantan,0,0,0,Sri Lanka
50253,6/1/2022,LKA,Melaka,0,0,0,Sri Lanka
50254,6/1/2022,LKA,Pahang,0,0,0,Sri Lanka
50255,6/1/2022,LKA,Perak,2,1,1,Sri Lanka
50256,6/1/2022,LKA,Perlis,0,0,0,Sri Lanka
50257,6/1/2022,LKA,Pulau Pinang,19,13,6,Sri Lanka
50258,6/1/2022,LKA,Sabah,8,5,3,Sri Lanka
50259,6/1/2022,LKA,Sarawak,5,3,2,Sri Lanka
50260,6/1/2022,LKA,Selangor,1798,1189,609,Sri Lanka
50261,6/1/2022,LKA,W.P. Labuan,0,0,0,Sri Lanka
50262,6/1/2022,LSO,Johor,1,0,1,Lesotho
50263,6/1/2022,LSO,Kedah,0,0,0,Lesotho
50264,6/1/2022,LSO,Pulau Pinang,0,0,0,Lesotho
50265,6/1/2022,LSO,Sarawak,0,0,0,Lesotho
50266,6/1/2022,LSO,Selangor,1,1,0,Lesotho
50267,6/1/2022,LTU,Johor,7,4,3,Lithuania
50268,6/1/2022,LTU,Kedah,5,3,2,Lithuania
50269,6/1/2022,LTU,Kelantan,1,0,1,Lithuania
50270,6/1/2022,LTU,Pahang,0,0,0,Lithuania
50271,6/1/2022,LTU,Perak,0,0,0,Lithuania
50272,6/1/2022,LTU,Perlis,0,0,0,Lithuania
50273,6/1/2022,LTU,Pulau Pinang,1,1,0,Lithuania
50274,6/1/2022,LTU,Sabah,2,1,1,Lithuania
50275,6/1/2022,LTU,Sarawak,2,1,1,Lithuania
50276,6/1/2022,LTU,Selangor,59,28,31,Lithuania
50277,6/1/2022,LTU,W.P. Labuan,0,0,0,Lithuania
50278,6/1/2022,LUX,Johor,3,2,1,Luxembourg
50279,6/1/2022,LUX,Kedah,0,0,0,Luxembourg
50280,6/1/2022,LUX,Kelantan,0,0,0,Luxembourg
50281,6/1/2022,LUX,Perak,0,0,0,Luxembourg
50282,6/1/2022,LUX,Perlis,0,0,0,Luxembourg
50283,6/1/2022,LUX,Pulau Pinang,2,1,1,Luxembourg
50284,6/1/2022,LUX,Sabah,0,0,0,Luxembourg
50285,6/1/2022,LUX,Sarawak,0,0,0,Luxembourg
50286,6/1/2022,LUX,Selangor,14,8,6,Luxembourg
50287,6/1/2022,LVA,Johor,6,4,2,Latvia
50288,6/1/2022,LVA,Kedah,0,0,0,Latvia
50289,6/1/2022,LVA,Kelantan,0,0,0,Latvia
50290,6/1/2022,LVA,Pahang,0,0,0,Latvia
50291,6/1/2022,LVA,Perak,0,0,0,Latvia
50292,6/1/2022,LVA,Perlis,0,0,0,Latvia
50293,6/1/2022,LVA,Pulau Pinang,0,0,0,Latvia
50294,6/1/2022,LVA,Sabah,1,0,1,Latvia
50295,6/1/2022,LVA,Sarawak,0,0,0,Latvia
50296,6/1/2022,LVA,Selangor,25,10,15,Latvia
50297,6/1/2022,LVA,W.P. Labuan,0,0,0,Latvia
50298,6/1/2022,MAC,Johor,0,0,0,Macao
50299,6/1/2022,MAC,Pahang,0,0,0,Macao
50300,6/1/2022,MAC,Perak,0,0,0,Macao
50301,6/1/2022,MAC,Selangor,0,0,0,Macao
50302,6/1/2022,MAC,W.P. Labuan,0,0,0,Macao
50303,6/1/2022,MAR,Johor,43,32,11,Morocco
50304,6/1/2022,MAR,Kedah,1,0,1,Morocco
50305,6/1/2022,MAR,Kelantan,0,0,0,Morocco
50306,6/1/2022,MAR,Melaka,0,0,0,Morocco
50307,6/1/2022,MAR,Pahang,0,0,0,Morocco
50308,6/1/2022,MAR,Perak,0,0,0,Morocco
50309,6/1/2022,MAR,Perlis,0,0,0,Morocco
50310,6/1/2022,MAR,Pulau Pinang,2,0,2,Morocco
50311,6/1/2022,MAR,Sabah,1,1,0,Morocco
50312,6/1/2022,MAR,Sarawak,0,0,0,Morocco
50313,6/1/2022,MAR,Selangor,302,144,158,Morocco
50314,6/1/2022,MAR,W.P. Labuan,0,0,0,Morocco
50315,6/1/2022,MCO,Johor,4,3,1,Monaco
50316,6/1/2022,MCO,Kedah,0,0,0,Monaco
50317,6/1/2022,MCO,Sabah,0,0,0,Monaco
50318,6/1/2022,MCO,Selangor,0,0,0,Monaco
50319,6/1/2022,MDA,Johor,6,3,3,"Moldova, Republic of"
50320,6/1/2022,MDA,Kedah,0,0,0,"Moldova, Republic of"
50321,6/1/2022,MDA,Kelantan,0,0,0,"Moldova, Republic of"
50322,6/1/2022,MDA,Negeri Sembilan,0,0,0,"Moldova, Republic of"
50323,6/1/2022,MDA,Perlis,0,0,0,"Moldova, Republic of"
50324,6/1/2022,MDA,Pulau Pinang,0,0,0,"Moldova, Republic of"
50325,6/1/2022,MDA,Sabah,0,0,0,"Moldova, Republic of"
50326,6/1/2022,MDA,Sarawak,0,0,0,"Moldova, Republic of"
50327,6/1/2022,MDA,Selangor,3,1,2,"Moldova, Republic of"
50328,6/1/2022,MDG,Johor,1,0,1,Madagascar
50329,6/1/2022,MDG,Kedah,0,0,0,Madagascar
50330,6/1/2022,MDG,Perak,0,0,0,Madagascar
50331,6/1/2022,MDG,Perlis,0,0,0,Madagascar
50332,6/1/2022,MDG,Pulau Pinang,0,0,0,Madagascar
50333,6/1/2022,MDG,Sabah,0,0,0,Madagascar
50334,6/1/2022,MDG,Sarawak,0,0,0,Madagascar
50335,6/1/2022,MDG,Selangor,14,7,7,Madagascar
50336,6/1/2022,MDV,Johor,82,49,33,Maldives
50337,6/1/2022,MDV,Kedah,0,0,0,Maldives
50338,6/1/2022,MDV,Kelantan,0,0,0,Maldives
50339,6/1/2022,MDV,Perak,0,0,0,Maldives
50340,6/1/2022,MDV,Perlis,1,1,0,Maldives
50341,6/1/2022,MDV,Pulau Pinang,14,9,5,Maldives
50342,6/1/2022,MDV,Sabah,0,0,0,Maldives
50343,6/1/2022,MDV,Sarawak,1,1,0,Maldives
50344,6/1/2022,MDV,Selangor,1376,697,679,Maldives
50345,6/1/2022,MEX,Johor,45,25,20,Mexico
50346,6/1/2022,MEX,Kedah,0,0,0,Mexico
50347,6/1/2022,MEX,Kelantan,0,0,0,Mexico
50348,6/1/2022,MEX,Pahang,0,0,0,Mexico
50349,6/1/2022,MEX,Perak,0,0,0,Mexico
50350,6/1/2022,MEX,Perlis,0,0,0,Mexico
50351,6/1/2022,MEX,Pulau Pinang,26,21,5,Mexico
50352,6/1/2022,MEX,Sabah,1,1,0,Mexico
50353,6/1/2022,MEX,Sarawak,1,1,0,Mexico
50354,6/1/2022,MEX,Selangor,197,102,95,Mexico
50355,6/1/2022,MEX,W.P. Labuan,0,0,0,Mexico
50356,6/1/2022,MHL,Johor,3,0,3,Marshall Islands
50357,6/1/2022,MHL,Kedah,0,0,0,Marshall Islands
50358,6/1/2022,MHL,Perak,0,0,0,Marshall Islands
50359,6/1/2022,MHL,Pulau Pinang,0,0,0,Marshall Islands
50360,6/1/2022,MHL,Sabah,0,0,0,Marshall Islands
50361,6/1/2022,MHL,Selangor,0,0,0,Marshall Islands
50362,6/1/2022,MKD,Johor,2,1,1,"Macedonia, the former Yugoslav Republic of"
50363,6/1/2022,MKD,Kedah,0,0,0,"Macedonia, the former Yugoslav Republic of"
50364,6/1/2022,MKD,Perak,0,0,0,"Macedonia, the former Yugoslav Republic of"
50365,6/1/2022,MKD,Pulau Pinang,0,0,0,"Macedonia, the former Yugoslav Republic of"
50366,6/1/2022,MKD,Sabah,0,0,0,"Macedonia, the former Yugoslav Republic of"
50367,6/1/2022,MKD,Sarawak,0,0,0,"Macedonia, the former Yugoslav Republic of"
50368,6/1/2022,MKD,Selangor,13,10,3,"Macedonia, the former Yugoslav Republic of"
50369,6/1/2022,MLI,Johor,2,2,0,Mali
50370,6/1/2022,MLI,Sabah,0,0,0,Mali
50371,6/1/2022,MLI,Selangor,3,2,1,Mali
50372,6/1/2022,MLT,Johor,6,5,1,Malta
50373,6/1/2022,MLT,Kedah,1,0,1,Malta
50374,6/1/2022,MLT,Kelantan,0,0,0,Malta
50375,6/1/2022,MLT,Perak,0,0,0,Malta
50376,6/1/2022,MLT,Perlis,0,0,0,Malta
50377,6/1/2022,MLT,Pulau Pinang,1,1,0,Malta
50378,6/1/2022,MLT,Sabah,3,2,1,Malta
50379,6/1/2022,MLT,Sarawak,0,0,0,Malta
50380,6/1/2022,MLT,Selangor,19,12,7,Malta
50381,6/1/2022,MLT,W.P. Labuan,0,0,0,Malta
50382,6/1/2022,MMR,Johor,2342,713,1629,Myanmar
50383,6/1/2022,MMR,Kedah,13,4,9,Myanmar
50384,6/1/2022,MMR,Kelantan,0,0,0,Myanmar
50385,6/1/2022,MMR,Negeri Sembilan,0,0,0,Myanmar
50386,6/1/2022,MMR,Pahang,0,0,0,Myanmar
50387,6/1/2022,MMR,Perak,11,2,9,Myanmar
50388,6/1/2022,MMR,Perlis,0,0,0,Myanmar
50389,6/1/2022,MMR,Pulau Pinang,64,14,50,Myanmar
50390,6/1/2022,MMR,Sabah,10,4,6,Myanmar
50391,6/1/2022,MMR,Sarawak,15,6,9,Myanmar
50392,6/1/2022,MMR,Selangor,3261,1974,1287,Myanmar
50393,6/1/2022,MMR,Terengganu,0,0,0,Myanmar
50394,6/1/2022,MMR,W.P. Labuan,0,0,0,Myanmar
50395,6/1/2022,MNE,Johor,1,1,0,Montenegro
50396,6/1/2022,MNE,Kedah,0,0,0,Montenegro
50397,6/1/2022,MNE,Pulau Pinang,0,0,0,Montenegro
50398,6/1/2022,MNE,Sabah,0,0,0,Montenegro
50399,6/1/2022,MNE,Sarawak,0,0,0,Montenegro
50400,6/1/2022,MNE,Selangor,4,3,1,Montenegro
50401,6/1/2022,MNG,Johor,61,18,43,Mongolia
50402,6/1/2022,MNG,Kedah,1,0,1,Mongolia
50403,6/1/2022,MNG,Kelantan,0,0,0,Mongolia
50404,6/1/2022,MNG,Perak,0,0,0,Mongolia
50405,6/1/2022,MNG,Perlis,1,0,1,Mongolia
50406,6/1/2022,MNG,Pulau Pinang,7,3,4,Mongolia
50407,6/1/2022,MNG,Sabah,3,1,2,Mongolia
50408,6/1/2022,MNG,Sarawak,0,0,0,Mongolia
50409,6/1/2022,MNG,Selangor,115,47,68,Mongolia
50410,6/1/2022,MNP,Selangor,0,0,0,Northern Mariana Islands
50411,6/1/2022,MOZ,Johor,1,1,0,Mozambique
50412,6/1/2022,MOZ,Kedah,0,0,0,Mozambique
50413,6/1/2022,MOZ,Perak,0,0,0,Mozambique
50414,6/1/2022,MOZ,Pulau Pinang,0,0,0,Mozambique
50415,6/1/2022,MOZ,Sabah,0,0,0,Mozambique
50416,6/1/2022,MOZ,Sarawak,0,0,0,Mozambique
50417,6/1/2022,MOZ,Selangor,41,22,19,Mozambique
50418,6/1/2022,MRT,Johor,1,1,0,Mauritania
50419,6/1/2022,MRT,Kedah,0,0,0,Mauritania
50420,6/1/2022,MRT,Pulau Pinang,0,0,0,Mauritania
50421,6/1/2022,MRT,Sabah,0,0,0,Mauritania
50422,6/1/2022,MRT,Sarawak,0,0,0,Mauritania
50423,6/1/2022,MRT,Selangor,8,6,2,Mauritania
50424,6/1/2022,MUS,Johor,40,20,20,Mauritius
50425,6/1/2022,MUS,Kedah,4,2,2,Mauritius
50426,6/1/2022,MUS,Kelantan,0,0,0,Mauritius
50427,6/1/2022,MUS,Pahang,0,0,0,Mauritius
50428,6/1/2022,MUS,Perak,0,0,0,Mauritius
50429,6/1/2022,MUS,Perlis,0,0,0,Mauritius
50430,6/1/2022,MUS,Pulau Pinang,0,0,0,Mauritius
50431,6/1/2022,MUS,Sabah,0,0,0,Mauritius
50432,6/1/2022,MUS,Sarawak,0,0,0,Mauritius
50433,6/1/2022,MUS,Selangor,156,80,76,Mauritius
50434,6/1/2022,MWI,Johor,0,0,0,Malawi
50435,6/1/2022,MWI,Pulau Pinang,0,0,0,Malawi
50436,6/1/2022,MWI,Sabah,0,0,0,Malawi
50437,6/1/2022,MWI,Sarawak,0,0,0,Malawi
50438,6/1/2022,MWI,Selangor,18,8,10,Malawi
50439,6/1/2022,MYT,Selangor,0,0,0,Mayotte
50440,6/1/2022,NAM,Johor,1,0,1,Namibia
50441,6/1/2022,NAM,Kedah,0,0,0,Namibia
50442,6/1/2022,NAM,Perak,0,0,0,Namibia
50443,6/1/2022,NAM,Perlis,0,0,0,Namibia
50444,6/1/2022,NAM,Pulau Pinang,0,0,0,Namibia
50445,6/1/2022,NAM,Sabah,0,0,0,Namibia
50446,6/1/2022,NAM,Sarawak,0,0,0,Namibia
50447,6/1/2022,NAM,Selangor,5,2,3,Namibia
50448,6/1/2022,NCL,Selangor,0,0,0,New Caledonia
50449,6/1/2022,NER,Johor,0,0,0,Niger
50450,6/1/2022,NER,Sabah,0,0,0,Niger
50451,6/1/2022,NER,Selangor,6,2,4,Niger
50452,6/1/2022,NGA,Johor,31,25,6,Nigeria
50453,6/1/2022,NGA,Kedah,0,0,0,Nigeria
50454,6/1/2022,NGA,Perlis,0,0,0,Nigeria
50455,6/1/2022,NGA,Pulau Pinang,1,1,0,Nigeria
50456,6/1/2022,NGA,Sabah,1,1,0,Nigeria
50457,6/1/2022,NGA,Sarawak,1,1,0,Nigeria
50458,6/1/2022,NGA,Selangor,303,241,62,Nigeria
50459,6/1/2022,NIC,Johor,0,0,0,Nicaragua
50460,6/1/2022,NIC,Kedah,0,0,0,Nicaragua
50461,6/1/2022,NIC,Pulau Pinang,0,0,0,Nicaragua
50462,6/1/2022,NIC,Sabah,0,0,0,Nicaragua
50463,6/1/2022,NIC,Selangor,2,2,0,Nicaragua
50464,6/1/2022,NLD,Johor,531,384,147,Netherlands
50465,6/1/2022,NLD,Kedah,40,28,12,Netherlands
50466,6/1/2022,NLD,Kelantan,4,3,1,Netherlands
50467,6/1/2022,NLD,Melaka,0,0,0,Netherlands
50468,6/1/2022,NLD,Negeri Sembilan,3,0,3,Netherlands
50469,6/1/2022,NLD,Pahang,2,1,1,Netherlands
50470,6/1/2022,NLD,Perak,2,1,1,Netherlands
50471,6/1/2022,NLD,Perlis,12,7,5,Netherlands
50472,6/1/2022,NLD,Pulau Pinang,97,71,26,Netherlands
50473,6/1/2022,NLD,Sabah,39,23,16,Netherlands
50474,6/1/2022,NLD,Sarawak,26,15,11,Netherlands
50475,6/1/2022,NLD,Selangor,1856,1228,628,Netherlands
50476,6/1/2022,NLD,Terengganu,0,0,0,Netherlands
50477,6/1/2022,NLD,W.P. Labuan,0,0,0,Netherlands
50478,6/1/2022,NOR,Johor,84,59,25,Norway
50479,6/1/2022,NOR,Kedah,3,2,1,Norway
50480,6/1/2022,NOR,Kelantan,1,1,0,Norway
50481,6/1/2022,NOR,Melaka,0,0,0,Norway
50482,6/1/2022,NOR,Pahang,0,0,0,Norway
50483,6/1/2022,NOR,Perak,0,0,0,Norway
50484,6/1/2022,NOR,Perlis,3,1,2,Norway
50485,6/1/2022,NOR,Pulau Pinang,25,12,13,Norway
50486,6/1/2022,NOR,Sabah,9,8,1,Norway
50487,6/1/2022,NOR,Sarawak,5,2,3,Norway
50488,6/1/2022,NOR,Selangor,427,253,174,Norway
50489,6/1/2022,NOR,W.P. Labuan,0,0,0,Norway
50490,6/1/2022,NPL,Johor,668,572,96,Nepal
50491,6/1/2022,NPL,Kedah,2,2,0,Nepal
50492,6/1/2022,NPL,Pahang,0,0,0,Nepal
50493,6/1/2022,NPL,Perak,0,0,0,Nepal
50494,6/1/2022,NPL,Perlis,1,1,0,Nepal
50495,6/1/2022,NPL,Pulau Pinang,4,3,1,Nepal
50496,6/1/2022,NPL,Sabah,3,3,0,Nepal
50497,6/1/2022,NPL,Sarawak,3,3,0,Nepal
50498,6/1/2022,NPL,Selangor,11640,11011,629,Nepal
50499,6/1/2022,NPL,W.P. Labuan,0,0,0,Nepal
50500,6/1/2022,NRU,Johor,0,0,0,Nauru
50501,6/1/2022,NRU,Pulau Pinang,0,0,0,Nauru
50502,6/1/2022,NRU,Selangor,0,0,0,Nauru
50503,6/1/2022,NZL,Johor,394,268,126,New Zealand
50504,6/1/2022,NZL,Kedah,26,15,11,New Zealand
50505,6/1/2022,NZL,Kelantan,2,2,0,New Zealand
50506,6/1/2022,NZL,Melaka,0,0,0,New Zealand
50507,6/1/2022,NZL,Negeri Sembilan,0,0,0,New Zealand
50508,6/1/2022,NZL,Pahang,2,1,1,New Zealand
50509,6/1/2022,NZL,Perak,10,6,4,New Zealand
50510,6/1/2022,NZL,Perlis,0,0,0,New Zealand
50511,6/1/2022,NZL,Pulau Pinang,91,58,33,New Zealand
50512,6/1/2022,NZL,Sabah,19,9,10,New Zealand
50513,6/1/2022,NZL,Sarawak,23,15,8,New Zealand
50514,6/1/2022,NZL,Selangor,997,647,350,New Zealand
50515,6/1/2022,NZL,Terengganu,1,1,0,New Zealand
50516,6/1/2022,NZL,W.P. Labuan,0,0,0,New Zealand
50517,6/1/2022,OMN,Johor,52,32,20,Oman
50518,6/1/2022,OMN,Kedah,0,0,0,Oman
50519,6/1/2022,OMN,Kelantan,0,0,0,Oman
50520,6/1/2022,OMN,Melaka,0,0,0,Oman
50521,6/1/2022,OMN,Perak,0,0,0,Oman
50522,6/1/2022,OMN,Perlis,0,0,0,Oman
50523,6/1/2022,OMN,Pulau Pinang,2,1,1,Oman
50524,6/1/2022,OMN,Sabah,2,1,1,Oman
50525,6/1/2022,OMN,Sarawak,0,0,0,Oman
50526,6/1/2022,OMN,Selangor,870,499,371,Oman
50527,6/1/2022,PAK,Johor,598,423,175,Pakistan
50528,6/1/2022,PAK,Kedah,57,35,22,Pakistan
50529,6/1/2022,PAK,Kelantan,11,11,0,Pakistan
50530,6/1/2022,PAK,Melaka,0,0,0,Pakistan
50531,6/1/2022,PAK,Negeri Sembilan,0,0,0,Pakistan
50532,6/1/2022,PAK,Pahang,0,0,0,Pakistan
50533,6/1/2022,PAK,Perak,0,0,0,Pakistan
50534,6/1/2022,PAK,Perlis,9,9,0,Pakistan
50535,6/1/2022,PAK,Pulau Pinang,21,19,2,Pakistan
50536,6/1/2022,PAK,Sabah,2,2,0,Pakistan
50537,6/1/2022,PAK,Sarawak,14,7,7,Pakistan
50538,6/1/2022,PAK,Selangor,7132,5840,1292,Pakistan
50539,6/1/2022,PAK,W.P. Labuan,0,0,0,Pakistan
50540,6/1/2022,PAN,Johor,0,0,0,Panama
50541,6/1/2022,PAN,Kedah,0,0,0,Panama
50542,6/1/2022,PAN,Perak,0,0,0,Panama
50543,6/1/2022,PAN,Perlis,0,0,0,Panama
50544,6/1/2022,PAN,Pulau Pinang,0,0,0,Panama
50545,6/1/2022,PAN,Sabah,0,0,0,Panama
50546,6/1/2022,PAN,Sarawak,0,0,0,Panama
50547,6/1/2022,PAN,Selangor,6,1,5,Panama
50548,6/1/2022,PER,Johor,14,6,8,Peru
50549,6/1/2022,PER,Kedah,1,1,0,Peru
50550,6/1/2022,PER,Kelantan,0,0,0,Peru
50551,6/1/2022,PER,Pahang,0,0,0,Peru
50552,6/1/2022,PER,Perak,0,0,0,Peru
50553,6/1/2022,PER,Perlis,0,0,0,Peru
50554,6/1/2022,PER,Pulau Pinang,6,3,3,Peru
50555,6/1/2022,PER,Sabah,0,0,0,Peru
50556,6/1/2022,PER,Sarawak,0,0,0,Peru
50557,6/1/2022,PER,Selangor,30,19,11,Peru
50558,6/1/2022,PER,W.P. Labuan,0,0,0,Peru
50559,6/1/2022,PHL,Johor,9956,3030,6926,Philippines
50560,6/1/2022,PHL,Kedah,193,49,144,Philippines
50561,6/1/2022,PHL,Kelantan,7,5,2,Philippines
50562,6/1/2022,PHL,Melaka,0,0,0,Philippines
50563,6/1/2022,PHL,Negeri Sembilan,0,0,0,Philippines
50564,6/1/2022,PHL,Pahang,1,1,0,Philippines
50565,6/1/2022,PHL,Perak,34,8,26,Philippines
50566,6/1/2022,PHL,Perlis,42,21,21,Philippines
50567,6/1/2022,PHL,Pulau Pinang,261,113,148,Philippines
50568,6/1/2022,PHL,Sabah,344,109,235,Philippines
50569,6/1/2022,PHL,Sarawak,117,57,60,Philippines
50570,6/1/2022,PHL,Selangor,7501,3134,4367,Philippines
50571,6/1/2022,PHL,Terengganu,1,1,0,Philippines
50572,6/1/2022,PHL,W.P. Labuan,4,3,1,Philippines
50573,6/1/2022,PLW,Johor,0,0,0,Palau
50574,6/1/2022,PLW,Pulau Pinang,0,0,0,Palau
50575,6/1/2022,PLW,Selangor,0,0,0,Palau
50576,6/1/2022,PNG,Johor,11,6,5,Papua New Guinea
50577,6/1/2022,PNG,Kedah,0,0,0,Papua New Guinea
50578,6/1/2022,PNG,Kelantan,0,0,0,Papua New Guinea
50579,6/1/2022,PNG,Perak,0,0,0,Papua New Guinea
50580,6/1/2022,PNG,Pulau Pinang,4,2,2,Papua New Guinea
50581,6/1/2022,PNG,Sabah,0,0,0,Papua New Guinea
50582,6/1/2022,PNG,Sarawak,0,0,0,Papua New Guinea
50583,6/1/2022,PNG,Selangor,45,23,22,Papua New Guinea
50584,6/1/2022,POL,Johor,130,78,52,Poland
50585,6/1/2022,POL,Kedah,9,4,5,Poland
50586,6/1/2022,POL,Kelantan,1,1,0,Poland
50587,6/1/2022,POL,Melaka,0,0,0,Poland
50588,6/1/2022,POL,Negeri Sembilan,0,0,0,Poland
50589,6/1/2022,POL,Pahang,0,0,0,Poland
50590,6/1/2022,POL,Perak,0,0,0,Poland
50591,6/1/2022,POL,Perlis,5,2,3,Poland
50592,6/1/2022,POL,Pulau Pinang,10,5,5,Poland
50593,6/1/2022,POL,Sabah,17,6,11,Poland
50594,6/1/2022,POL,Sarawak,1,1,0,Poland
50595,6/1/2022,POL,Selangor,457,261,196,Poland
50596,6/1/2022,POL,Terengganu,0,0,0,Poland
50597,6/1/2022,POL,W.P. Labuan,0,0,0,Poland
50598,6/1/2022,PRK,Selangor,0,0,0,"Korea, Democratic People's Republic of"
50599,6/1/2022,PRT,Johor,77,44,33,Portugal
50600,6/1/2022,PRT,Kedah,13,8,5,Portugal
50601,6/1/2022,PRT,Kelantan,0,0,0,Portugal
50602,6/1/2022,PRT,Melaka,0,0,0,Portugal
50603,6/1/2022,PRT,Pahang,0,0,0,Portugal
50604,6/1/2022,PRT,Perak,0,0,0,Portugal
50605,6/1/2022,PRT,Perlis,3,3,0,Portugal
50606,6/1/2022,PRT,Pulau Pinang,24,15,9,Portugal
50607,6/1/2022,PRT,Sabah,2,1,1,Portugal
50608,6/1/2022,PRT,Sarawak,1,1,0,Portugal
50609,6/1/2022,PRT,Selangor,440,278,162,Portugal
50610,6/1/2022,PRT,W.P. Labuan,0,0,0,Portugal
50611,6/1/2022,PRY,Johor,3,3,0,Paraguay
50612,6/1/2022,PRY,Kedah,0,0,0,Paraguay
50613,6/1/2022,PRY,Perak,0,0,0,Paraguay
50614,6/1/2022,PRY,Perlis,0,0,0,Paraguay
50615,6/1/2022,PRY,Pulau Pinang,0,0,0,Paraguay
50616,6/1/2022,PRY,Sabah,0,0,0,Paraguay
50617,6/1/2022,PRY,Sarawak,0,0,0,Paraguay
50618,6/1/2022,PRY,Selangor,0,0,0,Paraguay
50619,6/1/2022,PSE,Johor,11,6,5,"Palestinian Territory, Occupied"
50620,6/1/2022,PSE,Kedah,0,0,0,"Palestinian Territory, Occupied"
50621,6/1/2022,PSE,Kelantan,0,0,0,"Palestinian Territory, Occupied"
50622,6/1/2022,PSE,Melaka,0,0,0,"Palestinian Territory, Occupied"
50623,6/1/2022,PSE,Perak,0,0,0,"Palestinian Territory, Occupied"
50624,6/1/2022,PSE,Perlis,0,0,0,"Palestinian Territory, Occupied"
50625,6/1/2022,PSE,Pulau Pinang,0,0,0,"Palestinian Territory, Occupied"
50626,6/1/2022,PSE,Sabah,0,0,0,"Palestinian Territory, Occupied"
50627,6/1/2022,PSE,Sarawak,0,0,0,"Palestinian Territory, Occupied"
50628,6/1/2022,PSE,Selangor,219,134,85,"Palestinian Territory, Occupied"
50629,6/1/2022,QAT,Johor,18,8,10,Qatar
50630,6/1/2022,QAT,Kedah,0,0,0,Qatar
50631,6/1/2022,QAT,Perlis,0,0,0,Qatar
50632,6/1/2022,QAT,Pulau Pinang,0,0,0,Qatar
50633,6/1/2022,QAT,Sabah,0,0,0,Qatar
50634,6/1/2022,QAT,Sarawak,0,0,0,Qatar
50635,6/1/2022,QAT,Selangor,250,163,87,Qatar
50636,6/1/2022,REU,Johor,0,0,0,Reunion
50637,6/1/2022,REU,Sarawak,0,0,0,Reunion
50638,6/1/2022,ROU,Johor,78,50,28,Romania
50639,6/1/2022,ROU,Kedah,2,2,0,Romania
50640,6/1/2022,ROU,Kelantan,0,0,0,Romania
50641,6/1/2022,ROU,Negeri Sembilan,0,0,0,Romania
50642,6/1/2022,ROU,Pahang,0,0,0,Romania
50643,6/1/2022,ROU,Perak,0,0,0,Romania
50644,6/1/2022,ROU,Perlis,0,0,0,Romania
50645,6/1/2022,ROU,Pulau Pinang,8,5,3,Romania
50646,6/1/2022,ROU,Sabah,8,5,3,Romania
50647,6/1/2022,ROU,Sarawak,4,4,0,Romania
50648,6/1/2022,ROU,Selangor,197,112,85,Romania
50649,6/1/2022,ROU,W.P. Labuan,0,0,0,Romania
50650,6/1/2022,RUS,Johor,178,101,77,Russia
50651,6/1/2022,RUS,Kedah,48,22,26,Russia
50652,6/1/2022,RUS,Kelantan,3,0,3,Russia
50653,6/1/2022,RUS,Melaka,0,0,0,Russia
50654,6/1/2022,RUS,Negeri Sembilan,0,0,0,Russia
50655,6/1/2022,RUS,Pahang,0,0,0,Russia
50656,6/1/2022,RUS,Perak,0,0,0,Russia
50657,6/1/2022,RUS,Perlis,14,9,5,Russia
50658,6/1/2022,RUS,Pulau Pinang,18,10,8,Russia
50659,6/1/2022,RUS,Sabah,6,3,3,Russia
50660,6/1/2022,RUS,Sarawak,8,3,5,Russia
50661,6/1/2022,RUS,Selangor,1167,641,526,Russia
50662,6/1/2022,RUS,W.P. Labuan,0,0,0,Russia
50663,6/1/2022,RWA,Johor,1,1,0,Rwanda
50664,6/1/2022,RWA,Kedah,0,0,0,Rwanda
50665,6/1/2022,RWA,Pulau Pinang,0,0,0,Rwanda
50666,6/1/2022,RWA,Selangor,1,1,0,Rwanda
50667,6/1/2022,SAU,Johor,64,44,20,Saudi Arabia
50668,6/1/2022,SAU,Kedah,6,3,3,Saudi Arabia
50669,6/1/2022,SAU,Kelantan,0,0,0,Saudi Arabia
50670,6/1/2022,SAU,Melaka,0,0,0,Saudi Arabia
50671,6/1/2022,SAU,Perak,0,0,0,Saudi Arabia
50672,6/1/2022,SAU,Perlis,0,0,0,Saudi Arabia
50673,6/1/2022,SAU,Pulau Pinang,9,3,6,Saudi Arabia
50674,6/1/2022,SAU,Sabah,0,0,0,Saudi Arabia
50675,6/1/2022,SAU,Sarawak,0,0,0,Saudi Arabia
50676,6/1/2022,SAU,Selangor,4293,2370,1923,Saudi Arabia
50677,6/1/2022,SAU,W.P. Labuan,0,0,0,Saudi Arabia
50678,6/1/2022,SDN,Johor,9,5,4,Sudan
50679,6/1/2022,SDN,Kedah,0,0,0,Sudan
50680,6/1/2022,SDN,Kelantan,0,0,0,Sudan
50681,6/1/2022,SDN,Perlis,0,0,0,Sudan
50682,6/1/2022,SDN,Pulau Pinang,0,0,0,Sudan
50683,6/1/2022,SDN,Sabah,0,0,0,Sudan
50684,6/1/2022,SDN,Sarawak,0,0,0,Sudan
50685,6/1/2022,SDN,Selangor,625,351,274,Sudan
50686,6/1/2022,SDN,W.P. Labuan,0,0,0,Sudan
50687,6/1/2022,SEN,Johor,2,2,0,Senegal
50688,6/1/2022,SEN,Kedah,2,0,2,Senegal
50689,6/1/2022,SEN,Kelantan,0,0,0,Senegal
50690,6/1/2022,SEN,Perak,0,0,0,Senegal
50691,6/1/2022,SEN,Perlis,0,0,0,Senegal
50692,6/1/2022,SEN,Pulau Pinang,0,0,0,Senegal
50693,6/1/2022,SEN,Sabah,0,0,0,Senegal
50694,6/1/2022,SEN,Sarawak,0,0,0,Senegal
50695,6/1/2022,SEN,Selangor,14,12,2,Senegal
50696,6/1/2022,SGP,Johor,795093,471150,323943,Singapore
50697,6/1/2022,SGP,Kedah,2739,1354,1385,Singapore
50698,6/1/2022,SGP,Kelantan,16,13,3,Singapore
50699,6/1/2022,SGP,Melaka,20,15,5,Singapore
50700,6/1/2022,SGP,Negeri Sembilan,2,0,2,Singapore
50701,6/1/2022,SGP,Pahang,20,15,5,Singapore
50702,6/1/2022,SGP,Perak,3887,1893,1994,Singapore
50703,6/1/2022,SGP,Perlis,44,33,11,Singapore
50704,6/1/2022,SGP,Pulau Pinang,14417,7398,7019,Singapore
50705,6/1/2022,SGP,Sabah,2986,1503,1483,Singapore
50706,6/1/2022,SGP,Sarawak,2856,1515,1341,Singapore
50707,6/1/2022,SGP,Selangor,29204,15654,13550,Singapore
50708,6/1/2022,SGP,Terengganu,1,1,0,Singapore
50709,6/1/2022,SGP,W.P. Labuan,0,0,0,Singapore
50710,6/1/2022,SGS,Johor,0,0,0,South Georgia and the South Sandwich Islands
50711,6/1/2022,SGS,Sabah,0,0,0,South Georgia and the South Sandwich Islands
50712,6/1/2022,SGS,Selangor,2,2,0,South Georgia and the South Sandwich Islands
50713,6/1/2022,SHN,Sarawak,0,0,0,"Saint Helena, Ascension and Tristan da Cunha"
50714,6/1/2022,SLB,Johor,3,3,0,Solomon Islands
50715,6/1/2022,SLB,Perlis,0,0,0,Solomon Islands
50716,6/1/2022,SLB,Pulau Pinang,0,0,0,Solomon Islands
50717,6/1/2022,SLB,Sabah,0,0,0,Solomon Islands
50718,6/1/2022,SLB,Sarawak,1,0,1,Solomon Islands
50719,6/1/2022,SLB,Selangor,2,2,0,Solomon Islands
50720,6/1/2022,SLB,W.P. Labuan,0,0,0,Solomon Islands
50721,6/1/2022,SLE,Johor,1,1,0,Sierra Leone
50722,6/1/2022,SLE,Kedah,0,0,0,Sierra Leone
50723,6/1/2022,SLE,Perak,0,0,0,Sierra Leone
50724,6/1/2022,SLE,Pulau Pinang,0,0,0,Sierra Leone
50725,6/1/2022,SLE,Sabah,0,0,0,Sierra Leone
50726,6/1/2022,SLE,Selangor,14,9,5,Sierra Leone
50727,6/1/2022,SLV,Johor,0,0,0,El Salvador
50728,6/1/2022,SLV,Kedah,0,0,0,El Salvador
50729,6/1/2022,SLV,Perak,0,0,0,El Salvador
50730,6/1/2022,SLV,Perlis,0,0,0,El Salvador
50731,6/1/2022,SLV,Pulau Pinang,0,0,0,El Salvador
50732,6/1/2022,SLV,Sabah,0,0,0,El Salvador
50733,6/1/2022,SLV,Selangor,5,3,2,El Salvador
50734,6/1/2022,SLV,W.P. Labuan,0,0,0,El Salvador
50735,6/1/2022,SMR,Johor,0,0,0,San Marino
50736,6/1/2022,SMR,Selangor,0,0,0,San Marino
50737,6/1/2022,SOM,Johor,0,0,0,Somalia
50738,6/1/2022,SOM,Kedah,0,0,0,Somalia
50739,6/1/2022,SOM,Kelantan,0,0,0,Somalia
50740,6/1/2022,SOM,Perlis,0,0,0,Somalia
50741,6/1/2022,SOM,Sabah,0,0,0,Somalia
50742,6/1/2022,SOM,Sarawak,0,0,0,Somalia
50743,6/1/2022,SOM,Selangor,138,81,57,Somalia
50744,6/1/2022,SRB,Johor,5,5,0,Serbia
50745,6/1/2022,SRB,Kedah,0,0,0,Serbia
50746,6/1/2022,SRB,Kelantan,0,0,0,Serbia
50747,6/1/2022,SRB,Pahang,0,0,0,Serbia
50748,6/1/2022,SRB,Perak,0,0,0,Serbia
50749,6/1/2022,SRB,Perlis,1,0,1,Serbia
50750,6/1/2022,SRB,Pulau Pinang,0,0,0,Serbia
50751,6/1/2022,SRB,Sabah,0,0,0,Serbia
50752,6/1/2022,SRB,Sarawak,0,0,0,Serbia
50753,6/1/2022,SRB,Selangor,25,15,10,Serbia
50754,6/1/2022,STP,Selangor,0,0,0,Sao Tome and Principe
50755,6/1/2022,SUR,Johor,0,0,0,Suriname
50756,6/1/2022,SUR,Kedah,0,0,0,Suriname
50757,6/1/2022,SUR,Kelantan,0,0,0,Suriname
50758,6/1/2022,SUR,Perak,0,0,0,Suriname
50759,6/1/2022,SUR,Perlis,0,0,0,Suriname
50760,6/1/2022,SUR,Pulau Pinang,0,0,0,Suriname
50761,6/1/2022,SUR,Sabah,0,0,0,Suriname
50762,6/1/2022,SUR,Sarawak,0,0,0,Suriname
50763,6/1/2022,SUR,Selangor,5,4,1,Suriname
50764,6/1/2022,SVK,Johor,16,8,8,Slovakia
50765,6/1/2022,SVK,Kedah,1,1,0,Slovakia
50766,6/1/2022,SVK,Kelantan,0,0,0,Slovakia
50767,6/1/2022,SVK,Negeri Sembilan,0,0,0,Slovakia
50768,6/1/2022,SVK,Pahang,0,0,0,Slovakia
50769,6/1/2022,SVK,Perak,0,0,0,Slovakia
50770,6/1/2022,SVK,Perlis,0,0,0,Slovakia
50771,6/1/2022,SVK,Pulau Pinang,1,1,0,Slovakia
50772,6/1/2022,SVK,Sabah,1,1,0,Slovakia
50773,6/1/2022,SVK,Sarawak,0,0,0,Slovakia
50774,6/1/2022,SVK,Selangor,109,45,64,Slovakia
50775,6/1/2022,SVK,W.P. Labuan,0,0,0,Slovakia
50776,6/1/2022,SVN,Johor,3,0,3,Slovenia
50777,6/1/2022,SVN,Kedah,0,0,0,Slovenia
50778,6/1/2022,SVN,Kelantan,0,0,0,Slovenia
50779,6/1/2022,SVN,Perak,0,0,0,Slovenia
50780,6/1/2022,SVN,Perlis,0,0,0,Slovenia
50781,6/1/2022,SVN,Pulau Pinang,0,0,0,Slovenia
50782,6/1/2022,SVN,Sabah,0,0,0,Slovenia
50783,6/1/2022,SVN,Sarawak,1,1,0,Slovenia
50784,6/1/2022,SVN,Selangor,30,20,10,Slovenia
50785,6/1/2022,SVN,W.P. Labuan,0,0,0,Slovenia
50786,6/1/2022,SWE,Johor,145,107,38,Sweden
50787,6/1/2022,SWE,Kedah,7,6,1,Sweden
50788,6/1/2022,SWE,Kelantan,3,2,1,Sweden
50789,6/1/2022,SWE,Melaka,0,0,0,Sweden
50790,6/1/2022,SWE,Negeri Sembilan,0,0,0,Sweden
50791,6/1/2022,SWE,Pahang,0,0,0,Sweden
50792,6/1/2022,SWE,Perak,4,2,2,Sweden
50793,6/1/2022,SWE,Perlis,6,5,1,Sweden
50794,6/1/2022,SWE,Pulau Pinang,37,20,17,Sweden
50795,6/1/2022,SWE,Sabah,22,11,11,Sweden
50796,6/1/2022,SWE,Sarawak,8,5,3,Sweden
50797,6/1/2022,SWE,Selangor,495,324,171,Sweden
50798,6/1/2022,SWE,W.P. Labuan,0,0,0,Sweden
50799,6/1/2022,SWZ,Johor,0,0,0,Swaziland
50800,6/1/2022,SWZ,Kedah,0,0,0,Swaziland
50801,6/1/2022,SWZ,Pulau Pinang,0,0,0,Swaziland
50802,6/1/2022,SWZ,Sabah,0,0,0,Swaziland
50803,6/1/2022,SWZ,Selangor,9,6,3,Swaziland
50804,6/1/2022,SYC,Johor,3,3,0,Seychelles
50805,6/1/2022,SYC,Kedah,0,0,0,Seychelles
50806,6/1/2022,SYC,Pulau Pinang,0,0,0,Seychelles
50807,6/1/2022,SYC,Sabah,0,0,0,Seychelles
50808,6/1/2022,SYC,Sarawak,0,0,0,Seychelles
50809,6/1/2022,SYC,Selangor,30,11,19,Seychelles
50810,6/1/2022,SYR,Johor,6,2,4,Syrian Arab Republic
50811,6/1/2022,SYR,Kedah,1,1,0,Syrian Arab Republic
50812,6/1/2022,SYR,Kelantan,0,0,0,Syrian Arab Republic
50813,6/1/2022,SYR,Pahang,0,0,0,Syrian Arab Republic
50814,6/1/2022,SYR,Perlis,0,0,0,Syrian Arab Republic
50815,6/1/2022,SYR,Pulau Pinang,0,0,0,Syrian Arab Republic
50816,6/1/2022,SYR,Sabah,0,0,0,Syrian Arab Republic
50817,6/1/2022,SYR,Sarawak,0,0,0,Syrian Arab Republic
50818,6/1/2022,SYR,Selangor,464,278,186,Syrian Arab Republic
50819,6/1/2022,SYR,W.P. Labuan,0,0,0,Syrian Arab Republic
50820,6/1/2022,TCA,Perlis,0,0,0,Turks and Caicos
50821,6/1/2022,TCD,Johor,1,1,0,Chad
50822,6/1/2022,TCD,Kedah,0,0,0,Chad
50823,6/1/2022,TCD,Perlis,0,0,0,Chad
50824,6/1/2022,TCD,Selangor,10,7,3,Chad
50825,6/1/2022,TGO,Johor,0,0,0,Togo
50826,6/1/2022,TGO,Perak,0,0,0,Togo
50827,6/1/2022,TGO,Pulau Pinang,0,0,0,Togo
50828,6/1/2022,TGO,Selangor,1,0,1,Togo
50829,6/1/2022,THA,Johor,2429,510,1919,Thailand
50830,6/1/2022,THA,Kedah,36092,24203,11889,Thailand
50831,6/1/2022,THA,Kelantan,8681,3840,4841,Thailand
50832,6/1/2022,THA,Melaka,3,1,2,Thailand
50833,6/1/2022,THA,Negeri Sembilan,0,0,0,Thailand
50834,6/1/2022,THA,Pahang,3,3,0,Thailand
50835,6/1/2022,THA,Perak,3068,1365,1703,Thailand
50836,6/1/2022,THA,Perlis,40471,25967,14504,Thailand
50837,6/1/2022,THA,Pulau Pinang,1079,432,647,Thailand
50838,6/1/2022,THA,Sabah,17,9,8,Thailand
50839,6/1/2022,THA,Sarawak,29,20,9,Thailand
50840,6/1/2022,THA,Selangor,5756,2333,3423,Thailand
50841,6/1/2022,THA,Terengganu,0,0,0,Thailand
50842,6/1/2022,THA,W.P. Labuan,0,0,0,Thailand
50843,6/1/2022,TJK,Johor,2,2,0,Tajikistan
50844,6/1/2022,TJK,Kedah,0,0,0,Tajikistan
50845,6/1/2022,TJK,Perlis,0,0,0,Tajikistan
50846,6/1/2022,TJK,Pulau Pinang,0,0,0,Tajikistan
50847,6/1/2022,TJK,Sabah,0,0,0,Tajikistan
50848,6/1/2022,TJK,Selangor,38,28,10,Tajikistan
50849,6/1/2022,TKL,Selangor,0,0,0,Tokelau
50850,6/1/2022,TKM,Johor,0,0,0,Turkmenistan
50851,6/1/2022,TKM,Kedah,0,0,0,Turkmenistan
50852,6/1/2022,TKM,Kelantan,0,0,0,Turkmenistan
50853,6/1/2022,TKM,Perlis,0,0,0,Turkmenistan
50854,6/1/2022,TKM,Pulau Pinang,0,0,0,Turkmenistan
50855,6/1/2022,TKM,Sabah,0,0,0,Turkmenistan
50856,6/1/2022,TKM,Sarawak,0,0,0,Turkmenistan
50857,6/1/2022,TKM,Selangor,49,40,9,Turkmenistan
50858,6/1/2022,TLS,Johor,1,1,0,Timor-Leste
50859,6/1/2022,TLS,Kedah,0,0,0,Timor-Leste
50860,6/1/2022,TLS,Perlis,0,0,0,Timor-Leste
50861,6/1/2022,TLS,Pulau Pinang,3,2,1,Timor-Leste
50862,6/1/2022,TLS,Sabah,0,0,0,Timor-Leste
50863,6/1/2022,TLS,Sarawak,3,1,2,Timor-Leste
50864,6/1/2022,TLS,Selangor,234,152,82,Timor-Leste
50865,6/1/2022,TON,Johor,0,0,0,Tonga
50866,6/1/2022,TON,Pulau Pinang,0,0,0,Tonga
50867,6/1/2022,TON,Sarawak,0,0,0,Tonga
50868,6/1/2022,TON,Selangor,0,0,0,Tonga
50869,6/1/2022,TTO,Johor,1,0,1,Trinidad and Tobago
50870,6/1/2022,TTO,Kedah,0,0,0,Trinidad and Tobago
50871,6/1/2022,TTO,Pahang,0,0,0,Trinidad and Tobago
50872,6/1/2022,TTO,Pulau Pinang,0,0,0,Trinidad and Tobago
50873,6/1/2022,TTO,Sabah,0,0,0,Trinidad and Tobago
50874,6/1/2022,TTO,Sarawak,1,0,1,Trinidad and Tobago
50875,6/1/2022,TTO,Selangor,5,5,0,Trinidad and Tobago
50876,6/1/2022,TUN,Johor,1,1,0,Tunisia
50877,6/1/2022,TUN,Kedah,6,4,2,Tunisia
50878,6/1/2022,TUN,Kelantan,0,0,0,Tunisia
50879,6/1/2022,TUN,Melaka,1,0,1,Tunisia
50880,6/1/2022,TUN,Perak,0,0,0,Tunisia
50881,6/1/2022,TUN,Perlis,0,0,0,Tunisia
50882,6/1/2022,TUN,Pulau Pinang,2,2,0,Tunisia
50883,6/1/2022,TUN,Sabah,0,0,0,Tunisia
50884,6/1/2022,TUN,Sarawak,0,0,0,Tunisia
50885,6/1/2022,TUN,Selangor,199,95,104,Tunisia
50886,6/1/2022,TUN,W.P. Labuan,0,0,0,Tunisia
50887,6/1/2022,TUR,Johor,123,93,30,Turkey
50888,6/1/2022,TUR,Kedah,20,8,12,Turkey
50889,6/1/2022,TUR,Kelantan,0,0,0,Turkey
50890,6/1/2022,TUR,Melaka,0,0,0,Turkey
50891,6/1/2022,TUR,Negeri Sembilan,0,0,0,Turkey
50892,6/1/2022,TUR,Pahang,0,0,0,Turkey
50893,6/1/2022,TUR,Perak,2,2,0,Turkey
50894,6/1/2022,TUR,Perlis,7,4,3,Turkey
50895,6/1/2022,TUR,Pulau Pinang,5,3,2,Turkey
50896,6/1/2022,TUR,Sabah,1,1,0,Turkey
50897,6/1/2022,TUR,Sarawak,0,0,0,Turkey
50898,6/1/2022,TUR,Selangor,527,382,145,Turkey
50899,6/1/2022,TUR,W.P. Labuan,0,0,0,Turkey
50900,6/1/2022,TUV,Selangor,0,0,0,Tuvalu
50901,6/1/2022,TWN,Johor,1973,779,1194,Taiwan
50902,6/1/2022,TWN,Kedah,38,19,19,Taiwan
50903,6/1/2022,TWN,Kelantan,0,0,0,Taiwan
50904,6/1/2022,TWN,Melaka,0,0,0,Taiwan
50905,6/1/2022,TWN,Negeri Sembilan,0,0,0,Taiwan
50906,6/1/2022,TWN,Pahang,3,3,0,Taiwan
50907,6/1/2022,TWN,Perak,7,2,5,Taiwan
50908,6/1/2022,TWN,Perlis,2,2,0,Taiwan
50909,6/1/2022,TWN,Pulau Pinang,368,214,154,Taiwan
50910,6/1/2022,TWN,Sabah,54,18,36,Taiwan
50911,6/1/2022,TWN,Sarawak,48,23,25,Taiwan
50912,6/1/2022,TWN,Selangor,1306,745,561,Taiwan
50913,6/1/2022,TWN,W.P. Labuan,0,0,0,Taiwan
50914,6/1/2022,TZA,Johor,6,1,5,"Tanzania, United Republic of"
50915,6/1/2022,TZA,Kedah,0,0,0,"Tanzania, United Republic of"
50916,6/1/2022,TZA,Perak,0,0,0,"Tanzania, United Republic of"
50917,6/1/2022,TZA,Perlis,0,0,0,"Tanzania, United Republic of"
50918,6/1/2022,TZA,Pulau Pinang,0,0,0,"Tanzania, United Republic of"
50919,6/1/2022,TZA,Sabah,0,0,0,"Tanzania, United Republic of"
50920,6/1/2022,TZA,Sarawak,0,0,0,"Tanzania, United Republic of"
50921,6/1/2022,TZA,Selangor,69,33,36,"Tanzania, United Republic of"
50922,6/1/2022,UGA,Johor,1,1,0,Uganda
50923,6/1/2022,UGA,Kedah,0,0,0,Uganda
50924,6/1/2022,UGA,Perak,0,0,0,Uganda
50925,6/1/2022,UGA,Perlis,0,0,0,Uganda
50926,6/1/2022,UGA,Pulau Pinang,1,0,1,Uganda
50927,6/1/2022,UGA,Sabah,0,0,0,Uganda
50928,6/1/2022,UGA,Sarawak,0,0,0,Uganda
50929,6/1/2022,UGA,Selangor,39,20,19,Uganda
50930,6/1/2022,UKR,Johor,62,36,26,Ukraine
50931,6/1/2022,UKR,Kedah,8,4,4,Ukraine
50932,6/1/2022,UKR,Kelantan,0,0,0,Ukraine
50933,6/1/2022,UKR,Melaka,0,0,0,Ukraine
50934,6/1/2022,UKR,Negeri Sembilan,0,0,0,Ukraine
50935,6/1/2022,UKR,Pahang,0,0,0,Ukraine
50936,6/1/2022,UKR,Perak,0,0,0,Ukraine
50937,6/1/2022,UKR,Perlis,1,1,0,Ukraine
50938,6/1/2022,UKR,Pulau Pinang,3,1,2,Ukraine
50939,6/1/2022,UKR,Sabah,5,0,5,Ukraine
50940,6/1/2022,UKR,Sarawak,0,0,0,Ukraine
50941,6/1/2022,UKR,Selangor,295,162,133,Ukraine
50942,6/1/2022,UKR,W.P. Labuan,0,0,0,Ukraine
50943,6/1/2022,URY,Johor,8,3,5,Uruguay
50944,6/1/2022,URY,Kedah,0,0,0,Uruguay
50945,6/1/2022,URY,Kelantan,0,0,0,Uruguay
50946,6/1/2022,URY,Perak,0,0,0,Uruguay
50947,6/1/2022,URY,Perlis,0,0,0,Uruguay
50948,6/1/2022,URY,Pulau Pinang,0,0,0,Uruguay
50949,6/1/2022,URY,Sabah,0,0,0,Uruguay
50950,6/1/2022,URY,Sarawak,0,0,0,Uruguay
50951,6/1/2022,URY,Selangor,13,8,5,Uruguay
50952,6/1/2022,URY,W.P. Labuan,0,0,0,Uruguay
50953,6/1/2022,USA,Johor,2673,1645,1028,United States Of America
50954,6/1/2022,USA,Kedah,175,86,89,United States Of America
50955,6/1/2022,USA,Kelantan,4,2,2,United States Of America
50956,6/1/2022,USA,Melaka,3,3,0,United States Of America
50957,6/1/2022,USA,Negeri Sembilan,0,0,0,United States Of America
50958,6/1/2022,USA,Pahang,3,3,0,United States Of America
50959,6/1/2022,USA,Perak,42,24,18,United States Of America
50960,6/1/2022,USA,Perlis,25,16,9,United States Of America
50961,6/1/2022,USA,Pulau Pinang,1072,686,386,United States Of America
50962,6/1/2022,USA,Sabah,179,95,84,United States Of America
50963,6/1/2022,USA,Sarawak,87,52,35,United States Of America
50964,6/1/2022,USA,Selangor,8380,4950,3430,United States Of America
50965,6/1/2022,USA,Terengganu,0,0,0,United States Of America
50966,6/1/2022,USA,W.P. Labuan,0,0,0,United States Of America
50967,6/1/2022,UZB,Johor,25,13,12,Uzbekistan
50968,6/1/2022,UZB,Kedah,0,0,0,Uzbekistan
50969,6/1/2022,UZB,Kelantan,0,0,0,Uzbekistan
50970,6/1/2022,UZB,Perak,0,0,0,Uzbekistan
50971,6/1/2022,UZB,Perlis,3,0,3,Uzbekistan
50972,6/1/2022,UZB,Pulau Pinang,0,0,0,Uzbekistan
50973,6/1/2022,UZB,Sabah,0,0,0,Uzbekistan
50974,6/1/2022,UZB,Sarawak,0,0,0,Uzbekistan
50975,6/1/2022,UZB,Selangor,214,93,121,Uzbekistan
50976,6/1/2022,VAT,Johor,1,1,0,Holy See (Vatican City State)
50977,6/1/2022,VAT,Sarawak,0,0,0,Holy See (Vatican City State)
50978,6/1/2022,VAT,Selangor,0,0,0,Holy See (Vatican City State)
50979,6/1/2022,VCT,Johor,0,0,0,Saint Vincent and the Grenadines
50980,6/1/2022,VCT,Kedah,0,0,0,Saint Vincent and the Grenadines
50981,6/1/2022,VCT,Pulau Pinang,0,0,0,Saint Vincent and the Grenadines
50982,6/1/2022,VCT,Sarawak,0,0,0,Saint Vincent and the Grenadines
50983,6/1/2022,VCT,Selangor,0,0,0,Saint Vincent and the Grenadines
50984,6/1/2022,VEN,Johor,7,5,2,Venezuela
50985,6/1/2022,VEN,Kedah,1,1,0,Venezuela
50986,6/1/2022,VEN,Kelantan,0,0,0,Venezuela
50987,6/1/2022,VEN,Melaka,0,0,0,Venezuela
50988,6/1/2022,VEN,Perak,0,0,0,Venezuela
50989,6/1/2022,VEN,Perlis,0,0,0,Venezuela
50990,6/1/2022,VEN,Pulau Pinang,0,0,0,Venezuela
50991,6/1/2022,VEN,Sabah,0,0,0,Venezuela
50992,6/1/2022,VEN,Sarawak,0,0,0,Venezuela
50993,6/1/2022,VEN,Selangor,36,25,11,Venezuela
50994,6/1/2022,VEN,W.P. Labuan,0,0,0,Venezuela
50995,6/1/2022,VNM,Johor,9803,3265,6538,Vietnam
50996,6/1/2022,VNM,Kedah,198,30,168,Vietnam
50997,6/1/2022,VNM,Kelantan,6,6,0,Vietnam
50998,6/1/2022,VNM,Melaka,0,0,0,Vietnam
50999,6/1/2022,VNM,Negeri Sembilan,0,0,0,Vietnam
51000,6/1/2022,VNM,Pahang,0,0,0,Vietnam
51001,6/1/2022,VNM,Perak,44,9,35,Vietnam
51002,6/1/2022,VNM,Perlis,6,4,2,Vietnam
51003,6/1/2022,VNM,Pulau Pinang,685,150,535,Vietnam
51004,6/1/2022,VNM,Sabah,18,7,11,Vietnam
51005,6/1/2022,VNM,Sarawak,27,4,23,Vietnam
51006,6/1/2022,VNM,Selangor,10157,3087,7070,Vietnam
51007,6/1/2022,VNM,Terengganu,0,0,0,Vietnam
51008,6/1/2022,VNM,W.P. Labuan,0,0,0,Vietnam
51009,6/1/2022,VUT,Johor,13,10,3,Vanuatu
51010,6/1/2022,VUT,Kedah,1,1,0,Vanuatu
51011,6/1/2022,VUT,Pulau Pinang,0,0,0,Vanuatu
51012,6/1/2022,VUT,Sabah,0,0,0,Vanuatu
51013,6/1/2022,VUT,Sarawak,0,0,0,Vanuatu
51014,6/1/2022,VUT,Selangor,25,22,3,Vanuatu
51015,6/1/2022,WSM,Johor,0,0,0,Samoa
51016,6/1/2022,WSM,Sarawak,0,0,0,Samoa
51017,6/1/2022,WSM,Selangor,1,0,1,Samoa
51018,6/1/2022,YEM,Johor,29,22,7,Yemen
51019,6/1/2022,YEM,Kedah,2,2,0,Yemen
51020,6/1/2022,YEM,Kelantan,0,0,0,Yemen
51021,6/1/2022,YEM,Melaka,0,0,0,Yemen
51022,6/1/2022,YEM,Pahang,0,0,0,Yemen
51023,6/1/2022,YEM,Perak,0,0,0,Yemen
51024,6/1/2022,YEM,Perlis,0,0,0,Yemen
51025,6/1/2022,YEM,Pulau Pinang,0,0,0,Yemen
51026,6/1/2022,YEM,Sabah,0,0,0,Yemen
51027,6/1/2022,YEM,Sarawak,0,0,0,Yemen
51028,6/1/2022,YEM,Selangor,1150,743,407,Yemen
51029,6/1/2022,YEM,W.P. Labuan,0,0,0,Yemen
51030,6/1/2022,ZAF,Johor,168,104,64,South Africa
51031,6/1/2022,ZAF,Kedah,17,8,9,South Africa
51032,6/1/2022,ZAF,Kelantan,2,1,1,South Africa
51033,6/1/2022,ZAF,Melaka,2,1,1,South Africa
51034,6/1/2022,ZAF,Pahang,0,0,0,South Africa
51035,6/1/2022,ZAF,Perak,1,1,0,South Africa
51036,6/1/2022,ZAF,Perlis,7,5,2,South Africa
51037,6/1/2022,ZAF,Pulau Pinang,19,13,6,South Africa
51038,6/1/2022,ZAF,Sabah,6,4,2,South Africa
51039,6/1/2022,ZAF,Sarawak,11,8,3,South Africa
51040,6/1/2022,ZAF,Selangor,514,295,219,South Africa
51041,6/1/2022,ZAF,Terengganu,0,0,0,South Africa
51042,6/1/2022,ZAF,W.P. Labuan,0,0,0,South Africa
51043,6/1/2022,ZMB,Johor,1,1,0,Zambia
51044,6/1/2022,ZMB,Kedah,0,0,0,Zambia
51045,6/1/2022,ZMB,Perak,0,0,0,Zambia
51046,6/1/2022,ZMB,Perlis,0,0,0,Zambia
51047,6/1/2022,ZMB,Pulau Pinang,0,0,0,Zambia
51048,6/1/2022,ZMB,Sabah,0,0,0,Zambia
51049,6/1/2022,ZMB,Sarawak,0,0,0,Zambia
51050,6/1/2022,ZMB,Selangor,37,20,17,Zambia
51051,6/1/2022,ZWE,Johor,3,2,1,Zimbabwe
51052,6/1/2022,ZWE,Kedah,0,0,0,Zimbabwe
51053,6/1/2022,ZWE,Kelantan,0,0,0,Zimbabwe
51054,6/1/2022,ZWE,Perak,0,0,0,Zimbabwe
51055,6/1/2022,ZWE,Perlis,0,0,0,Zimbabwe
51056,6/1/2022,ZWE,Pulau Pinang,2,0,2,Zimbabwe
51057,6/1/2022,ZWE,Sabah,0,0,0,Zimbabwe
51058,6/1/2022,ZWE,Sarawak,0,0,0,Zimbabwe
51059,6/1/2022,ZWE,Selangor,66,33,33,Zimbabwe
51060,7/1/2022,ABW,Kedah,0,0,0,Aruba
51061,7/1/2022,ABW,Pulau Pinang,0,0,0,Aruba
51062,7/1/2022,AFG,Johor,1,1,0,Afghanistan
51063,7/1/2022,AFG,Kedah,0,0,0,Afghanistan
51064,7/1/2022,AFG,Perlis,0,0,0,Afghanistan
51065,7/1/2022,AFG,Pulau Pinang,0,0,0,Afghanistan
51066,7/1/2022,AFG,Sarawak,1,1,0,Afghanistan
51067,7/1/2022,AFG,Selangor,61,42,19,Afghanistan
51068,7/1/2022,AGO,Johor,0,0,0,Angola
51069,7/1/2022,AGO,Kedah,0,0,0,Angola
51070,7/1/2022,AGO,Sabah,0,0,0,Angola
51071,7/1/2022,AGO,Selangor,1,0,1,Angola
51072,7/1/2022,AIA,Selangor,0,0,0,Anguilla
51073,7/1/2022,ALB,Johor,11,5,6,Albania
51074,7/1/2022,ALB,Kedah,0,0,0,Albania
51075,7/1/2022,ALB,Perak,0,0,0,Albania
51076,7/1/2022,ALB,Perlis,0,0,0,Albania
51077,7/1/2022,ALB,Pulau Pinang,2,2,0,Albania
51078,7/1/2022,ALB,Sabah,0,0,0,Albania
51079,7/1/2022,ALB,Sarawak,0,0,0,Albania
51080,7/1/2022,ALB,Selangor,20,13,7,Albania
51081,7/1/2022,AND,Johor,1,0,1,Andorra
51082,7/1/2022,AND,Kedah,1,1,0,Andorra
51083,7/1/2022,AND,Perlis,0,0,0,Andorra
51084,7/1/2022,AND,Pulau Pinang,0,0,0,Andorra
51085,7/1/2022,AND,Selangor,3,1,2,Andorra
51086,7/1/2022,ANT,Selangor,0,0,0,Netherlands Antilles
51087,7/1/2022,ARE,Johor,37,18,19,United Arab Emirates
51088,7/1/2022,ARE,Kedah,15,6,9,United Arab Emirates
51089,7/1/2022,ARE,Kelantan,0,0,0,United Arab Emirates
51090,7/1/2022,ARE,Perak,0,0,0,United Arab Emirates
51091,7/1/2022,ARE,Perlis,1,1,0,United Arab Emirates
51092,7/1/2022,ARE,Pulau Pinang,5,3,2,United Arab Emirates
51093,7/1/2022,ARE,Sabah,1,1,0,United Arab Emirates
51094,7/1/2022,ARE,Sarawak,2,2,0,United Arab Emirates
51095,7/1/2022,ARE,Selangor,650,340,310,United Arab Emirates
51096,7/1/2022,ARG,Johor,59,31,28,Argentina
51097,7/1/2022,ARG,Kedah,8,5,3,Argentina
51098,7/1/2022,ARG,Kelantan,0,0,0,Argentina
51099,7/1/2022,ARG,Melaka,0,0,0,Argentina
51100,7/1/2022,ARG,Perak,0,0,0,Argentina
51101,7/1/2022,ARG,Perlis,1,1,0,Argentina
51102,7/1/2022,ARG,Pulau Pinang,5,3,2,Argentina
51103,7/1/2022,ARG,Sabah,5,1,4,Argentina
51104,7/1/2022,ARG,Sarawak,3,0,3,Argentina
51105,7/1/2022,ARG,Selangor,201,123,78,Argentina
51106,7/1/2022,ARG,W.P. Labuan,0,0,0,Argentina
51107,7/1/2022,ARM,Johor,7,1,6,Armenia
51108,7/1/2022,ARM,Kedah,0,0,0,Armenia
51109,7/1/2022,ARM,Kelantan,0,0,0,Armenia
51110,7/1/2022,ARM,Perak,0,0,0,Armenia
51111,7/1/2022,ARM,Perlis,0,0,0,Armenia
51112,7/1/2022,ARM,Pulau Pinang,0,0,0,Armenia
51113,7/1/2022,ARM,Sabah,0,0,0,Armenia
51114,7/1/2022,ARM,Sarawak,0,0,0,Armenia
51115,7/1/2022,ARM,Selangor,25,16,9,Armenia
51116,7/1/2022,ATA,Selangor,0,0,0,Antarctica
51117,7/1/2022,ATG,Johor,0,0,0,Antigua and Barbuda
51118,7/1/2022,ATG,Kedah,0,0,0,Antigua and Barbuda
51119,7/1/2022,ATG,Pulau Pinang,0,0,0,Antigua and Barbuda
51120,7/1/2022,ATG,Sarawak,0,0,0,Antigua and Barbuda
51121,7/1/2022,ATG,Selangor,9,6,3,Antigua and Barbuda
51122,7/1/2022,AUS,Johor,3909,2355,1554,Australia
51123,7/1/2022,AUS,Kedah,386,212,174,Australia
51124,7/1/2022,AUS,Kelantan,3,2,1,Australia
51125,7/1/2022,AUS,Melaka,0,0,0,Australia
51126,7/1/2022,AUS,Negeri Sembilan,0,0,0,Australia
51127,7/1/2022,AUS,Pahang,3,3,0,Australia
51128,7/1/2022,AUS,Perak,203,114,89,Australia
51129,7/1/2022,AUS,Perlis,44,24,20,Australia
51130,7/1/2022,AUS,Pulau Pinang,1348,715,633,Australia
51131,7/1/2022,AUS,Sabah,387,220,167,Australia
51132,7/1/2022,AUS,Sarawak,384,214,170,Australia
51133,7/1/2022,AUS,Selangor,12143,7141,5002,Australia
51134,7/1/2022,AUS,Terengganu,0,0,0,Australia
51135,7/1/2022,AUS,W.P. Labuan,0,0,0,Australia
51136,7/1/2022,AUT,Johor,146,97,49,Austria
51137,7/1/2022,AUT,Kedah,17,12,5,Austria
51138,7/1/2022,AUT,Kelantan,1,1,0,Austria
51139,7/1/2022,AUT,Melaka,0,0,0,Austria
51140,7/1/2022,AUT,Negeri Sembilan,0,0,0,Austria
51141,7/1/2022,AUT,Pahang,0,0,0,Austria
51142,7/1/2022,AUT,Perak,4,4,0,Austria
51143,7/1/2022,AUT,Perlis,11,6,5,Austria
51144,7/1/2022,AUT,Pulau Pinang,48,36,12,Austria
51145,7/1/2022,AUT,Sabah,18,12,6,Austria
51146,7/1/2022,AUT,Sarawak,17,9,8,Austria
51147,7/1/2022,AUT,Selangor,677,413,264,Austria
51148,7/1/2022,AUT,Terengganu,0,0,0,Austria
51149,7/1/2022,AUT,W.P. Labuan,0,0,0,Austria
51150,7/1/2022,AZE,Johor,2,1,1,Azerbaijan
51151,7/1/2022,AZE,Kedah,1,1,0,Azerbaijan
51152,7/1/2022,AZE,Kelantan,0,0,0,Azerbaijan
51153,7/1/2022,AZE,Melaka,0,0,0,Azerbaijan
51154,7/1/2022,AZE,Perlis,0,0,0,Azerbaijan
51155,7/1/2022,AZE,Pulau Pinang,0,0,0,Azerbaijan
51156,7/1/2022,AZE,Sabah,0,0,0,Azerbaijan
51157,7/1/2022,AZE,Sarawak,0,0,0,Azerbaijan
51158,7/1/2022,AZE,Selangor,57,34,23,Azerbaijan
51159,7/1/2022,AZE,W.P. Labuan,0,0,0,Azerbaijan
51160,7/1/2022,BDI,Pulau Pinang,0,0,0,Burundi
51161,7/1/2022,BDI,Sarawak,0,0,0,Burundi
51162,7/1/2022,BDI,Selangor,2,1,1,Burundi
51163,7/1/2022,BEL,Johor,223,133,90,Belgium
51164,7/1/2022,BEL,Kedah,25,14,11,Belgium
51165,7/1/2022,BEL,Kelantan,2,0,2,Belgium
51166,7/1/2022,BEL,Melaka,0,0,0,Belgium
51167,7/1/2022,BEL,Negeri Sembilan,0,0,0,Belgium
51168,7/1/2022,BEL,Pahang,0,0,0,Belgium
51169,7/1/2022,BEL,Perak,8,5,3,Belgium
51170,7/1/2022,BEL,Perlis,2,2,0,Belgium
51171,7/1/2022,BEL,Pulau Pinang,59,36,23,Belgium
51172,7/1/2022,BEL,Sabah,42,23,19,Belgium
51173,7/1/2022,BEL,Sarawak,17,8,9,Belgium
51174,7/1/2022,BEL,Selangor,1169,658,511,Belgium
51175,7/1/2022,BEL,W.P. Labuan,0,0,0,Belgium
51176,7/1/2022,BEN,Johor,1,1,0,Benin
51177,7/1/2022,BEN,Kedah,0,0,0,Benin
51178,7/1/2022,BEN,Perak,0,0,0,Benin
51179,7/1/2022,BEN,Pulau Pinang,0,0,0,Benin
51180,7/1/2022,BEN,Sabah,0,0,0,Benin
51181,7/1/2022,BEN,Sarawak,0,0,0,Benin
51182,7/1/2022,BEN,Selangor,5,4,1,Benin
51183,7/1/2022,BFA,Perak,0,0,0,Burkina Faso
51184,7/1/2022,BFA,Pulau Pinang,0,0,0,Burkina Faso
51185,7/1/2022,BFA,Selangor,4,4,0,Burkina Faso
51186,7/1/2022,BGD,Johor,1656,1366,290,Bangladesh
51187,7/1/2022,BGD,Kedah,40,23,17,Bangladesh
51188,7/1/2022,BGD,Kelantan,0,0,0,Bangladesh
51189,7/1/2022,BGD,Melaka,0,0,0,Bangladesh
51190,7/1/2022,BGD,Negeri Sembilan,0,0,0,Bangladesh
51191,7/1/2022,BGD,Pahang,0,0,0,Bangladesh
51192,7/1/2022,BGD,Perak,0,0,0,Bangladesh
51193,7/1/2022,BGD,Perlis,1,1,0,Bangladesh
51194,7/1/2022,BGD,Pulau Pinang,82,77,5,Bangladesh
51195,7/1/2022,BGD,Sabah,3,2,1,Bangladesh
51196,7/1/2022,BGD,Sarawak,2,1,1,Bangladesh
51197,7/1/2022,BGD,Selangor,16380,14386,1994,Bangladesh
51198,7/1/2022,BGD,W.P. Labuan,0,0,0,Bangladesh
51199,7/1/2022,BGR,Johor,31,16,15,Bulgaria
51200,7/1/2022,BGR,Kedah,1,0,1,Bulgaria
51201,7/1/2022,BGR,Kelantan,0,0,0,Bulgaria
51202,7/1/2022,BGR,Pahang,0,0,0,Bulgaria
51203,7/1/2022,BGR,Perak,1,1,0,Bulgaria
51204,7/1/2022,BGR,Perlis,0,0,0,Bulgaria
51205,7/1/2022,BGR,Pulau Pinang,0,0,0,Bulgaria
51206,7/1/2022,BGR,Sabah,1,0,1,Bulgaria
51207,7/1/2022,BGR,Sarawak,1,1,0,Bulgaria
51208,7/1/2022,BGR,Selangor,84,50,34,Bulgaria
51209,7/1/2022,BGR,W.P. Labuan,0,0,0,Bulgaria
51210,7/1/2022,BHR,Johor,38,20,18,Bahrain
51211,7/1/2022,BHR,Kedah,0,0,0,Bahrain
51212,7/1/2022,BHR,Kelantan,0,0,0,Bahrain
51213,7/1/2022,BHR,Perlis,1,1,0,Bahrain
51214,7/1/2022,BHR,Pulau Pinang,0,0,0,Bahrain
51215,7/1/2022,BHR,Sabah,0,0,0,Bahrain
51216,7/1/2022,BHR,Sarawak,0,0,0,Bahrain
51217,7/1/2022,BHR,Selangor,192,88,104,Bahrain
51218,7/1/2022,BHS,Johor,0,0,0,Bahamas
51219,7/1/2022,BHS,Kedah,2,1,1,Bahamas
51220,7/1/2022,BHS,Perak,1,0,1,Bahamas
51221,7/1/2022,BHS,Sabah,0,0,0,Bahamas
51222,7/1/2022,BHS,Sarawak,0,0,0,Bahamas
51223,7/1/2022,BHS,Selangor,3,1,2,Bahamas
51224,7/1/2022,BIH,Johor,5,3,2,Bosnia and Herzegovina
51225,7/1/2022,BIH,Kedah,1,1,0,Bosnia and Herzegovina
51226,7/1/2022,BIH,Perlis,0,0,0,Bosnia and Herzegovina
51227,7/1/2022,BIH,Pulau Pinang,0,0,0,Bosnia and Herzegovina
51228,7/1/2022,BIH,Sabah,0,0,0,Bosnia and Herzegovina
51229,7/1/2022,BIH,Sarawak,0,0,0,Bosnia and Herzegovina
51230,7/1/2022,BIH,Selangor,36,22,14,Bosnia and Herzegovina
51231,7/1/2022,BLR,Johor,6,5,1,Belarus
51232,7/1/2022,BLR,Kedah,0,0,0,Belarus
51233,7/1/2022,BLR,Kelantan,0,0,0,Belarus
51234,7/1/2022,BLR,Pahang,0,0,0,Belarus
51235,7/1/2022,BLR,Perak,2,1,1,Belarus
51236,7/1/2022,BLR,Perlis,0,0,0,Belarus
51237,7/1/2022,BLR,Pulau Pinang,2,1,1,Belarus
51238,7/1/2022,BLR,Sabah,3,1,2,Belarus
51239,7/1/2022,BLR,Sarawak,0,0,0,Belarus
51240,7/1/2022,BLR,Selangor,76,36,40,Belarus
51241,7/1/2022,BLR,W.P. Labuan,0,0,0,Belarus
51242,7/1/2022,BLZ,Johor,0,0,0,Belize
51243,7/1/2022,BLZ,Pulau Pinang,0,0,0,Belize
51244,7/1/2022,BLZ,Sarawak,0,0,0,Belize
51245,7/1/2022,BLZ,Selangor,7,2,5,Belize
51246,7/1/2022,BMU,Selangor,0,0,0,Bermuda
51247,7/1/2022,BOL,Johor,0,0,0,Bolivia
51248,7/1/2022,BOL,Kedah,0,0,0,Bolivia
51249,7/1/2022,BOL,Melaka,0,0,0,Bolivia
51250,7/1/2022,BOL,Perak,0,0,0,Bolivia
51251,7/1/2022,BOL,Perlis,0,0,0,Bolivia
51252,7/1/2022,BOL,Pulau Pinang,0,0,0,Bolivia
51253,7/1/2022,BOL,Sabah,0,0,0,Bolivia
51254,7/1/2022,BOL,Sarawak,5,3,2,Bolivia
51255,7/1/2022,BOL,Selangor,7,5,2,Bolivia
51256,7/1/2022,BRA,Johor,201,113,88,Brazil
51257,7/1/2022,BRA,Kedah,30,14,16,Brazil
51258,7/1/2022,BRA,Kelantan,1,0,1,Brazil
51259,7/1/2022,BRA,Melaka,2,2,0,Brazil
51260,7/1/2022,BRA,Pahang,0,0,0,Brazil
51261,7/1/2022,BRA,Perak,5,2,3,Brazil
51262,7/1/2022,BRA,Perlis,3,3,0,Brazil
51263,7/1/2022,BRA,Pulau Pinang,23,18,5,Brazil
51264,7/1/2022,BRA,Sabah,5,4,1,Brazil
51265,7/1/2022,BRA,Sarawak,1,1,0,Brazil
51266,7/1/2022,BRA,Selangor,498,272,226,Brazil
51267,7/1/2022,BRA,W.P. Labuan,0,0,0,Brazil
51268,7/1/2022,BRB,Johor,1,0,1,Barbados
51269,7/1/2022,BRB,Kedah,0,0,0,Barbados
51270,7/1/2022,BRB,Perlis,0,0,0,Barbados
51271,7/1/2022,BRB,Pulau Pinang,0,0,0,Barbados
51272,7/1/2022,BRB,Selangor,2,0,2,Barbados
51273,7/1/2022,BRN,Johor,198,112,86,Brunei Darussalam
51274,7/1/2022,BRN,Kedah,1,1,0,Brunei Darussalam
51275,7/1/2022,BRN,Kelantan,0,0,0,Brunei Darussalam
51276,7/1/2022,BRN,Melaka,0,0,0,Brunei Darussalam
51277,7/1/2022,BRN,Pahang,0,0,0,Brunei Darussalam
51278,7/1/2022,BRN,Perak,1,1,0,Brunei Darussalam
51279,7/1/2022,BRN,Perlis,9,3,6,Brunei Darussalam
51280,7/1/2022,BRN,Pulau Pinang,3,2,1,Brunei Darussalam
51281,7/1/2022,BRN,Sabah,889,443,446,Brunei Darussalam
51282,7/1/2022,BRN,Sarawak,6462,3682,2780,Brunei Darussalam
51283,7/1/2022,BRN,Selangor,2978,1542,1436,Brunei Darussalam
51284,7/1/2022,BRN,W.P. Labuan,53,26,27,Brunei Darussalam
51285,7/1/2022,BTN,Johor,0,0,0,Bhutan
51286,7/1/2022,BTN,Kedah,1,1,0,Bhutan
51287,7/1/2022,BTN,Perak,0,0,0,Bhutan
51288,7/1/2022,BTN,Perlis,0,0,0,Bhutan
51289,7/1/2022,BTN,Pulau Pinang,0,0,0,Bhutan
51290,7/1/2022,BTN,Sabah,0,0,0,Bhutan
51291,7/1/2022,BTN,Sarawak,0,0,0,Bhutan
51292,7/1/2022,BTN,Selangor,42,25,17,Bhutan
51293,7/1/2022,BWA,Johor,1,1,0,Botswana
51294,7/1/2022,BWA,Kedah,0,0,0,Botswana
51295,7/1/2022,BWA,Perlis,0,0,0,Botswana
51296,7/1/2022,BWA,Pulau Pinang,0,0,0,Botswana
51297,7/1/2022,BWA,Sabah,0,0,0,Botswana
51298,7/1/2022,BWA,Sarawak,0,0,0,Botswana
51299,7/1/2022,BWA,Selangor,12,4,8,Botswana
51300,7/1/2022,CAF,Kedah,0,0,0,Central African Republic
51301,7/1/2022,CAF,Selangor,0,0,0,Central African Republic
51302,7/1/2022,CAN,Johor,788,482,306,Canada
51303,7/1/2022,CAN,Kedah,57,30,27,Canada
51304,7/1/2022,CAN,Kelantan,0,0,0,Canada
51305,7/1/2022,CAN,Melaka,0,0,0,Canada
51306,7/1/2022,CAN,Negeri Sembilan,0,0,0,Canada
51307,7/1/2022,CAN,Pahang,5,1,4,Canada
51308,7/1/2022,CAN,Perak,23,13,10,Canada
51309,7/1/2022,CAN,Perlis,16,12,4,Canada
51310,7/1/2022,CAN,Pulau Pinang,168,94,74,Canada
51311,7/1/2022,CAN,Sabah,62,28,34,Canada
51312,7/1/2022,CAN,Sarawak,51,33,18,Canada
51313,7/1/2022,CAN,Selangor,2517,1461,1056,Canada
51314,7/1/2022,CAN,Terengganu,0,0,0,Canada
51315,7/1/2022,CAN,W.P. Labuan,1,1,0,Canada
51316,7/1/2022,CCK,Selangor,0,0,0,Cocos (Keeling) Islands
51317,7/1/2022,CHE,Johor,385,224,161,Switzerland
51318,7/1/2022,CHE,Kedah,56,30,26,Switzerland
51319,7/1/2022,CHE,Kelantan,5,4,1,Switzerland
51320,7/1/2022,CHE,Melaka,0,0,0,Switzerland
51321,7/1/2022,CHE,Negeri Sembilan,0,0,0,Switzerland
51322,7/1/2022,CHE,Pahang,2,2,0,Switzerland
51323,7/1/2022,CHE,Perak,5,3,2,Switzerland
51324,7/1/2022,CHE,Perlis,11,6,5,Switzerland
51325,7/1/2022,CHE,Pulau Pinang,94,58,36,Switzerland
51326,7/1/2022,CHE,Sabah,49,22,27,Switzerland
51327,7/1/2022,CHE,Sarawak,42,25,17,Switzerland
51328,7/1/2022,CHE,Selangor,1235,705,530,Switzerland
51329,7/1/2022,CHE,W.P. Labuan,1,1,0,Switzerland
51330,7/1/2022,CHL,Johor,20,13,7,Chile
51331,7/1/2022,CHL,Kedah,5,2,3,Chile
51332,7/1/2022,CHL,Kelantan,0,0,0,Chile
51333,7/1/2022,CHL,Melaka,0,0,0,Chile
51334,7/1/2022,CHL,Pahang,0,0,0,Chile
51335,7/1/2022,CHL,Perak,0,0,0,Chile
51336,7/1/2022,CHL,Perlis,1,1,0,Chile
51337,7/1/2022,CHL,Pulau Pinang,4,3,1,Chile
51338,7/1/2022,CHL,Sabah,0,0,0,Chile
51339,7/1/2022,CHL,Sarawak,0,0,0,Chile
51340,7/1/2022,CHL,Selangor,114,62,52,Chile
51341,7/1/2022,CHN,Johor,18366,7545,10821,China
51342,7/1/2022,CHN,Kedah,341,143,198,China
51343,7/1/2022,CHN,Kelantan,5,0,5,China
51344,7/1/2022,CHN,Melaka,1,1,0,China
51345,7/1/2022,CHN,Pahang,3,3,0,China
51346,7/1/2022,CHN,Perak,144,73,71,China
51347,7/1/2022,CHN,Perlis,44,27,17,China
51348,7/1/2022,CHN,Pulau Pinang,1048,524,524,China
51349,7/1/2022,CHN,Sabah,308,122,186,China
51350,7/1/2022,CHN,Sarawak,141,62,79,China
51351,7/1/2022,CHN,Selangor,9849,5931,3918,China
51352,7/1/2022,CHN,Terengganu,0,0,0,China
51353,7/1/2022,CHN,W.P. Labuan,0,0,0,China
51354,7/1/2022,CIV,Johor,0,0,0,C��te d'Iv
51355,7/1/2022,CIV,Kedah,0,0,0,C��te d'Iv
51356,7/1/2022,CIV,Pulau Pinang,0,0,0,C��te d'Iv
51357,7/1/2022,CIV,Sabah,0,0,0,C��te d'Iv
51358,7/1/2022,CIV,Sarawak,1,0,1,C��te d'Iv
51359,7/1/2022,CIV,Selangor,16,11,5,C��te d'Iv
51360,7/1/2022,CMR,Johor,2,2,0,Cameroon
51361,7/1/2022,CMR,Kedah,0,0,0,Cameroon
51362,7/1/2022,CMR,Pulau Pinang,1,1,0,Cameroon
51363,7/1/2022,CMR,Sabah,0,0,0,Cameroon
51364,7/1/2022,CMR,Sarawak,1,1,0,Cameroon
51365,7/1/2022,CMR,Selangor,16,13,3,Cameroon
51366,7/1/2022,COD,Johor,0,0,0,"Congo, the Democratic Republic of the"
51367,7/1/2022,COD,Pulau Pinang,0,0,0,"Congo, the Democratic Republic of the"
51368,7/1/2022,COD,Sarawak,0,0,0,"Congo, the Democratic Republic of the"
51369,7/1/2022,COD,Selangor,6,1,5,"Congo, the Democratic Republic of the"
51370,7/1/2022,COG,Johor,0,0,0,Congo
51371,7/1/2022,COG,Kedah,0,0,0,Congo
51372,7/1/2022,COG,Selangor,0,0,0,Congo
51373,7/1/2022,COK,Selangor,0,0,0,Cook Islands
51374,7/1/2022,COL,Johor,27,11,16,Colombia
51375,7/1/2022,COL,Kedah,2,0,2,Colombia
51376,7/1/2022,COL,Perak,0,0,0,Colombia
51377,7/1/2022,COL,Pulau Pinang,5,2,3,Colombia
51378,7/1/2022,COL,Sabah,2,2,0,Colombia
51379,7/1/2022,COL,Sarawak,2,2,0,Colombia
51380,7/1/2022,COL,Selangor,88,41,47,Colombia
51381,7/1/2022,COL,W.P. Labuan,0,0,0,Colombia
51382,7/1/2022,COM,Johor,0,0,0,Comoros
51383,7/1/2022,COM,Kedah,0,0,0,Comoros
51384,7/1/2022,COM,Selangor,2,1,1,Comoros
51385,7/1/2022,CPV,Johor,0,0,0,Cape Verde
51386,7/1/2022,CPV,Kedah,0,0,0,Cape Verde
51387,7/1/2022,CPV,Pulau Pinang,0,0,0,Cape Verde
51388,7/1/2022,CPV,Sabah,0,0,0,Cape Verde
51389,7/1/2022,CPV,Selangor,1,1,0,Cape Verde
51390,7/1/2022,CRI,Johor,11,6,5,Costa Rica
51391,7/1/2022,CRI,Kedah,0,0,0,Costa Rica
51392,7/1/2022,CRI,Perak,0,0,0,Costa Rica
51393,7/1/2022,CRI,Perlis,0,0,0,Costa Rica
51394,7/1/2022,CRI,Pulau Pinang,6,1,5,Costa Rica
51395,7/1/2022,CRI,Sabah,0,0,0,Costa Rica
51396,7/1/2022,CRI,Sarawak,0,0,0,Costa Rica
51397,7/1/2022,CRI,Selangor,27,12,15,Costa Rica
51398,7/1/2022,CUB,Johor,10,7,3,Cuba
51399,7/1/2022,CUB,Kedah,0,0,0,Cuba
51400,7/1/2022,CUB,Perlis,0,0,0,Cuba
51401,7/1/2022,CUB,Pulau Pinang,0,0,0,Cuba
51402,7/1/2022,CUB,Sabah,0,0,0,Cuba
51403,7/1/2022,CUB,Sarawak,2,1,1,Cuba
51404,7/1/2022,CUB,Selangor,11,5,6,Cuba
51405,7/1/2022,CYP,Johor,11,9,2,Cyprus
51406,7/1/2022,CYP,Kedah,4,2,2,Cyprus
51407,7/1/2022,CYP,Perak,2,2,0,Cyprus
51408,7/1/2022,CYP,Perlis,0,0,0,Cyprus
51409,7/1/2022,CYP,Pulau Pinang,1,0,1,Cyprus
51410,7/1/2022,CYP,Sabah,3,2,1,Cyprus
51411,7/1/2022,CYP,Sarawak,0,0,0,Cyprus
51412,7/1/2022,CYP,Selangor,43,27,16,Cyprus
51413,7/1/2022,CZE,Johor,85,56,29,Czech Republic
51414,7/1/2022,CZE,Kedah,20,9,11,Czech Republic
51415,7/1/2022,CZE,Kelantan,5,3,2,Czech Republic
51416,7/1/2022,CZE,Melaka,0,0,0,Czech Republic
51417,7/1/2022,CZE,Negeri Sembilan,0,0,0,Czech Republic
51418,7/1/2022,CZE,Perak,2,1,1,Czech Republic
51419,7/1/2022,CZE,Perlis,4,3,1,Czech Republic
51420,7/1/2022,CZE,Pulau Pinang,19,12,7,Czech Republic
51421,7/1/2022,CZE,Sabah,8,4,4,Czech Republic
51422,7/1/2022,CZE,Sarawak,16,8,8,Czech Republic
51423,7/1/2022,CZE,Selangor,375,201,174,Czech Republic
51424,7/1/2022,CZE,W.P. Labuan,0,0,0,Czech Republic
51425,7/1/2022,DEU,Johor,1486,981,505,Germany
51426,7/1/2022,DEU,Kedah,245,130,115,Germany
51427,7/1/2022,DEU,Kelantan,16,10,6,Germany
51428,7/1/2022,DEU,Melaka,0,0,0,Germany
51429,7/1/2022,DEU,Negeri Sembilan,0,0,0,Germany
51430,7/1/2022,DEU,Pahang,1,1,0,Germany
51431,7/1/2022,DEU,Perak,24,18,6,Germany
51432,7/1/2022,DEU,Perlis,58,38,20,Germany
51433,7/1/2022,DEU,Pulau Pinang,412,307,105,Germany
51434,7/1/2022,DEU,Sabah,124,72,52,Germany
51435,7/1/2022,DEU,Sarawak,125,74,51,Germany
51436,7/1/2022,DEU,Selangor,5314,3167,2147,Germany
51437,7/1/2022,DEU,Terengganu,0,0,0,Germany
51438,7/1/2022,DEU,W.P. Labuan,1,1,0,Germany
51439,7/1/2022,DJI,Johor,0,0,0,Djibouti
51440,7/1/2022,DJI,Selangor,1,0,1,Djibouti
51441,7/1/2022,DMA,Johor,3,3,0,Dominica
51442,7/1/2022,DMA,Kedah,0,0,0,Dominica
51443,7/1/2022,DMA,Pulau Pinang,1,1,0,Dominica
51444,7/1/2022,DMA,Sabah,0,0,0,Dominica
51445,7/1/2022,DMA,Sarawak,0,0,0,Dominica
51446,7/1/2022,DMA,Selangor,22,13,9,Dominica
51447,7/1/2022,DMA,W.P. Labuan,0,0,0,Dominica
51448,7/1/2022,DNK,Johor,235,130,105,Denmark
51449,7/1/2022,DNK,Kedah,32,16,16,Denmark
51450,7/1/2022,DNK,Kelantan,0,0,0,Denmark
51451,7/1/2022,DNK,Melaka,0,0,0,Denmark
51452,7/1/2022,DNK,Negeri Sembilan,0,0,0,Denmark
51453,7/1/2022,DNK,Pahang,0,0,0,Denmark
51454,7/1/2022,DNK,Perak,2,2,0,Denmark
51455,7/1/2022,DNK,Perlis,7,6,1,Denmark
51456,7/1/2022,DNK,Pulau Pinang,38,25,13,Denmark
51457,7/1/2022,DNK,Sabah,24,16,8,Denmark
51458,7/1/2022,DNK,Sarawak,27,17,10,Denmark
51459,7/1/2022,DNK,Selangor,1136,637,499,Denmark
51460,7/1/2022,DNK,W.P. Labuan,0,0,0,Denmark
51461,7/1/2022,DOM,Johor,2,0,2,Dominican Republic
51462,7/1/2022,DOM,Kedah,0,0,0,Dominican Republic
51463,7/1/2022,DOM,Perak,0,0,0,Dominican Republic
51464,7/1/2022,DOM,Perlis,0,0,0,Dominican Republic
51465,7/1/2022,DOM,Pulau Pinang,0,0,0,Dominican Republic
51466,7/1/2022,DOM,Sabah,0,0,0,Dominican Republic
51467,7/1/2022,DOM,Sarawak,0,0,0,Dominican Republic
51468,7/1/2022,DOM,Selangor,15,10,5,Dominican Republic
51469,7/1/2022,DZA,Johor,14,13,1,Algeria
51470,7/1/2022,DZA,Kedah,4,3,1,Algeria
51471,7/1/2022,DZA,Kelantan,0,0,0,Algeria
51472,7/1/2022,DZA,Melaka,0,0,0,Algeria
51473,7/1/2022,DZA,Perak,0,0,0,Algeria
51474,7/1/2022,DZA,Perlis,0,0,0,Algeria
51475,7/1/2022,DZA,Pulau Pinang,1,1,0,Algeria
51476,7/1/2022,DZA,Sabah,5,4,1,Algeria
51477,7/1/2022,DZA,Sarawak,1,1,0,Algeria
51478,7/1/2022,DZA,Selangor,264,144,120,Algeria
51479,7/1/2022,DZA,W.P. Labuan,0,0,0,Algeria
51480,7/1/2022,ECU,Johor,4,2,2,Ecuador
51481,7/1/2022,ECU,Kedah,3,1,2,Ecuador
51482,7/1/2022,ECU,Perak,0,0,0,Ecuador
51483,7/1/2022,ECU,Perlis,0,0,0,Ecuador
51484,7/1/2022,ECU,Pulau Pinang,0,0,0,Ecuador
51485,7/1/2022,ECU,Sabah,0,0,0,Ecuador
51486,7/1/2022,ECU,Sarawak,1,0,1,Ecuador
51487,7/1/2022,ECU,Selangor,34,14,20,Ecuador
51488,7/1/2022,EGY,Johor,140,112,28,Egypt
51489,7/1/2022,EGY,Kedah,7,4,3,Egypt
51490,7/1/2022,EGY,Kelantan,0,0,0,Egypt
51491,7/1/2022,EGY,Melaka,0,0,0,Egypt
51492,7/1/2022,EGY,Pahang,0,0,0,Egypt
51493,7/1/2022,EGY,Perak,0,0,0,Egypt
51494,7/1/2022,EGY,Perlis,0,0,0,Egypt
51495,7/1/2022,EGY,Pulau Pinang,12,6,6,Egypt
51496,7/1/2022,EGY,Sabah,12,8,4,Egypt
51497,7/1/2022,EGY,Sarawak,6,2,4,Egypt
51498,7/1/2022,EGY,Selangor,1113,666,447,Egypt
51499,7/1/2022,EGY,Terengganu,0,0,0,Egypt
51500,7/1/2022,EGY,W.P. Labuan,0,0,0,Egypt
51501,7/1/2022,ERI,Johor,1,0,1,Eritrea
51502,7/1/2022,ERI,Pulau Pinang,0,0,0,Eritrea
51503,7/1/2022,ERI,Sabah,0,0,0,Eritrea
51504,7/1/2022,ERI,Selangor,7,5,2,Eritrea
51505,7/1/2022,ESP,Johor,498,273,225,Spain
51506,7/1/2022,ESP,Kedah,54,28,26,Spain
51507,7/1/2022,ESP,Kelantan,10,4,6,Spain
51508,7/1/2022,ESP,Melaka,0,0,0,Spain
51509,7/1/2022,ESP,Negeri Sembilan,0,0,0,Spain
51510,7/1/2022,ESP,Pahang,0,0,0,Spain
51511,7/1/2022,ESP,Perak,12,8,4,Spain
51512,7/1/2022,ESP,Perlis,10,5,5,Spain
51513,7/1/2022,ESP,Pulau Pinang,141,69,72,Spain
51514,7/1/2022,ESP,Sabah,41,23,18,Spain
51515,7/1/2022,ESP,Sarawak,63,26,37,Spain
51516,7/1/2022,ESP,Selangor,2916,1523,1393,Spain
51517,7/1/2022,ESP,W.P. Labuan,0,0,0,Spain
51518,7/1/2022,EST,Johor,5,3,2,Estonia
51519,7/1/2022,EST,Kedah,0,0,0,Estonia
51520,7/1/2022,EST,Kelantan,0,0,0,Estonia
51521,7/1/2022,EST,Pahang,0,0,0,Estonia
51522,7/1/2022,EST,Perak,1,1,0,Estonia
51523,7/1/2022,EST,Perlis,0,0,0,Estonia
51524,7/1/2022,EST,Pulau Pinang,2,0,2,Estonia
51525,7/1/2022,EST,Sabah,0,0,0,Estonia
51526,7/1/2022,EST,Sarawak,0,0,0,Estonia
51527,7/1/2022,EST,Selangor,31,16,15,Estonia
51528,7/1/2022,EST,W.P. Labuan,0,0,0,Estonia
51529,7/1/2022,ETH,Johor,3,1,2,Ethiopia
51530,7/1/2022,ETH,Kedah,0,0,0,Ethiopia
51531,7/1/2022,ETH,Pulau Pinang,0,0,0,Ethiopia
51532,7/1/2022,ETH,Sarawak,0,0,0,Ethiopia
51533,7/1/2022,ETH,Selangor,34,16,18,Ethiopia
51534,7/1/2022,FIN,Johor,125,64,61,Finland
51535,7/1/2022,FIN,Kedah,13,7,6,Finland
51536,7/1/2022,FIN,Kelantan,0,0,0,Finland
51537,7/1/2022,FIN,Melaka,0,0,0,Finland
51538,7/1/2022,FIN,Negeri Sembilan,0,0,0,Finland
51539,7/1/2022,FIN,Pahang,0,0,0,Finland
51540,7/1/2022,FIN,Perak,0,0,0,Finland
51541,7/1/2022,FIN,Perlis,0,0,0,Finland
51542,7/1/2022,FIN,Pulau Pinang,16,9,7,Finland
51543,7/1/2022,FIN,Sabah,0,0,0,Finland
51544,7/1/2022,FIN,Sarawak,3,2,1,Finland
51545,7/1/2022,FIN,Selangor,227,138,89,Finland
51546,7/1/2022,FIN,W.P. Labuan,0,0,0,Finland
51547,7/1/2022,FJI,Johor,54,24,30,Fiji
51548,7/1/2022,FJI,Kedah,1,1,0,Fiji
51549,7/1/2022,FJI,Kelantan,0,0,0,Fiji
51550,7/1/2022,FJI,Perak,0,0,0,Fiji
51551,7/1/2022,FJI,Perlis,0,0,0,Fiji
51552,7/1/2022,FJI,Pulau Pinang,0,0,0,Fiji
51553,7/1/2022,FJI,Sabah,0,0,0,Fiji
51554,7/1/2022,FJI,Sarawak,2,0,2,Fiji
51555,7/1/2022,FJI,Selangor,48,24,24,Fiji
51556,7/1/2022,FRA,Johor,2080,1212,868,France
51557,7/1/2022,FRA,Kedah,159,92,67,France
51558,7/1/2022,FRA,Kelantan,8,6,2,France
51559,7/1/2022,FRA,Melaka,1,1,0,France
51560,7/1/2022,FRA,Negeri Sembilan,0,0,0,France
51561,7/1/2022,FRA,Pahang,4,3,1,France
51562,7/1/2022,FRA,Perak,22,17,5,France
51563,7/1/2022,FRA,Perlis,27,17,10,France
51564,7/1/2022,FRA,Pulau Pinang,275,169,106,France
51565,7/1/2022,FRA,Sabah,131,78,53,France
51566,7/1/2022,FRA,Sarawak,136,73,63,France
51567,7/1/2022,FRA,Selangor,6709,3780,2929,France
51568,7/1/2022,FRA,Terengganu,0,0,0,France
51569,7/1/2022,FRA,W.P. Labuan,0,0,0,France
51570,7/1/2022,FSM,Johor,0,0,0,"Micronesia, Federated States of"
51571,7/1/2022,FSM,Pulau Pinang,0,0,0,"Micronesia, Federated States of"
51572,7/1/2022,FSM,Selangor,0,0,0,"Micronesia, Federated States of"
51573,7/1/2022,GAB,Johor,0,0,0,Gabon
51574,7/1/2022,GAB,Pulau Pinang,0,0,0,Gabon
51575,7/1/2022,GAB,Sarawak,0,0,0,Gabon
51576,7/1/2022,GAB,Selangor,7,5,2,Gabon
51577,7/1/2022,GBR,Johor,3444,2214,1230,United Kingdom
51578,7/1/2022,GBR,Kedah,451,262,189,United Kingdom
51579,7/1/2022,GBR,Kelantan,7,4,3,United Kingdom
51580,7/1/2022,GBR,Melaka,1,1,0,United Kingdom
51581,7/1/2022,GBR,Negeri Sembilan,1,1,0,United Kingdom
51582,7/1/2022,GBR,Pahang,2,2,0,United Kingdom
51583,7/1/2022,GBR,Perak,97,56,41,United Kingdom
51584,7/1/2022,GBR,Perlis,120,68,52,United Kingdom
51585,7/1/2022,GBR,Pulau Pinang,898,538,360,United Kingdom
51586,7/1/2022,GBR,Sabah,601,328,273,United Kingdom
51587,7/1/2022,GBR,Sarawak,296,179,117,United Kingdom
51588,7/1/2022,GBR,Selangor,14178,8171,6007,United Kingdom
51589,7/1/2022,GBR,Terengganu,0,0,0,United Kingdom
51590,7/1/2022,GBR,W.P. Labuan,3,2,1,United Kingdom
51591,7/1/2022,GEO,Johor,2,2,0,Georgia
51592,7/1/2022,GEO,Kedah,0,0,0,Georgia
51593,7/1/2022,GEO,Melaka,0,0,0,Georgia
51594,7/1/2022,GEO,Perak,0,0,0,Georgia
51595,7/1/2022,GEO,Perlis,0,0,0,Georgia
51596,7/1/2022,GEO,Pulau Pinang,0,0,0,Georgia
51597,7/1/2022,GEO,Sabah,0,0,0,Georgia
51598,7/1/2022,GEO,Sarawak,0,0,0,Georgia
51599,7/1/2022,GEO,Selangor,17,10,7,Georgia
51600,7/1/2022,GHA,Johor,3,3,0,Ghana
51601,7/1/2022,GHA,Kedah,0,0,0,Ghana
51602,7/1/2022,GHA,Kelantan,0,0,0,Ghana
51603,7/1/2022,GHA,Pulau Pinang,0,0,0,Ghana
51604,7/1/2022,GHA,Sabah,0,0,0,Ghana
51605,7/1/2022,GHA,Sarawak,0,0,0,Ghana
51606,7/1/2022,GHA,Selangor,34,26,8,Ghana
51607,7/1/2022,GIB,Johor,0,0,0,Gibraltar
51608,7/1/2022,GIB,Sarawak,1,0,1,Gibraltar
51609,7/1/2022,GIN,Johor,0,0,0,Guinea
51610,7/1/2022,GIN,Kedah,0,0,0,Guinea
51611,7/1/2022,GIN,Kelantan,0,0,0,Guinea
51612,7/1/2022,GIN,Perlis,0,0,0,Guinea
51613,7/1/2022,GIN,Pulau Pinang,0,0,0,Guinea
51614,7/1/2022,GIN,Sabah,0,0,0,Guinea
51615,7/1/2022,GIN,Sarawak,0,0,0,Guinea
51616,7/1/2022,GIN,Selangor,23,19,4,Guinea
51617,7/1/2022,GLP,Selangor,0,0,0,Guadeloupe
51618,7/1/2022,GMB,Johor,0,0,0,Gambia
51619,7/1/2022,GMB,Kedah,0,0,0,Gambia
51620,7/1/2022,GMB,Kelantan,0,0,0,Gambia
51621,7/1/2022,GMB,Pulau Pinang,0,0,0,Gambia
51622,7/1/2022,GMB,Sabah,0,0,0,Gambia
51623,7/1/2022,GMB,Sarawak,0,0,0,Gambia
51624,7/1/2022,GMB,Selangor,6,3,3,Gambia
51625,7/1/2022,GNB,Johor,0,0,0,Guinea-Bissau
51626,7/1/2022,GNB,Selangor,0,0,0,Guinea-Bissau
51627,7/1/2022,GNQ,Johor,0,0,0,Equatorial Guinea
51628,7/1/2022,GNQ,Selangor,1,1,0,Equatorial Guinea
51629,7/1/2022,GRC,Johor,22,16,6,Greece
51630,7/1/2022,GRC,Kedah,10,8,2,Greece
51631,7/1/2022,GRC,Kelantan,1,0,1,Greece
51632,7/1/2022,GRC,Melaka,0,0,0,Greece
51633,7/1/2022,GRC,Negeri Sembilan,0,0,0,Greece
51634,7/1/2022,GRC,Pahang,0,0,0,Greece
51635,7/1/2022,GRC,Perak,0,0,0,Greece
51636,7/1/2022,GRC,Perlis,1,0,1,Greece
51637,7/1/2022,GRC,Pulau Pinang,2,2,0,Greece
51638,7/1/2022,GRC,Sabah,2,1,1,Greece
51639,7/1/2022,GRC,Sarawak,3,3,0,Greece
51640,7/1/2022,GRC,Selangor,105,71,34,Greece
51641,7/1/2022,GRD,Johor,5,2,3,Grenada
51642,7/1/2022,GRD,Kedah,0,0,0,Grenada
51643,7/1/2022,GRD,Pulau Pinang,0,0,0,Grenada
51644,7/1/2022,GRD,Sabah,0,0,0,Grenada
51645,7/1/2022,GRD,Sarawak,0,0,0,Grenada
51646,7/1/2022,GRD,Selangor,10,5,5,Grenada
51647,7/1/2022,GRL,Johor,0,0,0,Greenland
51648,7/1/2022,GRL,Selangor,0,0,0,Greenland
51649,7/1/2022,GTM,Johor,1,0,1,Guatemala
51650,7/1/2022,GTM,Kedah,0,0,0,Guatemala
51651,7/1/2022,GTM,Pahang,0,0,0,Guatemala
51652,7/1/2022,GTM,Perak,0,0,0,Guatemala
51653,7/1/2022,GTM,Pulau Pinang,0,0,0,Guatemala
51654,7/1/2022,GTM,Sabah,0,0,0,Guatemala
51655,7/1/2022,GTM,Sarawak,0,0,0,Guatemala
51656,7/1/2022,GTM,Selangor,9,7,2,Guatemala
51657,7/1/2022,GTM,W.P. Labuan,0,0,0,Guatemala
51658,7/1/2022,GUY,Johor,0,0,0,Guyana
51659,7/1/2022,GUY,Kedah,0,0,0,Guyana
51660,7/1/2022,GUY,Pulau Pinang,0,0,0,Guyana
51661,7/1/2022,GUY,Sarawak,0,0,0,Guyana
51662,7/1/2022,GUY,Selangor,1,0,1,Guyana
51663,7/1/2022,HKG,Johor,0,0,0,Hong Kong
51664,7/1/2022,HKG,Kedah,0,0,0,Hong Kong
51665,7/1/2022,HKG,Kelantan,0,0,0,Hong Kong
51666,7/1/2022,HKG,Pahang,0,0,0,Hong Kong
51667,7/1/2022,HKG,Perak,33,10,23,Hong Kong
51668,7/1/2022,HKG,Perlis,1,1,0,Hong Kong
51669,7/1/2022,HKG,Pulau Pinang,12,8,4,Hong Kong
51670,7/1/2022,HKG,Sabah,53,27,26,Hong Kong
51671,7/1/2022,HKG,Sarawak,42,23,19,Hong Kong
51672,7/1/2022,HKG,Selangor,12,7,5,Hong Kong
51673,7/1/2022,HKG,Terengganu,0,0,0,Hong Kong
51674,7/1/2022,HMD,Johor,0,0,0,Heard Island and McDonald Islands
51675,7/1/2022,HND,Johor,4,0,4,Honduras
51676,7/1/2022,HND,Kedah,0,0,0,Honduras
51677,7/1/2022,HND,Perak,0,0,0,Honduras
51678,7/1/2022,HND,Pulau Pinang,0,0,0,Honduras
51679,7/1/2022,HND,Sabah,0,0,0,Honduras
51680,7/1/2022,HND,Sarawak,0,0,0,Honduras
51681,7/1/2022,HND,Selangor,10,7,3,Honduras
51682,7/1/2022,HRV,Johor,25,16,9,Croatia
51683,7/1/2022,HRV,Kedah,1,0,1,Croatia
51684,7/1/2022,HRV,Kelantan,0,0,0,Croatia
51685,7/1/2022,HRV,Melaka,0,0,0,Croatia
51686,7/1/2022,HRV,Pahang,0,0,0,Croatia
51687,7/1/2022,HRV,Perak,0,0,0,Croatia
51688,7/1/2022,HRV,Perlis,0,0,0,Croatia
51689,7/1/2022,HRV,Pulau Pinang,2,1,1,Croatia
51690,7/1/2022,HRV,Sabah,3,3,0,Croatia
51691,7/1/2022,HRV,Sarawak,0,0,0,Croatia
51692,7/1/2022,HRV,Selangor,96,66,30,Croatia
51693,7/1/2022,HTI,Johor,5,4,1,Haiti
51694,7/1/2022,HTI,Kedah,0,0,0,Haiti
51695,7/1/2022,HTI,Kelantan,0,0,0,Haiti
51696,7/1/2022,HTI,Perak,0,0,0,Haiti
51697,7/1/2022,HTI,Pulau Pinang,0,0,0,Haiti
51698,7/1/2022,HTI,Sabah,0,0,0,Haiti
51699,7/1/2022,HTI,Selangor,7,4,3,Haiti
51700,7/1/2022,HUN,Johor,64,50,14,Hungary
51701,7/1/2022,HUN,Kedah,13,4,9,Hungary
51702,7/1/2022,HUN,Kelantan,0,0,0,Hungary
51703,7/1/2022,HUN,Pahang,0,0,0,Hungary
51704,7/1/2022,HUN,Perak,2,2,0,Hungary
51705,7/1/2022,HUN,Perlis,3,3,0,Hungary
51706,7/1/2022,HUN,Pulau Pinang,19,11,8,Hungary
51707,7/1/2022,HUN,Sabah,9,5,4,Hungary
51708,7/1/2022,HUN,Sarawak,8,3,5,Hungary
51709,7/1/2022,HUN,Selangor,234,126,108,Hungary
51710,7/1/2022,HUN,W.P. Labuan,0,0,0,Hungary
51711,7/1/2022,IDN,Johor,84876,45924,38952,Indonesia
51712,7/1/2022,IDN,Kedah,1658,661,997,Indonesia
51713,7/1/2022,IDN,Kelantan,89,53,36,Indonesia
51714,7/1/2022,IDN,Melaka,6231,2663,3568,Indonesia
51715,7/1/2022,IDN,Negeri Sembilan,6081,4051,2030,Indonesia
51716,7/1/2022,IDN,Pahang,7,6,1,Indonesia
51717,7/1/2022,IDN,Perak,127,46,81,Indonesia
51718,7/1/2022,IDN,Perlis,140,62,78,Indonesia
51719,7/1/2022,IDN,Pulau Pinang,18153,7138,11015,Indonesia
51720,7/1/2022,IDN,Sabah,3963,1890,2073,Indonesia
51721,7/1/2022,IDN,Sarawak,23710,13814,9896,Indonesia
51722,7/1/2022,IDN,Selangor,45541,21372,24169,Indonesia
51723,7/1/2022,IDN,Terengganu,0,0,0,Indonesia
51724,7/1/2022,IDN,W.P. Labuan,2,2,0,Indonesia
51725,7/1/2022,IND,Johor,12385,8784,3601,India
51726,7/1/2022,IND,Kedah,477,271,206,India
51727,7/1/2022,IND,Kelantan,8,6,2,India
51728,7/1/2022,IND,Melaka,0,0,0,India
51729,7/1/2022,IND,Negeri Sembilan,0,0,0,India
51730,7/1/2022,IND,Pahang,0,0,0,India
51731,7/1/2022,IND,Perak,643,542,101,India
51732,7/1/2022,IND,Perlis,117,101,16,India
51733,7/1/2022,IND,Pulau Pinang,659,464,195,India
51734,7/1/2022,IND,Sabah,180,119,61,India
51735,7/1/2022,IND,Sarawak,93,70,23,India
51736,7/1/2022,IND,Selangor,38269,28244,10025,India
51737,7/1/2022,IND,Terengganu,0,0,0,India
51738,7/1/2022,IND,W.P. Labuan,0,0,0,India
51739,7/1/2022,IOT,Pulau Pinang,0,0,0,British Indian Ocean Territory
51740,7/1/2022,IOT,Selangor,0,0,0,British Indian Ocean Territory
51741,7/1/2022,IRL,Johor,253,160,93,Ireland
51742,7/1/2022,IRL,Kedah,21,11,10,Ireland
51743,7/1/2022,IRL,Kelantan,0,0,0,Ireland
51744,7/1/2022,IRL,Negeri Sembilan,0,0,0,Ireland
51745,7/1/2022,IRL,Pahang,0,0,0,Ireland
51746,7/1/2022,IRL,Perak,7,4,3,Ireland
51747,7/1/2022,IRL,Perlis,8,1,7,Ireland
51748,7/1/2022,IRL,Pulau Pinang,68,42,26,Ireland
51749,7/1/2022,IRL,Sabah,18,8,10,Ireland
51750,7/1/2022,IRL,Sarawak,14,8,6,Ireland
51751,7/1/2022,IRL,Selangor,973,547,426,Ireland
51752,7/1/2022,IRL,Terengganu,0,0,0,Ireland
51753,7/1/2022,IRL,W.P. Labuan,0,0,0,Ireland
51754,7/1/2022,IRN,Johor,152,88,64,Iran
51755,7/1/2022,IRN,Kedah,3,1,2,Iran
51756,7/1/2022,IRN,Kelantan,0,0,0,Iran
51757,7/1/2022,IRN,Perak,0,0,0,Iran
51758,7/1/2022,IRN,Perlis,1,1,0,Iran
51759,7/1/2022,IRN,Pulau Pinang,3,1,2,Iran
51760,7/1/2022,IRN,Sabah,4,3,1,Iran
51761,7/1/2022,IRN,Sarawak,1,1,0,Iran
51762,7/1/2022,IRN,Selangor,1417,737,680,Iran
51763,7/1/2022,IRN,W.P. Labuan,0,0,0,Iran
51764,7/1/2022,IRQ,Johor,17,16,1,Iraq
51765,7/1/2022,IRQ,Kedah,0,0,0,Iraq
51766,7/1/2022,IRQ,Kelantan,0,0,0,Iraq
51767,7/1/2022,IRQ,Melaka,0,0,0,Iraq
51768,7/1/2022,IRQ,Pahang,0,0,0,Iraq
51769,7/1/2022,IRQ,Perak,0,0,0,Iraq
51770,7/1/2022,IRQ,Perlis,0,0,0,Iraq
51771,7/1/2022,IRQ,Pulau Pinang,0,0,0,Iraq
51772,7/1/2022,IRQ,Sabah,0,0,0,Iraq
51773,7/1/2022,IRQ,Sarawak,0,0,0,Iraq
51774,7/1/2022,IRQ,Selangor,672,393,279,Iraq
51775,7/1/2022,ISL,Johor,0,0,0,Iceland
51776,7/1/2022,ISL,Kedah,0,0,0,Iceland
51777,7/1/2022,ISL,Kelantan,1,0,1,Iceland
51778,7/1/2022,ISL,Perak,2,1,1,Iceland
51779,7/1/2022,ISL,Perlis,0,0,0,Iceland
51780,7/1/2022,ISL,Pulau Pinang,3,1,2,Iceland
51781,7/1/2022,ISL,Sabah,0,0,0,Iceland
51782,7/1/2022,ISL,Sarawak,4,2,2,Iceland
51783,7/1/2022,ISL,Selangor,22,7,15,Iceland
51784,7/1/2022,ISL,W.P. Labuan,0,0,0,Iceland
51785,7/1/2022,ISR,Pulau Pinang,0,0,0,Israel
51786,7/1/2022,ITA,Johor,468,305,163,Italy
51787,7/1/2022,ITA,Kedah,34,23,11,Italy
51788,7/1/2022,ITA,Kelantan,0,0,0,Italy
51789,7/1/2022,ITA,Melaka,0,0,0,Italy
51790,7/1/2022,ITA,Negeri Sembilan,0,0,0,Italy
51791,7/1/2022,ITA,Pahang,0,0,0,Italy
51792,7/1/2022,ITA,Perak,2,2,0,Italy
51793,7/1/2022,ITA,Perlis,9,4,5,Italy
51794,7/1/2022,ITA,Pulau Pinang,81,54,27,Italy
51795,7/1/2022,ITA,Sabah,29,15,14,Italy
51796,7/1/2022,ITA,Sarawak,27,16,11,Italy
51797,7/1/2022,ITA,Selangor,1936,1219,717,Italy
51798,7/1/2022,ITA,W.P. Labuan,0,0,0,Italy
51799,7/1/2022,JAM,Johor,0,0,0,Jamaica
51800,7/1/2022,JAM,Kedah,0,0,0,Jamaica
51801,7/1/2022,JAM,Perak,0,0,0,Jamaica
51802,7/1/2022,JAM,Pulau Pinang,0,0,0,Jamaica
51803,7/1/2022,JAM,Sabah,0,0,0,Jamaica
51804,7/1/2022,JAM,Sarawak,0,0,0,Jamaica
51805,7/1/2022,JAM,Selangor,5,4,1,Jamaica
51806,7/1/2022,JAM,W.P. Labuan,0,0,0,Jamaica
51807,7/1/2022,JOR,Johor,15,10,5,Jordan
51808,7/1/2022,JOR,Kedah,1,1,0,Jordan
51809,7/1/2022,JOR,Kelantan,0,0,0,Jordan
51810,7/1/2022,JOR,Melaka,0,0,0,Jordan
51811,7/1/2022,JOR,Perlis,0,0,0,Jordan
51812,7/1/2022,JOR,Pulau Pinang,9,5,4,Jordan
51813,7/1/2022,JOR,Sabah,1,1,0,Jordan
51814,7/1/2022,JOR,Sarawak,1,1,0,Jordan
51815,7/1/2022,JOR,Selangor,602,378,224,Jordan
51816,7/1/2022,JOR,W.P. Labuan,0,0,0,Jordan
51817,7/1/2022,JPN,Johor,4233,3059,1174,Japan
51818,7/1/2022,JPN,Kedah,99,56,43,Japan
51819,7/1/2022,JPN,Kelantan,3,1,2,Japan
51820,7/1/2022,JPN,Melaka,1,1,0,Japan
51821,7/1/2022,JPN,Negeri Sembilan,2,0,2,Japan
51822,7/1/2022,JPN,Pahang,0,0,0,Japan
51823,7/1/2022,JPN,Perak,10,6,4,Japan
51824,7/1/2022,JPN,Perlis,10,9,1,Japan
51825,7/1/2022,JPN,Pulau Pinang,666,457,209,Japan
51826,7/1/2022,JPN,Sabah,182,104,78,Japan
51827,7/1/2022,JPN,Sarawak,59,34,25,Japan
51828,7/1/2022,JPN,Selangor,8192,5378,2814,Japan
51829,7/1/2022,JPN,W.P. Labuan,0,0,0,Japan
51830,7/1/2022,KAZ,Johor,36,23,13,Kazakhstan
51831,7/1/2022,KAZ,Kedah,2,0,2,Kazakhstan
51832,7/1/2022,KAZ,Kelantan,1,1,0,Kazakhstan
51833,7/1/2022,KAZ,Melaka,0,0,0,Kazakhstan
51834,7/1/2022,KAZ,Perak,0,0,0,Kazakhstan
51835,7/1/2022,KAZ,Perlis,0,0,0,Kazakhstan
51836,7/1/2022,KAZ,Pulau Pinang,0,0,0,Kazakhstan
51837,7/1/2022,KAZ,Sabah,1,1,0,Kazakhstan
51838,7/1/2022,KAZ,Sarawak,0,0,0,Kazakhstan
51839,7/1/2022,KAZ,Selangor,290,129,161,Kazakhstan
51840,7/1/2022,KAZ,W.P. Labuan,0,0,0,Kazakhstan
51841,7/1/2022,KEN,Johor,15,6,9,Kenya
51842,7/1/2022,KEN,Kedah,2,1,1,Kenya
51843,7/1/2022,KEN,Kelantan,0,0,0,Kenya
51844,7/1/2022,KEN,Perak,0,0,0,Kenya
51845,7/1/2022,KEN,Perlis,1,1,0,Kenya
51846,7/1/2022,KEN,Pulau Pinang,1,1,0,Kenya
51847,7/1/2022,KEN,Sabah,0,0,0,Kenya
51848,7/1/2022,KEN,Sarawak,0,0,0,Kenya
51849,7/1/2022,KEN,Selangor,170,90,80,Kenya
51850,7/1/2022,KGZ,Johor,7,3,4,Kyrgyzstan
51851,7/1/2022,KGZ,Kedah,0,0,0,Kyrgyzstan
51852,7/1/2022,KGZ,Kelantan,0,0,0,Kyrgyzstan
51853,7/1/2022,KGZ,Perak,0,0,0,Kyrgyzstan
51854,7/1/2022,KGZ,Perlis,0,0,0,Kyrgyzstan
51855,7/1/2022,KGZ,Pulau Pinang,0,0,0,Kyrgyzstan
51856,7/1/2022,KGZ,Sabah,0,0,0,Kyrgyzstan
51857,7/1/2022,KGZ,Sarawak,0,0,0,Kyrgyzstan
51858,7/1/2022,KGZ,Selangor,136,79,57,Kyrgyzstan
51859,7/1/2022,KHM,Johor,1025,424,601,Cambodia
51860,7/1/2022,KHM,Kedah,997,635,362,Cambodia
51861,7/1/2022,KHM,Kelantan,216,124,92,Cambodia
51862,7/1/2022,KHM,Melaka,1,0,1,Cambodia
51863,7/1/2022,KHM,Negeri Sembilan,0,0,0,Cambodia
51864,7/1/2022,KHM,Pahang,0,0,0,Cambodia
51865,7/1/2022,KHM,Perak,17,16,1,Cambodia
51866,7/1/2022,KHM,Perlis,312,223,89,Cambodia
51867,7/1/2022,KHM,Pulau Pinang,39,16,23,Cambodia
51868,7/1/2022,KHM,Sabah,2,0,2,Cambodia
51869,7/1/2022,KHM,Sarawak,6,5,1,Cambodia
51870,7/1/2022,KHM,Selangor,3060,1468,1592,Cambodia
51871,7/1/2022,KHM,W.P. Labuan,0,0,0,Cambodia
51872,7/1/2022,KIR,Johor,0,0,0,Kiribati
51873,7/1/2022,KIR,Sabah,0,0,0,Kiribati
51874,7/1/2022,KIR,Selangor,1,1,0,Kiribati
51875,7/1/2022,KNA,Johor,26,20,6,Saint Kitts and Nevis
51876,7/1/2022,KNA,Kedah,0,0,0,Saint Kitts and Nevis
51877,7/1/2022,KNA,Perlis,0,0,0,Saint Kitts and Nevis
51878,7/1/2022,KNA,Pulau Pinang,0,0,0,Saint Kitts and Nevis
51879,7/1/2022,KNA,Sabah,0,0,0,Saint Kitts and Nevis
51880,7/1/2022,KNA,Selangor,60,38,22,Saint Kitts and Nevis
51881,7/1/2022,KNA,W.P. Labuan,0,0,0,Saint Kitts and Nevis
51882,7/1/2022,KOR,Johor,8437,4798,3639,"Korea, Republic of (South Korea)"
51883,7/1/2022,KOR,Kedah,84,45,39,"Korea, Republic of (South Korea)"
51884,7/1/2022,KOR,Kelantan,0,0,0,"Korea, Republic of (South Korea)"
51885,7/1/2022,KOR,Melaka,0,0,0,"Korea, Republic of (South Korea)"
51886,7/1/2022,KOR,Negeri Sembilan,1,1,0,"Korea, Republic of (South Korea)"
51887,7/1/2022,KOR,Pahang,0,0,0,"Korea, Republic of (South Korea)"
51888,7/1/2022,KOR,Perak,15,9,6,"Korea, Republic of (South Korea)"
51889,7/1/2022,KOR,Perlis,29,23,6,"Korea, Republic of (South Korea)"
51890,7/1/2022,KOR,Pulau Pinang,416,218,198,"Korea, Republic of (South Korea)"
51891,7/1/2022,KOR,Sabah,8963,3888,5075,"Korea, Republic of (South Korea)"
51892,7/1/2022,KOR,Sarawak,103,60,43,"Korea, Republic of (South Korea)"
51893,7/1/2022,KOR,Selangor,8451,4763,3688,"Korea, Republic of (South Korea)"
51894,7/1/2022,KOR,Terengganu,0,0,0,"Korea, Republic of (South Korea)"
51895,7/1/2022,KOR,W.P. Labuan,0,0,0,"Korea, Republic of (South Korea)"
51896,7/1/2022,KWT,Johor,72,39,33,Kuwait
51897,7/1/2022,KWT,Kedah,46,22,24,Kuwait
51898,7/1/2022,KWT,Kelantan,0,0,0,Kuwait
51899,7/1/2022,KWT,Perak,0,0,0,Kuwait
51900,7/1/2022,KWT,Perlis,3,1,2,Kuwait
51901,7/1/2022,KWT,Pulau Pinang,29,13,16,Kuwait
51902,7/1/2022,KWT,Sabah,0,0,0,Kuwait
51903,7/1/2022,KWT,Sarawak,0,0,0,Kuwait
51904,7/1/2022,KWT,Selangor,782,410,372,Kuwait
51905,7/1/2022,KWT,W.P. Labuan,0,0,0,Kuwait
51906,7/1/2022,LAO,Johor,55,17,38,Lao People's Democratic Republic
51907,7/1/2022,LAO,Kedah,568,83,485,Lao People's Democratic Republic
51908,7/1/2022,LAO,Kelantan,42,2,40,Lao People's Democratic Republic
51909,7/1/2022,LAO,Melaka,0,0,0,Lao People's Democratic Republic
51910,7/1/2022,LAO,Perak,1,1,0,Lao People's Democratic Republic
51911,7/1/2022,LAO,Perlis,51,13,38,Lao People's Democratic Republic
51912,7/1/2022,LAO,Pulau Pinang,53,32,21,Lao People's Democratic Republic
51913,7/1/2022,LAO,Sabah,7,4,3,Lao People's Democratic Republic
51914,7/1/2022,LAO,Sarawak,0,0,0,Lao People's Democratic Republic
51915,7/1/2022,LAO,Selangor,305,93,212,Lao People's Democratic Republic
51916,7/1/2022,LAO,W.P. Labuan,0,0,0,Lao People's Democratic Republic
51917,7/1/2022,LBN,Johor,8,5,3,Lebanon
51918,7/1/2022,LBN,Kedah,0,0,0,Lebanon
51919,7/1/2022,LBN,Kelantan,0,0,0,Lebanon
51920,7/1/2022,LBN,Pahang,0,0,0,Lebanon
51921,7/1/2022,LBN,Perak,0,0,0,Lebanon
51922,7/1/2022,LBN,Perlis,0,0,0,Lebanon
51923,7/1/2022,LBN,Pulau Pinang,1,1,0,Lebanon
51924,7/1/2022,LBN,Sabah,0,0,0,Lebanon
51925,7/1/2022,LBN,Sarawak,1,1,0,Lebanon
51926,7/1/2022,LBN,Selangor,180,116,64,Lebanon
51927,7/1/2022,LBN,W.P. Labuan,0,0,0,Lebanon
51928,7/1/2022,LBR,Johor,3,3,0,Liberia
51929,7/1/2022,LBR,Kedah,0,0,0,Liberia
51930,7/1/2022,LBR,Sabah,0,0,0,Liberia
51931,7/1/2022,LBR,Sarawak,0,0,0,Liberia
51932,7/1/2022,LBR,Selangor,3,3,0,Liberia
51933,7/1/2022,LBY,Johor,2,2,0,Libyan Arab Jamahiriya
51934,7/1/2022,LBY,Kedah,0,0,0,Libyan Arab Jamahiriya
51935,7/1/2022,LBY,Perlis,0,0,0,Libyan Arab Jamahiriya
51936,7/1/2022,LBY,Pulau Pinang,0,0,0,Libyan Arab Jamahiriya
51937,7/1/2022,LBY,Sabah,0,0,0,Libyan Arab Jamahiriya
51938,7/1/2022,LBY,Sarawak,0,0,0,Libyan Arab Jamahiriya
51939,7/1/2022,LBY,Selangor,138,91,47,Libyan Arab Jamahiriya
51940,7/1/2022,LCA,Johor,6,5,1,Saint Lucia
51941,7/1/2022,LCA,Kedah,0,0,0,Saint Lucia
51942,7/1/2022,LCA,Pulau Pinang,0,0,0,Saint Lucia
51943,7/1/2022,LCA,Sarawak,0,0,0,Saint Lucia
51944,7/1/2022,LCA,Selangor,2,2,0,Saint Lucia
51945,7/1/2022,LIE,Johor,2,2,0,Liechtenstein
51946,7/1/2022,LIE,Kedah,0,0,0,Liechtenstein
51947,7/1/2022,LIE,Perlis,0,0,0,Liechtenstein
51948,7/1/2022,LIE,Pulau Pinang,0,0,0,Liechtenstein
51949,7/1/2022,LIE,Sabah,0,0,0,Liechtenstein
51950,7/1/2022,LIE,Sarawak,0,0,0,Liechtenstein
51951,7/1/2022,LIE,Selangor,2,2,0,Liechtenstein
51952,7/1/2022,LKA,Johor,812,569,243,Sri Lanka
51953,7/1/2022,LKA,Kedah,10,7,3,Sri Lanka
51954,7/1/2022,LKA,Kelantan,0,0,0,Sri Lanka
51955,7/1/2022,LKA,Melaka,0,0,0,Sri Lanka
51956,7/1/2022,LKA,Pahang,0,0,0,Sri Lanka
51957,7/1/2022,LKA,Perak,7,5,2,Sri Lanka
51958,7/1/2022,LKA,Perlis,0,0,0,Sri Lanka
51959,7/1/2022,LKA,Pulau Pinang,31,17,14,Sri Lanka
51960,7/1/2022,LKA,Sabah,10,8,2,Sri Lanka
51961,7/1/2022,LKA,Sarawak,9,6,3,Sri Lanka
51962,7/1/2022,LKA,Selangor,2154,1314,840,Sri Lanka
51963,7/1/2022,LKA,W.P. Labuan,0,0,0,Sri Lanka
51964,7/1/2022,LSO,Johor,0,0,0,Lesotho
51965,7/1/2022,LSO,Kedah,0,0,0,Lesotho
51966,7/1/2022,LSO,Pulau Pinang,0,0,0,Lesotho
51967,7/1/2022,LSO,Sarawak,0,0,0,Lesotho
51968,7/1/2022,LSO,Selangor,8,4,4,Lesotho
51969,7/1/2022,LTU,Johor,20,9,11,Lithuania
51970,7/1/2022,LTU,Kedah,1,1,0,Lithuania
51971,7/1/2022,LTU,Kelantan,0,0,0,Lithuania
51972,7/1/2022,LTU,Pahang,0,0,0,Lithuania
51973,7/1/2022,LTU,Perak,0,0,0,Lithuania
51974,7/1/2022,LTU,Perlis,1,0,1,Lithuania
51975,7/1/2022,LTU,Pulau Pinang,0,0,0,Lithuania
51976,7/1/2022,LTU,Sabah,3,2,1,Lithuania
51977,7/1/2022,LTU,Sarawak,1,1,0,Lithuania
51978,7/1/2022,LTU,Selangor,102,53,49,Lithuania
51979,7/1/2022,LTU,W.P. Labuan,0,0,0,Lithuania
51980,7/1/2022,LUX,Johor,13,7,6,Luxembourg
51981,7/1/2022,LUX,Kedah,2,2,0,Luxembourg
51982,7/1/2022,LUX,Kelantan,0,0,0,Luxembourg
51983,7/1/2022,LUX,Perak,0,0,0,Luxembourg
51984,7/1/2022,LUX,Perlis,0,0,0,Luxembourg
51985,7/1/2022,LUX,Pulau Pinang,1,0,1,Luxembourg
51986,7/1/2022,LUX,Sabah,0,0,0,Luxembourg
51987,7/1/2022,LUX,Sarawak,1,1,0,Luxembourg
51988,7/1/2022,LUX,Selangor,29,17,12,Luxembourg
51989,7/1/2022,LVA,Johor,5,1,4,Latvia
51990,7/1/2022,LVA,Kedah,0,0,0,Latvia
51991,7/1/2022,LVA,Kelantan,0,0,0,Latvia
51992,7/1/2022,LVA,Pahang,0,0,0,Latvia
51993,7/1/2022,LVA,Perak,0,0,0,Latvia
51994,7/1/2022,LVA,Perlis,0,0,0,Latvia
51995,7/1/2022,LVA,Pulau Pinang,0,0,0,Latvia
51996,7/1/2022,LVA,Sabah,4,0,4,Latvia
51997,7/1/2022,LVA,Sarawak,1,1,0,Latvia
51998,7/1/2022,LVA,Selangor,36,15,21,Latvia
51999,7/1/2022,LVA,W.P. Labuan,0,0,0,Latvia
52000,7/1/2022,MAC,Johor,0,0,0,Macao
52001,7/1/2022,MAC,Pahang,0,0,0,Macao
52002,7/1/2022,MAC,Perak,0,0,0,Macao
52003,7/1/2022,MAC,Selangor,0,0,0,Macao
52004,7/1/2022,MAC,W.P. Labuan,0,0,0,Macao
52005,7/1/2022,MAR,Johor,58,38,20,Morocco
52006,7/1/2022,MAR,Kedah,2,2,0,Morocco
52007,7/1/2022,MAR,Kelantan,1,1,0,Morocco
52008,7/1/2022,MAR,Melaka,0,0,0,Morocco
52009,7/1/2022,MAR,Pahang,0,0,0,Morocco
52010,7/1/2022,MAR,Perak,0,0,0,Morocco
52011,7/1/2022,MAR,Perlis,2,2,0,Morocco
52012,7/1/2022,MAR,Pulau Pinang,2,2,0,Morocco
52013,7/1/2022,MAR,Sabah,3,1,2,Morocco
52014,7/1/2022,MAR,Sarawak,4,3,1,Morocco
52015,7/1/2022,MAR,Selangor,388,204,184,Morocco
52016,7/1/2022,MAR,W.P. Labuan,0,0,0,Morocco
52017,7/1/2022,MCO,Johor,0,0,0,Monaco
52018,7/1/2022,MCO,Kedah,0,0,0,Monaco
52019,7/1/2022,MCO,Sabah,0,0,0,Monaco
52020,7/1/2022,MCO,Selangor,3,0,3,Monaco
52021,7/1/2022,MDA,Johor,0,0,0,"Moldova, Republic of"
52022,7/1/2022,MDA,Kedah,0,0,0,"Moldova, Republic of"
52023,7/1/2022,MDA,Kelantan,0,0,0,"Moldova, Republic of"
52024,7/1/2022,MDA,Negeri Sembilan,0,0,0,"Moldova, Republic of"
52025,7/1/2022,MDA,Perlis,0,0,0,"Moldova, Republic of"
52026,7/1/2022,MDA,Pulau Pinang,1,0,1,"Moldova, Republic of"
52027,7/1/2022,MDA,Sabah,0,0,0,"Moldova, Republic of"
52028,7/1/2022,MDA,Sarawak,1,0,1,"Moldova, Republic of"
52029,7/1/2022,MDA,Selangor,6,4,2,"Moldova, Republic of"
52030,7/1/2022,MDG,Johor,6,3,3,Madagascar
52031,7/1/2022,MDG,Kedah,0,0,0,Madagascar
52032,7/1/2022,MDG,Perak,0,0,0,Madagascar
52033,7/1/2022,MDG,Perlis,0,0,0,Madagascar
52034,7/1/2022,MDG,Pulau Pinang,0,0,0,Madagascar
52035,7/1/2022,MDG,Sabah,0,0,0,Madagascar
52036,7/1/2022,MDG,Sarawak,0,0,0,Madagascar
52037,7/1/2022,MDG,Selangor,7,4,3,Madagascar
52038,7/1/2022,MDV,Johor,288,143,145,Maldives
52039,7/1/2022,MDV,Kedah,1,1,0,Maldives
52040,7/1/2022,MDV,Kelantan,1,1,0,Maldives
52041,7/1/2022,MDV,Perak,0,0,0,Maldives
52042,7/1/2022,MDV,Perlis,2,2,0,Maldives
52043,7/1/2022,MDV,Pulau Pinang,11,6,5,Maldives
52044,7/1/2022,MDV,Sabah,1,1,0,Maldives
52045,7/1/2022,MDV,Sarawak,1,0,1,Maldives
52046,7/1/2022,MDV,Selangor,4409,2055,2354,Maldives
52047,7/1/2022,MEX,Johor,58,37,21,Mexico
52048,7/1/2022,MEX,Kedah,10,6,4,Mexico
52049,7/1/2022,MEX,Kelantan,0,0,0,Mexico
52050,7/1/2022,MEX,Pahang,0,0,0,Mexico
52051,7/1/2022,MEX,Perak,0,0,0,Mexico
52052,7/1/2022,MEX,Perlis,0,0,0,Mexico
52053,7/1/2022,MEX,Pulau Pinang,33,25,8,Mexico
52054,7/1/2022,MEX,Sabah,3,1,2,Mexico
52055,7/1/2022,MEX,Sarawak,0,0,0,Mexico
52056,7/1/2022,MEX,Selangor,308,170,138,Mexico
52057,7/1/2022,MEX,W.P. Labuan,0,0,0,Mexico
52058,7/1/2022,MHL,Johor,0,0,0,Marshall Islands
52059,7/1/2022,MHL,Kedah,0,0,0,Marshall Islands
52060,7/1/2022,MHL,Perak,0,0,0,Marshall Islands
52061,7/1/2022,MHL,Pulau Pinang,1,1,0,Marshall Islands
52062,7/1/2022,MHL,Sabah,0,0,0,Marshall Islands
52063,7/1/2022,MHL,Selangor,1,1,0,Marshall Islands
52064,7/1/2022,MKD,Johor,4,3,1,"Macedonia, the former Yugoslav Republic of"
52065,7/1/2022,MKD,Kedah,0,0,0,"Macedonia, the former Yugoslav Republic of"
52066,7/1/2022,MKD,Perak,0,0,0,"Macedonia, the former Yugoslav Republic of"
52067,7/1/2022,MKD,Pulau Pinang,0,0,0,"Macedonia, the former Yugoslav Republic of"
52068,7/1/2022,MKD,Sabah,0,0,0,"Macedonia, the former Yugoslav Republic of"
52069,7/1/2022,MKD,Sarawak,0,0,0,"Macedonia, the former Yugoslav Republic of"
52070,7/1/2022,MKD,Selangor,5,2,3,"Macedonia, the former Yugoslav Republic of"
52071,7/1/2022,MLI,Johor,3,3,0,Mali
52072,7/1/2022,MLI,Sabah,0,0,0,Mali
52073,7/1/2022,MLI,Selangor,1,1,0,Mali
52074,7/1/2022,MLT,Johor,5,3,2,Malta
52075,7/1/2022,MLT,Kedah,8,4,4,Malta
52076,7/1/2022,MLT,Kelantan,0,0,0,Malta
52077,7/1/2022,MLT,Perak,0,0,0,Malta
52078,7/1/2022,MLT,Perlis,0,0,0,Malta
52079,7/1/2022,MLT,Pulau Pinang,3,3,0,Malta
52080,7/1/2022,MLT,Sabah,1,1,0,Malta
52081,7/1/2022,MLT,Sarawak,0,0,0,Malta
52082,7/1/2022,MLT,Selangor,51,25,26,Malta
52083,7/1/2022,MLT,W.P. Labuan,0,0,0,Malta
52084,7/1/2022,MMR,Johor,2999,1040,1959,Myanmar
52085,7/1/2022,MMR,Kedah,30,9,21,Myanmar
52086,7/1/2022,MMR,Kelantan,1,1,0,Myanmar
52087,7/1/2022,MMR,Negeri Sembilan,0,0,0,Myanmar
52088,7/1/2022,MMR,Pahang,0,0,0,Myanmar
52089,7/1/2022,MMR,Perak,16,6,10,Myanmar
52090,7/1/2022,MMR,Perlis,5,2,3,Myanmar
52091,7/1/2022,MMR,Pulau Pinang,89,35,54,Myanmar
52092,7/1/2022,MMR,Sabah,12,7,5,Myanmar
52093,7/1/2022,MMR,Sarawak,10,5,5,Myanmar
52094,7/1/2022,MMR,Selangor,4649,2929,1720,Myanmar
52095,7/1/2022,MMR,Terengganu,0,0,0,Myanmar
52096,7/1/2022,MMR,W.P. Labuan,0,0,0,Myanmar
52097,7/1/2022,MNE,Johor,0,0,0,Montenegro
52098,7/1/2022,MNE,Kedah,0,0,0,Montenegro
52099,7/1/2022,MNE,Pulau Pinang,0,0,0,Montenegro
52100,7/1/2022,MNE,Sabah,0,0,0,Montenegro
52101,7/1/2022,MNE,Sarawak,0,0,0,Montenegro
52102,7/1/2022,MNE,Selangor,5,4,1,Montenegro
52103,7/1/2022,MNG,Johor,128,51,77,Mongolia
52104,7/1/2022,MNG,Kedah,0,0,0,Mongolia
52105,7/1/2022,MNG,Kelantan,0,0,0,Mongolia
52106,7/1/2022,MNG,Perak,0,0,0,Mongolia
52107,7/1/2022,MNG,Perlis,0,0,0,Mongolia
52108,7/1/2022,MNG,Pulau Pinang,11,4,7,Mongolia
52109,7/1/2022,MNG,Sabah,6,3,3,Mongolia
52110,7/1/2022,MNG,Sarawak,0,0,0,Mongolia
52111,7/1/2022,MNG,Selangor,209,93,116,Mongolia
52112,7/1/2022,MNP,Selangor,0,0,0,Northern Mariana Islands
52113,7/1/2022,MOZ,Johor,1,1,0,Mozambique
52114,7/1/2022,MOZ,Kedah,0,0,0,Mozambique
52115,7/1/2022,MOZ,Perak,0,0,0,Mozambique
52116,7/1/2022,MOZ,Pulau Pinang,0,0,0,Mozambique
52117,7/1/2022,MOZ,Sabah,0,0,0,Mozambique
52118,7/1/2022,MOZ,Sarawak,0,0,0,Mozambique
52119,7/1/2022,MOZ,Selangor,6,2,4,Mozambique
52120,7/1/2022,MRT,Johor,9,9,0,Mauritania
52121,7/1/2022,MRT,Kedah,0,0,0,Mauritania
52122,7/1/2022,MRT,Pulau Pinang,0,0,0,Mauritania
52123,7/1/2022,MRT,Sabah,0,0,0,Mauritania
52124,7/1/2022,MRT,Sarawak,0,0,0,Mauritania
52125,7/1/2022,MRT,Selangor,9,7,2,Mauritania
52126,7/1/2022,MUS,Johor,69,37,32,Mauritius
52127,7/1/2022,MUS,Kedah,0,0,0,Mauritius
52128,7/1/2022,MUS,Kelantan,2,1,1,Mauritius
52129,7/1/2022,MUS,Pahang,0,0,0,Mauritius
52130,7/1/2022,MUS,Perak,0,0,0,Mauritius
52131,7/1/2022,MUS,Perlis,1,1,0,Mauritius
52132,7/1/2022,MUS,Pulau Pinang,6,4,2,Mauritius
52133,7/1/2022,MUS,Sabah,0,0,0,Mauritius
52134,7/1/2022,MUS,Sarawak,3,1,2,Mauritius
52135,7/1/2022,MUS,Selangor,233,115,118,Mauritius
52136,7/1/2022,MWI,Johor,1,0,1,Malawi
52137,7/1/2022,MWI,Pulau Pinang,0,0,0,Malawi
52138,7/1/2022,MWI,Sabah,0,0,0,Malawi
52139,7/1/2022,MWI,Sarawak,0,0,0,Malawi
52140,7/1/2022,MWI,Selangor,11,9,2,Malawi
52141,7/1/2022,MYT,Selangor,0,0,0,Mayotte
52142,7/1/2022,NAM,Johor,1,0,1,Namibia
52143,7/1/2022,NAM,Kedah,0,0,0,Namibia
52144,7/1/2022,NAM,Perak,0,0,0,Namibia
52145,7/1/2022,NAM,Perlis,0,0,0,Namibia
52146,7/1/2022,NAM,Pulau Pinang,1,0,1,Namibia
52147,7/1/2022,NAM,Sabah,0,0,0,Namibia
52148,7/1/2022,NAM,Sarawak,0,0,0,Namibia
52149,7/1/2022,NAM,Selangor,4,1,3,Namibia
52150,7/1/2022,NCL,Selangor,0,0,0,New Caledonia
52151,7/1/2022,NER,Johor,0,0,0,Niger
52152,7/1/2022,NER,Sabah,0,0,0,Niger
52153,7/1/2022,NER,Selangor,2,0,2,Niger
52154,7/1/2022,NGA,Johor,13,11,2,Nigeria
52155,7/1/2022,NGA,Kedah,1,1,0,Nigeria
52156,7/1/2022,NGA,Perlis,0,0,0,Nigeria
52157,7/1/2022,NGA,Pulau Pinang,4,3,1,Nigeria
52158,7/1/2022,NGA,Sabah,0,0,0,Nigeria
52159,7/1/2022,NGA,Sarawak,5,3,2,Nigeria
52160,7/1/2022,NGA,Selangor,265,191,74,Nigeria
52161,7/1/2022,NIC,Johor,1,1,0,Nicaragua
52162,7/1/2022,NIC,Kedah,0,0,0,Nicaragua
52163,7/1/2022,NIC,Pulau Pinang,0,0,0,Nicaragua
52164,7/1/2022,NIC,Sabah,0,0,0,Nicaragua
52165,7/1/2022,NIC,Selangor,5,2,3,Nicaragua
52166,7/1/2022,NLD,Johor,1048,617,431,Netherlands
52167,7/1/2022,NLD,Kedah,113,65,48,Netherlands
52168,7/1/2022,NLD,Kelantan,5,2,3,Netherlands
52169,7/1/2022,NLD,Melaka,0,0,0,Netherlands
52170,7/1/2022,NLD,Negeri Sembilan,0,0,0,Netherlands
52171,7/1/2022,NLD,Pahang,0,0,0,Netherlands
52172,7/1/2022,NLD,Perak,18,8,10,Netherlands
52173,7/1/2022,NLD,Perlis,27,16,11,Netherlands
52174,7/1/2022,NLD,Pulau Pinang,207,122,85,Netherlands
52175,7/1/2022,NLD,Sabah,107,52,55,Netherlands
52176,7/1/2022,NLD,Sarawak,121,62,59,Netherlands
52177,7/1/2022,NLD,Selangor,4552,2519,2033,Netherlands
52178,7/1/2022,NLD,Terengganu,0,0,0,Netherlands
52179,7/1/2022,NLD,W.P. Labuan,0,0,0,Netherlands
52180,7/1/2022,NOR,Johor,186,125,61,Norway
52181,7/1/2022,NOR,Kedah,28,15,13,Norway
52182,7/1/2022,NOR,Kelantan,0,0,0,Norway
52183,7/1/2022,NOR,Melaka,0,0,0,Norway
52184,7/1/2022,NOR,Pahang,0,0,0,Norway
52185,7/1/2022,NOR,Perak,0,0,0,Norway
52186,7/1/2022,NOR,Perlis,1,0,1,Norway
52187,7/1/2022,NOR,Pulau Pinang,31,17,14,Norway
52188,7/1/2022,NOR,Sabah,27,17,10,Norway
52189,7/1/2022,NOR,Sarawak,7,3,4,Norway
52190,7/1/2022,NOR,Selangor,684,389,295,Norway
52191,7/1/2022,NOR,W.P. Labuan,0,0,0,Norway
52192,7/1/2022,NPL,Johor,477,431,46,Nepal
52193,7/1/2022,NPL,Kedah,2,1,1,Nepal
52194,7/1/2022,NPL,Pahang,0,0,0,Nepal
52195,7/1/2022,NPL,Perak,1,1,0,Nepal
52196,7/1/2022,NPL,Perlis,1,1,0,Nepal
52197,7/1/2022,NPL,Pulau Pinang,10,7,3,Nepal
52198,7/1/2022,NPL,Sabah,17,12,5,Nepal
52199,7/1/2022,NPL,Sarawak,1,1,0,Nepal
52200,7/1/2022,NPL,Selangor,18711,17944,767,Nepal
52201,7/1/2022,NPL,W.P. Labuan,0,0,0,Nepal
52202,7/1/2022,NRU,Johor,0,0,0,Nauru
52203,7/1/2022,NRU,Pulau Pinang,0,0,0,Nauru
52204,7/1/2022,NRU,Selangor,1,0,1,Nauru
52205,7/1/2022,NZL,Johor,499,340,159,New Zealand
52206,7/1/2022,NZL,Kedah,41,25,16,New Zealand
52207,7/1/2022,NZL,Kelantan,1,1,0,New Zealand
52208,7/1/2022,NZL,Melaka,0,0,0,New Zealand
52209,7/1/2022,NZL,Negeri Sembilan,0,0,0,New Zealand
52210,7/1/2022,NZL,Pahang,1,0,1,New Zealand
52211,7/1/2022,NZL,Perak,15,13,2,New Zealand
52212,7/1/2022,NZL,Perlis,3,2,1,New Zealand
52213,7/1/2022,NZL,Pulau Pinang,115,62,53,New Zealand
52214,7/1/2022,NZL,Sabah,60,35,25,New Zealand
52215,7/1/2022,NZL,Sarawak,48,28,20,New Zealand
52216,7/1/2022,NZL,Selangor,1564,905,659,New Zealand
52217,7/1/2022,NZL,Terengganu,0,0,0,New Zealand
52218,7/1/2022,NZL,W.P. Labuan,0,0,0,New Zealand
52219,7/1/2022,OMN,Johor,204,91,113,Oman
52220,7/1/2022,OMN,Kedah,4,1,3,Oman
52221,7/1/2022,OMN,Kelantan,0,0,0,Oman
52222,7/1/2022,OMN,Melaka,0,0,0,Oman
52223,7/1/2022,OMN,Perak,0,0,0,Oman
52224,7/1/2022,OMN,Perlis,1,1,0,Oman
52225,7/1/2022,OMN,Pulau Pinang,8,5,3,Oman
52226,7/1/2022,OMN,Sabah,0,0,0,Oman
52227,7/1/2022,OMN,Sarawak,0,0,0,Oman
52228,7/1/2022,OMN,Selangor,1212,638,574,Oman
52229,7/1/2022,PAK,Johor,813,551,262,Pakistan
52230,7/1/2022,PAK,Kedah,103,66,37,Pakistan
52231,7/1/2022,PAK,Kelantan,12,12,0,Pakistan
52232,7/1/2022,PAK,Melaka,1,1,0,Pakistan
52233,7/1/2022,PAK,Negeri Sembilan,0,0,0,Pakistan
52234,7/1/2022,PAK,Pahang,0,0,0,Pakistan
52235,7/1/2022,PAK,Perak,1,1,0,Pakistan
52236,7/1/2022,PAK,Perlis,5,5,0,Pakistan
52237,7/1/2022,PAK,Pulau Pinang,24,18,6,Pakistan
52238,7/1/2022,PAK,Sabah,17,11,6,Pakistan
52239,7/1/2022,PAK,Sarawak,5,5,0,Pakistan
52240,7/1/2022,PAK,Selangor,8292,6636,1656,Pakistan
52241,7/1/2022,PAK,W.P. Labuan,0,0,0,Pakistan
52242,7/1/2022,PAN,Johor,0,0,0,Panama
52243,7/1/2022,PAN,Kedah,0,0,0,Panama
52244,7/1/2022,PAN,Perak,0,0,0,Panama
52245,7/1/2022,PAN,Perlis,0,0,0,Panama
52246,7/1/2022,PAN,Pulau Pinang,2,1,1,Panama
52247,7/1/2022,PAN,Sabah,0,0,0,Panama
52248,7/1/2022,PAN,Sarawak,0,0,0,Panama
52249,7/1/2022,PAN,Selangor,6,2,4,Panama
52250,7/1/2022,PER,Johor,27,14,13,Peru
52251,7/1/2022,PER,Kedah,2,2,0,Peru
52252,7/1/2022,PER,Kelantan,0,0,0,Peru
52253,7/1/2022,PER,Pahang,0,0,0,Peru
52254,7/1/2022,PER,Perak,0,0,0,Peru
52255,7/1/2022,PER,Perlis,0,0,0,Peru
52256,7/1/2022,PER,Pulau Pinang,0,0,0,Peru
52257,7/1/2022,PER,Sabah,0,0,0,Peru
52258,7/1/2022,PER,Sarawak,0,0,0,Peru
52259,7/1/2022,PER,Selangor,58,29,29,Peru
52260,7/1/2022,PER,W.P. Labuan,0,0,0,Peru
52261,7/1/2022,PHL,Johor,13058,4163,8895,Philippines
52262,7/1/2022,PHL,Kedah,231,92,139,Philippines
52263,7/1/2022,PHL,Kelantan,15,5,10,Philippines
52264,7/1/2022,PHL,Melaka,2,1,1,Philippines
52265,7/1/2022,PHL,Negeri Sembilan,0,0,0,Philippines
52266,7/1/2022,PHL,Pahang,7,4,3,Philippines
52267,7/1/2022,PHL,Perak,39,13,26,Philippines
52268,7/1/2022,PHL,Perlis,122,35,87,Philippines
52269,7/1/2022,PHL,Pulau Pinang,652,266,386,Philippines
52270,7/1/2022,PHL,Sabah,597,222,375,Philippines
52271,7/1/2022,PHL,Sarawak,178,96,82,Philippines
52272,7/1/2022,PHL,Selangor,11204,4467,6737,Philippines
52273,7/1/2022,PHL,Terengganu,0,0,0,Philippines
52274,7/1/2022,PHL,W.P. Labuan,3,3,0,Philippines
52275,7/1/2022,PLW,Johor,0,0,0,Palau
52276,7/1/2022,PLW,Pulau Pinang,0,0,0,Palau
52277,7/1/2022,PLW,Selangor,1,1,0,Palau
52278,7/1/2022,PNG,Johor,10,7,3,Papua New Guinea
52279,7/1/2022,PNG,Kedah,1,1,0,Papua New Guinea
52280,7/1/2022,PNG,Kelantan,0,0,0,Papua New Guinea
52281,7/1/2022,PNG,Perak,0,0,0,Papua New Guinea
52282,7/1/2022,PNG,Pulau Pinang,0,0,0,Papua New Guinea
52283,7/1/2022,PNG,Sabah,0,0,0,Papua New Guinea
52284,7/1/2022,PNG,Sarawak,1,0,1,Papua New Guinea
52285,7/1/2022,PNG,Selangor,46,31,15,Papua New Guinea
52286,7/1/2022,POL,Johor,256,149,107,Poland
52287,7/1/2022,POL,Kedah,13,6,7,Poland
52288,7/1/2022,POL,Kelantan,0,0,0,Poland
52289,7/1/2022,POL,Melaka,0,0,0,Poland
52290,7/1/2022,POL,Negeri Sembilan,0,0,0,Poland
52291,7/1/2022,POL,Pahang,0,0,0,Poland
52292,7/1/2022,POL,Perak,1,0,1,Poland
52293,7/1/2022,POL,Perlis,8,6,2,Poland
52294,7/1/2022,POL,Pulau Pinang,24,11,13,Poland
52295,7/1/2022,POL,Sabah,37,19,18,Poland
52296,7/1/2022,POL,Sarawak,23,11,12,Poland
52297,7/1/2022,POL,Selangor,582,277,305,Poland
52298,7/1/2022,POL,Terengganu,0,0,0,Poland
52299,7/1/2022,POL,W.P. Labuan,0,0,0,Poland
52300,7/1/2022,PRK,Selangor,0,0,0,"Korea, Democratic People's Republic of"
52301,7/1/2022,PRT,Johor,92,51,41,Portugal
52302,7/1/2022,PRT,Kedah,9,5,4,Portugal
52303,7/1/2022,PRT,Kelantan,0,0,0,Portugal
52304,7/1/2022,PRT,Melaka,0,0,0,Portugal
52305,7/1/2022,PRT,Pahang,0,0,0,Portugal
52306,7/1/2022,PRT,Perak,4,3,1,Portugal
52307,7/1/2022,PRT,Perlis,4,0,4,Portugal
52308,7/1/2022,PRT,Pulau Pinang,22,17,5,Portugal
52309,7/1/2022,PRT,Sabah,7,2,5,Portugal
52310,7/1/2022,PRT,Sarawak,1,0,1,Portugal
52311,7/1/2022,PRT,Selangor,575,305,270,Portugal
52312,7/1/2022,PRT,W.P. Labuan,0,0,0,Portugal
52313,7/1/2022,PRY,Johor,4,3,1,Paraguay
52314,7/1/2022,PRY,Kedah,0,0,0,Paraguay
52315,7/1/2022,PRY,Perak,0,0,0,Paraguay
52316,7/1/2022,PRY,Perlis,0,0,0,Paraguay
52317,7/1/2022,PRY,Pulau Pinang,0,0,0,Paraguay
52318,7/1/2022,PRY,Sabah,0,0,0,Paraguay
52319,7/1/2022,PRY,Sarawak,0,0,0,Paraguay
52320,7/1/2022,PRY,Selangor,5,3,2,Paraguay
52321,7/1/2022,PSE,Johor,3,2,1,"Palestinian Territory, Occupied"
52322,7/1/2022,PSE,Kedah,5,2,3,"Palestinian Territory, Occupied"
52323,7/1/2022,PSE,Kelantan,0,0,0,"Palestinian Territory, Occupied"
52324,7/1/2022,PSE,Melaka,0,0,0,"Palestinian Territory, Occupied"
52325,7/1/2022,PSE,Perak,0,0,0,"Palestinian Territory, Occupied"
52326,7/1/2022,PSE,Perlis,0,0,0,"Palestinian Territory, Occupied"
52327,7/1/2022,PSE,Pulau Pinang,0,0,0,"Palestinian Territory, Occupied"
52328,7/1/2022,PSE,Sabah,1,1,0,"Palestinian Territory, Occupied"
52329,7/1/2022,PSE,Sarawak,0,0,0,"Palestinian Territory, Occupied"
52330,7/1/2022,PSE,Selangor,224,143,81,"Palestinian Territory, Occupied"
52331,7/1/2022,QAT,Johor,75,33,42,Qatar
52332,7/1/2022,QAT,Kedah,1,0,1,Qatar
52333,7/1/2022,QAT,Perlis,0,0,0,Qatar
52334,7/1/2022,QAT,Pulau Pinang,1,1,0,Qatar
52335,7/1/2022,QAT,Sabah,0,0,0,Qatar
52336,7/1/2022,QAT,Sarawak,0,0,0,Qatar
52337,7/1/2022,QAT,Selangor,439,211,228,Qatar
52338,7/1/2022,REU,Johor,0,0,0,Reunion
52339,7/1/2022,REU,Sarawak,0,0,0,Reunion
52340,7/1/2022,ROU,Johor,107,55,52,Romania
52341,7/1/2022,ROU,Kedah,2,1,1,Romania
52342,7/1/2022,ROU,Kelantan,1,0,1,Romania
52343,7/1/2022,ROU,Negeri Sembilan,0,0,0,Romania
52344,7/1/2022,ROU,Pahang,0,0,0,Romania
52345,7/1/2022,ROU,Perak,0,0,0,Romania
52346,7/1/2022,ROU,Perlis,1,1,0,Romania
52347,7/1/2022,ROU,Pulau Pinang,14,9,5,Romania
52348,7/1/2022,ROU,Sabah,4,2,2,Romania
52349,7/1/2022,ROU,Sarawak,1,0,1,Romania
52350,7/1/2022,ROU,Selangor,297,177,120,Romania
52351,7/1/2022,ROU,W.P. Labuan,0,0,0,Romania
52352,7/1/2022,RUS,Johor,271,139,132,Russia
52353,7/1/2022,RUS,Kedah,56,27,29,Russia
52354,7/1/2022,RUS,Kelantan,4,2,2,Russia
52355,7/1/2022,RUS,Melaka,1,1,0,Russia
52356,7/1/2022,RUS,Negeri Sembilan,0,0,0,Russia
52357,7/1/2022,RUS,Pahang,0,0,0,Russia
52358,7/1/2022,RUS,Perak,1,1,0,Russia
52359,7/1/2022,RUS,Perlis,6,2,4,Russia
52360,7/1/2022,RUS,Pulau Pinang,37,17,20,Russia
52361,7/1/2022,RUS,Sabah,22,8,14,Russia
52362,7/1/2022,RUS,Sarawak,8,3,5,Russia
52363,7/1/2022,RUS,Selangor,1664,861,803,Russia
52364,7/1/2022,RUS,W.P. Labuan,0,0,0,Russia
52365,7/1/2022,RWA,Johor,1,1,0,Rwanda
52366,7/1/2022,RWA,Kedah,0,0,0,Rwanda
52367,7/1/2022,RWA,Pulau Pinang,0,0,0,Rwanda
52368,7/1/2022,RWA,Selangor,1,1,0,Rwanda
52369,7/1/2022,SAU,Johor,255,145,110,Saudi Arabia
52370,7/1/2022,SAU,Kedah,66,35,31,Saudi Arabia
52371,7/1/2022,SAU,Kelantan,4,3,1,Saudi Arabia
52372,7/1/2022,SAU,Melaka,0,0,0,Saudi Arabia
52373,7/1/2022,SAU,Perak,3,2,1,Saudi Arabia
52374,7/1/2022,SAU,Perlis,4,3,1,Saudi Arabia
52375,7/1/2022,SAU,Pulau Pinang,67,28,39,Saudi Arabia
52376,7/1/2022,SAU,Sabah,11,10,1,Saudi Arabia
52377,7/1/2022,SAU,Sarawak,5,4,1,Saudi Arabia
52378,7/1/2022,SAU,Selangor,9163,4578,4585,Saudi Arabia
52379,7/1/2022,SAU,W.P. Labuan,0,0,0,Saudi Arabia
52380,7/1/2022,SDN,Johor,8,5,3,Sudan
52381,7/1/2022,SDN,Kedah,1,1,0,Sudan
52382,7/1/2022,SDN,Kelantan,0,0,0,Sudan
52383,7/1/2022,SDN,Perlis,0,0,0,Sudan
52384,7/1/2022,SDN,Pulau Pinang,0,0,0,Sudan
52385,7/1/2022,SDN,Sabah,0,0,0,Sudan
52386,7/1/2022,SDN,Sarawak,0,0,0,Sudan
52387,7/1/2022,SDN,Selangor,905,458,447,Sudan
52388,7/1/2022,SDN,W.P. Labuan,0,0,0,Sudan
52389,7/1/2022,SEN,Johor,0,0,0,Senegal
52390,7/1/2022,SEN,Kedah,0,0,0,Senegal
52391,7/1/2022,SEN,Kelantan,1,1,0,Senegal
52392,7/1/2022,SEN,Perak,0,0,0,Senegal
52393,7/1/2022,SEN,Perlis,0,0,0,Senegal
52394,7/1/2022,SEN,Pulau Pinang,0,0,0,Senegal
52395,7/1/2022,SEN,Sabah,0,0,0,Senegal
52396,7/1/2022,SEN,Sarawak,1,1,0,Senegal
52397,7/1/2022,SEN,Selangor,15,13,2,Senegal
52398,7/1/2022,SGP,Johor,931641,555703,375938,Singapore
52399,7/1/2022,SGP,Kedah,2168,1165,1003,Singapore
52400,7/1/2022,SGP,Kelantan,25,13,12,Singapore
52401,7/1/2022,SGP,Melaka,11,4,7,Singapore
52402,7/1/2022,SGP,Negeri Sembilan,3,3,0,Singapore
52403,7/1/2022,SGP,Pahang,39,31,8,Singapore
52404,7/1/2022,SGP,Perak,3645,1723,1922,Singapore
52405,7/1/2022,SGP,Perlis,55,36,19,Singapore
52406,7/1/2022,SGP,Pulau Pinang,12524,6227,6297,Singapore
52407,7/1/2022,SGP,Sabah,1941,1063,878,Singapore
52408,7/1/2022,SGP,Sarawak,2439,1466,973,Singapore
52409,7/1/2022,SGP,Selangor,25819,13936,11883,Singapore
52410,7/1/2022,SGP,Terengganu,0,0,0,Singapore
52411,7/1/2022,SGP,W.P. Labuan,0,0,0,Singapore
52412,7/1/2022,SGS,Johor,0,0,0,South Georgia and the South Sandwich Islands
52413,7/1/2022,SGS,Sabah,0,0,0,South Georgia and the South Sandwich Islands
52414,7/1/2022,SGS,Selangor,1,1,0,South Georgia and the South Sandwich Islands
52415,7/1/2022,SHN,Sarawak,0,0,0,"Saint Helena, Ascension and Tristan da Cunha"
52416,7/1/2022,SLB,Johor,1,1,0,Solomon Islands
52417,7/1/2022,SLB,Perlis,0,0,0,Solomon Islands
52418,7/1/2022,SLB,Pulau Pinang,0,0,0,Solomon Islands
52419,7/1/2022,SLB,Sabah,0,0,0,Solomon Islands
52420,7/1/2022,SLB,Sarawak,0,0,0,Solomon Islands
52421,7/1/2022,SLB,Selangor,6,3,3,Solomon Islands
52422,7/1/2022,SLB,W.P. Labuan,0,0,0,Solomon Islands
52423,7/1/2022,SLE,Johor,1,1,0,Sierra Leone
52424,7/1/2022,SLE,Kedah,0,0,0,Sierra Leone
52425,7/1/2022,SLE,Perak,0,0,0,Sierra Leone
52426,7/1/2022,SLE,Pulau Pinang,1,1,0,Sierra Leone
52427,7/1/2022,SLE,Sabah,0,0,0,Sierra Leone
52428,7/1/2022,SLE,Selangor,13,11,2,Sierra Leone
52429,7/1/2022,SLV,Johor,0,0,0,El Salvador
52430,7/1/2022,SLV,Kedah,0,0,0,El Salvador
52431,7/1/2022,SLV,Perak,0,0,0,El Salvador
52432,7/1/2022,SLV,Perlis,0,0,0,El Salvador
52433,7/1/2022,SLV,Pulau Pinang,1,1,0,El Salvador
52434,7/1/2022,SLV,Sabah,0,0,0,El Salvador
52435,7/1/2022,SLV,Selangor,0,0,0,El Salvador
52436,7/1/2022,SLV,W.P. Labuan,0,0,0,El Salvador
52437,7/1/2022,SMR,Johor,0,0,0,San Marino
52438,7/1/2022,SMR,Selangor,0,0,0,San Marino
52439,7/1/2022,SOM,Johor,0,0,0,Somalia
52440,7/1/2022,SOM,Kedah,0,0,0,Somalia
52441,7/1/2022,SOM,Kelantan,0,0,0,Somalia
52442,7/1/2022,SOM,Perlis,0,0,0,Somalia
52443,7/1/2022,SOM,Sabah,0,0,0,Somalia
52444,7/1/2022,SOM,Sarawak,0,0,0,Somalia
52445,7/1/2022,SOM,Selangor,123,60,63,Somalia
52446,7/1/2022,SRB,Johor,6,2,4,Serbia
52447,7/1/2022,SRB,Kedah,0,0,0,Serbia
52448,7/1/2022,SRB,Kelantan,1,1,0,Serbia
52449,7/1/2022,SRB,Pahang,0,0,0,Serbia
52450,7/1/2022,SRB,Perak,0,0,0,Serbia
52451,7/1/2022,SRB,Perlis,0,0,0,Serbia
52452,7/1/2022,SRB,Pulau Pinang,0,0,0,Serbia
52453,7/1/2022,SRB,Sabah,0,0,0,Serbia
52454,7/1/2022,SRB,Sarawak,0,0,0,Serbia
52455,7/1/2022,SRB,Selangor,33,23,10,Serbia
52456,7/1/2022,STP,Selangor,1,0,1,Sao Tome and Principe
52457,7/1/2022,SUR,Johor,1,1,0,Suriname
52458,7/1/2022,SUR,Kedah,0,0,0,Suriname
52459,7/1/2022,SUR,Kelantan,0,0,0,Suriname
52460,7/1/2022,SUR,Perak,0,0,0,Suriname
52461,7/1/2022,SUR,Perlis,0,0,0,Suriname
52462,7/1/2022,SUR,Pulau Pinang,0,0,0,Suriname
52463,7/1/2022,SUR,Sabah,0,0,0,Suriname
52464,7/1/2022,SUR,Sarawak,0,0,0,Suriname
52465,7/1/2022,SUR,Selangor,4,2,2,Suriname
52466,7/1/2022,SVK,Johor,21,11,10,Slovakia
52467,7/1/2022,SVK,Kedah,39,20,19,Slovakia
52468,7/1/2022,SVK,Kelantan,0,0,0,Slovakia
52469,7/1/2022,SVK,Negeri Sembilan,0,0,0,Slovakia
52470,7/1/2022,SVK,Pahang,0,0,0,Slovakia
52471,7/1/2022,SVK,Perak,0,0,0,Slovakia
52472,7/1/2022,SVK,Perlis,0,0,0,Slovakia
52473,7/1/2022,SVK,Pulau Pinang,5,4,1,Slovakia
52474,7/1/2022,SVK,Sabah,1,0,1,Slovakia
52475,7/1/2022,SVK,Sarawak,2,0,2,Slovakia
52476,7/1/2022,SVK,Selangor,216,117,99,Slovakia
52477,7/1/2022,SVK,W.P. Labuan,0,0,0,Slovakia
52478,7/1/2022,SVN,Johor,10,9,1,Slovenia
52479,7/1/2022,SVN,Kedah,0,0,0,Slovenia
52480,7/1/2022,SVN,Kelantan,1,1,0,Slovenia
52481,7/1/2022,SVN,Perak,0,0,0,Slovenia
52482,7/1/2022,SVN,Perlis,0,0,0,Slovenia
52483,7/1/2022,SVN,Pulau Pinang,1,1,0,Slovenia
52484,7/1/2022,SVN,Sabah,6,3,3,Slovenia
52485,7/1/2022,SVN,Sarawak,9,6,3,Slovenia
52486,7/1/2022,SVN,Selangor,80,50,30,Slovenia
52487,7/1/2022,SVN,W.P. Labuan,0,0,0,Slovenia
52488,7/1/2022,SWE,Johor,166,107,59,Sweden
52489,7/1/2022,SWE,Kedah,30,23,7,Sweden
52490,7/1/2022,SWE,Kelantan,24,11,13,Sweden
52491,7/1/2022,SWE,Melaka,0,0,0,Sweden
52492,7/1/2022,SWE,Negeri Sembilan,0,0,0,Sweden
52493,7/1/2022,SWE,Pahang,0,0,0,Sweden
52494,7/1/2022,SWE,Perak,7,3,4,Sweden
52495,7/1/2022,SWE,Perlis,11,8,3,Sweden
52496,7/1/2022,SWE,Pulau Pinang,38,23,15,Sweden
52497,7/1/2022,SWE,Sabah,33,21,12,Sweden
52498,7/1/2022,SWE,Sarawak,8,5,3,Sweden
52499,7/1/2022,SWE,Selangor,683,416,267,Sweden
52500,7/1/2022,SWE,W.P. Labuan,0,0,0,Sweden
52501,7/1/2022,SWZ,Johor,0,0,0,Swaziland
52502,7/1/2022,SWZ,Kedah,0,0,0,Swaziland
52503,7/1/2022,SWZ,Pulau Pinang,0,0,0,Swaziland
52504,7/1/2022,SWZ,Sabah,0,0,0,Swaziland
52505,7/1/2022,SWZ,Selangor,11,5,6,Swaziland
52506,7/1/2022,SYC,Johor,1,0,1,Seychelles
52507,7/1/2022,SYC,Kedah,0,0,0,Seychelles
52508,7/1/2022,SYC,Pulau Pinang,0,0,0,Seychelles
52509,7/1/2022,SYC,Sabah,0,0,0,Seychelles
52510,7/1/2022,SYC,Sarawak,2,1,1,Seychelles
52511,7/1/2022,SYC,Selangor,41,19,22,Seychelles
52512,7/1/2022,SYR,Johor,11,5,6,Syrian Arab Republic
52513,7/1/2022,SYR,Kedah,0,0,0,Syrian Arab Republic
52514,7/1/2022,SYR,Kelantan,0,0,0,Syrian Arab Republic
52515,7/1/2022,SYR,Pahang,0,0,0,Syrian Arab Republic
52516,7/1/2022,SYR,Perlis,0,0,0,Syrian Arab Republic
52517,7/1/2022,SYR,Pulau Pinang,2,2,0,Syrian Arab Republic
52518,7/1/2022,SYR,Sabah,0,0,0,Syrian Arab Republic
52519,7/1/2022,SYR,Sarawak,4,2,2,Syrian Arab Republic
52520,7/1/2022,SYR,Selangor,541,305,236,Syrian Arab Republic
52521,7/1/2022,SYR,W.P. Labuan,0,0,0,Syrian Arab Republic
52522,7/1/2022,TCA,Perlis,0,0,0,Turks and Caicos
52523,7/1/2022,TCD,Johor,0,0,0,Chad
52524,7/1/2022,TCD,Kedah,0,0,0,Chad
52525,7/1/2022,TCD,Perlis,0,0,0,Chad
52526,7/1/2022,TCD,Selangor,11,8,3,Chad
52527,7/1/2022,TGO,Johor,0,0,0,Togo
52528,7/1/2022,TGO,Perak,0,0,0,Togo
52529,7/1/2022,TGO,Pulau Pinang,0,0,0,Togo
52530,7/1/2022,TGO,Selangor,1,1,0,Togo
52531,7/1/2022,THA,Johor,3762,904,2858,Thailand
52532,7/1/2022,THA,Kedah,44100,26582,17518,Thailand
52533,7/1/2022,THA,Kelantan,15453,7350,8103,Thailand
52534,7/1/2022,THA,Melaka,1,0,1,Thailand
52535,7/1/2022,THA,Negeri Sembilan,0,0,0,Thailand
52536,7/1/2022,THA,Pahang,9,9,0,Thailand
52537,7/1/2022,THA,Perak,5468,2425,3043,Thailand
52538,7/1/2022,THA,Perlis,49284,30984,18300,Thailand
52539,7/1/2022,THA,Pulau Pinang,1827,815,1012,Thailand
52540,7/1/2022,THA,Sabah,172,67,105,Thailand
52541,7/1/2022,THA,Sarawak,47,25,22,Thailand
52542,7/1/2022,THA,Selangor,8969,3690,5279,Thailand
52543,7/1/2022,THA,Terengganu,0,0,0,Thailand
52544,7/1/2022,THA,W.P. Labuan,0,0,0,Thailand
52545,7/1/2022,TJK,Johor,0,0,0,Tajikistan
52546,7/1/2022,TJK,Kedah,1,1,0,Tajikistan
52547,7/1/2022,TJK,Perlis,0,0,0,Tajikistan
52548,7/1/2022,TJK,Pulau Pinang,0,0,0,Tajikistan
52549,7/1/2022,TJK,Sabah,1,1,0,Tajikistan
52550,7/1/2022,TJK,Selangor,77,46,31,Tajikistan
52551,7/1/2022,TKL,Selangor,0,0,0,Tokelau
52552,7/1/2022,TKM,Johor,1,1,0,Turkmenistan
52553,7/1/2022,TKM,Kedah,0,0,0,Turkmenistan
52554,7/1/2022,TKM,Kelantan,0,0,0,Turkmenistan
52555,7/1/2022,TKM,Perlis,0,0,0,Turkmenistan
52556,7/1/2022,TKM,Pulau Pinang,0,0,0,Turkmenistan
52557,7/1/2022,TKM,Sabah,0,0,0,Turkmenistan
52558,7/1/2022,TKM,Sarawak,0,0,0,Turkmenistan
52559,7/1/2022,TKM,Selangor,71,37,34,Turkmenistan
52560,7/1/2022,TLS,Johor,21,20,1,Timor-Leste
52561,7/1/2022,TLS,Kedah,0,0,0,Timor-Leste
52562,7/1/2022,TLS,Perlis,0,0,0,Timor-Leste
52563,7/1/2022,TLS,Pulau Pinang,0,0,0,Timor-Leste
52564,7/1/2022,TLS,Sabah,0,0,0,Timor-Leste
52565,7/1/2022,TLS,Sarawak,0,0,0,Timor-Leste
52566,7/1/2022,TLS,Selangor,457,311,146,Timor-Leste
52567,7/1/2022,TON,Johor,1,0,1,Tonga
52568,7/1/2022,TON,Pulau Pinang,2,0,2,Tonga
52569,7/1/2022,TON,Sarawak,0,0,0,Tonga
52570,7/1/2022,TON,Selangor,6,2,4,Tonga
52571,7/1/2022,TTO,Johor,2,0,2,Trinidad and Tobago
52572,7/1/2022,TTO,Kedah,0,0,0,Trinidad and Tobago
52573,7/1/2022,TTO,Pahang,0,0,0,Trinidad and Tobago
52574,7/1/2022,TTO,Pulau Pinang,2,0,2,Trinidad and Tobago
52575,7/1/2022,TTO,Sabah,0,0,0,Trinidad and Tobago
52576,7/1/2022,TTO,Sarawak,0,0,0,Trinidad and Tobago
52577,7/1/2022,TTO,Selangor,17,9,8,Trinidad and Tobago
52578,7/1/2022,TUN,Johor,2,1,1,Tunisia
52579,7/1/2022,TUN,Kedah,0,0,0,Tunisia
52580,7/1/2022,TUN,Kelantan,5,3,2,Tunisia
52581,7/1/2022,TUN,Melaka,0,0,0,Tunisia
52582,7/1/2022,TUN,Perak,0,0,0,Tunisia
52583,7/1/2022,TUN,Perlis,0,0,0,Tunisia
52584,7/1/2022,TUN,Pulau Pinang,0,0,0,Tunisia
52585,7/1/2022,TUN,Sabah,2,2,0,Tunisia
52586,7/1/2022,TUN,Sarawak,0,0,0,Tunisia
52587,7/1/2022,TUN,Selangor,307,148,159,Tunisia
52588,7/1/2022,TUN,W.P. Labuan,0,0,0,Tunisia
52589,7/1/2022,TUR,Johor,200,130,70,Turkey
52590,7/1/2022,TUR,Kedah,10,6,4,Turkey
52591,7/1/2022,TUR,Kelantan,4,4,0,Turkey
52592,7/1/2022,TUR,Melaka,0,0,0,Turkey
52593,7/1/2022,TUR,Negeri Sembilan,0,0,0,Turkey
52594,7/1/2022,TUR,Pahang,0,0,0,Turkey
52595,7/1/2022,TUR,Perak,1,1,0,Turkey
52596,7/1/2022,TUR,Perlis,1,0,1,Turkey
52597,7/1/2022,TUR,Pulau Pinang,19,13,6,Turkey
52598,7/1/2022,TUR,Sabah,2,1,1,Turkey
52599,7/1/2022,TUR,Sarawak,3,2,1,Turkey
52600,7/1/2022,TUR,Selangor,748,463,285,Turkey
52601,7/1/2022,TUR,W.P. Labuan,0,0,0,Turkey
52602,7/1/2022,TUV,Selangor,0,0,0,Tuvalu
52603,7/1/2022,TWN,Johor,2579,1126,1453,Taiwan
52604,7/1/2022,TWN,Kedah,54,24,30,Taiwan
52605,7/1/2022,TWN,Kelantan,0,0,0,Taiwan
52606,7/1/2022,TWN,Melaka,0,0,0,Taiwan
52607,7/1/2022,TWN,Negeri Sembilan,2,1,1,Taiwan
52608,7/1/2022,TWN,Pahang,1,1,0,Taiwan
52609,7/1/2022,TWN,Perak,29,16,13,Taiwan
52610,7/1/2022,TWN,Perlis,0,0,0,Taiwan
52611,7/1/2022,TWN,Pulau Pinang,493,277,216,Taiwan
52612,7/1/2022,TWN,Sabah,39,18,21,Taiwan
52613,7/1/2022,TWN,Sarawak,92,39,53,Taiwan
52614,7/1/2022,TWN,Selangor,2075,1147,928,Taiwan
52615,7/1/2022,TWN,W.P. Labuan,0,0,0,Taiwan
52616,7/1/2022,TZA,Johor,3,1,2,"Tanzania, United Republic of"
52617,7/1/2022,TZA,Kedah,0,0,0,"Tanzania, United Republic of"
52618,7/1/2022,TZA,Perak,0,0,0,"Tanzania, United Republic of"
52619,7/1/2022,TZA,Perlis,0,0,0,"Tanzania, United Republic of"
52620,7/1/2022,TZA,Pulau Pinang,0,0,0,"Tanzania, United Republic of"
52621,7/1/2022,TZA,Sabah,0,0,0,"Tanzania, United Republic of"
52622,7/1/2022,TZA,Sarawak,0,0,0,"Tanzania, United Republic of"
52623,7/1/2022,TZA,Selangor,75,31,44,"Tanzania, United Republic of"
52624,7/1/2022,UGA,Johor,10,6,4,Uganda
52625,7/1/2022,UGA,Kedah,0,0,0,Uganda
52626,7/1/2022,UGA,Perak,0,0,0,Uganda
52627,7/1/2022,UGA,Perlis,0,0,0,Uganda
52628,7/1/2022,UGA,Pulau Pinang,0,0,0,Uganda
52629,7/1/2022,UGA,Sabah,0,0,0,Uganda
52630,7/1/2022,UGA,Sarawak,0,0,0,Uganda
52631,7/1/2022,UGA,Selangor,42,15,27,Uganda
52632,7/1/2022,UKR,Johor,89,51,38,Ukraine
52633,7/1/2022,UKR,Kedah,7,1,6,Ukraine
52634,7/1/2022,UKR,Kelantan,2,1,1,Ukraine
52635,7/1/2022,UKR,Melaka,0,0,0,Ukraine
52636,7/1/2022,UKR,Negeri Sembilan,0,0,0,Ukraine
52637,7/1/2022,UKR,Pahang,0,0,0,Ukraine
52638,7/1/2022,UKR,Perak,1,1,0,Ukraine
52639,7/1/2022,UKR,Perlis,2,2,0,Ukraine
52640,7/1/2022,UKR,Pulau Pinang,8,4,4,Ukraine
52641,7/1/2022,UKR,Sabah,10,6,4,Ukraine
52642,7/1/2022,UKR,Sarawak,2,0,2,Ukraine
52643,7/1/2022,UKR,Selangor,359,182,177,Ukraine
52644,7/1/2022,UKR,W.P. Labuan,0,0,0,Ukraine
52645,7/1/2022,URY,Johor,8,2,6,Uruguay
52646,7/1/2022,URY,Kedah,1,1,0,Uruguay
52647,7/1/2022,URY,Kelantan,0,0,0,Uruguay
52648,7/1/2022,URY,Perak,0,0,0,Uruguay
52649,7/1/2022,URY,Perlis,0,0,0,Uruguay
52650,7/1/2022,URY,Pulau Pinang,0,0,0,Uruguay
52651,7/1/2022,URY,Sabah,1,1,0,Uruguay
52652,7/1/2022,URY,Sarawak,0,0,0,Uruguay
52653,7/1/2022,URY,Selangor,23,16,7,Uruguay
52654,7/1/2022,URY,W.P. Labuan,0,0,0,Uruguay
52655,7/1/2022,USA,Johor,3361,2020,1341,United States Of America
52656,7/1/2022,USA,Kedah,237,138,99,United States Of America
52657,7/1/2022,USA,Kelantan,16,12,4,United States Of America
52658,7/1/2022,USA,Melaka,7,5,2,United States Of America
52659,7/1/2022,USA,Negeri Sembilan,0,0,0,United States Of America
52660,7/1/2022,USA,Pahang,0,0,0,United States Of America
52661,7/1/2022,USA,Perak,122,65,57,United States Of America
52662,7/1/2022,USA,Perlis,34,25,9,United States Of America
52663,7/1/2022,USA,Pulau Pinang,1364,833,531,United States Of America
52664,7/1/2022,USA,Sabah,308,171,137,United States Of America
52665,7/1/2022,USA,Sarawak,173,94,79,United States Of America
52666,7/1/2022,USA,Selangor,10431,5972,4459,United States Of America
52667,7/1/2022,USA,Terengganu,0,0,0,United States Of America
52668,7/1/2022,USA,W.P. Labuan,0,0,0,United States Of America
52669,7/1/2022,UZB,Johor,25,17,8,Uzbekistan
52670,7/1/2022,UZB,Kedah,18,10,8,Uzbekistan
52671,7/1/2022,UZB,Kelantan,0,0,0,Uzbekistan
52672,7/1/2022,UZB,Perak,0,0,0,Uzbekistan
52673,7/1/2022,UZB,Perlis,0,0,0,Uzbekistan
52674,7/1/2022,UZB,Pulau Pinang,6,1,5,Uzbekistan
52675,7/1/2022,UZB,Sabah,46,45,1,Uzbekistan
52676,7/1/2022,UZB,Sarawak,0,0,0,Uzbekistan
52677,7/1/2022,UZB,Selangor,514,251,263,Uzbekistan
52678,7/1/2022,VAT,Johor,1,1,0,Holy See (Vatican City State)
52679,7/1/2022,VAT,Sarawak,0,0,0,Holy See (Vatican City State)
52680,7/1/2022,VAT,Selangor,0,0,0,Holy See (Vatican City State)
52681,7/1/2022,VCT,Johor,0,0,0,Saint Vincent and the Grenadines
52682,7/1/2022,VCT,Kedah,0,0,0,Saint Vincent and the Grenadines
52683,7/1/2022,VCT,Pulau Pinang,0,0,0,Saint Vincent and the Grenadines
52684,7/1/2022,VCT,Sarawak,0,0,0,Saint Vincent and the Grenadines
52685,7/1/2022,VCT,Selangor,0,0,0,Saint Vincent and the Grenadines
52686,7/1/2022,VEN,Johor,4,2,2,Venezuela
52687,7/1/2022,VEN,Kedah,0,0,0,Venezuela
52688,7/1/2022,VEN,Kelantan,0,0,0,Venezuela
52689,7/1/2022,VEN,Melaka,0,0,0,Venezuela
52690,7/1/2022,VEN,Perak,0,0,0,Venezuela
52691,7/1/2022,VEN,Perlis,0,0,0,Venezuela
52692,7/1/2022,VEN,Pulau Pinang,0,0,0,Venezuela
52693,7/1/2022,VEN,Sabah,1,1,0,Venezuela
52694,7/1/2022,VEN,Sarawak,0,0,0,Venezuela
52695,7/1/2022,VEN,Selangor,33,18,15,Venezuela
52696,7/1/2022,VEN,W.P. Labuan,0,0,0,Venezuela
52697,7/1/2022,VNM,Johor,15197,5214,9983,Vietnam
52698,7/1/2022,VNM,Kedah,328,43,285,Vietnam
52699,7/1/2022,VNM,Kelantan,3,2,1,Vietnam
52700,7/1/2022,VNM,Melaka,0,0,0,Vietnam
52701,7/1/2022,VNM,Negeri Sembilan,0,0,0,Vietnam
52702,7/1/2022,VNM,Pahang,1,1,0,Vietnam
52703,7/1/2022,VNM,Perak,86,7,79,Vietnam
52704,7/1/2022,VNM,Perlis,19,6,13,Vietnam
52705,7/1/2022,VNM,Pulau Pinang,1102,306,796,Vietnam
52706,7/1/2022,VNM,Sabah,17,3,14,Vietnam
52707,7/1/2022,VNM,Sarawak,35,7,28,Vietnam
52708,7/1/2022,VNM,Selangor,10851,3555,7296,Vietnam
52709,7/1/2022,VNM,Terengganu,0,0,0,Vietnam
52710,7/1/2022,VNM,W.P. Labuan,0,0,0,Vietnam
52711,7/1/2022,VUT,Johor,14,11,3,Vanuatu
52712,7/1/2022,VUT,Kedah,0,0,0,Vanuatu
52713,7/1/2022,VUT,Pulau Pinang,2,2,0,Vanuatu
52714,7/1/2022,VUT,Sabah,0,0,0,Vanuatu
52715,7/1/2022,VUT,Sarawak,0,0,0,Vanuatu
52716,7/1/2022,VUT,Selangor,19,16,3,Vanuatu
52717,7/1/2022,WSM,Johor,0,0,0,Samoa
52718,7/1/2022,WSM,Sarawak,0,0,0,Samoa
52719,7/1/2022,WSM,Selangor,1,1,0,Samoa
52720,7/1/2022,YEM,Johor,34,22,12,Yemen
52721,7/1/2022,YEM,Kedah,7,3,4,Yemen
52722,7/1/2022,YEM,Kelantan,1,1,0,Yemen
52723,7/1/2022,YEM,Melaka,4,2,2,Yemen
52724,7/1/2022,YEM,Pahang,0,0,0,Yemen
52725,7/1/2022,YEM,Perak,0,0,0,Yemen
52726,7/1/2022,YEM,Perlis,3,3,0,Yemen
52727,7/1/2022,YEM,Pulau Pinang,3,2,1,Yemen
52728,7/1/2022,YEM,Sabah,1,1,0,Yemen
52729,7/1/2022,YEM,Sarawak,0,0,0,Yemen
52730,7/1/2022,YEM,Selangor,1148,724,424,Yemen
52731,7/1/2022,YEM,W.P. Labuan,0,0,0,Yemen
52732,7/1/2022,ZAF,Johor,194,100,94,South Africa
52733,7/1/2022,ZAF,Kedah,20,8,12,South Africa
52734,7/1/2022,ZAF,Kelantan,1,1,0,South Africa
52735,7/1/2022,ZAF,Melaka,0,0,0,South Africa
52736,7/1/2022,ZAF,Pahang,0,0,0,South Africa
52737,7/1/2022,ZAF,Perak,2,2,0,South Africa
52738,7/1/2022,ZAF,Perlis,12,10,2,South Africa
52739,7/1/2022,ZAF,Pulau Pinang,32,16,16,South Africa
52740,7/1/2022,ZAF,Sabah,18,10,8,South Africa
52741,7/1/2022,ZAF,Sarawak,38,20,18,South Africa
52742,7/1/2022,ZAF,Selangor,643,384,259,South Africa
52743,7/1/2022,ZAF,Terengganu,0,0,0,South Africa
52744,7/1/2022,ZAF,W.P. Labuan,0,0,0,South Africa
52745,7/1/2022,ZMB,Johor,2,2,0,Zambia
52746,7/1/2022,ZMB,Kedah,0,0,0,Zambia
52747,7/1/2022,ZMB,Perak,0,0,0,Zambia
52748,7/1/2022,ZMB,Perlis,0,0,0,Zambia
52749,7/1/2022,ZMB,Pulau Pinang,1,0,1,Zambia
52750,7/1/2022,ZMB,Sabah,0,0,0,Zambia
52751,7/1/2022,ZMB,Sarawak,0,0,0,Zambia
52752,7/1/2022,ZMB,Selangor,19,13,6,Zambia
52753,7/1/2022,ZWE,Johor,10,5,5,Zimbabwe
52754,7/1/2022,ZWE,Kedah,5,3,2,Zimbabwe
52755,7/1/2022,ZWE,Kelantan,0,0,0,Zimbabwe
52756,7/1/2022,ZWE,Perak,0,0,0,Zimbabwe
52757,7/1/2022,ZWE,Perlis,1,0,1,Zimbabwe
52758,7/1/2022,ZWE,Pulau Pinang,2,0,2,Zimbabwe
52759,7/1/2022,ZWE,Sabah,0,0,0,Zimbabwe
52760,7/1/2022,ZWE,Sarawak,0,0,0,Zimbabwe
52761,7/1/2022,ZWE,Selangor,94,49,45,Zimbabwe
52762,8/1/2022,ABW,Kedah,0,0,0,Aruba
52763,8/1/2022,ABW,Pulau Pinang,0,0,0,Aruba
52764,8/1/2022,AFG,Johor,0,0,0,Afghanistan
52765,8/1/2022,AFG,Kedah,0,0,0,Afghanistan
52766,8/1/2022,AFG,Perlis,0,0,0,Afghanistan
52767,8/1/2022,AFG,Pulau Pinang,0,0,0,Afghanistan
52768,8/1/2022,AFG,Sarawak,0,0,0,Afghanistan
52769,8/1/2022,AFG,Selangor,74,50,24,Afghanistan
52770,8/1/2022,AGO,Johor,0,0,0,Angola
52771,8/1/2022,AGO,Kedah,0,0,0,Angola
52772,8/1/2022,AGO,Sabah,0,0,0,Angola
52773,8/1/2022,AGO,Selangor,0,0,0,Angola
52774,8/1/2022,AIA,Selangor,0,0,0,Anguilla
52775,8/1/2022,ALB,Johor,17,12,5,Albania
52776,8/1/2022,ALB,Kedah,1,1,0,Albania
52777,8/1/2022,ALB,Perak,0,0,0,Albania
52778,8/1/2022,ALB,Perlis,0,0,0,Albania
52779,8/1/2022,ALB,Pulau Pinang,1,0,1,Albania
52780,8/1/2022,ALB,Sabah,0,0,0,Albania
52781,8/1/2022,ALB,Sarawak,0,0,0,Albania
52782,8/1/2022,ALB,Selangor,35,22,13,Albania
52783,8/1/2022,AND,Johor,1,0,1,Andorra
52784,8/1/2022,AND,Kedah,0,0,0,Andorra
52785,8/1/2022,AND,Perlis,2,0,2,Andorra
52786,8/1/2022,AND,Pulau Pinang,0,0,0,Andorra
52787,8/1/2022,AND,Selangor,2,2,0,Andorra
52788,8/1/2022,ANT,Selangor,0,0,0,Netherlands Antilles
52789,8/1/2022,ARE,Johor,37,23,14,United Arab Emirates
52790,8/1/2022,ARE,Kedah,3,3,0,United Arab Emirates
52791,8/1/2022,ARE,Kelantan,0,0,0,United Arab Emirates
52792,8/1/2022,ARE,Perak,0,0,0,United Arab Emirates
52793,8/1/2022,ARE,Perlis,0,0,0,United Arab Emirates
52794,8/1/2022,ARE,Pulau Pinang,0,0,0,United Arab Emirates
52795,8/1/2022,ARE,Sabah,0,0,0,United Arab Emirates
52796,8/1/2022,ARE,Sarawak,0,0,0,United Arab Emirates
52797,8/1/2022,ARE,Selangor,605,313,292,United Arab Emirates
52798,8/1/2022,ARG,Johor,44,23,21,Argentina
52799,8/1/2022,ARG,Kedah,13,9,4,Argentina
52800,8/1/2022,ARG,Kelantan,2,1,1,Argentina
52801,8/1/2022,ARG,Melaka,0,0,0,Argentina
52802,8/1/2022,ARG,Perak,0,0,0,Argentina
52803,8/1/2022,ARG,Perlis,1,0,1,Argentina
52804,8/1/2022,ARG,Pulau Pinang,2,2,0,Argentina
52805,8/1/2022,ARG,Sabah,2,2,0,Argentina
52806,8/1/2022,ARG,Sarawak,2,1,1,Argentina
52807,8/1/2022,ARG,Selangor,193,106,87,Argentina
52808,8/1/2022,ARG,W.P. Labuan,0,0,0,Argentina
52809,8/1/2022,ARM,Johor,6,3,3,Armenia
52810,8/1/2022,ARM,Kedah,1,1,0,Armenia
52811,8/1/2022,ARM,Kelantan,0,0,0,Armenia
52812,8/1/2022,ARM,Perak,0,0,0,Armenia
52813,8/1/2022,ARM,Perlis,0,0,0,Armenia
52814,8/1/2022,ARM,Pulau Pinang,0,0,0,Armenia
52815,8/1/2022,ARM,Sabah,0,0,0,Armenia
52816,8/1/2022,ARM,Sarawak,0,0,0,Armenia
52817,8/1/2022,ARM,Selangor,15,8,7,Armenia
52818,8/1/2022,ATA,Selangor,0,0,0,Antarctica
52819,8/1/2022,ATG,Johor,4,3,1,Antigua and Barbuda
52820,8/1/2022,ATG,Kedah,3,0,3,Antigua and Barbuda
52821,8/1/2022,ATG,Pulau Pinang,0,0,0,Antigua and Barbuda
52822,8/1/2022,ATG,Sarawak,0,0,0,Antigua and Barbuda
52823,8/1/2022,ATG,Selangor,13,10,3,Antigua and Barbuda
52824,8/1/2022,AUS,Johor,3198,1924,1274,Australia
52825,8/1/2022,AUS,Kedah,333,194,139,Australia
52826,8/1/2022,AUS,Kelantan,7,5,2,Australia
52827,8/1/2022,AUS,Melaka,9,6,3,Australia
52828,8/1/2022,AUS,Negeri Sembilan,0,0,0,Australia
52829,8/1/2022,AUS,Pahang,1,1,0,Australia
52830,8/1/2022,AUS,Perak,144,78,66,Australia
52831,8/1/2022,AUS,Perlis,30,23,7,Australia
52832,8/1/2022,AUS,Pulau Pinang,1286,716,570,Australia
52833,8/1/2022,AUS,Sabah,312,164,148,Australia
52834,8/1/2022,AUS,Sarawak,450,244,206,Australia
52835,8/1/2022,AUS,Selangor,11071,6783,4288,Australia
52836,8/1/2022,AUS,Terengganu,0,0,0,Australia
52837,8/1/2022,AUS,W.P. Labuan,2,2,0,Australia
52838,8/1/2022,AUT,Johor,154,96,58,Austria
52839,8/1/2022,AUT,Kedah,37,18,19,Austria
52840,8/1/2022,AUT,Kelantan,0,0,0,Austria
52841,8/1/2022,AUT,Melaka,3,2,1,Austria
52842,8/1/2022,AUT,Negeri Sembilan,0,0,0,Austria
52843,8/1/2022,AUT,Pahang,0,0,0,Austria
52844,8/1/2022,AUT,Perak,1,0,1,Austria
52845,8/1/2022,AUT,Perlis,15,9,6,Austria
52846,8/1/2022,AUT,Pulau Pinang,62,45,17,Austria
52847,8/1/2022,AUT,Sabah,22,15,7,Austria
52848,8/1/2022,AUT,Sarawak,19,13,6,Austria
52849,8/1/2022,AUT,Selangor,673,413,260,Austria
52850,8/1/2022,AUT,Terengganu,0,0,0,Austria
52851,8/1/2022,AUT,W.P. Labuan,0,0,0,Austria
52852,8/1/2022,AZE,Johor,4,3,1,Azerbaijan
52853,8/1/2022,AZE,Kedah,5,3,2,Azerbaijan
52854,8/1/2022,AZE,Kelantan,0,0,0,Azerbaijan
52855,8/1/2022,AZE,Melaka,0,0,0,Azerbaijan
52856,8/1/2022,AZE,Perlis,0,0,0,Azerbaijan
52857,8/1/2022,AZE,Pulau Pinang,0,0,0,Azerbaijan
52858,8/1/2022,AZE,Sabah,1,1,0,Azerbaijan
52859,8/1/2022,AZE,Sarawak,0,0,0,Azerbaijan
52860,8/1/2022,AZE,Selangor,104,47,57,Azerbaijan
52861,8/1/2022,AZE,W.P. Labuan,0,0,0,Azerbaijan
52862,8/1/2022,BDI,Pulau Pinang,0,0,0,Burundi
52863,8/1/2022,BDI,Sarawak,0,0,0,Burundi
52864,8/1/2022,BDI,Selangor,4,2,2,Burundi
52865,8/1/2022,BEL,Johor,226,147,79,Belgium
52866,8/1/2022,BEL,Kedah,12,7,5,Belgium
52867,8/1/2022,BEL,Kelantan,0,0,0,Belgium
52868,8/1/2022,BEL,Melaka,0,0,0,Belgium
52869,8/1/2022,BEL,Negeri Sembilan,1,1,0,Belgium
52870,8/1/2022,BEL,Pahang,6,4,2,Belgium
52871,8/1/2022,BEL,Perak,7,2,5,Belgium
52872,8/1/2022,BEL,Perlis,9,6,3,Belgium
52873,8/1/2022,BEL,Pulau Pinang,68,46,22,Belgium
52874,8/1/2022,BEL,Sabah,16,10,6,Belgium
52875,8/1/2022,BEL,Sarawak,29,16,13,Belgium
52876,8/1/2022,BEL,Selangor,1002,563,439,Belgium
52877,8/1/2022,BEL,W.P. Labuan,0,0,0,Belgium
52878,8/1/2022,BEN,Johor,1,1,0,Benin
52879,8/1/2022,BEN,Kedah,0,0,0,Benin
52880,8/1/2022,BEN,Perak,0,0,0,Benin
52881,8/1/2022,BEN,Pulau Pinang,0,0,0,Benin
52882,8/1/2022,BEN,Sabah,0,0,0,Benin
52883,8/1/2022,BEN,Sarawak,0,0,0,Benin
52884,8/1/2022,BEN,Selangor,5,4,1,Benin
52885,8/1/2022,BFA,Perak,0,0,0,Burkina Faso
52886,8/1/2022,BFA,Pulau Pinang,0,0,0,Burkina Faso
52887,8/1/2022,BFA,Selangor,1,1,0,Burkina Faso
52888,8/1/2022,BGD,Johor,1521,1228,293,Bangladesh
52889,8/1/2022,BGD,Kedah,33,25,8,Bangladesh
52890,8/1/2022,BGD,Kelantan,0,0,0,Bangladesh
52891,8/1/2022,BGD,Melaka,0,0,0,Bangladesh
52892,8/1/2022,BGD,Negeri Sembilan,0,0,0,Bangladesh
52893,8/1/2022,BGD,Pahang,0,0,0,Bangladesh
52894,8/1/2022,BGD,Perak,0,0,0,Bangladesh
52895,8/1/2022,BGD,Perlis,2,2,0,Bangladesh
52896,8/1/2022,BGD,Pulau Pinang,160,150,10,Bangladesh
52897,8/1/2022,BGD,Sabah,1,1,0,Bangladesh
52898,8/1/2022,BGD,Sarawak,19,12,7,Bangladesh
52899,8/1/2022,BGD,Selangor,24441,22429,2012,Bangladesh
52900,8/1/2022,BGD,W.P. Labuan,2,2,0,Bangladesh
52901,8/1/2022,BGR,Johor,39,20,19,Bulgaria
52902,8/1/2022,BGR,Kedah,4,1,3,Bulgaria
52903,8/1/2022,BGR,Kelantan,0,0,0,Bulgaria
52904,8/1/2022,BGR,Pahang,0,0,0,Bulgaria
52905,8/1/2022,BGR,Perak,0,0,0,Bulgaria
52906,8/1/2022,BGR,Perlis,0,0,0,Bulgaria
52907,8/1/2022,BGR,Pulau Pinang,1,1,0,Bulgaria
52908,8/1/2022,BGR,Sabah,0,0,0,Bulgaria
52909,8/1/2022,BGR,Sarawak,9,2,7,Bulgaria
52910,8/1/2022,BGR,Selangor,146,88,58,Bulgaria
52911,8/1/2022,BGR,W.P. Labuan,0,0,0,Bulgaria
52912,8/1/2022,BHR,Johor,42,23,19,Bahrain
52913,8/1/2022,BHR,Kedah,3,1,2,Bahrain
52914,8/1/2022,BHR,Kelantan,0,0,0,Bahrain
52915,8/1/2022,BHR,Perlis,0,0,0,Bahrain
52916,8/1/2022,BHR,Pulau Pinang,0,0,0,Bahrain
52917,8/1/2022,BHR,Sabah,1,1,0,Bahrain
52918,8/1/2022,BHR,Sarawak,4,4,0,Bahrain
52919,8/1/2022,BHR,Selangor,233,101,132,Bahrain
52920,8/1/2022,BHS,Johor,8,4,4,Bahamas
52921,8/1/2022,BHS,Kedah,0,0,0,Bahamas
52922,8/1/2022,BHS,Perak,0,0,0,Bahamas
52923,8/1/2022,BHS,Sabah,0,0,0,Bahamas
52924,8/1/2022,BHS,Sarawak,1,0,1,Bahamas
52925,8/1/2022,BHS,Selangor,4,1,3,Bahamas
52926,8/1/2022,BIH,Johor,21,11,10,Bosnia and Herzegovina
52927,8/1/2022,BIH,Kedah,1,1,0,Bosnia and Herzegovina
52928,8/1/2022,BIH,Perlis,0,0,0,Bosnia and Herzegovina
52929,8/1/2022,BIH,Pulau Pinang,0,0,0,Bosnia and Herzegovina
52930,8/1/2022,BIH,Sabah,0,0,0,Bosnia and Herzegovina
52931,8/1/2022,BIH,Sarawak,2,2,0,Bosnia and Herzegovina
52932,8/1/2022,BIH,Selangor,45,27,18,Bosnia and Herzegovina
52933,8/1/2022,BLR,Johor,5,3,2,Belarus
52934,8/1/2022,BLR,Kedah,3,2,1,Belarus
52935,8/1/2022,BLR,Kelantan,0,0,0,Belarus
52936,8/1/2022,BLR,Pahang,0,0,0,Belarus
52937,8/1/2022,BLR,Perak,0,0,0,Belarus
52938,8/1/2022,BLR,Perlis,0,0,0,Belarus
52939,8/1/2022,BLR,Pulau Pinang,2,0,2,Belarus
52940,8/1/2022,BLR,Sabah,1,1,0,Belarus
52941,8/1/2022,BLR,Sarawak,0,0,0,Belarus
52942,8/1/2022,BLR,Selangor,105,50,55,Belarus
52943,8/1/2022,BLR,W.P. Labuan,0,0,0,Belarus
52944,8/1/2022,BLZ,Johor,0,0,0,Belize
52945,8/1/2022,BLZ,Pulau Pinang,0,0,0,Belize
52946,8/1/2022,BLZ,Sarawak,3,2,1,Belize
52947,8/1/2022,BLZ,Selangor,4,3,1,Belize
52948,8/1/2022,BMU,Selangor,0,0,0,Bermuda
52949,8/1/2022,BOL,Johor,2,1,1,Bolivia
52950,8/1/2022,BOL,Kedah,0,0,0,Bolivia
52951,8/1/2022,BOL,Melaka,0,0,0,Bolivia
52952,8/1/2022,BOL,Perak,0,0,0,Bolivia
52953,8/1/2022,BOL,Perlis,0,0,0,Bolivia
52954,8/1/2022,BOL,Pulau Pinang,0,0,0,Bolivia
52955,8/1/2022,BOL,Sabah,0,0,0,Bolivia
52956,8/1/2022,BOL,Sarawak,2,0,2,Bolivia
52957,8/1/2022,BOL,Selangor,15,9,6,Bolivia
52958,8/1/2022,BRA,Johor,170,102,68,Brazil
52959,8/1/2022,BRA,Kedah,23,11,12,Brazil
52960,8/1/2022,BRA,Kelantan,0,0,0,Brazil
52961,8/1/2022,BRA,Melaka,0,0,0,Brazil
52962,8/1/2022,BRA,Pahang,0,0,0,Brazil
52963,8/1/2022,BRA,Perak,2,1,1,Brazil
52964,8/1/2022,BRA,Perlis,8,3,5,Brazil
52965,8/1/2022,BRA,Pulau Pinang,12,4,8,Brazil
52966,8/1/2022,BRA,Sabah,10,4,6,Brazil
52967,8/1/2022,BRA,Sarawak,3,2,1,Brazil
52968,8/1/2022,BRA,Selangor,662,360,302,Brazil
52969,8/1/2022,BRA,W.P. Labuan,0,0,0,Brazil
52970,8/1/2022,BRB,Johor,1,0,1,Barbados
52971,8/1/2022,BRB,Kedah,0,0,0,Barbados
52972,8/1/2022,BRB,Perlis,1,0,1,Barbados
52973,8/1/2022,BRB,Pulau Pinang,1,1,0,Barbados
52974,8/1/2022,BRB,Selangor,5,4,1,Barbados
52975,8/1/2022,BRN,Johor,184,100,84,Brunei Darussalam
52976,8/1/2022,BRN,Kedah,2,1,1,Brunei Darussalam
52977,8/1/2022,BRN,Kelantan,0,0,0,Brunei Darussalam
52978,8/1/2022,BRN,Melaka,0,0,0,Brunei Darussalam
52979,8/1/2022,BRN,Pahang,0,0,0,Brunei Darussalam
52980,8/1/2022,BRN,Perak,1,0,1,Brunei Darussalam
52981,8/1/2022,BRN,Perlis,9,6,3,Brunei Darussalam
52982,8/1/2022,BRN,Pulau Pinang,20,9,11,Brunei Darussalam
52983,8/1/2022,BRN,Sabah,655,307,348,Brunei Darussalam
52984,8/1/2022,BRN,Sarawak,32245,17935,14310,Brunei Darussalam
52985,8/1/2022,BRN,Selangor,3362,1746,1616,Brunei Darussalam
52986,8/1/2022,BRN,W.P. Labuan,475,278,197,Brunei Darussalam
52987,8/1/2022,BTN,Johor,2,2,0,Bhutan
52988,8/1/2022,BTN,Kedah,0,0,0,Bhutan
52989,8/1/2022,BTN,Perak,0,0,0,Bhutan
52990,8/1/2022,BTN,Perlis,0,0,0,Bhutan
52991,8/1/2022,BTN,Pulau Pinang,3,1,2,Bhutan
52992,8/1/2022,BTN,Sabah,0,0,0,Bhutan
52993,8/1/2022,BTN,Sarawak,0,0,0,Bhutan
52994,8/1/2022,BTN,Selangor,38,29,9,Bhutan
52995,8/1/2022,BWA,Johor,0,0,0,Botswana
52996,8/1/2022,BWA,Kedah,1,0,1,Botswana
52997,8/1/2022,BWA,Perlis,0,0,0,Botswana
52998,8/1/2022,BWA,Pulau Pinang,0,0,0,Botswana
52999,8/1/2022,BWA,Sabah,0,0,0,Botswana
53000,8/1/2022,BWA,Sarawak,0,0,0,Botswana
53001,8/1/2022,BWA,Selangor,10,4,6,Botswana
53002,8/1/2022,CAF,Kedah,0,0,0,Central African Republic
53003,8/1/2022,CAF,Selangor,0,0,0,Central African Republic
53004,8/1/2022,CAN,Johor,902,521,381,Canada
53005,8/1/2022,CAN,Kedah,84,51,33,Canada
53006,8/1/2022,CAN,Kelantan,11,5,6,Canada
53007,8/1/2022,CAN,Melaka,0,0,0,Canada
53008,8/1/2022,CAN,Negeri Sembilan,0,0,0,Canada
53009,8/1/2022,CAN,Pahang,0,0,0,Canada
53010,8/1/2022,CAN,Perak,21,14,7,Canada
53011,8/1/2022,CAN,Perlis,31,19,12,Canada
53012,8/1/2022,CAN,Pulau Pinang,219,123,96,Canada
53013,8/1/2022,CAN,Sabah,74,34,40,Canada
53014,8/1/2022,CAN,Sarawak,164,100,64,Canada
53015,8/1/2022,CAN,Selangor,2708,1575,1133,Canada
53016,8/1/2022,CAN,Terengganu,0,0,0,Canada
53017,8/1/2022,CAN,W.P. Labuan,0,0,0,Canada
53018,8/1/2022,CCK,Selangor,0,0,0,Cocos (Keeling) Islands
53019,8/1/2022,CHE,Johor,347,221,126,Switzerland
53020,8/1/2022,CHE,Kedah,45,24,21,Switzerland
53021,8/1/2022,CHE,Kelantan,4,2,2,Switzerland
53022,8/1/2022,CHE,Melaka,4,2,2,Switzerland
53023,8/1/2022,CHE,Negeri Sembilan,2,1,1,Switzerland
53024,8/1/2022,CHE,Pahang,0,0,0,Switzerland
53025,8/1/2022,CHE,Perak,5,4,1,Switzerland
53026,8/1/2022,CHE,Perlis,28,14,14,Switzerland
53027,8/1/2022,CHE,Pulau Pinang,81,55,26,Switzerland
53028,8/1/2022,CHE,Sabah,30,16,14,Switzerland
53029,8/1/2022,CHE,Sarawak,21,10,11,Switzerland
53030,8/1/2022,CHE,Selangor,993,602,391,Switzerland
53031,8/1/2022,CHE,W.P. Labuan,0,0,0,Switzerland
53032,8/1/2022,CHL,Johor,26,14,12,Chile
53033,8/1/2022,CHL,Kedah,5,1,4,Chile
53034,8/1/2022,CHL,Kelantan,0,0,0,Chile
53035,8/1/2022,CHL,Melaka,0,0,0,Chile
53036,8/1/2022,CHL,Pahang,0,0,0,Chile
53037,8/1/2022,CHL,Perak,0,0,0,Chile
53038,8/1/2022,CHL,Perlis,14,8,6,Chile
53039,8/1/2022,CHL,Pulau Pinang,4,3,1,Chile
53040,8/1/2022,CHL,Sabah,2,1,1,Chile
53041,8/1/2022,CHL,Sarawak,0,0,0,Chile
53042,8/1/2022,CHL,Selangor,101,58,43,Chile
53043,8/1/2022,CHN,Johor,18386,7559,10827,China
53044,8/1/2022,CHN,Kedah,290,132,158,China
53045,8/1/2022,CHN,Kelantan,6,3,3,China
53046,8/1/2022,CHN,Melaka,0,0,0,China
53047,8/1/2022,CHN,Pahang,1,1,0,China
53048,8/1/2022,CHN,Perak,139,64,75,China
53049,8/1/2022,CHN,Perlis,26,13,13,China
53050,8/1/2022,CHN,Pulau Pinang,1086,501,585,China
53051,8/1/2022,CHN,Sabah,272,104,168,China
53052,8/1/2022,CHN,Sarawak,246,113,133,China
53053,8/1/2022,CHN,Selangor,11847,7049,4798,China
53054,8/1/2022,CHN,Terengganu,0,0,0,China
53055,8/1/2022,CHN,W.P. Labuan,2,0,2,China
53056,8/1/2022,CIV,Johor,1,0,1,C��te d'Iv
53057,8/1/2022,CIV,Kedah,2,0,2,C��te d'Iv
53058,8/1/2022,CIV,Pulau Pinang,0,0,0,C��te d'Iv
53059,8/1/2022,CIV,Sabah,0,0,0,C��te d'Iv
53060,8/1/2022,CIV,Sarawak,0,0,0,C��te d'Iv
53061,8/1/2022,CIV,Selangor,16,10,6,C��te d'Iv
53062,8/1/2022,CMR,Johor,1,1,0,Cameroon
53063,8/1/2022,CMR,Kedah,0,0,0,Cameroon
53064,8/1/2022,CMR,Pulau Pinang,0,0,0,Cameroon
53065,8/1/2022,CMR,Sabah,1,1,0,Cameroon
53066,8/1/2022,CMR,Sarawak,0,0,0,Cameroon
53067,8/1/2022,CMR,Selangor,20,10,10,Cameroon
53068,8/1/2022,COD,Johor,0,0,0,"Congo, the Democratic Republic of the"
53069,8/1/2022,COD,Pulau Pinang,0,0,0,"Congo, the Democratic Republic of the"
53070,8/1/2022,COD,Sarawak,0,0,0,"Congo, the Democratic Republic of the"
53071,8/1/2022,COD,Selangor,14,10,4,"Congo, the Democratic Republic of the"
53072,8/1/2022,COG,Johor,0,0,0,Congo
53073,8/1/2022,COG,Kedah,0,0,0,Congo
53074,8/1/2022,COG,Selangor,0,0,0,Congo
53075,8/1/2022,COK,Selangor,0,0,0,Cook Islands
53076,8/1/2022,COL,Johor,16,6,10,Colombia
53077,8/1/2022,COL,Kedah,0,0,0,Colombia
53078,8/1/2022,COL,Perak,3,1,2,Colombia
53079,8/1/2022,COL,Pulau Pinang,2,1,1,Colombia
53080,8/1/2022,COL,Sabah,2,1,1,Colombia
53081,8/1/2022,COL,Sarawak,0,0,0,Colombia
53082,8/1/2022,COL,Selangor,92,51,41,Colombia
53083,8/1/2022,COL,W.P. Labuan,0,0,0,Colombia
53084,8/1/2022,COM,Johor,0,0,0,Comoros
53085,8/1/2022,COM,Kedah,1,0,1,Comoros
53086,8/1/2022,COM,Selangor,9,3,6,Comoros
53087,8/1/2022,CPV,Johor,0,0,0,Cape Verde
53088,8/1/2022,CPV,Kedah,0,0,0,Cape Verde
53089,8/1/2022,CPV,Pulau Pinang,0,0,0,Cape Verde
53090,8/1/2022,CPV,Sabah,0,0,0,Cape Verde
53091,8/1/2022,CPV,Selangor,5,3,2,Cape Verde
53092,8/1/2022,CRI,Johor,0,0,0,Costa Rica
53093,8/1/2022,CRI,Kedah,0,0,0,Costa Rica
53094,8/1/2022,CRI,Perak,0,0,0,Costa Rica
53095,8/1/2022,CRI,Perlis,1,1,0,Costa Rica
53096,8/1/2022,CRI,Pulau Pinang,4,2,2,Costa Rica
53097,8/1/2022,CRI,Sabah,1,0,1,Costa Rica
53098,8/1/2022,CRI,Sarawak,2,1,1,Costa Rica
53099,8/1/2022,CRI,Selangor,35,17,18,Costa Rica
53100,8/1/2022,CUB,Johor,0,0,0,Cuba
53101,8/1/2022,CUB,Kedah,0,0,0,Cuba
53102,8/1/2022,CUB,Perlis,1,1,0,Cuba
53103,8/1/2022,CUB,Pulau Pinang,0,0,0,Cuba
53104,8/1/2022,CUB,Sabah,0,0,0,Cuba
53105,8/1/2022,CUB,Sarawak,0,0,0,Cuba
53106,8/1/2022,CUB,Selangor,19,12,7,Cuba
53107,8/1/2022,CYP,Johor,7,6,1,Cyprus
53108,8/1/2022,CYP,Kedah,0,0,0,Cyprus
53109,8/1/2022,CYP,Perak,0,0,0,Cyprus
53110,8/1/2022,CYP,Perlis,0,0,0,Cyprus
53111,8/1/2022,CYP,Pulau Pinang,2,2,0,Cyprus
53112,8/1/2022,CYP,Sabah,2,1,1,Cyprus
53113,8/1/2022,CYP,Sarawak,3,2,1,Cyprus
53114,8/1/2022,CYP,Selangor,60,32,28,Cyprus
53115,8/1/2022,CZE,Johor,109,59,50,Czech Republic
53116,8/1/2022,CZE,Kedah,21,9,12,Czech Republic
53117,8/1/2022,CZE,Kelantan,0,0,0,Czech Republic
53118,8/1/2022,CZE,Melaka,0,0,0,Czech Republic
53119,8/1/2022,CZE,Negeri Sembilan,0,0,0,Czech Republic
53120,8/1/2022,CZE,Perak,0,0,0,Czech Republic
53121,8/1/2022,CZE,Perlis,6,4,2,Czech Republic
53122,8/1/2022,CZE,Pulau Pinang,19,9,10,Czech Republic
53123,8/1/2022,CZE,Sabah,12,7,5,Czech Republic
53124,8/1/2022,CZE,Sarawak,17,7,10,Czech Republic
53125,8/1/2022,CZE,Selangor,312,175,137,Czech Republic
53126,8/1/2022,CZE,W.P. Labuan,0,0,0,Czech Republic
53127,8/1/2022,DEU,Johor,1900,1196,704,Germany
53128,8/1/2022,DEU,Kedah,244,126,118,Germany
53129,8/1/2022,DEU,Kelantan,12,8,4,Germany
53130,8/1/2022,DEU,Melaka,1,1,0,Germany
53131,8/1/2022,DEU,Negeri Sembilan,0,0,0,Germany
53132,8/1/2022,DEU,Pahang,0,0,0,Germany
53133,8/1/2022,DEU,Perak,21,13,8,Germany
53134,8/1/2022,DEU,Perlis,76,35,41,Germany
53135,8/1/2022,DEU,Pulau Pinang,493,340,153,Germany
53136,8/1/2022,DEU,Sabah,151,77,74,Germany
53137,8/1/2022,DEU,Sarawak,174,102,72,Germany
53138,8/1/2022,DEU,Selangor,6483,3742,2741,Germany
53139,8/1/2022,DEU,Terengganu,0,0,0,Germany
53140,8/1/2022,DEU,W.P. Labuan,0,0,0,Germany
53141,8/1/2022,DJI,Johor,0,0,0,Djibouti
53142,8/1/2022,DJI,Selangor,18,13,5,Djibouti
53143,8/1/2022,DMA,Johor,1,1,0,Dominica
53144,8/1/2022,DMA,Kedah,1,1,0,Dominica
53145,8/1/2022,DMA,Pulau Pinang,5,5,0,Dominica
53146,8/1/2022,DMA,Sabah,0,0,0,Dominica
53147,8/1/2022,DMA,Sarawak,0,0,0,Dominica
53148,8/1/2022,DMA,Selangor,31,21,10,Dominica
53149,8/1/2022,DMA,W.P. Labuan,0,0,0,Dominica
53150,8/1/2022,DNK,Johor,199,132,67,Denmark
53151,8/1/2022,DNK,Kedah,44,19,25,Denmark
53152,8/1/2022,DNK,Kelantan,1,0,1,Denmark
53153,8/1/2022,DNK,Melaka,0,0,0,Denmark
53154,8/1/2022,DNK,Negeri Sembilan,0,0,0,Denmark
53155,8/1/2022,DNK,Pahang,1,1,0,Denmark
53156,8/1/2022,DNK,Perak,2,2,0,Denmark
53157,8/1/2022,DNK,Perlis,2,1,1,Denmark
53158,8/1/2022,DNK,Pulau Pinang,41,36,5,Denmark
53159,8/1/2022,DNK,Sabah,27,14,13,Denmark
53160,8/1/2022,DNK,Sarawak,25,11,14,Denmark
53161,8/1/2022,DNK,Selangor,670,408,262,Denmark
53162,8/1/2022,DNK,W.P. Labuan,0,0,0,Denmark
53163,8/1/2022,DOM,Johor,2,0,2,Dominican Republic
53164,8/1/2022,DOM,Kedah,0,0,0,Dominican Republic
53165,8/1/2022,DOM,Perak,0,0,0,Dominican Republic
53166,8/1/2022,DOM,Perlis,0,0,0,Dominican Republic
53167,8/1/2022,DOM,Pulau Pinang,0,0,0,Dominican Republic
53168,8/1/2022,DOM,Sabah,0,0,0,Dominican Republic
53169,8/1/2022,DOM,Sarawak,0,0,0,Dominican Republic
53170,8/1/2022,DOM,Selangor,11,7,4,Dominican Republic
53171,8/1/2022,DZA,Johor,20,16,4,Algeria
53172,8/1/2022,DZA,Kedah,2,2,0,Algeria
53173,8/1/2022,DZA,Kelantan,0,0,0,Algeria
53174,8/1/2022,DZA,Melaka,0,0,0,Algeria
53175,8/1/2022,DZA,Perak,0,0,0,Algeria
53176,8/1/2022,DZA,Perlis,0,0,0,Algeria
53177,8/1/2022,DZA,Pulau Pinang,1,1,0,Algeria
53178,8/1/2022,DZA,Sabah,1,1,0,Algeria
53179,8/1/2022,DZA,Sarawak,4,3,1,Algeria
53180,8/1/2022,DZA,Selangor,901,467,434,Algeria
53181,8/1/2022,DZA,W.P. Labuan,0,0,0,Algeria
53182,8/1/2022,ECU,Johor,6,4,2,Ecuador
53183,8/1/2022,ECU,Kedah,1,0,1,Ecuador
53184,8/1/2022,ECU,Perak,0,0,0,Ecuador
53185,8/1/2022,ECU,Perlis,0,0,0,Ecuador
53186,8/1/2022,ECU,Pulau Pinang,3,1,2,Ecuador
53187,8/1/2022,ECU,Sabah,1,0,1,Ecuador
53188,8/1/2022,ECU,Sarawak,3,1,2,Ecuador
53189,8/1/2022,ECU,Selangor,52,22,30,Ecuador
53190,8/1/2022,EGY,Johor,183,136,47,Egypt
53191,8/1/2022,EGY,Kedah,1,1,0,Egypt
53192,8/1/2022,EGY,Kelantan,1,1,0,Egypt
53193,8/1/2022,EGY,Melaka,0,0,0,Egypt
53194,8/1/2022,EGY,Pahang,0,0,0,Egypt
53195,8/1/2022,EGY,Perak,0,0,0,Egypt
53196,8/1/2022,EGY,Perlis,0,0,0,Egypt
53197,8/1/2022,EGY,Pulau Pinang,4,4,0,Egypt
53198,8/1/2022,EGY,Sabah,5,4,1,Egypt
53199,8/1/2022,EGY,Sarawak,72,44,28,Egypt
53200,8/1/2022,EGY,Selangor,1648,1044,604,Egypt
53201,8/1/2022,EGY,Terengganu,0,0,0,Egypt
53202,8/1/2022,EGY,W.P. Labuan,1,1,0,Egypt
53203,8/1/2022,ERI,Johor,0,0,0,Eritrea
53204,8/1/2022,ERI,Pulau Pinang,0,0,0,Eritrea
53205,8/1/2022,ERI,Sabah,0,0,0,Eritrea
53206,8/1/2022,ERI,Selangor,7,4,3,Eritrea
53207,8/1/2022,ESP,Johor,790,396,394,Spain
53208,8/1/2022,ESP,Kedah,83,47,36,Spain
53209,8/1/2022,ESP,Kelantan,10,7,3,Spain
53210,8/1/2022,ESP,Melaka,0,0,0,Spain
53211,8/1/2022,ESP,Negeri Sembilan,0,0,0,Spain
53212,8/1/2022,ESP,Pahang,0,0,0,Spain
53213,8/1/2022,ESP,Perak,15,8,7,Spain
53214,8/1/2022,ESP,Perlis,17,11,6,Spain
53215,8/1/2022,ESP,Pulau Pinang,233,112,121,Spain
53216,8/1/2022,ESP,Sabah,77,42,35,Spain
53217,8/1/2022,ESP,Sarawak,87,49,38,Spain
53218,8/1/2022,ESP,Selangor,4946,2559,2387,Spain
53219,8/1/2022,ESP,W.P. Labuan,1,1,0,Spain
53220,8/1/2022,EST,Johor,17,8,9,Estonia
53221,8/1/2022,EST,Kedah,2,1,1,Estonia
53222,8/1/2022,EST,Kelantan,0,0,0,Estonia
53223,8/1/2022,EST,Pahang,0,0,0,Estonia
53224,8/1/2022,EST,Perak,0,0,0,Estonia
53225,8/1/2022,EST,Perlis,1,0,1,Estonia
53226,8/1/2022,EST,Pulau Pinang,2,1,1,Estonia
53227,8/1/2022,EST,Sabah,0,0,0,Estonia
53228,8/1/2022,EST,Sarawak,2,1,1,Estonia
53229,8/1/2022,EST,Selangor,63,26,37,Estonia
53230,8/1/2022,EST,W.P. Labuan,0,0,0,Estonia
53231,8/1/2022,ETH,Johor,1,1,0,Ethiopia
53232,8/1/2022,ETH,Kedah,0,0,0,Ethiopia
53233,8/1/2022,ETH,Pulau Pinang,0,0,0,Ethiopia
53234,8/1/2022,ETH,Sarawak,0,0,0,Ethiopia
53235,8/1/2022,ETH,Selangor,34,19,15,Ethiopia
53236,8/1/2022,FIN,Johor,95,59,36,Finland
53237,8/1/2022,FIN,Kedah,7,4,3,Finland
53238,8/1/2022,FIN,Kelantan,0,0,0,Finland
53239,8/1/2022,FIN,Melaka,0,0,0,Finland
53240,8/1/2022,FIN,Negeri Sembilan,0,0,0,Finland
53241,8/1/2022,FIN,Pahang,0,0,0,Finland
53242,8/1/2022,FIN,Perak,1,1,0,Finland
53243,8/1/2022,FIN,Perlis,2,1,1,Finland
53244,8/1/2022,FIN,Pulau Pinang,11,7,4,Finland
53245,8/1/2022,FIN,Sabah,6,1,5,Finland
53246,8/1/2022,FIN,Sarawak,3,1,2,Finland
53247,8/1/2022,FIN,Selangor,193,121,72,Finland
53248,8/1/2022,FIN,W.P. Labuan,0,0,0,Finland
53249,8/1/2022,FJI,Johor,26,14,12,Fiji
53250,8/1/2022,FJI,Kedah,0,0,0,Fiji
53251,8/1/2022,FJI,Kelantan,0,0,0,Fiji
53252,8/1/2022,FJI,Perak,0,0,0,Fiji
53253,8/1/2022,FJI,Perlis,1,1,0,Fiji
53254,8/1/2022,FJI,Pulau Pinang,0,0,0,Fiji
53255,8/1/2022,FJI,Sabah,1,1,0,Fiji
53256,8/1/2022,FJI,Sarawak,0,0,0,Fiji
53257,8/1/2022,FJI,Selangor,59,30,29,Fiji
53258,8/1/2022,FRA,Johor,2203,1303,900,France
53259,8/1/2022,FRA,Kedah,194,111,83,France
53260,8/1/2022,FRA,Kelantan,4,2,2,France
53261,8/1/2022,FRA,Melaka,1,0,1,France
53262,8/1/2022,FRA,Negeri Sembilan,1,1,0,France
53263,8/1/2022,FRA,Pahang,5,5,0,France
53264,8/1/2022,FRA,Perak,23,13,10,France
53265,8/1/2022,FRA,Perlis,82,44,38,France
53266,8/1/2022,FRA,Pulau Pinang,314,199,115,France
53267,8/1/2022,FRA,Sabah,167,94,73,France
53268,8/1/2022,FRA,Sarawak,161,88,73,France
53269,8/1/2022,FRA,Selangor,10785,5892,4893,France
53270,8/1/2022,FRA,Terengganu,0,0,0,France
53271,8/1/2022,FRA,W.P. Labuan,9,7,2,France
53272,8/1/2022,FSM,Johor,0,0,0,"Micronesia, Federated States of"
53273,8/1/2022,FSM,Pulau Pinang,0,0,0,"Micronesia, Federated States of"
53274,8/1/2022,FSM,Selangor,1,0,1,"Micronesia, Federated States of"
53275,8/1/2022,GAB,Johor,11,6,5,Gabon
53276,8/1/2022,GAB,Pulau Pinang,0,0,0,Gabon
53277,8/1/2022,GAB,Sarawak,0,0,0,Gabon
53278,8/1/2022,GAB,Selangor,6,2,4,Gabon
53279,8/1/2022,GBR,Johor,4151,2630,1521,United Kingdom
53280,8/1/2022,GBR,Kedah,598,331,267,United Kingdom
53281,8/1/2022,GBR,Kelantan,9,8,1,United Kingdom
53282,8/1/2022,GBR,Melaka,2,1,1,United Kingdom
53283,8/1/2022,GBR,Negeri Sembilan,0,0,0,United Kingdom
53284,8/1/2022,GBR,Pahang,10,8,2,United Kingdom
53285,8/1/2022,GBR,Perak,93,51,42,United Kingdom
53286,8/1/2022,GBR,Perlis,140,93,47,United Kingdom
53287,8/1/2022,GBR,Pulau Pinang,1067,644,423,United Kingdom
53288,8/1/2022,GBR,Sabah,552,307,245,United Kingdom
53289,8/1/2022,GBR,Sarawak,985,609,376,United Kingdom
53290,8/1/2022,GBR,Selangor,16004,9302,6702,United Kingdom
53291,8/1/2022,GBR,Terengganu,0,0,0,United Kingdom
53292,8/1/2022,GBR,W.P. Labuan,16,10,6,United Kingdom
53293,8/1/2022,GEO,Johor,9,8,1,Georgia
53294,8/1/2022,GEO,Kedah,0,0,0,Georgia
53295,8/1/2022,GEO,Melaka,0,0,0,Georgia
53296,8/1/2022,GEO,Perak,0,0,0,Georgia
53297,8/1/2022,GEO,Perlis,0,0,0,Georgia
53298,8/1/2022,GEO,Pulau Pinang,0,0,0,Georgia
53299,8/1/2022,GEO,Sabah,0,0,0,Georgia
53300,8/1/2022,GEO,Sarawak,0,0,0,Georgia
53301,8/1/2022,GEO,Selangor,41,32,9,Georgia
53302,8/1/2022,GHA,Johor,3,3,0,Ghana
53303,8/1/2022,GHA,Kedah,0,0,0,Ghana
53304,8/1/2022,GHA,Kelantan,0,0,0,Ghana
53305,8/1/2022,GHA,Pulau Pinang,0,0,0,Ghana
53306,8/1/2022,GHA,Sabah,0,0,0,Ghana
53307,8/1/2022,GHA,Sarawak,0,0,0,Ghana
53308,8/1/2022,GHA,Selangor,45,30,15,Ghana
53309,8/1/2022,GIB,Johor,0,0,0,Gibraltar
53310,8/1/2022,GIB,Sarawak,0,0,0,Gibraltar
53311,8/1/2022,GIN,Johor,3,1,2,Guinea
53312,8/1/2022,GIN,Kedah,0,0,0,Guinea
53313,8/1/2022,GIN,Kelantan,0,0,0,Guinea
53314,8/1/2022,GIN,Perlis,0,0,0,Guinea
53315,8/1/2022,GIN,Pulau Pinang,0,0,0,Guinea
53316,8/1/2022,GIN,Sabah,0,0,0,Guinea
53317,8/1/2022,GIN,Sarawak,0,0,0,Guinea
53318,8/1/2022,GIN,Selangor,38,26,12,Guinea
53319,8/1/2022,GLP,Selangor,0,0,0,Guadeloupe
53320,8/1/2022,GMB,Johor,4,4,0,Gambia
53321,8/1/2022,GMB,Kedah,0,0,0,Gambia
53322,8/1/2022,GMB,Kelantan,0,0,0,Gambia
53323,8/1/2022,GMB,Pulau Pinang,0,0,0,Gambia
53324,8/1/2022,GMB,Sabah,0,0,0,Gambia
53325,8/1/2022,GMB,Sarawak,0,0,0,Gambia
53326,8/1/2022,GMB,Selangor,21,12,9,Gambia
53327,8/1/2022,GNB,Johor,0,0,0,Guinea-Bissau
53328,8/1/2022,GNB,Selangor,0,0,0,Guinea-Bissau
53329,8/1/2022,GNQ,Johor,0,0,0,Equatorial Guinea
53330,8/1/2022,GNQ,Selangor,1,0,1,Equatorial Guinea
53331,8/1/2022,GRC,Johor,34,31,3,Greece
53332,8/1/2022,GRC,Kedah,6,2,4,Greece
53333,8/1/2022,GRC,Kelantan,0,0,0,Greece
53334,8/1/2022,GRC,Melaka,0,0,0,Greece
53335,8/1/2022,GRC,Negeri Sembilan,0,0,0,Greece
53336,8/1/2022,GRC,Pahang,0,0,0,Greece
53337,8/1/2022,GRC,Perak,0,0,0,Greece
53338,8/1/2022,GRC,Perlis,0,0,0,Greece
53339,8/1/2022,GRC,Pulau Pinang,15,10,5,Greece
53340,8/1/2022,GRC,Sabah,1,1,0,Greece
53341,8/1/2022,GRC,Sarawak,3,1,2,Greece
53342,8/1/2022,GRC,Selangor,197,116,81,Greece
53343,8/1/2022,GRD,Johor,9,6,3,Grenada
53344,8/1/2022,GRD,Kedah,4,3,1,Grenada
53345,8/1/2022,GRD,Pulau Pinang,2,1,1,Grenada
53346,8/1/2022,GRD,Sabah,0,0,0,Grenada
53347,8/1/2022,GRD,Sarawak,1,1,0,Grenada
53348,8/1/2022,GRD,Selangor,9,6,3,Grenada
53349,8/1/2022,GRL,Johor,0,0,0,Greenland
53350,8/1/2022,GRL,Selangor,0,0,0,Greenland
53351,8/1/2022,GTM,Johor,1,1,0,Guatemala
53352,8/1/2022,GTM,Kedah,0,0,0,Guatemala
53353,8/1/2022,GTM,Pahang,0,0,0,Guatemala
53354,8/1/2022,GTM,Perak,0,0,0,Guatemala
53355,8/1/2022,GTM,Pulau Pinang,0,0,0,Guatemala
53356,8/1/2022,GTM,Sabah,0,0,0,Guatemala
53357,8/1/2022,GTM,Sarawak,0,0,0,Guatemala
53358,8/1/2022,GTM,Selangor,11,9,2,Guatemala
53359,8/1/2022,GTM,W.P. Labuan,0,0,0,Guatemala
53360,8/1/2022,GUY,Johor,3,3,0,Guyana
53361,8/1/2022,GUY,Kedah,0,0,0,Guyana
53362,8/1/2022,GUY,Pulau Pinang,0,0,0,Guyana
53363,8/1/2022,GUY,Sarawak,0,0,0,Guyana
53364,8/1/2022,GUY,Selangor,3,2,1,Guyana
53365,8/1/2022,HKG,Johor,3,3,0,Hong Kong
53366,8/1/2022,HKG,Kedah,0,0,0,Hong Kong
53367,8/1/2022,HKG,Kelantan,0,0,0,Hong Kong
53368,8/1/2022,HKG,Pahang,0,0,0,Hong Kong
53369,8/1/2022,HKG,Perak,21,9,12,Hong Kong
53370,8/1/2022,HKG,Perlis,9,5,4,Hong Kong
53371,8/1/2022,HKG,Pulau Pinang,0,0,0,Hong Kong
53372,8/1/2022,HKG,Sabah,47,26,21,Hong Kong
53373,8/1/2022,HKG,Sarawak,31,20,11,Hong Kong
53374,8/1/2022,HKG,Selangor,4,3,1,Hong Kong
53375,8/1/2022,HKG,Terengganu,0,0,0,Hong Kong
53376,8/1/2022,HMD,Johor,0,0,0,Heard Island and McDonald Islands
53377,8/1/2022,HND,Johor,1,0,1,Honduras
53378,8/1/2022,HND,Kedah,0,0,0,Honduras
53379,8/1/2022,HND,Perak,0,0,0,Honduras
53380,8/1/2022,HND,Pulau Pinang,1,0,1,Honduras
53381,8/1/2022,HND,Sabah,0,0,0,Honduras
53382,8/1/2022,HND,Sarawak,0,0,0,Honduras
53383,8/1/2022,HND,Selangor,9,5,4,Honduras
53384,8/1/2022,HRV,Johor,13,9,4,Croatia
53385,8/1/2022,HRV,Kedah,2,0,2,Croatia
53386,8/1/2022,HRV,Kelantan,0,0,0,Croatia
53387,8/1/2022,HRV,Melaka,0,0,0,Croatia
53388,8/1/2022,HRV,Pahang,0,0,0,Croatia
53389,8/1/2022,HRV,Perak,0,0,0,Croatia
53390,8/1/2022,HRV,Perlis,0,0,0,Croatia
53391,8/1/2022,HRV,Pulau Pinang,3,1,2,Croatia
53392,8/1/2022,HRV,Sabah,5,5,0,Croatia
53393,8/1/2022,HRV,Sarawak,0,0,0,Croatia
53394,8/1/2022,HRV,Selangor,127,90,37,Croatia
53395,8/1/2022,HTI,Johor,0,0,0,Haiti
53396,8/1/2022,HTI,Kedah,0,0,0,Haiti
53397,8/1/2022,HTI,Kelantan,0,0,0,Haiti
53398,8/1/2022,HTI,Perak,0,0,0,Haiti
53399,8/1/2022,HTI,Pulau Pinang,0,0,0,Haiti
53400,8/1/2022,HTI,Sabah,0,0,0,Haiti
53401,8/1/2022,HTI,Selangor,1,1,0,Haiti
53402,8/1/2022,HUN,Johor,81,56,25,Hungary
53403,8/1/2022,HUN,Kedah,4,1,3,Hungary
53404,8/1/2022,HUN,Kelantan,0,0,0,Hungary
53405,8/1/2022,HUN,Pahang,0,0,0,Hungary
53406,8/1/2022,HUN,Perak,1,0,1,Hungary
53407,8/1/2022,HUN,Perlis,0,0,0,Hungary
53408,8/1/2022,HUN,Pulau Pinang,9,7,2,Hungary
53409,8/1/2022,HUN,Sabah,5,4,1,Hungary
53410,8/1/2022,HUN,Sarawak,2,2,0,Hungary
53411,8/1/2022,HUN,Selangor,245,137,108,Hungary
53412,8/1/2022,HUN,W.P. Labuan,0,0,0,Hungary
53413,8/1/2022,IDN,Johor,85856,48437,37419,Indonesia
53414,8/1/2022,IDN,Kedah,2239,857,1382,Indonesia
53415,8/1/2022,IDN,Kelantan,126,63,63,Indonesia
53416,8/1/2022,IDN,Melaka,6462,2744,3718,Indonesia
53417,8/1/2022,IDN,Negeri Sembilan,7501,5238,2263,Indonesia
53418,8/1/2022,IDN,Pahang,28,24,4,Indonesia
53419,8/1/2022,IDN,Perak,105,36,69,Indonesia
53420,8/1/2022,IDN,Perlis,291,128,163,Indonesia
53421,8/1/2022,IDN,Pulau Pinang,20947,7971,12976,Indonesia
53422,8/1/2022,IDN,Sabah,3757,1882,1875,Indonesia
53423,8/1/2022,IDN,Sarawak,24047,13692,10355,Indonesia
53424,8/1/2022,IDN,Selangor,60380,29211,31169,Indonesia
53425,8/1/2022,IDN,Terengganu,0,0,0,Indonesia
53426,8/1/2022,IDN,W.P. Labuan,11,4,7,Indonesia
53427,8/1/2022,IND,Johor,13312,9303,4009,India
53428,8/1/2022,IND,Kedah,514,286,228,India
53429,8/1/2022,IND,Kelantan,5,4,1,India
53430,8/1/2022,IND,Melaka,1,1,0,India
53431,8/1/2022,IND,Negeri Sembilan,0,0,0,India
53432,8/1/2022,IND,Pahang,0,0,0,India
53433,8/1/2022,IND,Perak,865,740,125,India
53434,8/1/2022,IND,Perlis,68,55,13,India
53435,8/1/2022,IND,Pulau Pinang,628,452,176,India
53436,8/1/2022,IND,Sabah,174,116,58,India
53437,8/1/2022,IND,Sarawak,199,160,39,India
53438,8/1/2022,IND,Selangor,40291,29328,10963,India
53439,8/1/2022,IND,Terengganu,0,0,0,India
53440,8/1/2022,IND,W.P. Labuan,4,3,1,India
53441,8/1/2022,IOT,Pulau Pinang,0,0,0,British Indian Ocean Territory
53442,8/1/2022,IOT,Selangor,0,0,0,British Indian Ocean Territory
53443,8/1/2022,IRL,Johor,199,130,69,Ireland
53444,8/1/2022,IRL,Kedah,27,14,13,Ireland
53445,8/1/2022,IRL,Kelantan,0,0,0,Ireland
53446,8/1/2022,IRL,Negeri Sembilan,0,0,0,Ireland
53447,8/1/2022,IRL,Pahang,0,0,0,Ireland
53448,8/1/2022,IRL,Perak,8,4,4,Ireland
53449,8/1/2022,IRL,Perlis,8,5,3,Ireland
53450,8/1/2022,IRL,Pulau Pinang,49,32,17,Ireland
53451,8/1/2022,IRL,Sabah,28,13,15,Ireland
53452,8/1/2022,IRL,Sarawak,28,13,15,Ireland
53453,8/1/2022,IRL,Selangor,973,567,406,Ireland
53454,8/1/2022,IRL,Terengganu,0,0,0,Ireland
53455,8/1/2022,IRL,W.P. Labuan,0,0,0,Ireland
53456,8/1/2022,IRN,Johor,62,41,21,Iran
53457,8/1/2022,IRN,Kedah,2,2,0,Iran
53458,8/1/2022,IRN,Kelantan,0,0,0,Iran
53459,8/1/2022,IRN,Perak,0,0,0,Iran
53460,8/1/2022,IRN,Perlis,0,0,0,Iran
53461,8/1/2022,IRN,Pulau Pinang,2,1,1,Iran
53462,8/1/2022,IRN,Sabah,3,2,1,Iran
53463,8/1/2022,IRN,Sarawak,1,0,1,Iran
53464,8/1/2022,IRN,Selangor,1129,600,529,Iran
53465,8/1/2022,IRN,W.P. Labuan,0,0,0,Iran
53466,8/1/2022,IRQ,Johor,14,10,4,Iraq
53467,8/1/2022,IRQ,Kedah,5,2,3,Iraq
53468,8/1/2022,IRQ,Kelantan,0,0,0,Iraq
53469,8/1/2022,IRQ,Melaka,4,3,1,Iraq
53470,8/1/2022,IRQ,Pahang,0,0,0,Iraq
53471,8/1/2022,IRQ,Perak,0,0,0,Iraq
53472,8/1/2022,IRQ,Perlis,0,0,0,Iraq
53473,8/1/2022,IRQ,Pulau Pinang,2,2,0,Iraq
53474,8/1/2022,IRQ,Sabah,1,1,0,Iraq
53475,8/1/2022,IRQ,Sarawak,0,0,0,Iraq
53476,8/1/2022,IRQ,Selangor,872,523,349,Iraq
53477,8/1/2022,ISL,Johor,2,2,0,Iceland
53478,8/1/2022,ISL,Kedah,2,2,0,Iceland
53479,8/1/2022,ISL,Kelantan,0,0,0,Iceland
53480,8/1/2022,ISL,Perak,0,0,0,Iceland
53481,8/1/2022,ISL,Perlis,0,0,0,Iceland
53482,8/1/2022,ISL,Pulau Pinang,1,1,0,Iceland
53483,8/1/2022,ISL,Sabah,0,0,0,Iceland
53484,8/1/2022,ISL,Sarawak,5,3,2,Iceland
53485,8/1/2022,ISL,Selangor,17,12,5,Iceland
53486,8/1/2022,ISL,W.P. Labuan,0,0,0,Iceland
53487,8/1/2022,ISR,Pulau Pinang,0,0,0,Israel
53488,8/1/2022,ITA,Johor,923,555,368,Italy
53489,8/1/2022,ITA,Kedah,65,38,27,Italy
53490,8/1/2022,ITA,Kelantan,7,2,5,Italy
53491,8/1/2022,ITA,Melaka,0,0,0,Italy
53492,8/1/2022,ITA,Negeri Sembilan,0,0,0,Italy
53493,8/1/2022,ITA,Pahang,1,1,0,Italy
53494,8/1/2022,ITA,Perak,12,5,7,Italy
53495,8/1/2022,ITA,Perlis,21,12,9,Italy
53496,8/1/2022,ITA,Pulau Pinang,145,88,57,Italy
53497,8/1/2022,ITA,Sabah,90,41,49,Italy
53498,8/1/2022,ITA,Sarawak,106,49,57,Italy
53499,8/1/2022,ITA,Selangor,4930,2751,2179,Italy
53500,8/1/2022,ITA,W.P. Labuan,0,0,0,Italy
53501,8/1/2022,JAM,Johor,0,0,0,Jamaica
53502,8/1/2022,JAM,Kedah,0,0,0,Jamaica
53503,8/1/2022,JAM,Perak,0,0,0,Jamaica
53504,8/1/2022,JAM,Pulau Pinang,2,1,1,Jamaica
53505,8/1/2022,JAM,Sabah,0,0,0,Jamaica
53506,8/1/2022,JAM,Sarawak,0,0,0,Jamaica
53507,8/1/2022,JAM,Selangor,21,12,9,Jamaica
53508,8/1/2022,JAM,W.P. Labuan,0,0,0,Jamaica
53509,8/1/2022,JOR,Johor,5,4,1,Jordan
53510,8/1/2022,JOR,Kedah,1,1,0,Jordan
53511,8/1/2022,JOR,Kelantan,0,0,0,Jordan
53512,8/1/2022,JOR,Melaka,0,0,0,Jordan
53513,8/1/2022,JOR,Perlis,0,0,0,Jordan
53514,8/1/2022,JOR,Pulau Pinang,2,1,1,Jordan
53515,8/1/2022,JOR,Sabah,0,0,0,Jordan
53516,8/1/2022,JOR,Sarawak,0,0,0,Jordan
53517,8/1/2022,JOR,Selangor,648,382,266,Jordan
53518,8/1/2022,JOR,W.P. Labuan,0,0,0,Jordan
53519,8/1/2022,JPN,Johor,4695,3275,1420,Japan
53520,8/1/2022,JPN,Kedah,142,71,71,Japan
53521,8/1/2022,JPN,Kelantan,6,4,2,Japan
53522,8/1/2022,JPN,Melaka,0,0,0,Japan
53523,8/1/2022,JPN,Negeri Sembilan,0,0,0,Japan
53524,8/1/2022,JPN,Pahang,6,4,2,Japan
53525,8/1/2022,JPN,Perak,34,20,14,Japan
53526,8/1/2022,JPN,Perlis,26,18,8,Japan
53527,8/1/2022,JPN,Pulau Pinang,1091,710,381,Japan
53528,8/1/2022,JPN,Sabah,240,104,136,Japan
53529,8/1/2022,JPN,Sarawak,113,60,53,Japan
53530,8/1/2022,JPN,Selangor,11022,6681,4341,Japan
53531,8/1/2022,JPN,W.P. Labuan,6,4,2,Japan
53532,8/1/2022,KAZ,Johor,31,17,14,Kazakhstan
53533,8/1/2022,KAZ,Kedah,8,2,6,Kazakhstan
53534,8/1/2022,KAZ,Kelantan,0,0,0,Kazakhstan
53535,8/1/2022,KAZ,Melaka,0,0,0,Kazakhstan
53536,8/1/2022,KAZ,Perak,0,0,0,Kazakhstan
53537,8/1/2022,KAZ,Perlis,0,0,0,Kazakhstan
53538,8/1/2022,KAZ,Pulau Pinang,1,1,0,Kazakhstan
53539,8/1/2022,KAZ,Sabah,5,1,4,Kazakhstan
53540,8/1/2022,KAZ,Sarawak,2,0,2,Kazakhstan
53541,8/1/2022,KAZ,Selangor,378,184,194,Kazakhstan
53542,8/1/2022,KAZ,W.P. Labuan,0,0,0,Kazakhstan
53543,8/1/2022,KEN,Johor,35,13,22,Kenya
53544,8/1/2022,KEN,Kedah,6,5,1,Kenya
53545,8/1/2022,KEN,Kelantan,0,0,0,Kenya
53546,8/1/2022,KEN,Perak,0,0,0,Kenya
53547,8/1/2022,KEN,Perlis,0,0,0,Kenya
53548,8/1/2022,KEN,Pulau Pinang,2,1,1,Kenya
53549,8/1/2022,KEN,Sabah,1,1,0,Kenya
53550,8/1/2022,KEN,Sarawak,1,0,1,Kenya
53551,8/1/2022,KEN,Selangor,219,116,103,Kenya
53552,8/1/2022,KGZ,Johor,20,6,14,Kyrgyzstan
53553,8/1/2022,KGZ,Kedah,0,0,0,Kyrgyzstan
53554,8/1/2022,KGZ,Kelantan,1,0,1,Kyrgyzstan
53555,8/1/2022,KGZ,Perak,0,0,0,Kyrgyzstan
53556,8/1/2022,KGZ,Perlis,0,0,0,Kyrgyzstan
53557,8/1/2022,KGZ,Pulau Pinang,0,0,0,Kyrgyzstan
53558,8/1/2022,KGZ,Sabah,0,0,0,Kyrgyzstan
53559,8/1/2022,KGZ,Sarawak,0,0,0,Kyrgyzstan
53560,8/1/2022,KGZ,Selangor,172,90,82,Kyrgyzstan
53561,8/1/2022,KHM,Johor,1325,588,737,Cambodia
53562,8/1/2022,KHM,Kedah,57,44,13,Cambodia
53563,8/1/2022,KHM,Kelantan,514,316,198,Cambodia
53564,8/1/2022,KHM,Melaka,0,0,0,Cambodia
53565,8/1/2022,KHM,Negeri Sembilan,0,0,0,Cambodia
53566,8/1/2022,KHM,Pahang,0,0,0,Cambodia
53567,8/1/2022,KHM,Perak,20,16,4,Cambodia
53568,8/1/2022,KHM,Perlis,1020,647,373,Cambodia
53569,8/1/2022,KHM,Pulau Pinang,18,8,10,Cambodia
53570,8/1/2022,KHM,Sabah,0,0,0,Cambodia
53571,8/1/2022,KHM,Sarawak,2,1,1,Cambodia
53572,8/1/2022,KHM,Selangor,3146,1562,1584,Cambodia
53573,8/1/2022,KHM,W.P. Labuan,0,0,0,Cambodia
53574,8/1/2022,KIR,Johor,0,0,0,Kiribati
53575,8/1/2022,KIR,Sabah,0,0,0,Kiribati
53576,8/1/2022,KIR,Selangor,0,0,0,Kiribati
53577,8/1/2022,KNA,Johor,19,10,9,Saint Kitts and Nevis
53578,8/1/2022,KNA,Kedah,0,0,0,Saint Kitts and Nevis
53579,8/1/2022,KNA,Perlis,1,1,0,Saint Kitts and Nevis
53580,8/1/2022,KNA,Pulau Pinang,0,0,0,Saint Kitts and Nevis
53581,8/1/2022,KNA,Sabah,0,0,0,Saint Kitts and Nevis
53582,8/1/2022,KNA,Selangor,33,29,4,Saint Kitts and Nevis
53583,8/1/2022,KNA,W.P. Labuan,0,0,0,Saint Kitts and Nevis
53584,8/1/2022,KOR,Johor,8356,4576,3780,"Korea, Republic of (South Korea)"
53585,8/1/2022,KOR,Kedah,125,60,65,"Korea, Republic of (South Korea)"
53586,8/1/2022,KOR,Kelantan,1,1,0,"Korea, Republic of (South Korea)"
53587,8/1/2022,KOR,Melaka,4,4,0,"Korea, Republic of (South Korea)"
53588,8/1/2022,KOR,Negeri Sembilan,0,0,0,"Korea, Republic of (South Korea)"
53589,8/1/2022,KOR,Pahang,0,0,0,"Korea, Republic of (South Korea)"
53590,8/1/2022,KOR,Perak,15,10,5,"Korea, Republic of (South Korea)"
53591,8/1/2022,KOR,Perlis,47,33,14,"Korea, Republic of (South Korea)"
53592,8/1/2022,KOR,Pulau Pinang,480,270,210,"Korea, Republic of (South Korea)"
53593,8/1/2022,KOR,Sabah,8892,3946,4946,"Korea, Republic of (South Korea)"
53594,8/1/2022,KOR,Sarawak,110,69,41,"Korea, Republic of (South Korea)"
53595,8/1/2022,KOR,Selangor,8249,4679,3570,"Korea, Republic of (South Korea)"
53596,8/1/2022,KOR,Terengganu,0,0,0,"Korea, Republic of (South Korea)"
53597,8/1/2022,KOR,W.P. Labuan,1,0,1,"Korea, Republic of (South Korea)"
53598,8/1/2022,KWT,Johor,100,58,42,Kuwait
53599,8/1/2022,KWT,Kedah,23,13,10,Kuwait
53600,8/1/2022,KWT,Kelantan,0,0,0,Kuwait
53601,8/1/2022,KWT,Perak,1,1,0,Kuwait
53602,8/1/2022,KWT,Perlis,0,0,0,Kuwait
53603,8/1/2022,KWT,Pulau Pinang,13,6,7,Kuwait
53604,8/1/2022,KWT,Sabah,0,0,0,Kuwait
53605,8/1/2022,KWT,Sarawak,0,0,0,Kuwait
53606,8/1/2022,KWT,Selangor,1308,641,667,Kuwait
53607,8/1/2022,KWT,W.P. Labuan,0,0,0,Kuwait
53608,8/1/2022,LAO,Johor,48,12,36,Lao People's Democratic Republic
53609,8/1/2022,LAO,Kedah,212,32,180,Lao People's Democratic Republic
53610,8/1/2022,LAO,Kelantan,82,5,77,Lao People's Democratic Republic
53611,8/1/2022,LAO,Melaka,0,0,0,Lao People's Democratic Republic
53612,8/1/2022,LAO,Perak,27,3,24,Lao People's Democratic Republic
53613,8/1/2022,LAO,Perlis,475,79,396,Lao People's Democratic Republic
53614,8/1/2022,LAO,Pulau Pinang,10,1,9,Lao People's Democratic Republic
53615,8/1/2022,LAO,Sabah,1,0,1,Lao People's Democratic Republic
53616,8/1/2022,LAO,Sarawak,6,4,2,Lao People's Democratic Republic
53617,8/1/2022,LAO,Selangor,309,105,204,Lao People's Democratic Republic
53618,8/1/2022,LAO,W.P. Labuan,0,0,0,Lao People's Democratic Republic
53619,8/1/2022,LBN,Johor,13,11,2,Lebanon
53620,8/1/2022,LBN,Kedah,1,1,0,Lebanon
53621,8/1/2022,LBN,Kelantan,0,0,0,Lebanon
53622,8/1/2022,LBN,Pahang,0,0,0,Lebanon
53623,8/1/2022,LBN,Perak,0,0,0,Lebanon
53624,8/1/2022,LBN,Perlis,0,0,0,Lebanon
53625,8/1/2022,LBN,Pulau Pinang,2,1,1,Lebanon
53626,8/1/2022,LBN,Sabah,1,0,1,Lebanon
53627,8/1/2022,LBN,Sarawak,0,0,0,Lebanon
53628,8/1/2022,LBN,Selangor,177,115,62,Lebanon
53629,8/1/2022,LBN,W.P. Labuan,1,1,0,Lebanon
53630,8/1/2022,LBR,Johor,3,3,0,Liberia
53631,8/1/2022,LBR,Kedah,0,0,0,Liberia
53632,8/1/2022,LBR,Sabah,0,0,0,Liberia
53633,8/1/2022,LBR,Sarawak,0,0,0,Liberia
53634,8/1/2022,LBR,Selangor,5,2,3,Liberia
53635,8/1/2022,LBY,Johor,3,3,0,Libyan Arab Jamahiriya
53636,8/1/2022,LBY,Kedah,0,0,0,Libyan Arab Jamahiriya
53637,8/1/2022,LBY,Perlis,0,0,0,Libyan Arab Jamahiriya
53638,8/1/2022,LBY,Pulau Pinang,0,0,0,Libyan Arab Jamahiriya
53639,8/1/2022,LBY,Sabah,0,0,0,Libyan Arab Jamahiriya
53640,8/1/2022,LBY,Sarawak,7,3,4,Libyan Arab Jamahiriya
53641,8/1/2022,LBY,Selangor,258,180,78,Libyan Arab Jamahiriya
53642,8/1/2022,LCA,Johor,3,3,0,Saint Lucia
53643,8/1/2022,LCA,Kedah,0,0,0,Saint Lucia
53644,8/1/2022,LCA,Pulau Pinang,0,0,0,Saint Lucia
53645,8/1/2022,LCA,Sarawak,0,0,0,Saint Lucia
53646,8/1/2022,LCA,Selangor,13,5,8,Saint Lucia
53647,8/1/2022,LIE,Johor,1,1,0,Liechtenstein
53648,8/1/2022,LIE,Kedah,0,0,0,Liechtenstein
53649,8/1/2022,LIE,Perlis,0,0,0,Liechtenstein
53650,8/1/2022,LIE,Pulau Pinang,0,0,0,Liechtenstein
53651,8/1/2022,LIE,Sabah,0,0,0,Liechtenstein
53652,8/1/2022,LIE,Sarawak,0,0,0,Liechtenstein
53653,8/1/2022,LIE,Selangor,2,1,1,Liechtenstein
53654,8/1/2022,LKA,Johor,1010,659,351,Sri Lanka
53655,8/1/2022,LKA,Kedah,53,30,23,Sri Lanka
53656,8/1/2022,LKA,Kelantan,0,0,0,Sri Lanka
53657,8/1/2022,LKA,Melaka,0,0,0,Sri Lanka
53658,8/1/2022,LKA,Pahang,0,0,0,Sri Lanka
53659,8/1/2022,LKA,Perak,6,3,3,Sri Lanka
53660,8/1/2022,LKA,Perlis,2,1,1,Sri Lanka
53661,8/1/2022,LKA,Pulau Pinang,27,16,11,Sri Lanka
53662,8/1/2022,LKA,Sabah,2,1,1,Sri Lanka
53663,8/1/2022,LKA,Sarawak,12,11,1,Sri Lanka
53664,8/1/2022,LKA,Selangor,2490,1615,875,Sri Lanka
53665,8/1/2022,LKA,W.P. Labuan,0,0,0,Sri Lanka
53666,8/1/2022,LSO,Johor,0,0,0,Lesotho
53667,8/1/2022,LSO,Kedah,0,0,0,Lesotho
53668,8/1/2022,LSO,Pulau Pinang,0,0,0,Lesotho
53669,8/1/2022,LSO,Sarawak,0,0,0,Lesotho
53670,8/1/2022,LSO,Selangor,1,1,0,Lesotho
53671,8/1/2022,LTU,Johor,21,6,15,Lithuania
53672,8/1/2022,LTU,Kedah,5,1,4,Lithuania
53673,8/1/2022,LTU,Kelantan,0,0,0,Lithuania
53674,8/1/2022,LTU,Pahang,0,0,0,Lithuania
53675,8/1/2022,LTU,Perak,0,0,0,Lithuania
53676,8/1/2022,LTU,Perlis,2,2,0,Lithuania
53677,8/1/2022,LTU,Pulau Pinang,12,5,7,Lithuania
53678,8/1/2022,LTU,Sabah,1,1,0,Lithuania
53679,8/1/2022,LTU,Sarawak,2,0,2,Lithuania
53680,8/1/2022,LTU,Selangor,128,78,50,Lithuania
53681,8/1/2022,LTU,W.P. Labuan,0,0,0,Lithuania
53682,8/1/2022,LUX,Johor,5,0,5,Luxembourg
53683,8/1/2022,LUX,Kedah,4,2,2,Luxembourg
53684,8/1/2022,LUX,Kelantan,0,0,0,Luxembourg
53685,8/1/2022,LUX,Perak,0,0,0,Luxembourg
53686,8/1/2022,LUX,Perlis,2,1,1,Luxembourg
53687,8/1/2022,LUX,Pulau Pinang,4,3,1,Luxembourg
53688,8/1/2022,LUX,Sabah,0,0,0,Luxembourg
53689,8/1/2022,LUX,Sarawak,0,0,0,Luxembourg
53690,8/1/2022,LUX,Selangor,55,31,24,Luxembourg
53691,8/1/2022,LVA,Johor,6,5,1,Latvia
53692,8/1/2022,LVA,Kedah,3,1,2,Latvia
53693,8/1/2022,LVA,Kelantan,0,0,0,Latvia
53694,8/1/2022,LVA,Pahang,0,0,0,Latvia
53695,8/1/2022,LVA,Perak,0,0,0,Latvia
53696,8/1/2022,LVA,Perlis,0,0,0,Latvia
53697,8/1/2022,LVA,Pulau Pinang,1,0,1,Latvia
53698,8/1/2022,LVA,Sabah,0,0,0,Latvia
53699,8/1/2022,LVA,Sarawak,4,3,1,Latvia
53700,8/1/2022,LVA,Selangor,98,58,40,Latvia
53701,8/1/2022,LVA,W.P. Labuan,0,0,0,Latvia
53702,8/1/2022,MAC,Johor,0,0,0,Macao
53703,8/1/2022,MAC,Pahang,0,0,0,Macao
53704,8/1/2022,MAC,Perak,0,0,0,Macao
53705,8/1/2022,MAC,Selangor,0,0,0,Macao
53706,8/1/2022,MAC,W.P. Labuan,0,0,0,Macao
53707,8/1/2022,MAR,Johor,69,49,20,Morocco
53708,8/1/2022,MAR,Kedah,9,4,5,Morocco
53709,8/1/2022,MAR,Kelantan,1,1,0,Morocco
53710,8/1/2022,MAR,Melaka,1,0,1,Morocco
53711,8/1/2022,MAR,Pahang,0,0,0,Morocco
53712,8/1/2022,MAR,Perak,0,0,0,Morocco
53713,8/1/2022,MAR,Perlis,4,2,2,Morocco
53714,8/1/2022,MAR,Pulau Pinang,6,3,3,Morocco
53715,8/1/2022,MAR,Sabah,1,1,0,Morocco
53716,8/1/2022,MAR,Sarawak,2,2,0,Morocco
53717,8/1/2022,MAR,Selangor,851,389,462,Morocco
53718,8/1/2022,MAR,W.P. Labuan,0,0,0,Morocco
53719,8/1/2022,MCO,Johor,0,0,0,Monaco
53720,8/1/2022,MCO,Kedah,0,0,0,Monaco
53721,8/1/2022,MCO,Sabah,0,0,0,Monaco
53722,8/1/2022,MCO,Selangor,0,0,0,Monaco
53723,8/1/2022,MDA,Johor,2,1,1,"Moldova, Republic of"
53724,8/1/2022,MDA,Kedah,0,0,0,"Moldova, Republic of"
53725,8/1/2022,MDA,Kelantan,0,0,0,"Moldova, Republic of"
53726,8/1/2022,MDA,Negeri Sembilan,0,0,0,"Moldova, Republic of"
53727,8/1/2022,MDA,Perlis,0,0,0,"Moldova, Republic of"
53728,8/1/2022,MDA,Pulau Pinang,0,0,0,"Moldova, Republic of"
53729,8/1/2022,MDA,Sabah,0,0,0,"Moldova, Republic of"
53730,8/1/2022,MDA,Sarawak,0,0,0,"Moldova, Republic of"
53731,8/1/2022,MDA,Selangor,22,11,11,"Moldova, Republic of"
53732,8/1/2022,MDG,Johor,5,3,2,Madagascar
53733,8/1/2022,MDG,Kedah,0,0,0,Madagascar
53734,8/1/2022,MDG,Perak,0,0,0,Madagascar
53735,8/1/2022,MDG,Perlis,0,0,0,Madagascar
53736,8/1/2022,MDG,Pulau Pinang,0,0,0,Madagascar
53737,8/1/2022,MDG,Sabah,0,0,0,Madagascar
53738,8/1/2022,MDG,Sarawak,0,0,0,Madagascar
53739,8/1/2022,MDG,Selangor,12,4,8,Madagascar
53740,8/1/2022,MDV,Johor,71,46,25,Maldives
53741,8/1/2022,MDV,Kedah,6,3,3,Maldives
53742,8/1/2022,MDV,Kelantan,0,0,0,Maldives
53743,8/1/2022,MDV,Perak,4,2,2,Maldives
53744,8/1/2022,MDV,Perlis,0,0,0,Maldives
53745,8/1/2022,MDV,Pulau Pinang,2,1,1,Maldives
53746,8/1/2022,MDV,Sabah,0,0,0,Maldives
53747,8/1/2022,MDV,Sarawak,3,1,2,Maldives
53748,8/1/2022,MDV,Selangor,1763,897,866,Maldives
53749,8/1/2022,MEX,Johor,73,41,32,Mexico
53750,8/1/2022,MEX,Kedah,2,0,2,Mexico
53751,8/1/2022,MEX,Kelantan,0,0,0,Mexico
53752,8/1/2022,MEX,Pahang,0,0,0,Mexico
53753,8/1/2022,MEX,Perak,0,0,0,Mexico
53754,8/1/2022,MEX,Perlis,2,2,0,Mexico
53755,8/1/2022,MEX,Pulau Pinang,31,23,8,Mexico
53756,8/1/2022,MEX,Sabah,5,2,3,Mexico
53757,8/1/2022,MEX,Sarawak,2,1,1,Mexico
53758,8/1/2022,MEX,Selangor,306,167,139,Mexico
53759,8/1/2022,MEX,W.P. Labuan,0,0,0,Mexico
53760,8/1/2022,MHL,Johor,0,0,0,Marshall Islands
53761,8/1/2022,MHL,Kedah,0,0,0,Marshall Islands
53762,8/1/2022,MHL,Perak,0,0,0,Marshall Islands
53763,8/1/2022,MHL,Pulau Pinang,0,0,0,Marshall Islands
53764,8/1/2022,MHL,Sabah,0,0,0,Marshall Islands
53765,8/1/2022,MHL,Selangor,2,2,0,Marshall Islands
53766,8/1/2022,MKD,Johor,2,1,1,"Macedonia, the former Yugoslav Republic of"
53767,8/1/2022,MKD,Kedah,0,0,0,"Macedonia, the former Yugoslav Republic of"
53768,8/1/2022,MKD,Perak,0,0,0,"Macedonia, the former Yugoslav Republic of"
53769,8/1/2022,MKD,Pulau Pinang,0,0,0,"Macedonia, the former Yugoslav Republic of"
53770,8/1/2022,MKD,Sabah,0,0,0,"Macedonia, the former Yugoslav Republic of"
53771,8/1/2022,MKD,Sarawak,0,0,0,"Macedonia, the former Yugoslav Republic of"
53772,8/1/2022,MKD,Selangor,20,15,5,"Macedonia, the former Yugoslav Republic of"
53773,8/1/2022,MLI,Johor,5,5,0,Mali
53774,8/1/2022,MLI,Sabah,0,0,0,Mali
53775,8/1/2022,MLI,Selangor,3,3,0,Mali
53776,8/1/2022,MLT,Johor,4,2,2,Malta
53777,8/1/2022,MLT,Kedah,0,0,0,Malta
53778,8/1/2022,MLT,Kelantan,0,0,0,Malta
53779,8/1/2022,MLT,Perak,0,0,0,Malta
53780,8/1/2022,MLT,Perlis,0,0,0,Malta
53781,8/1/2022,MLT,Pulau Pinang,0,0,0,Malta
53782,8/1/2022,MLT,Sabah,0,0,0,Malta
53783,8/1/2022,MLT,Sarawak,4,2,2,Malta
53784,8/1/2022,MLT,Selangor,55,29,26,Malta
53785,8/1/2022,MLT,W.P. Labuan,0,0,0,Malta
53786,8/1/2022,MMR,Johor,2736,921,1815,Myanmar
53787,8/1/2022,MMR,Kedah,21,5,16,Myanmar
53788,8/1/2022,MMR,Kelantan,1,0,1,Myanmar
53789,8/1/2022,MMR,Negeri Sembilan,0,0,0,Myanmar
53790,8/1/2022,MMR,Pahang,0,0,0,Myanmar
53791,8/1/2022,MMR,Perak,6,3,3,Myanmar
53792,8/1/2022,MMR,Perlis,2,0,2,Myanmar
53793,8/1/2022,MMR,Pulau Pinang,104,44,60,Myanmar
53794,8/1/2022,MMR,Sabah,15,7,8,Myanmar
53795,8/1/2022,MMR,Sarawak,49,25,24,Myanmar
53796,8/1/2022,MMR,Selangor,6512,4147,2365,Myanmar
53797,8/1/2022,MMR,Terengganu,0,0,0,Myanmar
53798,8/1/2022,MMR,W.P. Labuan,0,0,0,Myanmar
53799,8/1/2022,MNE,Johor,3,3,0,Montenegro
53800,8/1/2022,MNE,Kedah,0,0,0,Montenegro
53801,8/1/2022,MNE,Pulau Pinang,0,0,0,Montenegro
53802,8/1/2022,MNE,Sabah,0,0,0,Montenegro
53803,8/1/2022,MNE,Sarawak,0,0,0,Montenegro
53804,8/1/2022,MNE,Selangor,4,4,0,Montenegro
53805,8/1/2022,MNG,Johor,114,45,69,Mongolia
53806,8/1/2022,MNG,Kedah,0,0,0,Mongolia
53807,8/1/2022,MNG,Kelantan,0,0,0,Mongolia
53808,8/1/2022,MNG,Perak,0,0,0,Mongolia
53809,8/1/2022,MNG,Perlis,0,0,0,Mongolia
53810,8/1/2022,MNG,Pulau Pinang,6,3,3,Mongolia
53811,8/1/2022,MNG,Sabah,0,0,0,Mongolia
53812,8/1/2022,MNG,Sarawak,0,0,0,Mongolia
53813,8/1/2022,MNG,Selangor,169,65,104,Mongolia
53814,8/1/2022,MNP,Selangor,0,0,0,Northern Mariana Islands
53815,8/1/2022,MOZ,Johor,0,0,0,Mozambique
53816,8/1/2022,MOZ,Kedah,0,0,0,Mozambique
53817,8/1/2022,MOZ,Perak,0,0,0,Mozambique
53818,8/1/2022,MOZ,Pulau Pinang,0,0,0,Mozambique
53819,8/1/2022,MOZ,Sabah,0,0,0,Mozambique
53820,8/1/2022,MOZ,Sarawak,1,1,0,Mozambique
53821,8/1/2022,MOZ,Selangor,16,10,6,Mozambique
53822,8/1/2022,MRT,Johor,4,1,3,Mauritania
53823,8/1/2022,MRT,Kedah,1,1,0,Mauritania
53824,8/1/2022,MRT,Pulau Pinang,0,0,0,Mauritania
53825,8/1/2022,MRT,Sabah,0,0,0,Mauritania
53826,8/1/2022,MRT,Sarawak,0,0,0,Mauritania
53827,8/1/2022,MRT,Selangor,21,16,5,Mauritania
53828,8/1/2022,MUS,Johor,59,32,27,Mauritius
53829,8/1/2022,MUS,Kedah,2,0,2,Mauritius
53830,8/1/2022,MUS,Kelantan,0,0,0,Mauritius
53831,8/1/2022,MUS,Pahang,0,0,0,Mauritius
53832,8/1/2022,MUS,Perak,1,0,1,Mauritius
53833,8/1/2022,MUS,Perlis,0,0,0,Mauritius
53834,8/1/2022,MUS,Pulau Pinang,7,2,5,Mauritius
53835,8/1/2022,MUS,Sabah,0,0,0,Mauritius
53836,8/1/2022,MUS,Sarawak,0,0,0,Mauritius
53837,8/1/2022,MUS,Selangor,266,137,129,Mauritius
53838,8/1/2022,MWI,Johor,0,0,0,Malawi
53839,8/1/2022,MWI,Pulau Pinang,1,0,1,Malawi
53840,8/1/2022,MWI,Sabah,0,0,0,Malawi
53841,8/1/2022,MWI,Sarawak,0,0,0,Malawi
53842,8/1/2022,MWI,Selangor,28,16,12,Malawi
53843,8/1/2022,MYT,Selangor,0,0,0,Mayotte
53844,8/1/2022,NAM,Johor,1,0,1,Namibia
53845,8/1/2022,NAM,Kedah,0,0,0,Namibia
53846,8/1/2022,NAM,Perak,0,0,0,Namibia
53847,8/1/2022,NAM,Perlis,0,0,0,Namibia
53848,8/1/2022,NAM,Pulau Pinang,0,0,0,Namibia
53849,8/1/2022,NAM,Sabah,0,0,0,Namibia
53850,8/1/2022,NAM,Sarawak,0,0,0,Namibia
53851,8/1/2022,NAM,Selangor,19,11,8,Namibia
53852,8/1/2022,NCL,Selangor,1,1,0,New Caledonia
53853,8/1/2022,NER,Johor,0,0,0,Niger
53854,8/1/2022,NER,Sabah,0,0,0,Niger
53855,8/1/2022,NER,Selangor,1,1,0,Niger
53856,8/1/2022,NGA,Johor,21,17,4,Nigeria
53857,8/1/2022,NGA,Kedah,1,1,0,Nigeria
53858,8/1/2022,NGA,Perlis,0,0,0,Nigeria
53859,8/1/2022,NGA,Pulau Pinang,3,3,0,Nigeria
53860,8/1/2022,NGA,Sabah,1,1,0,Nigeria
53861,8/1/2022,NGA,Sarawak,3,3,0,Nigeria
53862,8/1/2022,NGA,Selangor,319,252,67,Nigeria
53863,8/1/2022,NIC,Johor,4,2,2,Nicaragua
53864,8/1/2022,NIC,Kedah,0,0,0,Nicaragua
53865,8/1/2022,NIC,Pulau Pinang,0,0,0,Nicaragua
53866,8/1/2022,NIC,Sabah,0,0,0,Nicaragua
53867,8/1/2022,NIC,Selangor,3,2,1,Nicaragua
53868,8/1/2022,NLD,Johor,1040,645,395,Netherlands
53869,8/1/2022,NLD,Kedah,142,79,63,Netherlands
53870,8/1/2022,NLD,Kelantan,1,1,0,Netherlands
53871,8/1/2022,NLD,Melaka,0,0,0,Netherlands
53872,8/1/2022,NLD,Negeri Sembilan,1,1,0,Netherlands
53873,8/1/2022,NLD,Pahang,0,0,0,Netherlands
53874,8/1/2022,NLD,Perak,11,8,3,Netherlands
53875,8/1/2022,NLD,Perlis,24,15,9,Netherlands
53876,8/1/2022,NLD,Pulau Pinang,207,128,79,Netherlands
53877,8/1/2022,NLD,Sabah,93,48,45,Netherlands
53878,8/1/2022,NLD,Sarawak,146,87,59,Netherlands
53879,8/1/2022,NLD,Selangor,4282,2479,1803,Netherlands
53880,8/1/2022,NLD,Terengganu,0,0,0,Netherlands
53881,8/1/2022,NLD,W.P. Labuan,3,1,2,Netherlands
53882,8/1/2022,NOR,Johor,101,70,31,Norway
53883,8/1/2022,NOR,Kedah,3,3,0,Norway
53884,8/1/2022,NOR,Kelantan,3,3,0,Norway
53885,8/1/2022,NOR,Melaka,0,0,0,Norway
53886,8/1/2022,NOR,Pahang,0,0,0,Norway
53887,8/1/2022,NOR,Perak,0,0,0,Norway
53888,8/1/2022,NOR,Perlis,3,0,3,Norway
53889,8/1/2022,NOR,Pulau Pinang,33,21,12,Norway
53890,8/1/2022,NOR,Sabah,16,15,1,Norway
53891,8/1/2022,NOR,Sarawak,14,11,3,Norway
53892,8/1/2022,NOR,Selangor,422,281,141,Norway
53893,8/1/2022,NOR,W.P. Labuan,0,0,0,Norway
53894,8/1/2022,NPL,Johor,432,338,94,Nepal
53895,8/1/2022,NPL,Kedah,4,3,1,Nepal
53896,8/1/2022,NPL,Pahang,0,0,0,Nepal
53897,8/1/2022,NPL,Perak,0,0,0,Nepal
53898,8/1/2022,NPL,Perlis,0,0,0,Nepal
53899,8/1/2022,NPL,Pulau Pinang,19,16,3,Nepal
53900,8/1/2022,NPL,Sabah,9,8,1,Nepal
53901,8/1/2022,NPL,Sarawak,73,48,25,Nepal
53902,8/1/2022,NPL,Selangor,27956,27201,755,Nepal
53903,8/1/2022,NPL,W.P. Labuan,79,72,7,Nepal
53904,8/1/2022,NRU,Johor,0,0,0,Nauru
53905,8/1/2022,NRU,Pulau Pinang,0,0,0,Nauru
53906,8/1/2022,NRU,Selangor,0,0,0,Nauru
53907,8/1/2022,NZL,Johor,473,304,169,New Zealand
53908,8/1/2022,NZL,Kedah,46,24,22,New Zealand
53909,8/1/2022,NZL,Kelantan,0,0,0,New Zealand
53910,8/1/2022,NZL,Melaka,0,0,0,New Zealand
53911,8/1/2022,NZL,Negeri Sembilan,0,0,0,New Zealand
53912,8/1/2022,NZL,Pahang,1,1,0,New Zealand
53913,8/1/2022,NZL,Perak,11,5,6,New Zealand
53914,8/1/2022,NZL,Perlis,12,9,3,New Zealand
53915,8/1/2022,NZL,Pulau Pinang,136,83,53,New Zealand
53916,8/1/2022,NZL,Sabah,32,20,12,New Zealand
53917,8/1/2022,NZL,Sarawak,73,42,31,New Zealand
53918,8/1/2022,NZL,Selangor,1445,925,520,New Zealand
53919,8/1/2022,NZL,Terengganu,0,0,0,New Zealand
53920,8/1/2022,NZL,W.P. Labuan,0,0,0,New Zealand
53921,8/1/2022,OMN,Johor,125,75,50,Oman
53922,8/1/2022,OMN,Kedah,5,4,1,Oman
53923,8/1/2022,OMN,Kelantan,0,0,0,Oman
53924,8/1/2022,OMN,Melaka,0,0,0,Oman
53925,8/1/2022,OMN,Perak,0,0,0,Oman
53926,8/1/2022,OMN,Perlis,0,0,0,Oman
53927,8/1/2022,OMN,Pulau Pinang,10,7,3,Oman
53928,8/1/2022,OMN,Sabah,0,0,0,Oman
53929,8/1/2022,OMN,Sarawak,7,6,1,Oman
53930,8/1/2022,OMN,Selangor,1118,603,515,Oman
53931,8/1/2022,PAK,Johor,664,477,187,Pakistan
53932,8/1/2022,PAK,Kedah,93,69,24,Pakistan
53933,8/1/2022,PAK,Kelantan,20,20,0,Pakistan
53934,8/1/2022,PAK,Melaka,0,0,0,Pakistan
53935,8/1/2022,PAK,Negeri Sembilan,1,1,0,Pakistan
53936,8/1/2022,PAK,Pahang,0,0,0,Pakistan
53937,8/1/2022,PAK,Perak,32,27,5,Pakistan
53938,8/1/2022,PAK,Perlis,25,23,2,Pakistan
53939,8/1/2022,PAK,Pulau Pinang,50,34,16,Pakistan
53940,8/1/2022,PAK,Sabah,6,6,0,Pakistan
53941,8/1/2022,PAK,Sarawak,27,26,1,Pakistan
53942,8/1/2022,PAK,Selangor,8805,7367,1438,Pakistan
53943,8/1/2022,PAK,W.P. Labuan,0,0,0,Pakistan
53944,8/1/2022,PAN,Johor,1,1,0,Panama
53945,8/1/2022,PAN,Kedah,0,0,0,Panama
53946,8/1/2022,PAN,Perak,0,0,0,Panama
53947,8/1/2022,PAN,Perlis,0,0,0,Panama
53948,8/1/2022,PAN,Pulau Pinang,2,2,0,Panama
53949,8/1/2022,PAN,Sabah,0,0,0,Panama
53950,8/1/2022,PAN,Sarawak,0,0,0,Panama
53951,8/1/2022,PAN,Selangor,9,3,6,Panama
53952,8/1/2022,PER,Johor,26,19,7,Peru
53953,8/1/2022,PER,Kedah,2,0,2,Peru
53954,8/1/2022,PER,Kelantan,0,0,0,Peru
53955,8/1/2022,PER,Pahang,0,0,0,Peru
53956,8/1/2022,PER,Perak,0,0,0,Peru
53957,8/1/2022,PER,Perlis,0,0,0,Peru
53958,8/1/2022,PER,Pulau Pinang,11,4,7,Peru
53959,8/1/2022,PER,Sabah,1,1,0,Peru
53960,8/1/2022,PER,Sarawak,0,0,0,Peru
53961,8/1/2022,PER,Selangor,105,58,47,Peru
53962,8/1/2022,PER,W.P. Labuan,0,0,0,Peru
53963,8/1/2022,PHL,Johor,12757,4045,8712,Philippines
53964,8/1/2022,PHL,Kedah,189,67,122,Philippines
53965,8/1/2022,PHL,Kelantan,7,3,4,Philippines
53966,8/1/2022,PHL,Melaka,1,0,1,Philippines
53967,8/1/2022,PHL,Negeri Sembilan,0,0,0,Philippines
53968,8/1/2022,PHL,Pahang,32,27,5,Philippines
53969,8/1/2022,PHL,Perak,51,22,29,Philippines
53970,8/1/2022,PHL,Perlis,230,77,153,Philippines
53971,8/1/2022,PHL,Pulau Pinang,348,144,204,Philippines
53972,8/1/2022,PHL,Sabah,634,244,390,Philippines
53973,8/1/2022,PHL,Sarawak,543,223,320,Philippines
53974,8/1/2022,PHL,Selangor,11100,4475,6625,Philippines
53975,8/1/2022,PHL,Terengganu,0,0,0,Philippines
53976,8/1/2022,PHL,W.P. Labuan,25,4,21,Philippines
53977,8/1/2022,PLW,Johor,0,0,0,Palau
53978,8/1/2022,PLW,Pulau Pinang,0,0,0,Palau
53979,8/1/2022,PLW,Selangor,1,1,0,Palau
53980,8/1/2022,PNG,Johor,8,7,1,Papua New Guinea
53981,8/1/2022,PNG,Kedah,0,0,0,Papua New Guinea
53982,8/1/2022,PNG,Kelantan,0,0,0,Papua New Guinea
53983,8/1/2022,PNG,Perak,1,1,0,Papua New Guinea
53984,8/1/2022,PNG,Pulau Pinang,1,1,0,Papua New Guinea
53985,8/1/2022,PNG,Sabah,0,0,0,Papua New Guinea
53986,8/1/2022,PNG,Sarawak,4,1,3,Papua New Guinea
53987,8/1/2022,PNG,Selangor,38,18,20,Papua New Guinea
53988,8/1/2022,POL,Johor,320,174,146,Poland
53989,8/1/2022,POL,Kedah,14,6,8,Poland
53990,8/1/2022,POL,Kelantan,3,1,2,Poland
53991,8/1/2022,POL,Melaka,1,1,0,Poland
53992,8/1/2022,POL,Negeri Sembilan,0,0,0,Poland
53993,8/1/2022,POL,Pahang,0,0,0,Poland
53994,8/1/2022,POL,Perak,5,2,3,Poland
53995,8/1/2022,POL,Perlis,5,3,2,Poland
53996,8/1/2022,POL,Pulau Pinang,35,20,15,Poland
53997,8/1/2022,POL,Sabah,19,7,12,Poland
53998,8/1/2022,POL,Sarawak,46,21,25,Poland
53999,8/1/2022,POL,Selangor,863,433,430,Poland
54000,8/1/2022,POL,Terengganu,0,0,0,Poland
54001,8/1/2022,POL,W.P. Labuan,0,0,0,Poland
54002,8/1/2022,PRK,Selangor,0,0,0,"Korea, Democratic People's Republic of"
54003,8/1/2022,PRT,Johor,164,89,75,Portugal
54004,8/1/2022,PRT,Kedah,17,11,6,Portugal
54005,8/1/2022,PRT,Kelantan,0,0,0,Portugal
54006,8/1/2022,PRT,Melaka,0,0,0,Portugal
54007,8/1/2022,PRT,Pahang,0,0,0,Portugal
54008,8/1/2022,PRT,Perak,2,0,2,Portugal
54009,8/1/2022,PRT,Perlis,4,2,2,Portugal
54010,8/1/2022,PRT,Pulau Pinang,32,15,17,Portugal
54011,8/1/2022,PRT,Sabah,9,6,3,Portugal
54012,8/1/2022,PRT,Sarawak,7,3,4,Portugal
54013,8/1/2022,PRT,Selangor,739,422,317,Portugal
54014,8/1/2022,PRT,W.P. Labuan,0,0,0,Portugal
54015,8/1/2022,PRY,Johor,0,0,0,Paraguay
54016,8/1/2022,PRY,Kedah,0,0,0,Paraguay
54017,8/1/2022,PRY,Perak,0,0,0,Paraguay
54018,8/1/2022,PRY,Perlis,0,0,0,Paraguay
54019,8/1/2022,PRY,Pulau Pinang,1,0,1,Paraguay
54020,8/1/2022,PRY,Sabah,1,0,1,Paraguay
54021,8/1/2022,PRY,Sarawak,0,0,0,Paraguay
54022,8/1/2022,PRY,Selangor,8,2,6,Paraguay
54023,8/1/2022,PSE,Johor,6,4,2,"Palestinian Territory, Occupied"
54024,8/1/2022,PSE,Kedah,0,0,0,"Palestinian Territory, Occupied"
54025,8/1/2022,PSE,Kelantan,0,0,0,"Palestinian Territory, Occupied"
54026,8/1/2022,PSE,Melaka,0,0,0,"Palestinian Territory, Occupied"
54027,8/1/2022,PSE,Perak,0,0,0,"Palestinian Territory, Occupied"
54028,8/1/2022,PSE,Perlis,0,0,0,"Palestinian Territory, Occupied"
54029,8/1/2022,PSE,Pulau Pinang,0,0,0,"Palestinian Territory, Occupied"
54030,8/1/2022,PSE,Sabah,0,0,0,"Palestinian Territory, Occupied"
54031,8/1/2022,PSE,Sarawak,2,1,1,"Palestinian Territory, Occupied"
54032,8/1/2022,PSE,Selangor,283,182,101,"Palestinian Territory, Occupied"
54033,8/1/2022,QAT,Johor,9,5,4,Qatar
54034,8/1/2022,QAT,Kedah,0,0,0,Qatar
54035,8/1/2022,QAT,Perlis,0,0,0,Qatar
54036,8/1/2022,QAT,Pulau Pinang,0,0,0,Qatar
54037,8/1/2022,QAT,Sabah,0,0,0,Qatar
54038,8/1/2022,QAT,Sarawak,0,0,0,Qatar
54039,8/1/2022,QAT,Selangor,155,101,54,Qatar
54040,8/1/2022,REU,Johor,0,0,0,Reunion
54041,8/1/2022,REU,Sarawak,0,0,0,Reunion
54042,8/1/2022,ROU,Johor,98,46,52,Romania
54043,8/1/2022,ROU,Kedah,1,0,1,Romania
54044,8/1/2022,ROU,Kelantan,0,0,0,Romania
54045,8/1/2022,ROU,Negeri Sembilan,0,0,0,Romania
54046,8/1/2022,ROU,Pahang,0,0,0,Romania
54047,8/1/2022,ROU,Perak,0,0,0,Romania
54048,8/1/2022,ROU,Perlis,0,0,0,Romania
54049,8/1/2022,ROU,Pulau Pinang,9,5,4,Romania
54050,8/1/2022,ROU,Sabah,9,3,6,Romania
54051,8/1/2022,ROU,Sarawak,4,2,2,Romania
54052,8/1/2022,ROU,Selangor,374,195,179,Romania
54053,8/1/2022,ROU,W.P. Labuan,0,0,0,Romania
54054,8/1/2022,RUS,Johor,236,121,115,Russia
54055,8/1/2022,RUS,Kedah,48,21,27,Russia
54056,8/1/2022,RUS,Kelantan,2,1,1,Russia
54057,8/1/2022,RUS,Melaka,0,0,0,Russia
54058,8/1/2022,RUS,Negeri Sembilan,0,0,0,Russia
54059,8/1/2022,RUS,Pahang,0,0,0,Russia
54060,8/1/2022,RUS,Perak,1,1,0,Russia
54061,8/1/2022,RUS,Perlis,29,10,19,Russia
54062,8/1/2022,RUS,Pulau Pinang,36,21,15,Russia
54063,8/1/2022,RUS,Sabah,12,6,6,Russia
54064,8/1/2022,RUS,Sarawak,30,17,13,Russia
54065,8/1/2022,RUS,Selangor,2323,1164,1159,Russia
54066,8/1/2022,RUS,W.P. Labuan,0,0,0,Russia
54067,8/1/2022,RWA,Johor,0,0,0,Rwanda
54068,8/1/2022,RWA,Kedah,0,0,0,Rwanda
54069,8/1/2022,RWA,Pulau Pinang,0,0,0,Rwanda
54070,8/1/2022,RWA,Selangor,2,2,0,Rwanda
54071,8/1/2022,SAU,Johor,167,80,87,Saudi Arabia
54072,8/1/2022,SAU,Kedah,45,34,11,Saudi Arabia
54073,8/1/2022,SAU,Kelantan,9,2,7,Saudi Arabia
54074,8/1/2022,SAU,Melaka,0,0,0,Saudi Arabia
54075,8/1/2022,SAU,Perak,7,1,6,Saudi Arabia
54076,8/1/2022,SAU,Perlis,12,6,6,Saudi Arabia
54077,8/1/2022,SAU,Pulau Pinang,56,32,24,Saudi Arabia
54078,8/1/2022,SAU,Sabah,13,10,3,Saudi Arabia
54079,8/1/2022,SAU,Sarawak,14,11,3,Saudi Arabia
54080,8/1/2022,SAU,Selangor,6898,3563,3335,Saudi Arabia
54081,8/1/2022,SAU,W.P. Labuan,0,0,0,Saudi Arabia
54082,8/1/2022,SDN,Johor,9,3,6,Sudan
54083,8/1/2022,SDN,Kedah,1,1,0,Sudan
54084,8/1/2022,SDN,Kelantan,0,0,0,Sudan
54085,8/1/2022,SDN,Perlis,0,0,0,Sudan
54086,8/1/2022,SDN,Pulau Pinang,0,0,0,Sudan
54087,8/1/2022,SDN,Sabah,0,0,0,Sudan
54088,8/1/2022,SDN,Sarawak,2,2,0,Sudan
54089,8/1/2022,SDN,Selangor,1001,549,452,Sudan
54090,8/1/2022,SDN,W.P. Labuan,1,1,0,Sudan
54091,8/1/2022,SEN,Johor,1,0,1,Senegal
54092,8/1/2022,SEN,Kedah,2,1,1,Senegal
54093,8/1/2022,SEN,Kelantan,0,0,0,Senegal
54094,8/1/2022,SEN,Perak,0,0,0,Senegal
54095,8/1/2022,SEN,Perlis,0,0,0,Senegal
54096,8/1/2022,SEN,Pulau Pinang,0,0,0,Senegal
54097,8/1/2022,SEN,Sabah,0,0,0,Senegal
54098,8/1/2022,SEN,Sarawak,0,0,0,Senegal
54099,8/1/2022,SEN,Selangor,25,17,8,Senegal
54100,8/1/2022,SGP,Johor,925212,550835,374377,Singapore
54101,8/1/2022,SGP,Kedah,2394,1324,1070,Singapore
54102,8/1/2022,SGP,Kelantan,61,44,17,Singapore
54103,8/1/2022,SGP,Melaka,13,11,2,Singapore
54104,8/1/2022,SGP,Negeri Sembilan,0,0,0,Singapore
54105,8/1/2022,SGP,Pahang,75,47,28,Singapore
54106,8/1/2022,SGP,Perak,3457,1629,1828,Singapore
54107,8/1/2022,SGP,Perlis,147,98,49,Singapore
54108,8/1/2022,SGP,Pulau Pinang,11206,5832,5374,Singapore
54109,8/1/2022,SGP,Sabah,2101,1106,995,Singapore
54110,8/1/2022,SGP,Sarawak,2490,1521,969,Singapore
54111,8/1/2022,SGP,Selangor,27171,15045,12126,Singapore
54112,8/1/2022,SGP,Terengganu,0,0,0,Singapore
54113,8/1/2022,SGP,W.P. Labuan,4,4,0,Singapore
54114,8/1/2022,SGS,Johor,0,0,0,South Georgia and the South Sandwich Islands
54115,8/1/2022,SGS,Sabah,0,0,0,South Georgia and the South Sandwich Islands
54116,8/1/2022,SGS,Selangor,1,1,0,South Georgia and the South Sandwich Islands
54117,8/1/2022,SHN,Sarawak,0,0,0,"Saint Helena, Ascension and Tristan da Cunha"
54118,8/1/2022,SLB,Johor,0,0,0,Solomon Islands
54119,8/1/2022,SLB,Perlis,1,1,0,Solomon Islands
54120,8/1/2022,SLB,Pulau Pinang,0,0,0,Solomon Islands
54121,8/1/2022,SLB,Sabah,0,0,0,Solomon Islands
54122,8/1/2022,SLB,Sarawak,4,2,2,Solomon Islands
54123,8/1/2022,SLB,Selangor,9,4,5,Solomon Islands
54124,8/1/2022,SLB,W.P. Labuan,0,0,0,Solomon Islands
54125,8/1/2022,SLE,Johor,0,0,0,Sierra Leone
54126,8/1/2022,SLE,Kedah,0,0,0,Sierra Leone
54127,8/1/2022,SLE,Perak,0,0,0,Sierra Leone
54128,8/1/2022,SLE,Pulau Pinang,1,1,0,Sierra Leone
54129,8/1/2022,SLE,Sabah,0,0,0,Sierra Leone
54130,8/1/2022,SLE,Selangor,15,7,8,Sierra Leone
54131,8/1/2022,SLV,Johor,2,1,1,El Salvador
54132,8/1/2022,SLV,Kedah,0,0,0,El Salvador
54133,8/1/2022,SLV,Perak,0,0,0,El Salvador
54134,8/1/2022,SLV,Perlis,0,0,0,El Salvador
54135,8/1/2022,SLV,Pulau Pinang,1,0,1,El Salvador
54136,8/1/2022,SLV,Sabah,0,0,0,El Salvador
54137,8/1/2022,SLV,Selangor,11,7,4,El Salvador
54138,8/1/2022,SLV,W.P. Labuan,0,0,0,El Salvador
54139,8/1/2022,SMR,Johor,0,0,0,San Marino
54140,8/1/2022,SMR,Selangor,2,1,1,San Marino
54141,8/1/2022,SOM,Johor,0,0,0,Somalia
54142,8/1/2022,SOM,Kedah,0,0,0,Somalia
54143,8/1/2022,SOM,Kelantan,0,0,0,Somalia
54144,8/1/2022,SOM,Perlis,0,0,0,Somalia
54145,8/1/2022,SOM,Sabah,0,0,0,Somalia
54146,8/1/2022,SOM,Sarawak,0,0,0,Somalia
54147,8/1/2022,SOM,Selangor,200,120,80,Somalia
54148,8/1/2022,SRB,Johor,9,4,5,Serbia
54149,8/1/2022,SRB,Kedah,0,0,0,Serbia
54150,8/1/2022,SRB,Kelantan,0,0,0,Serbia
54151,8/1/2022,SRB,Pahang,0,0,0,Serbia
54152,8/1/2022,SRB,Perak,0,0,0,Serbia
54153,8/1/2022,SRB,Perlis,0,0,0,Serbia
54154,8/1/2022,SRB,Pulau Pinang,0,0,0,Serbia
54155,8/1/2022,SRB,Sabah,1,0,1,Serbia
54156,8/1/2022,SRB,Sarawak,0,0,0,Serbia
54157,8/1/2022,SRB,Selangor,28,17,11,Serbia
54158,8/1/2022,STP,Selangor,2,1,1,Sao Tome and Principe
54159,8/1/2022,SUR,Johor,2,2,0,Suriname
54160,8/1/2022,SUR,Kedah,0,0,0,Suriname
54161,8/1/2022,SUR,Kelantan,0,0,0,Suriname
54162,8/1/2022,SUR,Perak,0,0,0,Suriname
54163,8/1/2022,SUR,Perlis,0,0,0,Suriname
54164,8/1/2022,SUR,Pulau Pinang,0,0,0,Suriname
54165,8/1/2022,SUR,Sabah,0,0,0,Suriname
54166,8/1/2022,SUR,Sarawak,0,0,0,Suriname
54167,8/1/2022,SUR,Selangor,6,4,2,Suriname
54168,8/1/2022,SVK,Johor,19,10,9,Slovakia
54169,8/1/2022,SVK,Kedah,35,21,14,Slovakia
54170,8/1/2022,SVK,Kelantan,1,0,1,Slovakia
54171,8/1/2022,SVK,Negeri Sembilan,0,0,0,Slovakia
54172,8/1/2022,SVK,Pahang,0,0,0,Slovakia
54173,8/1/2022,SVK,Perak,0,0,0,Slovakia
54174,8/1/2022,SVK,Perlis,1,0,1,Slovakia
54175,8/1/2022,SVK,Pulau Pinang,6,2,4,Slovakia
54176,8/1/2022,SVK,Sabah,12,6,6,Slovakia
54177,8/1/2022,SVK,Sarawak,2,1,1,Slovakia
54178,8/1/2022,SVK,Selangor,214,113,101,Slovakia
54179,8/1/2022,SVK,W.P. Labuan,0,0,0,Slovakia
54180,8/1/2022,SVN,Johor,8,5,3,Slovenia
54181,8/1/2022,SVN,Kedah,1,0,1,Slovenia
54182,8/1/2022,SVN,Kelantan,0,0,0,Slovenia
54183,8/1/2022,SVN,Perak,0,0,0,Slovenia
54184,8/1/2022,SVN,Perlis,0,0,0,Slovenia
54185,8/1/2022,SVN,Pulau Pinang,0,0,0,Slovenia
54186,8/1/2022,SVN,Sabah,0,0,0,Slovenia
54187,8/1/2022,SVN,Sarawak,4,2,2,Slovenia
54188,8/1/2022,SVN,Selangor,72,42,30,Slovenia
54189,8/1/2022,SVN,W.P. Labuan,0,0,0,Slovenia
54190,8/1/2022,SWE,Johor,145,98,47,Sweden
54191,8/1/2022,SWE,Kedah,6,4,2,Sweden
54192,8/1/2022,SWE,Kelantan,10,5,5,Sweden
54193,8/1/2022,SWE,Melaka,0,0,0,Sweden
54194,8/1/2022,SWE,Negeri Sembilan,0,0,0,Sweden
54195,8/1/2022,SWE,Pahang,0,0,0,Sweden
54196,8/1/2022,SWE,Perak,1,1,0,Sweden
54197,8/1/2022,SWE,Perlis,0,0,0,Sweden
54198,8/1/2022,SWE,Pulau Pinang,32,20,12,Sweden
54199,8/1/2022,SWE,Sabah,7,4,3,Sweden
54200,8/1/2022,SWE,Sarawak,11,7,4,Sweden
54201,8/1/2022,SWE,Selangor,569,386,183,Sweden
54202,8/1/2022,SWE,W.P. Labuan,1,1,0,Sweden
54203,8/1/2022,SWZ,Johor,0,0,0,Swaziland
54204,8/1/2022,SWZ,Kedah,0,0,0,Swaziland
54205,8/1/2022,SWZ,Pulau Pinang,0,0,0,Swaziland
54206,8/1/2022,SWZ,Sabah,0,0,0,Swaziland
54207,8/1/2022,SWZ,Selangor,12,3,9,Swaziland
54208,8/1/2022,SYC,Johor,6,4,2,Seychelles
54209,8/1/2022,SYC,Kedah,0,0,0,Seychelles
54210,8/1/2022,SYC,Pulau Pinang,0,0,0,Seychelles
54211,8/1/2022,SYC,Sabah,0,0,0,Seychelles
54212,8/1/2022,SYC,Sarawak,0,0,0,Seychelles
54213,8/1/2022,SYC,Selangor,75,30,45,Seychelles
54214,8/1/2022,SYR,Johor,10,5,5,Syrian Arab Republic
54215,8/1/2022,SYR,Kedah,1,1,0,Syrian Arab Republic
54216,8/1/2022,SYR,Kelantan,0,0,0,Syrian Arab Republic
54217,8/1/2022,SYR,Pahang,0,0,0,Syrian Arab Republic
54218,8/1/2022,SYR,Perlis,0,0,0,Syrian Arab Republic
54219,8/1/2022,SYR,Pulau Pinang,1,1,0,Syrian Arab Republic
54220,8/1/2022,SYR,Sabah,0,0,0,Syrian Arab Republic
54221,8/1/2022,SYR,Sarawak,9,6,3,Syrian Arab Republic
54222,8/1/2022,SYR,Selangor,681,393,288,Syrian Arab Republic
54223,8/1/2022,SYR,W.P. Labuan,0,0,0,Syrian Arab Republic
54224,8/1/2022,TCA,Perlis,0,0,0,Turks and Caicos
54225,8/1/2022,TCD,Johor,2,2,0,Chad
54226,8/1/2022,TCD,Kedah,0,0,0,Chad
54227,8/1/2022,TCD,Perlis,0,0,0,Chad
54228,8/1/2022,TCD,Selangor,13,7,6,Chad
54229,8/1/2022,TGO,Johor,2,1,1,Togo
54230,8/1/2022,TGO,Perak,0,0,0,Togo
54231,8/1/2022,TGO,Pulau Pinang,0,0,0,Togo
54232,8/1/2022,TGO,Selangor,0,0,0,Togo
54233,8/1/2022,THA,Johor,3938,944,2994,Thailand
54234,8/1/2022,THA,Kedah,39784,27359,12425,Thailand
54235,8/1/2022,THA,Kelantan,28591,14183,14408,Thailand
54236,8/1/2022,THA,Melaka,1,0,1,Thailand
54237,8/1/2022,THA,Negeri Sembilan,0,0,0,Thailand
54238,8/1/2022,THA,Pahang,21,17,4,Thailand
54239,8/1/2022,THA,Perak,6861,3018,3843,Thailand
54240,8/1/2022,THA,Perlis,62471,38204,24267,Thailand
54241,8/1/2022,THA,Pulau Pinang,1549,641,908,Thailand
54242,8/1/2022,THA,Sabah,161,48,113,Thailand
54243,8/1/2022,THA,Sarawak,125,44,81,Thailand
54244,8/1/2022,THA,Selangor,8545,3620,4925,Thailand
54245,8/1/2022,THA,Terengganu,0,0,0,Thailand
54246,8/1/2022,THA,W.P. Labuan,3,1,2,Thailand
54247,8/1/2022,TJK,Johor,0,0,0,Tajikistan
54248,8/1/2022,TJK,Kedah,0,0,0,Tajikistan
54249,8/1/2022,TJK,Perlis,0,0,0,Tajikistan
54250,8/1/2022,TJK,Pulau Pinang,1,0,1,Tajikistan
54251,8/1/2022,TJK,Sabah,0,0,0,Tajikistan
54252,8/1/2022,TJK,Selangor,79,52,27,Tajikistan
54253,8/1/2022,TKL,Selangor,0,0,0,Tokelau
54254,8/1/2022,TKM,Johor,3,1,2,Turkmenistan
54255,8/1/2022,TKM,Kedah,1,0,1,Turkmenistan
54256,8/1/2022,TKM,Kelantan,0,0,0,Turkmenistan
54257,8/1/2022,TKM,Perlis,0,0,0,Turkmenistan
54258,8/1/2022,TKM,Pulau Pinang,0,0,0,Turkmenistan
54259,8/1/2022,TKM,Sabah,0,0,0,Turkmenistan
54260,8/1/2022,TKM,Sarawak,0,0,0,Turkmenistan
54261,8/1/2022,TKM,Selangor,74,41,33,Turkmenistan
54262,8/1/2022,TLS,Johor,22,20,2,Timor-Leste
54263,8/1/2022,TLS,Kedah,3,2,1,Timor-Leste
54264,8/1/2022,TLS,Perlis,0,0,0,Timor-Leste
54265,8/1/2022,TLS,Pulau Pinang,5,3,2,Timor-Leste
54266,8/1/2022,TLS,Sabah,1,1,0,Timor-Leste
54267,8/1/2022,TLS,Sarawak,1,0,1,Timor-Leste
54268,8/1/2022,TLS,Selangor,362,244,118,Timor-Leste
54269,8/1/2022,TON,Johor,1,0,1,Tonga
54270,8/1/2022,TON,Pulau Pinang,0,0,0,Tonga
54271,8/1/2022,TON,Sarawak,0,0,0,Tonga
54272,8/1/2022,TON,Selangor,5,1,4,Tonga
54273,8/1/2022,TTO,Johor,4,1,3,Trinidad and Tobago
54274,8/1/2022,TTO,Kedah,0,0,0,Trinidad and Tobago
54275,8/1/2022,TTO,Pahang,0,0,0,Trinidad and Tobago
54276,8/1/2022,TTO,Pulau Pinang,0,0,0,Trinidad and Tobago
54277,8/1/2022,TTO,Sabah,1,0,1,Trinidad and Tobago
54278,8/1/2022,TTO,Sarawak,0,0,0,Trinidad and Tobago
54279,8/1/2022,TTO,Selangor,40,28,12,Trinidad and Tobago
54280,8/1/2022,TUN,Johor,5,3,2,Tunisia
54281,8/1/2022,TUN,Kedah,2,0,2,Tunisia
54282,8/1/2022,TUN,Kelantan,0,0,0,Tunisia
54283,8/1/2022,TUN,Melaka,0,0,0,Tunisia
54284,8/1/2022,TUN,Perak,0,0,0,Tunisia
54285,8/1/2022,TUN,Perlis,0,0,0,Tunisia
54286,8/1/2022,TUN,Pulau Pinang,4,1,3,Tunisia
54287,8/1/2022,TUN,Sabah,1,0,1,Tunisia
54288,8/1/2022,TUN,Sarawak,1,0,1,Tunisia
54289,8/1/2022,TUN,Selangor,688,308,380,Tunisia
54290,8/1/2022,TUN,W.P. Labuan,0,0,0,Tunisia
54291,8/1/2022,TUR,Johor,224,165,59,Turkey
54292,8/1/2022,TUR,Kedah,13,9,4,Turkey
54293,8/1/2022,TUR,Kelantan,2,2,0,Turkey
54294,8/1/2022,TUR,Melaka,0,0,0,Turkey
54295,8/1/2022,TUR,Negeri Sembilan,0,0,0,Turkey
54296,8/1/2022,TUR,Pahang,0,0,0,Turkey
54297,8/1/2022,TUR,Perak,1,1,0,Turkey
54298,8/1/2022,TUR,Perlis,9,8,1,Turkey
54299,8/1/2022,TUR,Pulau Pinang,20,15,5,Turkey
54300,8/1/2022,TUR,Sabah,4,3,1,Turkey
54301,8/1/2022,TUR,Sarawak,15,14,1,Turkey
54302,8/1/2022,TUR,Selangor,797,563,234,Turkey
54303,8/1/2022,TUR,W.P. Labuan,0,0,0,Turkey
54304,8/1/2022,TUV,Selangor,1,0,1,Tuvalu
54305,8/1/2022,TWN,Johor,2691,1177,1514,Taiwan
54306,8/1/2022,TWN,Kedah,64,31,33,Taiwan
54307,8/1/2022,TWN,Kelantan,1,1,0,Taiwan
54308,8/1/2022,TWN,Melaka,0,0,0,Taiwan
54309,8/1/2022,TWN,Negeri Sembilan,0,0,0,Taiwan
54310,8/1/2022,TWN,Pahang,0,0,0,Taiwan
54311,8/1/2022,TWN,Perak,38,24,14,Taiwan
54312,8/1/2022,TWN,Perlis,5,4,1,Taiwan
54313,8/1/2022,TWN,Pulau Pinang,515,294,221,Taiwan
54314,8/1/2022,TWN,Sabah,70,32,38,Taiwan
54315,8/1/2022,TWN,Sarawak,130,55,75,Taiwan
54316,8/1/2022,TWN,Selangor,3107,1768,1339,Taiwan
54317,8/1/2022,TWN,W.P. Labuan,1,1,0,Taiwan
54318,8/1/2022,TZA,Johor,4,4,0,"Tanzania, United Republic of"
54319,8/1/2022,TZA,Kedah,0,0,0,"Tanzania, United Republic of"
54320,8/1/2022,TZA,Perak,0,0,0,"Tanzania, United Republic of"
54321,8/1/2022,TZA,Perlis,0,0,0,"Tanzania, United Republic of"
54322,8/1/2022,TZA,Pulau Pinang,0,0,0,"Tanzania, United Republic of"
54323,8/1/2022,TZA,Sabah,0,0,0,"Tanzania, United Republic of"
54324,8/1/2022,TZA,Sarawak,0,0,0,"Tanzania, United Republic of"
54325,8/1/2022,TZA,Selangor,82,41,41,"Tanzania, United Republic of"
54326,8/1/2022,UGA,Johor,7,3,4,Uganda
54327,8/1/2022,UGA,Kedah,0,0,0,Uganda
54328,8/1/2022,UGA,Perak,0,0,0,Uganda
54329,8/1/2022,UGA,Perlis,1,0,1,Uganda
54330,8/1/2022,UGA,Pulau Pinang,1,0,1,Uganda
54331,8/1/2022,UGA,Sabah,4,2,2,Uganda
54332,8/1/2022,UGA,Sarawak,0,0,0,Uganda
54333,8/1/2022,UGA,Selangor,49,26,23,Uganda
54334,8/1/2022,UKR,Johor,83,59,24,Ukraine
54335,8/1/2022,UKR,Kedah,21,10,11,Ukraine
54336,8/1/2022,UKR,Kelantan,0,0,0,Ukraine
54337,8/1/2022,UKR,Melaka,0,0,0,Ukraine
54338,8/1/2022,UKR,Negeri Sembilan,0,0,0,Ukraine
54339,8/1/2022,UKR,Pahang,0,0,0,Ukraine
54340,8/1/2022,UKR,Perak,0,0,0,Ukraine
54341,8/1/2022,UKR,Perlis,7,1,6,Ukraine
54342,8/1/2022,UKR,Pulau Pinang,14,6,8,Ukraine
54343,8/1/2022,UKR,Sabah,6,2,4,Ukraine
54344,8/1/2022,UKR,Sarawak,0,0,0,Ukraine
54345,8/1/2022,UKR,Selangor,442,230,212,Ukraine
54346,8/1/2022,UKR,W.P. Labuan,0,0,0,Ukraine
54347,8/1/2022,URY,Johor,4,1,3,Uruguay
54348,8/1/2022,URY,Kedah,2,1,1,Uruguay
54349,8/1/2022,URY,Kelantan,0,0,0,Uruguay
54350,8/1/2022,URY,Perak,0,0,0,Uruguay
54351,8/1/2022,URY,Perlis,0,0,0,Uruguay
54352,8/1/2022,URY,Pulau Pinang,0,0,0,Uruguay
54353,8/1/2022,URY,Sabah,0,0,0,Uruguay
54354,8/1/2022,URY,Sarawak,0,0,0,Uruguay
54355,8/1/2022,URY,Selangor,11,6,5,Uruguay
54356,8/1/2022,URY,W.P. Labuan,0,0,0,Uruguay
54357,8/1/2022,USA,Johor,2820,1812,1008,United States Of America
54358,8/1/2022,USA,Kedah,235,126,109,United States Of America
54359,8/1/2022,USA,Kelantan,7,6,1,United States Of America
54360,8/1/2022,USA,Melaka,2,2,0,United States Of America
54361,8/1/2022,USA,Negeri Sembilan,1,1,0,United States Of America
54362,8/1/2022,USA,Pahang,2,0,2,United States Of America
54363,8/1/2022,USA,Perak,108,53,55,United States Of America
54364,8/1/2022,USA,Perlis,47,32,15,United States Of America
54365,8/1/2022,USA,Pulau Pinang,1260,805,455,United States Of America
54366,8/1/2022,USA,Sabah,207,116,91,United States Of America
54367,8/1/2022,USA,Sarawak,197,108,89,United States Of America
54368,8/1/2022,USA,Selangor,9455,5746,3709,United States Of America
54369,8/1/2022,USA,Terengganu,0,0,0,United States Of America
54370,8/1/2022,USA,W.P. Labuan,0,0,0,United States Of America
54371,8/1/2022,UZB,Johor,27,18,9,Uzbekistan
54372,8/1/2022,UZB,Kedah,6,4,2,Uzbekistan
54373,8/1/2022,UZB,Kelantan,0,0,0,Uzbekistan
54374,8/1/2022,UZB,Perak,0,0,0,Uzbekistan
54375,8/1/2022,UZB,Perlis,1,0,1,Uzbekistan
54376,8/1/2022,UZB,Pulau Pinang,8,2,6,Uzbekistan
54377,8/1/2022,UZB,Sabah,43,43,0,Uzbekistan
54378,8/1/2022,UZB,Sarawak,1,1,0,Uzbekistan
54379,8/1/2022,UZB,Selangor,767,433,334,Uzbekistan
54380,8/1/2022,VAT,Johor,0,0,0,Holy See (Vatican City State)
54381,8/1/2022,VAT,Sarawak,0,0,0,Holy See (Vatican City State)
54382,8/1/2022,VAT,Selangor,0,0,0,Holy See (Vatican City State)
54383,8/1/2022,VCT,Johor,0,0,0,Saint Vincent and the Grenadines
54384,8/1/2022,VCT,Kedah,0,0,0,Saint Vincent and the Grenadines
54385,8/1/2022,VCT,Pulau Pinang,0,0,0,Saint Vincent and the Grenadines
54386,8/1/2022,VCT,Sarawak,0,0,0,Saint Vincent and the Grenadines
54387,8/1/2022,VCT,Selangor,5,3,2,Saint Vincent and the Grenadines
54388,8/1/2022,VEN,Johor,4,3,1,Venezuela
54389,8/1/2022,VEN,Kedah,1,0,1,Venezuela
54390,8/1/2022,VEN,Kelantan,0,0,0,Venezuela
54391,8/1/2022,VEN,Melaka,0,0,0,Venezuela
54392,8/1/2022,VEN,Perak,0,0,0,Venezuela
54393,8/1/2022,VEN,Perlis,0,0,0,Venezuela
54394,8/1/2022,VEN,Pulau Pinang,0,0,0,Venezuela
54395,8/1/2022,VEN,Sabah,0,0,0,Venezuela
54396,8/1/2022,VEN,Sarawak,4,2,2,Venezuela
54397,8/1/2022,VEN,Selangor,54,25,29,Venezuela
54398,8/1/2022,VEN,W.P. Labuan,0,0,0,Venezuela
54399,8/1/2022,VNM,Johor,15557,5597,9960,Vietnam
54400,8/1/2022,VNM,Kedah,163,26,137,Vietnam
54401,8/1/2022,VNM,Kelantan,8,8,0,Vietnam
54402,8/1/2022,VNM,Melaka,2,0,2,Vietnam
54403,8/1/2022,VNM,Negeri Sembilan,0,0,0,Vietnam
54404,8/1/2022,VNM,Pahang,0,0,0,Vietnam
54405,8/1/2022,VNM,Perak,105,8,97,Vietnam
54406,8/1/2022,VNM,Perlis,174,23,151,Vietnam
54407,8/1/2022,VNM,Pulau Pinang,1269,398,871,Vietnam
54408,8/1/2022,VNM,Sabah,30,10,20,Vietnam
54409,8/1/2022,VNM,Sarawak,50,7,43,Vietnam
54410,8/1/2022,VNM,Selangor,12326,4480,7846,Vietnam
54411,8/1/2022,VNM,Terengganu,0,0,0,Vietnam
54412,8/1/2022,VNM,W.P. Labuan,4,2,2,Vietnam
54413,8/1/2022,VUT,Johor,23,15,8,Vanuatu
54414,8/1/2022,VUT,Kedah,0,0,0,Vanuatu
54415,8/1/2022,VUT,Pulau Pinang,2,2,0,Vanuatu
54416,8/1/2022,VUT,Sabah,0,0,0,Vanuatu
54417,8/1/2022,VUT,Sarawak,0,0,0,Vanuatu
54418,8/1/2022,VUT,Selangor,37,27,10,Vanuatu
54419,8/1/2022,WSM,Johor,2,2,0,Samoa
54420,8/1/2022,WSM,Sarawak,0,0,0,Samoa
54421,8/1/2022,WSM,Selangor,0,0,0,Samoa
54422,8/1/2022,YEM,Johor,29,23,6,Yemen
54423,8/1/2022,YEM,Kedah,2,2,0,Yemen
54424,8/1/2022,YEM,Kelantan,1,1,0,Yemen
54425,8/1/2022,YEM,Melaka,0,0,0,Yemen
54426,8/1/2022,YEM,Pahang,0,0,0,Yemen
54427,8/1/2022,YEM,Perak,0,0,0,Yemen
54428,8/1/2022,YEM,Perlis,1,1,0,Yemen
54429,8/1/2022,YEM,Pulau Pinang,6,4,2,Yemen
54430,8/1/2022,YEM,Sabah,1,1,0,Yemen
54431,8/1/2022,YEM,Sarawak,1,1,0,Yemen
54432,8/1/2022,YEM,Selangor,1486,941,545,Yemen
54433,8/1/2022,YEM,W.P. Labuan,0,0,0,Yemen
54434,8/1/2022,ZAF,Johor,199,124,75,South Africa
54435,8/1/2022,ZAF,Kedah,18,12,6,South Africa
54436,8/1/2022,ZAF,Kelantan,0,0,0,South Africa
54437,8/1/2022,ZAF,Melaka,0,0,0,South Africa
54438,8/1/2022,ZAF,Pahang,0,0,0,South Africa
54439,8/1/2022,ZAF,Perak,6,2,4,South Africa
54440,8/1/2022,ZAF,Perlis,8,4,4,South Africa
54441,8/1/2022,ZAF,Pulau Pinang,35,20,15,South Africa
54442,8/1/2022,ZAF,Sabah,33,18,15,South Africa
54443,8/1/2022,ZAF,Sarawak,92,39,53,South Africa
54444,8/1/2022,ZAF,Selangor,610,351,259,South Africa
54445,8/1/2022,ZAF,Terengganu,0,0,0,South Africa
54446,8/1/2022,ZAF,W.P. Labuan,0,0,0,South Africa
54447,8/1/2022,ZMB,Johor,5,3,2,Zambia
54448,8/1/2022,ZMB,Kedah,0,0,0,Zambia
54449,8/1/2022,ZMB,Perak,0,0,0,Zambia
54450,8/1/2022,ZMB,Perlis,0,0,0,Zambia
54451,8/1/2022,ZMB,Pulau Pinang,0,0,0,Zambia
54452,8/1/2022,ZMB,Sabah,0,0,0,Zambia
54453,8/1/2022,ZMB,Sarawak,1,0,1,Zambia
54454,8/1/2022,ZMB,Selangor,37,20,17,Zambia
54455,8/1/2022,ZWE,Johor,7,3,4,Zimbabwe
54456,8/1/2022,ZWE,Kedah,1,0,1,Zimbabwe
54457,8/1/2022,ZWE,Kelantan,1,0,1,Zimbabwe
54458,8/1/2022,ZWE,Perak,0,0,0,Zimbabwe
54459,8/1/2022,ZWE,Perlis,0,0,0,Zimbabwe
54460,8/1/2022,ZWE,Pulau Pinang,0,0,0,Zimbabwe
54461,8/1/2022,ZWE,Sabah,0,0,0,Zimbabwe
54462,8/1/2022,ZWE,Sarawak,2,1,1,Zimbabwe
54463,8/1/2022,ZWE,Selangor,113,43,70,Zimbabwe
54464,9/1/2022,ABW,Kedah,0,0,0,Aruba
54465,9/1/2022,ABW,Pulau Pinang,0,0,0,Aruba
54466,9/1/2022,AFG,Johor,0,0,0,Afghanistan
54467,9/1/2022,AFG,Kedah,0,0,0,Afghanistan
54468,9/1/2022,AFG,Perlis,0,0,0,Afghanistan
54469,9/1/2022,AFG,Pulau Pinang,0,0,0,Afghanistan
54470,9/1/2022,AFG,Sarawak,0,0,0,Afghanistan
54471,9/1/2022,AFG,Selangor,51,45,6,Afghanistan
54472,9/1/2022,AGO,Johor,0,0,0,Angola
54473,9/1/2022,AGO,Kedah,0,0,0,Angola
54474,9/1/2022,AGO,Sabah,0,0,0,Angola
54475,9/1/2022,AGO,Selangor,12,5,7,Angola
54476,9/1/2022,AIA,Selangor,0,0,0,Anguilla
54477,9/1/2022,ALB,Johor,17,10,7,Albania
54478,9/1/2022,ALB,Kedah,0,0,0,Albania
54479,9/1/2022,ALB,Perak,0,0,0,Albania
54480,9/1/2022,ALB,Perlis,0,0,0,Albania
54481,9/1/2022,ALB,Pulau Pinang,1,1,0,Albania
54482,9/1/2022,ALB,Sabah,1,0,1,Albania
54483,9/1/2022,ALB,Sarawak,0,0,0,Albania
54484,9/1/2022,ALB,Selangor,23,10,13,Albania
54485,9/1/2022,AND,Johor,1,1,0,Andorra
54486,9/1/2022,AND,Kedah,0,0,0,Andorra
54487,9/1/2022,AND,Perlis,0,0,0,Andorra
54488,9/1/2022,AND,Pulau Pinang,1,0,1,Andorra
54489,9/1/2022,AND,Selangor,7,4,3,Andorra
54490,9/1/2022,ANT,Selangor,0,0,0,Netherlands Antilles
54491,9/1/2022,ARE,Johor,13,5,8,United Arab Emirates
54492,9/1/2022,ARE,Kedah,0,0,0,United Arab Emirates
54493,9/1/2022,ARE,Kelantan,0,0,0,United Arab Emirates
54494,9/1/2022,ARE,Perak,0,0,0,United Arab Emirates
54495,9/1/2022,ARE,Perlis,0,0,0,United Arab Emirates
54496,9/1/2022,ARE,Pulau Pinang,0,0,0,United Arab Emirates
54497,9/1/2022,ARE,Sabah,0,0,0,United Arab Emirates
54498,9/1/2022,ARE,Sarawak,0,0,0,United Arab Emirates
54499,9/1/2022,ARE,Selangor,221,170,51,United Arab Emirates
54500,9/1/2022,ARG,Johor,44,28,16,Argentina
54501,9/1/2022,ARG,Kedah,10,6,4,Argentina
54502,9/1/2022,ARG,Kelantan,2,1,1,Argentina
54503,9/1/2022,ARG,Melaka,0,0,0,Argentina
54504,9/1/2022,ARG,Perak,2,1,1,Argentina
54505,9/1/2022,ARG,Perlis,7,5,2,Argentina
54506,9/1/2022,ARG,Pulau Pinang,6,2,4,Argentina
54507,9/1/2022,ARG,Sabah,1,0,1,Argentina
54508,9/1/2022,ARG,Sarawak,3,1,2,Argentina
54509,9/1/2022,ARG,Selangor,221,127,94,Argentina
54510,9/1/2022,ARG,W.P. Labuan,0,0,0,Argentina
54511,9/1/2022,ARM,Johor,4,2,2,Armenia
54512,9/1/2022,ARM,Kedah,0,0,0,Armenia
54513,9/1/2022,ARM,Kelantan,0,0,0,Armenia
54514,9/1/2022,ARM,Perak,0,0,0,Armenia
54515,9/1/2022,ARM,Perlis,0,0,0,Armenia
54516,9/1/2022,ARM,Pulau Pinang,0,0,0,Armenia
54517,9/1/2022,ARM,Sabah,0,0,0,Armenia
54518,9/1/2022,ARM,Sarawak,0,0,0,Armenia
54519,9/1/2022,ARM,Selangor,32,18,14,Armenia
54520,9/1/2022,ATA,Selangor,0,0,0,Antarctica
54521,9/1/2022,ATG,Johor,9,4,5,Antigua and Barbuda
54522,9/1/2022,ATG,Kedah,0,0,0,Antigua and Barbuda
54523,9/1/2022,ATG,Pulau Pinang,0,0,0,Antigua and Barbuda
54524,9/1/2022,ATG,Sarawak,1,1,0,Antigua and Barbuda
54525,9/1/2022,ATG,Selangor,7,5,2,Antigua and Barbuda
54526,9/1/2022,AUS,Johor,4241,2505,1736,Australia
54527,9/1/2022,AUS,Kedah,326,170,156,Australia
54528,9/1/2022,AUS,Kelantan,3,3,0,Australia
54529,9/1/2022,AUS,Melaka,6,5,1,Australia
54530,9/1/2022,AUS,Negeri Sembilan,2,2,0,Australia
54531,9/1/2022,AUS,Pahang,8,4,4,Australia
54532,9/1/2022,AUS,Perak,187,89,98,Australia
54533,9/1/2022,AUS,Perlis,62,43,19,Australia
54534,9/1/2022,AUS,Pulau Pinang,1276,698,578,Australia
54535,9/1/2022,AUS,Sabah,355,181,174,Australia
54536,9/1/2022,AUS,Sarawak,434,235,199,Australia
54537,9/1/2022,AUS,Selangor,14837,8813,6024,Australia
54538,9/1/2022,AUS,Terengganu,0,0,0,Australia
54539,9/1/2022,AUS,W.P. Labuan,7,5,2,Australia
54540,9/1/2022,AUT,Johor,133,84,49,Austria
54541,9/1/2022,AUT,Kedah,19,8,11,Austria
54542,9/1/2022,AUT,Kelantan,0,0,0,Austria
54543,9/1/2022,AUT,Melaka,0,0,0,Austria
54544,9/1/2022,AUT,Negeri Sembilan,0,0,0,Austria
54545,9/1/2022,AUT,Pahang,1,1,0,Austria
54546,9/1/2022,AUT,Perak,6,3,3,Austria
54547,9/1/2022,AUT,Perlis,7,2,5,Austria
54548,9/1/2022,AUT,Pulau Pinang,77,60,17,Austria
54549,9/1/2022,AUT,Sabah,10,6,4,Austria
54550,9/1/2022,AUT,Sarawak,9,6,3,Austria
54551,9/1/2022,AUT,Selangor,569,369,200,Austria
54552,9/1/2022,AUT,Terengganu,2,1,1,Austria
54553,9/1/2022,AUT,W.P. Labuan,0,0,0,Austria
54554,9/1/2022,AZE,Johor,1,0,1,Azerbaijan
54555,9/1/2022,AZE,Kedah,1,1,0,Azerbaijan
54556,9/1/2022,AZE,Kelantan,0,0,0,Azerbaijan
54557,9/1/2022,AZE,Melaka,0,0,0,Azerbaijan
54558,9/1/2022,AZE,Perlis,0,0,0,Azerbaijan
54559,9/1/2022,AZE,Pulau Pinang,0,0,0,Azerbaijan
54560,9/1/2022,AZE,Sabah,0,0,0,Azerbaijan
54561,9/1/2022,AZE,Sarawak,1,0,1,Azerbaijan
54562,9/1/2022,AZE,Selangor,65,30,35,Azerbaijan
54563,9/1/2022,AZE,W.P. Labuan,0,0,0,Azerbaijan
54564,9/1/2022,BDI,Pulau Pinang,0,0,0,Burundi
54565,9/1/2022,BDI,Sarawak,0,0,0,Burundi
54566,9/1/2022,BDI,Selangor,2,1,1,Burundi
54567,9/1/2022,BEL,Johor,228,145,83,Belgium
54568,9/1/2022,BEL,Kedah,26,17,9,Belgium
54569,9/1/2022,BEL,Kelantan,1,1,0,Belgium
54570,9/1/2022,BEL,Melaka,0,0,0,Belgium
54571,9/1/2022,BEL,Negeri Sembilan,0,0,0,Belgium
54572,9/1/2022,BEL,Pahang,0,0,0,Belgium
54573,9/1/2022,BEL,Perak,3,3,0,Belgium
54574,9/1/2022,BEL,Perlis,12,8,4,Belgium
54575,9/1/2022,BEL,Pulau Pinang,34,22,12,Belgium
54576,9/1/2022,BEL,Sabah,30,15,15,Belgium
54577,9/1/2022,BEL,Sarawak,8,5,3,Belgium
54578,9/1/2022,BEL,Selangor,953,582,371,Belgium
54579,9/1/2022,BEL,W.P. Labuan,0,0,0,Belgium
54580,9/1/2022,BEN,Johor,0,0,0,Benin
54581,9/1/2022,BEN,Kedah,0,0,0,Benin
54582,9/1/2022,BEN,Perak,0,0,0,Benin
54583,9/1/2022,BEN,Pulau Pinang,0,0,0,Benin
54584,9/1/2022,BEN,Sabah,0,0,0,Benin
54585,9/1/2022,BEN,Sarawak,0,0,0,Benin
54586,9/1/2022,BEN,Selangor,9,6,3,Benin
54587,9/1/2022,BFA,Perak,0,0,0,Burkina Faso
54588,9/1/2022,BFA,Pulau Pinang,1,1,0,Burkina Faso
54589,9/1/2022,BFA,Selangor,10,9,1,Burkina Faso
54590,9/1/2022,BGD,Johor,1702,1368,334,Bangladesh
54591,9/1/2022,BGD,Kedah,35,24,11,Bangladesh
54592,9/1/2022,BGD,Kelantan,1,1,0,Bangladesh
54593,9/1/2022,BGD,Melaka,0,0,0,Bangladesh
54594,9/1/2022,BGD,Negeri Sembilan,1,1,0,Bangladesh
54595,9/1/2022,BGD,Pahang,0,0,0,Bangladesh
54596,9/1/2022,BGD,Perak,0,0,0,Bangladesh
54597,9/1/2022,BGD,Perlis,5,5,0,Bangladesh
54598,9/1/2022,BGD,Pulau Pinang,172,164,8,Bangladesh
54599,9/1/2022,BGD,Sabah,1,1,0,Bangladesh
54600,9/1/2022,BGD,Sarawak,17,16,1,Bangladesh
54601,9/1/2022,BGD,Selangor,25148,23571,1577,Bangladesh
54602,9/1/2022,BGD,W.P. Labuan,3,3,0,Bangladesh
54603,9/1/2022,BGR,Johor,42,21,21,Bulgaria
54604,9/1/2022,BGR,Kedah,1,0,1,Bulgaria
54605,9/1/2022,BGR,Kelantan,0,0,0,Bulgaria
54606,9/1/2022,BGR,Pahang,0,0,0,Bulgaria
54607,9/1/2022,BGR,Perak,0,0,0,Bulgaria
54608,9/1/2022,BGR,Perlis,0,0,0,Bulgaria
54609,9/1/2022,BGR,Pulau Pinang,4,1,3,Bulgaria
54610,9/1/2022,BGR,Sabah,1,0,1,Bulgaria
54611,9/1/2022,BGR,Sarawak,2,2,0,Bulgaria
54612,9/1/2022,BGR,Selangor,107,67,40,Bulgaria
54613,9/1/2022,BGR,W.P. Labuan,0,0,0,Bulgaria
54614,9/1/2022,BHR,Johor,1,1,0,Bahrain
54615,9/1/2022,BHR,Kedah,0,0,0,Bahrain
54616,9/1/2022,BHR,Kelantan,0,0,0,Bahrain
54617,9/1/2022,BHR,Perlis,1,1,0,Bahrain
54618,9/1/2022,BHR,Pulau Pinang,3,3,0,Bahrain
54619,9/1/2022,BHR,Sabah,0,0,0,Bahrain
54620,9/1/2022,BHR,Sarawak,0,0,0,Bahrain
54621,9/1/2022,BHR,Selangor,121,78,43,Bahrain
54622,9/1/2022,BHS,Johor,0,0,0,Bahamas
54623,9/1/2022,BHS,Kedah,0,0,0,Bahamas
54624,9/1/2022,BHS,Perak,0,0,0,Bahamas
54625,9/1/2022,BHS,Sabah,0,0,0,Bahamas
54626,9/1/2022,BHS,Sarawak,0,0,0,Bahamas
54627,9/1/2022,BHS,Selangor,3,3,0,Bahamas
54628,9/1/2022,BIH,Johor,1,0,1,Bosnia and Herzegovina
54629,9/1/2022,BIH,Kedah,0,0,0,Bosnia and Herzegovina
54630,9/1/2022,BIH,Perlis,0,0,0,Bosnia and Herzegovina
54631,9/1/2022,BIH,Pulau Pinang,1,1,0,Bosnia and Herzegovina
54632,9/1/2022,BIH,Sabah,2,1,1,Bosnia and Herzegovina
54633,9/1/2022,BIH,Sarawak,1,1,0,Bosnia and Herzegovina
54634,9/1/2022,BIH,Selangor,35,20,15,Bosnia and Herzegovina
54635,9/1/2022,BLR,Johor,12,7,5,Belarus
54636,9/1/2022,BLR,Kedah,2,1,1,Belarus
54637,9/1/2022,BLR,Kelantan,0,0,0,Belarus
54638,9/1/2022,BLR,Pahang,1,0,1,Belarus
54639,9/1/2022,BLR,Perak,0,0,0,Belarus
54640,9/1/2022,BLR,Perlis,0,0,0,Belarus
54641,9/1/2022,BLR,Pulau Pinang,1,1,0,Belarus
54642,9/1/2022,BLR,Sabah,0,0,0,Belarus
54643,9/1/2022,BLR,Sarawak,3,2,1,Belarus
54644,9/1/2022,BLR,Selangor,114,44,70,Belarus
54645,9/1/2022,BLR,W.P. Labuan,0,0,0,Belarus
54646,9/1/2022,BLZ,Johor,1,1,0,Belize
54647,9/1/2022,BLZ,Pulau Pinang,0,0,0,Belize
54648,9/1/2022,BLZ,Sarawak,0,0,0,Belize
54649,9/1/2022,BLZ,Selangor,7,4,3,Belize
54650,9/1/2022,BMU,Selangor,0,0,0,Bermuda
54651,9/1/2022,BOL,Johor,2,2,0,Bolivia
54652,9/1/2022,BOL,Kedah,0,0,0,Bolivia
54653,9/1/2022,BOL,Melaka,0,0,0,Bolivia
54654,9/1/2022,BOL,Perak,0,0,0,Bolivia
54655,9/1/2022,BOL,Perlis,0,0,0,Bolivia
54656,9/1/2022,BOL,Pulau Pinang,4,1,3,Bolivia
54657,9/1/2022,BOL,Sabah,0,0,0,Bolivia
54658,9/1/2022,BOL,Sarawak,3,2,1,Bolivia
54659,9/1/2022,BOL,Selangor,20,7,13,Bolivia
54660,9/1/2022,BRA,Johor,173,94,79,Brazil
54661,9/1/2022,BRA,Kedah,9,2,7,Brazil
54662,9/1/2022,BRA,Kelantan,0,0,0,Brazil
54663,9/1/2022,BRA,Melaka,0,0,0,Brazil
54664,9/1/2022,BRA,Pahang,0,0,0,Brazil
54665,9/1/2022,BRA,Perak,5,5,0,Brazil
54666,9/1/2022,BRA,Perlis,6,3,3,Brazil
54667,9/1/2022,BRA,Pulau Pinang,11,7,4,Brazil
54668,9/1/2022,BRA,Sabah,6,5,1,Brazil
54669,9/1/2022,BRA,Sarawak,7,3,4,Brazil
54670,9/1/2022,BRA,Selangor,656,414,242,Brazil
54671,9/1/2022,BRA,W.P. Labuan,0,0,0,Brazil
54672,9/1/2022,BRB,Johor,0,0,0,Barbados
54673,9/1/2022,BRB,Kedah,0,0,0,Barbados
54674,9/1/2022,BRB,Perlis,0,0,0,Barbados
54675,9/1/2022,BRB,Pulau Pinang,0,0,0,Barbados
54676,9/1/2022,BRB,Selangor,7,3,4,Barbados
54677,9/1/2022,BRN,Johor,365,207,158,Brunei Darussalam
54678,9/1/2022,BRN,Kedah,8,7,1,Brunei Darussalam
54679,9/1/2022,BRN,Kelantan,3,2,1,Brunei Darussalam
54680,9/1/2022,BRN,Melaka,0,0,0,Brunei Darussalam
54681,9/1/2022,BRN,Pahang,0,0,0,Brunei Darussalam
54682,9/1/2022,BRN,Perak,3,2,1,Brunei Darussalam
54683,9/1/2022,BRN,Perlis,26,14,12,Brunei Darussalam
54684,9/1/2022,BRN,Pulau Pinang,12,5,7,Brunei Darussalam
54685,9/1/2022,BRN,Sabah,739,349,390,Brunei Darussalam
54686,9/1/2022,BRN,Sarawak,56010,30172,25838,Brunei Darussalam
54687,9/1/2022,BRN,Selangor,3519,1780,1739,Brunei Darussalam
54688,9/1/2022,BRN,W.P. Labuan,647,430,217,Brunei Darussalam
54689,9/1/2022,BTN,Johor,2,2,0,Bhutan
54690,9/1/2022,BTN,Kedah,0,0,0,Bhutan
54691,9/1/2022,BTN,Perak,0,0,0,Bhutan
54692,9/1/2022,BTN,Perlis,0,0,0,Bhutan
54693,9/1/2022,BTN,Pulau Pinang,2,0,2,Bhutan
54694,9/1/2022,BTN,Sabah,0,0,0,Bhutan
54695,9/1/2022,BTN,Sarawak,0,0,0,Bhutan
54696,9/1/2022,BTN,Selangor,63,37,26,Bhutan
54697,9/1/2022,BWA,Johor,2,0,2,Botswana
54698,9/1/2022,BWA,Kedah,0,0,0,Botswana
54699,9/1/2022,BWA,Perlis,0,0,0,Botswana
54700,9/1/2022,BWA,Pulau Pinang,1,0,1,Botswana
54701,9/1/2022,BWA,Sabah,0,0,0,Botswana
54702,9/1/2022,BWA,Sarawak,0,0,0,Botswana
54703,9/1/2022,BWA,Selangor,3,1,2,Botswana
54704,9/1/2022,CAF,Kedah,0,0,0,Central African Republic
54705,9/1/2022,CAF,Selangor,0,0,0,Central African Republic
54706,9/1/2022,CAN,Johor,961,577,384,Canada
54707,9/1/2022,CAN,Kedah,53,33,20,Canada
54708,9/1/2022,CAN,Kelantan,5,1,4,Canada
54709,9/1/2022,CAN,Melaka,0,0,0,Canada
54710,9/1/2022,CAN,Negeri Sembilan,0,0,0,Canada
54711,9/1/2022,CAN,Pahang,0,0,0,Canada
54712,9/1/2022,CAN,Perak,19,10,9,Canada
54713,9/1/2022,CAN,Perlis,19,14,5,Canada
54714,9/1/2022,CAN,Pulau Pinang,216,132,84,Canada
54715,9/1/2022,CAN,Sabah,90,41,49,Canada
54716,9/1/2022,CAN,Sarawak,201,114,87,Canada
54717,9/1/2022,CAN,Selangor,2608,1656,952,Canada
54718,9/1/2022,CAN,Terengganu,0,0,0,Canada
54719,9/1/2022,CAN,W.P. Labuan,0,0,0,Canada
54720,9/1/2022,CCK,Selangor,0,0,0,Cocos (Keeling) Islands
54721,9/1/2022,CHE,Johor,255,156,99,Switzerland
54722,9/1/2022,CHE,Kedah,28,21,7,Switzerland
54723,9/1/2022,CHE,Kelantan,1,1,0,Switzerland
54724,9/1/2022,CHE,Melaka,0,0,0,Switzerland
54725,9/1/2022,CHE,Negeri Sembilan,0,0,0,Switzerland
54726,9/1/2022,CHE,Pahang,0,0,0,Switzerland
54727,9/1/2022,CHE,Perak,6,5,1,Switzerland
54728,9/1/2022,CHE,Perlis,6,4,2,Switzerland
54729,9/1/2022,CHE,Pulau Pinang,92,62,30,Switzerland
54730,9/1/2022,CHE,Sabah,29,14,15,Switzerland
54731,9/1/2022,CHE,Sarawak,33,13,20,Switzerland
54732,9/1/2022,CHE,Selangor,835,528,307,Switzerland
54733,9/1/2022,CHE,W.P. Labuan,0,0,0,Switzerland
54734,9/1/2022,CHL,Johor,41,20,21,Chile
54735,9/1/2022,CHL,Kedah,3,0,3,Chile
54736,9/1/2022,CHL,Kelantan,0,0,0,Chile
54737,9/1/2022,CHL,Melaka,0,0,0,Chile
54738,9/1/2022,CHL,Pahang,0,0,0,Chile
54739,9/1/2022,CHL,Perak,0,0,0,Chile
54740,9/1/2022,CHL,Perlis,4,3,1,Chile
54741,9/1/2022,CHL,Pulau Pinang,1,1,0,Chile
54742,9/1/2022,CHL,Sabah,5,2,3,Chile
54743,9/1/2022,CHL,Sarawak,1,0,1,Chile
54744,9/1/2022,CHL,Selangor,91,51,40,Chile
54745,9/1/2022,CHN,Johor,20790,8385,12405,China
54746,9/1/2022,CHN,Kedah,300,120,180,China
54747,9/1/2022,CHN,Kelantan,3,1,2,China
54748,9/1/2022,CHN,Melaka,0,0,0,China
54749,9/1/2022,CHN,Pahang,3,2,1,China
54750,9/1/2022,CHN,Perak,115,43,72,China
54751,9/1/2022,CHN,Perlis,45,27,18,China
54752,9/1/2022,CHN,Pulau Pinang,1050,528,522,China
54753,9/1/2022,CHN,Sabah,347,171,176,China
54754,9/1/2022,CHN,Sarawak,288,124,164,China
54755,9/1/2022,CHN,Selangor,14957,8875,6082,China
54756,9/1/2022,CHN,Terengganu,0,0,0,China
54757,9/1/2022,CHN,W.P. Labuan,4,2,2,China
54758,9/1/2022,CIV,Johor,0,0,0,C��te d'Iv
54759,9/1/2022,CIV,Kedah,0,0,0,C��te d'Iv
54760,9/1/2022,CIV,Pulau Pinang,0,0,0,C��te d'Iv
54761,9/1/2022,CIV,Sabah,0,0,0,C��te d'Iv
54762,9/1/2022,CIV,Sarawak,0,0,0,C��te d'Iv
54763,9/1/2022,CIV,Selangor,32,27,5,C��te d'Iv
54764,9/1/2022,CMR,Johor,2,2,0,Cameroon
54765,9/1/2022,CMR,Kedah,0,0,0,Cameroon
54766,9/1/2022,CMR,Pulau Pinang,0,0,0,Cameroon
54767,9/1/2022,CMR,Sabah,0,0,0,Cameroon
54768,9/1/2022,CMR,Sarawak,0,0,0,Cameroon
54769,9/1/2022,CMR,Selangor,16,13,3,Cameroon
54770,9/1/2022,COD,Johor,0,0,0,"Congo, the Democratic Republic of the"
54771,9/1/2022,COD,Pulau Pinang,0,0,0,"Congo, the Democratic Republic of the"
54772,9/1/2022,COD,Sarawak,0,0,0,"Congo, the Democratic Republic of the"
54773,9/1/2022,COD,Selangor,15,13,2,"Congo, the Democratic Republic of the"
54774,9/1/2022,COG,Johor,0,0,0,Congo
54775,9/1/2022,COG,Kedah,0,0,0,Congo
54776,9/1/2022,COG,Selangor,1,1,0,Congo
54777,9/1/2022,COK,Selangor,0,0,0,Cook Islands
54778,9/1/2022,COL,Johor,26,14,12,Colombia
54779,9/1/2022,COL,Kedah,5,3,2,Colombia
54780,9/1/2022,COL,Perak,0,0,0,Colombia
54781,9/1/2022,COL,Pulau Pinang,1,1,0,Colombia
54782,9/1/2022,COL,Sabah,0,0,0,Colombia
54783,9/1/2022,COL,Sarawak,0,0,0,Colombia
54784,9/1/2022,COL,Selangor,107,63,44,Colombia
54785,9/1/2022,COL,W.P. Labuan,0,0,0,Colombia
54786,9/1/2022,COM,Johor,0,0,0,Comoros
54787,9/1/2022,COM,Kedah,0,0,0,Comoros
54788,9/1/2022,COM,Selangor,4,4,0,Comoros
54789,9/1/2022,CPV,Johor,0,0,0,Cape Verde
54790,9/1/2022,CPV,Kedah,0,0,0,Cape Verde
54791,9/1/2022,CPV,Pulau Pinang,0,0,0,Cape Verde
54792,9/1/2022,CPV,Sabah,0,0,0,Cape Verde
54793,9/1/2022,CPV,Selangor,1,1,0,Cape Verde
54794,9/1/2022,CRI,Johor,12,8,4,Costa Rica
54795,9/1/2022,CRI,Kedah,0,0,0,Costa Rica
54796,9/1/2022,CRI,Perak,0,0,0,Costa Rica
54797,9/1/2022,CRI,Perlis,2,2,0,Costa Rica
54798,9/1/2022,CRI,Pulau Pinang,3,2,1,Costa Rica
54799,9/1/2022,CRI,Sabah,0,0,0,Costa Rica
54800,9/1/2022,CRI,Sarawak,0,0,0,Costa Rica
54801,9/1/2022,CRI,Selangor,44,23,21,Costa Rica
54802,9/1/2022,CUB,Johor,1,1,0,Cuba
54803,9/1/2022,CUB,Kedah,0,0,0,Cuba
54804,9/1/2022,CUB,Perlis,0,0,0,Cuba
54805,9/1/2022,CUB,Pulau Pinang,0,0,0,Cuba
54806,9/1/2022,CUB,Sabah,0,0,0,Cuba
54807,9/1/2022,CUB,Sarawak,0,0,0,Cuba
54808,9/1/2022,CUB,Selangor,15,3,12,Cuba
54809,9/1/2022,CYP,Johor,12,8,4,Cyprus
54810,9/1/2022,CYP,Kedah,1,0,1,Cyprus
54811,9/1/2022,CYP,Perak,0,0,0,Cyprus
54812,9/1/2022,CYP,Perlis,0,0,0,Cyprus
54813,9/1/2022,CYP,Pulau Pinang,3,3,0,Cyprus
54814,9/1/2022,CYP,Sabah,0,0,0,Cyprus
54815,9/1/2022,CYP,Sarawak,0,0,0,Cyprus
54816,9/1/2022,CYP,Selangor,32,25,7,Cyprus
54817,9/1/2022,CZE,Johor,84,52,32,Czech Republic
54818,9/1/2022,CZE,Kedah,3,1,2,Czech Republic
54819,9/1/2022,CZE,Kelantan,0,0,0,Czech Republic
54820,9/1/2022,CZE,Melaka,0,0,0,Czech Republic
54821,9/1/2022,CZE,Negeri Sembilan,1,1,0,Czech Republic
54822,9/1/2022,CZE,Perak,0,0,0,Czech Republic
54823,9/1/2022,CZE,Perlis,10,7,3,Czech Republic
54824,9/1/2022,CZE,Pulau Pinang,12,9,3,Czech Republic
54825,9/1/2022,CZE,Sabah,6,3,3,Czech Republic
54826,9/1/2022,CZE,Sarawak,1,1,0,Czech Republic
54827,9/1/2022,CZE,Selangor,319,193,126,Czech Republic
54828,9/1/2022,CZE,W.P. Labuan,0,0,0,Czech Republic
54829,9/1/2022,DEU,Johor,1858,1162,696,Germany
54830,9/1/2022,DEU,Kedah,144,71,73,Germany
54831,9/1/2022,DEU,Kelantan,6,4,2,Germany
54832,9/1/2022,DEU,Melaka,8,4,4,Germany
54833,9/1/2022,DEU,Negeri Sembilan,0,0,0,Germany
54834,9/1/2022,DEU,Pahang,3,2,1,Germany
54835,9/1/2022,DEU,Perak,11,9,2,Germany
54836,9/1/2022,DEU,Perlis,78,46,32,Germany
54837,9/1/2022,DEU,Pulau Pinang,470,346,124,Germany
54838,9/1/2022,DEU,Sabah,118,76,42,Germany
54839,9/1/2022,DEU,Sarawak,152,80,72,Germany
54840,9/1/2022,DEU,Selangor,5457,3392,2065,Germany
54841,9/1/2022,DEU,Terengganu,1,1,0,Germany
54842,9/1/2022,DEU,W.P. Labuan,3,2,1,Germany
54843,9/1/2022,DJI,Johor,0,0,0,Djibouti
54844,9/1/2022,DJI,Selangor,11,7,4,Djibouti
54845,9/1/2022,DMA,Johor,8,8,0,Dominica
54846,9/1/2022,DMA,Kedah,0,0,0,Dominica
54847,9/1/2022,DMA,Pulau Pinang,0,0,0,Dominica
54848,9/1/2022,DMA,Sabah,0,0,0,Dominica
54849,9/1/2022,DMA,Sarawak,4,2,2,Dominica
54850,9/1/2022,DMA,Selangor,21,20,1,Dominica
54851,9/1/2022,DMA,W.P. Labuan,0,0,0,Dominica
54852,9/1/2022,DNK,Johor,217,146,71,Denmark
54853,9/1/2022,DNK,Kedah,36,14,22,Denmark
54854,9/1/2022,DNK,Kelantan,0,0,0,Denmark
54855,9/1/2022,DNK,Melaka,0,0,0,Denmark
54856,9/1/2022,DNK,Negeri Sembilan,0,0,0,Denmark
54857,9/1/2022,DNK,Pahang,29,12,17,Denmark
54858,9/1/2022,DNK,Perak,0,0,0,Denmark
54859,9/1/2022,DNK,Perlis,18,10,8,Denmark
54860,9/1/2022,DNK,Pulau Pinang,55,40,15,Denmark
54861,9/1/2022,DNK,Sabah,25,16,9,Denmark
54862,9/1/2022,DNK,Sarawak,17,10,7,Denmark
54863,9/1/2022,DNK,Selangor,684,427,257,Denmark
54864,9/1/2022,DNK,W.P. Labuan,1,0,1,Denmark
54865,9/1/2022,DOM,Johor,0,0,0,Dominican Republic
54866,9/1/2022,DOM,Kedah,0,0,0,Dominican Republic
54867,9/1/2022,DOM,Perak,0,0,0,Dominican Republic
54868,9/1/2022,DOM,Perlis,0,0,0,Dominican Republic
54869,9/1/2022,DOM,Pulau Pinang,1,1,0,Dominican Republic
54870,9/1/2022,DOM,Sabah,0,0,0,Dominican Republic
54871,9/1/2022,DOM,Sarawak,0,0,0,Dominican Republic
54872,9/1/2022,DOM,Selangor,8,3,5,Dominican Republic
54873,9/1/2022,DZA,Johor,21,16,5,Algeria
54874,9/1/2022,DZA,Kedah,0,0,0,Algeria
54875,9/1/2022,DZA,Kelantan,0,0,0,Algeria
54876,9/1/2022,DZA,Melaka,0,0,0,Algeria
54877,9/1/2022,DZA,Perak,0,0,0,Algeria
54878,9/1/2022,DZA,Perlis,0,0,0,Algeria
54879,9/1/2022,DZA,Pulau Pinang,0,0,0,Algeria
54880,9/1/2022,DZA,Sabah,1,1,0,Algeria
54881,9/1/2022,DZA,Sarawak,1,1,0,Algeria
54882,9/1/2022,DZA,Selangor,478,285,193,Algeria
54883,9/1/2022,DZA,W.P. Labuan,0,0,0,Algeria
54884,9/1/2022,ECU,Johor,7,4,3,Ecuador
54885,9/1/2022,ECU,Kedah,3,2,1,Ecuador
54886,9/1/2022,ECU,Perak,0,0,0,Ecuador
54887,9/1/2022,ECU,Perlis,0,0,0,Ecuador
54888,9/1/2022,ECU,Pulau Pinang,1,0,1,Ecuador
54889,9/1/2022,ECU,Sabah,1,1,0,Ecuador
54890,9/1/2022,ECU,Sarawak,2,1,1,Ecuador
54891,9/1/2022,ECU,Selangor,43,21,22,Ecuador
54892,9/1/2022,EGY,Johor,164,137,27,Egypt
54893,9/1/2022,EGY,Kedah,2,2,0,Egypt
54894,9/1/2022,EGY,Kelantan,2,2,0,Egypt
54895,9/1/2022,EGY,Melaka,0,0,0,Egypt
54896,9/1/2022,EGY,Pahang,0,0,0,Egypt
54897,9/1/2022,EGY,Perak,0,0,0,Egypt
54898,9/1/2022,EGY,Perlis,0,0,0,Egypt
54899,9/1/2022,EGY,Pulau Pinang,4,4,0,Egypt
54900,9/1/2022,EGY,Sabah,0,0,0,Egypt
54901,9/1/2022,EGY,Sarawak,119,74,45,Egypt
54902,9/1/2022,EGY,Selangor,1708,1135,573,Egypt
54903,9/1/2022,EGY,Terengganu,0,0,0,Egypt
54904,9/1/2022,EGY,W.P. Labuan,0,0,0,Egypt
54905,9/1/2022,ERI,Johor,0,0,0,Eritrea
54906,9/1/2022,ERI,Pulau Pinang,0,0,0,Eritrea
54907,9/1/2022,ERI,Sabah,0,0,0,Eritrea
54908,9/1/2022,ERI,Selangor,17,9,8,Eritrea
54909,9/1/2022,ESP,Johor,473,264,209,Spain
54910,9/1/2022,ESP,Kedah,49,28,21,Spain
54911,9/1/2022,ESP,Kelantan,3,1,2,Spain
54912,9/1/2022,ESP,Melaka,1,0,1,Spain
54913,9/1/2022,ESP,Negeri Sembilan,0,0,0,Spain
54914,9/1/2022,ESP,Pahang,0,0,0,Spain
54915,9/1/2022,ESP,Perak,1,1,0,Spain
54916,9/1/2022,ESP,Perlis,7,6,1,Spain
54917,9/1/2022,ESP,Pulau Pinang,79,45,34,Spain
54918,9/1/2022,ESP,Sabah,38,18,20,Spain
54919,9/1/2022,ESP,Sarawak,64,30,34,Spain
54920,9/1/2022,ESP,Selangor,2375,1321,1054,Spain
54921,9/1/2022,ESP,W.P. Labuan,0,0,0,Spain
54922,9/1/2022,EST,Johor,11,8,3,Estonia
54923,9/1/2022,EST,Kedah,1,1,0,Estonia
54924,9/1/2022,EST,Kelantan,0,0,0,Estonia
54925,9/1/2022,EST,Pahang,0,0,0,Estonia
54926,9/1/2022,EST,Perak,0,0,0,Estonia
54927,9/1/2022,EST,Perlis,1,1,0,Estonia
54928,9/1/2022,EST,Pulau Pinang,2,0,2,Estonia
54929,9/1/2022,EST,Sabah,3,1,2,Estonia
54930,9/1/2022,EST,Sarawak,8,6,2,Estonia
54931,9/1/2022,EST,Selangor,73,47,26,Estonia
54932,9/1/2022,EST,W.P. Labuan,0,0,0,Estonia
54933,9/1/2022,ETH,Johor,2,2,0,Ethiopia
54934,9/1/2022,ETH,Kedah,0,0,0,Ethiopia
54935,9/1/2022,ETH,Pulau Pinang,1,1,0,Ethiopia
54936,9/1/2022,ETH,Sarawak,0,0,0,Ethiopia
54937,9/1/2022,ETH,Selangor,23,11,12,Ethiopia
54938,9/1/2022,FIN,Johor,113,77,36,Finland
54939,9/1/2022,FIN,Kedah,12,8,4,Finland
54940,9/1/2022,FIN,Kelantan,0,0,0,Finland
54941,9/1/2022,FIN,Melaka,0,0,0,Finland
54942,9/1/2022,FIN,Negeri Sembilan,0,0,0,Finland
54943,9/1/2022,FIN,Pahang,0,0,0,Finland
54944,9/1/2022,FIN,Perak,0,0,0,Finland
54945,9/1/2022,FIN,Perlis,0,0,0,Finland
54946,9/1/2022,FIN,Pulau Pinang,19,13,6,Finland
54947,9/1/2022,FIN,Sabah,7,5,2,Finland
54948,9/1/2022,FIN,Sarawak,7,4,3,Finland
54949,9/1/2022,FIN,Selangor,269,181,88,Finland
54950,9/1/2022,FIN,W.P. Labuan,0,0,0,Finland
54951,9/1/2022,FJI,Johor,56,31,25,Fiji
54952,9/1/2022,FJI,Kedah,0,0,0,Fiji
54953,9/1/2022,FJI,Kelantan,0,0,0,Fiji
54954,9/1/2022,FJI,Perak,0,0,0,Fiji
54955,9/1/2022,FJI,Perlis,0,0,0,Fiji
54956,9/1/2022,FJI,Pulau Pinang,3,2,1,Fiji
54957,9/1/2022,FJI,Sabah,2,1,1,Fiji
54958,9/1/2022,FJI,Sarawak,1,0,1,Fiji
54959,9/1/2022,FJI,Selangor,72,36,36,Fiji
54960,9/1/2022,FRA,Johor,1357,870,487,France
54961,9/1/2022,FRA,Kedah,150,100,50,France
54962,9/1/2022,FRA,Kelantan,3,3,0,France
54963,9/1/2022,FRA,Melaka,2,1,1,France
54964,9/1/2022,FRA,Negeri Sembilan,6,3,3,France
54965,9/1/2022,FRA,Pahang,4,3,1,France
54966,9/1/2022,FRA,Perak,21,12,9,France
54967,9/1/2022,FRA,Perlis,49,32,17,France
54968,9/1/2022,FRA,Pulau Pinang,246,163,83,France
54969,9/1/2022,FRA,Sabah,68,48,20,France
54970,9/1/2022,FRA,Sarawak,54,34,20,France
54971,9/1/2022,FRA,Selangor,6180,3628,2552,France
54972,9/1/2022,FRA,Terengganu,2,1,1,France
54973,9/1/2022,FRA,W.P. Labuan,3,3,0,France
54974,9/1/2022,FSM,Johor,0,0,0,"Micronesia, Federated States of"
54975,9/1/2022,FSM,Pulau Pinang,0,0,0,"Micronesia, Federated States of"
54976,9/1/2022,FSM,Selangor,0,0,0,"Micronesia, Federated States of"
54977,9/1/2022,GAB,Johor,4,3,1,Gabon
54978,9/1/2022,GAB,Pulau Pinang,0,0,0,Gabon
54979,9/1/2022,GAB,Sarawak,0,0,0,Gabon
54980,9/1/2022,GAB,Selangor,4,3,1,Gabon
54981,9/1/2022,GBR,Johor,3265,2234,1031,United Kingdom
54982,9/1/2022,GBR,Kedah,331,198,133,United Kingdom
54983,9/1/2022,GBR,Kelantan,3,3,0,United Kingdom
54984,9/1/2022,GBR,Melaka,3,1,2,United Kingdom
54985,9/1/2022,GBR,Negeri Sembilan,2,2,0,United Kingdom
54986,9/1/2022,GBR,Pahang,8,6,2,United Kingdom
54987,9/1/2022,GBR,Perak,53,34,19,United Kingdom
54988,9/1/2022,GBR,Perlis,113,74,39,United Kingdom
54989,9/1/2022,GBR,Pulau Pinang,879,532,347,United Kingdom
54990,9/1/2022,GBR,Sabah,318,180,138,United Kingdom
54991,9/1/2022,GBR,Sarawak,968,632,336,United Kingdom
54992,9/1/2022,GBR,Selangor,11781,7331,4450,United Kingdom
54993,9/1/2022,GBR,Terengganu,3,3,0,United Kingdom
54994,9/1/2022,GBR,W.P. Labuan,44,39,5,United Kingdom
54995,9/1/2022,GEO,Johor,18,12,6,Georgia
54996,9/1/2022,GEO,Kedah,1,1,0,Georgia
54997,9/1/2022,GEO,Melaka,0,0,0,Georgia
54998,9/1/2022,GEO,Perak,0,0,0,Georgia
54999,9/1/2022,GEO,Perlis,0,0,0,Georgia
55000,9/1/2022,GEO,Pulau Pinang,0,0,0,Georgia
55001,9/1/2022,GEO,Sabah,0,0,0,Georgia
55002,9/1/2022,GEO,Sarawak,0,0,0,Georgia
55003,9/1/2022,GEO,Selangor,47,41,6,Georgia
55004,9/1/2022,GHA,Johor,6,6,0,Ghana
55005,9/1/2022,GHA,Kedah,0,0,0,Ghana
55006,9/1/2022,GHA,Kelantan,0,0,0,Ghana
55007,9/1/2022,GHA,Pulau Pinang,0,0,0,Ghana
55008,9/1/2022,GHA,Sabah,0,0,0,Ghana
55009,9/1/2022,GHA,Sarawak,0,0,0,Ghana
55010,9/1/2022,GHA,Selangor,56,43,13,Ghana
55011,9/1/2022,GIB,Johor,0,0,0,Gibraltar
55012,9/1/2022,GIB,Sarawak,0,0,0,Gibraltar
55013,9/1/2022,GIN,Johor,2,2,0,Guinea
55014,9/1/2022,GIN,Kedah,0,0,0,Guinea
55015,9/1/2022,GIN,Kelantan,1,1,0,Guinea
55016,9/1/2022,GIN,Perlis,0,0,0,Guinea
55017,9/1/2022,GIN,Pulau Pinang,1,1,0,Guinea
55018,9/1/2022,GIN,Sabah,0,0,0,Guinea
55019,9/1/2022,GIN,Sarawak,0,0,0,Guinea
55020,9/1/2022,GIN,Selangor,25,22,3,Guinea
55021,9/1/2022,GLP,Selangor,0,0,0,Guadeloupe
55022,9/1/2022,GMB,Johor,0,0,0,Gambia
55023,9/1/2022,GMB,Kedah,0,0,0,Gambia
55024,9/1/2022,GMB,Kelantan,0,0,0,Gambia
55025,9/1/2022,GMB,Pulau Pinang,0,0,0,Gambia
55026,9/1/2022,GMB,Sabah,0,0,0,Gambia
55027,9/1/2022,GMB,Sarawak,0,0,0,Gambia
55028,9/1/2022,GMB,Selangor,13,10,3,Gambia
55029,9/1/2022,GNB,Johor,0,0,0,Guinea-Bissau
55030,9/1/2022,GNB,Selangor,0,0,0,Guinea-Bissau
55031,9/1/2022,GNQ,Johor,0,0,0,Equatorial Guinea
55032,9/1/2022,GNQ,Selangor,0,0,0,Equatorial Guinea
55033,9/1/2022,GRC,Johor,41,30,11,Greece
55034,9/1/2022,GRC,Kedah,0,0,0,Greece
55035,9/1/2022,GRC,Kelantan,0,0,0,Greece
55036,9/1/2022,GRC,Melaka,0,0,0,Greece
55037,9/1/2022,GRC,Negeri Sembilan,0,0,0,Greece
55038,9/1/2022,GRC,Pahang,0,0,0,Greece
55039,9/1/2022,GRC,Perak,0,0,0,Greece
55040,9/1/2022,GRC,Perlis,1,0,1,Greece
55041,9/1/2022,GRC,Pulau Pinang,2,2,0,Greece
55042,9/1/2022,GRC,Sabah,5,3,2,Greece
55043,9/1/2022,GRC,Sarawak,3,2,1,Greece
55044,9/1/2022,GRC,Selangor,134,101,33,Greece
55045,9/1/2022,GRD,Johor,6,4,2,Grenada
55046,9/1/2022,GRD,Kedah,0,0,0,Grenada
55047,9/1/2022,GRD,Pulau Pinang,1,1,0,Grenada
55048,9/1/2022,GRD,Sabah,0,0,0,Grenada
55049,9/1/2022,GRD,Sarawak,0,0,0,Grenada
55050,9/1/2022,GRD,Selangor,11,9,2,Grenada
55051,9/1/2022,GRL,Johor,0,0,0,Greenland
55052,9/1/2022,GRL,Selangor,0,0,0,Greenland
55053,9/1/2022,GTM,Johor,0,0,0,Guatemala
55054,9/1/2022,GTM,Kedah,0,0,0,Guatemala
55055,9/1/2022,GTM,Pahang,0,0,0,Guatemala
55056,9/1/2022,GTM,Perak,0,0,0,Guatemala
55057,9/1/2022,GTM,Pulau Pinang,1,0,1,Guatemala
55058,9/1/2022,GTM,Sabah,0,0,0,Guatemala
55059,9/1/2022,GTM,Sarawak,0,0,0,Guatemala
55060,9/1/2022,GTM,Selangor,10,5,5,Guatemala
55061,9/1/2022,GTM,W.P. Labuan,0,0,0,Guatemala
55062,9/1/2022,GUY,Johor,0,0,0,Guyana
55063,9/1/2022,GUY,Kedah,0,0,0,Guyana
55064,9/1/2022,GUY,Pulau Pinang,0,0,0,Guyana
55065,9/1/2022,GUY,Sarawak,0,0,0,Guyana
55066,9/1/2022,GUY,Selangor,2,1,1,Guyana
55067,9/1/2022,HKG,Johor,1,1,0,Hong Kong
55068,9/1/2022,HKG,Kedah,2,1,1,Hong Kong
55069,9/1/2022,HKG,Kelantan,0,0,0,Hong Kong
55070,9/1/2022,HKG,Pahang,0,0,0,Hong Kong
55071,9/1/2022,HKG,Perak,19,11,8,Hong Kong
55072,9/1/2022,HKG,Perlis,4,2,2,Hong Kong
55073,9/1/2022,HKG,Pulau Pinang,0,0,0,Hong Kong
55074,9/1/2022,HKG,Sabah,13,7,6,Hong Kong
55075,9/1/2022,HKG,Sarawak,0,0,0,Hong Kong
55076,9/1/2022,HKG,Selangor,1,1,0,Hong Kong
55077,9/1/2022,HKG,Terengganu,0,0,0,Hong Kong
55078,9/1/2022,HMD,Johor,0,0,0,Heard Island and McDonald Islands
55079,9/1/2022,HND,Johor,2,1,1,Honduras
55080,9/1/2022,HND,Kedah,0,0,0,Honduras
55081,9/1/2022,HND,Perak,0,0,0,Honduras
55082,9/1/2022,HND,Pulau Pinang,0,0,0,Honduras
55083,9/1/2022,HND,Sabah,0,0,0,Honduras
55084,9/1/2022,HND,Sarawak,0,0,0,Honduras
55085,9/1/2022,HND,Selangor,13,4,9,Honduras
55086,9/1/2022,HRV,Johor,32,20,12,Croatia
55087,9/1/2022,HRV,Kedah,3,1,2,Croatia
55088,9/1/2022,HRV,Kelantan,0,0,0,Croatia
55089,9/1/2022,HRV,Melaka,0,0,0,Croatia
55090,9/1/2022,HRV,Pahang,0,0,0,Croatia
55091,9/1/2022,HRV,Perak,3,2,1,Croatia
55092,9/1/2022,HRV,Perlis,0,0,0,Croatia
55093,9/1/2022,HRV,Pulau Pinang,4,3,1,Croatia
55094,9/1/2022,HRV,Sabah,0,0,0,Croatia
55095,9/1/2022,HRV,Sarawak,2,2,0,Croatia
55096,9/1/2022,HRV,Selangor,116,86,30,Croatia
55097,9/1/2022,HTI,Johor,4,3,1,Haiti
55098,9/1/2022,HTI,Kedah,0,0,0,Haiti
55099,9/1/2022,HTI,Kelantan,0,0,0,Haiti
55100,9/1/2022,HTI,Perak,0,0,0,Haiti
55101,9/1/2022,HTI,Pulau Pinang,1,0,1,Haiti
55102,9/1/2022,HTI,Sabah,0,0,0,Haiti
55103,9/1/2022,HTI,Selangor,3,2,1,Haiti
55104,9/1/2022,HUN,Johor,66,42,24,Hungary
55105,9/1/2022,HUN,Kedah,7,2,5,Hungary
55106,9/1/2022,HUN,Kelantan,2,2,0,Hungary
55107,9/1/2022,HUN,Pahang,1,1,0,Hungary
55108,9/1/2022,HUN,Perak,0,0,0,Hungary
55109,9/1/2022,HUN,Perlis,2,1,1,Hungary
55110,9/1/2022,HUN,Pulau Pinang,9,5,4,Hungary
55111,9/1/2022,HUN,Sabah,3,1,2,Hungary
55112,9/1/2022,HUN,Sarawak,2,1,1,Hungary
55113,9/1/2022,HUN,Selangor,300,160,140,Hungary
55114,9/1/2022,HUN,W.P. Labuan,0,0,0,Hungary
55115,9/1/2022,IDN,Johor,85343,46090,39253,Indonesia
55116,9/1/2022,IDN,Kedah,2035,783,1252,Indonesia
55117,9/1/2022,IDN,Kelantan,93,59,34,Indonesia
55118,9/1/2022,IDN,Melaka,7816,3486,4330,Indonesia
55119,9/1/2022,IDN,Negeri Sembilan,6826,4691,2135,Indonesia
55120,9/1/2022,IDN,Pahang,8,7,1,Indonesia
55121,9/1/2022,IDN,Perak,133,27,106,Indonesia
55122,9/1/2022,IDN,Perlis,275,109,166,Indonesia
55123,9/1/2022,IDN,Pulau Pinang,23721,8843,14878,Indonesia
55124,9/1/2022,IDN,Sabah,3700,1799,1901,Indonesia
55125,9/1/2022,IDN,Sarawak,25941,14755,11186,Indonesia
55126,9/1/2022,IDN,Selangor,63148,31678,31470,Indonesia
55127,9/1/2022,IDN,Terengganu,2,1,1,Indonesia
55128,9/1/2022,IDN,W.P. Labuan,28,20,8,Indonesia
55129,9/1/2022,IND,Johor,14758,10199,4559,India
55130,9/1/2022,IND,Kedah,591,326,265,India
55131,9/1/2022,IND,Kelantan,5,3,2,India
55132,9/1/2022,IND,Melaka,12,7,5,India
55133,9/1/2022,IND,Negeri Sembilan,0,0,0,India
55134,9/1/2022,IND,Pahang,2,1,1,India
55135,9/1/2022,IND,Perak,1029,912,117,India
55136,9/1/2022,IND,Perlis,61,48,13,India
55137,9/1/2022,IND,Pulau Pinang,506,366,140,India
55138,9/1/2022,IND,Sabah,193,130,63,India
55139,9/1/2022,IND,Sarawak,406,288,118,India
55140,9/1/2022,IND,Selangor,39817,30128,9689,India
55141,9/1/2022,IND,Terengganu,0,0,0,India
55142,9/1/2022,IND,W.P. Labuan,20,13,7,India
55143,9/1/2022,IOT,Pulau Pinang,0,0,0,British Indian Ocean Territory
55144,9/1/2022,IOT,Selangor,0,0,0,British Indian Ocean Territory
55145,9/1/2022,IRL,Johor,224,157,67,Ireland
55146,9/1/2022,IRL,Kedah,36,26,10,Ireland
55147,9/1/2022,IRL,Kelantan,0,0,0,Ireland
55148,9/1/2022,IRL,Negeri Sembilan,0,0,0,Ireland
55149,9/1/2022,IRL,Pahang,0,0,0,Ireland
55150,9/1/2022,IRL,Perak,14,6,8,Ireland
55151,9/1/2022,IRL,Perlis,27,15,12,Ireland
55152,9/1/2022,IRL,Pulau Pinang,61,36,25,Ireland
55153,9/1/2022,IRL,Sabah,14,9,5,Ireland
55154,9/1/2022,IRL,Sarawak,28,14,14,Ireland
55155,9/1/2022,IRL,Selangor,949,561,388,Ireland
55156,9/1/2022,IRL,Terengganu,0,0,0,Ireland
55157,9/1/2022,IRL,W.P. Labuan,0,0,0,Ireland
55158,9/1/2022,IRN,Johor,60,45,15,Iran
55159,9/1/2022,IRN,Kedah,4,3,1,Iran
55160,9/1/2022,IRN,Kelantan,0,0,0,Iran
55161,9/1/2022,IRN,Perak,0,0,0,Iran
55162,9/1/2022,IRN,Perlis,3,3,0,Iran
55163,9/1/2022,IRN,Pulau Pinang,4,2,2,Iran
55164,9/1/2022,IRN,Sabah,1,1,0,Iran
55165,9/1/2022,IRN,Sarawak,12,4,8,Iran
55166,9/1/2022,IRN,Selangor,843,451,392,Iran
55167,9/1/2022,IRN,W.P. Labuan,0,0,0,Iran
55168,9/1/2022,IRQ,Johor,19,13,6,Iraq
55169,9/1/2022,IRQ,Kedah,0,0,0,Iraq
55170,9/1/2022,IRQ,Kelantan,0,0,0,Iraq
55171,9/1/2022,IRQ,Melaka,0,0,0,Iraq
55172,9/1/2022,IRQ,Pahang,0,0,0,Iraq
55173,9/1/2022,IRQ,Perak,0,0,0,Iraq
55174,9/1/2022,IRQ,Perlis,1,1,0,Iraq
55175,9/1/2022,IRQ,Pulau Pinang,0,0,0,Iraq
55176,9/1/2022,IRQ,Sabah,0,0,0,Iraq
55177,9/1/2022,IRQ,Sarawak,0,0,0,Iraq
55178,9/1/2022,IRQ,Selangor,770,504,266,Iraq
55179,9/1/2022,ISL,Johor,9,8,1,Iceland
55180,9/1/2022,ISL,Kedah,0,0,0,Iceland
55181,9/1/2022,ISL,Kelantan,0,0,0,Iceland
55182,9/1/2022,ISL,Perak,0,0,0,Iceland
55183,9/1/2022,ISL,Perlis,1,1,0,Iceland
55184,9/1/2022,ISL,Pulau Pinang,1,1,0,Iceland
55185,9/1/2022,ISL,Sabah,0,0,0,Iceland
55186,9/1/2022,ISL,Sarawak,0,0,0,Iceland
55187,9/1/2022,ISL,Selangor,16,12,4,Iceland
55188,9/1/2022,ISL,W.P. Labuan,0,0,0,Iceland
55189,9/1/2022,ISR,Pulau Pinang,2,2,0,Israel
55190,9/1/2022,ITA,Johor,473,339,134,Italy
55191,9/1/2022,ITA,Kedah,29,18,11,Italy
55192,9/1/2022,ITA,Kelantan,2,2,0,Italy
55193,9/1/2022,ITA,Melaka,1,0,1,Italy
55194,9/1/2022,ITA,Negeri Sembilan,2,1,1,Italy
55195,9/1/2022,ITA,Pahang,0,0,0,Italy
55196,9/1/2022,ITA,Perak,0,0,0,Italy
55197,9/1/2022,ITA,Perlis,15,10,5,Italy
55198,9/1/2022,ITA,Pulau Pinang,80,61,19,Italy
55199,9/1/2022,ITA,Sabah,34,21,13,Italy
55200,9/1/2022,ITA,Sarawak,25,15,10,Italy
55201,9/1/2022,ITA,Selangor,1839,1248,591,Italy
55202,9/1/2022,ITA,W.P. Labuan,0,0,0,Italy
55203,9/1/2022,JAM,Johor,0,0,0,Jamaica
55204,9/1/2022,JAM,Kedah,0,0,0,Jamaica
55205,9/1/2022,JAM,Perak,0,0,0,Jamaica
55206,9/1/2022,JAM,Pulau Pinang,1,1,0,Jamaica
55207,9/1/2022,JAM,Sabah,1,0,1,Jamaica
55208,9/1/2022,JAM,Sarawak,0,0,0,Jamaica
55209,9/1/2022,JAM,Selangor,5,1,4,Jamaica
55210,9/1/2022,JAM,W.P. Labuan,0,0,0,Jamaica
55211,9/1/2022,JOR,Johor,17,11,6,Jordan
55212,9/1/2022,JOR,Kedah,3,3,0,Jordan
55213,9/1/2022,JOR,Kelantan,0,0,0,Jordan
55214,9/1/2022,JOR,Melaka,0,0,0,Jordan
55215,9/1/2022,JOR,Perlis,1,1,0,Jordan
55216,9/1/2022,JOR,Pulau Pinang,8,8,0,Jordan
55217,9/1/2022,JOR,Sabah,2,2,0,Jordan
55218,9/1/2022,JOR,Sarawak,0,0,0,Jordan
55219,9/1/2022,JOR,Selangor,658,400,258,Jordan
55220,9/1/2022,JOR,W.P. Labuan,1,1,0,Jordan
55221,9/1/2022,JPN,Johor,4608,3386,1222,Japan
55222,9/1/2022,JPN,Kedah,76,49,27,Japan
55223,9/1/2022,JPN,Kelantan,7,7,0,Japan
55224,9/1/2022,JPN,Melaka,1,1,0,Japan
55225,9/1/2022,JPN,Negeri Sembilan,0,0,0,Japan
55226,9/1/2022,JPN,Pahang,0,0,0,Japan
55227,9/1/2022,JPN,Perak,36,24,12,Japan
55228,9/1/2022,JPN,Perlis,51,42,9,Japan
55229,9/1/2022,JPN,Pulau Pinang,817,620,197,Japan
55230,9/1/2022,JPN,Sabah,166,91,75,Japan
55231,9/1/2022,JPN,Sarawak,97,67,30,Japan
55232,9/1/2022,JPN,Selangor,9946,6616,3330,Japan
55233,9/1/2022,JPN,W.P. Labuan,4,4,0,Japan
55234,9/1/2022,KAZ,Johor,20,5,15,Kazakhstan
55235,9/1/2022,KAZ,Kedah,8,4,4,Kazakhstan
55236,9/1/2022,KAZ,Kelantan,0,0,0,Kazakhstan
55237,9/1/2022,KAZ,Melaka,0,0,0,Kazakhstan
55238,9/1/2022,KAZ,Perak,0,0,0,Kazakhstan
55239,9/1/2022,KAZ,Perlis,2,1,1,Kazakhstan
55240,9/1/2022,KAZ,Pulau Pinang,8,3,5,Kazakhstan
55241,9/1/2022,KAZ,Sabah,0,0,0,Kazakhstan
55242,9/1/2022,KAZ,Sarawak,1,1,0,Kazakhstan
55243,9/1/2022,KAZ,Selangor,382,160,222,Kazakhstan
55244,9/1/2022,KAZ,W.P. Labuan,0,0,0,Kazakhstan
55245,9/1/2022,KEN,Johor,26,12,14,Kenya
55246,9/1/2022,KEN,Kedah,4,2,2,Kenya
55247,9/1/2022,KEN,Kelantan,0,0,0,Kenya
55248,9/1/2022,KEN,Perak,0,0,0,Kenya
55249,9/1/2022,KEN,Perlis,0,0,0,Kenya
55250,9/1/2022,KEN,Pulau Pinang,1,0,1,Kenya
55251,9/1/2022,KEN,Sabah,2,2,0,Kenya
55252,9/1/2022,KEN,Sarawak,3,2,1,Kenya
55253,9/1/2022,KEN,Selangor,305,162,143,Kenya
55254,9/1/2022,KGZ,Johor,6,2,4,Kyrgyzstan
55255,9/1/2022,KGZ,Kedah,1,1,0,Kyrgyzstan
55256,9/1/2022,KGZ,Kelantan,0,0,0,Kyrgyzstan
55257,9/1/2022,KGZ,Perak,0,0,0,Kyrgyzstan
55258,9/1/2022,KGZ,Perlis,0,0,0,Kyrgyzstan
55259,9/1/2022,KGZ,Pulau Pinang,0,0,0,Kyrgyzstan
55260,9/1/2022,KGZ,Sabah,0,0,0,Kyrgyzstan
55261,9/1/2022,KGZ,Sarawak,0,0,0,Kyrgyzstan
55262,9/1/2022,KGZ,Selangor,124,65,59,Kyrgyzstan
55263,9/1/2022,KHM,Johor,1325,575,750,Cambodia
55264,9/1/2022,KHM,Kedah,143,83,60,Cambodia
55265,9/1/2022,KHM,Kelantan,601,379,222,Cambodia
55266,9/1/2022,KHM,Melaka,0,0,0,Cambodia
55267,9/1/2022,KHM,Negeri Sembilan,0,0,0,Cambodia
55268,9/1/2022,KHM,Pahang,0,0,0,Cambodia
55269,9/1/2022,KHM,Perak,4,1,3,Cambodia
55270,9/1/2022,KHM,Perlis,901,626,275,Cambodia
55271,9/1/2022,KHM,Pulau Pinang,33,13,20,Cambodia
55272,9/1/2022,KHM,Sabah,1,0,1,Cambodia
55273,9/1/2022,KHM,Sarawak,0,0,0,Cambodia
55274,9/1/2022,KHM,Selangor,3468,1615,1853,Cambodia
55275,9/1/2022,KHM,W.P. Labuan,0,0,0,Cambodia
55276,9/1/2022,KIR,Johor,0,0,0,Kiribati
55277,9/1/2022,KIR,Sabah,0,0,0,Kiribati
55278,9/1/2022,KIR,Selangor,0,0,0,Kiribati
55279,9/1/2022,KNA,Johor,24,18,6,Saint Kitts and Nevis
55280,9/1/2022,KNA,Kedah,1,1,0,Saint Kitts and Nevis
55281,9/1/2022,KNA,Perlis,0,0,0,Saint Kitts and Nevis
55282,9/1/2022,KNA,Pulau Pinang,2,2,0,Saint Kitts and Nevis
55283,9/1/2022,KNA,Sabah,0,0,0,Saint Kitts and Nevis
55284,9/1/2022,KNA,Selangor,37,26,11,Saint Kitts and Nevis
55285,9/1/2022,KNA,W.P. Labuan,0,0,0,Saint Kitts and Nevis
55286,9/1/2022,KOR,Johor,6829,3972,2857,"Korea, Republic of (South Korea)"
55287,9/1/2022,KOR,Kedah,72,27,45,"Korea, Republic of (South Korea)"
55288,9/1/2022,KOR,Kelantan,0,0,0,"Korea, Republic of (South Korea)"
55289,9/1/2022,KOR,Melaka,3,3,0,"Korea, Republic of (South Korea)"
55290,9/1/2022,KOR,Negeri Sembilan,0,0,0,"Korea, Republic of (South Korea)"
55291,9/1/2022,KOR,Pahang,0,0,0,"Korea, Republic of (South Korea)"
55292,9/1/2022,KOR,Perak,19,11,8,"Korea, Republic of (South Korea)"
55293,9/1/2022,KOR,Perlis,26,22,4,"Korea, Republic of (South Korea)"
55294,9/1/2022,KOR,Pulau Pinang,317,191,126,"Korea, Republic of (South Korea)"
55295,9/1/2022,KOR,Sabah,5550,2474,3076,"Korea, Republic of (South Korea)"
55296,9/1/2022,KOR,Sarawak,148,78,70,"Korea, Republic of (South Korea)"
55297,9/1/2022,KOR,Selangor,7541,4517,3024,"Korea, Republic of (South Korea)"
55298,9/1/2022,KOR,Terengganu,0,0,0,"Korea, Republic of (South Korea)"
55299,9/1/2022,KOR,W.P. Labuan,3,0,3,"Korea, Republic of (South Korea)"
55300,9/1/2022,KWT,Johor,57,30,27,Kuwait
55301,9/1/2022,KWT,Kedah,0,0,0,Kuwait
55302,9/1/2022,KWT,Kelantan,0,0,0,Kuwait
55303,9/1/2022,KWT,Perak,0,0,0,Kuwait
55304,9/1/2022,KWT,Perlis,0,0,0,Kuwait
55305,9/1/2022,KWT,Pulau Pinang,8,7,1,Kuwait
55306,9/1/2022,KWT,Sabah,0,0,0,Kuwait
55307,9/1/2022,KWT,Sarawak,0,0,0,Kuwait
55308,9/1/2022,KWT,Selangor,406,220,186,Kuwait
55309,9/1/2022,KWT,W.P. Labuan,0,0,0,Kuwait
55310,9/1/2022,LAO,Johor,116,40,76,Lao People's Democratic Republic
55311,9/1/2022,LAO,Kedah,657,68,589,Lao People's Democratic Republic
55312,9/1/2022,LAO,Kelantan,65,8,57,Lao People's Democratic Republic
55313,9/1/2022,LAO,Melaka,1,0,1,Lao People's Democratic Republic
55314,9/1/2022,LAO,Perak,16,4,12,Lao People's Democratic Republic
55315,9/1/2022,LAO,Perlis,303,97,206,Lao People's Democratic Republic
55316,9/1/2022,LAO,Pulau Pinang,17,7,10,Lao People's Democratic Republic
55317,9/1/2022,LAO,Sabah,2,0,2,Lao People's Democratic Republic
55318,9/1/2022,LAO,Sarawak,4,4,0,Lao People's Democratic Republic
55319,9/1/2022,LAO,Selangor,206,67,139,Lao People's Democratic Republic
55320,9/1/2022,LAO,W.P. Labuan,0,0,0,Lao People's Democratic Republic
55321,9/1/2022,LBN,Johor,8,6,2,Lebanon
55322,9/1/2022,LBN,Kedah,0,0,0,Lebanon
55323,9/1/2022,LBN,Kelantan,0,0,0,Lebanon
55324,9/1/2022,LBN,Pahang,0,0,0,Lebanon
55325,9/1/2022,LBN,Perak,0,0,0,Lebanon
55326,9/1/2022,LBN,Perlis,0,0,0,Lebanon
55327,9/1/2022,LBN,Pulau Pinang,2,0,2,Lebanon
55328,9/1/2022,LBN,Sabah,2,2,0,Lebanon
55329,9/1/2022,LBN,Sarawak,2,0,2,Lebanon
55330,9/1/2022,LBN,Selangor,201,130,71,Lebanon
55331,9/1/2022,LBN,W.P. Labuan,0,0,0,Lebanon
55332,9/1/2022,LBR,Johor,1,1,0,Liberia
55333,9/1/2022,LBR,Kedah,0,0,0,Liberia
55334,9/1/2022,LBR,Sabah,0,0,0,Liberia
55335,9/1/2022,LBR,Sarawak,0,0,0,Liberia
55336,9/1/2022,LBR,Selangor,5,4,1,Liberia
55337,9/1/2022,LBY,Johor,8,6,2,Libyan Arab Jamahiriya
55338,9/1/2022,LBY,Kedah,0,0,0,Libyan Arab Jamahiriya
55339,9/1/2022,LBY,Perlis,0,0,0,Libyan Arab Jamahiriya
55340,9/1/2022,LBY,Pulau Pinang,1,1,0,Libyan Arab Jamahiriya
55341,9/1/2022,LBY,Sabah,1,1,0,Libyan Arab Jamahiriya
55342,9/1/2022,LBY,Sarawak,1,1,0,Libyan Arab Jamahiriya
55343,9/1/2022,LBY,Selangor,361,245,116,Libyan Arab Jamahiriya
55344,9/1/2022,LCA,Johor,6,5,1,Saint Lucia
55345,9/1/2022,LCA,Kedah,0,0,0,Saint Lucia
55346,9/1/2022,LCA,Pulau Pinang,0,0,0,Saint Lucia
55347,9/1/2022,LCA,Sarawak,0,0,0,Saint Lucia
55348,9/1/2022,LCA,Selangor,7,7,0,Saint Lucia
55349,9/1/2022,LIE,Johor,1,1,0,Liechtenstein
55350,9/1/2022,LIE,Kedah,0,0,0,Liechtenstein
55351,9/1/2022,LIE,Perlis,0,0,0,Liechtenstein
55352,9/1/2022,LIE,Pulau Pinang,2,2,0,Liechtenstein
55353,9/1/2022,LIE,Sabah,0,0,0,Liechtenstein
55354,9/1/2022,LIE,Sarawak,0,0,0,Liechtenstein
55355,9/1/2022,LIE,Selangor,3,3,0,Liechtenstein
55356,9/1/2022,LKA,Johor,914,581,333,Sri Lanka
55357,9/1/2022,LKA,Kedah,20,11,9,Sri Lanka
55358,9/1/2022,LKA,Kelantan,0,0,0,Sri Lanka
55359,9/1/2022,LKA,Melaka,0,0,0,Sri Lanka
55360,9/1/2022,LKA,Pahang,0,0,0,Sri Lanka
55361,9/1/2022,LKA,Perak,1,0,1,Sri Lanka
55362,9/1/2022,LKA,Perlis,3,1,2,Sri Lanka
55363,9/1/2022,LKA,Pulau Pinang,26,16,10,Sri Lanka
55364,9/1/2022,LKA,Sabah,16,10,6,Sri Lanka
55365,9/1/2022,LKA,Sarawak,10,6,4,Sri Lanka
55366,9/1/2022,LKA,Selangor,2482,1657,825,Sri Lanka
55367,9/1/2022,LKA,W.P. Labuan,0,0,0,Sri Lanka
55368,9/1/2022,LSO,Johor,0,0,0,Lesotho
55369,9/1/2022,LSO,Kedah,0,0,0,Lesotho
55370,9/1/2022,LSO,Pulau Pinang,0,0,0,Lesotho
55371,9/1/2022,LSO,Sarawak,0,0,0,Lesotho
55372,9/1/2022,LSO,Selangor,6,3,3,Lesotho
55373,9/1/2022,LTU,Johor,28,10,18,Lithuania
55374,9/1/2022,LTU,Kedah,8,5,3,Lithuania
55375,9/1/2022,LTU,Kelantan,0,0,0,Lithuania
55376,9/1/2022,LTU,Pahang,0,0,0,Lithuania
55377,9/1/2022,LTU,Perak,2,0,2,Lithuania
55378,9/1/2022,LTU,Perlis,3,1,2,Lithuania
55379,9/1/2022,LTU,Pulau Pinang,3,1,2,Lithuania
55380,9/1/2022,LTU,Sabah,5,3,2,Lithuania
55381,9/1/2022,LTU,Sarawak,3,1,2,Lithuania
55382,9/1/2022,LTU,Selangor,158,90,68,Lithuania
55383,9/1/2022,LTU,W.P. Labuan,0,0,0,Lithuania
55384,9/1/2022,LUX,Johor,10,5,5,Luxembourg
55385,9/1/2022,LUX,Kedah,0,0,0,Luxembourg
55386,9/1/2022,LUX,Kelantan,0,0,0,Luxembourg
55387,9/1/2022,LUX,Perak,0,0,0,Luxembourg
55388,9/1/2022,LUX,Perlis,0,0,0,Luxembourg
55389,9/1/2022,LUX,Pulau Pinang,0,0,0,Luxembourg
55390,9/1/2022,LUX,Sabah,0,0,0,Luxembourg
55391,9/1/2022,LUX,Sarawak,0,0,0,Luxembourg
55392,9/1/2022,LUX,Selangor,34,19,15,Luxembourg
55393,9/1/2022,LVA,Johor,13,5,8,Latvia
55394,9/1/2022,LVA,Kedah,0,0,0,Latvia
55395,9/1/2022,LVA,Kelantan,0,0,0,Latvia
55396,9/1/2022,LVA,Pahang,0,0,0,Latvia
55397,9/1/2022,LVA,Perak,0,0,0,Latvia
55398,9/1/2022,LVA,Perlis,0,0,0,Latvia
55399,9/1/2022,LVA,Pulau Pinang,2,1,1,Latvia
55400,9/1/2022,LVA,Sabah,0,0,0,Latvia
55401,9/1/2022,LVA,Sarawak,4,2,2,Latvia
55402,9/1/2022,LVA,Selangor,53,32,21,Latvia
55403,9/1/2022,LVA,W.P. Labuan,0,0,0,Latvia
55404,9/1/2022,MAC,Johor,0,0,0,Macao
55405,9/1/2022,MAC,Pahang,0,0,0,Macao
55406,9/1/2022,MAC,Perak,0,0,0,Macao
55407,9/1/2022,MAC,Selangor,0,0,0,Macao
55408,9/1/2022,MAC,W.P. Labuan,0,0,0,Macao
55409,9/1/2022,MAR,Johor,56,41,15,Morocco
55410,9/1/2022,MAR,Kedah,4,3,1,Morocco
55411,9/1/2022,MAR,Kelantan,0,0,0,Morocco
55412,9/1/2022,MAR,Melaka,0,0,0,Morocco
55413,9/1/2022,MAR,Pahang,0,0,0,Morocco
55414,9/1/2022,MAR,Perak,0,0,0,Morocco
55415,9/1/2022,MAR,Perlis,0,0,0,Morocco
55416,9/1/2022,MAR,Pulau Pinang,7,6,1,Morocco
55417,9/1/2022,MAR,Sabah,1,0,1,Morocco
55418,9/1/2022,MAR,Sarawak,3,3,0,Morocco
55419,9/1/2022,MAR,Selangor,643,318,325,Morocco
55420,9/1/2022,MAR,W.P. Labuan,0,0,0,Morocco
55421,9/1/2022,MCO,Johor,0,0,0,Monaco
55422,9/1/2022,MCO,Kedah,0,0,0,Monaco
55423,9/1/2022,MCO,Sabah,0,0,0,Monaco
55424,9/1/2022,MCO,Selangor,0,0,0,Monaco
55425,9/1/2022,MDA,Johor,8,5,3,"Moldova, Republic of"
55426,9/1/2022,MDA,Kedah,0,0,0,"Moldova, Republic of"
55427,9/1/2022,MDA,Kelantan,0,0,0,"Moldova, Republic of"
55428,9/1/2022,MDA,Negeri Sembilan,0,0,0,"Moldova, Republic of"
55429,9/1/2022,MDA,Perlis,0,0,0,"Moldova, Republic of"
55430,9/1/2022,MDA,Pulau Pinang,0,0,0,"Moldova, Republic of"
55431,9/1/2022,MDA,Sabah,1,0,1,"Moldova, Republic of"
55432,9/1/2022,MDA,Sarawak,3,0,3,"Moldova, Republic of"
55433,9/1/2022,MDA,Selangor,27,13,14,"Moldova, Republic of"
55434,9/1/2022,MDG,Johor,0,0,0,Madagascar
55435,9/1/2022,MDG,Kedah,1,1,0,Madagascar
55436,9/1/2022,MDG,Perak,0,0,0,Madagascar
55437,9/1/2022,MDG,Perlis,0,0,0,Madagascar
55438,9/1/2022,MDG,Pulau Pinang,0,0,0,Madagascar
55439,9/1/2022,MDG,Sabah,0,0,0,Madagascar
55440,9/1/2022,MDG,Sarawak,0,0,0,Madagascar
55441,9/1/2022,MDG,Selangor,15,4,11,Madagascar
55442,9/1/2022,MDV,Johor,90,61,29,Maldives
55443,9/1/2022,MDV,Kedah,3,1,2,Maldives
55444,9/1/2022,MDV,Kelantan,0,0,0,Maldives
55445,9/1/2022,MDV,Perak,0,0,0,Maldives
55446,9/1/2022,MDV,Perlis,0,0,0,Maldives
55447,9/1/2022,MDV,Pulau Pinang,4,3,1,Maldives
55448,9/1/2022,MDV,Sabah,0,0,0,Maldives
55449,9/1/2022,MDV,Sarawak,7,5,2,Maldives
55450,9/1/2022,MDV,Selangor,1741,997,744,Maldives
55451,9/1/2022,MEX,Johor,120,61,59,Mexico
55452,9/1/2022,MEX,Kedah,8,4,4,Mexico
55453,9/1/2022,MEX,Kelantan,0,0,0,Mexico
55454,9/1/2022,MEX,Pahang,0,0,0,Mexico
55455,9/1/2022,MEX,Perak,0,0,0,Mexico
55456,9/1/2022,MEX,Perlis,1,1,0,Mexico
55457,9/1/2022,MEX,Pulau Pinang,15,14,1,Mexico
55458,9/1/2022,MEX,Sabah,6,3,3,Mexico
55459,9/1/2022,MEX,Sarawak,2,1,1,Mexico
55460,9/1/2022,MEX,Selangor,401,218,183,Mexico
55461,9/1/2022,MEX,W.P. Labuan,0,0,0,Mexico
55462,9/1/2022,MHL,Johor,0,0,0,Marshall Islands
55463,9/1/2022,MHL,Kedah,0,0,0,Marshall Islands
55464,9/1/2022,MHL,Perak,0,0,0,Marshall Islands
55465,9/1/2022,MHL,Pulau Pinang,0,0,0,Marshall Islands
55466,9/1/2022,MHL,Sabah,0,0,0,Marshall Islands
55467,9/1/2022,MHL,Selangor,1,1,0,Marshall Islands
55468,9/1/2022,MKD,Johor,5,2,3,"Macedonia, the former Yugoslav Republic of"
55469,9/1/2022,MKD,Kedah,0,0,0,"Macedonia, the former Yugoslav Republic of"
55470,9/1/2022,MKD,Perak,0,0,0,"Macedonia, the former Yugoslav Republic of"
55471,9/1/2022,MKD,Pulau Pinang,5,5,0,"Macedonia, the former Yugoslav Republic of"
55472,9/1/2022,MKD,Sabah,0,0,0,"Macedonia, the former Yugoslav Republic of"
55473,9/1/2022,MKD,Sarawak,4,2,2,"Macedonia, the former Yugoslav Republic of"
55474,9/1/2022,MKD,Selangor,26,15,11,"Macedonia, the former Yugoslav Republic of"
55475,9/1/2022,MLI,Johor,2,2,0,Mali
55476,9/1/2022,MLI,Sabah,0,0,0,Mali
55477,9/1/2022,MLI,Selangor,5,3,2,Mali
55478,9/1/2022,MLT,Johor,3,2,1,Malta
55479,9/1/2022,MLT,Kedah,0,0,0,Malta
55480,9/1/2022,MLT,Kelantan,0,0,0,Malta
55481,9/1/2022,MLT,Perak,2,1,1,Malta
55482,9/1/2022,MLT,Perlis,0,0,0,Malta
55483,9/1/2022,MLT,Pulau Pinang,1,1,0,Malta
55484,9/1/2022,MLT,Sabah,4,2,2,Malta
55485,9/1/2022,MLT,Sarawak,0,0,0,Malta
55486,9/1/2022,MLT,Selangor,31,21,10,Malta
55487,9/1/2022,MLT,W.P. Labuan,0,0,0,Malta
55488,9/1/2022,MMR,Johor,3275,1037,2238,Myanmar
55489,9/1/2022,MMR,Kedah,37,12,25,Myanmar
55490,9/1/2022,MMR,Kelantan,3,1,2,Myanmar
55491,9/1/2022,MMR,Negeri Sembilan,0,0,0,Myanmar
55492,9/1/2022,MMR,Pahang,0,0,0,Myanmar
55493,9/1/2022,MMR,Perak,12,5,7,Myanmar
55494,9/1/2022,MMR,Perlis,8,0,8,Myanmar
55495,9/1/2022,MMR,Pulau Pinang,118,50,68,Myanmar
55496,9/1/2022,MMR,Sabah,10,3,7,Myanmar
55497,9/1/2022,MMR,Sarawak,33,11,22,Myanmar
55498,9/1/2022,MMR,Selangor,6809,4840,1969,Myanmar
55499,9/1/2022,MMR,Terengganu,0,0,0,Myanmar
55500,9/1/2022,MMR,W.P. Labuan,0,0,0,Myanmar
55501,9/1/2022,MNE,Johor,0,0,0,Montenegro
55502,9/1/2022,MNE,Kedah,0,0,0,Montenegro
55503,9/1/2022,MNE,Pulau Pinang,0,0,0,Montenegro
55504,9/1/2022,MNE,Sabah,0,0,0,Montenegro
55505,9/1/2022,MNE,Sarawak,2,2,0,Montenegro
55506,9/1/2022,MNE,Selangor,6,5,1,Montenegro
55507,9/1/2022,MNG,Johor,91,42,49,Mongolia
55508,9/1/2022,MNG,Kedah,9,3,6,Mongolia
55509,9/1/2022,MNG,Kelantan,0,0,0,Mongolia
55510,9/1/2022,MNG,Perak,0,0,0,Mongolia
55511,9/1/2022,MNG,Perlis,1,0,1,Mongolia
55512,9/1/2022,MNG,Pulau Pinang,11,6,5,Mongolia
55513,9/1/2022,MNG,Sabah,1,0,1,Mongolia
55514,9/1/2022,MNG,Sarawak,0,0,0,Mongolia
55515,9/1/2022,MNG,Selangor,245,111,134,Mongolia
55516,9/1/2022,MNP,Selangor,0,0,0,Northern Mariana Islands
55517,9/1/2022,MOZ,Johor,2,0,2,Mozambique
55518,9/1/2022,MOZ,Kedah,0,0,0,Mozambique
55519,9/1/2022,MOZ,Perak,0,0,0,Mozambique
55520,9/1/2022,MOZ,Pulau Pinang,0,0,0,Mozambique
55521,9/1/2022,MOZ,Sabah,0,0,0,Mozambique
55522,9/1/2022,MOZ,Sarawak,0,0,0,Mozambique
55523,9/1/2022,MOZ,Selangor,23,16,7,Mozambique
55524,9/1/2022,MRT,Johor,3,1,2,Mauritania
55525,9/1/2022,MRT,Kedah,0,0,0,Mauritania
55526,9/1/2022,MRT,Pulau Pinang,0,0,0,Mauritania
55527,9/1/2022,MRT,Sabah,0,0,0,Mauritania
55528,9/1/2022,MRT,Sarawak,0,0,0,Mauritania
55529,9/1/2022,MRT,Selangor,14,10,4,Mauritania
55530,9/1/2022,MUS,Johor,73,37,36,Mauritius
55531,9/1/2022,MUS,Kedah,4,3,1,Mauritius
55532,9/1/2022,MUS,Kelantan,0,0,0,Mauritius
55533,9/1/2022,MUS,Pahang,0,0,0,Mauritius
55534,9/1/2022,MUS,Perak,0,0,0,Mauritius
55535,9/1/2022,MUS,Perlis,1,0,1,Mauritius
55536,9/1/2022,MUS,Pulau Pinang,8,3,5,Mauritius
55537,9/1/2022,MUS,Sabah,2,1,1,Mauritius
55538,9/1/2022,MUS,Sarawak,0,0,0,Mauritius
55539,9/1/2022,MUS,Selangor,278,135,143,Mauritius
55540,9/1/2022,MWI,Johor,0,0,0,Malawi
55541,9/1/2022,MWI,Pulau Pinang,0,0,0,Malawi
55542,9/1/2022,MWI,Sabah,0,0,0,Malawi
55543,9/1/2022,MWI,Sarawak,0,0,0,Malawi
55544,9/1/2022,MWI,Selangor,17,10,7,Malawi
55545,9/1/2022,MYT,Selangor,0,0,0,Mayotte
55546,9/1/2022,NAM,Johor,7,5,2,Namibia
55547,9/1/2022,NAM,Kedah,0,0,0,Namibia
55548,9/1/2022,NAM,Perak,0,0,0,Namibia
55549,9/1/2022,NAM,Perlis,0,0,0,Namibia
55550,9/1/2022,NAM,Pulau Pinang,1,0,1,Namibia
55551,9/1/2022,NAM,Sabah,0,0,0,Namibia
55552,9/1/2022,NAM,Sarawak,0,0,0,Namibia
55553,9/1/2022,NAM,Selangor,5,0,5,Namibia
55554,9/1/2022,NCL,Selangor,0,0,0,New Caledonia
55555,9/1/2022,NER,Johor,0,0,0,Niger
55556,9/1/2022,NER,Sabah,0,0,0,Niger
55557,9/1/2022,NER,Selangor,4,3,1,Niger
55558,9/1/2022,NGA,Johor,20,18,2,Nigeria
55559,9/1/2022,NGA,Kedah,0,0,0,Nigeria
55560,9/1/2022,NGA,Perlis,0,0,0,Nigeria
55561,9/1/2022,NGA,Pulau Pinang,2,2,0,Nigeria
55562,9/1/2022,NGA,Sabah,0,0,0,Nigeria
55563,9/1/2022,NGA,Sarawak,1,1,0,Nigeria
55564,9/1/2022,NGA,Selangor,329,261,68,Nigeria
55565,9/1/2022,NIC,Johor,2,0,2,Nicaragua
55566,9/1/2022,NIC,Kedah,0,0,0,Nicaragua
55567,9/1/2022,NIC,Pulau Pinang,0,0,0,Nicaragua
55568,9/1/2022,NIC,Sabah,0,0,0,Nicaragua
55569,9/1/2022,NIC,Selangor,6,2,4,Nicaragua
55570,9/1/2022,NLD,Johor,859,543,316,Netherlands
55571,9/1/2022,NLD,Kedah,74,45,29,Netherlands
55572,9/1/2022,NLD,Kelantan,4,4,0,Netherlands
55573,9/1/2022,NLD,Melaka,2,1,1,Netherlands
55574,9/1/2022,NLD,Negeri Sembilan,0,0,0,Netherlands
55575,9/1/2022,NLD,Pahang,1,1,0,Netherlands
55576,9/1/2022,NLD,Perak,3,1,2,Netherlands
55577,9/1/2022,NLD,Perlis,24,15,9,Netherlands
55578,9/1/2022,NLD,Pulau Pinang,149,93,56,Netherlands
55579,9/1/2022,NLD,Sabah,94,51,43,Netherlands
55580,9/1/2022,NLD,Sarawak,116,66,50,Netherlands
55581,9/1/2022,NLD,Selangor,3121,1894,1227,Netherlands
55582,9/1/2022,NLD,Terengganu,0,0,0,Netherlands
55583,9/1/2022,NLD,W.P. Labuan,0,0,0,Netherlands
55584,9/1/2022,NOR,Johor,122,82,40,Norway
55585,9/1/2022,NOR,Kedah,13,9,4,Norway
55586,9/1/2022,NOR,Kelantan,0,0,0,Norway
55587,9/1/2022,NOR,Melaka,0,0,0,Norway
55588,9/1/2022,NOR,Pahang,0,0,0,Norway
55589,9/1/2022,NOR,Perak,2,1,1,Norway
55590,9/1/2022,NOR,Perlis,1,1,0,Norway
55591,9/1/2022,NOR,Pulau Pinang,11,8,3,Norway
55592,9/1/2022,NOR,Sabah,3,3,0,Norway
55593,9/1/2022,NOR,Sarawak,16,14,2,Norway
55594,9/1/2022,NOR,Selangor,372,240,132,Norway
55595,9/1/2022,NOR,W.P. Labuan,1,0,1,Norway
55596,9/1/2022,NPL,Johor,392,327,65,Nepal
55597,9/1/2022,NPL,Kedah,1,0,1,Nepal
55598,9/1/2022,NPL,Pahang,0,0,0,Nepal
55599,9/1/2022,NPL,Perak,0,0,0,Nepal
55600,9/1/2022,NPL,Perlis,0,0,0,Nepal
55601,9/1/2022,NPL,Pulau Pinang,19,13,6,Nepal
55602,9/1/2022,NPL,Sabah,7,4,3,Nepal
55603,9/1/2022,NPL,Sarawak,117,73,44,Nepal
55604,9/1/2022,NPL,Selangor,33400,32030,1370,Nepal
55605,9/1/2022,NPL,W.P. Labuan,91,87,4,Nepal
55606,9/1/2022,NRU,Johor,0,0,0,Nauru
55607,9/1/2022,NRU,Pulau Pinang,0,0,0,Nauru
55608,9/1/2022,NRU,Selangor,0,0,0,Nauru
55609,9/1/2022,NZL,Johor,507,329,178,New Zealand
55610,9/1/2022,NZL,Kedah,56,32,24,New Zealand
55611,9/1/2022,NZL,Kelantan,1,1,0,New Zealand
55612,9/1/2022,NZL,Melaka,0,0,0,New Zealand
55613,9/1/2022,NZL,Negeri Sembilan,1,1,0,New Zealand
55614,9/1/2022,NZL,Pahang,3,3,0,New Zealand
55615,9/1/2022,NZL,Perak,8,6,2,New Zealand
55616,9/1/2022,NZL,Perlis,15,10,5,New Zealand
55617,9/1/2022,NZL,Pulau Pinang,124,72,52,New Zealand
55618,9/1/2022,NZL,Sabah,61,39,22,New Zealand
55619,9/1/2022,NZL,Sarawak,97,47,50,New Zealand
55620,9/1/2022,NZL,Selangor,1737,1110,627,New Zealand
55621,9/1/2022,NZL,Terengganu,0,0,0,New Zealand
55622,9/1/2022,NZL,W.P. Labuan,0,0,0,New Zealand
55623,9/1/2022,OMN,Johor,39,24,15,Oman
55624,9/1/2022,OMN,Kedah,2,2,0,Oman
55625,9/1/2022,OMN,Kelantan,1,1,0,Oman
55626,9/1/2022,OMN,Melaka,0,0,0,Oman
55627,9/1/2022,OMN,Perak,0,0,0,Oman
55628,9/1/2022,OMN,Perlis,0,0,0,Oman
55629,9/1/2022,OMN,Pulau Pinang,5,5,0,Oman
55630,9/1/2022,OMN,Sabah,0,0,0,Oman
55631,9/1/2022,OMN,Sarawak,19,7,12,Oman
55632,9/1/2022,OMN,Selangor,567,356,211,Oman
55633,9/1/2022,PAK,Johor,707,555,152,Pakistan
55634,9/1/2022,PAK,Kedah,79,61,18,Pakistan
55635,9/1/2022,PAK,Kelantan,20,20,0,Pakistan
55636,9/1/2022,PAK,Melaka,0,0,0,Pakistan
55637,9/1/2022,PAK,Negeri Sembilan,1,1,0,Pakistan
55638,9/1/2022,PAK,Pahang,0,0,0,Pakistan
55639,9/1/2022,PAK,Perak,103,103,0,Pakistan
55640,9/1/2022,PAK,Perlis,24,24,0,Pakistan
55641,9/1/2022,PAK,Pulau Pinang,26,23,3,Pakistan
55642,9/1/2022,PAK,Sabah,6,5,1,Pakistan
55643,9/1/2022,PAK,Sarawak,63,52,11,Pakistan
55644,9/1/2022,PAK,Selangor,9103,7961,1142,Pakistan
55645,9/1/2022,PAK,W.P. Labuan,2,2,0,Pakistan
55646,9/1/2022,PAN,Johor,6,3,3,Panama
55647,9/1/2022,PAN,Kedah,0,0,0,Panama
55648,9/1/2022,PAN,Perak,0,0,0,Panama
55649,9/1/2022,PAN,Perlis,1,0,1,Panama
55650,9/1/2022,PAN,Pulau Pinang,0,0,0,Panama
55651,9/1/2022,PAN,Sabah,0,0,0,Panama
55652,9/1/2022,PAN,Sarawak,0,0,0,Panama
55653,9/1/2022,PAN,Selangor,15,6,9,Panama
55654,9/1/2022,PER,Johor,36,25,11,Peru
55655,9/1/2022,PER,Kedah,1,0,1,Peru
55656,9/1/2022,PER,Kelantan,0,0,0,Peru
55657,9/1/2022,PER,Pahang,0,0,0,Peru
55658,9/1/2022,PER,Perak,0,0,0,Peru
55659,9/1/2022,PER,Perlis,3,1,2,Peru
55660,9/1/2022,PER,Pulau Pinang,2,1,1,Peru
55661,9/1/2022,PER,Sabah,2,1,1,Peru
55662,9/1/2022,PER,Sarawak,3,2,1,Peru
55663,9/1/2022,PER,Selangor,69,36,33,Peru
55664,9/1/2022,PER,W.P. Labuan,0,0,0,Peru
55665,9/1/2022,PHL,Johor,14117,4207,9910,Philippines
55666,9/1/2022,PHL,Kedah,275,105,170,Philippines
55667,9/1/2022,PHL,Kelantan,8,6,2,Philippines
55668,9/1/2022,PHL,Melaka,0,0,0,Philippines
55669,9/1/2022,PHL,Negeri Sembilan,0,0,0,Philippines
55670,9/1/2022,PHL,Pahang,9,9,0,Philippines
55671,9/1/2022,PHL,Perak,43,15,28,Philippines
55672,9/1/2022,PHL,Perlis,133,62,71,Philippines
55673,9/1/2022,PHL,Pulau Pinang,320,103,217,Philippines
55674,9/1/2022,PHL,Sabah,1072,534,538,Philippines
55675,9/1/2022,PHL,Sarawak,758,299,459,Philippines
55676,9/1/2022,PHL,Selangor,10486,4141,6345,Philippines
55677,9/1/2022,PHL,Terengganu,0,0,0,Philippines
55678,9/1/2022,PHL,W.P. Labuan,42,11,31,Philippines
55679,9/1/2022,PLW,Johor,4,4,0,Palau
55680,9/1/2022,PLW,Pulau Pinang,0,0,0,Palau
55681,9/1/2022,PLW,Selangor,0,0,0,Palau
55682,9/1/2022,PNG,Johor,8,3,5,Papua New Guinea
55683,9/1/2022,PNG,Kedah,0,0,0,Papua New Guinea
55684,9/1/2022,PNG,Kelantan,0,0,0,Papua New Guinea
55685,9/1/2022,PNG,Perak,0,0,0,Papua New Guinea
55686,9/1/2022,PNG,Pulau Pinang,2,1,1,Papua New Guinea
55687,9/1/2022,PNG,Sabah,1,0,1,Papua New Guinea
55688,9/1/2022,PNG,Sarawak,3,1,2,Papua New Guinea
55689,9/1/2022,PNG,Selangor,36,16,20,Papua New Guinea
55690,9/1/2022,POL,Johor,189,103,86,Poland
55691,9/1/2022,POL,Kedah,19,10,9,Poland
55692,9/1/2022,POL,Kelantan,2,1,1,Poland
55693,9/1/2022,POL,Melaka,0,0,0,Poland
55694,9/1/2022,POL,Negeri Sembilan,0,0,0,Poland
55695,9/1/2022,POL,Pahang,0,0,0,Poland
55696,9/1/2022,POL,Perak,5,4,1,Poland
55697,9/1/2022,POL,Perlis,13,8,5,Poland
55698,9/1/2022,POL,Pulau Pinang,33,22,11,Poland
55699,9/1/2022,POL,Sabah,48,28,20,Poland
55700,9/1/2022,POL,Sarawak,17,9,8,Poland
55701,9/1/2022,POL,Selangor,896,493,403,Poland
55702,9/1/2022,POL,Terengganu,0,0,0,Poland
55703,9/1/2022,POL,W.P. Labuan,0,0,0,Poland
55704,9/1/2022,PRK,Selangor,0,0,0,"Korea, Democratic People's Republic of"
55705,9/1/2022,PRT,Johor,80,47,33,Portugal
55706,9/1/2022,PRT,Kedah,12,5,7,Portugal
55707,9/1/2022,PRT,Kelantan,0,0,0,Portugal
55708,9/1/2022,PRT,Melaka,1,1,0,Portugal
55709,9/1/2022,PRT,Pahang,0,0,0,Portugal
55710,9/1/2022,PRT,Perak,0,0,0,Portugal
55711,9/1/2022,PRT,Perlis,1,1,0,Portugal
55712,9/1/2022,PRT,Pulau Pinang,36,19,17,Portugal
55713,9/1/2022,PRT,Sabah,9,7,2,Portugal
55714,9/1/2022,PRT,Sarawak,4,2,2,Portugal
55715,9/1/2022,PRT,Selangor,445,271,174,Portugal
55716,9/1/2022,PRT,W.P. Labuan,0,0,0,Portugal
55717,9/1/2022,PRY,Johor,0,0,0,Paraguay
55718,9/1/2022,PRY,Kedah,0,0,0,Paraguay
55719,9/1/2022,PRY,Perak,0,0,0,Paraguay
55720,9/1/2022,PRY,Perlis,0,0,0,Paraguay
55721,9/1/2022,PRY,Pulau Pinang,0,0,0,Paraguay
55722,9/1/2022,PRY,Sabah,0,0,0,Paraguay
55723,9/1/2022,PRY,Sarawak,0,0,0,Paraguay
55724,9/1/2022,PRY,Selangor,11,7,4,Paraguay
55725,9/1/2022,PSE,Johor,5,3,2,"Palestinian Territory, Occupied"
55726,9/1/2022,PSE,Kedah,0,0,0,"Palestinian Territory, Occupied"
55727,9/1/2022,PSE,Kelantan,0,0,0,"Palestinian Territory, Occupied"
55728,9/1/2022,PSE,Melaka,0,0,0,"Palestinian Territory, Occupied"
55729,9/1/2022,PSE,Perak,0,0,0,"Palestinian Territory, Occupied"
55730,9/1/2022,PSE,Perlis,0,0,0,"Palestinian Territory, Occupied"
55731,9/1/2022,PSE,Pulau Pinang,1,0,1,"Palestinian Territory, Occupied"
55732,9/1/2022,PSE,Sabah,0,0,0,"Palestinian Territory, Occupied"
55733,9/1/2022,PSE,Sarawak,1,1,0,"Palestinian Territory, Occupied"
55734,9/1/2022,PSE,Selangor,302,212,90,"Palestinian Territory, Occupied"
55735,9/1/2022,QAT,Johor,0,0,0,Qatar
55736,9/1/2022,QAT,Kedah,0,0,0,Qatar
55737,9/1/2022,QAT,Perlis,0,0,0,Qatar
55738,9/1/2022,QAT,Pulau Pinang,0,0,0,Qatar
55739,9/1/2022,QAT,Sabah,0,0,0,Qatar
55740,9/1/2022,QAT,Sarawak,1,1,0,Qatar
55741,9/1/2022,QAT,Selangor,40,28,12,Qatar
55742,9/1/2022,REU,Johor,0,0,0,Reunion
55743,9/1/2022,REU,Sarawak,0,0,0,Reunion
55744,9/1/2022,ROU,Johor,78,48,30,Romania
55745,9/1/2022,ROU,Kedah,6,3,3,Romania
55746,9/1/2022,ROU,Kelantan,0,0,0,Romania
55747,9/1/2022,ROU,Negeri Sembilan,0,0,0,Romania
55748,9/1/2022,ROU,Pahang,0,0,0,Romania
55749,9/1/2022,ROU,Perak,0,0,0,Romania
55750,9/1/2022,ROU,Perlis,0,0,0,Romania
55751,9/1/2022,ROU,Pulau Pinang,13,4,9,Romania
55752,9/1/2022,ROU,Sabah,3,1,2,Romania
55753,9/1/2022,ROU,Sarawak,4,3,1,Romania
55754,9/1/2022,ROU,Selangor,386,226,160,Romania
55755,9/1/2022,ROU,W.P. Labuan,1,1,0,Romania
55756,9/1/2022,RUS,Johor,265,143,122,Russia
55757,9/1/2022,RUS,Kedah,243,122,121,Russia
55758,9/1/2022,RUS,Kelantan,9,6,3,Russia
55759,9/1/2022,RUS,Melaka,0,0,0,Russia
55760,9/1/2022,RUS,Negeri Sembilan,0,0,0,Russia
55761,9/1/2022,RUS,Pahang,1,0,1,Russia
55762,9/1/2022,RUS,Perak,0,0,0,Russia
55763,9/1/2022,RUS,Perlis,94,53,41,Russia
55764,9/1/2022,RUS,Pulau Pinang,95,59,36,Russia
55765,9/1/2022,RUS,Sabah,10,7,3,Russia
55766,9/1/2022,RUS,Sarawak,35,17,18,Russia
55767,9/1/2022,RUS,Selangor,2592,1315,1277,Russia
55768,9/1/2022,RUS,W.P. Labuan,3,2,1,Russia
55769,9/1/2022,RWA,Johor,0,0,0,Rwanda
55770,9/1/2022,RWA,Kedah,0,0,0,Rwanda
55771,9/1/2022,RWA,Pulau Pinang,0,0,0,Rwanda
55772,9/1/2022,RWA,Selangor,3,1,2,Rwanda
55773,9/1/2022,SAU,Johor,99,73,26,Saudi Arabia
55774,9/1/2022,SAU,Kedah,8,5,3,Saudi Arabia
55775,9/1/2022,SAU,Kelantan,9,5,4,Saudi Arabia
55776,9/1/2022,SAU,Melaka,0,0,0,Saudi Arabia
55777,9/1/2022,SAU,Perak,3,1,2,Saudi Arabia
55778,9/1/2022,SAU,Perlis,11,9,2,Saudi Arabia
55779,9/1/2022,SAU,Pulau Pinang,8,6,2,Saudi Arabia
55780,9/1/2022,SAU,Sabah,5,5,0,Saudi Arabia
55781,9/1/2022,SAU,Sarawak,19,17,2,Saudi Arabia
55782,9/1/2022,SAU,Selangor,2463,1446,1017,Saudi Arabia
55783,9/1/2022,SAU,W.P. Labuan,0,0,0,Saudi Arabia
55784,9/1/2022,SDN,Johor,4,2,2,Sudan
55785,9/1/2022,SDN,Kedah,0,0,0,Sudan
55786,9/1/2022,SDN,Kelantan,0,0,0,Sudan
55787,9/1/2022,SDN,Perlis,0,0,0,Sudan
55788,9/1/2022,SDN,Pulau Pinang,0,0,0,Sudan
55789,9/1/2022,SDN,Sabah,0,0,0,Sudan
55790,9/1/2022,SDN,Sarawak,10,5,5,Sudan
55791,9/1/2022,SDN,Selangor,860,522,338,Sudan
55792,9/1/2022,SDN,W.P. Labuan,0,0,0,Sudan
55793,9/1/2022,SEN,Johor,0,0,0,Senegal
55794,9/1/2022,SEN,Kedah,0,0,0,Senegal
55795,9/1/2022,SEN,Kelantan,0,0,0,Senegal
55796,9/1/2022,SEN,Perak,0,0,0,Senegal
55797,9/1/2022,SEN,Perlis,0,0,0,Senegal
55798,9/1/2022,SEN,Pulau Pinang,3,0,3,Senegal
55799,9/1/2022,SEN,Sabah,0,0,0,Senegal
55800,9/1/2022,SEN,Sarawak,0,0,0,Senegal
55801,9/1/2022,SEN,Selangor,25,18,7,Senegal
55802,9/1/2022,SGP,Johor,1006646,580516,426130,Singapore
55803,9/1/2022,SGP,Kedah,3140,1642,1498,Singapore
55804,9/1/2022,SGP,Kelantan,90,55,35,Singapore
55805,9/1/2022,SGP,Melaka,19,11,8,Singapore
55806,9/1/2022,SGP,Negeri Sembilan,1,1,0,Singapore
55807,9/1/2022,SGP,Pahang,100,70,30,Singapore
55808,9/1/2022,SGP,Perak,4322,1981,2341,Singapore
55809,9/1/2022,SGP,Perlis,249,173,76,Singapore
55810,9/1/2022,SGP,Pulau Pinang,13498,6674,6824,Singapore
55811,9/1/2022,SGP,Sabah,3429,1767,1662,Singapore
55812,9/1/2022,SGP,Sarawak,3149,1807,1342,Singapore
55813,9/1/2022,SGP,Selangor,32490,17331,15159,Singapore
55814,9/1/2022,SGP,Terengganu,2,2,0,Singapore
55815,9/1/2022,SGP,W.P. Labuan,2,2,0,Singapore
55816,9/1/2022,SGS,Johor,0,0,0,South Georgia and the South Sandwich Islands
55817,9/1/2022,SGS,Sabah,0,0,0,South Georgia and the South Sandwich Islands
55818,9/1/2022,SGS,Selangor,0,0,0,South Georgia and the South Sandwich Islands
55819,9/1/2022,SHN,Sarawak,0,0,0,"Saint Helena, Ascension and Tristan da Cunha"
55820,9/1/2022,SLB,Johor,0,0,0,Solomon Islands
55821,9/1/2022,SLB,Perlis,0,0,0,Solomon Islands
55822,9/1/2022,SLB,Pulau Pinang,0,0,0,Solomon Islands
55823,9/1/2022,SLB,Sabah,0,0,0,Solomon Islands
55824,9/1/2022,SLB,Sarawak,0,0,0,Solomon Islands
55825,9/1/2022,SLB,Selangor,4,4,0,Solomon Islands
55826,9/1/2022,SLB,W.P. Labuan,0,0,0,Solomon Islands
55827,9/1/2022,SLE,Johor,0,0,0,Sierra Leone
55828,9/1/2022,SLE,Kedah,0,0,0,Sierra Leone
55829,9/1/2022,SLE,Perak,0,0,0,Sierra Leone
55830,9/1/2022,SLE,Pulau Pinang,0,0,0,Sierra Leone
55831,9/1/2022,SLE,Sabah,0,0,0,Sierra Leone
55832,9/1/2022,SLE,Selangor,7,5,2,Sierra Leone
55833,9/1/2022,SLV,Johor,1,1,0,El Salvador
55834,9/1/2022,SLV,Kedah,0,0,0,El Salvador
55835,9/1/2022,SLV,Perak,0,0,0,El Salvador
55836,9/1/2022,SLV,Perlis,0,0,0,El Salvador
55837,9/1/2022,SLV,Pulau Pinang,0,0,0,El Salvador
55838,9/1/2022,SLV,Sabah,0,0,0,El Salvador
55839,9/1/2022,SLV,Selangor,6,4,2,El Salvador
55840,9/1/2022,SLV,W.P. Labuan,0,0,0,El Salvador
55841,9/1/2022,SMR,Johor,0,0,0,San Marino
55842,9/1/2022,SMR,Selangor,0,0,0,San Marino
55843,9/1/2022,SOM,Johor,0,0,0,Somalia
55844,9/1/2022,SOM,Kedah,0,0,0,Somalia
55845,9/1/2022,SOM,Kelantan,0,0,0,Somalia
55846,9/1/2022,SOM,Perlis,0,0,0,Somalia
55847,9/1/2022,SOM,Sabah,0,0,0,Somalia
55848,9/1/2022,SOM,Sarawak,0,0,0,Somalia
55849,9/1/2022,SOM,Selangor,235,148,87,Somalia
55850,9/1/2022,SRB,Johor,5,3,2,Serbia
55851,9/1/2022,SRB,Kedah,1,1,0,Serbia
55852,9/1/2022,SRB,Kelantan,0,0,0,Serbia
55853,9/1/2022,SRB,Pahang,0,0,0,Serbia
55854,9/1/2022,SRB,Perak,0,0,0,Serbia
55855,9/1/2022,SRB,Perlis,0,0,0,Serbia
55856,9/1/2022,SRB,Pulau Pinang,13,13,0,Serbia
55857,9/1/2022,SRB,Sabah,1,1,0,Serbia
55858,9/1/2022,SRB,Sarawak,0,0,0,Serbia
55859,9/1/2022,SRB,Selangor,42,25,17,Serbia
55860,9/1/2022,STP,Selangor,1,1,0,Sao Tome and Principe
55861,9/1/2022,SUR,Johor,4,3,1,Suriname
55862,9/1/2022,SUR,Kedah,0,0,0,Suriname
55863,9/1/2022,SUR,Kelantan,0,0,0,Suriname
55864,9/1/2022,SUR,Perak,0,0,0,Suriname
55865,9/1/2022,SUR,Perlis,0,0,0,Suriname
55866,9/1/2022,SUR,Pulau Pinang,0,0,0,Suriname
55867,9/1/2022,SUR,Sabah,0,0,0,Suriname
55868,9/1/2022,SUR,Sarawak,0,0,0,Suriname
55869,9/1/2022,SUR,Selangor,4,3,1,Suriname
55870,9/1/2022,SVK,Johor,37,21,16,Slovakia
55871,9/1/2022,SVK,Kedah,2,1,1,Slovakia
55872,9/1/2022,SVK,Kelantan,1,0,1,Slovakia
55873,9/1/2022,SVK,Negeri Sembilan,0,0,0,Slovakia
55874,9/1/2022,SVK,Pahang,0,0,0,Slovakia
55875,9/1/2022,SVK,Perak,0,0,0,Slovakia
55876,9/1/2022,SVK,Perlis,0,0,0,Slovakia
55877,9/1/2022,SVK,Pulau Pinang,12,7,5,Slovakia
55878,9/1/2022,SVK,Sabah,7,5,2,Slovakia
55879,9/1/2022,SVK,Sarawak,0,0,0,Slovakia
55880,9/1/2022,SVK,Selangor,149,85,64,Slovakia
55881,9/1/2022,SVK,W.P. Labuan,0,0,0,Slovakia
55882,9/1/2022,SVN,Johor,12,8,4,Slovenia
55883,9/1/2022,SVN,Kedah,1,0,1,Slovenia
55884,9/1/2022,SVN,Kelantan,0,0,0,Slovenia
55885,9/1/2022,SVN,Perak,0,0,0,Slovenia
55886,9/1/2022,SVN,Perlis,0,0,0,Slovenia
55887,9/1/2022,SVN,Pulau Pinang,2,2,0,Slovenia
55888,9/1/2022,SVN,Sabah,0,0,0,Slovenia
55889,9/1/2022,SVN,Sarawak,1,0,1,Slovenia
55890,9/1/2022,SVN,Selangor,54,31,23,Slovenia
55891,9/1/2022,SVN,W.P. Labuan,0,0,0,Slovenia
55892,9/1/2022,SWE,Johor,249,168,81,Sweden
55893,9/1/2022,SWE,Kedah,19,12,7,Sweden
55894,9/1/2022,SWE,Kelantan,0,0,0,Sweden
55895,9/1/2022,SWE,Melaka,1,1,0,Sweden
55896,9/1/2022,SWE,Negeri Sembilan,0,0,0,Sweden
55897,9/1/2022,SWE,Pahang,0,0,0,Sweden
55898,9/1/2022,SWE,Perak,4,4,0,Sweden
55899,9/1/2022,SWE,Perlis,2,1,1,Sweden
55900,9/1/2022,SWE,Pulau Pinang,50,43,7,Sweden
55901,9/1/2022,SWE,Sabah,17,11,6,Sweden
55902,9/1/2022,SWE,Sarawak,7,6,1,Sweden
55903,9/1/2022,SWE,Selangor,669,429,240,Sweden
55904,9/1/2022,SWE,W.P. Labuan,0,0,0,Sweden
55905,9/1/2022,SWZ,Johor,0,0,0,Swaziland
55906,9/1/2022,SWZ,Kedah,0,0,0,Swaziland
55907,9/1/2022,SWZ,Pulau Pinang,0,0,0,Swaziland
55908,9/1/2022,SWZ,Sabah,0,0,0,Swaziland
55909,9/1/2022,SWZ,Selangor,10,5,5,Swaziland
55910,9/1/2022,SYC,Johor,3,1,2,Seychelles
55911,9/1/2022,SYC,Kedah,0,0,0,Seychelles
55912,9/1/2022,SYC,Pulau Pinang,0,0,0,Seychelles
55913,9/1/2022,SYC,Sabah,0,0,0,Seychelles
55914,9/1/2022,SYC,Sarawak,1,1,0,Seychelles
55915,9/1/2022,SYC,Selangor,62,29,33,Seychelles
55916,9/1/2022,SYR,Johor,7,1,6,Syrian Arab Republic
55917,9/1/2022,SYR,Kedah,0,0,0,Syrian Arab Republic
55918,9/1/2022,SYR,Kelantan,0,0,0,Syrian Arab Republic
55919,9/1/2022,SYR,Pahang,0,0,0,Syrian Arab Republic
55920,9/1/2022,SYR,Perlis,0,0,0,Syrian Arab Republic
55921,9/1/2022,SYR,Pulau Pinang,1,1,0,Syrian Arab Republic
55922,9/1/2022,SYR,Sabah,0,0,0,Syrian Arab Republic
55923,9/1/2022,SYR,Sarawak,2,1,1,Syrian Arab Republic
55924,9/1/2022,SYR,Selangor,713,438,275,Syrian Arab Republic
55925,9/1/2022,SYR,W.P. Labuan,0,0,0,Syrian Arab Republic
55926,9/1/2022,TCA,Perlis,0,0,0,Turks and Caicos
55927,9/1/2022,TCD,Johor,0,0,0,Chad
55928,9/1/2022,TCD,Kedah,0,0,0,Chad
55929,9/1/2022,TCD,Perlis,0,0,0,Chad
55930,9/1/2022,TCD,Selangor,13,10,3,Chad
55931,9/1/2022,TGO,Johor,1,0,1,Togo
55932,9/1/2022,TGO,Perak,0,0,0,Togo
55933,9/1/2022,TGO,Pulau Pinang,0,0,0,Togo
55934,9/1/2022,TGO,Selangor,8,7,1,Togo
55935,9/1/2022,THA,Johor,4153,947,3206,Thailand
55936,9/1/2022,THA,Kedah,43887,26352,17535,Thailand
55937,9/1/2022,THA,Kelantan,29055,14833,14222,Thailand
55938,9/1/2022,THA,Melaka,2,2,0,Thailand
55939,9/1/2022,THA,Negeri Sembilan,2,1,1,Thailand
55940,9/1/2022,THA,Pahang,38,34,4,Thailand
55941,9/1/2022,THA,Perak,3393,1609,1784,Thailand
55942,9/1/2022,THA,Perlis,45337,27498,17839,Thailand
55943,9/1/2022,THA,Pulau Pinang,1580,675,905,Thailand
55944,9/1/2022,THA,Sabah,135,45,90,Thailand
55945,9/1/2022,THA,Sarawak,161,58,103,Thailand
55946,9/1/2022,THA,Selangor,8635,3579,5056,Thailand
55947,9/1/2022,THA,Terengganu,3,3,0,Thailand
55948,9/1/2022,THA,W.P. Labuan,1,0,1,Thailand
55949,9/1/2022,TJK,Johor,1,0,1,Tajikistan
55950,9/1/2022,TJK,Kedah,1,1,0,Tajikistan
55951,9/1/2022,TJK,Perlis,1,1,0,Tajikistan
55952,9/1/2022,TJK,Pulau Pinang,0,0,0,Tajikistan
55953,9/1/2022,TJK,Sabah,0,0,0,Tajikistan
55954,9/1/2022,TJK,Selangor,153,118,35,Tajikistan
55955,9/1/2022,TKL,Selangor,0,0,0,Tokelau
55956,9/1/2022,TKM,Johor,3,1,2,Turkmenistan
55957,9/1/2022,TKM,Kedah,0,0,0,Turkmenistan
55958,9/1/2022,TKM,Kelantan,0,0,0,Turkmenistan
55959,9/1/2022,TKM,Perlis,0,0,0,Turkmenistan
55960,9/1/2022,TKM,Pulau Pinang,0,0,0,Turkmenistan
55961,9/1/2022,TKM,Sabah,0,0,0,Turkmenistan
55962,9/1/2022,TKM,Sarawak,0,0,0,Turkmenistan
55963,9/1/2022,TKM,Selangor,60,34,26,Turkmenistan
55964,9/1/2022,TLS,Johor,26,23,3,Timor-Leste
55965,9/1/2022,TLS,Kedah,0,0,0,Timor-Leste
55966,9/1/2022,TLS,Perlis,0,0,0,Timor-Leste
55967,9/1/2022,TLS,Pulau Pinang,8,6,2,Timor-Leste
55968,9/1/2022,TLS,Sabah,0,0,0,Timor-Leste
55969,9/1/2022,TLS,Sarawak,0,0,0,Timor-Leste
55970,9/1/2022,TLS,Selangor,193,118,75,Timor-Leste
55971,9/1/2022,TON,Johor,0,0,0,Tonga
55972,9/1/2022,TON,Pulau Pinang,1,1,0,Tonga
55973,9/1/2022,TON,Sarawak,0,0,0,Tonga
55974,9/1/2022,TON,Selangor,13,7,6,Tonga
55975,9/1/2022,TTO,Johor,1,1,0,Trinidad and Tobago
55976,9/1/2022,TTO,Kedah,0,0,0,Trinidad and Tobago
55977,9/1/2022,TTO,Pahang,0,0,0,Trinidad and Tobago
55978,9/1/2022,TTO,Pulau Pinang,1,1,0,Trinidad and Tobago
55979,9/1/2022,TTO,Sabah,0,0,0,Trinidad and Tobago
55980,9/1/2022,TTO,Sarawak,1,0,1,Trinidad and Tobago
55981,9/1/2022,TTO,Selangor,13,7,6,Trinidad and Tobago
55982,9/1/2022,TUN,Johor,8,4,4,Tunisia
55983,9/1/2022,TUN,Kedah,1,1,0,Tunisia
55984,9/1/2022,TUN,Kelantan,0,0,0,Tunisia
55985,9/1/2022,TUN,Melaka,0,0,0,Tunisia
55986,9/1/2022,TUN,Perak,0,0,0,Tunisia
55987,9/1/2022,TUN,Perlis,0,0,0,Tunisia
55988,9/1/2022,TUN,Pulau Pinang,5,5,0,Tunisia
55989,9/1/2022,TUN,Sabah,0,0,0,Tunisia
55990,9/1/2022,TUN,Sarawak,1,0,1,Tunisia
55991,9/1/2022,TUN,Selangor,530,276,254,Tunisia
55992,9/1/2022,TUN,W.P. Labuan,0,0,0,Tunisia
55993,9/1/2022,TUR,Johor,159,119,40,Turkey
55994,9/1/2022,TUR,Kedah,16,11,5,Turkey
55995,9/1/2022,TUR,Kelantan,2,2,0,Turkey
55996,9/1/2022,TUR,Melaka,0,0,0,Turkey
55997,9/1/2022,TUR,Negeri Sembilan,2,1,1,Turkey
55998,9/1/2022,TUR,Pahang,0,0,0,Turkey
55999,9/1/2022,TUR,Perak,0,0,0,Turkey
56000,9/1/2022,TUR,Perlis,15,13,2,Turkey
56001,9/1/2022,TUR,Pulau Pinang,22,16,6,Turkey
56002,9/1/2022,TUR,Sabah,3,2,1,Turkey
56003,9/1/2022,TUR,Sarawak,11,8,3,Turkey
56004,9/1/2022,TUR,Selangor,737,517,220,Turkey
56005,9/1/2022,TUR,W.P. Labuan,0,0,0,Turkey
56006,9/1/2022,TUV,Selangor,0,0,0,Tuvalu
56007,9/1/2022,TWN,Johor,2649,1117,1532,Taiwan
56008,9/1/2022,TWN,Kedah,53,25,28,Taiwan
56009,9/1/2022,TWN,Kelantan,0,0,0,Taiwan
56010,9/1/2022,TWN,Melaka,0,0,0,Taiwan
56011,9/1/2022,TWN,Negeri Sembilan,1,0,1,Taiwan
56012,9/1/2022,TWN,Pahang,0,0,0,Taiwan
56013,9/1/2022,TWN,Perak,37,19,18,Taiwan
56014,9/1/2022,TWN,Perlis,13,7,6,Taiwan
56015,9/1/2022,TWN,Pulau Pinang,599,341,258,Taiwan
56016,9/1/2022,TWN,Sabah,74,40,34,Taiwan
56017,9/1/2022,TWN,Sarawak,123,65,58,Taiwan
56018,9/1/2022,TWN,Selangor,5370,2555,2815,Taiwan
56019,9/1/2022,TWN,W.P. Labuan,0,0,0,Taiwan
56020,9/1/2022,TZA,Johor,7,2,5,"Tanzania, United Republic of"
56021,9/1/2022,TZA,Kedah,0,0,0,"Tanzania, United Republic of"
56022,9/1/2022,TZA,Perak,0,0,0,"Tanzania, United Republic of"
56023,9/1/2022,TZA,Perlis,0,0,0,"Tanzania, United Republic of"
56024,9/1/2022,TZA,Pulau Pinang,0,0,0,"Tanzania, United Republic of"
56025,9/1/2022,TZA,Sabah,0,0,0,"Tanzania, United Republic of"
56026,9/1/2022,TZA,Sarawak,0,0,0,"Tanzania, United Republic of"
56027,9/1/2022,TZA,Selangor,143,85,58,"Tanzania, United Republic of"
56028,9/1/2022,UGA,Johor,3,1,2,Uganda
56029,9/1/2022,UGA,Kedah,0,0,0,Uganda
56030,9/1/2022,UGA,Perak,0,0,0,Uganda
56031,9/1/2022,UGA,Perlis,0,0,0,Uganda
56032,9/1/2022,UGA,Pulau Pinang,1,0,1,Uganda
56033,9/1/2022,UGA,Sabah,0,0,0,Uganda
56034,9/1/2022,UGA,Sarawak,0,0,0,Uganda
56035,9/1/2022,UGA,Selangor,62,33,29,Uganda
56036,9/1/2022,UKR,Johor,71,37,34,Ukraine
56037,9/1/2022,UKR,Kedah,27,15,12,Ukraine
56038,9/1/2022,UKR,Kelantan,1,0,1,Ukraine
56039,9/1/2022,UKR,Melaka,0,0,0,Ukraine
56040,9/1/2022,UKR,Negeri Sembilan,0,0,0,Ukraine
56041,9/1/2022,UKR,Pahang,2,2,0,Ukraine
56042,9/1/2022,UKR,Perak,0,0,0,Ukraine
56043,9/1/2022,UKR,Perlis,11,7,4,Ukraine
56044,9/1/2022,UKR,Pulau Pinang,30,11,19,Ukraine
56045,9/1/2022,UKR,Sabah,2,1,1,Ukraine
56046,9/1/2022,UKR,Sarawak,3,3,0,Ukraine
56047,9/1/2022,UKR,Selangor,485,260,225,Ukraine
56048,9/1/2022,UKR,W.P. Labuan,0,0,0,Ukraine
56049,9/1/2022,URY,Johor,7,3,4,Uruguay
56050,9/1/2022,URY,Kedah,0,0,0,Uruguay
56051,9/1/2022,URY,Kelantan,0,0,0,Uruguay
56052,9/1/2022,URY,Perak,0,0,0,Uruguay
56053,9/1/2022,URY,Perlis,0,0,0,Uruguay
56054,9/1/2022,URY,Pulau Pinang,0,0,0,Uruguay
56055,9/1/2022,URY,Sabah,0,0,0,Uruguay
56056,9/1/2022,URY,Sarawak,0,0,0,Uruguay
56057,9/1/2022,URY,Selangor,13,7,6,Uruguay
56058,9/1/2022,URY,W.P. Labuan,0,0,0,Uruguay
56059,9/1/2022,USA,Johor,2801,1763,1038,United States Of America
56060,9/1/2022,USA,Kedah,224,122,102,United States Of America
56061,9/1/2022,USA,Kelantan,4,1,3,United States Of America
56062,9/1/2022,USA,Melaka,3,1,2,United States Of America
56063,9/1/2022,USA,Negeri Sembilan,0,0,0,United States Of America
56064,9/1/2022,USA,Pahang,8,4,4,United States Of America
56065,9/1/2022,USA,Perak,61,37,24,United States Of America
56066,9/1/2022,USA,Perlis,55,44,11,United States Of America
56067,9/1/2022,USA,Pulau Pinang,1243,814,429,United States Of America
56068,9/1/2022,USA,Sabah,253,156,97,United States Of America
56069,9/1/2022,USA,Sarawak,229,134,95,United States Of America
56070,9/1/2022,USA,Selangor,8891,5502,3389,United States Of America
56071,9/1/2022,USA,Terengganu,0,0,0,United States Of America
56072,9/1/2022,USA,W.P. Labuan,6,3,3,United States Of America
56073,9/1/2022,UZB,Johor,63,32,31,Uzbekistan
56074,9/1/2022,UZB,Kedah,5,3,2,Uzbekistan
56075,9/1/2022,UZB,Kelantan,0,0,0,Uzbekistan
56076,9/1/2022,UZB,Perak,0,0,0,Uzbekistan
56077,9/1/2022,UZB,Perlis,1,1,0,Uzbekistan
56078,9/1/2022,UZB,Pulau Pinang,10,6,4,Uzbekistan
56079,9/1/2022,UZB,Sabah,30,28,2,Uzbekistan
56080,9/1/2022,UZB,Sarawak,0,0,0,Uzbekistan
56081,9/1/2022,UZB,Selangor,700,440,260,Uzbekistan
56082,9/1/2022,VAT,Johor,0,0,0,Holy See (Vatican City State)
56083,9/1/2022,VAT,Sarawak,0,0,0,Holy See (Vatican City State)
56084,9/1/2022,VAT,Selangor,2,2,0,Holy See (Vatican City State)
56085,9/1/2022,VCT,Johor,1,1,0,Saint Vincent and the Grenadines
56086,9/1/2022,VCT,Kedah,0,0,0,Saint Vincent and the Grenadines
56087,9/1/2022,VCT,Pulau Pinang,0,0,0,Saint Vincent and the Grenadines
56088,9/1/2022,VCT,Sarawak,0,0,0,Saint Vincent and the Grenadines
56089,9/1/2022,VCT,Selangor,0,0,0,Saint Vincent and the Grenadines
56090,9/1/2022,VEN,Johor,8,6,2,Venezuela
56091,9/1/2022,VEN,Kedah,1,0,1,Venezuela
56092,9/1/2022,VEN,Kelantan,0,0,0,Venezuela
56093,9/1/2022,VEN,Melaka,0,0,0,Venezuela
56094,9/1/2022,VEN,Perak,0,0,0,Venezuela
56095,9/1/2022,VEN,Perlis,0,0,0,Venezuela
56096,9/1/2022,VEN,Pulau Pinang,3,2,1,Venezuela
56097,9/1/2022,VEN,Sabah,3,1,2,Venezuela
56098,9/1/2022,VEN,Sarawak,5,2,3,Venezuela
56099,9/1/2022,VEN,Selangor,40,27,13,Venezuela
56100,9/1/2022,VEN,W.P. Labuan,0,0,0,Venezuela
56101,9/1/2022,VNM,Johor,12050,3771,8279,Vietnam
56102,9/1/2022,VNM,Kedah,173,24,149,Vietnam
56103,9/1/2022,VNM,Kelantan,7,6,1,Vietnam
56104,9/1/2022,VNM,Melaka,0,0,0,Vietnam
56105,9/1/2022,VNM,Negeri Sembilan,0,0,0,Vietnam
56106,9/1/2022,VNM,Pahang,0,0,0,Vietnam
56107,9/1/2022,VNM,Perak,77,2,75,Vietnam
56108,9/1/2022,VNM,Perlis,190,21,169,Vietnam
56109,9/1/2022,VNM,Pulau Pinang,1174,386,788,Vietnam
56110,9/1/2022,VNM,Sabah,20,6,14,Vietnam
56111,9/1/2022,VNM,Sarawak,90,19,71,Vietnam
56112,9/1/2022,VNM,Selangor,12531,4317,8214,Vietnam
56113,9/1/2022,VNM,Terengganu,1,1,0,Vietnam
56114,9/1/2022,VNM,W.P. Labuan,0,0,0,Vietnam
56115,9/1/2022,VUT,Johor,15,12,3,Vanuatu
56116,9/1/2022,VUT,Kedah,0,0,0,Vanuatu
56117,9/1/2022,VUT,Pulau Pinang,3,3,0,Vanuatu
56118,9/1/2022,VUT,Sabah,1,1,0,Vanuatu
56119,9/1/2022,VUT,Sarawak,0,0,0,Vanuatu
56120,9/1/2022,VUT,Selangor,46,35,11,Vanuatu
56121,9/1/2022,WSM,Johor,0,0,0,Samoa
56122,9/1/2022,WSM,Sarawak,0,0,0,Samoa
56123,9/1/2022,WSM,Selangor,7,5,2,Samoa
56124,9/1/2022,YEM,Johor,40,28,12,Yemen
56125,9/1/2022,YEM,Kedah,4,3,1,Yemen
56126,9/1/2022,YEM,Kelantan,0,0,0,Yemen
56127,9/1/2022,YEM,Melaka,0,0,0,Yemen
56128,9/1/2022,YEM,Pahang,0,0,0,Yemen
56129,9/1/2022,YEM,Perak,0,0,0,Yemen
56130,9/1/2022,YEM,Perlis,5,4,1,Yemen
56131,9/1/2022,YEM,Pulau Pinang,1,1,0,Yemen
56132,9/1/2022,YEM,Sabah,1,1,0,Yemen
56133,9/1/2022,YEM,Sarawak,7,5,2,Yemen
56134,9/1/2022,YEM,Selangor,1251,874,377,Yemen
56135,9/1/2022,YEM,W.P. Labuan,0,0,0,Yemen
56136,9/1/2022,ZAF,Johor,171,116,55,South Africa
56137,9/1/2022,ZAF,Kedah,14,9,5,South Africa
56138,9/1/2022,ZAF,Kelantan,0,0,0,South Africa
56139,9/1/2022,ZAF,Melaka,1,1,0,South Africa
56140,9/1/2022,ZAF,Pahang,0,0,0,South Africa
56141,9/1/2022,ZAF,Perak,1,1,0,South Africa
56142,9/1/2022,ZAF,Perlis,6,4,2,South Africa
56143,9/1/2022,ZAF,Pulau Pinang,44,24,20,South Africa
56144,9/1/2022,ZAF,Sabah,17,6,11,South Africa
56145,9/1/2022,ZAF,Sarawak,80,36,44,South Africa
56146,9/1/2022,ZAF,Selangor,614,359,255,South Africa
56147,9/1/2022,ZAF,Terengganu,0,0,0,South Africa
56148,9/1/2022,ZAF,W.P. Labuan,22,10,12,South Africa
56149,9/1/2022,ZMB,Johor,3,3,0,Zambia
56150,9/1/2022,ZMB,Kedah,0,0,0,Zambia
56151,9/1/2022,ZMB,Perak,0,0,0,Zambia
56152,9/1/2022,ZMB,Perlis,0,0,0,Zambia
56153,9/1/2022,ZMB,Pulau Pinang,0,0,0,Zambia
56154,9/1/2022,ZMB,Sabah,0,0,0,Zambia
56155,9/1/2022,ZMB,Sarawak,0,0,0,Zambia
56156,9/1/2022,ZMB,Selangor,73,47,26,Zambia
56157,9/1/2022,ZWE,Johor,6,3,3,Zimbabwe
56158,9/1/2022,ZWE,Kedah,0,0,0,Zimbabwe
56159,9/1/2022,ZWE,Kelantan,0,0,0,Zimbabwe
56160,9/1/2022,ZWE,Perak,0,0,0,Zimbabwe
56161,9/1/2022,ZWE,Perlis,0,0,0,Zimbabwe
56162,9/1/2022,ZWE,Pulau Pinang,1,1,0,Zimbabwe
56163,9/1/2022,ZWE,Sabah,1,0,1,Zimbabwe
56164,9/1/2022,ZWE,Sarawak,2,0,2,Zimbabwe
56165,9/1/2022,ZWE,Selangor,87,48,39,Zimbabwe
56166,10/1/2022,ABW,Kedah,0,0,0,Aruba
56167,10/1/2022,ABW,Pulau Pinang,0,0,0,Aruba
56168,10/1/2022,AFG,Johor,0,0,0,Afghanistan
56169,10/1/2022,AFG,Kedah,0,0,0,Afghanistan
56170,10/1/2022,AFG,Perlis,0,0,0,Afghanistan
56171,10/1/2022,AFG,Pulau Pinang,0,0,0,Afghanistan
56172,10/1/2022,AFG,Sarawak,0,0,0,Afghanistan
56173,10/1/2022,AFG,Selangor,48,31,17,Afghanistan
56174,10/1/2022,AGO,Johor,0,0,0,Angola
56175,10/1/2022,AGO,Kedah,1,0,1,Angola
56176,10/1/2022,AGO,Sabah,0,0,0,Angola
56177,10/1/2022,AGO,Selangor,5,5,0,Angola
56178,10/1/2022,AIA,Selangor,0,0,0,Anguilla
56179,10/1/2022,ALB,Johor,24,18,6,Albania
56180,10/1/2022,ALB,Kedah,1,1,0,Albania
56181,10/1/2022,ALB,Perak,0,0,0,Albania
56182,10/1/2022,ALB,Perlis,0,0,0,Albania
56183,10/1/2022,ALB,Pulau Pinang,1,0,1,Albania
56184,10/1/2022,ALB,Sabah,0,0,0,Albania
56185,10/1/2022,ALB,Sarawak,0,0,0,Albania
56186,10/1/2022,ALB,Selangor,38,28,10,Albania
56187,10/1/2022,AND,Johor,0,0,0,Andorra
56188,10/1/2022,AND,Kedah,0,0,0,Andorra
56189,10/1/2022,AND,Perlis,0,0,0,Andorra
56190,10/1/2022,AND,Pulau Pinang,0,0,0,Andorra
56191,10/1/2022,AND,Selangor,6,3,3,Andorra
56192,10/1/2022,ANT,Selangor,0,0,0,Netherlands Antilles
56193,10/1/2022,ARE,Johor,40,28,12,United Arab Emirates
56194,10/1/2022,ARE,Kedah,0,0,0,United Arab Emirates
56195,10/1/2022,ARE,Kelantan,0,0,0,United Arab Emirates
56196,10/1/2022,ARE,Perak,1,0,1,United Arab Emirates
56197,10/1/2022,ARE,Perlis,2,2,0,United Arab Emirates
56198,10/1/2022,ARE,Pulau Pinang,2,1,1,United Arab Emirates
56199,10/1/2022,ARE,Sabah,0,0,0,United Arab Emirates
56200,10/1/2022,ARE,Sarawak,0,0,0,United Arab Emirates
56201,10/1/2022,ARE,Selangor,311,228,83,United Arab Emirates
56202,10/1/2022,ARG,Johor,61,32,29,Argentina
56203,10/1/2022,ARG,Kedah,17,11,6,Argentina
56204,10/1/2022,ARG,Kelantan,0,0,0,Argentina
56205,10/1/2022,ARG,Melaka,0,0,0,Argentina
56206,10/1/2022,ARG,Perak,2,1,1,Argentina
56207,10/1/2022,ARG,Perlis,3,2,1,Argentina
56208,10/1/2022,ARG,Pulau Pinang,12,6,6,Argentina
56209,10/1/2022,ARG,Sabah,2,1,1,Argentina
56210,10/1/2022,ARG,Sarawak,2,1,1,Argentina
56211,10/1/2022,ARG,Selangor,282,157,125,Argentina
56212,10/1/2022,ARG,W.P. Labuan,0,0,0,Argentina
56213,10/1/2022,ARM,Johor,6,5,1,Armenia
56214,10/1/2022,ARM,Kedah,6,4,2,Armenia
56215,10/1/2022,ARM,Kelantan,0,0,0,Armenia
56216,10/1/2022,ARM,Perak,0,0,0,Armenia
56217,10/1/2022,ARM,Perlis,0,0,0,Armenia
56218,10/1/2022,ARM,Pulau Pinang,3,3,0,Armenia
56219,10/1/2022,ARM,Sabah,0,0,0,Armenia
56220,10/1/2022,ARM,Sarawak,0,0,0,Armenia
56221,10/1/2022,ARM,Selangor,19,9,10,Armenia
56222,10/1/2022,ATA,Selangor,0,0,0,Antarctica
56223,10/1/2022,ATG,Johor,7,3,4,Antigua and Barbuda
56224,10/1/2022,ATG,Kedah,0,0,0,Antigua and Barbuda
56225,10/1/2022,ATG,Pulau Pinang,1,0,1,Antigua and Barbuda
56226,10/1/2022,ATG,Sarawak,0,0,0,Antigua and Barbuda
56227,10/1/2022,ATG,Selangor,23,15,8,Antigua and Barbuda
56228,10/1/2022,AUS,Johor,4493,2669,1824,Australia
56229,10/1/2022,AUS,Kedah,445,244,201,Australia
56230,10/1/2022,AUS,Kelantan,2,2,0,Australia
56231,10/1/2022,AUS,Melaka,1,1,0,Australia
56232,10/1/2022,AUS,Negeri Sembilan,0,0,0,Australia
56233,10/1/2022,AUS,Pahang,2,2,0,Australia
56234,10/1/2022,AUS,Perak,196,100,96,Australia
56235,10/1/2022,AUS,Perlis,51,37,14,Australia
56236,10/1/2022,AUS,Pulau Pinang,1343,763,580,Australia
56237,10/1/2022,AUS,Sabah,424,233,191,Australia
56238,10/1/2022,AUS,Sarawak,470,252,218,Australia
56239,10/1/2022,AUS,Selangor,16736,10152,6584,Australia
56240,10/1/2022,AUS,Terengganu,0,0,0,Australia
56241,10/1/2022,AUS,W.P. Labuan,6,5,1,Australia
56242,10/1/2022,AUT,Johor,153,117,36,Austria
56243,10/1/2022,AUT,Kedah,13,9,4,Austria
56244,10/1/2022,AUT,Kelantan,2,2,0,Austria
56245,10/1/2022,AUT,Melaka,0,0,0,Austria
56246,10/1/2022,AUT,Negeri Sembilan,0,0,0,Austria
56247,10/1/2022,AUT,Pahang,0,0,0,Austria
56248,10/1/2022,AUT,Perak,5,2,3,Austria
56249,10/1/2022,AUT,Perlis,7,3,4,Austria
56250,10/1/2022,AUT,Pulau Pinang,74,59,15,Austria
56251,10/1/2022,AUT,Sabah,12,8,4,Austria
56252,10/1/2022,AUT,Sarawak,11,7,4,Austria
56253,10/1/2022,AUT,Selangor,546,374,172,Austria
56254,10/1/2022,AUT,Terengganu,0,0,0,Austria
56255,10/1/2022,AUT,W.P. Labuan,2,1,1,Austria
56256,10/1/2022,AZE,Johor,4,3,1,Azerbaijan
56257,10/1/2022,AZE,Kedah,5,3,2,Azerbaijan
56258,10/1/2022,AZE,Kelantan,0,0,0,Azerbaijan
56259,10/1/2022,AZE,Melaka,0,0,0,Azerbaijan
56260,10/1/2022,AZE,Perlis,0,0,0,Azerbaijan
56261,10/1/2022,AZE,Pulau Pinang,0,0,0,Azerbaijan
56262,10/1/2022,AZE,Sabah,1,0,1,Azerbaijan
56263,10/1/2022,AZE,Sarawak,1,1,0,Azerbaijan
56264,10/1/2022,AZE,Selangor,72,46,26,Azerbaijan
56265,10/1/2022,AZE,W.P. Labuan,0,0,0,Azerbaijan
56266,10/1/2022,BDI,Pulau Pinang,0,0,0,Burundi
56267,10/1/2022,BDI,Sarawak,0,0,0,Burundi
56268,10/1/2022,BDI,Selangor,7,5,2,Burundi
56269,10/1/2022,BEL,Johor,213,136,77,Belgium
56270,10/1/2022,BEL,Kedah,22,11,11,Belgium
56271,10/1/2022,BEL,Kelantan,2,2,0,Belgium
56272,10/1/2022,BEL,Melaka,0,0,0,Belgium
56273,10/1/2022,BEL,Negeri Sembilan,0,0,0,Belgium
56274,10/1/2022,BEL,Pahang,0,0,0,Belgium
56275,10/1/2022,BEL,Perak,2,1,1,Belgium
56276,10/1/2022,BEL,Perlis,7,3,4,Belgium
56277,10/1/2022,BEL,Pulau Pinang,33,25,8,Belgium
56278,10/1/2022,BEL,Sabah,20,12,8,Belgium
56279,10/1/2022,BEL,Sarawak,24,10,14,Belgium
56280,10/1/2022,BEL,Selangor,875,558,317,Belgium
56281,10/1/2022,BEL,W.P. Labuan,0,0,0,Belgium
56282,10/1/2022,BEN,Johor,0,0,0,Benin
56283,10/1/2022,BEN,Kedah,0,0,0,Benin
56284,10/1/2022,BEN,Perak,2,1,1,Benin
56285,10/1/2022,BEN,Pulau Pinang,1,1,0,Benin
56286,10/1/2022,BEN,Sabah,0,0,0,Benin
56287,10/1/2022,BEN,Sarawak,0,0,0,Benin
56288,10/1/2022,BEN,Selangor,16,13,3,Benin
56289,10/1/2022,BFA,Perak,1,0,1,Burkina Faso
56290,10/1/2022,BFA,Pulau Pinang,0,0,0,Burkina Faso
56291,10/1/2022,BFA,Selangor,14,10,4,Burkina Faso
56292,10/1/2022,BGD,Johor,2043,1687,356,Bangladesh
56293,10/1/2022,BGD,Kedah,45,34,11,Bangladesh
56294,10/1/2022,BGD,Kelantan,0,0,0,Bangladesh
56295,10/1/2022,BGD,Melaka,0,0,0,Bangladesh
56296,10/1/2022,BGD,Negeri Sembilan,0,0,0,Bangladesh
56297,10/1/2022,BGD,Pahang,0,0,0,Bangladesh
56298,10/1/2022,BGD,Perak,0,0,0,Bangladesh
56299,10/1/2022,BGD,Perlis,11,8,3,Bangladesh
56300,10/1/2022,BGD,Pulau Pinang,238,226,12,Bangladesh
56301,10/1/2022,BGD,Sabah,2,1,1,Bangladesh
56302,10/1/2022,BGD,Sarawak,26,21,5,Bangladesh
56303,10/1/2022,BGD,Selangor,31159,29530,1629,Bangladesh
56304,10/1/2022,BGD,W.P. Labuan,0,0,0,Bangladesh
56305,10/1/2022,BGR,Johor,62,40,22,Bulgaria
56306,10/1/2022,BGR,Kedah,2,0,2,Bulgaria
56307,10/1/2022,BGR,Kelantan,0,0,0,Bulgaria
56308,10/1/2022,BGR,Pahang,0,0,0,Bulgaria
56309,10/1/2022,BGR,Perak,2,0,2,Bulgaria
56310,10/1/2022,BGR,Perlis,0,0,0,Bulgaria
56311,10/1/2022,BGR,Pulau Pinang,19,6,13,Bulgaria
56312,10/1/2022,BGR,Sabah,1,1,0,Bulgaria
56313,10/1/2022,BGR,Sarawak,1,0,1,Bulgaria
56314,10/1/2022,BGR,Selangor,122,86,36,Bulgaria
56315,10/1/2022,BGR,W.P. Labuan,0,0,0,Bulgaria
56316,10/1/2022,BHR,Johor,2,1,1,Bahrain
56317,10/1/2022,BHR,Kedah,0,0,0,Bahrain
56318,10/1/2022,BHR,Kelantan,0,0,0,Bahrain
56319,10/1/2022,BHR,Perlis,1,1,0,Bahrain
56320,10/1/2022,BHR,Pulau Pinang,7,3,4,Bahrain
56321,10/1/2022,BHR,Sabah,1,1,0,Bahrain
56322,10/1/2022,BHR,Sarawak,0,0,0,Bahrain
56323,10/1/2022,BHR,Selangor,132,84,48,Bahrain
56324,10/1/2022,BHS,Johor,0,0,0,Bahamas
56325,10/1/2022,BHS,Kedah,0,0,0,Bahamas
56326,10/1/2022,BHS,Perak,0,0,0,Bahamas
56327,10/1/2022,BHS,Sabah,0,0,0,Bahamas
56328,10/1/2022,BHS,Sarawak,0,0,0,Bahamas
56329,10/1/2022,BHS,Selangor,8,4,4,Bahamas
56330,10/1/2022,BIH,Johor,8,5,3,Bosnia and Herzegovina
56331,10/1/2022,BIH,Kedah,0,0,0,Bosnia and Herzegovina
56332,10/1/2022,BIH,Perlis,0,0,0,Bosnia and Herzegovina
56333,10/1/2022,BIH,Pulau Pinang,1,1,0,Bosnia and Herzegovina
56334,10/1/2022,BIH,Sabah,0,0,0,Bosnia and Herzegovina
56335,10/1/2022,BIH,Sarawak,2,2,0,Bosnia and Herzegovina
56336,10/1/2022,BIH,Selangor,44,25,19,Bosnia and Herzegovina
56337,10/1/2022,BLR,Johor,13,9,4,Belarus
56338,10/1/2022,BLR,Kedah,19,8,11,Belarus
56339,10/1/2022,BLR,Kelantan,2,1,1,Belarus
56340,10/1/2022,BLR,Pahang,0,0,0,Belarus
56341,10/1/2022,BLR,Perak,2,0,2,Belarus
56342,10/1/2022,BLR,Perlis,0,0,0,Belarus
56343,10/1/2022,BLR,Pulau Pinang,4,3,1,Belarus
56344,10/1/2022,BLR,Sabah,0,0,0,Belarus
56345,10/1/2022,BLR,Sarawak,5,2,3,Belarus
56346,10/1/2022,BLR,Selangor,196,89,107,Belarus
56347,10/1/2022,BLR,W.P. Labuan,0,0,0,Belarus
56348,10/1/2022,BLZ,Johor,3,1,2,Belize
56349,10/1/2022,BLZ,Pulau Pinang,0,0,0,Belize
56350,10/1/2022,BLZ,Sarawak,0,0,0,Belize
56351,10/1/2022,BLZ,Selangor,2,1,1,Belize
56352,10/1/2022,BMU,Selangor,0,0,0,Bermuda
56353,10/1/2022,BOL,Johor,1,0,1,Bolivia
56354,10/1/2022,BOL,Kedah,0,0,0,Bolivia
56355,10/1/2022,BOL,Melaka,0,0,0,Bolivia
56356,10/1/2022,BOL,Perak,1,1,0,Bolivia
56357,10/1/2022,BOL,Perlis,0,0,0,Bolivia
56358,10/1/2022,BOL,Pulau Pinang,2,1,1,Bolivia
56359,10/1/2022,BOL,Sabah,0,0,0,Bolivia
56360,10/1/2022,BOL,Sarawak,4,2,2,Bolivia
56361,10/1/2022,BOL,Selangor,16,10,6,Bolivia
56362,10/1/2022,BRA,Johor,245,130,115,Brazil
56363,10/1/2022,BRA,Kedah,22,10,12,Brazil
56364,10/1/2022,BRA,Kelantan,0,0,0,Brazil
56365,10/1/2022,BRA,Melaka,0,0,0,Brazil
56366,10/1/2022,BRA,Pahang,0,0,0,Brazil
56367,10/1/2022,BRA,Perak,3,2,1,Brazil
56368,10/1/2022,BRA,Perlis,5,2,3,Brazil
56369,10/1/2022,BRA,Pulau Pinang,14,9,5,Brazil
56370,10/1/2022,BRA,Sabah,1,1,0,Brazil
56371,10/1/2022,BRA,Sarawak,13,7,6,Brazil
56372,10/1/2022,BRA,Selangor,658,402,256,Brazil
56373,10/1/2022,BRA,W.P. Labuan,0,0,0,Brazil
56374,10/1/2022,BRB,Johor,1,0,1,Barbados
56375,10/1/2022,BRB,Kedah,0,0,0,Barbados
56376,10/1/2022,BRB,Perlis,0,0,0,Barbados
56377,10/1/2022,BRB,Pulau Pinang,0,0,0,Barbados
56378,10/1/2022,BRB,Selangor,10,4,6,Barbados
56379,10/1/2022,BRN,Johor,294,151,143,Brunei Darussalam
56380,10/1/2022,BRN,Kedah,12,7,5,Brunei Darussalam
56381,10/1/2022,BRN,Kelantan,0,0,0,Brunei Darussalam
56382,10/1/2022,BRN,Melaka,0,0,0,Brunei Darussalam
56383,10/1/2022,BRN,Pahang,0,0,0,Brunei Darussalam
56384,10/1/2022,BRN,Perak,2,1,1,Brunei Darussalam
56385,10/1/2022,BRN,Perlis,6,4,2,Brunei Darussalam
56386,10/1/2022,BRN,Pulau Pinang,11,4,7,Brunei Darussalam
56387,10/1/2022,BRN,Sabah,638,291,347,Brunei Darussalam
56388,10/1/2022,BRN,Sarawak,58681,31932,26749,Brunei Darussalam
56389,10/1/2022,BRN,Selangor,3683,1866,1817,Brunei Darussalam
56390,10/1/2022,BRN,W.P. Labuan,714,513,201,Brunei Darussalam
56391,10/1/2022,BTN,Johor,0,0,0,Bhutan
56392,10/1/2022,BTN,Kedah,1,1,0,Bhutan
56393,10/1/2022,BTN,Perak,0,0,0,Bhutan
56394,10/1/2022,BTN,Perlis,0,0,0,Bhutan
56395,10/1/2022,BTN,Pulau Pinang,2,2,0,Bhutan
56396,10/1/2022,BTN,Sabah,0,0,0,Bhutan
56397,10/1/2022,BTN,Sarawak,0,0,0,Bhutan
56398,10/1/2022,BTN,Selangor,20,15,5,Bhutan
56399,10/1/2022,BWA,Johor,5,2,3,Botswana
56400,10/1/2022,BWA,Kedah,0,0,0,Botswana
56401,10/1/2022,BWA,Perlis,0,0,0,Botswana
56402,10/1/2022,BWA,Pulau Pinang,0,0,0,Botswana
56403,10/1/2022,BWA,Sabah,0,0,0,Botswana
56404,10/1/2022,BWA,Sarawak,1,1,0,Botswana
56405,10/1/2022,BWA,Selangor,17,10,7,Botswana
56406,10/1/2022,CAF,Kedah,0,0,0,Central African Republic
56407,10/1/2022,CAF,Selangor,0,0,0,Central African Republic
56408,10/1/2022,CAN,Johor,1146,682,464,Canada
56409,10/1/2022,CAN,Kedah,111,61,50,Canada
56410,10/1/2022,CAN,Kelantan,1,0,1,Canada
56411,10/1/2022,CAN,Melaka,0,0,0,Canada
56412,10/1/2022,CAN,Negeri Sembilan,0,0,0,Canada
56413,10/1/2022,CAN,Pahang,0,0,0,Canada
56414,10/1/2022,CAN,Perak,23,12,11,Canada
56415,10/1/2022,CAN,Perlis,26,17,9,Canada
56416,10/1/2022,CAN,Pulau Pinang,317,200,117,Canada
56417,10/1/2022,CAN,Sabah,151,90,61,Canada
56418,10/1/2022,CAN,Sarawak,228,125,103,Canada
56419,10/1/2022,CAN,Selangor,3401,2047,1354,Canada
56420,10/1/2022,CAN,Terengganu,0,0,0,Canada
56421,10/1/2022,CAN,W.P. Labuan,5,4,1,Canada
56422,10/1/2022,CCK,Selangor,0,0,0,Cocos (Keeling) Islands
56423,10/1/2022,CHE,Johor,510,309,201,Switzerland
56424,10/1/2022,CHE,Kedah,71,41,30,Switzerland
56425,10/1/2022,CHE,Kelantan,3,2,1,Switzerland
56426,10/1/2022,CHE,Melaka,0,0,0,Switzerland
56427,10/1/2022,CHE,Negeri Sembilan,0,0,0,Switzerland
56428,10/1/2022,CHE,Pahang,0,0,0,Switzerland
56429,10/1/2022,CHE,Perak,6,4,2,Switzerland
56430,10/1/2022,CHE,Perlis,13,10,3,Switzerland
56431,10/1/2022,CHE,Pulau Pinang,110,67,43,Switzerland
56432,10/1/2022,CHE,Sabah,46,27,19,Switzerland
56433,10/1/2022,CHE,Sarawak,32,15,17,Switzerland
56434,10/1/2022,CHE,Selangor,984,605,379,Switzerland
56435,10/1/2022,CHE,W.P. Labuan,3,2,1,Switzerland
56436,10/1/2022,CHL,Johor,33,22,11,Chile
56437,10/1/2022,CHL,Kedah,7,3,4,Chile
56438,10/1/2022,CHL,Kelantan,0,0,0,Chile
56439,10/1/2022,CHL,Melaka,2,1,1,Chile
56440,10/1/2022,CHL,Pahang,0,0,0,Chile
56441,10/1/2022,CHL,Perak,2,0,2,Chile
56442,10/1/2022,CHL,Perlis,6,5,1,Chile
56443,10/1/2022,CHL,Pulau Pinang,7,5,2,Chile
56444,10/1/2022,CHL,Sabah,2,1,1,Chile
56445,10/1/2022,CHL,Sarawak,2,1,1,Chile
56446,10/1/2022,CHL,Selangor,125,71,54,Chile
56447,10/1/2022,CHN,Johor,21525,8935,12590,China
56448,10/1/2022,CHN,Kedah,473,189,284,China
56449,10/1/2022,CHN,Kelantan,9,6,3,China
56450,10/1/2022,CHN,Melaka,2,1,1,China
56451,10/1/2022,CHN,Pahang,0,0,0,China
56452,10/1/2022,CHN,Perak,123,44,79,China
56453,10/1/2022,CHN,Perlis,55,33,22,China
56454,10/1/2022,CHN,Pulau Pinang,1206,578,628,China
56455,10/1/2022,CHN,Sabah,384,170,214,China
56456,10/1/2022,CHN,Sarawak,410,213,197,China
56457,10/1/2022,CHN,Selangor,16993,9798,7195,China
56458,10/1/2022,CHN,Terengganu,0,0,0,China
56459,10/1/2022,CHN,W.P. Labuan,7,4,3,China
56460,10/1/2022,CIV,Johor,5,3,2,C��te d'Iv
56461,10/1/2022,CIV,Kedah,0,0,0,C��te d'Iv
56462,10/1/2022,CIV,Pulau Pinang,1,1,0,C��te d'Iv
56463,10/1/2022,CIV,Sabah,0,0,0,C��te d'Iv
56464,10/1/2022,CIV,Sarawak,0,0,0,C��te d'Iv
56465,10/1/2022,CIV,Selangor,52,38,14,C��te d'Iv
56466,10/1/2022,CMR,Johor,1,1,0,Cameroon
56467,10/1/2022,CMR,Kedah,0,0,0,Cameroon
56468,10/1/2022,CMR,Pulau Pinang,3,2,1,Cameroon
56469,10/1/2022,CMR,Sabah,0,0,0,Cameroon
56470,10/1/2022,CMR,Sarawak,0,0,0,Cameroon
56471,10/1/2022,CMR,Selangor,51,27,24,Cameroon
56472,10/1/2022,COD,Johor,1,1,0,"Congo, the Democratic Republic of the"
56473,10/1/2022,COD,Pulau Pinang,0,0,0,"Congo, the Democratic Republic of the"
56474,10/1/2022,COD,Sarawak,0,0,0,"Congo, the Democratic Republic of the"
56475,10/1/2022,COD,Selangor,4,4,0,"Congo, the Democratic Republic of the"
56476,10/1/2022,COG,Johor,0,0,0,Congo
56477,10/1/2022,COG,Kedah,0,0,0,Congo
56478,10/1/2022,COG,Selangor,1,1,0,Congo
56479,10/1/2022,COK,Selangor,0,0,0,Cook Islands
56480,10/1/2022,COL,Johor,23,10,13,Colombia
56481,10/1/2022,COL,Kedah,0,0,0,Colombia
56482,10/1/2022,COL,Perak,0,0,0,Colombia
56483,10/1/2022,COL,Pulau Pinang,0,0,0,Colombia
56484,10/1/2022,COL,Sabah,2,1,1,Colombia
56485,10/1/2022,COL,Sarawak,1,0,1,Colombia
56486,10/1/2022,COL,Selangor,218,112,106,Colombia
56487,10/1/2022,COL,W.P. Labuan,0,0,0,Colombia
56488,10/1/2022,COM,Johor,0,0,0,Comoros
56489,10/1/2022,COM,Kedah,0,0,0,Comoros
56490,10/1/2022,COM,Selangor,10,8,2,Comoros
56491,10/1/2022,CPV,Johor,0,0,0,Cape Verde
56492,10/1/2022,CPV,Kedah,0,0,0,Cape Verde
56493,10/1/2022,CPV,Pulau Pinang,0,0,0,Cape Verde
56494,10/1/2022,CPV,Sabah,0,0,0,Cape Verde
56495,10/1/2022,CPV,Selangor,5,2,3,Cape Verde
56496,10/1/2022,CRI,Johor,9,5,4,Costa Rica
56497,10/1/2022,CRI,Kedah,0,0,0,Costa Rica
56498,10/1/2022,CRI,Perak,2,1,1,Costa Rica
56499,10/1/2022,CRI,Perlis,0,0,0,Costa Rica
56500,10/1/2022,CRI,Pulau Pinang,11,7,4,Costa Rica
56501,10/1/2022,CRI,Sabah,1,1,0,Costa Rica
56502,10/1/2022,CRI,Sarawak,0,0,0,Costa Rica
56503,10/1/2022,CRI,Selangor,71,34,37,Costa Rica
56504,10/1/2022,CUB,Johor,7,5,2,Cuba
56505,10/1/2022,CUB,Kedah,0,0,0,Cuba
56506,10/1/2022,CUB,Perlis,0,0,0,Cuba
56507,10/1/2022,CUB,Pulau Pinang,1,1,0,Cuba
56508,10/1/2022,CUB,Sabah,0,0,0,Cuba
56509,10/1/2022,CUB,Sarawak,0,0,0,Cuba
56510,10/1/2022,CUB,Selangor,32,17,15,Cuba
56511,10/1/2022,CYP,Johor,8,5,3,Cyprus
56512,10/1/2022,CYP,Kedah,0,0,0,Cyprus
56513,10/1/2022,CYP,Perak,0,0,0,Cyprus
56514,10/1/2022,CYP,Perlis,0,0,0,Cyprus
56515,10/1/2022,CYP,Pulau Pinang,3,2,1,Cyprus
56516,10/1/2022,CYP,Sabah,0,0,0,Cyprus
56517,10/1/2022,CYP,Sarawak,4,1,3,Cyprus
56518,10/1/2022,CYP,Selangor,28,20,8,Cyprus
56519,10/1/2022,CZE,Johor,63,36,27,Czech Republic
56520,10/1/2022,CZE,Kedah,39,13,26,Czech Republic
56521,10/1/2022,CZE,Kelantan,4,2,2,Czech Republic
56522,10/1/2022,CZE,Melaka,0,0,0,Czech Republic
56523,10/1/2022,CZE,Negeri Sembilan,0,0,0,Czech Republic
56524,10/1/2022,CZE,Perak,0,0,0,Czech Republic
56525,10/1/2022,CZE,Perlis,14,7,7,Czech Republic
56526,10/1/2022,CZE,Pulau Pinang,17,12,5,Czech Republic
56527,10/1/2022,CZE,Sabah,9,4,5,Czech Republic
56528,10/1/2022,CZE,Sarawak,4,2,2,Czech Republic
56529,10/1/2022,CZE,Selangor,346,223,123,Czech Republic
56530,10/1/2022,CZE,W.P. Labuan,0,0,0,Czech Republic
56531,10/1/2022,DEU,Johor,2013,1307,706,Germany
56532,10/1/2022,DEU,Kedah,349,184,165,Germany
56533,10/1/2022,DEU,Kelantan,4,3,1,Germany
56534,10/1/2022,DEU,Melaka,1,0,1,Germany
56535,10/1/2022,DEU,Negeri Sembilan,0,0,0,Germany
56536,10/1/2022,DEU,Pahang,4,3,1,Germany
56537,10/1/2022,DEU,Perak,16,10,6,Germany
56538,10/1/2022,DEU,Perlis,69,43,26,Germany
56539,10/1/2022,DEU,Pulau Pinang,529,391,138,Germany
56540,10/1/2022,DEU,Sabah,126,78,48,Germany
56541,10/1/2022,DEU,Sarawak,214,129,85,Germany
56542,10/1/2022,DEU,Selangor,5474,3458,2016,Germany
56543,10/1/2022,DEU,Terengganu,0,0,0,Germany
56544,10/1/2022,DEU,W.P. Labuan,12,7,5,Germany
56545,10/1/2022,DJI,Johor,0,0,0,Djibouti
56546,10/1/2022,DJI,Selangor,24,21,3,Djibouti
56547,10/1/2022,DMA,Johor,5,5,0,Dominica
56548,10/1/2022,DMA,Kedah,0,0,0,Dominica
56549,10/1/2022,DMA,Pulau Pinang,1,1,0,Dominica
56550,10/1/2022,DMA,Sabah,0,0,0,Dominica
56551,10/1/2022,DMA,Sarawak,0,0,0,Dominica
56552,10/1/2022,DMA,Selangor,30,24,6,Dominica
56553,10/1/2022,DMA,W.P. Labuan,0,0,0,Dominica
56554,10/1/2022,DNK,Johor,318,216,102,Denmark
56555,10/1/2022,DNK,Kedah,37,19,18,Denmark
56556,10/1/2022,DNK,Kelantan,0,0,0,Denmark
56557,10/1/2022,DNK,Melaka,0,0,0,Denmark
56558,10/1/2022,DNK,Negeri Sembilan,0,0,0,Denmark
56559,10/1/2022,DNK,Pahang,0,0,0,Denmark
56560,10/1/2022,DNK,Perak,6,4,2,Denmark
56561,10/1/2022,DNK,Perlis,9,6,3,Denmark
56562,10/1/2022,DNK,Pulau Pinang,49,31,18,Denmark
56563,10/1/2022,DNK,Sabah,39,24,15,Denmark
56564,10/1/2022,DNK,Sarawak,26,12,14,Denmark
56565,10/1/2022,DNK,Selangor,735,465,270,Denmark
56566,10/1/2022,DNK,W.P. Labuan,0,0,0,Denmark
56567,10/1/2022,DOM,Johor,3,2,1,Dominican Republic
56568,10/1/2022,DOM,Kedah,0,0,0,Dominican Republic
56569,10/1/2022,DOM,Perak,1,0,1,Dominican Republic
56570,10/1/2022,DOM,Perlis,1,0,1,Dominican Republic
56571,10/1/2022,DOM,Pulau Pinang,0,0,0,Dominican Republic
56572,10/1/2022,DOM,Sabah,0,0,0,Dominican Republic
56573,10/1/2022,DOM,Sarawak,0,0,0,Dominican Republic
56574,10/1/2022,DOM,Selangor,37,18,19,Dominican Republic
56575,10/1/2022,DZA,Johor,17,16,1,Algeria
56576,10/1/2022,DZA,Kedah,2,1,1,Algeria
56577,10/1/2022,DZA,Kelantan,0,0,0,Algeria
56578,10/1/2022,DZA,Melaka,0,0,0,Algeria
56579,10/1/2022,DZA,Perak,0,0,0,Algeria
56580,10/1/2022,DZA,Perlis,0,0,0,Algeria
56581,10/1/2022,DZA,Pulau Pinang,4,4,0,Algeria
56582,10/1/2022,DZA,Sabah,3,3,0,Algeria
56583,10/1/2022,DZA,Sarawak,1,1,0,Algeria
56584,10/1/2022,DZA,Selangor,424,288,136,Algeria
56585,10/1/2022,DZA,W.P. Labuan,0,0,0,Algeria
56586,10/1/2022,ECU,Johor,19,10,9,Ecuador
56587,10/1/2022,ECU,Kedah,0,0,0,Ecuador
56588,10/1/2022,ECU,Perak,2,1,1,Ecuador
56589,10/1/2022,ECU,Perlis,0,0,0,Ecuador
56590,10/1/2022,ECU,Pulau Pinang,1,0,1,Ecuador
56591,10/1/2022,ECU,Sabah,1,0,1,Ecuador
56592,10/1/2022,ECU,Sarawak,4,2,2,Ecuador
56593,10/1/2022,ECU,Selangor,72,44,28,Ecuador
56594,10/1/2022,EGY,Johor,218,177,41,Egypt
56595,10/1/2022,EGY,Kedah,7,5,2,Egypt
56596,10/1/2022,EGY,Kelantan,0,0,0,Egypt
56597,10/1/2022,EGY,Melaka,0,0,0,Egypt
56598,10/1/2022,EGY,Pahang,0,0,0,Egypt
56599,10/1/2022,EGY,Perak,1,1,0,Egypt
56600,10/1/2022,EGY,Perlis,1,1,0,Egypt
56601,10/1/2022,EGY,Pulau Pinang,13,9,4,Egypt
56602,10/1/2022,EGY,Sabah,5,5,0,Egypt
56603,10/1/2022,EGY,Sarawak,136,95,41,Egypt
56604,10/1/2022,EGY,Selangor,1692,1151,541,Egypt
56605,10/1/2022,EGY,Terengganu,0,0,0,Egypt
56606,10/1/2022,EGY,W.P. Labuan,0,0,0,Egypt
56607,10/1/2022,ERI,Johor,0,0,0,Eritrea
56608,10/1/2022,ERI,Pulau Pinang,0,0,0,Eritrea
56609,10/1/2022,ERI,Sabah,0,0,0,Eritrea
56610,10/1/2022,ERI,Selangor,19,15,4,Eritrea
56611,10/1/2022,ESP,Johor,459,266,193,Spain
56612,10/1/2022,ESP,Kedah,80,49,31,Spain
56613,10/1/2022,ESP,Kelantan,3,0,3,Spain
56614,10/1/2022,ESP,Melaka,0,0,0,Spain
56615,10/1/2022,ESP,Negeri Sembilan,0,0,0,Spain
56616,10/1/2022,ESP,Pahang,1,1,0,Spain
56617,10/1/2022,ESP,Perak,2,0,2,Spain
56618,10/1/2022,ESP,Perlis,21,17,4,Spain
56619,10/1/2022,ESP,Pulau Pinang,69,45,24,Spain
56620,10/1/2022,ESP,Sabah,27,14,13,Spain
56621,10/1/2022,ESP,Sarawak,45,27,18,Spain
56622,10/1/2022,ESP,Selangor,3003,1913,1090,Spain
56623,10/1/2022,ESP,W.P. Labuan,2,1,1,Spain
56624,10/1/2022,EST,Johor,19,13,6,Estonia
56625,10/1/2022,EST,Kedah,21,15,6,Estonia
56626,10/1/2022,EST,Kelantan,0,0,0,Estonia
56627,10/1/2022,EST,Pahang,0,0,0,Estonia
56628,10/1/2022,EST,Perak,1,1,0,Estonia
56629,10/1/2022,EST,Perlis,0,0,0,Estonia
56630,10/1/2022,EST,Pulau Pinang,6,1,5,Estonia
56631,10/1/2022,EST,Sabah,11,7,4,Estonia
56632,10/1/2022,EST,Sarawak,0,0,0,Estonia
56633,10/1/2022,EST,Selangor,103,53,50,Estonia
56634,10/1/2022,EST,W.P. Labuan,0,0,0,Estonia
56635,10/1/2022,ETH,Johor,3,3,0,Ethiopia
56636,10/1/2022,ETH,Kedah,0,0,0,Ethiopia
56637,10/1/2022,ETH,Pulau Pinang,0,0,0,Ethiopia
56638,10/1/2022,ETH,Sarawak,3,2,1,Ethiopia
56639,10/1/2022,ETH,Selangor,54,47,7,Ethiopia
56640,10/1/2022,FIN,Johor,175,96,79,Finland
56641,10/1/2022,FIN,Kedah,47,27,20,Finland
56642,10/1/2022,FIN,Kelantan,0,0,0,Finland
56643,10/1/2022,FIN,Melaka,0,0,0,Finland
56644,10/1/2022,FIN,Negeri Sembilan,0,0,0,Finland
56645,10/1/2022,FIN,Pahang,0,0,0,Finland
56646,10/1/2022,FIN,Perak,1,1,0,Finland
56647,10/1/2022,FIN,Perlis,3,3,0,Finland
56648,10/1/2022,FIN,Pulau Pinang,48,27,21,Finland
56649,10/1/2022,FIN,Sabah,9,6,3,Finland
56650,10/1/2022,FIN,Sarawak,9,7,2,Finland
56651,10/1/2022,FIN,Selangor,421,248,173,Finland
56652,10/1/2022,FIN,W.P. Labuan,2,2,0,Finland
56653,10/1/2022,FJI,Johor,55,22,33,Fiji
56654,10/1/2022,FJI,Kedah,0,0,0,Fiji
56655,10/1/2022,FJI,Kelantan,0,0,0,Fiji
56656,10/1/2022,FJI,Perak,4,3,1,Fiji
56657,10/1/2022,FJI,Perlis,0,0,0,Fiji
56658,10/1/2022,FJI,Pulau Pinang,6,1,5,Fiji
56659,10/1/2022,FJI,Sabah,0,0,0,Fiji
56660,10/1/2022,FJI,Sarawak,0,0,0,Fiji
56661,10/1/2022,FJI,Selangor,116,73,43,Fiji
56662,10/1/2022,FRA,Johor,2074,1292,782,France
56663,10/1/2022,FRA,Kedah,283,154,129,France
56664,10/1/2022,FRA,Kelantan,14,10,4,France
56665,10/1/2022,FRA,Melaka,0,0,0,France
56666,10/1/2022,FRA,Negeri Sembilan,1,0,1,France
56667,10/1/2022,FRA,Pahang,0,0,0,France
56668,10/1/2022,FRA,Perak,32,20,12,France
56669,10/1/2022,FRA,Perlis,49,34,15,France
56670,10/1/2022,FRA,Pulau Pinang,278,185,93,France
56671,10/1/2022,FRA,Sabah,150,87,63,France
56672,10/1/2022,FRA,Sarawak,133,76,57,France
56673,10/1/2022,FRA,Selangor,6356,3892,2464,France
56674,10/1/2022,FRA,Terengganu,2,1,1,France
56675,10/1/2022,FRA,W.P. Labuan,1,1,0,France
56676,10/1/2022,FSM,Johor,0,0,0,"Micronesia, Federated States of"
56677,10/1/2022,FSM,Pulau Pinang,0,0,0,"Micronesia, Federated States of"
56678,10/1/2022,FSM,Selangor,1,1,0,"Micronesia, Federated States of"
56679,10/1/2022,GAB,Johor,0,0,0,Gabon
56680,10/1/2022,GAB,Pulau Pinang,0,0,0,Gabon
56681,10/1/2022,GAB,Sarawak,0,0,0,Gabon
56682,10/1/2022,GAB,Selangor,14,8,6,Gabon
56683,10/1/2022,GBR,Johor,4645,2909,1736,United Kingdom
56684,10/1/2022,GBR,Kedah,773,445,328,United Kingdom
56685,10/1/2022,GBR,Kelantan,10,5,5,United Kingdom
56686,10/1/2022,GBR,Melaka,1,1,0,United Kingdom
56687,10/1/2022,GBR,Negeri Sembilan,0,0,0,United Kingdom
56688,10/1/2022,GBR,Pahang,8,7,1,United Kingdom
56689,10/1/2022,GBR,Perak,62,34,28,United Kingdom
56690,10/1/2022,GBR,Perlis,73,47,26,United Kingdom
56691,10/1/2022,GBR,Pulau Pinang,1199,700,499,United Kingdom
56692,10/1/2022,GBR,Sabah,552,284,268,United Kingdom
56693,10/1/2022,GBR,Sarawak,1475,872,603,United Kingdom
56694,10/1/2022,GBR,Selangor,14629,9069,5560,United Kingdom
56695,10/1/2022,GBR,Terengganu,0,0,0,United Kingdom
56696,10/1/2022,GBR,W.P. Labuan,54,42,12,United Kingdom
56697,10/1/2022,GEO,Johor,8,7,1,Georgia
56698,10/1/2022,GEO,Kedah,0,0,0,Georgia
56699,10/1/2022,GEO,Melaka,0,0,0,Georgia
56700,10/1/2022,GEO,Perak,1,0,1,Georgia
56701,10/1/2022,GEO,Perlis,1,1,0,Georgia
56702,10/1/2022,GEO,Pulau Pinang,0,0,0,Georgia
56703,10/1/2022,GEO,Sabah,0,0,0,Georgia
56704,10/1/2022,GEO,Sarawak,0,0,0,Georgia
56705,10/1/2022,GEO,Selangor,45,28,17,Georgia
56706,10/1/2022,GHA,Johor,11,3,8,Ghana
56707,10/1/2022,GHA,Kedah,0,0,0,Ghana
56708,10/1/2022,GHA,Kelantan,0,0,0,Ghana
56709,10/1/2022,GHA,Pulau Pinang,3,2,1,Ghana
56710,10/1/2022,GHA,Sabah,0,0,0,Ghana
56711,10/1/2022,GHA,Sarawak,1,1,0,Ghana
56712,10/1/2022,GHA,Selangor,90,68,22,Ghana
56713,10/1/2022,GIB,Johor,0,0,0,Gibraltar
56714,10/1/2022,GIB,Sarawak,0,0,0,Gibraltar
56715,10/1/2022,GIN,Johor,4,3,1,Guinea
56716,10/1/2022,GIN,Kedah,0,0,0,Guinea
56717,10/1/2022,GIN,Kelantan,0,0,0,Guinea
56718,10/1/2022,GIN,Perlis,5,2,3,Guinea
56719,10/1/2022,GIN,Pulau Pinang,0,0,0,Guinea
56720,10/1/2022,GIN,Sabah,0,0,0,Guinea
56721,10/1/2022,GIN,Sarawak,0,0,0,Guinea
56722,10/1/2022,GIN,Selangor,59,42,17,Guinea
56723,10/1/2022,GLP,Selangor,0,0,0,Guadeloupe
56724,10/1/2022,GMB,Johor,10,6,4,Gambia
56725,10/1/2022,GMB,Kedah,0,0,0,Gambia
56726,10/1/2022,GMB,Kelantan,0,0,0,Gambia
56727,10/1/2022,GMB,Pulau Pinang,1,1,0,Gambia
56728,10/1/2022,GMB,Sabah,0,0,0,Gambia
56729,10/1/2022,GMB,Sarawak,0,0,0,Gambia
56730,10/1/2022,GMB,Selangor,30,29,1,Gambia
56731,10/1/2022,GNB,Johor,0,0,0,Guinea-Bissau
56732,10/1/2022,GNB,Selangor,2,1,1,Guinea-Bissau
56733,10/1/2022,GNQ,Johor,0,0,0,Equatorial Guinea
56734,10/1/2022,GNQ,Selangor,0,0,0,Equatorial Guinea
56735,10/1/2022,GRC,Johor,60,44,16,Greece
56736,10/1/2022,GRC,Kedah,6,3,3,Greece
56737,10/1/2022,GRC,Kelantan,0,0,0,Greece
56738,10/1/2022,GRC,Melaka,0,0,0,Greece
56739,10/1/2022,GRC,Negeri Sembilan,0,0,0,Greece
56740,10/1/2022,GRC,Pahang,0,0,0,Greece
56741,10/1/2022,GRC,Perak,2,1,1,Greece
56742,10/1/2022,GRC,Perlis,1,1,0,Greece
56743,10/1/2022,GRC,Pulau Pinang,5,4,1,Greece
56744,10/1/2022,GRC,Sabah,0,0,0,Greece
56745,10/1/2022,GRC,Sarawak,1,0,1,Greece
56746,10/1/2022,GRC,Selangor,139,96,43,Greece
56747,10/1/2022,GRD,Johor,7,4,3,Grenada
56748,10/1/2022,GRD,Kedah,0,0,0,Grenada
56749,10/1/2022,GRD,Pulau Pinang,0,0,0,Grenada
56750,10/1/2022,GRD,Sabah,6,3,3,Grenada
56751,10/1/2022,GRD,Sarawak,1,1,0,Grenada
56752,10/1/2022,GRD,Selangor,4,3,1,Grenada
56753,10/1/2022,GRL,Johor,0,0,0,Greenland
56754,10/1/2022,GRL,Selangor,0,0,0,Greenland
56755,10/1/2022,GTM,Johor,1,1,0,Guatemala
56756,10/1/2022,GTM,Kedah,0,0,0,Guatemala
56757,10/1/2022,GTM,Pahang,0,0,0,Guatemala
56758,10/1/2022,GTM,Perak,2,1,1,Guatemala
56759,10/1/2022,GTM,Pulau Pinang,1,1,0,Guatemala
56760,10/1/2022,GTM,Sabah,0,0,0,Guatemala
56761,10/1/2022,GTM,Sarawak,0,0,0,Guatemala
56762,10/1/2022,GTM,Selangor,9,3,6,Guatemala
56763,10/1/2022,GTM,W.P. Labuan,0,0,0,Guatemala
56764,10/1/2022,GUY,Johor,1,0,1,Guyana
56765,10/1/2022,GUY,Kedah,0,0,0,Guyana
56766,10/1/2022,GUY,Pulau Pinang,0,0,0,Guyana
56767,10/1/2022,GUY,Sarawak,0,0,0,Guyana
56768,10/1/2022,GUY,Selangor,2,1,1,Guyana
56769,10/1/2022,HKG,Johor,3,1,2,Hong Kong
56770,10/1/2022,HKG,Kedah,0,0,0,Hong Kong
56771,10/1/2022,HKG,Kelantan,0,0,0,Hong Kong
56772,10/1/2022,HKG,Pahang,0,0,0,Hong Kong
56773,10/1/2022,HKG,Perak,29,15,14,Hong Kong
56774,10/1/2022,HKG,Perlis,0,0,0,Hong Kong
56775,10/1/2022,HKG,Pulau Pinang,0,0,0,Hong Kong
56776,10/1/2022,HKG,Sabah,8,5,3,Hong Kong
56777,10/1/2022,HKG,Sarawak,0,0,0,Hong Kong
56778,10/1/2022,HKG,Selangor,74,41,33,Hong Kong
56779,10/1/2022,HKG,Terengganu,0,0,0,Hong Kong
56780,10/1/2022,HMD,Johor,0,0,0,Heard Island and McDonald Islands
56781,10/1/2022,HND,Johor,8,3,5,Honduras
56782,10/1/2022,HND,Kedah,1,0,1,Honduras
56783,10/1/2022,HND,Perak,2,1,1,Honduras
56784,10/1/2022,HND,Pulau Pinang,2,1,1,Honduras
56785,10/1/2022,HND,Sabah,1,1,0,Honduras
56786,10/1/2022,HND,Sarawak,0,0,0,Honduras
56787,10/1/2022,HND,Selangor,7,4,3,Honduras
56788,10/1/2022,HRV,Johor,28,20,8,Croatia
56789,10/1/2022,HRV,Kedah,0,0,0,Croatia
56790,10/1/2022,HRV,Kelantan,0,0,0,Croatia
56791,10/1/2022,HRV,Melaka,0,0,0,Croatia
56792,10/1/2022,HRV,Pahang,0,0,0,Croatia
56793,10/1/2022,HRV,Perak,0,0,0,Croatia
56794,10/1/2022,HRV,Perlis,0,0,0,Croatia
56795,10/1/2022,HRV,Pulau Pinang,6,4,2,Croatia
56796,10/1/2022,HRV,Sabah,1,1,0,Croatia
56797,10/1/2022,HRV,Sarawak,3,2,1,Croatia
56798,10/1/2022,HRV,Selangor,113,89,24,Croatia
56799,10/1/2022,HTI,Johor,3,1,2,Haiti
56800,10/1/2022,HTI,Kedah,1,0,1,Haiti
56801,10/1/2022,HTI,Kelantan,0,0,0,Haiti
56802,10/1/2022,HTI,Perak,1,1,0,Haiti
56803,10/1/2022,HTI,Pulau Pinang,0,0,0,Haiti
56804,10/1/2022,HTI,Sabah,0,0,0,Haiti
56805,10/1/2022,HTI,Selangor,0,0,0,Haiti
56806,10/1/2022,HUN,Johor,104,72,32,Hungary
56807,10/1/2022,HUN,Kedah,8,6,2,Hungary
56808,10/1/2022,HUN,Kelantan,0,0,0,Hungary
56809,10/1/2022,HUN,Pahang,0,0,0,Hungary
56810,10/1/2022,HUN,Perak,1,0,1,Hungary
56811,10/1/2022,HUN,Perlis,1,1,0,Hungary
56812,10/1/2022,HUN,Pulau Pinang,15,11,4,Hungary
56813,10/1/2022,HUN,Sabah,1,1,0,Hungary
56814,10/1/2022,HUN,Sarawak,2,1,1,Hungary
56815,10/1/2022,HUN,Selangor,335,186,149,Hungary
56816,10/1/2022,HUN,W.P. Labuan,0,0,0,Hungary
56817,10/1/2022,IDN,Johor,92684,50940,41744,Indonesia
56818,10/1/2022,IDN,Kedah,3570,1231,2339,Indonesia
56819,10/1/2022,IDN,Kelantan,151,112,39,Indonesia
56820,10/1/2022,IDN,Melaka,6724,3080,3644,Indonesia
56821,10/1/2022,IDN,Negeri Sembilan,7349,5041,2308,Indonesia
56822,10/1/2022,IDN,Pahang,3,3,0,Indonesia
56823,10/1/2022,IDN,Perak,143,44,99,Indonesia
56824,10/1/2022,IDN,Perlis,431,158,273,Indonesia
56825,10/1/2022,IDN,Pulau Pinang,25298,9479,15819,Indonesia
56826,10/1/2022,IDN,Sabah,3405,1685,1720,Indonesia
56827,10/1/2022,IDN,Sarawak,27248,15616,11632,Indonesia
56828,10/1/2022,IDN,Selangor,81534,41146,40388,Indonesia
56829,10/1/2022,IDN,Terengganu,0,0,0,Indonesia
56830,10/1/2022,IDN,W.P. Labuan,21,13,8,Indonesia
56831,10/1/2022,IND,Johor,16054,10877,5177,India
56832,10/1/2022,IND,Kedah,789,457,332,India
56833,10/1/2022,IND,Kelantan,1,1,0,India
56834,10/1/2022,IND,Melaka,1,1,0,India
56835,10/1/2022,IND,Negeri Sembilan,2,2,0,India
56836,10/1/2022,IND,Pahang,0,0,0,India
56837,10/1/2022,IND,Perak,242,210,32,India
56838,10/1/2022,IND,Perlis,80,71,9,India
56839,10/1/2022,IND,Pulau Pinang,1888,1416,472,India
56840,10/1/2022,IND,Sabah,208,124,84,India
56841,10/1/2022,IND,Sarawak,444,336,108,India
56842,10/1/2022,IND,Selangor,48579,34881,13698,India
56843,10/1/2022,IND,Terengganu,0,0,0,India
56844,10/1/2022,IND,W.P. Labuan,27,21,6,India
56845,10/1/2022,IOT,Pulau Pinang,1,1,0,British Indian Ocean Territory
56846,10/1/2022,IOT,Selangor,0,0,0,British Indian Ocean Territory
56847,10/1/2022,IRL,Johor,291,182,109,Ireland
56848,10/1/2022,IRL,Kedah,73,41,32,Ireland
56849,10/1/2022,IRL,Kelantan,0,0,0,Ireland
56850,10/1/2022,IRL,Negeri Sembilan,0,0,0,Ireland
56851,10/1/2022,IRL,Pahang,0,0,0,Ireland
56852,10/1/2022,IRL,Perak,7,2,5,Ireland
56853,10/1/2022,IRL,Perlis,11,9,2,Ireland
56854,10/1/2022,IRL,Pulau Pinang,105,69,36,Ireland
56855,10/1/2022,IRL,Sabah,23,13,10,Ireland
56856,10/1/2022,IRL,Sarawak,39,20,19,Ireland
56857,10/1/2022,IRL,Selangor,1296,757,539,Ireland
56858,10/1/2022,IRL,Terengganu,0,0,0,Ireland
56859,10/1/2022,IRL,W.P. Labuan,0,0,0,Ireland
56860,10/1/2022,IRN,Johor,93,64,29,Iran
56861,10/1/2022,IRN,Kedah,3,1,2,Iran
56862,10/1/2022,IRN,Kelantan,0,0,0,Iran
56863,10/1/2022,IRN,Perak,0,0,0,Iran
56864,10/1/2022,IRN,Perlis,7,6,1,Iran
56865,10/1/2022,IRN,Pulau Pinang,8,6,2,Iran
56866,10/1/2022,IRN,Sabah,1,1,0,Iran
56867,10/1/2022,IRN,Sarawak,1,1,0,Iran
56868,10/1/2022,IRN,Selangor,857,498,359,Iran
56869,10/1/2022,IRN,W.P. Labuan,0,0,0,Iran
56870,10/1/2022,IRQ,Johor,12,11,1,Iraq
56871,10/1/2022,IRQ,Kedah,2,1,1,Iraq
56872,10/1/2022,IRQ,Kelantan,0,0,0,Iraq
56873,10/1/2022,IRQ,Melaka,0,0,0,Iraq
56874,10/1/2022,IRQ,Pahang,0,0,0,Iraq
56875,10/1/2022,IRQ,Perak,0,0,0,Iraq
56876,10/1/2022,IRQ,Perlis,0,0,0,Iraq
56877,10/1/2022,IRQ,Pulau Pinang,2,2,0,Iraq
56878,10/1/2022,IRQ,Sabah,0,0,0,Iraq
56879,10/1/2022,IRQ,Sarawak,1,0,1,Iraq
56880,10/1/2022,IRQ,Selangor,705,498,207,Iraq
56881,10/1/2022,ISL,Johor,3,3,0,Iceland
56882,10/1/2022,ISL,Kedah,0,0,0,Iceland
56883,10/1/2022,ISL,Kelantan,0,0,0,Iceland
56884,10/1/2022,ISL,Perak,2,1,1,Iceland
56885,10/1/2022,ISL,Perlis,0,0,0,Iceland
56886,10/1/2022,ISL,Pulau Pinang,2,2,0,Iceland
56887,10/1/2022,ISL,Sabah,8,4,4,Iceland
56888,10/1/2022,ISL,Sarawak,0,0,0,Iceland
56889,10/1/2022,ISL,Selangor,24,13,11,Iceland
56890,10/1/2022,ISL,W.P. Labuan,0,0,0,Iceland
56891,10/1/2022,ISR,Pulau Pinang,0,0,0,Israel
56892,10/1/2022,ITA,Johor,450,324,126,Italy
56893,10/1/2022,ITA,Kedah,63,40,23,Italy
56894,10/1/2022,ITA,Kelantan,3,1,2,Italy
56895,10/1/2022,ITA,Melaka,0,0,0,Italy
56896,10/1/2022,ITA,Negeri Sembilan,0,0,0,Italy
56897,10/1/2022,ITA,Pahang,1,1,0,Italy
56898,10/1/2022,ITA,Perak,2,2,0,Italy
56899,10/1/2022,ITA,Perlis,14,9,5,Italy
56900,10/1/2022,ITA,Pulau Pinang,78,53,25,Italy
56901,10/1/2022,ITA,Sabah,24,14,10,Italy
56902,10/1/2022,ITA,Sarawak,19,13,6,Italy
56903,10/1/2022,ITA,Selangor,2226,1671,555,Italy
56904,10/1/2022,ITA,W.P. Labuan,0,0,0,Italy
56905,10/1/2022,JAM,Johor,8,1,7,Jamaica
56906,10/1/2022,JAM,Kedah,0,0,0,Jamaica
56907,10/1/2022,JAM,Perak,1,0,1,Jamaica
56908,10/1/2022,JAM,Pulau Pinang,2,1,1,Jamaica
56909,10/1/2022,JAM,Sabah,0,0,0,Jamaica
56910,10/1/2022,JAM,Sarawak,0,0,0,Jamaica
56911,10/1/2022,JAM,Selangor,12,7,5,Jamaica
56912,10/1/2022,JAM,W.P. Labuan,0,0,0,Jamaica
56913,10/1/2022,JOR,Johor,9,8,1,Jordan
56914,10/1/2022,JOR,Kedah,10,6,4,Jordan
56915,10/1/2022,JOR,Kelantan,0,0,0,Jordan
56916,10/1/2022,JOR,Melaka,0,0,0,Jordan
56917,10/1/2022,JOR,Perlis,2,2,0,Jordan
56918,10/1/2022,JOR,Pulau Pinang,5,3,2,Jordan
56919,10/1/2022,JOR,Sabah,1,1,0,Jordan
56920,10/1/2022,JOR,Sarawak,4,4,0,Jordan
56921,10/1/2022,JOR,Selangor,630,400,230,Jordan
56922,10/1/2022,JOR,W.P. Labuan,0,0,0,Jordan
56923,10/1/2022,JPN,Johor,4801,3430,1371,Japan
56924,10/1/2022,JPN,Kedah,148,75,73,Japan
56925,10/1/2022,JPN,Kelantan,3,3,0,Japan
56926,10/1/2022,JPN,Melaka,1,1,0,Japan
56927,10/1/2022,JPN,Negeri Sembilan,0,0,0,Japan
56928,10/1/2022,JPN,Pahang,1,0,1,Japan
56929,10/1/2022,JPN,Perak,38,26,12,Japan
56930,10/1/2022,JPN,Perlis,53,37,16,Japan
56931,10/1/2022,JPN,Pulau Pinang,808,617,191,Japan
56932,10/1/2022,JPN,Sabah,201,109,92,Japan
56933,10/1/2022,JPN,Sarawak,138,86,52,Japan
56934,10/1/2022,JPN,Selangor,10744,7300,3444,Japan
56935,10/1/2022,JPN,W.P. Labuan,4,3,1,Japan
56936,10/1/2022,KAZ,Johor,39,21,18,Kazakhstan
56937,10/1/2022,KAZ,Kedah,13,6,7,Kazakhstan
56938,10/1/2022,KAZ,Kelantan,0,0,0,Kazakhstan
56939,10/1/2022,KAZ,Melaka,0,0,0,Kazakhstan
56940,10/1/2022,KAZ,Perak,0,0,0,Kazakhstan
56941,10/1/2022,KAZ,Perlis,3,2,1,Kazakhstan
56942,10/1/2022,KAZ,Pulau Pinang,6,2,4,Kazakhstan
56943,10/1/2022,KAZ,Sabah,2,2,0,Kazakhstan
56944,10/1/2022,KAZ,Sarawak,3,1,2,Kazakhstan
56945,10/1/2022,KAZ,Selangor,464,164,300,Kazakhstan
56946,10/1/2022,KAZ,W.P. Labuan,0,0,0,Kazakhstan
56947,10/1/2022,KEN,Johor,65,29,36,Kenya
56948,10/1/2022,KEN,Kedah,2,1,1,Kenya
56949,10/1/2022,KEN,Kelantan,1,0,1,Kenya
56950,10/1/2022,KEN,Perak,2,1,1,Kenya
56951,10/1/2022,KEN,Perlis,1,1,0,Kenya
56952,10/1/2022,KEN,Pulau Pinang,3,1,2,Kenya
56953,10/1/2022,KEN,Sabah,1,1,0,Kenya
56954,10/1/2022,KEN,Sarawak,0,0,0,Kenya
56955,10/1/2022,KEN,Selangor,230,119,111,Kenya
56956,10/1/2022,KGZ,Johor,15,4,11,Kyrgyzstan
56957,10/1/2022,KGZ,Kedah,1,1,0,Kyrgyzstan
56958,10/1/2022,KGZ,Kelantan,0,0,0,Kyrgyzstan
56959,10/1/2022,KGZ,Perak,0,0,0,Kyrgyzstan
56960,10/1/2022,KGZ,Perlis,0,0,0,Kyrgyzstan
56961,10/1/2022,KGZ,Pulau Pinang,0,0,0,Kyrgyzstan
56962,10/1/2022,KGZ,Sabah,0,0,0,Kyrgyzstan
56963,10/1/2022,KGZ,Sarawak,0,0,0,Kyrgyzstan
56964,10/1/2022,KGZ,Selangor,89,50,39,Kyrgyzstan
56965,10/1/2022,KHM,Johor,1402,560,842,Cambodia
56966,10/1/2022,KHM,Kedah,195,155,40,Cambodia
56967,10/1/2022,KHM,Kelantan,766,443,323,Cambodia
56968,10/1/2022,KHM,Melaka,8,4,4,Cambodia
56969,10/1/2022,KHM,Negeri Sembilan,0,0,0,Cambodia
56970,10/1/2022,KHM,Pahang,0,0,0,Cambodia
56971,10/1/2022,KHM,Perak,12,6,6,Cambodia
56972,10/1/2022,KHM,Perlis,948,611,337,Cambodia
56973,10/1/2022,KHM,Pulau Pinang,33,17,16,Cambodia
56974,10/1/2022,KHM,Sabah,1,1,0,Cambodia
56975,10/1/2022,KHM,Sarawak,2,1,1,Cambodia
56976,10/1/2022,KHM,Selangor,3696,1847,1849,Cambodia
56977,10/1/2022,KHM,W.P. Labuan,0,0,0,Cambodia
56978,10/1/2022,KIR,Johor,0,0,0,Kiribati
56979,10/1/2022,KIR,Sabah,0,0,0,Kiribati
56980,10/1/2022,KIR,Selangor,0,0,0,Kiribati
56981,10/1/2022,KNA,Johor,27,16,11,Saint Kitts and Nevis
56982,10/1/2022,KNA,Kedah,0,0,0,Saint Kitts and Nevis
56983,10/1/2022,KNA,Perlis,0,0,0,Saint Kitts and Nevis
56984,10/1/2022,KNA,Pulau Pinang,4,4,0,Saint Kitts and Nevis
56985,10/1/2022,KNA,Sabah,0,0,0,Saint Kitts and Nevis
56986,10/1/2022,KNA,Selangor,50,40,10,Saint Kitts and Nevis
56987,10/1/2022,KNA,W.P. Labuan,0,0,0,Saint Kitts and Nevis
56988,10/1/2022,KOR,Johor,8235,4746,3489,"Korea, Republic of (South Korea)"
56989,10/1/2022,KOR,Kedah,116,53,63,"Korea, Republic of (South Korea)"
56990,10/1/2022,KOR,Kelantan,0,0,0,"Korea, Republic of (South Korea)"
56991,10/1/2022,KOR,Melaka,0,0,0,"Korea, Republic of (South Korea)"
56992,10/1/2022,KOR,Negeri Sembilan,0,0,0,"Korea, Republic of (South Korea)"
56993,10/1/2022,KOR,Pahang,0,0,0,"Korea, Republic of (South Korea)"
56994,10/1/2022,KOR,Perak,9,6,3,"Korea, Republic of (South Korea)"
56995,10/1/2022,KOR,Perlis,57,40,17,"Korea, Republic of (South Korea)"
56996,10/1/2022,KOR,Pulau Pinang,373,220,153,"Korea, Republic of (South Korea)"
56997,10/1/2022,KOR,Sabah,6038,2652,3386,"Korea, Republic of (South Korea)"
56998,10/1/2022,KOR,Sarawak,160,87,73,"Korea, Republic of (South Korea)"
56999,10/1/2022,KOR,Selangor,8670,5104,3566,"Korea, Republic of (South Korea)"
57000,10/1/2022,KOR,Terengganu,0,0,0,"Korea, Republic of (South Korea)"
57001,10/1/2022,KOR,W.P. Labuan,0,0,0,"Korea, Republic of (South Korea)"
57002,10/1/2022,KWT,Johor,12,3,9,Kuwait
57003,10/1/2022,KWT,Kedah,3,3,0,Kuwait
57004,10/1/2022,KWT,Kelantan,1,1,0,Kuwait
57005,10/1/2022,KWT,Perak,0,0,0,Kuwait
57006,10/1/2022,KWT,Perlis,0,0,0,Kuwait
57007,10/1/2022,KWT,Pulau Pinang,6,3,3,Kuwait
57008,10/1/2022,KWT,Sabah,0,0,0,Kuwait
57009,10/1/2022,KWT,Sarawak,0,0,0,Kuwait
57010,10/1/2022,KWT,Selangor,294,191,103,Kuwait
57011,10/1/2022,KWT,W.P. Labuan,0,0,0,Kuwait
57012,10/1/2022,LAO,Johor,89,29,60,Lao People's Democratic Republic
57013,10/1/2022,LAO,Kedah,885,93,792,Lao People's Democratic Republic
57014,10/1/2022,LAO,Kelantan,85,5,80,Lao People's Democratic Republic
57015,10/1/2022,LAO,Melaka,0,0,0,Lao People's Democratic Republic
57016,10/1/2022,LAO,Perak,14,1,13,Lao People's Democratic Republic
57017,10/1/2022,LAO,Perlis,135,37,98,Lao People's Democratic Republic
57018,10/1/2022,LAO,Pulau Pinang,16,1,15,Lao People's Democratic Republic
57019,10/1/2022,LAO,Sabah,2,0,2,Lao People's Democratic Republic
57020,10/1/2022,LAO,Sarawak,5,5,0,Lao People's Democratic Republic
57021,10/1/2022,LAO,Selangor,284,124,160,Lao People's Democratic Republic
57022,10/1/2022,LAO,W.P. Labuan,0,0,0,Lao People's Democratic Republic
57023,10/1/2022,LBN,Johor,16,8,8,Lebanon
57024,10/1/2022,LBN,Kedah,5,2,3,Lebanon
57025,10/1/2022,LBN,Kelantan,0,0,0,Lebanon
57026,10/1/2022,LBN,Pahang,0,0,0,Lebanon
57027,10/1/2022,LBN,Perak,0,0,0,Lebanon
57028,10/1/2022,LBN,Perlis,0,0,0,Lebanon
57029,10/1/2022,LBN,Pulau Pinang,5,5,0,Lebanon
57030,10/1/2022,LBN,Sabah,1,1,0,Lebanon
57031,10/1/2022,LBN,Sarawak,1,1,0,Lebanon
57032,10/1/2022,LBN,Selangor,176,123,53,Lebanon
57033,10/1/2022,LBN,W.P. Labuan,0,0,0,Lebanon
57034,10/1/2022,LBR,Johor,1,1,0,Liberia
57035,10/1/2022,LBR,Kedah,0,0,0,Liberia
57036,10/1/2022,LBR,Sabah,1,1,0,Liberia
57037,10/1/2022,LBR,Sarawak,0,0,0,Liberia
57038,10/1/2022,LBR,Selangor,23,17,6,Liberia
57039,10/1/2022,LBY,Johor,0,0,0,Libyan Arab Jamahiriya
57040,10/1/2022,LBY,Kedah,0,0,0,Libyan Arab Jamahiriya
57041,10/1/2022,LBY,Perlis,0,0,0,Libyan Arab Jamahiriya
57042,10/1/2022,LBY,Pulau Pinang,2,2,0,Libyan Arab Jamahiriya
57043,10/1/2022,LBY,Sabah,1,1,0,Libyan Arab Jamahiriya
57044,10/1/2022,LBY,Sarawak,0,0,0,Libyan Arab Jamahiriya
57045,10/1/2022,LBY,Selangor,318,216,102,Libyan Arab Jamahiriya
57046,10/1/2022,LCA,Johor,11,7,4,Saint Lucia
57047,10/1/2022,LCA,Kedah,0,0,0,Saint Lucia
57048,10/1/2022,LCA,Pulau Pinang,0,0,0,Saint Lucia
57049,10/1/2022,LCA,Sarawak,0,0,0,Saint Lucia
57050,10/1/2022,LCA,Selangor,4,4,0,Saint Lucia
57051,10/1/2022,LIE,Johor,3,3,0,Liechtenstein
57052,10/1/2022,LIE,Kedah,0,0,0,Liechtenstein
57053,10/1/2022,LIE,Perlis,0,0,0,Liechtenstein
57054,10/1/2022,LIE,Pulau Pinang,0,0,0,Liechtenstein
57055,10/1/2022,LIE,Sabah,0,0,0,Liechtenstein
57056,10/1/2022,LIE,Sarawak,0,0,0,Liechtenstein
57057,10/1/2022,LIE,Selangor,3,3,0,Liechtenstein
57058,10/1/2022,LKA,Johor,953,689,264,Sri Lanka
57059,10/1/2022,LKA,Kedah,27,15,12,Sri Lanka
57060,10/1/2022,LKA,Kelantan,0,0,0,Sri Lanka
57061,10/1/2022,LKA,Melaka,0,0,0,Sri Lanka
57062,10/1/2022,LKA,Pahang,0,0,0,Sri Lanka
57063,10/1/2022,LKA,Perak,5,3,2,Sri Lanka
57064,10/1/2022,LKA,Perlis,0,0,0,Sri Lanka
57065,10/1/2022,LKA,Pulau Pinang,26,17,9,Sri Lanka
57066,10/1/2022,LKA,Sabah,12,7,5,Sri Lanka
57067,10/1/2022,LKA,Sarawak,20,13,7,Sri Lanka
57068,10/1/2022,LKA,Selangor,2950,1946,1004,Sri Lanka
57069,10/1/2022,LKA,W.P. Labuan,0,0,0,Sri Lanka
57070,10/1/2022,LSO,Johor,0,0,0,Lesotho
57071,10/1/2022,LSO,Kedah,0,0,0,Lesotho
57072,10/1/2022,LSO,Pulau Pinang,0,0,0,Lesotho
57073,10/1/2022,LSO,Sarawak,0,0,0,Lesotho
57074,10/1/2022,LSO,Selangor,1,1,0,Lesotho
57075,10/1/2022,LTU,Johor,34,11,23,Lithuania
57076,10/1/2022,LTU,Kedah,9,4,5,Lithuania
57077,10/1/2022,LTU,Kelantan,0,0,0,Lithuania
57078,10/1/2022,LTU,Pahang,0,0,0,Lithuania
57079,10/1/2022,LTU,Perak,6,2,4,Lithuania
57080,10/1/2022,LTU,Perlis,0,0,0,Lithuania
57081,10/1/2022,LTU,Pulau Pinang,16,7,9,Lithuania
57082,10/1/2022,LTU,Sabah,11,7,4,Lithuania
57083,10/1/2022,LTU,Sarawak,5,2,3,Lithuania
57084,10/1/2022,LTU,Selangor,148,91,57,Lithuania
57085,10/1/2022,LTU,W.P. Labuan,0,0,0,Lithuania
57086,10/1/2022,LUX,Johor,6,2,4,Luxembourg
57087,10/1/2022,LUX,Kedah,2,2,0,Luxembourg
57088,10/1/2022,LUX,Kelantan,0,0,0,Luxembourg
57089,10/1/2022,LUX,Perak,0,0,0,Luxembourg
57090,10/1/2022,LUX,Perlis,0,0,0,Luxembourg
57091,10/1/2022,LUX,Pulau Pinang,2,1,1,Luxembourg
57092,10/1/2022,LUX,Sabah,0,0,0,Luxembourg
57093,10/1/2022,LUX,Sarawak,1,1,0,Luxembourg
57094,10/1/2022,LUX,Selangor,29,18,11,Luxembourg
57095,10/1/2022,LVA,Johor,48,19,29,Latvia
57096,10/1/2022,LVA,Kedah,31,12,19,Latvia
57097,10/1/2022,LVA,Kelantan,0,0,0,Latvia
57098,10/1/2022,LVA,Pahang,0,0,0,Latvia
57099,10/1/2022,LVA,Perak,0,0,0,Latvia
57100,10/1/2022,LVA,Perlis,2,1,1,Latvia
57101,10/1/2022,LVA,Pulau Pinang,5,1,4,Latvia
57102,10/1/2022,LVA,Sabah,5,3,2,Latvia
57103,10/1/2022,LVA,Sarawak,8,4,4,Latvia
57104,10/1/2022,LVA,Selangor,100,44,56,Latvia
57105,10/1/2022,LVA,W.P. Labuan,13,6,7,Latvia
57106,10/1/2022,MAC,Johor,1,0,1,Macao
57107,10/1/2022,MAC,Pahang,0,0,0,Macao
57108,10/1/2022,MAC,Perak,0,0,0,Macao
57109,10/1/2022,MAC,Selangor,3,0,3,Macao
57110,10/1/2022,MAC,W.P. Labuan,0,0,0,Macao
57111,10/1/2022,MAR,Johor,91,57,34,Morocco
57112,10/1/2022,MAR,Kedah,2,1,1,Morocco
57113,10/1/2022,MAR,Kelantan,2,2,0,Morocco
57114,10/1/2022,MAR,Melaka,0,0,0,Morocco
57115,10/1/2022,MAR,Pahang,0,0,0,Morocco
57116,10/1/2022,MAR,Perak,0,0,0,Morocco
57117,10/1/2022,MAR,Perlis,2,2,0,Morocco
57118,10/1/2022,MAR,Pulau Pinang,7,6,1,Morocco
57119,10/1/2022,MAR,Sabah,4,1,3,Morocco
57120,10/1/2022,MAR,Sarawak,4,4,0,Morocco
57121,10/1/2022,MAR,Selangor,880,454,426,Morocco
57122,10/1/2022,MAR,W.P. Labuan,0,0,0,Morocco
57123,10/1/2022,MCO,Johor,0,0,0,Monaco
57124,10/1/2022,MCO,Kedah,0,0,0,Monaco
57125,10/1/2022,MCO,Sabah,0,0,0,Monaco
57126,10/1/2022,MCO,Selangor,2,1,1,Monaco
57127,10/1/2022,MDA,Johor,0,0,0,"Moldova, Republic of"
57128,10/1/2022,MDA,Kedah,0,0,0,"Moldova, Republic of"
57129,10/1/2022,MDA,Kelantan,0,0,0,"Moldova, Republic of"
57130,10/1/2022,MDA,Negeri Sembilan,0,0,0,"Moldova, Republic of"
57131,10/1/2022,MDA,Perlis,0,0,0,"Moldova, Republic of"
57132,10/1/2022,MDA,Pulau Pinang,1,1,0,"Moldova, Republic of"
57133,10/1/2022,MDA,Sabah,0,0,0,"Moldova, Republic of"
57134,10/1/2022,MDA,Sarawak,0,0,0,"Moldova, Republic of"
57135,10/1/2022,MDA,Selangor,16,13,3,"Moldova, Republic of"
57136,10/1/2022,MDG,Johor,5,2,3,Madagascar
57137,10/1/2022,MDG,Kedah,0,0,0,Madagascar
57138,10/1/2022,MDG,Perak,2,0,2,Madagascar
57139,10/1/2022,MDG,Perlis,0,0,0,Madagascar
57140,10/1/2022,MDG,Pulau Pinang,0,0,0,Madagascar
57141,10/1/2022,MDG,Sabah,0,0,0,Madagascar
57142,10/1/2022,MDG,Sarawak,0,0,0,Madagascar
57143,10/1/2022,MDG,Selangor,9,3,6,Madagascar
57144,10/1/2022,MDV,Johor,93,61,32,Maldives
57145,10/1/2022,MDV,Kedah,1,1,0,Maldives
57146,10/1/2022,MDV,Kelantan,0,0,0,Maldives
57147,10/1/2022,MDV,Perak,2,1,1,Maldives
57148,10/1/2022,MDV,Perlis,0,0,0,Maldives
57149,10/1/2022,MDV,Pulau Pinang,3,3,0,Maldives
57150,10/1/2022,MDV,Sabah,0,0,0,Maldives
57151,10/1/2022,MDV,Sarawak,2,2,0,Maldives
57152,10/1/2022,MDV,Selangor,1838,984,854,Maldives
57153,10/1/2022,MEX,Johor,181,77,104,Mexico
57154,10/1/2022,MEX,Kedah,6,1,5,Mexico
57155,10/1/2022,MEX,Kelantan,0,0,0,Mexico
57156,10/1/2022,MEX,Pahang,0,0,0,Mexico
57157,10/1/2022,MEX,Perak,1,0,1,Mexico
57158,10/1/2022,MEX,Perlis,3,2,1,Mexico
57159,10/1/2022,MEX,Pulau Pinang,39,30,9,Mexico
57160,10/1/2022,MEX,Sabah,8,5,3,Mexico
57161,10/1/2022,MEX,Sarawak,7,3,4,Mexico
57162,10/1/2022,MEX,Selangor,550,292,258,Mexico
57163,10/1/2022,MEX,W.P. Labuan,0,0,0,Mexico
57164,10/1/2022,MHL,Johor,0,0,0,Marshall Islands
57165,10/1/2022,MHL,Kedah,1,1,0,Marshall Islands
57166,10/1/2022,MHL,Perak,0,0,0,Marshall Islands
57167,10/1/2022,MHL,Pulau Pinang,0,0,0,Marshall Islands
57168,10/1/2022,MHL,Sabah,0,0,0,Marshall Islands
57169,10/1/2022,MHL,Selangor,3,2,1,Marshall Islands
57170,10/1/2022,MKD,Johor,7,2,5,"Macedonia, the former Yugoslav Republic of"
57171,10/1/2022,MKD,Kedah,0,0,0,"Macedonia, the former Yugoslav Republic of"
57172,10/1/2022,MKD,Perak,2,0,2,"Macedonia, the former Yugoslav Republic of"
57173,10/1/2022,MKD,Pulau Pinang,3,3,0,"Macedonia, the former Yugoslav Republic of"
57174,10/1/2022,MKD,Sabah,0,0,0,"Macedonia, the former Yugoslav Republic of"
57175,10/1/2022,MKD,Sarawak,1,0,1,"Macedonia, the former Yugoslav Republic of"
57176,10/1/2022,MKD,Selangor,30,17,13,"Macedonia, the former Yugoslav Republic of"
57177,10/1/2022,MLI,Johor,0,0,0,Mali
57178,10/1/2022,MLI,Sabah,0,0,0,Mali
57179,10/1/2022,MLI,Selangor,10,7,3,Mali
57180,10/1/2022,MLT,Johor,9,7,2,Malta
57181,10/1/2022,MLT,Kedah,2,2,0,Malta
57182,10/1/2022,MLT,Kelantan,0,0,0,Malta
57183,10/1/2022,MLT,Perak,0,0,0,Malta
57184,10/1/2022,MLT,Perlis,1,1,0,Malta
57185,10/1/2022,MLT,Pulau Pinang,2,2,0,Malta
57186,10/1/2022,MLT,Sabah,0,0,0,Malta
57187,10/1/2022,MLT,Sarawak,0,0,0,Malta
57188,10/1/2022,MLT,Selangor,26,15,11,Malta
57189,10/1/2022,MLT,W.P. Labuan,0,0,0,Malta
57190,10/1/2022,MMR,Johor,3212,914,2298,Myanmar
57191,10/1/2022,MMR,Kedah,46,9,37,Myanmar
57192,10/1/2022,MMR,Kelantan,2,0,2,Myanmar
57193,10/1/2022,MMR,Negeri Sembilan,0,0,0,Myanmar
57194,10/1/2022,MMR,Pahang,0,0,0,Myanmar
57195,10/1/2022,MMR,Perak,15,8,7,Myanmar
57196,10/1/2022,MMR,Perlis,7,3,4,Myanmar
57197,10/1/2022,MMR,Pulau Pinang,112,50,62,Myanmar
57198,10/1/2022,MMR,Sabah,10,2,8,Myanmar
57199,10/1/2022,MMR,Sarawak,38,17,21,Myanmar
57200,10/1/2022,MMR,Selangor,7530,5036,2494,Myanmar
57201,10/1/2022,MMR,Terengganu,0,0,0,Myanmar
57202,10/1/2022,MMR,W.P. Labuan,0,0,0,Myanmar
57203,10/1/2022,MNE,Johor,0,0,0,Montenegro
57204,10/1/2022,MNE,Kedah,0,0,0,Montenegro
57205,10/1/2022,MNE,Pulau Pinang,0,0,0,Montenegro
57206,10/1/2022,MNE,Sabah,0,0,0,Montenegro
57207,10/1/2022,MNE,Sarawak,0,0,0,Montenegro
57208,10/1/2022,MNE,Selangor,11,9,2,Montenegro
57209,10/1/2022,MNG,Johor,87,43,44,Mongolia
57210,10/1/2022,MNG,Kedah,2,0,2,Mongolia
57211,10/1/2022,MNG,Kelantan,0,0,0,Mongolia
57212,10/1/2022,MNG,Perak,0,0,0,Mongolia
57213,10/1/2022,MNG,Perlis,0,0,0,Mongolia
57214,10/1/2022,MNG,Pulau Pinang,5,1,4,Mongolia
57215,10/1/2022,MNG,Sabah,3,2,1,Mongolia
57216,10/1/2022,MNG,Sarawak,2,2,0,Mongolia
57217,10/1/2022,MNG,Selangor,227,104,123,Mongolia
57218,10/1/2022,MNP,Selangor,0,0,0,Northern Mariana Islands
57219,10/1/2022,MOZ,Johor,6,5,1,Mozambique
57220,10/1/2022,MOZ,Kedah,0,0,0,Mozambique
57221,10/1/2022,MOZ,Perak,0,0,0,Mozambique
57222,10/1/2022,MOZ,Pulau Pinang,0,0,0,Mozambique
57223,10/1/2022,MOZ,Sabah,0,0,0,Mozambique
57224,10/1/2022,MOZ,Sarawak,0,0,0,Mozambique
57225,10/1/2022,MOZ,Selangor,20,13,7,Mozambique
57226,10/1/2022,MRT,Johor,0,0,0,Mauritania
57227,10/1/2022,MRT,Kedah,0,0,0,Mauritania
57228,10/1/2022,MRT,Pulau Pinang,0,0,0,Mauritania
57229,10/1/2022,MRT,Sabah,1,1,0,Mauritania
57230,10/1/2022,MRT,Sarawak,0,0,0,Mauritania
57231,10/1/2022,MRT,Selangor,51,47,4,Mauritania
57232,10/1/2022,MUS,Johor,75,42,33,Mauritius
57233,10/1/2022,MUS,Kedah,6,3,3,Mauritius
57234,10/1/2022,MUS,Kelantan,0,0,0,Mauritius
57235,10/1/2022,MUS,Pahang,0,0,0,Mauritius
57236,10/1/2022,MUS,Perak,0,0,0,Mauritius
57237,10/1/2022,MUS,Perlis,0,0,0,Mauritius
57238,10/1/2022,MUS,Pulau Pinang,3,3,0,Mauritius
57239,10/1/2022,MUS,Sabah,0,0,0,Mauritius
57240,10/1/2022,MUS,Sarawak,0,0,0,Mauritius
57241,10/1/2022,MUS,Selangor,266,181,85,Mauritius
57242,10/1/2022,MWI,Johor,0,0,0,Malawi
57243,10/1/2022,MWI,Pulau Pinang,0,0,0,Malawi
57244,10/1/2022,MWI,Sabah,0,0,0,Malawi
57245,10/1/2022,MWI,Sarawak,1,0,1,Malawi
57246,10/1/2022,MWI,Selangor,8,6,2,Malawi
57247,10/1/2022,MYT,Selangor,0,0,0,Mayotte
57248,10/1/2022,NAM,Johor,0,0,0,Namibia
57249,10/1/2022,NAM,Kedah,0,0,0,Namibia
57250,10/1/2022,NAM,Perak,2,1,1,Namibia
57251,10/1/2022,NAM,Perlis,0,0,0,Namibia
57252,10/1/2022,NAM,Pulau Pinang,0,0,0,Namibia
57253,10/1/2022,NAM,Sabah,0,0,0,Namibia
57254,10/1/2022,NAM,Sarawak,0,0,0,Namibia
57255,10/1/2022,NAM,Selangor,18,5,13,Namibia
57256,10/1/2022,NCL,Selangor,0,0,0,New Caledonia
57257,10/1/2022,NER,Johor,0,0,0,Niger
57258,10/1/2022,NER,Sabah,0,0,0,Niger
57259,10/1/2022,NER,Selangor,1,1,0,Niger
57260,10/1/2022,NGA,Johor,26,22,4,Nigeria
57261,10/1/2022,NGA,Kedah,1,1,0,Nigeria
57262,10/1/2022,NGA,Perlis,0,0,0,Nigeria
57263,10/1/2022,NGA,Pulau Pinang,4,4,0,Nigeria
57264,10/1/2022,NGA,Sabah,0,0,0,Nigeria
57265,10/1/2022,NGA,Sarawak,17,10,7,Nigeria
57266,10/1/2022,NGA,Selangor,341,272,69,Nigeria
57267,10/1/2022,NIC,Johor,1,1,0,Nicaragua
57268,10/1/2022,NIC,Kedah,0,0,0,Nicaragua
57269,10/1/2022,NIC,Pulau Pinang,2,1,1,Nicaragua
57270,10/1/2022,NIC,Sabah,0,0,0,Nicaragua
57271,10/1/2022,NIC,Selangor,6,2,4,Nicaragua
57272,10/1/2022,NLD,Johor,986,642,344,Netherlands
57273,10/1/2022,NLD,Kedah,129,69,60,Netherlands
57274,10/1/2022,NLD,Kelantan,1,1,0,Netherlands
57275,10/1/2022,NLD,Melaka,3,2,1,Netherlands
57276,10/1/2022,NLD,Negeri Sembilan,1,1,0,Netherlands
57277,10/1/2022,NLD,Pahang,0,0,0,Netherlands
57278,10/1/2022,NLD,Perak,29,19,10,Netherlands
57279,10/1/2022,NLD,Perlis,33,19,14,Netherlands
57280,10/1/2022,NLD,Pulau Pinang,217,136,81,Netherlands
57281,10/1/2022,NLD,Sabah,96,52,44,Netherlands
57282,10/1/2022,NLD,Sarawak,165,93,72,Netherlands
57283,10/1/2022,NLD,Selangor,2993,1859,1134,Netherlands
57284,10/1/2022,NLD,Terengganu,0,0,0,Netherlands
57285,10/1/2022,NLD,W.P. Labuan,3,1,2,Netherlands
57286,10/1/2022,NOR,Johor,180,120,60,Norway
57287,10/1/2022,NOR,Kedah,25,13,12,Norway
57288,10/1/2022,NOR,Kelantan,0,0,0,Norway
57289,10/1/2022,NOR,Melaka,0,0,0,Norway
57290,10/1/2022,NOR,Pahang,0,0,0,Norway
57291,10/1/2022,NOR,Perak,0,0,0,Norway
57292,10/1/2022,NOR,Perlis,7,5,2,Norway
57293,10/1/2022,NOR,Pulau Pinang,17,11,6,Norway
57294,10/1/2022,NOR,Sabah,8,6,2,Norway
57295,10/1/2022,NOR,Sarawak,14,11,3,Norway
57296,10/1/2022,NOR,Selangor,544,355,189,Norway
57297,10/1/2022,NOR,W.P. Labuan,0,0,0,Norway
57298,10/1/2022,NPL,Johor,590,344,246,Nepal
57299,10/1/2022,NPL,Kedah,7,7,0,Nepal
57300,10/1/2022,NPL,Pahang,0,0,0,Nepal
57301,10/1/2022,NPL,Perak,0,0,0,Nepal
57302,10/1/2022,NPL,Perlis,1,1,0,Nepal
57303,10/1/2022,NPL,Pulau Pinang,27,18,9,Nepal
57304,10/1/2022,NPL,Sabah,1,1,0,Nepal
57305,10/1/2022,NPL,Sarawak,144,99,45,Nepal
57306,10/1/2022,NPL,Selangor,17666,16936,730,Nepal
57307,10/1/2022,NPL,W.P. Labuan,54,54,0,Nepal
57308,10/1/2022,NRU,Johor,0,0,0,Nauru
57309,10/1/2022,NRU,Pulau Pinang,0,0,0,Nauru
57310,10/1/2022,NRU,Selangor,2,2,0,Nauru
57311,10/1/2022,NZL,Johor,668,395,273,New Zealand
57312,10/1/2022,NZL,Kedah,56,30,26,New Zealand
57313,10/1/2022,NZL,Kelantan,1,1,0,New Zealand
57314,10/1/2022,NZL,Melaka,1,1,0,New Zealand
57315,10/1/2022,NZL,Negeri Sembilan,0,0,0,New Zealand
57316,10/1/2022,NZL,Pahang,4,2,2,New Zealand
57317,10/1/2022,NZL,Perak,19,8,11,New Zealand
57318,10/1/2022,NZL,Perlis,10,6,4,New Zealand
57319,10/1/2022,NZL,Pulau Pinang,157,93,64,New Zealand
57320,10/1/2022,NZL,Sabah,69,35,34,New Zealand
57321,10/1/2022,NZL,Sarawak,105,57,48,New Zealand
57322,10/1/2022,NZL,Selangor,1990,1247,743,New Zealand
57323,10/1/2022,NZL,Terengganu,0,0,0,New Zealand
57324,10/1/2022,NZL,W.P. Labuan,7,4,3,New Zealand
57325,10/1/2022,OMN,Johor,37,17,20,Oman
57326,10/1/2022,OMN,Kedah,2,2,0,Oman
57327,10/1/2022,OMN,Kelantan,0,0,0,Oman
57328,10/1/2022,OMN,Melaka,0,0,0,Oman
57329,10/1/2022,OMN,Perak,0,0,0,Oman
57330,10/1/2022,OMN,Perlis,0,0,0,Oman
57331,10/1/2022,OMN,Pulau Pinang,4,2,2,Oman
57332,10/1/2022,OMN,Sabah,2,0,2,Oman
57333,10/1/2022,OMN,Sarawak,28,15,13,Oman
57334,10/1/2022,OMN,Selangor,852,670,182,Oman
57335,10/1/2022,PAK,Johor,653,495,158,Pakistan
57336,10/1/2022,PAK,Kedah,76,67,9,Pakistan
57337,10/1/2022,PAK,Kelantan,12,12,0,Pakistan
57338,10/1/2022,PAK,Melaka,0,0,0,Pakistan
57339,10/1/2022,PAK,Negeri Sembilan,0,0,0,Pakistan
57340,10/1/2022,PAK,Pahang,0,0,0,Pakistan
57341,10/1/2022,PAK,Perak,39,37,2,Pakistan
57342,10/1/2022,PAK,Perlis,27,23,4,Pakistan
57343,10/1/2022,PAK,Pulau Pinang,44,43,1,Pakistan
57344,10/1/2022,PAK,Sabah,8,7,1,Pakistan
57345,10/1/2022,PAK,Sarawak,94,67,27,Pakistan
57346,10/1/2022,PAK,Selangor,9561,8528,1033,Pakistan
57347,10/1/2022,PAK,W.P. Labuan,8,6,2,Pakistan
57348,10/1/2022,PAN,Johor,5,3,2,Panama
57349,10/1/2022,PAN,Kedah,1,0,1,Panama
57350,10/1/2022,PAN,Perak,0,0,0,Panama
57351,10/1/2022,PAN,Perlis,0,0,0,Panama
57352,10/1/2022,PAN,Pulau Pinang,1,0,1,Panama
57353,10/1/2022,PAN,Sabah,0,0,0,Panama
57354,10/1/2022,PAN,Sarawak,2,0,2,Panama
57355,10/1/2022,PAN,Selangor,18,12,6,Panama
57356,10/1/2022,PER,Johor,45,25,20,Peru
57357,10/1/2022,PER,Kedah,4,1,3,Peru
57358,10/1/2022,PER,Kelantan,0,0,0,Peru
57359,10/1/2022,PER,Pahang,0,0,0,Peru
57360,10/1/2022,PER,Perak,0,0,0,Peru
57361,10/1/2022,PER,Perlis,0,0,0,Peru
57362,10/1/2022,PER,Pulau Pinang,1,1,0,Peru
57363,10/1/2022,PER,Sabah,0,0,0,Peru
57364,10/1/2022,PER,Sarawak,3,1,2,Peru
57365,10/1/2022,PER,Selangor,67,33,34,Peru
57366,10/1/2022,PER,W.P. Labuan,0,0,0,Peru
57367,10/1/2022,PHL,Johor,16343,5190,11153,Philippines
57368,10/1/2022,PHL,Kedah,407,162,245,Philippines
57369,10/1/2022,PHL,Kelantan,11,6,5,Philippines
57370,10/1/2022,PHL,Melaka,0,0,0,Philippines
57371,10/1/2022,PHL,Negeri Sembilan,0,0,0,Philippines
57372,10/1/2022,PHL,Pahang,4,4,0,Philippines
57373,10/1/2022,PHL,Perak,42,18,24,Philippines
57374,10/1/2022,PHL,Perlis,169,62,107,Philippines
57375,10/1/2022,PHL,Pulau Pinang,376,140,236,Philippines
57376,10/1/2022,PHL,Sabah,1117,521,596,Philippines
57377,10/1/2022,PHL,Sarawak,1061,406,655,Philippines
57378,10/1/2022,PHL,Selangor,15278,6319,8959,Philippines
57379,10/1/2022,PHL,Terengganu,0,0,0,Philippines
57380,10/1/2022,PHL,W.P. Labuan,38,15,23,Philippines
57381,10/1/2022,PLW,Johor,0,0,0,Palau
57382,10/1/2022,PLW,Pulau Pinang,0,0,0,Palau
57383,10/1/2022,PLW,Selangor,3,2,1,Palau
57384,10/1/2022,PNG,Johor,15,11,4,Papua New Guinea
57385,10/1/2022,PNG,Kedah,0,0,0,Papua New Guinea
57386,10/1/2022,PNG,Kelantan,0,0,0,Papua New Guinea
57387,10/1/2022,PNG,Perak,0,0,0,Papua New Guinea
57388,10/1/2022,PNG,Pulau Pinang,1,0,1,Papua New Guinea
57389,10/1/2022,PNG,Sabah,0,0,0,Papua New Guinea
57390,10/1/2022,PNG,Sarawak,3,2,1,Papua New Guinea
57391,10/1/2022,PNG,Selangor,42,25,17,Papua New Guinea
57392,10/1/2022,POL,Johor,452,262,190,Poland
57393,10/1/2022,POL,Kedah,50,20,30,Poland
57394,10/1/2022,POL,Kelantan,0,0,0,Poland
57395,10/1/2022,POL,Melaka,0,0,0,Poland
57396,10/1/2022,POL,Negeri Sembilan,0,0,0,Poland
57397,10/1/2022,POL,Pahang,0,0,0,Poland
57398,10/1/2022,POL,Perak,1,0,1,Poland
57399,10/1/2022,POL,Perlis,6,4,2,Poland
57400,10/1/2022,POL,Pulau Pinang,46,23,23,Poland
57401,10/1/2022,POL,Sabah,12,6,6,Poland
57402,10/1/2022,POL,Sarawak,20,12,8,Poland
57403,10/1/2022,POL,Selangor,834,482,352,Poland
57404,10/1/2022,POL,Terengganu,0,0,0,Poland
57405,10/1/2022,POL,W.P. Labuan,4,3,1,Poland
57406,10/1/2022,PRK,Selangor,0,0,0,"Korea, Democratic People's Republic of"
57407,10/1/2022,PRT,Johor,137,67,70,Portugal
57408,10/1/2022,PRT,Kedah,17,10,7,Portugal
57409,10/1/2022,PRT,Kelantan,1,1,0,Portugal
57410,10/1/2022,PRT,Melaka,0,0,0,Portugal
57411,10/1/2022,PRT,Pahang,0,0,0,Portugal
57412,10/1/2022,PRT,Perak,2,2,0,Portugal
57413,10/1/2022,PRT,Perlis,1,1,0,Portugal
57414,10/1/2022,PRT,Pulau Pinang,25,14,11,Portugal
57415,10/1/2022,PRT,Sabah,24,13,11,Portugal
57416,10/1/2022,PRT,Sarawak,9,6,3,Portugal
57417,10/1/2022,PRT,Selangor,564,356,208,Portugal
57418,10/1/2022,PRT,W.P. Labuan,2,1,1,Portugal
57419,10/1/2022,PRY,Johor,2,1,1,Paraguay
57420,10/1/2022,PRY,Kedah,0,0,0,Paraguay
57421,10/1/2022,PRY,Perak,2,1,1,Paraguay
57422,10/1/2022,PRY,Perlis,0,0,0,Paraguay
57423,10/1/2022,PRY,Pulau Pinang,0,0,0,Paraguay
57424,10/1/2022,PRY,Sabah,4,3,1,Paraguay
57425,10/1/2022,PRY,Sarawak,0,0,0,Paraguay
57426,10/1/2022,PRY,Selangor,4,3,1,Paraguay
57427,10/1/2022,PSE,Johor,7,3,4,"Palestinian Territory, Occupied"
57428,10/1/2022,PSE,Kedah,0,0,0,"Palestinian Territory, Occupied"
57429,10/1/2022,PSE,Kelantan,0,0,0,"Palestinian Territory, Occupied"
57430,10/1/2022,PSE,Melaka,0,0,0,"Palestinian Territory, Occupied"
57431,10/1/2022,PSE,Perak,0,0,0,"Palestinian Territory, Occupied"
57432,10/1/2022,PSE,Perlis,0,0,0,"Palestinian Territory, Occupied"
57433,10/1/2022,PSE,Pulau Pinang,1,1,0,"Palestinian Territory, Occupied"
57434,10/1/2022,PSE,Sabah,0,0,0,"Palestinian Territory, Occupied"
57435,10/1/2022,PSE,Sarawak,1,1,0,"Palestinian Territory, Occupied"
57436,10/1/2022,PSE,Selangor,299,212,87,"Palestinian Territory, Occupied"
57437,10/1/2022,QAT,Johor,2,0,2,Qatar
57438,10/1/2022,QAT,Kedah,0,0,0,Qatar
57439,10/1/2022,QAT,Perlis,0,0,0,Qatar
57440,10/1/2022,QAT,Pulau Pinang,0,0,0,Qatar
57441,10/1/2022,QAT,Sabah,0,0,0,Qatar
57442,10/1/2022,QAT,Sarawak,2,1,1,Qatar
57443,10/1/2022,QAT,Selangor,81,66,15,Qatar
57444,10/1/2022,REU,Johor,0,0,0,Reunion
57445,10/1/2022,REU,Sarawak,0,0,0,Reunion
57446,10/1/2022,ROU,Johor,114,55,59,Romania
57447,10/1/2022,ROU,Kedah,10,6,4,Romania
57448,10/1/2022,ROU,Kelantan,0,0,0,Romania
57449,10/1/2022,ROU,Negeri Sembilan,0,0,0,Romania
57450,10/1/2022,ROU,Pahang,0,0,0,Romania
57451,10/1/2022,ROU,Perak,6,3,3,Romania
57452,10/1/2022,ROU,Perlis,1,1,0,Romania
57453,10/1/2022,ROU,Pulau Pinang,13,7,6,Romania
57454,10/1/2022,ROU,Sabah,2,1,1,Romania
57455,10/1/2022,ROU,Sarawak,4,1,3,Romania
57456,10/1/2022,ROU,Selangor,564,304,260,Romania
57457,10/1/2022,ROU,W.P. Labuan,0,0,0,Romania
57458,10/1/2022,RUS,Johor,303,168,135,Russia
57459,10/1/2022,RUS,Kedah,537,274,263,Russia
57460,10/1/2022,RUS,Kelantan,38,24,14,Russia
57461,10/1/2022,RUS,Melaka,0,0,0,Russia
57462,10/1/2022,RUS,Negeri Sembilan,0,0,0,Russia
57463,10/1/2022,RUS,Pahang,2,0,2,Russia
57464,10/1/2022,RUS,Perak,3,0,3,Russia
57465,10/1/2022,RUS,Perlis,141,75,66,Russia
57466,10/1/2022,RUS,Pulau Pinang,287,162,125,Russia
57467,10/1/2022,RUS,Sabah,23,11,12,Russia
57468,10/1/2022,RUS,Sarawak,55,28,27,Russia
57469,10/1/2022,RUS,Selangor,4728,2680,2048,Russia
57470,10/1/2022,RUS,W.P. Labuan,0,0,0,Russia
57471,10/1/2022,RWA,Johor,0,0,0,Rwanda
57472,10/1/2022,RWA,Kedah,0,0,0,Rwanda
57473,10/1/2022,RWA,Pulau Pinang,0,0,0,Rwanda
57474,10/1/2022,RWA,Selangor,13,9,4,Rwanda
57475,10/1/2022,SAU,Johor,114,70,44,Saudi Arabia
57476,10/1/2022,SAU,Kedah,7,5,2,Saudi Arabia
57477,10/1/2022,SAU,Kelantan,10,6,4,Saudi Arabia
57478,10/1/2022,SAU,Melaka,2,2,0,Saudi Arabia
57479,10/1/2022,SAU,Perak,0,0,0,Saudi Arabia
57480,10/1/2022,SAU,Perlis,9,9,0,Saudi Arabia
57481,10/1/2022,SAU,Pulau Pinang,16,10,6,Saudi Arabia
57482,10/1/2022,SAU,Sabah,1,1,0,Saudi Arabia
57483,10/1/2022,SAU,Sarawak,17,14,3,Saudi Arabia
57484,10/1/2022,SAU,Selangor,2696,1653,1043,Saudi Arabia
57485,10/1/2022,SAU,W.P. Labuan,0,0,0,Saudi Arabia
57486,10/1/2022,SDN,Johor,6,6,0,Sudan
57487,10/1/2022,SDN,Kedah,1,1,0,Sudan
57488,10/1/2022,SDN,Kelantan,0,0,0,Sudan
57489,10/1/2022,SDN,Perlis,0,0,0,Sudan
57490,10/1/2022,SDN,Pulau Pinang,1,1,0,Sudan
57491,10/1/2022,SDN,Sabah,0,0,0,Sudan
57492,10/1/2022,SDN,Sarawak,2,1,1,Sudan
57493,10/1/2022,SDN,Selangor,804,480,324,Sudan
57494,10/1/2022,SDN,W.P. Labuan,1,1,0,Sudan
57495,10/1/2022,SEN,Johor,2,1,1,Senegal
57496,10/1/2022,SEN,Kedah,0,0,0,Senegal
57497,10/1/2022,SEN,Kelantan,0,0,0,Senegal
57498,10/1/2022,SEN,Perak,1,0,1,Senegal
57499,10/1/2022,SEN,Perlis,0,0,0,Senegal
57500,10/1/2022,SEN,Pulau Pinang,0,0,0,Senegal
57501,10/1/2022,SEN,Sabah,1,1,0,Senegal
57502,10/1/2022,SEN,Sarawak,0,0,0,Senegal
57503,10/1/2022,SEN,Selangor,40,30,10,Senegal
57504,10/1/2022,SGP,Johor,990235,571806,418429,Singapore
57505,10/1/2022,SGP,Kedah,3016,1647,1369,Singapore
57506,10/1/2022,SGP,Kelantan,43,33,10,Singapore
57507,10/1/2022,SGP,Melaka,11,9,2,Singapore
57508,10/1/2022,SGP,Negeri Sembilan,66,28,38,Singapore
57509,10/1/2022,SGP,Pahang,67,43,24,Singapore
57510,10/1/2022,SGP,Perak,4463,2066,2397,Singapore
57511,10/1/2022,SGP,Perlis,270,194,76,Singapore
57512,10/1/2022,SGP,Pulau Pinang,12616,6245,6371,Singapore
57513,10/1/2022,SGP,Sabah,2754,1367,1387,Singapore
57514,10/1/2022,SGP,Sarawak,3125,1814,1311,Singapore
57515,10/1/2022,SGP,Selangor,47043,23617,23426,Singapore
57516,10/1/2022,SGP,Terengganu,0,0,0,Singapore
57517,10/1/2022,SGP,W.P. Labuan,17,12,5,Singapore
57518,10/1/2022,SGS,Johor,0,0,0,South Georgia and the South Sandwich Islands
57519,10/1/2022,SGS,Sabah,0,0,0,South Georgia and the South Sandwich Islands
57520,10/1/2022,SGS,Selangor,0,0,0,South Georgia and the South Sandwich Islands
57521,10/1/2022,SHN,Sarawak,0,0,0,"Saint Helena, Ascension and Tristan da Cunha"
57522,10/1/2022,SLB,Johor,2,2,0,Solomon Islands
57523,10/1/2022,SLB,Perlis,0,0,0,Solomon Islands
57524,10/1/2022,SLB,Pulau Pinang,0,0,0,Solomon Islands
57525,10/1/2022,SLB,Sabah,2,2,0,Solomon Islands
57526,10/1/2022,SLB,Sarawak,1,1,0,Solomon Islands
57527,10/1/2022,SLB,Selangor,5,3,2,Solomon Islands
57528,10/1/2022,SLB,W.P. Labuan,0,0,0,Solomon Islands
57529,10/1/2022,SLE,Johor,2,0,2,Sierra Leone
57530,10/1/2022,SLE,Kedah,0,0,0,Sierra Leone
57531,10/1/2022,SLE,Perak,1,1,0,Sierra Leone
57532,10/1/2022,SLE,Pulau Pinang,1,1,0,Sierra Leone
57533,10/1/2022,SLE,Sabah,0,0,0,Sierra Leone
57534,10/1/2022,SLE,Selangor,17,12,5,Sierra Leone
57535,10/1/2022,SLV,Johor,3,1,2,El Salvador
57536,10/1/2022,SLV,Kedah,0,0,0,El Salvador
57537,10/1/2022,SLV,Perak,1,1,0,El Salvador
57538,10/1/2022,SLV,Perlis,0,0,0,El Salvador
57539,10/1/2022,SLV,Pulau Pinang,1,1,0,El Salvador
57540,10/1/2022,SLV,Sabah,0,0,0,El Salvador
57541,10/1/2022,SLV,Selangor,7,3,4,El Salvador
57542,10/1/2022,SLV,W.P. Labuan,0,0,0,El Salvador
57543,10/1/2022,SMR,Johor,0,0,0,San Marino
57544,10/1/2022,SMR,Selangor,2,2,0,San Marino
57545,10/1/2022,SOM,Johor,3,3,0,Somalia
57546,10/1/2022,SOM,Kedah,0,0,0,Somalia
57547,10/1/2022,SOM,Kelantan,0,0,0,Somalia
57548,10/1/2022,SOM,Perlis,0,0,0,Somalia
57549,10/1/2022,SOM,Sabah,0,0,0,Somalia
57550,10/1/2022,SOM,Sarawak,0,0,0,Somalia
57551,10/1/2022,SOM,Selangor,262,171,91,Somalia
57552,10/1/2022,SRB,Johor,8,6,2,Serbia
57553,10/1/2022,SRB,Kedah,2,1,1,Serbia
57554,10/1/2022,SRB,Kelantan,0,0,0,Serbia
57555,10/1/2022,SRB,Pahang,0,0,0,Serbia
57556,10/1/2022,SRB,Perak,1,0,1,Serbia
57557,10/1/2022,SRB,Perlis,0,0,0,Serbia
57558,10/1/2022,SRB,Pulau Pinang,2,1,1,Serbia
57559,10/1/2022,SRB,Sabah,0,0,0,Serbia
57560,10/1/2022,SRB,Sarawak,1,1,0,Serbia
57561,10/1/2022,SRB,Selangor,59,28,31,Serbia
57562,10/1/2022,STP,Selangor,0,0,0,Sao Tome and Principe
57563,10/1/2022,SUR,Johor,17,6,11,Suriname
57564,10/1/2022,SUR,Kedah,0,0,0,Suriname
57565,10/1/2022,SUR,Kelantan,0,0,0,Suriname
57566,10/1/2022,SUR,Perak,0,0,0,Suriname
57567,10/1/2022,SUR,Perlis,0,0,0,Suriname
57568,10/1/2022,SUR,Pulau Pinang,1,1,0,Suriname
57569,10/1/2022,SUR,Sabah,0,0,0,Suriname
57570,10/1/2022,SUR,Sarawak,0,0,0,Suriname
57571,10/1/2022,SUR,Selangor,26,12,14,Suriname
57572,10/1/2022,SVK,Johor,21,11,10,Slovakia
57573,10/1/2022,SVK,Kedah,35,18,17,Slovakia
57574,10/1/2022,SVK,Kelantan,0,0,0,Slovakia
57575,10/1/2022,SVK,Negeri Sembilan,0,0,0,Slovakia
57576,10/1/2022,SVK,Pahang,0,0,0,Slovakia
57577,10/1/2022,SVK,Perak,0,0,0,Slovakia
57578,10/1/2022,SVK,Perlis,2,1,1,Slovakia
57579,10/1/2022,SVK,Pulau Pinang,10,8,2,Slovakia
57580,10/1/2022,SVK,Sabah,4,2,2,Slovakia
57581,10/1/2022,SVK,Sarawak,5,1,4,Slovakia
57582,10/1/2022,SVK,Selangor,199,121,78,Slovakia
57583,10/1/2022,SVK,W.P. Labuan,0,0,0,Slovakia
57584,10/1/2022,SVN,Johor,14,9,5,Slovenia
57585,10/1/2022,SVN,Kedah,7,6,1,Slovenia
57586,10/1/2022,SVN,Kelantan,0,0,0,Slovenia
57587,10/1/2022,SVN,Perak,1,0,1,Slovenia
57588,10/1/2022,SVN,Perlis,0,0,0,Slovenia
57589,10/1/2022,SVN,Pulau Pinang,7,5,2,Slovenia
57590,10/1/2022,SVN,Sabah,4,2,2,Slovenia
57591,10/1/2022,SVN,Sarawak,1,0,1,Slovenia
57592,10/1/2022,SVN,Selangor,59,37,22,Slovenia
57593,10/1/2022,SVN,W.P. Labuan,0,0,0,Slovenia
57594,10/1/2022,SWE,Johor,225,125,100,Sweden
57595,10/1/2022,SWE,Kedah,65,29,36,Sweden
57596,10/1/2022,SWE,Kelantan,2,2,0,Sweden
57597,10/1/2022,SWE,Melaka,0,0,0,Sweden
57598,10/1/2022,SWE,Negeri Sembilan,1,1,0,Sweden
57599,10/1/2022,SWE,Pahang,0,0,0,Sweden
57600,10/1/2022,SWE,Perak,5,3,2,Sweden
57601,10/1/2022,SWE,Perlis,11,6,5,Sweden
57602,10/1/2022,SWE,Pulau Pinang,76,54,22,Sweden
57603,10/1/2022,SWE,Sabah,13,9,4,Sweden
57604,10/1/2022,SWE,Sarawak,21,14,7,Sweden
57605,10/1/2022,SWE,Selangor,805,492,313,Sweden
57606,10/1/2022,SWE,W.P. Labuan,0,0,0,Sweden
57607,10/1/2022,SWZ,Johor,1,1,0,Swaziland
57608,10/1/2022,SWZ,Kedah,0,0,0,Swaziland
57609,10/1/2022,SWZ,Pulau Pinang,0,0,0,Swaziland
57610,10/1/2022,SWZ,Sabah,0,0,0,Swaziland
57611,10/1/2022,SWZ,Selangor,12,5,7,Swaziland
57612,10/1/2022,SYC,Johor,3,2,1,Seychelles
57613,10/1/2022,SYC,Kedah,0,0,0,Seychelles
57614,10/1/2022,SYC,Pulau Pinang,2,1,1,Seychelles
57615,10/1/2022,SYC,Sabah,0,0,0,Seychelles
57616,10/1/2022,SYC,Sarawak,2,2,0,Seychelles
57617,10/1/2022,SYC,Selangor,32,12,20,Seychelles
57618,10/1/2022,SYR,Johor,11,6,5,Syrian Arab Republic
57619,10/1/2022,SYR,Kedah,4,3,1,Syrian Arab Republic
57620,10/1/2022,SYR,Kelantan,0,0,0,Syrian Arab Republic
57621,10/1/2022,SYR,Pahang,2,2,0,Syrian Arab Republic
57622,10/1/2022,SYR,Perlis,2,1,1,Syrian Arab Republic
57623,10/1/2022,SYR,Pulau Pinang,1,1,0,Syrian Arab Republic
57624,10/1/2022,SYR,Sabah,0,0,0,Syrian Arab Republic
57625,10/1/2022,SYR,Sarawak,9,5,4,Syrian Arab Republic
57626,10/1/2022,SYR,Selangor,582,367,215,Syrian Arab Republic
57627,10/1/2022,SYR,W.P. Labuan,0,0,0,Syrian Arab Republic
57628,10/1/2022,TCA,Perlis,0,0,0,Turks and Caicos
57629,10/1/2022,TCD,Johor,2,2,0,Chad
57630,10/1/2022,TCD,Kedah,0,0,0,Chad
57631,10/1/2022,TCD,Perlis,0,0,0,Chad
57632,10/1/2022,TCD,Selangor,8,6,2,Chad
57633,10/1/2022,TGO,Johor,0,0,0,Togo
57634,10/1/2022,TGO,Perak,2,2,0,Togo
57635,10/1/2022,TGO,Pulau Pinang,0,0,0,Togo
57636,10/1/2022,TGO,Selangor,14,12,2,Togo
57637,10/1/2022,THA,Johor,7708,2249,5459,Thailand
57638,10/1/2022,THA,Kedah,62507,36255,26252,Thailand
57639,10/1/2022,THA,Kelantan,36906,18909,17997,Thailand
57640,10/1/2022,THA,Melaka,10,4,6,Thailand
57641,10/1/2022,THA,Negeri Sembilan,2,1,1,Thailand
57642,10/1/2022,THA,Pahang,27,21,6,Thailand
57643,10/1/2022,THA,Perak,8355,3861,4494,Thailand
57644,10/1/2022,THA,Perlis,55003,32227,22776,Thailand
57645,10/1/2022,THA,Pulau Pinang,2396,978,1418,Thailand
57646,10/1/2022,THA,Sabah,217,68,149,Thailand
57647,10/1/2022,THA,Sarawak,236,83,153,Thailand
57648,10/1/2022,THA,Selangor,12515,5152,7363,Thailand
57649,10/1/2022,THA,Terengganu,1,0,1,Thailand
57650,10/1/2022,THA,W.P. Labuan,5,4,1,Thailand
57651,10/1/2022,TJK,Johor,7,7,0,Tajikistan
57652,10/1/2022,TJK,Kedah,2,2,0,Tajikistan
57653,10/1/2022,TJK,Perlis,0,0,0,Tajikistan
57654,10/1/2022,TJK,Pulau Pinang,1,0,1,Tajikistan
57655,10/1/2022,TJK,Sabah,0,0,0,Tajikistan
57656,10/1/2022,TJK,Selangor,110,88,22,Tajikistan
57657,10/1/2022,TKL,Selangor,0,0,0,Tokelau
57658,10/1/2022,TKM,Johor,1,0,1,Turkmenistan
57659,10/1/2022,TKM,Kedah,2,1,1,Turkmenistan
57660,10/1/2022,TKM,Kelantan,0,0,0,Turkmenistan
57661,10/1/2022,TKM,Perlis,0,0,0,Turkmenistan
57662,10/1/2022,TKM,Pulau Pinang,0,0,0,Turkmenistan
57663,10/1/2022,TKM,Sabah,0,0,0,Turkmenistan
57664,10/1/2022,TKM,Sarawak,0,0,0,Turkmenistan
57665,10/1/2022,TKM,Selangor,54,32,22,Turkmenistan
57666,10/1/2022,TLS,Johor,37,33,4,Timor-Leste
57667,10/1/2022,TLS,Kedah,1,1,0,Timor-Leste
57668,10/1/2022,TLS,Perlis,0,0,0,Timor-Leste
57669,10/1/2022,TLS,Pulau Pinang,3,1,2,Timor-Leste
57670,10/1/2022,TLS,Sabah,0,0,0,Timor-Leste
57671,10/1/2022,TLS,Sarawak,1,0,1,Timor-Leste
57672,10/1/2022,TLS,Selangor,212,132,80,Timor-Leste
57673,10/1/2022,TON,Johor,2,1,1,Tonga
57674,10/1/2022,TON,Pulau Pinang,1,0,1,Tonga
57675,10/1/2022,TON,Sarawak,0,0,0,Tonga
57676,10/1/2022,TON,Selangor,11,6,5,Tonga
57677,10/1/2022,TTO,Johor,5,2,3,Trinidad and Tobago
57678,10/1/2022,TTO,Kedah,0,0,0,Trinidad and Tobago
57679,10/1/2022,TTO,Pahang,0,0,0,Trinidad and Tobago
57680,10/1/2022,TTO,Pulau Pinang,0,0,0,Trinidad and Tobago
57681,10/1/2022,TTO,Sabah,0,0,0,Trinidad and Tobago
57682,10/1/2022,TTO,Sarawak,2,2,0,Trinidad and Tobago
57683,10/1/2022,TTO,Selangor,40,32,8,Trinidad and Tobago
57684,10/1/2022,TUN,Johor,9,5,4,Tunisia
57685,10/1/2022,TUN,Kedah,2,0,2,Tunisia
57686,10/1/2022,TUN,Kelantan,0,0,0,Tunisia
57687,10/1/2022,TUN,Melaka,0,0,0,Tunisia
57688,10/1/2022,TUN,Perak,0,0,0,Tunisia
57689,10/1/2022,TUN,Perlis,2,2,0,Tunisia
57690,10/1/2022,TUN,Pulau Pinang,4,3,1,Tunisia
57691,10/1/2022,TUN,Sabah,0,0,0,Tunisia
57692,10/1/2022,TUN,Sarawak,0,0,0,Tunisia
57693,10/1/2022,TUN,Selangor,445,267,178,Tunisia
57694,10/1/2022,TUN,W.P. Labuan,0,0,0,Tunisia
57695,10/1/2022,TUR,Johor,200,142,58,Turkey
57696,10/1/2022,TUR,Kedah,29,26,3,Turkey
57697,10/1/2022,TUR,Kelantan,4,4,0,Turkey
57698,10/1/2022,TUR,Melaka,1,1,0,Turkey
57699,10/1/2022,TUR,Negeri Sembilan,0,0,0,Turkey
57700,10/1/2022,TUR,Pahang,0,0,0,Turkey
57701,10/1/2022,TUR,Perak,1,0,1,Turkey
57702,10/1/2022,TUR,Perlis,10,5,5,Turkey
57703,10/1/2022,TUR,Pulau Pinang,19,8,11,Turkey
57704,10/1/2022,TUR,Sabah,10,5,5,Turkey
57705,10/1/2022,TUR,Sarawak,17,11,6,Turkey
57706,10/1/2022,TUR,Selangor,1055,735,320,Turkey
57707,10/1/2022,TUR,W.P. Labuan,0,0,0,Turkey
57708,10/1/2022,TUV,Selangor,0,0,0,Tuvalu
57709,10/1/2022,TWN,Johor,2694,1166,1528,Taiwan
57710,10/1/2022,TWN,Kedah,53,33,20,Taiwan
57711,10/1/2022,TWN,Kelantan,1,1,0,Taiwan
57712,10/1/2022,TWN,Melaka,2,1,1,Taiwan
57713,10/1/2022,TWN,Negeri Sembilan,0,0,0,Taiwan
57714,10/1/2022,TWN,Pahang,1,0,1,Taiwan
57715,10/1/2022,TWN,Perak,27,9,18,Taiwan
57716,10/1/2022,TWN,Perlis,12,9,3,Taiwan
57717,10/1/2022,TWN,Pulau Pinang,742,462,280,Taiwan
57718,10/1/2022,TWN,Sabah,61,27,34,Taiwan
57719,10/1/2022,TWN,Sarawak,152,70,82,Taiwan
57720,10/1/2022,TWN,Selangor,4927,2620,2307,Taiwan
57721,10/1/2022,TWN,W.P. Labuan,0,0,0,Taiwan
57722,10/1/2022,TZA,Johor,15,11,4,"Tanzania, United Republic of"
57723,10/1/2022,TZA,Kedah,0,0,0,"Tanzania, United Republic of"
57724,10/1/2022,TZA,Perak,1,1,0,"Tanzania, United Republic of"
57725,10/1/2022,TZA,Perlis,0,0,0,"Tanzania, United Republic of"
57726,10/1/2022,TZA,Pulau Pinang,1,1,0,"Tanzania, United Republic of"
57727,10/1/2022,TZA,Sabah,0,0,0,"Tanzania, United Republic of"
57728,10/1/2022,TZA,Sarawak,0,0,0,"Tanzania, United Republic of"
57729,10/1/2022,TZA,Selangor,173,100,73,"Tanzania, United Republic of"
57730,10/1/2022,UGA,Johor,10,7,3,Uganda
57731,10/1/2022,UGA,Kedah,3,1,2,Uganda
57732,10/1/2022,UGA,Perak,2,1,1,Uganda
57733,10/1/2022,UGA,Perlis,3,1,2,Uganda
57734,10/1/2022,UGA,Pulau Pinang,1,0,1,Uganda
57735,10/1/2022,UGA,Sabah,0,0,0,Uganda
57736,10/1/2022,UGA,Sarawak,0,0,0,Uganda
57737,10/1/2022,UGA,Selangor,88,45,43,Uganda
57738,10/1/2022,UKR,Johor,96,64,32,Ukraine
57739,10/1/2022,UKR,Kedah,30,13,17,Ukraine
57740,10/1/2022,UKR,Kelantan,0,0,0,Ukraine
57741,10/1/2022,UKR,Melaka,0,0,0,Ukraine
57742,10/1/2022,UKR,Negeri Sembilan,0,0,0,Ukraine
57743,10/1/2022,UKR,Pahang,1,1,0,Ukraine
57744,10/1/2022,UKR,Perak,1,1,0,Ukraine
57745,10/1/2022,UKR,Perlis,21,11,10,Ukraine
57746,10/1/2022,UKR,Pulau Pinang,19,7,12,Ukraine
57747,10/1/2022,UKR,Sabah,1,1,0,Ukraine
57748,10/1/2022,UKR,Sarawak,2,1,1,Ukraine
57749,10/1/2022,UKR,Selangor,577,296,281,Ukraine
57750,10/1/2022,UKR,W.P. Labuan,0,0,0,Ukraine
57751,10/1/2022,URY,Johor,8,3,5,Uruguay
57752,10/1/2022,URY,Kedah,0,0,0,Uruguay
57753,10/1/2022,URY,Kelantan,0,0,0,Uruguay
57754,10/1/2022,URY,Perak,2,1,1,Uruguay
57755,10/1/2022,URY,Perlis,0,0,0,Uruguay
57756,10/1/2022,URY,Pulau Pinang,1,0,1,Uruguay
57757,10/1/2022,URY,Sabah,0,0,0,Uruguay
57758,10/1/2022,URY,Sarawak,2,1,1,Uruguay
57759,10/1/2022,URY,Selangor,47,19,28,Uruguay
57760,10/1/2022,URY,W.P. Labuan,0,0,0,Uruguay
57761,10/1/2022,USA,Johor,3458,2136,1322,United States Of America
57762,10/1/2022,USA,Kedah,307,193,114,United States Of America
57763,10/1/2022,USA,Kelantan,8,5,3,United States Of America
57764,10/1/2022,USA,Melaka,5,2,3,United States Of America
57765,10/1/2022,USA,Negeri Sembilan,0,0,0,United States Of America
57766,10/1/2022,USA,Pahang,3,3,0,United States Of America
57767,10/1/2022,USA,Perak,66,42,24,United States Of America
57768,10/1/2022,USA,Perlis,79,50,29,United States Of America
57769,10/1/2022,USA,Pulau Pinang,1461,891,570,United States Of America
57770,10/1/2022,USA,Sabah,372,187,185,United States Of America
57771,10/1/2022,USA,Sarawak,309,175,134,United States Of America
57772,10/1/2022,USA,Selangor,10799,6652,4147,United States Of America
57773,10/1/2022,USA,Terengganu,1,1,0,United States Of America
57774,10/1/2022,USA,W.P. Labuan,13,9,4,United States Of America
57775,10/1/2022,UZB,Johor,54,36,18,Uzbekistan
57776,10/1/2022,UZB,Kedah,10,4,6,Uzbekistan
57777,10/1/2022,UZB,Kelantan,0,0,0,Uzbekistan
57778,10/1/2022,UZB,Perak,0,0,0,Uzbekistan
57779,10/1/2022,UZB,Perlis,2,2,0,Uzbekistan
57780,10/1/2022,UZB,Pulau Pinang,6,1,5,Uzbekistan
57781,10/1/2022,UZB,Sabah,18,17,1,Uzbekistan
57782,10/1/2022,UZB,Sarawak,1,1,0,Uzbekistan
57783,10/1/2022,UZB,Selangor,529,323,206,Uzbekistan
57784,10/1/2022,VAT,Johor,0,0,0,Holy See (Vatican City State)
57785,10/1/2022,VAT,Sarawak,0,0,0,Holy See (Vatican City State)
57786,10/1/2022,VAT,Selangor,0,0,0,Holy See (Vatican City State)
57787,10/1/2022,VCT,Johor,0,0,0,Saint Vincent and the Grenadines
57788,10/1/2022,VCT,Kedah,0,0,0,Saint Vincent and the Grenadines
57789,10/1/2022,VCT,Pulau Pinang,0,0,0,Saint Vincent and the Grenadines
57790,10/1/2022,VCT,Sarawak,0,0,0,Saint Vincent and the Grenadines
57791,10/1/2022,VCT,Selangor,0,0,0,Saint Vincent and the Grenadines
57792,10/1/2022,VEN,Johor,8,7,1,Venezuela
57793,10/1/2022,VEN,Kedah,1,1,0,Venezuela
57794,10/1/2022,VEN,Kelantan,0,0,0,Venezuela
57795,10/1/2022,VEN,Melaka,0,0,0,Venezuela
57796,10/1/2022,VEN,Perak,0,0,0,Venezuela
57797,10/1/2022,VEN,Perlis,0,0,0,Venezuela
57798,10/1/2022,VEN,Pulau Pinang,0,0,0,Venezuela
57799,10/1/2022,VEN,Sabah,1,1,0,Venezuela
57800,10/1/2022,VEN,Sarawak,7,5,2,Venezuela
57801,10/1/2022,VEN,Selangor,71,48,23,Venezuela
57802,10/1/2022,VEN,W.P. Labuan,0,0,0,Venezuela
57803,10/1/2022,VNM,Johor,11524,3625,7899,Vietnam
57804,10/1/2022,VNM,Kedah,260,53,207,Vietnam
57805,10/1/2022,VNM,Kelantan,20,12,8,Vietnam
57806,10/1/2022,VNM,Melaka,0,0,0,Vietnam
57807,10/1/2022,VNM,Negeri Sembilan,0,0,0,Vietnam
57808,10/1/2022,VNM,Pahang,0,0,0,Vietnam
57809,10/1/2022,VNM,Perak,98,11,87,Vietnam
57810,10/1/2022,VNM,Perlis,241,25,216,Vietnam
57811,10/1/2022,VNM,Pulau Pinang,1774,451,1323,Vietnam
57812,10/1/2022,VNM,Sabah,22,9,13,Vietnam
57813,10/1/2022,VNM,Sarawak,96,14,82,Vietnam
57814,10/1/2022,VNM,Selangor,12642,4646,7996,Vietnam
57815,10/1/2022,VNM,Terengganu,0,0,0,Vietnam
57816,10/1/2022,VNM,W.P. Labuan,1,0,1,Vietnam
57817,10/1/2022,VUT,Johor,28,17,11,Vanuatu
57818,10/1/2022,VUT,Kedah,0,0,0,Vanuatu
57819,10/1/2022,VUT,Pulau Pinang,0,0,0,Vanuatu
57820,10/1/2022,VUT,Sabah,0,0,0,Vanuatu
57821,10/1/2022,VUT,Sarawak,0,0,0,Vanuatu
57822,10/1/2022,VUT,Selangor,44,35,9,Vanuatu
57823,10/1/2022,WSM,Johor,2,2,0,Samoa
57824,10/1/2022,WSM,Sarawak,0,0,0,Samoa
57825,10/1/2022,WSM,Selangor,8,3,5,Samoa
57826,10/1/2022,YEM,Johor,30,21,9,Yemen
57827,10/1/2022,YEM,Kedah,3,2,1,Yemen
57828,10/1/2022,YEM,Kelantan,1,1,0,Yemen
57829,10/1/2022,YEM,Melaka,0,0,0,Yemen
57830,10/1/2022,YEM,Pahang,0,0,0,Yemen
57831,10/1/2022,YEM,Perak,4,2,2,Yemen
57832,10/1/2022,YEM,Perlis,3,3,0,Yemen
57833,10/1/2022,YEM,Pulau Pinang,7,7,0,Yemen
57834,10/1/2022,YEM,Sabah,0,0,0,Yemen
57835,10/1/2022,YEM,Sarawak,2,2,0,Yemen
57836,10/1/2022,YEM,Selangor,1180,894,286,Yemen
57837,10/1/2022,YEM,W.P. Labuan,0,0,0,Yemen
57838,10/1/2022,ZAF,Johor,308,202,106,South Africa
57839,10/1/2022,ZAF,Kedah,54,29,25,South Africa
57840,10/1/2022,ZAF,Kelantan,0,0,0,South Africa
57841,10/1/2022,ZAF,Melaka,2,1,1,South Africa
57842,10/1/2022,ZAF,Pahang,1,1,0,South Africa
57843,10/1/2022,ZAF,Perak,4,3,1,South Africa
57844,10/1/2022,ZAF,Perlis,11,6,5,South Africa
57845,10/1/2022,ZAF,Pulau Pinang,55,29,26,South Africa
57846,10/1/2022,ZAF,Sabah,17,11,6,South Africa
57847,10/1/2022,ZAF,Sarawak,66,37,29,South Africa
57848,10/1/2022,ZAF,Selangor,892,579,313,South Africa
57849,10/1/2022,ZAF,Terengganu,0,0,0,South Africa
57850,10/1/2022,ZAF,W.P. Labuan,0,0,0,South Africa
57851,10/1/2022,ZMB,Johor,2,1,1,Zambia
57852,10/1/2022,ZMB,Kedah,0,0,0,Zambia
57853,10/1/2022,ZMB,Perak,2,0,2,Zambia
57854,10/1/2022,ZMB,Perlis,0,0,0,Zambia
57855,10/1/2022,ZMB,Pulau Pinang,1,1,0,Zambia
57856,10/1/2022,ZMB,Sabah,0,0,0,Zambia
57857,10/1/2022,ZMB,Sarawak,2,2,0,Zambia
57858,10/1/2022,ZMB,Selangor,37,22,15,Zambia
57859,10/1/2022,ZWE,Johor,16,3,13,Zimbabwe
57860,10/1/2022,ZWE,Kedah,0,0,0,Zimbabwe
57861,10/1/2022,ZWE,Kelantan,0,0,0,Zimbabwe
57862,10/1/2022,ZWE,Perak,0,0,0,Zimbabwe
57863,10/1/2022,ZWE,Perlis,0,0,0,Zimbabwe
57864,10/1/2022,ZWE,Pulau Pinang,0,0,0,Zimbabwe
57865,10/1/2022,ZWE,Sabah,1,1,0,Zimbabwe
57866,10/1/2022,ZWE,Sarawak,2,1,1,Zimbabwe
57867,10/1/2022,ZWE,Selangor,127,57,70,Zimbabwe
57868,11/1/2022,ABW,Kedah,0,0,0,Aruba
57869,11/1/2022,ABW,Pulau Pinang,0,0,0,Aruba
57870,11/1/2022,AFG,Johor,1,1,0,Afghanistan
57871,11/1/2022,AFG,Kedah,0,0,0,Afghanistan
57872,11/1/2022,AFG,Perlis,0,0,0,Afghanistan
57873,11/1/2022,AFG,Pulau Pinang,0,0,0,Afghanistan
57874,11/1/2022,AFG,Sarawak,1,0,1,Afghanistan
57875,11/1/2022,AFG,Selangor,25,20,5,Afghanistan
57876,11/1/2022,AGO,Johor,1,1,0,Angola
57877,11/1/2022,AGO,Kedah,0,0,0,Angola
57878,11/1/2022,AGO,Sabah,0,0,0,Angola
57879,11/1/2022,AGO,Selangor,3,3,0,Angola
57880,11/1/2022,AIA,Selangor,1,1,0,Anguilla
57881,11/1/2022,ALB,Johor,16,14,2,Albania
57882,11/1/2022,ALB,Kedah,0,0,0,Albania
57883,11/1/2022,ALB,Perak,0,0,0,Albania
57884,11/1/2022,ALB,Perlis,0,0,0,Albania
57885,11/1/2022,ALB,Pulau Pinang,0,0,0,Albania
57886,11/1/2022,ALB,Sabah,0,0,0,Albania
57887,11/1/2022,ALB,Sarawak,0,0,0,Albania
57888,11/1/2022,ALB,Selangor,25,13,12,Albania
57889,11/1/2022,AND,Johor,0,0,0,Andorra
57890,11/1/2022,AND,Kedah,0,0,0,Andorra
57891,11/1/2022,AND,Perlis,0,0,0,Andorra
57892,11/1/2022,AND,Pulau Pinang,0,0,0,Andorra
57893,11/1/2022,AND,Selangor,4,1,3,Andorra
57894,11/1/2022,ANT,Selangor,0,0,0,Netherlands Antilles
57895,11/1/2022,ARE,Johor,37,29,8,United Arab Emirates
57896,11/1/2022,ARE,Kedah,2,2,0,United Arab Emirates
57897,11/1/2022,ARE,Kelantan,0,0,0,United Arab Emirates
57898,11/1/2022,ARE,Perak,0,0,0,United Arab Emirates
57899,11/1/2022,ARE,Perlis,0,0,0,United Arab Emirates
57900,11/1/2022,ARE,Pulau Pinang,2,1,1,United Arab Emirates
57901,11/1/2022,ARE,Sabah,0,0,0,United Arab Emirates
57902,11/1/2022,ARE,Sarawak,0,0,0,United Arab Emirates
57903,11/1/2022,ARE,Selangor,363,246,117,United Arab Emirates
57904,11/1/2022,ARG,Johor,53,33,20,Argentina
57905,11/1/2022,ARG,Kedah,29,17,12,Argentina
57906,11/1/2022,ARG,Kelantan,0,0,0,Argentina
57907,11/1/2022,ARG,Melaka,0,0,0,Argentina
57908,11/1/2022,ARG,Perak,0,0,0,Argentina
57909,11/1/2022,ARG,Perlis,1,1,0,Argentina
57910,11/1/2022,ARG,Pulau Pinang,7,5,2,Argentina
57911,11/1/2022,ARG,Sabah,2,0,2,Argentina
57912,11/1/2022,ARG,Sarawak,0,0,0,Argentina
57913,11/1/2022,ARG,Selangor,269,164,105,Argentina
57914,11/1/2022,ARG,W.P. Labuan,0,0,0,Argentina
57915,11/1/2022,ARM,Johor,4,3,1,Armenia
57916,11/1/2022,ARM,Kedah,0,0,0,Armenia
57917,11/1/2022,ARM,Kelantan,0,0,0,Armenia
57918,11/1/2022,ARM,Perak,0,0,0,Armenia
57919,11/1/2022,ARM,Perlis,0,0,0,Armenia
57920,11/1/2022,ARM,Pulau Pinang,0,0,0,Armenia
57921,11/1/2022,ARM,Sabah,0,0,0,Armenia
57922,11/1/2022,ARM,Sarawak,0,0,0,Armenia
57923,11/1/2022,ARM,Selangor,28,9,19,Armenia
57924,11/1/2022,ATA,Selangor,0,0,0,Antarctica
57925,11/1/2022,ATG,Johor,4,4,0,Antigua and Barbuda
57926,11/1/2022,ATG,Kedah,0,0,0,Antigua and Barbuda
57927,11/1/2022,ATG,Pulau Pinang,0,0,0,Antigua and Barbuda
57928,11/1/2022,ATG,Sarawak,0,0,0,Antigua and Barbuda
57929,11/1/2022,ATG,Selangor,5,5,0,Antigua and Barbuda
57930,11/1/2022,AUS,Johor,3879,2312,1567,Australia
57931,11/1/2022,AUS,Kedah,457,255,202,Australia
57932,11/1/2022,AUS,Kelantan,4,3,1,Australia
57933,11/1/2022,AUS,Melaka,1,1,0,Australia
57934,11/1/2022,AUS,Negeri Sembilan,2,1,1,Australia
57935,11/1/2022,AUS,Pahang,0,0,0,Australia
57936,11/1/2022,AUS,Perak,143,80,63,Australia
57937,11/1/2022,AUS,Perlis,60,40,20,Australia
57938,11/1/2022,AUS,Pulau Pinang,1382,748,634,Australia
57939,11/1/2022,AUS,Sabah,315,162,153,Australia
57940,11/1/2022,AUS,Sarawak,536,296,240,Australia
57941,11/1/2022,AUS,Selangor,18721,10988,7733,Australia
57942,11/1/2022,AUS,Terengganu,0,0,0,Australia
57943,11/1/2022,AUS,W.P. Labuan,21,14,7,Australia
57944,11/1/2022,AUT,Johor,147,100,47,Austria
57945,11/1/2022,AUT,Kedah,43,20,23,Austria
57946,11/1/2022,AUT,Kelantan,0,0,0,Austria
57947,11/1/2022,AUT,Melaka,0,0,0,Austria
57948,11/1/2022,AUT,Negeri Sembilan,0,0,0,Austria
57949,11/1/2022,AUT,Pahang,0,0,0,Austria
57950,11/1/2022,AUT,Perak,2,1,1,Austria
57951,11/1/2022,AUT,Perlis,17,12,5,Austria
57952,11/1/2022,AUT,Pulau Pinang,75,52,23,Austria
57953,11/1/2022,AUT,Sabah,15,10,5,Austria
57954,11/1/2022,AUT,Sarawak,6,5,1,Austria
57955,11/1/2022,AUT,Selangor,679,445,234,Austria
57956,11/1/2022,AUT,Terengganu,0,0,0,Austria
57957,11/1/2022,AUT,W.P. Labuan,0,0,0,Austria
57958,11/1/2022,AZE,Johor,2,2,0,Azerbaijan
57959,11/1/2022,AZE,Kedah,0,0,0,Azerbaijan
57960,11/1/2022,AZE,Kelantan,0,0,0,Azerbaijan
57961,11/1/2022,AZE,Melaka,0,0,0,Azerbaijan
57962,11/1/2022,AZE,Perlis,0,0,0,Azerbaijan
57963,11/1/2022,AZE,Pulau Pinang,0,0,0,Azerbaijan
57964,11/1/2022,AZE,Sabah,1,1,0,Azerbaijan
57965,11/1/2022,AZE,Sarawak,0,0,0,Azerbaijan
57966,11/1/2022,AZE,Selangor,74,44,30,Azerbaijan
57967,11/1/2022,AZE,W.P. Labuan,0,0,0,Azerbaijan
57968,11/1/2022,BDI,Pulau Pinang,0,0,0,Burundi
57969,11/1/2022,BDI,Sarawak,0,0,0,Burundi
57970,11/1/2022,BDI,Selangor,6,4,2,Burundi
57971,11/1/2022,BEL,Johor,210,147,63,Belgium
57972,11/1/2022,BEL,Kedah,51,31,20,Belgium
57973,11/1/2022,BEL,Kelantan,5,4,1,Belgium
57974,11/1/2022,BEL,Melaka,0,0,0,Belgium
57975,11/1/2022,BEL,Negeri Sembilan,0,0,0,Belgium
57976,11/1/2022,BEL,Pahang,0,0,0,Belgium
57977,11/1/2022,BEL,Perak,3,2,1,Belgium
57978,11/1/2022,BEL,Perlis,9,8,1,Belgium
57979,11/1/2022,BEL,Pulau Pinang,56,43,13,Belgium
57980,11/1/2022,BEL,Sabah,15,9,6,Belgium
57981,11/1/2022,BEL,Sarawak,24,19,5,Belgium
57982,11/1/2022,BEL,Selangor,684,454,230,Belgium
57983,11/1/2022,BEL,W.P. Labuan,0,0,0,Belgium
57984,11/1/2022,BEN,Johor,2,0,2,Benin
57985,11/1/2022,BEN,Kedah,0,0,0,Benin
57986,11/1/2022,BEN,Perak,0,0,0,Benin
57987,11/1/2022,BEN,Pulau Pinang,0,0,0,Benin
57988,11/1/2022,BEN,Sabah,0,0,0,Benin
57989,11/1/2022,BEN,Sarawak,0,0,0,Benin
57990,11/1/2022,BEN,Selangor,6,5,1,Benin
57991,11/1/2022,BFA,Perak,0,0,0,Burkina Faso
57992,11/1/2022,BFA,Pulau Pinang,0,0,0,Burkina Faso
57993,11/1/2022,BFA,Selangor,2,2,0,Burkina Faso
57994,11/1/2022,BGD,Johor,1734,1456,278,Bangladesh
57995,11/1/2022,BGD,Kedah,38,23,15,Bangladesh
57996,11/1/2022,BGD,Kelantan,0,0,0,Bangladesh
57997,11/1/2022,BGD,Melaka,0,0,0,Bangladesh
57998,11/1/2022,BGD,Negeri Sembilan,0,0,0,Bangladesh
57999,11/1/2022,BGD,Pahang,0,0,0,Bangladesh
58000,11/1/2022,BGD,Perak,3,3,0,Bangladesh
58001,11/1/2022,BGD,Perlis,7,6,1,Bangladesh
58002,11/1/2022,BGD,Pulau Pinang,414,402,12,Bangladesh
58003,11/1/2022,BGD,Sabah,0,0,0,Bangladesh
58004,11/1/2022,BGD,Sarawak,59,53,6,Bangladesh
58005,11/1/2022,BGD,Selangor,34670,33433,1237,Bangladesh
58006,11/1/2022,BGD,W.P. Labuan,3,3,0,Bangladesh
58007,11/1/2022,BGR,Johor,51,25,26,Bulgaria
58008,11/1/2022,BGR,Kedah,7,4,3,Bulgaria
58009,11/1/2022,BGR,Kelantan,1,0,1,Bulgaria
58010,11/1/2022,BGR,Pahang,0,0,0,Bulgaria
58011,11/1/2022,BGR,Perak,0,0,0,Bulgaria
58012,11/1/2022,BGR,Perlis,1,0,1,Bulgaria
58013,11/1/2022,BGR,Pulau Pinang,7,5,2,Bulgaria
58014,11/1/2022,BGR,Sabah,1,0,1,Bulgaria
58015,11/1/2022,BGR,Sarawak,0,0,0,Bulgaria
58016,11/1/2022,BGR,Selangor,163,98,65,Bulgaria
58017,11/1/2022,BGR,W.P. Labuan,0,0,0,Bulgaria
58018,11/1/2022,BHR,Johor,0,0,0,Bahrain
58019,11/1/2022,BHR,Kedah,2,2,0,Bahrain
58020,11/1/2022,BHR,Kelantan,1,1,0,Bahrain
58021,11/1/2022,BHR,Perlis,0,0,0,Bahrain
58022,11/1/2022,BHR,Pulau Pinang,3,3,0,Bahrain
58023,11/1/2022,BHR,Sabah,0,0,0,Bahrain
58024,11/1/2022,BHR,Sarawak,0,0,0,Bahrain
58025,11/1/2022,BHR,Selangor,90,55,35,Bahrain
58026,11/1/2022,BHS,Johor,0,0,0,Bahamas
58027,11/1/2022,BHS,Kedah,0,0,0,Bahamas
58028,11/1/2022,BHS,Perak,0,0,0,Bahamas
58029,11/1/2022,BHS,Sabah,0,0,0,Bahamas
58030,11/1/2022,BHS,Sarawak,0,0,0,Bahamas
58031,11/1/2022,BHS,Selangor,6,0,6,Bahamas
58032,11/1/2022,BIH,Johor,3,3,0,Bosnia and Herzegovina
58033,11/1/2022,BIH,Kedah,0,0,0,Bosnia and Herzegovina
58034,11/1/2022,BIH,Perlis,0,0,0,Bosnia and Herzegovina
58035,11/1/2022,BIH,Pulau Pinang,2,1,1,Bosnia and Herzegovina
58036,11/1/2022,BIH,Sabah,0,0,0,Bosnia and Herzegovina
58037,11/1/2022,BIH,Sarawak,2,2,0,Bosnia and Herzegovina
58038,11/1/2022,BIH,Selangor,30,16,14,Bosnia and Herzegovina
58039,11/1/2022,BLR,Johor,7,3,4,Belarus
58040,11/1/2022,BLR,Kedah,4,1,3,Belarus
58041,11/1/2022,BLR,Kelantan,2,0,2,Belarus
58042,11/1/2022,BLR,Pahang,0,0,0,Belarus
58043,11/1/2022,BLR,Perak,0,0,0,Belarus
58044,11/1/2022,BLR,Perlis,0,0,0,Belarus
58045,11/1/2022,BLR,Pulau Pinang,2,1,1,Belarus
58046,11/1/2022,BLR,Sabah,1,1,0,Belarus
58047,11/1/2022,BLR,Sarawak,2,1,1,Belarus
58048,11/1/2022,BLR,Selangor,238,113,125,Belarus
58049,11/1/2022,BLR,W.P. Labuan,0,0,0,Belarus
58050,11/1/2022,BLZ,Johor,2,1,1,Belize
58051,11/1/2022,BLZ,Pulau Pinang,0,0,0,Belize
58052,11/1/2022,BLZ,Sarawak,1,1,0,Belize
58053,11/1/2022,BLZ,Selangor,5,1,4,Belize
58054,11/1/2022,BMU,Selangor,0,0,0,Bermuda
58055,11/1/2022,BOL,Johor,6,2,4,Bolivia
58056,11/1/2022,BOL,Kedah,0,0,0,Bolivia
58057,11/1/2022,BOL,Melaka,0,0,0,Bolivia
58058,11/1/2022,BOL,Perak,0,0,0,Bolivia
58059,11/1/2022,BOL,Perlis,0,0,0,Bolivia
58060,11/1/2022,BOL,Pulau Pinang,0,0,0,Bolivia
58061,11/1/2022,BOL,Sabah,0,0,0,Bolivia
58062,11/1/2022,BOL,Sarawak,5,3,2,Bolivia
58063,11/1/2022,BOL,Selangor,21,13,8,Bolivia
58064,11/1/2022,BRA,Johor,140,78,62,Brazil
58065,11/1/2022,BRA,Kedah,16,8,8,Brazil
58066,11/1/2022,BRA,Kelantan,0,0,0,Brazil
58067,11/1/2022,BRA,Melaka,0,0,0,Brazil
58068,11/1/2022,BRA,Pahang,0,0,0,Brazil
58069,11/1/2022,BRA,Perak,2,2,0,Brazil
58070,11/1/2022,BRA,Perlis,9,4,5,Brazil
58071,11/1/2022,BRA,Pulau Pinang,15,11,4,Brazil
58072,11/1/2022,BRA,Sabah,3,2,1,Brazil
58073,11/1/2022,BRA,Sarawak,4,2,2,Brazil
58074,11/1/2022,BRA,Selangor,676,374,302,Brazil
58075,11/1/2022,BRA,W.P. Labuan,1,0,1,Brazil
58076,11/1/2022,BRB,Johor,0,0,0,Barbados
58077,11/1/2022,BRB,Kedah,0,0,0,Barbados
58078,11/1/2022,BRB,Perlis,0,0,0,Barbados
58079,11/1/2022,BRB,Pulau Pinang,0,0,0,Barbados
58080,11/1/2022,BRB,Selangor,6,5,1,Barbados
58081,11/1/2022,BRN,Johor,279,144,135,Brunei Darussalam
58082,11/1/2022,BRN,Kedah,16,8,8,Brunei Darussalam
58083,11/1/2022,BRN,Kelantan,0,0,0,Brunei Darussalam
58084,11/1/2022,BRN,Melaka,0,0,0,Brunei Darussalam
58085,11/1/2022,BRN,Pahang,0,0,0,Brunei Darussalam
58086,11/1/2022,BRN,Perak,1,1,0,Brunei Darussalam
58087,11/1/2022,BRN,Perlis,7,4,3,Brunei Darussalam
58088,11/1/2022,BRN,Pulau Pinang,15,6,9,Brunei Darussalam
58089,11/1/2022,BRN,Sabah,823,393,430,Brunei Darussalam
58090,11/1/2022,BRN,Sarawak,59481,32252,27229,Brunei Darussalam
58091,11/1/2022,BRN,Selangor,4130,2057,2073,Brunei Darussalam
58092,11/1/2022,BRN,W.P. Labuan,788,556,232,Brunei Darussalam
58093,11/1/2022,BTN,Johor,0,0,0,Bhutan
58094,11/1/2022,BTN,Kedah,0,0,0,Bhutan
58095,11/1/2022,BTN,Perak,0,0,0,Bhutan
58096,11/1/2022,BTN,Perlis,0,0,0,Bhutan
58097,11/1/2022,BTN,Pulau Pinang,0,0,0,Bhutan
58098,11/1/2022,BTN,Sabah,1,1,0,Bhutan
58099,11/1/2022,BTN,Sarawak,0,0,0,Bhutan
58100,11/1/2022,BTN,Selangor,23,17,6,Bhutan
58101,11/1/2022,BWA,Johor,1,0,1,Botswana
58102,11/1/2022,BWA,Kedah,1,1,0,Botswana
58103,11/1/2022,BWA,Perlis,0,0,0,Botswana
58104,11/1/2022,BWA,Pulau Pinang,0,0,0,Botswana
58105,11/1/2022,BWA,Sabah,0,0,0,Botswana
58106,11/1/2022,BWA,Sarawak,0,0,0,Botswana
58107,11/1/2022,BWA,Selangor,3,2,1,Botswana
58108,11/1/2022,CAF,Kedah,0,0,0,Central African Republic
58109,11/1/2022,CAF,Selangor,0,0,0,Central African Republic
58110,11/1/2022,CAN,Johor,1233,716,517,Canada
58111,11/1/2022,CAN,Kedah,113,63,50,Canada
58112,11/1/2022,CAN,Kelantan,0,0,0,Canada
58113,11/1/2022,CAN,Melaka,0,0,0,Canada
58114,11/1/2022,CAN,Negeri Sembilan,0,0,0,Canada
58115,11/1/2022,CAN,Pahang,0,0,0,Canada
58116,11/1/2022,CAN,Perak,39,21,18,Canada
58117,11/1/2022,CAN,Perlis,50,32,18,Canada
58118,11/1/2022,CAN,Pulau Pinang,375,215,160,Canada
58119,11/1/2022,CAN,Sabah,110,60,50,Canada
58120,11/1/2022,CAN,Sarawak,302,156,146,Canada
58121,11/1/2022,CAN,Selangor,3503,2121,1382,Canada
58122,11/1/2022,CAN,Terengganu,0,0,0,Canada
58123,11/1/2022,CAN,W.P. Labuan,5,4,1,Canada
58124,11/1/2022,CCK,Selangor,1,1,0,Cocos (Keeling) Islands
58125,11/1/2022,CHE,Johor,300,189,111,Switzerland
58126,11/1/2022,CHE,Kedah,124,71,53,Switzerland
58127,11/1/2022,CHE,Kelantan,2,2,0,Switzerland
58128,11/1/2022,CHE,Melaka,0,0,0,Switzerland
58129,11/1/2022,CHE,Negeri Sembilan,0,0,0,Switzerland
58130,11/1/2022,CHE,Pahang,0,0,0,Switzerland
58131,11/1/2022,CHE,Perak,7,5,2,Switzerland
58132,11/1/2022,CHE,Perlis,21,15,6,Switzerland
58133,11/1/2022,CHE,Pulau Pinang,130,90,40,Switzerland
58134,11/1/2022,CHE,Sabah,27,18,9,Switzerland
58135,11/1/2022,CHE,Sarawak,28,15,13,Switzerland
58136,11/1/2022,CHE,Selangor,987,657,330,Switzerland
58137,11/1/2022,CHE,W.P. Labuan,1,1,0,Switzerland
58138,11/1/2022,CHL,Johor,16,10,6,Chile
58139,11/1/2022,CHL,Kedah,6,4,2,Chile
58140,11/1/2022,CHL,Kelantan,0,0,0,Chile
58141,11/1/2022,CHL,Melaka,0,0,0,Chile
58142,11/1/2022,CHL,Pahang,0,0,0,Chile
58143,11/1/2022,CHL,Perak,0,0,0,Chile
58144,11/1/2022,CHL,Perlis,1,1,0,Chile
58145,11/1/2022,CHL,Pulau Pinang,0,0,0,Chile
58146,11/1/2022,CHL,Sabah,2,2,0,Chile
58147,11/1/2022,CHL,Sarawak,0,0,0,Chile
58148,11/1/2022,CHL,Selangor,143,87,56,Chile
58149,11/1/2022,CHN,Johor,19263,7672,11591,China
58150,11/1/2022,CHN,Kedah,418,178,240,China
58151,11/1/2022,CHN,Kelantan,5,2,3,China
58152,11/1/2022,CHN,Melaka,5,4,1,China
58153,11/1/2022,CHN,Pahang,0,0,0,China
58154,11/1/2022,CHN,Perak,145,61,84,China
58155,11/1/2022,CHN,Perlis,40,27,13,China
58156,11/1/2022,CHN,Pulau Pinang,1465,777,688,China
58157,11/1/2022,CHN,Sabah,358,152,206,China
58158,11/1/2022,CHN,Sarawak,371,180,191,China
58159,11/1/2022,CHN,Selangor,19273,11464,7809,China
58160,11/1/2022,CHN,Terengganu,0,0,0,China
58161,11/1/2022,CHN,W.P. Labuan,17,10,7,China
58162,11/1/2022,CIV,Johor,0,0,0,C��te d'Iv
58163,11/1/2022,CIV,Kedah,0,0,0,C��te d'Iv
58164,11/1/2022,CIV,Pulau Pinang,0,0,0,C��te d'Iv
58165,11/1/2022,CIV,Sabah,0,0,0,C��te d'Iv
58166,11/1/2022,CIV,Sarawak,0,0,0,C��te d'Iv
58167,11/1/2022,CIV,Selangor,17,14,3,C��te d'Iv
58168,11/1/2022,CMR,Johor,4,4,0,Cameroon
58169,11/1/2022,CMR,Kedah,0,0,0,Cameroon
58170,11/1/2022,CMR,Pulau Pinang,0,0,0,Cameroon
58171,11/1/2022,CMR,Sabah,0,0,0,Cameroon
58172,11/1/2022,CMR,Sarawak,0,0,0,Cameroon
58173,11/1/2022,CMR,Selangor,16,12,4,Cameroon
58174,11/1/2022,COD,Johor,0,0,0,"Congo, the Democratic Republic of the"
58175,11/1/2022,COD,Pulau Pinang,0,0,0,"Congo, the Democratic Republic of the"
58176,11/1/2022,COD,Sarawak,0,0,0,"Congo, the Democratic Republic of the"
58177,11/1/2022,COD,Selangor,2,2,0,"Congo, the Democratic Republic of the"
58178,11/1/2022,COG,Johor,0,0,0,Congo
58179,11/1/2022,COG,Kedah,0,0,0,Congo
58180,11/1/2022,COG,Selangor,6,3,3,Congo
58181,11/1/2022,COK,Selangor,0,0,0,Cook Islands
58182,11/1/2022,COL,Johor,19,9,10,Colombia
58183,11/1/2022,COL,Kedah,1,0,1,Colombia
58184,11/1/2022,COL,Perak,0,0,0,Colombia
58185,11/1/2022,COL,Pulau Pinang,3,0,3,Colombia
58186,11/1/2022,COL,Sabah,0,0,0,Colombia
58187,11/1/2022,COL,Sarawak,0,0,0,Colombia
58188,11/1/2022,COL,Selangor,130,76,54,Colombia
58189,11/1/2022,COL,W.P. Labuan,0,0,0,Colombia
58190,11/1/2022,COM,Johor,0,0,0,Comoros
58191,11/1/2022,COM,Kedah,0,0,0,Comoros
58192,11/1/2022,COM,Selangor,16,10,6,Comoros
58193,11/1/2022,CPV,Johor,1,1,0,Cape Verde
58194,11/1/2022,CPV,Kedah,0,0,0,Cape Verde
58195,11/1/2022,CPV,Pulau Pinang,1,0,1,Cape Verde
58196,11/1/2022,CPV,Sabah,0,0,0,Cape Verde
58197,11/1/2022,CPV,Selangor,2,1,1,Cape Verde
58198,11/1/2022,CRI,Johor,8,7,1,Costa Rica
58199,11/1/2022,CRI,Kedah,0,0,0,Costa Rica
58200,11/1/2022,CRI,Perak,0,0,0,Costa Rica
58201,11/1/2022,CRI,Perlis,0,0,0,Costa Rica
58202,11/1/2022,CRI,Pulau Pinang,4,3,1,Costa Rica
58203,11/1/2022,CRI,Sabah,0,0,0,Costa Rica
58204,11/1/2022,CRI,Sarawak,0,0,0,Costa Rica
58205,11/1/2022,CRI,Selangor,41,20,21,Costa Rica
58206,11/1/2022,CUB,Johor,2,1,1,Cuba
58207,11/1/2022,CUB,Kedah,1,1,0,Cuba
58208,11/1/2022,CUB,Perlis,0,0,0,Cuba
58209,11/1/2022,CUB,Pulau Pinang,0,0,0,Cuba
58210,11/1/2022,CUB,Sabah,0,0,0,Cuba
58211,11/1/2022,CUB,Sarawak,0,0,0,Cuba
58212,11/1/2022,CUB,Selangor,25,15,10,Cuba
58213,11/1/2022,CYP,Johor,7,3,4,Cyprus
58214,11/1/2022,CYP,Kedah,1,1,0,Cyprus
58215,11/1/2022,CYP,Perak,0,0,0,Cyprus
58216,11/1/2022,CYP,Perlis,0,0,0,Cyprus
58217,11/1/2022,CYP,Pulau Pinang,3,2,1,Cyprus
58218,11/1/2022,CYP,Sabah,1,0,1,Cyprus
58219,11/1/2022,CYP,Sarawak,1,0,1,Cyprus
58220,11/1/2022,CYP,Selangor,50,36,14,Cyprus
58221,11/1/2022,CZE,Johor,131,77,54,Czech Republic
58222,11/1/2022,CZE,Kedah,76,34,42,Czech Republic
58223,11/1/2022,CZE,Kelantan,1,1,0,Czech Republic
58224,11/1/2022,CZE,Melaka,0,0,0,Czech Republic
58225,11/1/2022,CZE,Negeri Sembilan,0,0,0,Czech Republic
58226,11/1/2022,CZE,Perak,0,0,0,Czech Republic
58227,11/1/2022,CZE,Perlis,15,8,7,Czech Republic
58228,11/1/2022,CZE,Pulau Pinang,22,15,7,Czech Republic
58229,11/1/2022,CZE,Sabah,9,7,2,Czech Republic
58230,11/1/2022,CZE,Sarawak,7,5,2,Czech Republic
58231,11/1/2022,CZE,Selangor,422,272,150,Czech Republic
58232,11/1/2022,CZE,W.P. Labuan,1,0,1,Czech Republic
58233,11/1/2022,DEU,Johor,1907,1242,665,Germany
58234,11/1/2022,DEU,Kedah,460,234,226,Germany
58235,11/1/2022,DEU,Kelantan,11,9,2,Germany
58236,11/1/2022,DEU,Melaka,3,2,1,Germany
58237,11/1/2022,DEU,Negeri Sembilan,1,1,0,Germany
58238,11/1/2022,DEU,Pahang,1,1,0,Germany
58239,11/1/2022,DEU,Perak,19,14,5,Germany
58240,11/1/2022,DEU,Perlis,95,62,33,Germany
58241,11/1/2022,DEU,Pulau Pinang,601,449,152,Germany
58242,11/1/2022,DEU,Sabah,87,55,32,Germany
58243,11/1/2022,DEU,Sarawak,150,99,51,Germany
58244,11/1/2022,DEU,Selangor,5193,3520,1673,Germany
58245,11/1/2022,DEU,Terengganu,0,0,0,Germany
58246,11/1/2022,DEU,W.P. Labuan,2,1,1,Germany
58247,11/1/2022,DJI,Johor,0,0,0,Djibouti
58248,11/1/2022,DJI,Selangor,7,4,3,Djibouti
58249,11/1/2022,DMA,Johor,5,4,1,Dominica
58250,11/1/2022,DMA,Kedah,0,0,0,Dominica
58251,11/1/2022,DMA,Pulau Pinang,0,0,0,Dominica
58252,11/1/2022,DMA,Sabah,0,0,0,Dominica
58253,11/1/2022,DMA,Sarawak,0,0,0,Dominica
58254,11/1/2022,DMA,Selangor,21,18,3,Dominica
58255,11/1/2022,DMA,W.P. Labuan,0,0,0,Dominica
58256,11/1/2022,DNK,Johor,265,180,85,Denmark
58257,11/1/2022,DNK,Kedah,56,28,28,Denmark
58258,11/1/2022,DNK,Kelantan,0,0,0,Denmark
58259,11/1/2022,DNK,Melaka,0,0,0,Denmark
58260,11/1/2022,DNK,Negeri Sembilan,0,0,0,Denmark
58261,11/1/2022,DNK,Pahang,0,0,0,Denmark
58262,11/1/2022,DNK,Perak,3,3,0,Denmark
58263,11/1/2022,DNK,Perlis,10,6,4,Denmark
58264,11/1/2022,DNK,Pulau Pinang,62,39,23,Denmark
58265,11/1/2022,DNK,Sabah,15,11,4,Denmark
58266,11/1/2022,DNK,Sarawak,16,10,6,Denmark
58267,11/1/2022,DNK,Selangor,790,527,263,Denmark
58268,11/1/2022,DNK,W.P. Labuan,1,1,0,Denmark
58269,11/1/2022,DOM,Johor,0,0,0,Dominican Republic
58270,11/1/2022,DOM,Kedah,0,0,0,Dominican Republic
58271,11/1/2022,DOM,Perak,0,0,0,Dominican Republic
58272,11/1/2022,DOM,Perlis,0,0,0,Dominican Republic
58273,11/1/2022,DOM,Pulau Pinang,0,0,0,Dominican Republic
58274,11/1/2022,DOM,Sabah,0,0,0,Dominican Republic
58275,11/1/2022,DOM,Sarawak,0,0,0,Dominican Republic
58276,11/1/2022,DOM,Selangor,8,8,0,Dominican Republic
58277,11/1/2022,DZA,Johor,54,38,16,Algeria
58278,11/1/2022,DZA,Kedah,3,3,0,Algeria
58279,11/1/2022,DZA,Kelantan,1,1,0,Algeria
58280,11/1/2022,DZA,Melaka,0,0,0,Algeria
58281,11/1/2022,DZA,Perak,0,0,0,Algeria
58282,11/1/2022,DZA,Perlis,2,2,0,Algeria
58283,11/1/2022,DZA,Pulau Pinang,1,1,0,Algeria
58284,11/1/2022,DZA,Sabah,1,1,0,Algeria
58285,11/1/2022,DZA,Sarawak,1,1,0,Algeria
58286,11/1/2022,DZA,Selangor,428,312,116,Algeria
58287,11/1/2022,DZA,W.P. Labuan,0,0,0,Algeria
58288,11/1/2022,ECU,Johor,4,4,0,Ecuador
58289,11/1/2022,ECU,Kedah,0,0,0,Ecuador
58290,11/1/2022,ECU,Perak,0,0,0,Ecuador
58291,11/1/2022,ECU,Perlis,0,0,0,Ecuador
58292,11/1/2022,ECU,Pulau Pinang,1,0,1,Ecuador
58293,11/1/2022,ECU,Sabah,0,0,0,Ecuador
58294,11/1/2022,ECU,Sarawak,0,0,0,Ecuador
58295,11/1/2022,ECU,Selangor,45,24,21,Ecuador
58296,11/1/2022,EGY,Johor,143,116,27,Egypt
58297,11/1/2022,EGY,Kedah,3,3,0,Egypt
58298,11/1/2022,EGY,Kelantan,0,0,0,Egypt
58299,11/1/2022,EGY,Melaka,1,0,1,Egypt
58300,11/1/2022,EGY,Pahang,0,0,0,Egypt
58301,11/1/2022,EGY,Perak,0,0,0,Egypt
58302,11/1/2022,EGY,Perlis,0,0,0,Egypt
58303,11/1/2022,EGY,Pulau Pinang,9,7,2,Egypt
58304,11/1/2022,EGY,Sabah,5,5,0,Egypt
58305,11/1/2022,EGY,Sarawak,91,69,22,Egypt
58306,11/1/2022,EGY,Selangor,1273,844,429,Egypt
58307,11/1/2022,EGY,Terengganu,0,0,0,Egypt
58308,11/1/2022,EGY,W.P. Labuan,0,0,0,Egypt
58309,11/1/2022,ERI,Johor,0,0,0,Eritrea
58310,11/1/2022,ERI,Pulau Pinang,0,0,0,Eritrea
58311,11/1/2022,ERI,Sabah,0,0,0,Eritrea
58312,11/1/2022,ERI,Selangor,17,9,8,Eritrea
58313,11/1/2022,ESP,Johor,434,267,167,Spain
58314,11/1/2022,ESP,Kedah,191,93,98,Spain
58315,11/1/2022,ESP,Kelantan,1,1,0,Spain
58316,11/1/2022,ESP,Melaka,0,0,0,Spain
58317,11/1/2022,ESP,Negeri Sembilan,0,0,0,Spain
58318,11/1/2022,ESP,Pahang,0,0,0,Spain
58319,11/1/2022,ESP,Perak,1,0,1,Spain
58320,11/1/2022,ESP,Perlis,21,12,9,Spain
58321,11/1/2022,ESP,Pulau Pinang,92,52,40,Spain
58322,11/1/2022,ESP,Sabah,32,15,17,Spain
58323,11/1/2022,ESP,Sarawak,34,25,9,Spain
58324,11/1/2022,ESP,Selangor,2000,1184,816,Spain
58325,11/1/2022,ESP,W.P. Labuan,2,1,1,Spain
58326,11/1/2022,EST,Johor,32,16,16,Estonia
58327,11/1/2022,EST,Kedah,9,7,2,Estonia
58328,11/1/2022,EST,Kelantan,0,0,0,Estonia
58329,11/1/2022,EST,Pahang,0,0,0,Estonia
58330,11/1/2022,EST,Perak,0,0,0,Estonia
58331,11/1/2022,EST,Perlis,4,2,2,Estonia
58332,11/1/2022,EST,Pulau Pinang,5,3,2,Estonia
58333,11/1/2022,EST,Sabah,0,0,0,Estonia
58334,11/1/2022,EST,Sarawak,0,0,0,Estonia
58335,11/1/2022,EST,Selangor,122,71,51,Estonia
58336,11/1/2022,EST,W.P. Labuan,0,0,0,Estonia
58337,11/1/2022,ETH,Johor,0,0,0,Ethiopia
58338,11/1/2022,ETH,Kedah,0,0,0,Ethiopia
58339,11/1/2022,ETH,Pulau Pinang,0,0,0,Ethiopia
58340,11/1/2022,ETH,Sarawak,1,0,1,Ethiopia
58341,11/1/2022,ETH,Selangor,34,22,12,Ethiopia
58342,11/1/2022,FIN,Johor,166,99,67,Finland
58343,11/1/2022,FIN,Kedah,67,26,41,Finland
58344,11/1/2022,FIN,Kelantan,0,0,0,Finland
58345,11/1/2022,FIN,Melaka,0,0,0,Finland
58346,11/1/2022,FIN,Negeri Sembilan,0,0,0,Finland
58347,11/1/2022,FIN,Pahang,0,0,0,Finland
58348,11/1/2022,FIN,Perak,4,1,3,Finland
58349,11/1/2022,FIN,Perlis,5,3,2,Finland
58350,11/1/2022,FIN,Pulau Pinang,44,22,22,Finland
58351,11/1/2022,FIN,Sabah,10,4,6,Finland
58352,11/1/2022,FIN,Sarawak,13,5,8,Finland
58353,11/1/2022,FIN,Selangor,597,342,255,Finland
58354,11/1/2022,FIN,W.P. Labuan,0,0,0,Finland
58355,11/1/2022,FJI,Johor,29,18,11,Fiji
58356,11/1/2022,FJI,Kedah,0,0,0,Fiji
58357,11/1/2022,FJI,Kelantan,0,0,0,Fiji
58358,11/1/2022,FJI,Perak,1,1,0,Fiji
58359,11/1/2022,FJI,Perlis,1,0,1,Fiji
58360,11/1/2022,FJI,Pulau Pinang,3,2,1,Fiji
58361,11/1/2022,FJI,Sabah,0,0,0,Fiji
58362,11/1/2022,FJI,Sarawak,4,3,1,Fiji
58363,11/1/2022,FJI,Selangor,71,44,27,Fiji
58364,11/1/2022,FRA,Johor,1435,958,477,France
58365,11/1/2022,FRA,Kedah,285,167,118,France
58366,11/1/2022,FRA,Kelantan,4,3,1,France
58367,11/1/2022,FRA,Melaka,3,1,2,France
58368,11/1/2022,FRA,Negeri Sembilan,0,0,0,France
58369,11/1/2022,FRA,Pahang,3,3,0,France
58370,11/1/2022,FRA,Perak,25,16,9,France
58371,11/1/2022,FRA,Perlis,67,49,18,France
58372,11/1/2022,FRA,Pulau Pinang,264,178,86,France
58373,11/1/2022,FRA,Sabah,61,38,23,France
58374,11/1/2022,FRA,Sarawak,91,60,31,France
58375,11/1/2022,FRA,Selangor,4797,3181,1616,France
58376,11/1/2022,FRA,Terengganu,0,0,0,France
58377,11/1/2022,FRA,W.P. Labuan,11,9,2,France
58378,11/1/2022,FSM,Johor,0,0,0,"Micronesia, Federated States of"
58379,11/1/2022,FSM,Pulau Pinang,0,0,0,"Micronesia, Federated States of"
58380,11/1/2022,FSM,Selangor,0,0,0,"Micronesia, Federated States of"
58381,11/1/2022,GAB,Johor,0,0,0,Gabon
58382,11/1/2022,GAB,Pulau Pinang,0,0,0,Gabon
58383,11/1/2022,GAB,Sarawak,0,0,0,Gabon
58384,11/1/2022,GAB,Selangor,1,1,0,Gabon
58385,11/1/2022,GBR,Johor,3760,2446,1314,United Kingdom
58386,11/1/2022,GBR,Kedah,791,446,345,United Kingdom
58387,11/1/2022,GBR,Kelantan,4,3,1,United Kingdom
58388,11/1/2022,GBR,Melaka,3,3,0,United Kingdom
58389,11/1/2022,GBR,Negeri Sembilan,2,0,2,United Kingdom
58390,11/1/2022,GBR,Pahang,2,2,0,United Kingdom
58391,11/1/2022,GBR,Perak,64,36,28,United Kingdom
58392,11/1/2022,GBR,Perlis,154,93,61,United Kingdom
58393,11/1/2022,GBR,Pulau Pinang,1110,690,420,United Kingdom
58394,11/1/2022,GBR,Sabah,226,141,85,United Kingdom
58395,11/1/2022,GBR,Sarawak,864,561,303,United Kingdom
58396,11/1/2022,GBR,Selangor,13386,8520,4866,United Kingdom
58397,11/1/2022,GBR,Terengganu,1,1,0,United Kingdom
58398,11/1/2022,GBR,W.P. Labuan,49,34,15,United Kingdom
58399,11/1/2022,GEO,Johor,13,13,0,Georgia
58400,11/1/2022,GEO,Kedah,1,1,0,Georgia
58401,11/1/2022,GEO,Melaka,0,0,0,Georgia
58402,11/1/2022,GEO,Perak,0,0,0,Georgia
58403,11/1/2022,GEO,Perlis,2,1,1,Georgia
58404,11/1/2022,GEO,Pulau Pinang,0,0,0,Georgia
58405,11/1/2022,GEO,Sabah,0,0,0,Georgia
58406,11/1/2022,GEO,Sarawak,1,0,1,Georgia
58407,11/1/2022,GEO,Selangor,28,17,11,Georgia
58408,11/1/2022,GHA,Johor,24,6,18,Ghana
58409,11/1/2022,GHA,Kedah,0,0,0,Ghana
58410,11/1/2022,GHA,Kelantan,0,0,0,Ghana
58411,11/1/2022,GHA,Pulau Pinang,0,0,0,Ghana
58412,11/1/2022,GHA,Sabah,1,0,1,Ghana
58413,11/1/2022,GHA,Sarawak,0,0,0,Ghana
58414,11/1/2022,GHA,Selangor,64,36,28,Ghana
58415,11/1/2022,GIB,Johor,0,0,0,Gibraltar
58416,11/1/2022,GIB,Sarawak,0,0,0,Gibraltar
58417,11/1/2022,GIN,Johor,3,2,1,Guinea
58418,11/1/2022,GIN,Kedah,0,0,0,Guinea
58419,11/1/2022,GIN,Kelantan,0,0,0,Guinea
58420,11/1/2022,GIN,Perlis,2,2,0,Guinea
58421,11/1/2022,GIN,Pulau Pinang,0,0,0,Guinea
58422,11/1/2022,GIN,Sabah,0,0,0,Guinea
58423,11/1/2022,GIN,Sarawak,0,0,0,Guinea
58424,11/1/2022,GIN,Selangor,46,35,11,Guinea
58425,11/1/2022,GLP,Selangor,0,0,0,Guadeloupe
58426,11/1/2022,GMB,Johor,2,2,0,Gambia
58427,11/1/2022,GMB,Kedah,0,0,0,Gambia
58428,11/1/2022,GMB,Kelantan,0,0,0,Gambia
58429,11/1/2022,GMB,Pulau Pinang,0,0,0,Gambia
58430,11/1/2022,GMB,Sabah,0,0,0,Gambia
58431,11/1/2022,GMB,Sarawak,0,0,0,Gambia
58432,11/1/2022,GMB,Selangor,11,5,6,Gambia
58433,11/1/2022,GNB,Johor,0,0,0,Guinea-Bissau
58434,11/1/2022,GNB,Selangor,0,0,0,Guinea-Bissau
58435,11/1/2022,GNQ,Johor,0,0,0,Equatorial Guinea
58436,11/1/2022,GNQ,Selangor,1,1,0,Equatorial Guinea
58437,11/1/2022,GRC,Johor,45,37,8,Greece
58438,11/1/2022,GRC,Kedah,6,4,2,Greece
58439,11/1/2022,GRC,Kelantan,0,0,0,Greece
58440,11/1/2022,GRC,Melaka,0,0,0,Greece
58441,11/1/2022,GRC,Negeri Sembilan,0,0,0,Greece
58442,11/1/2022,GRC,Pahang,0,0,0,Greece
58443,11/1/2022,GRC,Perak,1,1,0,Greece
58444,11/1/2022,GRC,Perlis,1,0,1,Greece
58445,11/1/2022,GRC,Pulau Pinang,5,5,0,Greece
58446,11/1/2022,GRC,Sabah,2,1,1,Greece
58447,11/1/2022,GRC,Sarawak,2,1,1,Greece
58448,11/1/2022,GRC,Selangor,221,168,53,Greece
58449,11/1/2022,GRD,Johor,6,4,2,Grenada
58450,11/1/2022,GRD,Kedah,0,0,0,Grenada
58451,11/1/2022,GRD,Pulau Pinang,1,0,1,Grenada
58452,11/1/2022,GRD,Sabah,0,0,0,Grenada
58453,11/1/2022,GRD,Sarawak,1,1,0,Grenada
58454,11/1/2022,GRD,Selangor,7,7,0,Grenada
58455,11/1/2022,GRL,Johor,0,0,0,Greenland
58456,11/1/2022,GRL,Selangor,0,0,0,Greenland
58457,11/1/2022,GTM,Johor,0,0,0,Guatemala
58458,11/1/2022,GTM,Kedah,0,0,0,Guatemala
58459,11/1/2022,GTM,Pahang,0,0,0,Guatemala
58460,11/1/2022,GTM,Perak,0,0,0,Guatemala
58461,11/1/2022,GTM,Pulau Pinang,0,0,0,Guatemala
58462,11/1/2022,GTM,Sabah,0,0,0,Guatemala
58463,11/1/2022,GTM,Sarawak,0,0,0,Guatemala
58464,11/1/2022,GTM,Selangor,16,10,6,Guatemala
58465,11/1/2022,GTM,W.P. Labuan,0,0,0,Guatemala
58466,11/1/2022,GUY,Johor,0,0,0,Guyana
58467,11/1/2022,GUY,Kedah,0,0,0,Guyana
58468,11/1/2022,GUY,Pulau Pinang,0,0,0,Guyana
58469,11/1/2022,GUY,Sarawak,0,0,0,Guyana
58470,11/1/2022,GUY,Selangor,4,3,1,Guyana
58471,11/1/2022,HKG,Johor,1,0,1,Hong Kong
58472,11/1/2022,HKG,Kedah,0,0,0,Hong Kong
58473,11/1/2022,HKG,Kelantan,0,0,0,Hong Kong
58474,11/1/2022,HKG,Pahang,0,0,0,Hong Kong
58475,11/1/2022,HKG,Perak,30,17,13,Hong Kong
58476,11/1/2022,HKG,Perlis,2,2,0,Hong Kong
58477,11/1/2022,HKG,Pulau Pinang,0,0,0,Hong Kong
58478,11/1/2022,HKG,Sabah,1,0,1,Hong Kong
58479,11/1/2022,HKG,Sarawak,0,0,0,Hong Kong
58480,11/1/2022,HKG,Selangor,24,12,12,Hong Kong
58481,11/1/2022,HKG,Terengganu,0,0,0,Hong Kong
58482,11/1/2022,HMD,Johor,0,0,0,Heard Island and McDonald Islands
58483,11/1/2022,HND,Johor,2,2,0,Honduras
58484,11/1/2022,HND,Kedah,0,0,0,Honduras
58485,11/1/2022,HND,Perak,0,0,0,Honduras
58486,11/1/2022,HND,Pulau Pinang,2,1,1,Honduras
58487,11/1/2022,HND,Sabah,0,0,0,Honduras
58488,11/1/2022,HND,Sarawak,0,0,0,Honduras
58489,11/1/2022,HND,Selangor,9,5,4,Honduras
58490,11/1/2022,HRV,Johor,24,22,2,Croatia
58491,11/1/2022,HRV,Kedah,6,3,3,Croatia
58492,11/1/2022,HRV,Kelantan,0,0,0,Croatia
58493,11/1/2022,HRV,Melaka,0,0,0,Croatia
58494,11/1/2022,HRV,Pahang,0,0,0,Croatia
58495,11/1/2022,HRV,Perak,0,0,0,Croatia
58496,11/1/2022,HRV,Perlis,0,0,0,Croatia
58497,11/1/2022,HRV,Pulau Pinang,2,2,0,Croatia
58498,11/1/2022,HRV,Sabah,2,1,1,Croatia
58499,11/1/2022,HRV,Sarawak,5,4,1,Croatia
58500,11/1/2022,HRV,Selangor,141,96,45,Croatia
58501,11/1/2022,HTI,Johor,0,0,0,Haiti
58502,11/1/2022,HTI,Kedah,0,0,0,Haiti
58503,11/1/2022,HTI,Kelantan,0,0,0,Haiti
58504,11/1/2022,HTI,Perak,0,0,0,Haiti
58505,11/1/2022,HTI,Pulau Pinang,0,0,0,Haiti
58506,11/1/2022,HTI,Sabah,0,0,0,Haiti
58507,11/1/2022,HTI,Selangor,6,2,4,Haiti
58508,11/1/2022,HUN,Johor,98,58,40,Hungary
58509,11/1/2022,HUN,Kedah,9,5,4,Hungary
58510,11/1/2022,HUN,Kelantan,0,0,0,Hungary
58511,11/1/2022,HUN,Pahang,0,0,0,Hungary
58512,11/1/2022,HUN,Perak,0,0,0,Hungary
58513,11/1/2022,HUN,Perlis,4,2,2,Hungary
58514,11/1/2022,HUN,Pulau Pinang,13,10,3,Hungary
58515,11/1/2022,HUN,Sabah,7,5,2,Hungary
58516,11/1/2022,HUN,Sarawak,6,4,2,Hungary
58517,11/1/2022,HUN,Selangor,372,206,166,Hungary
58518,11/1/2022,HUN,W.P. Labuan,0,0,0,Hungary
58519,11/1/2022,IDN,Johor,96592,52990,43602,Indonesia
58520,11/1/2022,IDN,Kedah,3884,1470,2414,Indonesia
58521,11/1/2022,IDN,Kelantan,181,155,26,Indonesia
58522,11/1/2022,IDN,Melaka,5119,2322,2797,Indonesia
58523,11/1/2022,IDN,Negeri Sembilan,6786,4580,2206,Indonesia
58524,11/1/2022,IDN,Pahang,3,3,0,Indonesia
58525,11/1/2022,IDN,Perak,200,100,100,Indonesia
58526,11/1/2022,IDN,Perlis,354,175,179,Indonesia
58527,11/1/2022,IDN,Pulau Pinang,23905,8712,15193,Indonesia
58528,11/1/2022,IDN,Sabah,3585,1822,1763,Indonesia
58529,11/1/2022,IDN,Sarawak,28333,15737,12596,Indonesia
58530,11/1/2022,IDN,Selangor,83310,41495,41815,Indonesia
58531,11/1/2022,IDN,Terengganu,1,1,0,Indonesia
58532,11/1/2022,IDN,W.P. Labuan,85,50,35,Indonesia
58533,11/1/2022,IND,Johor,14093,9759,4334,India
58534,11/1/2022,IND,Kedah,482,290,192,India
58535,11/1/2022,IND,Kelantan,1,1,0,India
58536,11/1/2022,IND,Melaka,0,0,0,India
58537,11/1/2022,IND,Negeri Sembilan,0,0,0,India
58538,11/1/2022,IND,Pahang,0,0,0,India
58539,11/1/2022,IND,Perak,269,196,73,India
58540,11/1/2022,IND,Perlis,14,11,3,India
58541,11/1/2022,IND,Pulau Pinang,564,437,127,India
58542,11/1/2022,IND,Sabah,161,128,33,India
58543,11/1/2022,IND,Sarawak,646,515,131,India
58544,11/1/2022,IND,Selangor,44374,32516,11858,India
58545,11/1/2022,IND,Terengganu,1,1,0,India
58546,11/1/2022,IND,W.P. Labuan,31,26,5,India
58547,11/1/2022,IOT,Pulau Pinang,0,0,0,British Indian Ocean Territory
58548,11/1/2022,IOT,Selangor,1,1,0,British Indian Ocean Territory
58549,11/1/2022,IRL,Johor,270,182,88,Ireland
58550,11/1/2022,IRL,Kedah,66,35,31,Ireland
58551,11/1/2022,IRL,Kelantan,0,0,0,Ireland
58552,11/1/2022,IRL,Negeri Sembilan,0,0,0,Ireland
58553,11/1/2022,IRL,Pahang,1,1,0,Ireland
58554,11/1/2022,IRL,Perak,5,4,1,Ireland
58555,11/1/2022,IRL,Perlis,18,13,5,Ireland
58556,11/1/2022,IRL,Pulau Pinang,91,60,31,Ireland
58557,11/1/2022,IRL,Sabah,9,3,6,Ireland
58558,11/1/2022,IRL,Sarawak,24,19,5,Ireland
58559,11/1/2022,IRL,Selangor,896,543,353,Ireland
58560,11/1/2022,IRL,Terengganu,0,0,0,Ireland
58561,11/1/2022,IRL,W.P. Labuan,1,1,0,Ireland
58562,11/1/2022,IRN,Johor,78,54,24,Iran
58563,11/1/2022,IRN,Kedah,12,9,3,Iran
58564,11/1/2022,IRN,Kelantan,0,0,0,Iran
58565,11/1/2022,IRN,Perak,1,1,0,Iran
58566,11/1/2022,IRN,Perlis,0,0,0,Iran
58567,11/1/2022,IRN,Pulau Pinang,7,3,4,Iran
58568,11/1/2022,IRN,Sabah,1,1,0,Iran
58569,11/1/2022,IRN,Sarawak,6,3,3,Iran
58570,11/1/2022,IRN,Selangor,876,479,397,Iran
58571,11/1/2022,IRN,W.P. Labuan,0,0,0,Iran
58572,11/1/2022,IRQ,Johor,25,24,1,Iraq
58573,11/1/2022,IRQ,Kedah,2,1,1,Iraq
58574,11/1/2022,IRQ,Kelantan,0,0,0,Iraq
58575,11/1/2022,IRQ,Melaka,0,0,0,Iraq
58576,11/1/2022,IRQ,Pahang,0,0,0,Iraq
58577,11/1/2022,IRQ,Perak,0,0,0,Iraq
58578,11/1/2022,IRQ,Perlis,1,1,0,Iraq
58579,11/1/2022,IRQ,Pulau Pinang,0,0,0,Iraq
58580,11/1/2022,IRQ,Sabah,0,0,0,Iraq
58581,11/1/2022,IRQ,Sarawak,0,0,0,Iraq
58582,11/1/2022,IRQ,Selangor,939,732,207,Iraq
58583,11/1/2022,ISL,Johor,6,1,5,Iceland
58584,11/1/2022,ISL,Kedah,1,1,0,Iceland
58585,11/1/2022,ISL,Kelantan,0,0,0,Iceland
58586,11/1/2022,ISL,Perak,0,0,0,Iceland
58587,11/1/2022,ISL,Perlis,1,1,0,Iceland
58588,11/1/2022,ISL,Pulau Pinang,3,1,2,Iceland
58589,11/1/2022,ISL,Sabah,0,0,0,Iceland
58590,11/1/2022,ISL,Sarawak,1,0,1,Iceland
58591,11/1/2022,ISL,Selangor,26,19,7,Iceland
58592,11/1/2022,ISL,W.P. Labuan,0,0,0,Iceland
58593,11/1/2022,ISR,Pulau Pinang,1,1,0,Israel
58594,11/1/2022,ITA,Johor,444,346,98,Italy
58595,11/1/2022,ITA,Kedah,98,59,39,Italy
58596,11/1/2022,ITA,Kelantan,5,4,1,Italy
58597,11/1/2022,ITA,Melaka,1,1,0,Italy
58598,11/1/2022,ITA,Negeri Sembilan,0,0,0,Italy
58599,11/1/2022,ITA,Pahang,0,0,0,Italy
58600,11/1/2022,ITA,Perak,3,3,0,Italy
58601,11/1/2022,ITA,Perlis,13,10,3,Italy
58602,11/1/2022,ITA,Pulau Pinang,73,59,14,Italy
58603,11/1/2022,ITA,Sabah,28,21,7,Italy
58604,11/1/2022,ITA,Sarawak,120,80,40,Italy
58605,11/1/2022,ITA,Selangor,1756,1288,468,Italy
58606,11/1/2022,ITA,W.P. Labuan,0,0,0,Italy
58607,11/1/2022,JAM,Johor,4,3,1,Jamaica
58608,11/1/2022,JAM,Kedah,0,0,0,Jamaica
58609,11/1/2022,JAM,Perak,0,0,0,Jamaica
58610,11/1/2022,JAM,Pulau Pinang,1,1,0,Jamaica
58611,11/1/2022,JAM,Sabah,0,0,0,Jamaica
58612,11/1/2022,JAM,Sarawak,0,0,0,Jamaica
58613,11/1/2022,JAM,Selangor,16,9,7,Jamaica
58614,11/1/2022,JAM,W.P. Labuan,0,0,0,Jamaica
58615,11/1/2022,JOR,Johor,12,8,4,Jordan
58616,11/1/2022,JOR,Kedah,0,0,0,Jordan
58617,11/1/2022,JOR,Kelantan,0,0,0,Jordan
58618,11/1/2022,JOR,Melaka,0,0,0,Jordan
58619,11/1/2022,JOR,Perlis,1,1,0,Jordan
58620,11/1/2022,JOR,Pulau Pinang,1,1,0,Jordan
58621,11/1/2022,JOR,Sabah,0,0,0,Jordan
58622,11/1/2022,JOR,Sarawak,3,3,0,Jordan
58623,11/1/2022,JOR,Selangor,600,374,226,Jordan
58624,11/1/2022,JOR,W.P. Labuan,0,0,0,Jordan
58625,11/1/2022,JPN,Johor,4561,3295,1266,Japan
58626,11/1/2022,JPN,Kedah,200,107,93,Japan
58627,11/1/2022,JPN,Kelantan,6,3,3,Japan
58628,11/1/2022,JPN,Melaka,1,0,1,Japan
58629,11/1/2022,JPN,Negeri Sembilan,0,0,0,Japan
58630,11/1/2022,JPN,Pahang,0,0,0,Japan
58631,11/1/2022,JPN,Perak,43,31,12,Japan
58632,11/1/2022,JPN,Perlis,38,27,11,Japan
58633,11/1/2022,JPN,Pulau Pinang,913,726,187,Japan
58634,11/1/2022,JPN,Sabah,157,98,59,Japan
58635,11/1/2022,JPN,Sarawak,171,108,63,Japan
58636,11/1/2022,JPN,Selangor,11128,7760,3368,Japan
58637,11/1/2022,JPN,W.P. Labuan,4,3,1,Japan
58638,11/1/2022,KAZ,Johor,49,26,23,Kazakhstan
58639,11/1/2022,KAZ,Kedah,11,7,4,Kazakhstan
58640,11/1/2022,KAZ,Kelantan,7,3,4,Kazakhstan
58641,11/1/2022,KAZ,Melaka,0,0,0,Kazakhstan
58642,11/1/2022,KAZ,Perak,1,1,0,Kazakhstan
58643,11/1/2022,KAZ,Perlis,9,6,3,Kazakhstan
58644,11/1/2022,KAZ,Pulau Pinang,5,4,1,Kazakhstan
58645,11/1/2022,KAZ,Sabah,2,2,0,Kazakhstan
58646,11/1/2022,KAZ,Sarawak,6,1,5,Kazakhstan
58647,11/1/2022,KAZ,Selangor,431,177,254,Kazakhstan
58648,11/1/2022,KAZ,W.P. Labuan,0,0,0,Kazakhstan
58649,11/1/2022,KEN,Johor,62,30,32,Kenya
58650,11/1/2022,KEN,Kedah,1,1,0,Kenya
58651,11/1/2022,KEN,Kelantan,0,0,0,Kenya
58652,11/1/2022,KEN,Perak,0,0,0,Kenya
58653,11/1/2022,KEN,Perlis,0,0,0,Kenya
58654,11/1/2022,KEN,Pulau Pinang,3,1,2,Kenya
58655,11/1/2022,KEN,Sabah,1,0,1,Kenya
58656,11/1/2022,KEN,Sarawak,1,1,0,Kenya
58657,11/1/2022,KEN,Selangor,278,144,134,Kenya
58658,11/1/2022,KGZ,Johor,17,9,8,Kyrgyzstan
58659,11/1/2022,KGZ,Kedah,0,0,0,Kyrgyzstan
58660,11/1/2022,KGZ,Kelantan,0,0,0,Kyrgyzstan
58661,11/1/2022,KGZ,Perak,0,0,0,Kyrgyzstan
58662,11/1/2022,KGZ,Perlis,0,0,0,Kyrgyzstan
58663,11/1/2022,KGZ,Pulau Pinang,0,0,0,Kyrgyzstan
58664,11/1/2022,KGZ,Sabah,0,0,0,Kyrgyzstan
58665,11/1/2022,KGZ,Sarawak,1,0,1,Kyrgyzstan
58666,11/1/2022,KGZ,Selangor,127,68,59,Kyrgyzstan
58667,11/1/2022,KHM,Johor,2587,1117,1470,Cambodia
58668,11/1/2022,KHM,Kedah,308,259,49,Cambodia
58669,11/1/2022,KHM,Kelantan,428,235,193,Cambodia
58670,11/1/2022,KHM,Melaka,0,0,0,Cambodia
58671,11/1/2022,KHM,Negeri Sembilan,0,0,0,Cambodia
58672,11/1/2022,KHM,Pahang,0,0,0,Cambodia
58673,11/1/2022,KHM,Perak,7,6,1,Cambodia
58674,11/1/2022,KHM,Perlis,760,513,247,Cambodia
58675,11/1/2022,KHM,Pulau Pinang,26,11,15,Cambodia
58676,11/1/2022,KHM,Sabah,0,0,0,Cambodia
58677,11/1/2022,KHM,Sarawak,8,4,4,Cambodia
58678,11/1/2022,KHM,Selangor,4934,2349,2585,Cambodia
58679,11/1/2022,KHM,W.P. Labuan,0,0,0,Cambodia
58680,11/1/2022,KIR,Johor,0,0,0,Kiribati
58681,11/1/2022,KIR,Sabah,1,0,1,Kiribati
58682,11/1/2022,KIR,Selangor,3,2,1,Kiribati
58683,11/1/2022,KNA,Johor,16,10,6,Saint Kitts and Nevis
58684,11/1/2022,KNA,Kedah,0,0,0,Saint Kitts and Nevis
58685,11/1/2022,KNA,Perlis,0,0,0,Saint Kitts and Nevis
58686,11/1/2022,KNA,Pulau Pinang,1,1,0,Saint Kitts and Nevis
58687,11/1/2022,KNA,Sabah,1,0,1,Saint Kitts and Nevis
58688,11/1/2022,KNA,Selangor,39,28,11,Saint Kitts and Nevis
58689,11/1/2022,KNA,W.P. Labuan,0,0,0,Saint Kitts and Nevis
58690,11/1/2022,KOR,Johor,6743,3831,2912,"Korea, Republic of (South Korea)"
58691,11/1/2022,KOR,Kedah,141,68,73,"Korea, Republic of (South Korea)"
58692,11/1/2022,KOR,Kelantan,0,0,0,"Korea, Republic of (South Korea)"
58693,11/1/2022,KOR,Melaka,4,3,1,"Korea, Republic of (South Korea)"
58694,11/1/2022,KOR,Negeri Sembilan,0,0,0,"Korea, Republic of (South Korea)"
58695,11/1/2022,KOR,Pahang,1,1,0,"Korea, Republic of (South Korea)"
58696,11/1/2022,KOR,Perak,18,10,8,"Korea, Republic of (South Korea)"
58697,11/1/2022,KOR,Perlis,52,35,17,"Korea, Republic of (South Korea)"
58698,11/1/2022,KOR,Pulau Pinang,360,233,127,"Korea, Republic of (South Korea)"
58699,11/1/2022,KOR,Sabah,9595,4219,5376,"Korea, Republic of (South Korea)"
58700,11/1/2022,KOR,Sarawak,133,83,50,"Korea, Republic of (South Korea)"
58701,11/1/2022,KOR,Selangor,8143,4862,3281,"Korea, Republic of (South Korea)"
58702,11/1/2022,KOR,Terengganu,0,0,0,"Korea, Republic of (South Korea)"
58703,11/1/2022,KOR,W.P. Labuan,2,2,0,"Korea, Republic of (South Korea)"
58704,11/1/2022,KWT,Johor,14,7,7,Kuwait
58705,11/1/2022,KWT,Kedah,2,1,1,Kuwait
58706,11/1/2022,KWT,Kelantan,0,0,0,Kuwait
58707,11/1/2022,KWT,Perak,0,0,0,Kuwait
58708,11/1/2022,KWT,Perlis,0,0,0,Kuwait
58709,11/1/2022,KWT,Pulau Pinang,0,0,0,Kuwait
58710,11/1/2022,KWT,Sabah,1,0,1,Kuwait
58711,11/1/2022,KWT,Sarawak,5,3,2,Kuwait
58712,11/1/2022,KWT,Selangor,306,203,103,Kuwait
58713,11/1/2022,KWT,W.P. Labuan,0,0,0,Kuwait
58714,11/1/2022,LAO,Johor,135,34,101,Lao People's Democratic Republic
58715,11/1/2022,LAO,Kedah,747,51,696,Lao People's Democratic Republic
58716,11/1/2022,LAO,Kelantan,104,9,95,Lao People's Democratic Republic
58717,11/1/2022,LAO,Melaka,0,0,0,Lao People's Democratic Republic
58718,11/1/2022,LAO,Perak,6,1,5,Lao People's Democratic Republic
58719,11/1/2022,LAO,Perlis,246,74,172,Lao People's Democratic Republic
58720,11/1/2022,LAO,Pulau Pinang,18,5,13,Lao People's Democratic Republic
58721,11/1/2022,LAO,Sabah,3,1,2,Lao People's Democratic Republic
58722,11/1/2022,LAO,Sarawak,3,1,2,Lao People's Democratic Republic
58723,11/1/2022,LAO,Selangor,246,90,156,Lao People's Democratic Republic
58724,11/1/2022,LAO,W.P. Labuan,0,0,0,Lao People's Democratic Republic
58725,11/1/2022,LBN,Johor,7,7,0,Lebanon
58726,11/1/2022,LBN,Kedah,0,0,0,Lebanon
58727,11/1/2022,LBN,Kelantan,0,0,0,Lebanon
58728,11/1/2022,LBN,Pahang,0,0,0,Lebanon
58729,11/1/2022,LBN,Perak,0,0,0,Lebanon
58730,11/1/2022,LBN,Perlis,0,0,0,Lebanon
58731,11/1/2022,LBN,Pulau Pinang,2,1,1,Lebanon
58732,11/1/2022,LBN,Sabah,0,0,0,Lebanon
58733,11/1/2022,LBN,Sarawak,2,2,0,Lebanon
58734,11/1/2022,LBN,Selangor,178,125,53,Lebanon
58735,11/1/2022,LBN,W.P. Labuan,0,0,0,Lebanon
58736,11/1/2022,LBR,Johor,0,0,0,Liberia
58737,11/1/2022,LBR,Kedah,0,0,0,Liberia
58738,11/1/2022,LBR,Sabah,0,0,0,Liberia
58739,11/1/2022,LBR,Sarawak,0,0,0,Liberia
58740,11/1/2022,LBR,Selangor,4,3,1,Liberia
58741,11/1/2022,LBY,Johor,2,0,2,Libyan Arab Jamahiriya
58742,11/1/2022,LBY,Kedah,0,0,0,Libyan Arab Jamahiriya
58743,11/1/2022,LBY,Perlis,0,0,0,Libyan Arab Jamahiriya
58744,11/1/2022,LBY,Pulau Pinang,1,1,0,Libyan Arab Jamahiriya
58745,11/1/2022,LBY,Sabah,1,1,0,Libyan Arab Jamahiriya
58746,11/1/2022,LBY,Sarawak,4,2,2,Libyan Arab Jamahiriya
58747,11/1/2022,LBY,Selangor,251,173,78,Libyan Arab Jamahiriya
58748,11/1/2022,LCA,Johor,6,6,0,Saint Lucia
58749,11/1/2022,LCA,Kedah,0,0,0,Saint Lucia
58750,11/1/2022,LCA,Pulau Pinang,0,0,0,Saint Lucia
58751,11/1/2022,LCA,Sarawak,0,0,0,Saint Lucia
58752,11/1/2022,LCA,Selangor,5,4,1,Saint Lucia
58753,11/1/2022,LIE,Johor,3,2,1,Liechtenstein
58754,11/1/2022,LIE,Kedah,0,0,0,Liechtenstein
58755,11/1/2022,LIE,Perlis,0,0,0,Liechtenstein
58756,11/1/2022,LIE,Pulau Pinang,3,2,1,Liechtenstein
58757,11/1/2022,LIE,Sabah,0,0,0,Liechtenstein
58758,11/1/2022,LIE,Sarawak,0,0,0,Liechtenstein
58759,11/1/2022,LIE,Selangor,4,3,1,Liechtenstein
58760,11/1/2022,LKA,Johor,773,509,264,Sri Lanka
58761,11/1/2022,LKA,Kedah,19,11,8,Sri Lanka
58762,11/1/2022,LKA,Kelantan,0,0,0,Sri Lanka
58763,11/1/2022,LKA,Melaka,0,0,0,Sri Lanka
58764,11/1/2022,LKA,Pahang,0,0,0,Sri Lanka
58765,11/1/2022,LKA,Perak,1,1,0,Sri Lanka
58766,11/1/2022,LKA,Perlis,0,0,0,Sri Lanka
58767,11/1/2022,LKA,Pulau Pinang,9,9,0,Sri Lanka
58768,11/1/2022,LKA,Sabah,0,0,0,Sri Lanka
58769,11/1/2022,LKA,Sarawak,17,12,5,Sri Lanka
58770,11/1/2022,LKA,Selangor,3272,2140,1132,Sri Lanka
58771,11/1/2022,LKA,W.P. Labuan,0,0,0,Sri Lanka
58772,11/1/2022,LSO,Johor,1,1,0,Lesotho
58773,11/1/2022,LSO,Kedah,0,0,0,Lesotho
58774,11/1/2022,LSO,Pulau Pinang,0,0,0,Lesotho
58775,11/1/2022,LSO,Sarawak,0,0,0,Lesotho
58776,11/1/2022,LSO,Selangor,5,2,3,Lesotho
58777,11/1/2022,LTU,Johor,44,20,24,Lithuania
58778,11/1/2022,LTU,Kedah,6,3,3,Lithuania
58779,11/1/2022,LTU,Kelantan,0,0,0,Lithuania
58780,11/1/2022,LTU,Pahang,0,0,0,Lithuania
58781,11/1/2022,LTU,Perak,0,0,0,Lithuania
58782,11/1/2022,LTU,Perlis,5,4,1,Lithuania
58783,11/1/2022,LTU,Pulau Pinang,6,4,2,Lithuania
58784,11/1/2022,LTU,Sabah,1,1,0,Lithuania
58785,11/1/2022,LTU,Sarawak,5,3,2,Lithuania
58786,11/1/2022,LTU,Selangor,220,118,102,Lithuania
58787,11/1/2022,LTU,W.P. Labuan,0,0,0,Lithuania
58788,11/1/2022,LUX,Johor,11,3,8,Luxembourg
58789,11/1/2022,LUX,Kedah,1,1,0,Luxembourg
58790,11/1/2022,LUX,Kelantan,0,0,0,Luxembourg
58791,11/1/2022,LUX,Perak,0,0,0,Luxembourg
58792,11/1/2022,LUX,Perlis,0,0,0,Luxembourg
58793,11/1/2022,LUX,Pulau Pinang,2,1,1,Luxembourg
58794,11/1/2022,LUX,Sabah,0,0,0,Luxembourg
58795,11/1/2022,LUX,Sarawak,1,0,1,Luxembourg
58796,11/1/2022,LUX,Selangor,29,16,13,Luxembourg
58797,11/1/2022,LVA,Johor,15,12,3,Latvia
58798,11/1/2022,LVA,Kedah,1,0,1,Latvia
58799,11/1/2022,LVA,Kelantan,0,0,0,Latvia
58800,11/1/2022,LVA,Pahang,0,0,0,Latvia
58801,11/1/2022,LVA,Perak,0,0,0,Latvia
58802,11/1/2022,LVA,Perlis,0,0,0,Latvia
58803,11/1/2022,LVA,Pulau Pinang,1,1,0,Latvia
58804,11/1/2022,LVA,Sabah,1,0,1,Latvia
58805,11/1/2022,LVA,Sarawak,7,3,4,Latvia
58806,11/1/2022,LVA,Selangor,106,51,55,Latvia
58807,11/1/2022,LVA,W.P. Labuan,0,0,0,Latvia
58808,11/1/2022,MAC,Johor,0,0,0,Macao
58809,11/1/2022,MAC,Pahang,0,0,0,Macao
58810,11/1/2022,MAC,Perak,1,0,1,Macao
58811,11/1/2022,MAC,Selangor,0,0,0,Macao
58812,11/1/2022,MAC,W.P. Labuan,1,1,0,Macao
58813,11/1/2022,MAR,Johor,64,43,21,Morocco
58814,11/1/2022,MAR,Kedah,5,3,2,Morocco
58815,11/1/2022,MAR,Kelantan,0,0,0,Morocco
58816,11/1/2022,MAR,Melaka,0,0,0,Morocco
58817,11/1/2022,MAR,Pahang,0,0,0,Morocco
58818,11/1/2022,MAR,Perak,0,0,0,Morocco
58819,11/1/2022,MAR,Perlis,1,1,0,Morocco
58820,11/1/2022,MAR,Pulau Pinang,13,7,6,Morocco
58821,11/1/2022,MAR,Sabah,1,0,1,Morocco
58822,11/1/2022,MAR,Sarawak,3,2,1,Morocco
58823,11/1/2022,MAR,Selangor,491,284,207,Morocco
58824,11/1/2022,MAR,W.P. Labuan,0,0,0,Morocco
58825,11/1/2022,MCO,Johor,1,1,0,Monaco
58826,11/1/2022,MCO,Kedah,0,0,0,Monaco
58827,11/1/2022,MCO,Sabah,0,0,0,Monaco
58828,11/1/2022,MCO,Selangor,3,0,3,Monaco
58829,11/1/2022,MDA,Johor,1,1,0,"Moldova, Republic of"
58830,11/1/2022,MDA,Kedah,2,1,1,"Moldova, Republic of"
58831,11/1/2022,MDA,Kelantan,0,0,0,"Moldova, Republic of"
58832,11/1/2022,MDA,Negeri Sembilan,0,0,0,"Moldova, Republic of"
58833,11/1/2022,MDA,Perlis,0,0,0,"Moldova, Republic of"
58834,11/1/2022,MDA,Pulau Pinang,0,0,0,"Moldova, Republic of"
58835,11/1/2022,MDA,Sabah,1,0,1,"Moldova, Republic of"
58836,11/1/2022,MDA,Sarawak,1,0,1,"Moldova, Republic of"
58837,11/1/2022,MDA,Selangor,41,23,18,"Moldova, Republic of"
58838,11/1/2022,MDG,Johor,10,2,8,Madagascar
58839,11/1/2022,MDG,Kedah,0,0,0,Madagascar
58840,11/1/2022,MDG,Perak,0,0,0,Madagascar
58841,11/1/2022,MDG,Perlis,0,0,0,Madagascar
58842,11/1/2022,MDG,Pulau Pinang,1,0,1,Madagascar
58843,11/1/2022,MDG,Sabah,0,0,0,Madagascar
58844,11/1/2022,MDG,Sarawak,0,0,0,Madagascar
58845,11/1/2022,MDG,Selangor,43,13,30,Madagascar
58846,11/1/2022,MDV,Johor,122,67,55,Maldives
58847,11/1/2022,MDV,Kedah,2,1,1,Maldives
58848,11/1/2022,MDV,Kelantan,0,0,0,Maldives
58849,11/1/2022,MDV,Perak,0,0,0,Maldives
58850,11/1/2022,MDV,Perlis,3,3,0,Maldives
58851,11/1/2022,MDV,Pulau Pinang,8,8,0,Maldives
58852,11/1/2022,MDV,Sabah,0,0,0,Maldives
58853,11/1/2022,MDV,Sarawak,1,1,0,Maldives
58854,11/1/2022,MDV,Selangor,1739,913,826,Maldives
58855,11/1/2022,MEX,Johor,95,53,42,Mexico
58856,11/1/2022,MEX,Kedah,10,3,7,Mexico
58857,11/1/2022,MEX,Kelantan,0,0,0,Mexico
58858,11/1/2022,MEX,Pahang,0,0,0,Mexico
58859,11/1/2022,MEX,Perak,0,0,0,Mexico
58860,11/1/2022,MEX,Perlis,0,0,0,Mexico
58861,11/1/2022,MEX,Pulau Pinang,37,26,11,Mexico
58862,11/1/2022,MEX,Sabah,1,0,1,Mexico
58863,11/1/2022,MEX,Sarawak,2,1,1,Mexico
58864,11/1/2022,MEX,Selangor,456,236,220,Mexico
58865,11/1/2022,MEX,W.P. Labuan,0,0,0,Mexico
58866,11/1/2022,MHL,Johor,0,0,0,Marshall Islands
58867,11/1/2022,MHL,Kedah,0,0,0,Marshall Islands
58868,11/1/2022,MHL,Perak,0,0,0,Marshall Islands
58869,11/1/2022,MHL,Pulau Pinang,0,0,0,Marshall Islands
58870,11/1/2022,MHL,Sabah,0,0,0,Marshall Islands
58871,11/1/2022,MHL,Selangor,4,3,1,Marshall Islands
58872,11/1/2022,MKD,Johor,7,4,3,"Macedonia, the former Yugoslav Republic of"
58873,11/1/2022,MKD,Kedah,0,0,0,"Macedonia, the former Yugoslav Republic of"
58874,11/1/2022,MKD,Perak,0,0,0,"Macedonia, the former Yugoslav Republic of"
58875,11/1/2022,MKD,Pulau Pinang,0,0,0,"Macedonia, the former Yugoslav Republic of"
58876,11/1/2022,MKD,Sabah,0,0,0,"Macedonia, the former Yugoslav Republic of"
58877,11/1/2022,MKD,Sarawak,0,0,0,"Macedonia, the former Yugoslav Republic of"
58878,11/1/2022,MKD,Selangor,17,14,3,"Macedonia, the former Yugoslav Republic of"
58879,11/1/2022,MLI,Johor,0,0,0,Mali
58880,11/1/2022,MLI,Sabah,0,0,0,Mali
58881,11/1/2022,MLI,Selangor,3,3,0,Mali
58882,11/1/2022,MLT,Johor,6,2,4,Malta
58883,11/1/2022,MLT,Kedah,3,2,1,Malta
58884,11/1/2022,MLT,Kelantan,0,0,0,Malta
58885,11/1/2022,MLT,Perak,0,0,0,Malta
58886,11/1/2022,MLT,Perlis,0,0,0,Malta
58887,11/1/2022,MLT,Pulau Pinang,39,22,17,Malta
58888,11/1/2022,MLT,Sabah,1,1,0,Malta
58889,11/1/2022,MLT,Sarawak,0,0,0,Malta
58890,11/1/2022,MLT,Selangor,34,21,13,Malta
58891,11/1/2022,MLT,W.P. Labuan,0,0,0,Malta
58892,11/1/2022,MMR,Johor,3107,895,2212,Myanmar
58893,11/1/2022,MMR,Kedah,40,9,31,Myanmar
58894,11/1/2022,MMR,Kelantan,1,1,0,Myanmar
58895,11/1/2022,MMR,Negeri Sembilan,0,0,0,Myanmar
58896,11/1/2022,MMR,Pahang,0,0,0,Myanmar
58897,11/1/2022,MMR,Perak,21,4,17,Myanmar
58898,11/1/2022,MMR,Perlis,6,0,6,Myanmar
58899,11/1/2022,MMR,Pulau Pinang,172,89,83,Myanmar
58900,11/1/2022,MMR,Sabah,17,3,14,Myanmar
58901,11/1/2022,MMR,Sarawak,74,33,41,Myanmar
58902,11/1/2022,MMR,Selangor,8499,6288,2211,Myanmar
58903,11/1/2022,MMR,Terengganu,0,0,0,Myanmar
58904,11/1/2022,MMR,W.P. Labuan,0,0,0,Myanmar
58905,11/1/2022,MNE,Johor,1,1,0,Montenegro
58906,11/1/2022,MNE,Kedah,0,0,0,Montenegro
58907,11/1/2022,MNE,Pulau Pinang,0,0,0,Montenegro
58908,11/1/2022,MNE,Sabah,0,0,0,Montenegro
58909,11/1/2022,MNE,Sarawak,0,0,0,Montenegro
58910,11/1/2022,MNE,Selangor,10,10,0,Montenegro
58911,11/1/2022,MNG,Johor,119,62,57,Mongolia
58912,11/1/2022,MNG,Kedah,3,1,2,Mongolia
58913,11/1/2022,MNG,Kelantan,0,0,0,Mongolia
58914,11/1/2022,MNG,Perak,1,0,1,Mongolia
58915,11/1/2022,MNG,Perlis,8,6,2,Mongolia
58916,11/1/2022,MNG,Pulau Pinang,1,0,1,Mongolia
58917,11/1/2022,MNG,Sabah,3,2,1,Mongolia
58918,11/1/2022,MNG,Sarawak,2,2,0,Mongolia
58919,11/1/2022,MNG,Selangor,263,115,148,Mongolia
58920,11/1/2022,MNP,Selangor,0,0,0,Northern Mariana Islands
58921,11/1/2022,MOZ,Johor,0,0,0,Mozambique
58922,11/1/2022,MOZ,Kedah,0,0,0,Mozambique
58923,11/1/2022,MOZ,Perak,0,0,0,Mozambique
58924,11/1/2022,MOZ,Pulau Pinang,0,0,0,Mozambique
58925,11/1/2022,MOZ,Sabah,0,0,0,Mozambique
58926,11/1/2022,MOZ,Sarawak,0,0,0,Mozambique
58927,11/1/2022,MOZ,Selangor,14,10,4,Mozambique
58928,11/1/2022,MRT,Johor,2,2,0,Mauritania
58929,11/1/2022,MRT,Kedah,0,0,0,Mauritania
58930,11/1/2022,MRT,Pulau Pinang,0,0,0,Mauritania
58931,11/1/2022,MRT,Sabah,0,0,0,Mauritania
58932,11/1/2022,MRT,Sarawak,0,0,0,Mauritania
58933,11/1/2022,MRT,Selangor,24,22,2,Mauritania
58934,11/1/2022,MUS,Johor,175,100,75,Mauritius
58935,11/1/2022,MUS,Kedah,3,1,2,Mauritius
58936,11/1/2022,MUS,Kelantan,0,0,0,Mauritius
58937,11/1/2022,MUS,Pahang,0,0,0,Mauritius
58938,11/1/2022,MUS,Perak,3,1,2,Mauritius
58939,11/1/2022,MUS,Perlis,0,0,0,Mauritius
58940,11/1/2022,MUS,Pulau Pinang,13,9,4,Mauritius
58941,11/1/2022,MUS,Sabah,0,0,0,Mauritius
58942,11/1/2022,MUS,Sarawak,0,0,0,Mauritius
58943,11/1/2022,MUS,Selangor,2044,1015,1029,Mauritius
58944,11/1/2022,MWI,Johor,0,0,0,Malawi
58945,11/1/2022,MWI,Pulau Pinang,0,0,0,Malawi
58946,11/1/2022,MWI,Sabah,1,0,1,Malawi
58947,11/1/2022,MWI,Sarawak,2,0,2,Malawi
58948,11/1/2022,MWI,Selangor,37,19,18,Malawi
58949,11/1/2022,MYT,Selangor,0,0,0,Mayotte
58950,11/1/2022,NAM,Johor,0,0,0,Namibia
58951,11/1/2022,NAM,Kedah,1,0,1,Namibia
58952,11/1/2022,NAM,Perak,0,0,0,Namibia
58953,11/1/2022,NAM,Perlis,1,0,1,Namibia
58954,11/1/2022,NAM,Pulau Pinang,0,0,0,Namibia
58955,11/1/2022,NAM,Sabah,0,0,0,Namibia
58956,11/1/2022,NAM,Sarawak,0,0,0,Namibia
58957,11/1/2022,NAM,Selangor,12,5,7,Namibia
58958,11/1/2022,NCL,Selangor,0,0,0,New Caledonia
58959,11/1/2022,NER,Johor,0,0,0,Niger
58960,11/1/2022,NER,Sabah,0,0,0,Niger
58961,11/1/2022,NER,Selangor,0,0,0,Niger
58962,11/1/2022,NGA,Johor,36,30,6,Nigeria
58963,11/1/2022,NGA,Kedah,2,2,0,Nigeria
58964,11/1/2022,NGA,Perlis,0,0,0,Nigeria
58965,11/1/2022,NGA,Pulau Pinang,2,2,0,Nigeria
58966,11/1/2022,NGA,Sabah,0,0,0,Nigeria
58967,11/1/2022,NGA,Sarawak,4,2,2,Nigeria
58968,11/1/2022,NGA,Selangor,469,383,86,Nigeria
58969,11/1/2022,NIC,Johor,0,0,0,Nicaragua
58970,11/1/2022,NIC,Kedah,0,0,0,Nicaragua
58971,11/1/2022,NIC,Pulau Pinang,1,1,0,Nicaragua
58972,11/1/2022,NIC,Sabah,0,0,0,Nicaragua
58973,11/1/2022,NIC,Selangor,10,3,7,Nicaragua
58974,11/1/2022,NLD,Johor,777,537,240,Netherlands
58975,11/1/2022,NLD,Kedah,204,101,103,Netherlands
58976,11/1/2022,NLD,Kelantan,0,0,0,Netherlands
58977,11/1/2022,NLD,Melaka,3,2,1,Netherlands
58978,11/1/2022,NLD,Negeri Sembilan,4,3,1,Netherlands
58979,11/1/2022,NLD,Pahang,0,0,0,Netherlands
58980,11/1/2022,NLD,Perak,10,3,7,Netherlands
58981,11/1/2022,NLD,Perlis,31,18,13,Netherlands
58982,11/1/2022,NLD,Pulau Pinang,181,124,57,Netherlands
58983,11/1/2022,NLD,Sabah,43,25,18,Netherlands
58984,11/1/2022,NLD,Sarawak,120,76,44,Netherlands
58985,11/1/2022,NLD,Selangor,3078,1885,1193,Netherlands
58986,11/1/2022,NLD,Terengganu,0,0,0,Netherlands
58987,11/1/2022,NLD,W.P. Labuan,0,0,0,Netherlands
58988,11/1/2022,NOR,Johor,97,64,33,Norway
58989,11/1/2022,NOR,Kedah,20,13,7,Norway
58990,11/1/2022,NOR,Kelantan,0,0,0,Norway
58991,11/1/2022,NOR,Melaka,0,0,0,Norway
58992,11/1/2022,NOR,Pahang,0,0,0,Norway
58993,11/1/2022,NOR,Perak,0,0,0,Norway
58994,11/1/2022,NOR,Perlis,11,7,4,Norway
58995,11/1/2022,NOR,Pulau Pinang,16,11,5,Norway
58996,11/1/2022,NOR,Sabah,14,9,5,Norway
58997,11/1/2022,NOR,Sarawak,9,9,0,Norway
58998,11/1/2022,NOR,Selangor,561,375,186,Norway
58999,11/1/2022,NOR,W.P. Labuan,0,0,0,Norway
59000,11/1/2022,NPL,Johor,145,113,32,Nepal
59001,11/1/2022,NPL,Kedah,3,3,0,Nepal
59002,11/1/2022,NPL,Pahang,0,0,0,Nepal
59003,11/1/2022,NPL,Perak,0,0,0,Nepal
59004,11/1/2022,NPL,Perlis,0,0,0,Nepal
59005,11/1/2022,NPL,Pulau Pinang,14,14,0,Nepal
59006,11/1/2022,NPL,Sabah,8,3,5,Nepal
59007,11/1/2022,NPL,Sarawak,200,136,64,Nepal
59008,11/1/2022,NPL,Selangor,29515,28227,1288,Nepal
59009,11/1/2022,NPL,W.P. Labuan,59,56,3,Nepal
59010,11/1/2022,NRU,Johor,0,0,0,Nauru
59011,11/1/2022,NRU,Pulau Pinang,0,0,0,Nauru
59012,11/1/2022,NRU,Selangor,5,4,1,Nauru
59013,11/1/2022,NZL,Johor,627,350,277,New Zealand
59014,11/1/2022,NZL,Kedah,55,31,24,New Zealand
59015,11/1/2022,NZL,Kelantan,0,0,0,New Zealand
59016,11/1/2022,NZL,Melaka,0,0,0,New Zealand
59017,11/1/2022,NZL,Negeri Sembilan,0,0,0,New Zealand
59018,11/1/2022,NZL,Pahang,0,0,0,New Zealand
59019,11/1/2022,NZL,Perak,13,9,4,New Zealand
59020,11/1/2022,NZL,Perlis,13,10,3,New Zealand
59021,11/1/2022,NZL,Pulau Pinang,140,83,57,New Zealand
59022,11/1/2022,NZL,Sabah,31,20,11,New Zealand
59023,11/1/2022,NZL,Sarawak,86,54,32,New Zealand
59024,11/1/2022,NZL,Selangor,2223,1325,898,New Zealand
59025,11/1/2022,NZL,Terengganu,0,0,0,New Zealand
59026,11/1/2022,NZL,W.P. Labuan,0,0,0,New Zealand
59027,11/1/2022,OMN,Johor,43,28,15,Oman
59028,11/1/2022,OMN,Kedah,1,1,0,Oman
59029,11/1/2022,OMN,Kelantan,0,0,0,Oman
59030,11/1/2022,OMN,Melaka,0,0,0,Oman
59031,11/1/2022,OMN,Perak,0,0,0,Oman
59032,11/1/2022,OMN,Perlis,0,0,0,Oman
59033,11/1/2022,OMN,Pulau Pinang,6,5,1,Oman
59034,11/1/2022,OMN,Sabah,2,0,2,Oman
59035,11/1/2022,OMN,Sarawak,12,7,5,Oman
59036,11/1/2022,OMN,Selangor,591,390,201,Oman
59037,11/1/2022,PAK,Johor,828,630,198,Pakistan
59038,11/1/2022,PAK,Kedah,112,94,18,Pakistan
59039,11/1/2022,PAK,Kelantan,8,7,1,Pakistan
59040,11/1/2022,PAK,Melaka,0,0,0,Pakistan
59041,11/1/2022,PAK,Negeri Sembilan,0,0,0,Pakistan
59042,11/1/2022,PAK,Pahang,0,0,0,Pakistan
59043,11/1/2022,PAK,Perak,36,36,0,Pakistan
59044,11/1/2022,PAK,Perlis,22,21,1,Pakistan
59045,11/1/2022,PAK,Pulau Pinang,31,27,4,Pakistan
59046,11/1/2022,PAK,Sabah,4,4,0,Pakistan
59047,11/1/2022,PAK,Sarawak,91,73,18,Pakistan
59048,11/1/2022,PAK,Selangor,9096,7952,1144,Pakistan
59049,11/1/2022,PAK,W.P. Labuan,3,3,0,Pakistan
59050,11/1/2022,PAN,Johor,4,1,3,Panama
59051,11/1/2022,PAN,Kedah,0,0,0,Panama
59052,11/1/2022,PAN,Perak,0,0,0,Panama
59053,11/1/2022,PAN,Perlis,0,0,0,Panama
59054,11/1/2022,PAN,Pulau Pinang,0,0,0,Panama
59055,11/1/2022,PAN,Sabah,0,0,0,Panama
59056,11/1/2022,PAN,Sarawak,1,1,0,Panama
59057,11/1/2022,PAN,Selangor,20,8,12,Panama
59058,11/1/2022,PER,Johor,20,11,9,Peru
59059,11/1/2022,PER,Kedah,1,1,0,Peru
59060,11/1/2022,PER,Kelantan,0,0,0,Peru
59061,11/1/2022,PER,Pahang,0,0,0,Peru
59062,11/1/2022,PER,Perak,0,0,0,Peru
59063,11/1/2022,PER,Perlis,1,0,1,Peru
59064,11/1/2022,PER,Pulau Pinang,0,0,0,Peru
59065,11/1/2022,PER,Sabah,0,0,0,Peru
59066,11/1/2022,PER,Sarawak,0,0,0,Peru
59067,11/1/2022,PER,Selangor,100,49,51,Peru
59068,11/1/2022,PER,W.P. Labuan,0,0,0,Peru
59069,11/1/2022,PHL,Johor,16889,5358,11531,Philippines
59070,11/1/2022,PHL,Kedah,432,165,267,Philippines
59071,11/1/2022,PHL,Kelantan,23,10,13,Philippines
59072,11/1/2022,PHL,Melaka,1,0,1,Philippines
59073,11/1/2022,PHL,Negeri Sembilan,1,1,0,Philippines
59074,11/1/2022,PHL,Pahang,1,1,0,Philippines
59075,11/1/2022,PHL,Perak,62,23,39,Philippines
59076,11/1/2022,PHL,Perlis,103,36,67,Philippines
59077,11/1/2022,PHL,Pulau Pinang,383,131,252,Philippines
59078,11/1/2022,PHL,Sabah,1243,551,692,Philippines
59079,11/1/2022,PHL,Sarawak,1160,451,709,Philippines
59080,11/1/2022,PHL,Selangor,15381,5931,9450,Philippines
59081,11/1/2022,PHL,Terengganu,1,1,0,Philippines
59082,11/1/2022,PHL,W.P. Labuan,86,29,57,Philippines
59083,11/1/2022,PLW,Johor,1,1,0,Palau
59084,11/1/2022,PLW,Pulau Pinang,0,0,0,Palau
59085,11/1/2022,PLW,Selangor,0,0,0,Palau
59086,11/1/2022,PNG,Johor,13,6,7,Papua New Guinea
59087,11/1/2022,PNG,Kedah,0,0,0,Papua New Guinea
59088,11/1/2022,PNG,Kelantan,0,0,0,Papua New Guinea
59089,11/1/2022,PNG,Perak,0,0,0,Papua New Guinea
59090,11/1/2022,PNG,Pulau Pinang,0,0,0,Papua New Guinea
59091,11/1/2022,PNG,Sabah,0,0,0,Papua New Guinea
59092,11/1/2022,PNG,Sarawak,3,1,2,Papua New Guinea
59093,11/1/2022,PNG,Selangor,42,25,17,Papua New Guinea
59094,11/1/2022,POL,Johor,338,176,162,Poland
59095,11/1/2022,POL,Kedah,94,47,47,Poland
59096,11/1/2022,POL,Kelantan,1,1,0,Poland
59097,11/1/2022,POL,Melaka,0,0,0,Poland
59098,11/1/2022,POL,Negeri Sembilan,0,0,0,Poland
59099,11/1/2022,POL,Pahang,0,0,0,Poland
59100,11/1/2022,POL,Perak,5,4,1,Poland
59101,11/1/2022,POL,Perlis,11,7,4,Poland
59102,11/1/2022,POL,Pulau Pinang,128,74,54,Poland
59103,11/1/2022,POL,Sabah,36,23,13,Poland
59104,11/1/2022,POL,Sarawak,53,19,34,Poland
59105,11/1/2022,POL,Selangor,1235,669,566,Poland
59106,11/1/2022,POL,Terengganu,0,0,0,Poland
59107,11/1/2022,POL,W.P. Labuan,8,4,4,Poland
59108,11/1/2022,PRK,Selangor,0,0,0,"Korea, Democratic People's Republic of"
59109,11/1/2022,PRT,Johor,129,78,51,Portugal
59110,11/1/2022,PRT,Kedah,14,8,6,Portugal
59111,11/1/2022,PRT,Kelantan,0,0,0,Portugal
59112,11/1/2022,PRT,Melaka,0,0,0,Portugal
59113,11/1/2022,PRT,Pahang,0,0,0,Portugal
59114,11/1/2022,PRT,Perak,2,2,0,Portugal
59115,11/1/2022,PRT,Perlis,4,3,1,Portugal
59116,11/1/2022,PRT,Pulau Pinang,25,17,8,Portugal
59117,11/1/2022,PRT,Sabah,8,4,4,Portugal
59118,11/1/2022,PRT,Sarawak,9,8,1,Portugal
59119,11/1/2022,PRT,Selangor,568,344,224,Portugal
59120,11/1/2022,PRT,W.P. Labuan,1,0,1,Portugal
59121,11/1/2022,PRY,Johor,0,0,0,Paraguay
59122,11/1/2022,PRY,Kedah,0,0,0,Paraguay
59123,11/1/2022,PRY,Perak,0,0,0,Paraguay
59124,11/1/2022,PRY,Perlis,0,0,0,Paraguay
59125,11/1/2022,PRY,Pulau Pinang,0,0,0,Paraguay
59126,11/1/2022,PRY,Sabah,0,0,0,Paraguay
59127,11/1/2022,PRY,Sarawak,0,0,0,Paraguay
59128,11/1/2022,PRY,Selangor,6,4,2,Paraguay
59129,11/1/2022,PSE,Johor,2,2,0,"Palestinian Territory, Occupied"
59130,11/1/2022,PSE,Kedah,1,1,0,"Palestinian Territory, Occupied"
59131,11/1/2022,PSE,Kelantan,0,0,0,"Palestinian Territory, Occupied"
59132,11/1/2022,PSE,Melaka,0,0,0,"Palestinian Territory, Occupied"
59133,11/1/2022,PSE,Perak,0,0,0,"Palestinian Territory, Occupied"
59134,11/1/2022,PSE,Perlis,2,2,0,"Palestinian Territory, Occupied"
59135,11/1/2022,PSE,Pulau Pinang,2,2,0,"Palestinian Territory, Occupied"
59136,11/1/2022,PSE,Sabah,0,0,0,"Palestinian Territory, Occupied"
59137,11/1/2022,PSE,Sarawak,7,5,2,"Palestinian Territory, Occupied"
59138,11/1/2022,PSE,Selangor,254,172,82,"Palestinian Territory, Occupied"
59139,11/1/2022,QAT,Johor,18,14,4,Qatar
59140,11/1/2022,QAT,Kedah,0,0,0,Qatar
59141,11/1/2022,QAT,Perlis,0,0,0,Qatar
59142,11/1/2022,QAT,Pulau Pinang,4,3,1,Qatar
59143,11/1/2022,QAT,Sabah,0,0,0,Qatar
59144,11/1/2022,QAT,Sarawak,5,3,2,Qatar
59145,11/1/2022,QAT,Selangor,65,34,31,Qatar
59146,11/1/2022,REU,Johor,0,0,0,Reunion
59147,11/1/2022,REU,Sarawak,0,0,0,Reunion
59148,11/1/2022,ROU,Johor,93,53,40,Romania
59149,11/1/2022,ROU,Kedah,13,6,7,Romania
59150,11/1/2022,ROU,Kelantan,0,0,0,Romania
59151,11/1/2022,ROU,Negeri Sembilan,0,0,0,Romania
59152,11/1/2022,ROU,Pahang,0,0,0,Romania
59153,11/1/2022,ROU,Perak,2,0,2,Romania
59154,11/1/2022,ROU,Perlis,3,2,1,Romania
59155,11/1/2022,ROU,Pulau Pinang,24,15,9,Romania
59156,11/1/2022,ROU,Sabah,4,2,2,Romania
59157,11/1/2022,ROU,Sarawak,3,2,1,Romania
59158,11/1/2022,ROU,Selangor,536,284,252,Romania
59159,11/1/2022,ROU,W.P. Labuan,0,0,0,Romania
59160,11/1/2022,RUS,Johor,292,151,141,Russia
59161,11/1/2022,RUS,Kedah,291,169,122,Russia
59162,11/1/2022,RUS,Kelantan,57,34,23,Russia
59163,11/1/2022,RUS,Melaka,0,0,0,Russia
59164,11/1/2022,RUS,Negeri Sembilan,0,0,0,Russia
59165,11/1/2022,RUS,Pahang,0,0,0,Russia
59166,11/1/2022,RUS,Perak,2,0,2,Russia
59167,11/1/2022,RUS,Perlis,517,320,197,Russia
59168,11/1/2022,RUS,Pulau Pinang,321,180,141,Russia
59169,11/1/2022,RUS,Sabah,15,9,6,Russia
59170,11/1/2022,RUS,Sarawak,46,22,24,Russia
59171,11/1/2022,RUS,Selangor,7928,4540,3388,Russia
59172,11/1/2022,RUS,W.P. Labuan,3,1,2,Russia
59173,11/1/2022,RWA,Johor,2,2,0,Rwanda
59174,11/1/2022,RWA,Kedah,0,0,0,Rwanda
59175,11/1/2022,RWA,Pulau Pinang,0,0,0,Rwanda
59176,11/1/2022,RWA,Selangor,9,3,6,Rwanda
59177,11/1/2022,SAU,Johor,101,59,42,Saudi Arabia
59178,11/1/2022,SAU,Kedah,11,6,5,Saudi Arabia
59179,11/1/2022,SAU,Kelantan,0,0,0,Saudi Arabia
59180,11/1/2022,SAU,Melaka,0,0,0,Saudi Arabia
59181,11/1/2022,SAU,Perak,0,0,0,Saudi Arabia
59182,11/1/2022,SAU,Perlis,6,6,0,Saudi Arabia
59183,11/1/2022,SAU,Pulau Pinang,2,2,0,Saudi Arabia
59184,11/1/2022,SAU,Sabah,0,0,0,Saudi Arabia
59185,11/1/2022,SAU,Sarawak,27,19,8,Saudi Arabia
59186,11/1/2022,SAU,Selangor,3877,2132,1745,Saudi Arabia
59187,11/1/2022,SAU,W.P. Labuan,0,0,0,Saudi Arabia
59188,11/1/2022,SDN,Johor,9,5,4,Sudan
59189,11/1/2022,SDN,Kedah,0,0,0,Sudan
59190,11/1/2022,SDN,Kelantan,0,0,0,Sudan
59191,11/1/2022,SDN,Perlis,1,0,1,Sudan
59192,11/1/2022,SDN,Pulau Pinang,2,1,1,Sudan
59193,11/1/2022,SDN,Sabah,0,0,0,Sudan
59194,11/1/2022,SDN,Sarawak,4,4,0,Sudan
59195,11/1/2022,SDN,Selangor,784,470,314,Sudan
59196,11/1/2022,SDN,W.P. Labuan,1,1,0,Sudan
59197,11/1/2022,SEN,Johor,1,1,0,Senegal
59198,11/1/2022,SEN,Kedah,0,0,0,Senegal
59199,11/1/2022,SEN,Kelantan,0,0,0,Senegal
59200,11/1/2022,SEN,Perak,0,0,0,Senegal
59201,11/1/2022,SEN,Perlis,0,0,0,Senegal
59202,11/1/2022,SEN,Pulau Pinang,0,0,0,Senegal
59203,11/1/2022,SEN,Sabah,0,0,0,Senegal
59204,11/1/2022,SEN,Sarawak,0,0,0,Senegal
59205,11/1/2022,SEN,Selangor,19,13,6,Senegal
59206,11/1/2022,SGP,Johor,1005465,577797,427668,Singapore
59207,11/1/2022,SGP,Kedah,4114,2177,1937,Singapore
59208,11/1/2022,SGP,Kelantan,32,18,14,Singapore
59209,11/1/2022,SGP,Melaka,15,14,1,Singapore
59210,11/1/2022,SGP,Negeri Sembilan,4,3,1,Singapore
59211,11/1/2022,SGP,Pahang,35,12,23,Singapore
59212,11/1/2022,SGP,Perak,5710,2658,3052,Singapore
59213,11/1/2022,SGP,Perlis,229,136,93,Singapore
59214,11/1/2022,SGP,Pulau Pinang,15815,7828,7987,Singapore
59215,11/1/2022,SGP,Sabah,3584,1811,1773,Singapore
59216,11/1/2022,SGP,Sarawak,3972,2178,1794,Singapore
59217,11/1/2022,SGP,Selangor,53185,26212,26973,Singapore
59218,11/1/2022,SGP,Terengganu,0,0,0,Singapore
59219,11/1/2022,SGP,W.P. Labuan,23,18,5,Singapore
59220,11/1/2022,SGS,Johor,0,0,0,South Georgia and the South Sandwich Islands
59221,11/1/2022,SGS,Sabah,0,0,0,South Georgia and the South Sandwich Islands
59222,11/1/2022,SGS,Selangor,0,0,0,South Georgia and the South Sandwich Islands
59223,11/1/2022,SHN,Sarawak,0,0,0,"Saint Helena, Ascension and Tristan da Cunha"
59224,11/1/2022,SLB,Johor,1,1,0,Solomon Islands
59225,11/1/2022,SLB,Perlis,0,0,0,Solomon Islands
59226,11/1/2022,SLB,Pulau Pinang,0,0,0,Solomon Islands
59227,11/1/2022,SLB,Sabah,0,0,0,Solomon Islands
59228,11/1/2022,SLB,Sarawak,6,3,3,Solomon Islands
59229,11/1/2022,SLB,Selangor,13,6,7,Solomon Islands
59230,11/1/2022,SLB,W.P. Labuan,0,0,0,Solomon Islands
59231,11/1/2022,SLE,Johor,1,0,1,Sierra Leone
59232,11/1/2022,SLE,Kedah,0,0,0,Sierra Leone
59233,11/1/2022,SLE,Perak,0,0,0,Sierra Leone
59234,11/1/2022,SLE,Pulau Pinang,1,1,0,Sierra Leone
59235,11/1/2022,SLE,Sabah,0,0,0,Sierra Leone
59236,11/1/2022,SLE,Selangor,23,19,4,Sierra Leone
59237,11/1/2022,SLV,Johor,6,4,2,El Salvador
59238,11/1/2022,SLV,Kedah,1,1,0,El Salvador
59239,11/1/2022,SLV,Perak,0,0,0,El Salvador
59240,11/1/2022,SLV,Perlis,0,0,0,El Salvador
59241,11/1/2022,SLV,Pulau Pinang,0,0,0,El Salvador
59242,11/1/2022,SLV,Sabah,0,0,0,El Salvador
59243,11/1/2022,SLV,Selangor,14,7,7,El Salvador
59244,11/1/2022,SLV,W.P. Labuan,0,0,0,El Salvador
59245,11/1/2022,SMR,Johor,0,0,0,San Marino
59246,11/1/2022,SMR,Selangor,0,0,0,San Marino
59247,11/1/2022,SOM,Johor,0,0,0,Somalia
59248,11/1/2022,SOM,Kedah,0,0,0,Somalia
59249,11/1/2022,SOM,Kelantan,0,0,0,Somalia
59250,11/1/2022,SOM,Perlis,0,0,0,Somalia
59251,11/1/2022,SOM,Sabah,0,0,0,Somalia
59252,11/1/2022,SOM,Sarawak,1,1,0,Somalia
59253,11/1/2022,SOM,Selangor,247,156,91,Somalia
59254,11/1/2022,SRB,Johor,9,9,0,Serbia
59255,11/1/2022,SRB,Kedah,0,0,0,Serbia
59256,11/1/2022,SRB,Kelantan,0,0,0,Serbia
59257,11/1/2022,SRB,Pahang,0,0,0,Serbia
59258,11/1/2022,SRB,Perak,0,0,0,Serbia
59259,11/1/2022,SRB,Perlis,0,0,0,Serbia
59260,11/1/2022,SRB,Pulau Pinang,2,1,1,Serbia
59261,11/1/2022,SRB,Sabah,0,0,0,Serbia
59262,11/1/2022,SRB,Sarawak,0,0,0,Serbia
59263,11/1/2022,SRB,Selangor,54,32,22,Serbia
59264,11/1/2022,STP,Selangor,2,0,2,Sao Tome and Principe
59265,11/1/2022,SUR,Johor,3,1,2,Suriname
59266,11/1/2022,SUR,Kedah,1,1,0,Suriname
59267,11/1/2022,SUR,Kelantan,0,0,0,Suriname
59268,11/1/2022,SUR,Perak,0,0,0,Suriname
59269,11/1/2022,SUR,Perlis,0,0,0,Suriname
59270,11/1/2022,SUR,Pulau Pinang,1,1,0,Suriname
59271,11/1/2022,SUR,Sabah,0,0,0,Suriname
59272,11/1/2022,SUR,Sarawak,0,0,0,Suriname
59273,11/1/2022,SUR,Selangor,9,6,3,Suriname
59274,11/1/2022,SVK,Johor,25,16,9,Slovakia
59275,11/1/2022,SVK,Kedah,56,29,27,Slovakia
59276,11/1/2022,SVK,Kelantan,0,0,0,Slovakia
59277,11/1/2022,SVK,Negeri Sembilan,0,0,0,Slovakia
59278,11/1/2022,SVK,Pahang,0,0,0,Slovakia
59279,11/1/2022,SVK,Perak,0,0,0,Slovakia
59280,11/1/2022,SVK,Perlis,3,2,1,Slovakia
59281,11/1/2022,SVK,Pulau Pinang,12,8,4,Slovakia
59282,11/1/2022,SVK,Sabah,4,1,3,Slovakia
59283,11/1/2022,SVK,Sarawak,1,1,0,Slovakia
59284,11/1/2022,SVK,Selangor,254,141,113,Slovakia
59285,11/1/2022,SVK,W.P. Labuan,0,0,0,Slovakia
59286,11/1/2022,SVN,Johor,8,5,3,Slovenia
59287,11/1/2022,SVN,Kedah,11,5,6,Slovenia
59288,11/1/2022,SVN,Kelantan,0,0,0,Slovenia
59289,11/1/2022,SVN,Perak,0,0,0,Slovenia
59290,11/1/2022,SVN,Perlis,1,0,1,Slovenia
59291,11/1/2022,SVN,Pulau Pinang,4,2,2,Slovenia
59292,11/1/2022,SVN,Sabah,0,0,0,Slovenia
59293,11/1/2022,SVN,Sarawak,0,0,0,Slovenia
59294,11/1/2022,SVN,Selangor,70,44,26,Slovenia
59295,11/1/2022,SVN,W.P. Labuan,0,0,0,Slovenia
59296,11/1/2022,SWE,Johor,236,144,92,Sweden
59297,11/1/2022,SWE,Kedah,136,66,70,Sweden
59298,11/1/2022,SWE,Kelantan,5,1,4,Sweden
59299,11/1/2022,SWE,Melaka,0,0,0,Sweden
59300,11/1/2022,SWE,Negeri Sembilan,0,0,0,Sweden
59301,11/1/2022,SWE,Pahang,1,1,0,Sweden
59302,11/1/2022,SWE,Perak,4,2,2,Sweden
59303,11/1/2022,SWE,Perlis,9,7,2,Sweden
59304,11/1/2022,SWE,Pulau Pinang,69,51,18,Sweden
59305,11/1/2022,SWE,Sabah,13,7,6,Sweden
59306,11/1/2022,SWE,Sarawak,20,16,4,Sweden
59307,11/1/2022,SWE,Selangor,967,601,366,Sweden
59308,11/1/2022,SWE,W.P. Labuan,5,5,0,Sweden
59309,11/1/2022,SWZ,Johor,0,0,0,Swaziland
59310,11/1/2022,SWZ,Kedah,0,0,0,Swaziland
59311,11/1/2022,SWZ,Pulau Pinang,0,0,0,Swaziland
59312,11/1/2022,SWZ,Sabah,0,0,0,Swaziland
59313,11/1/2022,SWZ,Selangor,12,5,7,Swaziland
59314,11/1/2022,SYC,Johor,1,0,1,Seychelles
59315,11/1/2022,SYC,Kedah,0,0,0,Seychelles
59316,11/1/2022,SYC,Pulau Pinang,4,2,2,Seychelles
59317,11/1/2022,SYC,Sabah,0,0,0,Seychelles
59318,11/1/2022,SYC,Sarawak,1,1,0,Seychelles
59319,11/1/2022,SYC,Selangor,37,12,25,Seychelles
59320,11/1/2022,SYR,Johor,5,2,3,Syrian Arab Republic
59321,11/1/2022,SYR,Kedah,0,0,0,Syrian Arab Republic
59322,11/1/2022,SYR,Kelantan,0,0,0,Syrian Arab Republic
59323,11/1/2022,SYR,Pahang,4,4,0,Syrian Arab Republic
59324,11/1/2022,SYR,Perlis,0,0,0,Syrian Arab Republic
59325,11/1/2022,SYR,Pulau Pinang,1,1,0,Syrian Arab Republic
59326,11/1/2022,SYR,Sabah,0,0,0,Syrian Arab Republic
59327,11/1/2022,SYR,Sarawak,1,0,1,Syrian Arab Republic
59328,11/1/2022,SYR,Selangor,512,332,180,Syrian Arab Republic
59329,11/1/2022,SYR,W.P. Labuan,0,0,0,Syrian Arab Republic
59330,11/1/2022,TCA,Perlis,0,0,0,Turks and Caicos
59331,11/1/2022,TCD,Johor,5,5,0,Chad
59332,11/1/2022,TCD,Kedah,0,0,0,Chad
59333,11/1/2022,TCD,Perlis,0,0,0,Chad
59334,11/1/2022,TCD,Selangor,17,16,1,Chad
59335,11/1/2022,TGO,Johor,1,0,1,Togo
59336,11/1/2022,TGO,Perak,0,0,0,Togo
59337,11/1/2022,TGO,Pulau Pinang,0,0,0,Togo
59338,11/1/2022,TGO,Selangor,1,1,0,Togo
59339,11/1/2022,THA,Johor,4704,1275,3429,Thailand
59340,11/1/2022,THA,Kedah,58809,35945,22864,Thailand
59341,11/1/2022,THA,Kelantan,32286,17194,15092,Thailand
59342,11/1/2022,THA,Melaka,32,12,20,Thailand
59343,11/1/2022,THA,Negeri Sembilan,5,1,4,Thailand
59344,11/1/2022,THA,Pahang,2,2,0,Thailand
59345,11/1/2022,THA,Perak,8321,3933,4388,Thailand
59346,11/1/2022,THA,Perlis,51813,32080,19733,Thailand
59347,11/1/2022,THA,Pulau Pinang,1764,730,1034,Thailand
59348,11/1/2022,THA,Sabah,157,35,122,Thailand
59349,11/1/2022,THA,Sarawak,221,86,135,Thailand
59350,11/1/2022,THA,Selangor,10163,4287,5876,Thailand
59351,11/1/2022,THA,Terengganu,0,0,0,Thailand
59352,11/1/2022,THA,W.P. Labuan,5,2,3,Thailand
59353,11/1/2022,TJK,Johor,0,0,0,Tajikistan
59354,11/1/2022,TJK,Kedah,0,0,0,Tajikistan
59355,11/1/2022,TJK,Perlis,0,0,0,Tajikistan
59356,11/1/2022,TJK,Pulau Pinang,0,0,0,Tajikistan
59357,11/1/2022,TJK,Sabah,2,1,1,Tajikistan
59358,11/1/2022,TJK,Selangor,103,73,30,Tajikistan
59359,11/1/2022,TKL,Selangor,0,0,0,Tokelau
59360,11/1/2022,TKM,Johor,1,0,1,Turkmenistan
59361,11/1/2022,TKM,Kedah,0,0,0,Turkmenistan
59362,11/1/2022,TKM,Kelantan,0,0,0,Turkmenistan
59363,11/1/2022,TKM,Perlis,0,0,0,Turkmenistan
59364,11/1/2022,TKM,Pulau Pinang,0,0,0,Turkmenistan
59365,11/1/2022,TKM,Sabah,1,1,0,Turkmenistan
59366,11/1/2022,TKM,Sarawak,0,0,0,Turkmenistan
59367,11/1/2022,TKM,Selangor,48,25,23,Turkmenistan
59368,11/1/2022,TLS,Johor,6,6,0,Timor-Leste
59369,11/1/2022,TLS,Kedah,0,0,0,Timor-Leste
59370,11/1/2022,TLS,Perlis,0,0,0,Timor-Leste
59371,11/1/2022,TLS,Pulau Pinang,0,0,0,Timor-Leste
59372,11/1/2022,TLS,Sabah,3,2,1,Timor-Leste
59373,11/1/2022,TLS,Sarawak,2,0,2,Timor-Leste
59374,11/1/2022,TLS,Selangor,143,83,60,Timor-Leste
59375,11/1/2022,TON,Johor,1,1,0,Tonga
59376,11/1/2022,TON,Pulau Pinang,2,0,2,Tonga
59377,11/1/2022,TON,Sarawak,0,0,0,Tonga
59378,11/1/2022,TON,Selangor,8,4,4,Tonga
59379,11/1/2022,TTO,Johor,5,2,3,Trinidad and Tobago
59380,11/1/2022,TTO,Kedah,2,1,1,Trinidad and Tobago
59381,11/1/2022,TTO,Pahang,0,0,0,Trinidad and Tobago
59382,11/1/2022,TTO,Pulau Pinang,0,0,0,Trinidad and Tobago
59383,11/1/2022,TTO,Sabah,0,0,0,Trinidad and Tobago
59384,11/1/2022,TTO,Sarawak,0,0,0,Trinidad and Tobago
59385,11/1/2022,TTO,Selangor,36,20,16,Trinidad and Tobago
59386,11/1/2022,TUN,Johor,14,8,6,Tunisia
59387,11/1/2022,TUN,Kedah,3,1,2,Tunisia
59388,11/1/2022,TUN,Kelantan,0,0,0,Tunisia
59389,11/1/2022,TUN,Melaka,1,1,0,Tunisia
59390,11/1/2022,TUN,Perak,0,0,0,Tunisia
59391,11/1/2022,TUN,Perlis,1,0,1,Tunisia
59392,11/1/2022,TUN,Pulau Pinang,1,1,0,Tunisia
59393,11/1/2022,TUN,Sabah,0,0,0,Tunisia
59394,11/1/2022,TUN,Sarawak,2,0,2,Tunisia
59395,11/1/2022,TUN,Selangor,320,174,146,Tunisia
59396,11/1/2022,TUN,W.P. Labuan,0,0,0,Tunisia
59397,11/1/2022,TUR,Johor,275,186,89,Turkey
59398,11/1/2022,TUR,Kedah,13,10,3,Turkey
59399,11/1/2022,TUR,Kelantan,2,2,0,Turkey
59400,11/1/2022,TUR,Melaka,0,0,0,Turkey
59401,11/1/2022,TUR,Negeri Sembilan,0,0,0,Turkey
59402,11/1/2022,TUR,Pahang,0,0,0,Turkey
59403,11/1/2022,TUR,Perak,1,1,0,Turkey
59404,11/1/2022,TUR,Perlis,12,11,1,Turkey
59405,11/1/2022,TUR,Pulau Pinang,15,12,3,Turkey
59406,11/1/2022,TUR,Sabah,7,5,2,Turkey
59407,11/1/2022,TUR,Sarawak,16,9,7,Turkey
59408,11/1/2022,TUR,Selangor,883,649,234,Turkey
59409,11/1/2022,TUR,W.P. Labuan,0,0,0,Turkey
59410,11/1/2022,TUV,Selangor,0,0,0,Tuvalu
59411,11/1/2022,TWN,Johor,2713,1231,1482,Taiwan
59412,11/1/2022,TWN,Kedah,72,42,30,Taiwan
59413,11/1/2022,TWN,Kelantan,1,1,0,Taiwan
59414,11/1/2022,TWN,Melaka,1,1,0,Taiwan
59415,11/1/2022,TWN,Negeri Sembilan,0,0,0,Taiwan
59416,11/1/2022,TWN,Pahang,0,0,0,Taiwan
59417,11/1/2022,TWN,Perak,28,12,16,Taiwan
59418,11/1/2022,TWN,Perlis,8,3,5,Taiwan
59419,11/1/2022,TWN,Pulau Pinang,769,466,303,Taiwan
59420,11/1/2022,TWN,Sabah,74,28,46,Taiwan
59421,11/1/2022,TWN,Sarawak,191,83,108,Taiwan
59422,11/1/2022,TWN,Selangor,5291,2922,2369,Taiwan
59423,11/1/2022,TWN,W.P. Labuan,3,3,0,Taiwan
59424,11/1/2022,TZA,Johor,6,3,3,"Tanzania, United Republic of"
59425,11/1/2022,TZA,Kedah,0,0,0,"Tanzania, United Republic of"
59426,11/1/2022,TZA,Perak,0,0,0,"Tanzania, United Republic of"
59427,11/1/2022,TZA,Perlis,0,0,0,"Tanzania, United Republic of"
59428,11/1/2022,TZA,Pulau Pinang,0,0,0,"Tanzania, United Republic of"
59429,11/1/2022,TZA,Sabah,0,0,0,"Tanzania, United Republic of"
59430,11/1/2022,TZA,Sarawak,1,1,0,"Tanzania, United Republic of"
59431,11/1/2022,TZA,Selangor,143,64,79,"Tanzania, United Republic of"
59432,11/1/2022,UGA,Johor,25,15,10,Uganda
59433,11/1/2022,UGA,Kedah,0,0,0,Uganda
59434,11/1/2022,UGA,Perak,0,0,0,Uganda
59435,11/1/2022,UGA,Perlis,3,3,0,Uganda
59436,11/1/2022,UGA,Pulau Pinang,0,0,0,Uganda
59437,11/1/2022,UGA,Sabah,0,0,0,Uganda
59438,11/1/2022,UGA,Sarawak,0,0,0,Uganda
59439,11/1/2022,UGA,Selangor,68,40,28,Uganda
59440,11/1/2022,UKR,Johor,80,39,41,Ukraine
59441,11/1/2022,UKR,Kedah,23,9,14,Ukraine
59442,11/1/2022,UKR,Kelantan,3,2,1,Ukraine
59443,11/1/2022,UKR,Melaka,5,5,0,Ukraine
59444,11/1/2022,UKR,Negeri Sembilan,0,0,0,Ukraine
59445,11/1/2022,UKR,Pahang,0,0,0,Ukraine
59446,11/1/2022,UKR,Perak,0,0,0,Ukraine
59447,11/1/2022,UKR,Perlis,22,9,13,Ukraine
59448,11/1/2022,UKR,Pulau Pinang,37,17,20,Ukraine
59449,11/1/2022,UKR,Sabah,7,6,1,Ukraine
59450,11/1/2022,UKR,Sarawak,1,0,1,Ukraine
59451,11/1/2022,UKR,Selangor,736,369,367,Ukraine
59452,11/1/2022,UKR,W.P. Labuan,1,0,1,Ukraine
59453,11/1/2022,URY,Johor,8,2,6,Uruguay
59454,11/1/2022,URY,Kedah,0,0,0,Uruguay
59455,11/1/2022,URY,Kelantan,0,0,0,Uruguay
59456,11/1/2022,URY,Perak,0,0,0,Uruguay
59457,11/1/2022,URY,Perlis,0,0,0,Uruguay
59458,11/1/2022,URY,Pulau Pinang,1,0,1,Uruguay
59459,11/1/2022,URY,Sabah,1,1,0,Uruguay
59460,11/1/2022,URY,Sarawak,0,0,0,Uruguay
59461,11/1/2022,URY,Selangor,40,17,23,Uruguay
59462,11/1/2022,URY,W.P. Labuan,0,0,0,Uruguay
59463,11/1/2022,USA,Johor,3279,1972,1307,United States Of America
59464,11/1/2022,USA,Kedah,358,219,139,United States Of America
59465,11/1/2022,USA,Kelantan,6,5,1,United States Of America
59466,11/1/2022,USA,Melaka,3,2,1,United States Of America
59467,11/1/2022,USA,Negeri Sembilan,0,0,0,United States Of America
59468,11/1/2022,USA,Pahang,3,3,0,United States Of America
59469,11/1/2022,USA,Perak,101,51,50,United States Of America
59470,11/1/2022,USA,Perlis,113,75,38,United States Of America
59471,11/1/2022,USA,Pulau Pinang,1480,906,574,United States Of America
59472,11/1/2022,USA,Sabah,265,153,112,United States Of America
59473,11/1/2022,USA,Sarawak,225,126,99,United States Of America
59474,11/1/2022,USA,Selangor,11399,6830,4569,United States Of America
59475,11/1/2022,USA,Terengganu,0,0,0,United States Of America
59476,11/1/2022,USA,W.P. Labuan,7,7,0,United States Of America
59477,11/1/2022,UZB,Johor,68,50,18,Uzbekistan
59478,11/1/2022,UZB,Kedah,4,2,2,Uzbekistan
59479,11/1/2022,UZB,Kelantan,0,0,0,Uzbekistan
59480,11/1/2022,UZB,Perak,1,1,0,Uzbekistan
59481,11/1/2022,UZB,Perlis,6,3,3,Uzbekistan
59482,11/1/2022,UZB,Pulau Pinang,1,1,0,Uzbekistan
59483,11/1/2022,UZB,Sabah,54,52,2,Uzbekistan
59484,11/1/2022,UZB,Sarawak,0,0,0,Uzbekistan
59485,11/1/2022,UZB,Selangor,968,617,351,Uzbekistan
59486,11/1/2022,VAT,Johor,1,1,0,Holy See (Vatican City State)
59487,11/1/2022,VAT,Sarawak,0,0,0,Holy See (Vatican City State)
59488,11/1/2022,VAT,Selangor,1,1,0,Holy See (Vatican City State)
59489,11/1/2022,VCT,Johor,0,0,0,Saint Vincent and the Grenadines
59490,11/1/2022,VCT,Kedah,0,0,0,Saint Vincent and the Grenadines
59491,11/1/2022,VCT,Pulau Pinang,0,0,0,Saint Vincent and the Grenadines
59492,11/1/2022,VCT,Sarawak,0,0,0,Saint Vincent and the Grenadines
59493,11/1/2022,VCT,Selangor,1,0,1,Saint Vincent and the Grenadines
59494,11/1/2022,VEN,Johor,11,4,7,Venezuela
59495,11/1/2022,VEN,Kedah,0,0,0,Venezuela
59496,11/1/2022,VEN,Kelantan,0,0,0,Venezuela
59497,11/1/2022,VEN,Melaka,0,0,0,Venezuela
59498,11/1/2022,VEN,Perak,0,0,0,Venezuela
59499,11/1/2022,VEN,Perlis,0,0,0,Venezuela
59500,11/1/2022,VEN,Pulau Pinang,0,0,0,Venezuela
59501,11/1/2022,VEN,Sabah,0,0,0,Venezuela
59502,11/1/2022,VEN,Sarawak,0,0,0,Venezuela
59503,11/1/2022,VEN,Selangor,45,27,18,Venezuela
59504,11/1/2022,VEN,W.P. Labuan,0,0,0,Venezuela
59505,11/1/2022,VNM,Johor,10491,3145,7346,Vietnam
59506,11/1/2022,VNM,Kedah,221,40,181,Vietnam
59507,11/1/2022,VNM,Kelantan,9,6,3,Vietnam
59508,11/1/2022,VNM,Melaka,0,0,0,Vietnam
59509,11/1/2022,VNM,Negeri Sembilan,0,0,0,Vietnam
59510,11/1/2022,VNM,Pahang,2,2,0,Vietnam
59511,11/1/2022,VNM,Perak,110,9,101,Vietnam
59512,11/1/2022,VNM,Perlis,206,21,185,Vietnam
59513,11/1/2022,VNM,Pulau Pinang,1158,335,823,Vietnam
59514,11/1/2022,VNM,Sabah,15,6,9,Vietnam
59515,11/1/2022,VNM,Sarawak,135,19,116,Vietnam
59516,11/1/2022,VNM,Selangor,11063,3967,7096,Vietnam
59517,11/1/2022,VNM,Terengganu,0,0,0,Vietnam
59518,11/1/2022,VNM,W.P. Labuan,1,0,1,Vietnam
59519,11/1/2022,VUT,Johor,19,14,5,Vanuatu
59520,11/1/2022,VUT,Kedah,0,0,0,Vanuatu
59521,11/1/2022,VUT,Pulau Pinang,1,1,0,Vanuatu
59522,11/1/2022,VUT,Sabah,1,1,0,Vanuatu
59523,11/1/2022,VUT,Sarawak,0,0,0,Vanuatu
59524,11/1/2022,VUT,Selangor,46,41,5,Vanuatu
59525,11/1/2022,WSM,Johor,0,0,0,Samoa
59526,11/1/2022,WSM,Sarawak,0,0,0,Samoa
59527,11/1/2022,WSM,Selangor,8,6,2,Samoa
59528,11/1/2022,YEM,Johor,34,25,9,Yemen
59529,11/1/2022,YEM,Kedah,0,0,0,Yemen
59530,11/1/2022,YEM,Kelantan,2,2,0,Yemen
59531,11/1/2022,YEM,Melaka,0,0,0,Yemen
59532,11/1/2022,YEM,Pahang,0,0,0,Yemen
59533,11/1/2022,YEM,Perak,0,0,0,Yemen
59534,11/1/2022,YEM,Perlis,0,0,0,Yemen
59535,11/1/2022,YEM,Pulau Pinang,3,3,0,Yemen
59536,11/1/2022,YEM,Sabah,0,0,0,Yemen
59537,11/1/2022,YEM,Sarawak,2,2,0,Yemen
59538,11/1/2022,YEM,Selangor,1254,866,388,Yemen
59539,11/1/2022,YEM,W.P. Labuan,1,1,0,Yemen
59540,11/1/2022,ZAF,Johor,221,133,88,South Africa
59541,11/1/2022,ZAF,Kedah,25,13,12,South Africa
59542,11/1/2022,ZAF,Kelantan,0,0,0,South Africa
59543,11/1/2022,ZAF,Melaka,0,0,0,South Africa
59544,11/1/2022,ZAF,Pahang,0,0,0,South Africa
59545,11/1/2022,ZAF,Perak,2,1,1,South Africa
59546,11/1/2022,ZAF,Perlis,7,5,2,South Africa
59547,11/1/2022,ZAF,Pulau Pinang,47,35,12,South Africa
59548,11/1/2022,ZAF,Sabah,12,8,4,South Africa
59549,11/1/2022,ZAF,Sarawak,85,51,34,South Africa
59550,11/1/2022,ZAF,Selangor,689,420,269,South Africa
59551,11/1/2022,ZAF,Terengganu,0,0,0,South Africa
59552,11/1/2022,ZAF,W.P. Labuan,0,0,0,South Africa
59553,11/1/2022,ZMB,Johor,1,1,0,Zambia
59554,11/1/2022,ZMB,Kedah,0,0,0,Zambia
59555,11/1/2022,ZMB,Perak,0,0,0,Zambia
59556,11/1/2022,ZMB,Perlis,0,0,0,Zambia
59557,11/1/2022,ZMB,Pulau Pinang,1,0,1,Zambia
59558,11/1/2022,ZMB,Sabah,0,0,0,Zambia
59559,11/1/2022,ZMB,Sarawak,0,0,0,Zambia
59560,11/1/2022,ZMB,Selangor,41,21,20,Zambia
59561,11/1/2022,ZWE,Johor,4,1,3,Zimbabwe
59562,11/1/2022,ZWE,Kedah,0,0,0,Zimbabwe
59563,11/1/2022,ZWE,Kelantan,0,0,0,Zimbabwe
59564,11/1/2022,ZWE,Perak,0,0,0,Zimbabwe
59565,11/1/2022,ZWE,Perlis,0,0,0,Zimbabwe
59566,11/1/2022,ZWE,Pulau Pinang,1,0,1,Zimbabwe
59567,11/1/2022,ZWE,Sabah,1,0,1,Zimbabwe
59568,11/1/2022,ZWE,Sarawak,0,0,0,Zimbabwe
59569,11/1/2022,ZWE,Selangor,93,36,57,Zimbabwe
59570,12/1/2022,ABW,Kedah,0,0,0,Aruba
59571,12/1/2022,ABW,Pulau Pinang,0,0,0,Aruba
59572,12/1/2022,AFG,Johor,1,1,0,Afghanistan
59573,12/1/2022,AFG,Kedah,0,0,0,Afghanistan
59574,12/1/2022,AFG,Perlis,0,0,0,Afghanistan
59575,12/1/2022,AFG,Pulau Pinang,0,0,0,Afghanistan
59576,12/1/2022,AFG,Sarawak,1,1,0,Afghanistan
59577,12/1/2022,AFG,Selangor,33,27,6,Afghanistan
59578,12/1/2022,AGO,Johor,1,1,0,Angola
59579,12/1/2022,AGO,Kedah,0,0,0,Angola
59580,12/1/2022,AGO,Sabah,1,1,0,Angola
59581,12/1/2022,AGO,Selangor,1,1,0,Angola
59582,12/1/2022,AIA,Selangor,0,0,0,Anguilla
59583,12/1/2022,ALB,Johor,7,7,0,Albania
59584,12/1/2022,ALB,Kedah,0,0,0,Albania
59585,12/1/2022,ALB,Perak,0,0,0,Albania
59586,12/1/2022,ALB,Perlis,0,0,0,Albania
59587,12/1/2022,ALB,Pulau Pinang,4,3,1,Albania
59588,12/1/2022,ALB,Sabah,0,0,0,Albania
59589,12/1/2022,ALB,Sarawak,0,0,0,Albania
59590,12/1/2022,ALB,Selangor,42,22,20,Albania
59591,12/1/2022,AND,Johor,0,0,0,Andorra
59592,12/1/2022,AND,Kedah,0,0,0,Andorra
59593,12/1/2022,AND,Perlis,0,0,0,Andorra
59594,12/1/2022,AND,Pulau Pinang,0,0,0,Andorra
59595,12/1/2022,AND,Selangor,0,0,0,Andorra
59596,12/1/2022,ANT,Selangor,0,0,0,Netherlands Antilles
59597,12/1/2022,ARE,Johor,55,29,26,United Arab Emirates
59598,12/1/2022,ARE,Kedah,5,2,3,United Arab Emirates
59599,12/1/2022,ARE,Kelantan,0,0,0,United Arab Emirates
59600,12/1/2022,ARE,Perak,0,0,0,United Arab Emirates
59601,12/1/2022,ARE,Perlis,0,0,0,United Arab Emirates
59602,12/1/2022,ARE,Pulau Pinang,1,1,0,United Arab Emirates
59603,12/1/2022,ARE,Sabah,0,0,0,United Arab Emirates
59604,12/1/2022,ARE,Sarawak,0,0,0,United Arab Emirates
59605,12/1/2022,ARE,Selangor,673,345,328,United Arab Emirates
59606,12/1/2022,ARG,Johor,29,17,12,Argentina
59607,12/1/2022,ARG,Kedah,32,16,16,Argentina
59608,12/1/2022,ARG,Kelantan,1,1,0,Argentina
59609,12/1/2022,ARG,Melaka,0,0,0,Argentina
59610,12/1/2022,ARG,Perak,1,1,0,Argentina
59611,12/1/2022,ARG,Perlis,5,2,3,Argentina
59612,12/1/2022,ARG,Pulau Pinang,10,6,4,Argentina
59613,12/1/2022,ARG,Sabah,0,0,0,Argentina
59614,12/1/2022,ARG,Sarawak,4,2,2,Argentina
59615,12/1/2022,ARG,Selangor,229,119,110,Argentina
59616,12/1/2022,ARG,W.P. Labuan,0,0,0,Argentina
59617,12/1/2022,ARM,Johor,11,6,5,Armenia
59618,12/1/2022,ARM,Kedah,1,0,1,Armenia
59619,12/1/2022,ARM,Kelantan,0,0,0,Armenia
59620,12/1/2022,ARM,Perak,0,0,0,Armenia
59621,12/1/2022,ARM,Perlis,0,0,0,Armenia
59622,12/1/2022,ARM,Pulau Pinang,1,1,0,Armenia
59623,12/1/2022,ARM,Sabah,3,1,2,Armenia
59624,12/1/2022,ARM,Sarawak,0,0,0,Armenia
59625,12/1/2022,ARM,Selangor,39,18,21,Armenia
59626,12/1/2022,ATA,Selangor,0,0,0,Antarctica
59627,12/1/2022,ATG,Johor,3,1,2,Antigua and Barbuda
59628,12/1/2022,ATG,Kedah,0,0,0,Antigua and Barbuda
59629,12/1/2022,ATG,Pulau Pinang,1,1,0,Antigua and Barbuda
59630,12/1/2022,ATG,Sarawak,0,0,0,Antigua and Barbuda
59631,12/1/2022,ATG,Selangor,12,5,7,Antigua and Barbuda
59632,12/1/2022,AUS,Johor,5212,2921,2291,Australia
59633,12/1/2022,AUS,Kedah,538,302,236,Australia
59634,12/1/2022,AUS,Kelantan,3,3,0,Australia
59635,12/1/2022,AUS,Melaka,5,3,2,Australia
59636,12/1/2022,AUS,Negeri Sembilan,0,0,0,Australia
59637,12/1/2022,AUS,Pahang,21,9,12,Australia
59638,12/1/2022,AUS,Perak,190,95,95,Australia
59639,12/1/2022,AUS,Perlis,53,36,17,Australia
59640,12/1/2022,AUS,Pulau Pinang,1929,1010,919,Australia
59641,12/1/2022,AUS,Sabah,479,245,234,Australia
59642,12/1/2022,AUS,Sarawak,706,391,315,Australia
59643,12/1/2022,AUS,Selangor,30838,16944,13894,Australia
59644,12/1/2022,AUS,Terengganu,0,0,0,Australia
59645,12/1/2022,AUS,W.P. Labuan,28,14,14,Australia
59646,12/1/2022,AUT,Johor,113,74,39,Austria
59647,12/1/2022,AUT,Kedah,61,34,27,Austria
59648,12/1/2022,AUT,Kelantan,0,0,0,Austria
59649,12/1/2022,AUT,Melaka,0,0,0,Austria
59650,12/1/2022,AUT,Negeri Sembilan,0,0,0,Austria
59651,12/1/2022,AUT,Pahang,0,0,0,Austria
59652,12/1/2022,AUT,Perak,3,2,1,Austria
59653,12/1/2022,AUT,Perlis,12,7,5,Austria
59654,12/1/2022,AUT,Pulau Pinang,67,43,24,Austria
59655,12/1/2022,AUT,Sabah,6,3,3,Austria
59656,12/1/2022,AUT,Sarawak,18,15,3,Austria
59657,12/1/2022,AUT,Selangor,767,457,310,Austria
59658,12/1/2022,AUT,Terengganu,0,0,0,Austria
59659,12/1/2022,AUT,W.P. Labuan,0,0,0,Austria
59660,12/1/2022,AZE,Johor,10,6,4,Azerbaijan
59661,12/1/2022,AZE,Kedah,3,3,0,Azerbaijan
59662,12/1/2022,AZE,Kelantan,0,0,0,Azerbaijan
59663,12/1/2022,AZE,Melaka,0,0,0,Azerbaijan
59664,12/1/2022,AZE,Perlis,0,0,0,Azerbaijan
59665,12/1/2022,AZE,Pulau Pinang,1,0,1,Azerbaijan
59666,12/1/2022,AZE,Sabah,1,0,1,Azerbaijan
59667,12/1/2022,AZE,Sarawak,0,0,0,Azerbaijan
59668,12/1/2022,AZE,Selangor,103,57,46,Azerbaijan
59669,12/1/2022,AZE,W.P. Labuan,0,0,0,Azerbaijan
59670,12/1/2022,BDI,Pulau Pinang,0,0,0,Burundi
59671,12/1/2022,BDI,Sarawak,0,0,0,Burundi
59672,12/1/2022,BDI,Selangor,1,0,1,Burundi
59673,12/1/2022,BEL,Johor,166,111,55,Belgium
59674,12/1/2022,BEL,Kedah,60,35,25,Belgium
59675,12/1/2022,BEL,Kelantan,1,1,0,Belgium
59676,12/1/2022,BEL,Melaka,0,0,0,Belgium
59677,12/1/2022,BEL,Negeri Sembilan,0,0,0,Belgium
59678,12/1/2022,BEL,Pahang,0,0,0,Belgium
59679,12/1/2022,BEL,Perak,0,0,0,Belgium
59680,12/1/2022,BEL,Perlis,5,4,1,Belgium
59681,12/1/2022,BEL,Pulau Pinang,50,30,20,Belgium
59682,12/1/2022,BEL,Sabah,10,7,3,Belgium
59683,12/1/2022,BEL,Sarawak,18,8,10,Belgium
59684,12/1/2022,BEL,Selangor,612,408,204,Belgium
59685,12/1/2022,BEL,W.P. Labuan,3,2,1,Belgium
59686,12/1/2022,BEN,Johor,0,0,0,Benin
59687,12/1/2022,BEN,Kedah,0,0,0,Benin
59688,12/1/2022,BEN,Perak,0,0,0,Benin
59689,12/1/2022,BEN,Pulau Pinang,0,0,0,Benin
59690,12/1/2022,BEN,Sabah,1,1,0,Benin
59691,12/1/2022,BEN,Sarawak,0,0,0,Benin
59692,12/1/2022,BEN,Selangor,10,6,4,Benin
59693,12/1/2022,BFA,Perak,0,0,0,Burkina Faso
59694,12/1/2022,BFA,Pulau Pinang,1,1,0,Burkina Faso
59695,12/1/2022,BFA,Selangor,2,2,0,Burkina Faso
59696,12/1/2022,BGD,Johor,2184,1774,410,Bangladesh
59697,12/1/2022,BGD,Kedah,45,29,16,Bangladesh
59698,12/1/2022,BGD,Kelantan,2,2,0,Bangladesh
59699,12/1/2022,BGD,Melaka,0,0,0,Bangladesh
59700,12/1/2022,BGD,Negeri Sembilan,0,0,0,Bangladesh
59701,12/1/2022,BGD,Pahang,0,0,0,Bangladesh
59702,12/1/2022,BGD,Perak,0,0,0,Bangladesh
59703,12/1/2022,BGD,Perlis,2,2,0,Bangladesh
59704,12/1/2022,BGD,Pulau Pinang,317,306,11,Bangladesh
59705,12/1/2022,BGD,Sabah,6,4,2,Bangladesh
59706,12/1/2022,BGD,Sarawak,64,53,11,Bangladesh
59707,12/1/2022,BGD,Selangor,37198,35338,1860,Bangladesh
59708,12/1/2022,BGD,W.P. Labuan,2,2,0,Bangladesh
59709,12/1/2022,BGR,Johor,46,31,15,Bulgaria
59710,12/1/2022,BGR,Kedah,12,5,7,Bulgaria
59711,12/1/2022,BGR,Kelantan,0,0,0,Bulgaria
59712,12/1/2022,BGR,Pahang,2,2,0,Bulgaria
59713,12/1/2022,BGR,Perak,0,0,0,Bulgaria
59714,12/1/2022,BGR,Perlis,3,1,2,Bulgaria
59715,12/1/2022,BGR,Pulau Pinang,4,3,1,Bulgaria
59716,12/1/2022,BGR,Sabah,4,3,1,Bulgaria
59717,12/1/2022,BGR,Sarawak,0,0,0,Bulgaria
59718,12/1/2022,BGR,Selangor,201,105,96,Bulgaria
59719,12/1/2022,BGR,W.P. Labuan,0,0,0,Bulgaria
59720,12/1/2022,BHR,Johor,14,7,7,Bahrain
59721,12/1/2022,BHR,Kedah,0,0,0,Bahrain
59722,12/1/2022,BHR,Kelantan,0,0,0,Bahrain
59723,12/1/2022,BHR,Perlis,2,2,0,Bahrain
59724,12/1/2022,BHR,Pulau Pinang,0,0,0,Bahrain
59725,12/1/2022,BHR,Sabah,0,0,0,Bahrain
59726,12/1/2022,BHR,Sarawak,1,1,0,Bahrain
59727,12/1/2022,BHR,Selangor,102,57,45,Bahrain
59728,12/1/2022,BHS,Johor,2,2,0,Bahamas
59729,12/1/2022,BHS,Kedah,0,0,0,Bahamas
59730,12/1/2022,BHS,Perak,0,0,0,Bahamas
59731,12/1/2022,BHS,Sabah,0,0,0,Bahamas
59732,12/1/2022,BHS,Sarawak,0,0,0,Bahamas
59733,12/1/2022,BHS,Selangor,2,0,2,Bahamas
59734,12/1/2022,BIH,Johor,3,2,1,Bosnia and Herzegovina
59735,12/1/2022,BIH,Kedah,0,0,0,Bosnia and Herzegovina
59736,12/1/2022,BIH,Perlis,0,0,0,Bosnia and Herzegovina
59737,12/1/2022,BIH,Pulau Pinang,2,1,1,Bosnia and Herzegovina
59738,12/1/2022,BIH,Sabah,0,0,0,Bosnia and Herzegovina
59739,12/1/2022,BIH,Sarawak,1,1,0,Bosnia and Herzegovina
59740,12/1/2022,BIH,Selangor,35,24,11,Bosnia and Herzegovina
59741,12/1/2022,BLR,Johor,17,8,9,Belarus
59742,12/1/2022,BLR,Kedah,5,1,4,Belarus
59743,12/1/2022,BLR,Kelantan,0,0,0,Belarus
59744,12/1/2022,BLR,Pahang,0,0,0,Belarus
59745,12/1/2022,BLR,Perak,0,0,0,Belarus
59746,12/1/2022,BLR,Perlis,0,0,0,Belarus
59747,12/1/2022,BLR,Pulau Pinang,10,5,5,Belarus
59748,12/1/2022,BLR,Sabah,0,0,0,Belarus
59749,12/1/2022,BLR,Sarawak,8,3,5,Belarus
59750,12/1/2022,BLR,Selangor,245,121,124,Belarus
59751,12/1/2022,BLR,W.P. Labuan,0,0,0,Belarus
59752,12/1/2022,BLZ,Johor,5,1,4,Belize
59753,12/1/2022,BLZ,Pulau Pinang,0,0,0,Belize
59754,12/1/2022,BLZ,Sarawak,0,0,0,Belize
59755,12/1/2022,BLZ,Selangor,7,4,3,Belize
59756,12/1/2022,BMU,Selangor,0,0,0,Bermuda
59757,12/1/2022,BOL,Johor,1,1,0,Bolivia
59758,12/1/2022,BOL,Kedah,0,0,0,Bolivia
59759,12/1/2022,BOL,Melaka,0,0,0,Bolivia
59760,12/1/2022,BOL,Perak,0,0,0,Bolivia
59761,12/1/2022,BOL,Perlis,0,0,0,Bolivia
59762,12/1/2022,BOL,Pulau Pinang,0,0,0,Bolivia
59763,12/1/2022,BOL,Sabah,0,0,0,Bolivia
59764,12/1/2022,BOL,Sarawak,0,0,0,Bolivia
59765,12/1/2022,BOL,Selangor,20,15,5,Bolivia
59766,12/1/2022,BRA,Johor,147,85,62,Brazil
59767,12/1/2022,BRA,Kedah,56,31,25,Brazil
59768,12/1/2022,BRA,Kelantan,0,0,0,Brazil
59769,12/1/2022,BRA,Melaka,0,0,0,Brazil
59770,12/1/2022,BRA,Pahang,0,0,0,Brazil
59771,12/1/2022,BRA,Perak,1,1,0,Brazil
59772,12/1/2022,BRA,Perlis,13,8,5,Brazil
59773,12/1/2022,BRA,Pulau Pinang,16,10,6,Brazil
59774,12/1/2022,BRA,Sabah,9,5,4,Brazil
59775,12/1/2022,BRA,Sarawak,6,4,2,Brazil
59776,12/1/2022,BRA,Selangor,669,377,292,Brazil
59777,12/1/2022,BRA,W.P. Labuan,0,0,0,Brazil
59778,12/1/2022,BRB,Johor,0,0,0,Barbados
59779,12/1/2022,BRB,Kedah,0,0,0,Barbados
59780,12/1/2022,BRB,Perlis,0,0,0,Barbados
59781,12/1/2022,BRB,Pulau Pinang,0,0,0,Barbados
59782,12/1/2022,BRB,Selangor,7,4,3,Barbados
59783,12/1/2022,BRN,Johor,1033,497,536,Brunei Darussalam
59784,12/1/2022,BRN,Kedah,45,21,24,Brunei Darussalam
59785,12/1/2022,BRN,Kelantan,13,13,0,Brunei Darussalam
59786,12/1/2022,BRN,Melaka,0,0,0,Brunei Darussalam
59787,12/1/2022,BRN,Pahang,0,0,0,Brunei Darussalam
59788,12/1/2022,BRN,Perak,9,2,7,Brunei Darussalam
59789,12/1/2022,BRN,Perlis,57,30,27,Brunei Darussalam
59790,12/1/2022,BRN,Pulau Pinang,11,7,4,Brunei Darussalam
59791,12/1/2022,BRN,Sabah,1587,706,881,Brunei Darussalam
59792,12/1/2022,BRN,Sarawak,137530,71458,66072,Brunei Darussalam
59793,12/1/2022,BRN,Selangor,7873,3867,4006,Brunei Darussalam
59794,12/1/2022,BRN,W.P. Labuan,1769,1033,736,Brunei Darussalam
59795,12/1/2022,BTN,Johor,4,3,1,Bhutan
59796,12/1/2022,BTN,Kedah,1,0,1,Bhutan
59797,12/1/2022,BTN,Perak,0,0,0,Bhutan
59798,12/1/2022,BTN,Perlis,0,0,0,Bhutan
59799,12/1/2022,BTN,Pulau Pinang,17,8,9,Bhutan
59800,12/1/2022,BTN,Sabah,0,0,0,Bhutan
59801,12/1/2022,BTN,Sarawak,0,0,0,Bhutan
59802,12/1/2022,BTN,Selangor,36,17,19,Bhutan
59803,12/1/2022,BWA,Johor,1,1,0,Botswana
59804,12/1/2022,BWA,Kedah,1,1,0,Botswana
59805,12/1/2022,BWA,Perlis,0,0,0,Botswana
59806,12/1/2022,BWA,Pulau Pinang,2,2,0,Botswana
59807,12/1/2022,BWA,Sabah,1,1,0,Botswana
59808,12/1/2022,BWA,Sarawak,0,0,0,Botswana
59809,12/1/2022,BWA,Selangor,15,5,10,Botswana
59810,12/1/2022,CAF,Kedah,0,0,0,Central African Republic
59811,12/1/2022,CAF,Selangor,0,0,0,Central African Republic
59812,12/1/2022,CAN,Johor,1219,728,491,Canada
59813,12/1/2022,CAN,Kedah,142,84,58,Canada
59814,12/1/2022,CAN,Kelantan,4,2,2,Canada
59815,12/1/2022,CAN,Melaka,2,2,0,Canada
59816,12/1/2022,CAN,Negeri Sembilan,0,0,0,Canada
59817,12/1/2022,CAN,Pahang,3,2,1,Canada
59818,12/1/2022,CAN,Perak,25,18,7,Canada
59819,12/1/2022,CAN,Perlis,31,22,9,Canada
59820,12/1/2022,CAN,Pulau Pinang,407,217,190,Canada
59821,12/1/2022,CAN,Sabah,111,66,45,Canada
59822,12/1/2022,CAN,Sarawak,303,148,155,Canada
59823,12/1/2022,CAN,Selangor,3657,2089,1568,Canada
59824,12/1/2022,CAN,Terengganu,0,0,0,Canada
59825,12/1/2022,CAN,W.P. Labuan,4,3,1,Canada
59826,12/1/2022,CCK,Selangor,1,1,0,Cocos (Keeling) Islands
59827,12/1/2022,CHE,Johor,256,152,104,Switzerland
59828,12/1/2022,CHE,Kedah,112,67,45,Switzerland
59829,12/1/2022,CHE,Kelantan,2,1,1,Switzerland
59830,12/1/2022,CHE,Melaka,2,1,1,Switzerland
59831,12/1/2022,CHE,Negeri Sembilan,0,0,0,Switzerland
59832,12/1/2022,CHE,Pahang,0,0,0,Switzerland
59833,12/1/2022,CHE,Perak,1,1,0,Switzerland
59834,12/1/2022,CHE,Perlis,22,15,7,Switzerland
59835,12/1/2022,CHE,Pulau Pinang,55,35,20,Switzerland
59836,12/1/2022,CHE,Sabah,29,16,13,Switzerland
59837,12/1/2022,CHE,Sarawak,27,12,15,Switzerland
59838,12/1/2022,CHE,Selangor,1086,673,413,Switzerland
59839,12/1/2022,CHE,W.P. Labuan,1,1,0,Switzerland
59840,12/1/2022,CHL,Johor,20,9,11,Chile
59841,12/1/2022,CHL,Kedah,11,4,7,Chile
59842,12/1/2022,CHL,Kelantan,0,0,0,Chile
59843,12/1/2022,CHL,Melaka,0,0,0,Chile
59844,12/1/2022,CHL,Pahang,0,0,0,Chile
59845,12/1/2022,CHL,Perak,0,0,0,Chile
59846,12/1/2022,CHL,Perlis,3,2,1,Chile
59847,12/1/2022,CHL,Pulau Pinang,5,0,5,Chile
59848,12/1/2022,CHL,Sabah,0,0,0,Chile
59849,12/1/2022,CHL,Sarawak,0,0,0,Chile
59850,12/1/2022,CHL,Selangor,113,67,46,Chile
59851,12/1/2022,CHN,Johor,26433,10442,15991,China
59852,12/1/2022,CHN,Kedah,607,236,371,China
59853,12/1/2022,CHN,Kelantan,5,4,1,China
59854,12/1/2022,CHN,Melaka,2,0,2,China
59855,12/1/2022,CHN,Pahang,20,10,10,China
59856,12/1/2022,CHN,Perak,206,86,120,China
59857,12/1/2022,CHN,Perlis,59,19,40,China
59858,12/1/2022,CHN,Pulau Pinang,2723,1364,1359,China
59859,12/1/2022,CHN,Sabah,590,264,326,China
59860,12/1/2022,CHN,Sarawak,653,272,381,China
59861,12/1/2022,CHN,Selangor,22674,12268,10406,China
59862,12/1/2022,CHN,Terengganu,0,0,0,China
59863,12/1/2022,CHN,W.P. Labuan,26,22,4,China
59864,12/1/2022,CIV,Johor,0,0,0,C��te d'Iv
59865,12/1/2022,CIV,Kedah,0,0,0,C��te d'Iv
59866,12/1/2022,CIV,Pulau Pinang,0,0,0,C��te d'Iv
59867,12/1/2022,CIV,Sabah,0,0,0,C��te d'Iv
59868,12/1/2022,CIV,Sarawak,0,0,0,C��te d'Iv
59869,12/1/2022,CIV,Selangor,11,9,2,C��te d'Iv
59870,12/1/2022,CMR,Johor,6,6,0,Cameroon
59871,12/1/2022,CMR,Kedah,0,0,0,Cameroon
59872,12/1/2022,CMR,Pulau Pinang,0,0,0,Cameroon
59873,12/1/2022,CMR,Sabah,0,0,0,Cameroon
59874,12/1/2022,CMR,Sarawak,0,0,0,Cameroon
59875,12/1/2022,CMR,Selangor,10,8,2,Cameroon
59876,12/1/2022,COD,Johor,0,0,0,"Congo, the Democratic Republic of the"
59877,12/1/2022,COD,Pulau Pinang,0,0,0,"Congo, the Democratic Republic of the"
59878,12/1/2022,COD,Sarawak,0,0,0,"Congo, the Democratic Republic of the"
59879,12/1/2022,COD,Selangor,4,3,1,"Congo, the Democratic Republic of the"
59880,12/1/2022,COG,Johor,0,0,0,Congo
59881,12/1/2022,COG,Kedah,0,0,0,Congo
59882,12/1/2022,COG,Selangor,5,5,0,Congo
59883,12/1/2022,COK,Selangor,0,0,0,Cook Islands
59884,12/1/2022,COL,Johor,26,12,14,Colombia
59885,12/1/2022,COL,Kedah,4,1,3,Colombia
59886,12/1/2022,COL,Perak,0,0,0,Colombia
59887,12/1/2022,COL,Pulau Pinang,1,0,1,Colombia
59888,12/1/2022,COL,Sabah,1,0,1,Colombia
59889,12/1/2022,COL,Sarawak,0,0,0,Colombia
59890,12/1/2022,COL,Selangor,120,65,55,Colombia
59891,12/1/2022,COL,W.P. Labuan,0,0,0,Colombia
59892,12/1/2022,COM,Johor,1,0,1,Comoros
59893,12/1/2022,COM,Kedah,0,0,0,Comoros
59894,12/1/2022,COM,Selangor,17,11,6,Comoros
59895,12/1/2022,CPV,Johor,0,0,0,Cape Verde
59896,12/1/2022,CPV,Kedah,0,0,0,Cape Verde
59897,12/1/2022,CPV,Pulau Pinang,0,0,0,Cape Verde
59898,12/1/2022,CPV,Sabah,0,0,0,Cape Verde
59899,12/1/2022,CPV,Selangor,1,0,1,Cape Verde
59900,12/1/2022,CRI,Johor,6,3,3,Costa Rica
59901,12/1/2022,CRI,Kedah,1,0,1,Costa Rica
59902,12/1/2022,CRI,Perak,0,0,0,Costa Rica
59903,12/1/2022,CRI,Perlis,0,0,0,Costa Rica
59904,12/1/2022,CRI,Pulau Pinang,3,0,3,Costa Rica
59905,12/1/2022,CRI,Sabah,0,0,0,Costa Rica
59906,12/1/2022,CRI,Sarawak,0,0,0,Costa Rica
59907,12/1/2022,CRI,Selangor,33,19,14,Costa Rica
59908,12/1/2022,CUB,Johor,14,12,2,Cuba
59909,12/1/2022,CUB,Kedah,2,1,1,Cuba
59910,12/1/2022,CUB,Perlis,0,0,0,Cuba
59911,12/1/2022,CUB,Pulau Pinang,1,0,1,Cuba
59912,12/1/2022,CUB,Sabah,0,0,0,Cuba
59913,12/1/2022,CUB,Sarawak,0,0,0,Cuba
59914,12/1/2022,CUB,Selangor,38,23,15,Cuba
59915,12/1/2022,CYP,Johor,9,5,4,Cyprus
59916,12/1/2022,CYP,Kedah,0,0,0,Cyprus
59917,12/1/2022,CYP,Perak,0,0,0,Cyprus
59918,12/1/2022,CYP,Perlis,0,0,0,Cyprus
59919,12/1/2022,CYP,Pulau Pinang,1,1,0,Cyprus
59920,12/1/2022,CYP,Sabah,0,0,0,Cyprus
59921,12/1/2022,CYP,Sarawak,0,0,0,Cyprus
59922,12/1/2022,CYP,Selangor,70,40,30,Cyprus
59923,12/1/2022,CZE,Johor,60,36,24,Czech Republic
59924,12/1/2022,CZE,Kedah,62,33,29,Czech Republic
59925,12/1/2022,CZE,Kelantan,1,1,0,Czech Republic
59926,12/1/2022,CZE,Melaka,0,0,0,Czech Republic
59927,12/1/2022,CZE,Negeri Sembilan,0,0,0,Czech Republic
59928,12/1/2022,CZE,Perak,1,0,1,Czech Republic
59929,12/1/2022,CZE,Perlis,15,9,6,Czech Republic
59930,12/1/2022,CZE,Pulau Pinang,17,7,10,Czech Republic
59931,12/1/2022,CZE,Sabah,5,3,2,Czech Republic
59932,12/1/2022,CZE,Sarawak,7,3,4,Czech Republic
59933,12/1/2022,CZE,Selangor,401,238,163,Czech Republic
59934,12/1/2022,CZE,W.P. Labuan,1,0,1,Czech Republic
59935,12/1/2022,DEU,Johor,1413,930,483,Germany
59936,12/1/2022,DEU,Kedah,540,302,238,Germany
59937,12/1/2022,DEU,Kelantan,6,4,2,Germany
59938,12/1/2022,DEU,Melaka,2,1,1,Germany
59939,12/1/2022,DEU,Negeri Sembilan,0,0,0,Germany
59940,12/1/2022,DEU,Pahang,0,0,0,Germany
59941,12/1/2022,DEU,Perak,23,17,6,Germany
59942,12/1/2022,DEU,Perlis,102,68,34,Germany
59943,12/1/2022,DEU,Pulau Pinang,424,301,123,Germany
59944,12/1/2022,DEU,Sabah,96,61,35,Germany
59945,12/1/2022,DEU,Sarawak,180,119,61,Germany
59946,12/1/2022,DEU,Selangor,8908,5055,3853,Germany
59947,12/1/2022,DEU,Terengganu,0,0,0,Germany
59948,12/1/2022,DEU,W.P. Labuan,5,4,1,Germany
59949,12/1/2022,DJI,Johor,0,0,0,Djibouti
59950,12/1/2022,DJI,Selangor,25,12,13,Djibouti
59951,12/1/2022,DMA,Johor,9,8,1,Dominica
59952,12/1/2022,DMA,Kedah,0,0,0,Dominica
59953,12/1/2022,DMA,Pulau Pinang,1,0,1,Dominica
59954,12/1/2022,DMA,Sabah,0,0,0,Dominica
59955,12/1/2022,DMA,Sarawak,2,1,1,Dominica
59956,12/1/2022,DMA,Selangor,12,11,1,Dominica
59957,12/1/2022,DMA,W.P. Labuan,0,0,0,Dominica
59958,12/1/2022,DNK,Johor,225,156,69,Denmark
59959,12/1/2022,DNK,Kedah,96,52,44,Denmark
59960,12/1/2022,DNK,Kelantan,0,0,0,Denmark
59961,12/1/2022,DNK,Melaka,0,0,0,Denmark
59962,12/1/2022,DNK,Negeri Sembilan,0,0,0,Denmark
59963,12/1/2022,DNK,Pahang,0,0,0,Denmark
59964,12/1/2022,DNK,Perak,3,2,1,Denmark
59965,12/1/2022,DNK,Perlis,8,7,1,Denmark
59966,12/1/2022,DNK,Pulau Pinang,49,30,19,Denmark
59967,12/1/2022,DNK,Sabah,29,18,11,Denmark
59968,12/1/2022,DNK,Sarawak,10,7,3,Denmark
59969,12/1/2022,DNK,Selangor,666,385,281,Denmark
59970,12/1/2022,DNK,W.P. Labuan,0,0,0,Denmark
59971,12/1/2022,DOM,Johor,2,1,1,Dominican Republic
59972,12/1/2022,DOM,Kedah,0,0,0,Dominican Republic
59973,12/1/2022,DOM,Perak,0,0,0,Dominican Republic
59974,12/1/2022,DOM,Perlis,0,0,0,Dominican Republic
59975,12/1/2022,DOM,Pulau Pinang,0,0,0,Dominican Republic
59976,12/1/2022,DOM,Sabah,0,0,0,Dominican Republic
59977,12/1/2022,DOM,Sarawak,0,0,0,Dominican Republic
59978,12/1/2022,DOM,Selangor,12,5,7,Dominican Republic
59979,12/1/2022,DZA,Johor,45,36,9,Algeria
59980,12/1/2022,DZA,Kedah,3,3,0,Algeria
59981,12/1/2022,DZA,Kelantan,2,2,0,Algeria
59982,12/1/2022,DZA,Melaka,0,0,0,Algeria
59983,12/1/2022,DZA,Perak,0,0,0,Algeria
59984,12/1/2022,DZA,Perlis,3,2,1,Algeria
59985,12/1/2022,DZA,Pulau Pinang,0,0,0,Algeria
59986,12/1/2022,DZA,Sabah,6,4,2,Algeria
59987,12/1/2022,DZA,Sarawak,1,1,0,Algeria
59988,12/1/2022,DZA,Selangor,262,171,91,Algeria
59989,12/1/2022,DZA,W.P. Labuan,0,0,0,Algeria
59990,12/1/2022,ECU,Johor,6,3,3,Ecuador
59991,12/1/2022,ECU,Kedah,1,0,1,Ecuador
59992,12/1/2022,ECU,Perak,0,0,0,Ecuador
59993,12/1/2022,ECU,Perlis,0,0,0,Ecuador
59994,12/1/2022,ECU,Pulau Pinang,1,1,0,Ecuador
59995,12/1/2022,ECU,Sabah,0,0,0,Ecuador
59996,12/1/2022,ECU,Sarawak,0,0,0,Ecuador
59997,12/1/2022,ECU,Selangor,43,18,25,Ecuador
59998,12/1/2022,EGY,Johor,223,164,59,Egypt
59999,12/1/2022,EGY,Kedah,1,0,1,Egypt
60000,12/1/2022,EGY,Kelantan,0,0,0,Egypt
60001,12/1/2022,EGY,Melaka,0,0,0,Egypt
60002,12/1/2022,EGY,Pahang,0,0,0,Egypt
60003,12/1/2022,EGY,Perak,0,0,0,Egypt
60004,12/1/2022,EGY,Perlis,2,2,0,Egypt
60005,12/1/2022,EGY,Pulau Pinang,7,6,1,Egypt
60006,12/1/2022,EGY,Sabah,5,2,3,Egypt
60007,12/1/2022,EGY,Sarawak,189,126,63,Egypt
60008,12/1/2022,EGY,Selangor,1207,730,477,Egypt
60009,12/1/2022,EGY,Terengganu,0,0,0,Egypt
60010,12/1/2022,EGY,W.P. Labuan,0,0,0,Egypt
60011,12/1/2022,ERI,Johor,1,0,1,Eritrea
60012,12/1/2022,ERI,Pulau Pinang,0,0,0,Eritrea
60013,12/1/2022,ERI,Sabah,0,0,0,Eritrea
60014,12/1/2022,ERI,Selangor,12,6,6,Eritrea
60015,12/1/2022,ESP,Johor,254,150,104,Spain
60016,12/1/2022,ESP,Kedah,156,86,70,Spain
60017,12/1/2022,ESP,Kelantan,2,1,1,Spain
60018,12/1/2022,ESP,Melaka,0,0,0,Spain
60019,12/1/2022,ESP,Negeri Sembilan,0,0,0,Spain
60020,12/1/2022,ESP,Pahang,0,0,0,Spain
60021,12/1/2022,ESP,Perak,1,1,0,Spain
60022,12/1/2022,ESP,Perlis,16,8,8,Spain
60023,12/1/2022,ESP,Pulau Pinang,60,35,25,Spain
60024,12/1/2022,ESP,Sabah,19,16,3,Spain
60025,12/1/2022,ESP,Sarawak,27,19,8,Spain
60026,12/1/2022,ESP,Selangor,1458,830,628,Spain
60027,12/1/2022,ESP,W.P. Labuan,0,0,0,Spain
60028,12/1/2022,EST,Johor,22,12,10,Estonia
60029,12/1/2022,EST,Kedah,43,16,27,Estonia
60030,12/1/2022,EST,Kelantan,0,0,0,Estonia
60031,12/1/2022,EST,Pahang,0,0,0,Estonia
60032,12/1/2022,EST,Perak,1,0,1,Estonia
60033,12/1/2022,EST,Perlis,4,4,0,Estonia
60034,12/1/2022,EST,Pulau Pinang,4,0,4,Estonia
60035,12/1/2022,EST,Sabah,3,1,2,Estonia
60036,12/1/2022,EST,Sarawak,0,0,0,Estonia
60037,12/1/2022,EST,Selangor,228,100,128,Estonia
60038,12/1/2022,EST,W.P. Labuan,0,0,0,Estonia
60039,12/1/2022,ETH,Johor,1,0,1,Ethiopia
60040,12/1/2022,ETH,Kedah,0,0,0,Ethiopia
60041,12/1/2022,ETH,Pulau Pinang,1,1,0,Ethiopia
60042,12/1/2022,ETH,Sarawak,0,0,0,Ethiopia
60043,12/1/2022,ETH,Selangor,18,12,6,Ethiopia
60044,12/1/2022,FIN,Johor,167,108,59,Finland
60045,12/1/2022,FIN,Kedah,73,38,35,Finland
60046,12/1/2022,FIN,Kelantan,0,0,0,Finland
60047,12/1/2022,FIN,Melaka,0,0,0,Finland
60048,12/1/2022,FIN,Negeri Sembilan,0,0,0,Finland
60049,12/1/2022,FIN,Pahang,0,0,0,Finland
60050,12/1/2022,FIN,Perak,2,1,1,Finland
60051,12/1/2022,FIN,Perlis,3,2,1,Finland
60052,12/1/2022,FIN,Pulau Pinang,32,19,13,Finland
60053,12/1/2022,FIN,Sabah,13,10,3,Finland
60054,12/1/2022,FIN,Sarawak,15,5,10,Finland
60055,12/1/2022,FIN,Selangor,576,311,265,Finland
60056,12/1/2022,FIN,W.P. Labuan,0,0,0,Finland
60057,12/1/2022,FJI,Johor,41,21,20,Fiji
60058,12/1/2022,FJI,Kedah,2,2,0,Fiji
60059,12/1/2022,FJI,Kelantan,0,0,0,Fiji
60060,12/1/2022,FJI,Perak,0,0,0,Fiji
60061,12/1/2022,FJI,Perlis,0,0,0,Fiji
60062,12/1/2022,FJI,Pulau Pinang,1,0,1,Fiji
60063,12/1/2022,FJI,Sabah,2,2,0,Fiji
60064,12/1/2022,FJI,Sarawak,6,5,1,Fiji
60065,12/1/2022,FJI,Selangor,115,63,52,Fiji
60066,12/1/2022,FRA,Johor,1417,914,503,France
60067,12/1/2022,FRA,Kedah,492,270,222,France
60068,12/1/2022,FRA,Kelantan,9,6,3,France
60069,12/1/2022,FRA,Melaka,2,1,1,France
60070,12/1/2022,FRA,Negeri Sembilan,1,0,1,France
60071,12/1/2022,FRA,Pahang,11,3,8,France
60072,12/1/2022,FRA,Perak,24,17,7,France
60073,12/1/2022,FRA,Perlis,58,38,20,France
60074,12/1/2022,FRA,Pulau Pinang,297,193,104,France
60075,12/1/2022,FRA,Sabah,94,54,40,France
60076,12/1/2022,FRA,Sarawak,66,55,11,France
60077,12/1/2022,FRA,Selangor,4793,2871,1922,France
60078,12/1/2022,FRA,Terengganu,0,0,0,France
60079,12/1/2022,FRA,W.P. Labuan,3,1,2,France
60080,12/1/2022,FSM,Johor,0,0,0,"Micronesia, Federated States of"
60081,12/1/2022,FSM,Pulau Pinang,0,0,0,"Micronesia, Federated States of"
60082,12/1/2022,FSM,Selangor,0,0,0,"Micronesia, Federated States of"
60083,12/1/2022,GAB,Johor,0,0,0,Gabon
60084,12/1/2022,GAB,Pulau Pinang,0,0,0,Gabon
60085,12/1/2022,GAB,Sarawak,0,0,0,Gabon
60086,12/1/2022,GAB,Selangor,6,0,6,Gabon
60087,12/1/2022,GBR,Johor,3852,2420,1432,United Kingdom
60088,12/1/2022,GBR,Kedah,1113,628,485,United Kingdom
60089,12/1/2022,GBR,Kelantan,8,6,2,United Kingdom
60090,12/1/2022,GBR,Melaka,2,1,1,United Kingdom
60091,12/1/2022,GBR,Negeri Sembilan,0,0,0,United Kingdom
60092,12/1/2022,GBR,Pahang,11,6,5,United Kingdom
60093,12/1/2022,GBR,Perak,99,62,37,United Kingdom
60094,12/1/2022,GBR,Perlis,108,67,41,United Kingdom
60095,12/1/2022,GBR,Pulau Pinang,1292,739,553,United Kingdom
60096,12/1/2022,GBR,Sabah,383,223,160,United Kingdom
60097,12/1/2022,GBR,Sarawak,1526,900,626,United Kingdom
60098,12/1/2022,GBR,Selangor,13980,8282,5698,United Kingdom
60099,12/1/2022,GBR,Terengganu,0,0,0,United Kingdom
60100,12/1/2022,GBR,W.P. Labuan,29,13,16,United Kingdom
60101,12/1/2022,GEO,Johor,6,5,1,Georgia
60102,12/1/2022,GEO,Kedah,0,0,0,Georgia
60103,12/1/2022,GEO,Melaka,0,0,0,Georgia
60104,12/1/2022,GEO,Perak,0,0,0,Georgia
60105,12/1/2022,GEO,Perlis,2,2,0,Georgia
60106,12/1/2022,GEO,Pulau Pinang,1,0,1,Georgia
60107,12/1/2022,GEO,Sabah,0,0,0,Georgia
60108,12/1/2022,GEO,Sarawak,0,0,0,Georgia
60109,12/1/2022,GEO,Selangor,48,26,22,Georgia
60110,12/1/2022,GHA,Johor,7,3,4,Ghana
60111,12/1/2022,GHA,Kedah,0,0,0,Ghana
60112,12/1/2022,GHA,Kelantan,0,0,0,Ghana
60113,12/1/2022,GHA,Pulau Pinang,1,0,1,Ghana
60114,12/1/2022,GHA,Sabah,0,0,0,Ghana
60115,12/1/2022,GHA,Sarawak,1,1,0,Ghana
60116,12/1/2022,GHA,Selangor,64,41,23,Ghana
60117,12/1/2022,GIB,Johor,0,0,0,Gibraltar
60118,12/1/2022,GIB,Sarawak,0,0,0,Gibraltar
60119,12/1/2022,GIN,Johor,4,2,2,Guinea
60120,12/1/2022,GIN,Kedah,0,0,0,Guinea
60121,12/1/2022,GIN,Kelantan,1,1,0,Guinea
60122,12/1/2022,GIN,Perlis,0,0,0,Guinea
60123,12/1/2022,GIN,Pulau Pinang,0,0,0,Guinea
60124,12/1/2022,GIN,Sabah,0,0,0,Guinea
60125,12/1/2022,GIN,Sarawak,0,0,0,Guinea
60126,12/1/2022,GIN,Selangor,36,24,12,Guinea
60127,12/1/2022,GLP,Selangor,0,0,0,Guadeloupe
60128,12/1/2022,GMB,Johor,0,0,0,Gambia
60129,12/1/2022,GMB,Kedah,0,0,0,Gambia
60130,12/1/2022,GMB,Kelantan,0,0,0,Gambia
60131,12/1/2022,GMB,Pulau Pinang,0,0,0,Gambia
60132,12/1/2022,GMB,Sabah,0,0,0,Gambia
60133,12/1/2022,GMB,Sarawak,0,0,0,Gambia
60134,12/1/2022,GMB,Selangor,16,10,6,Gambia
60135,12/1/2022,GNB,Johor,0,0,0,Guinea-Bissau
60136,12/1/2022,GNB,Selangor,0,0,0,Guinea-Bissau
60137,12/1/2022,GNQ,Johor,0,0,0,Equatorial Guinea
60138,12/1/2022,GNQ,Selangor,0,0,0,Equatorial Guinea
60139,12/1/2022,GRC,Johor,39,26,13,Greece
60140,12/1/2022,GRC,Kedah,20,11,9,Greece
60141,12/1/2022,GRC,Kelantan,0,0,0,Greece
60142,12/1/2022,GRC,Melaka,0,0,0,Greece
60143,12/1/2022,GRC,Negeri Sembilan,0,0,0,Greece
60144,12/1/2022,GRC,Pahang,0,0,0,Greece
60145,12/1/2022,GRC,Perak,0,0,0,Greece
60146,12/1/2022,GRC,Perlis,4,3,1,Greece
60147,12/1/2022,GRC,Pulau Pinang,5,4,1,Greece
60148,12/1/2022,GRC,Sabah,2,2,0,Greece
60149,12/1/2022,GRC,Sarawak,1,1,0,Greece
60150,12/1/2022,GRC,Selangor,159,106,53,Greece
60151,12/1/2022,GRD,Johor,9,7,2,Grenada
60152,12/1/2022,GRD,Kedah,1,1,0,Grenada
60153,12/1/2022,GRD,Pulau Pinang,1,1,0,Grenada
60154,12/1/2022,GRD,Sabah,0,0,0,Grenada
60155,12/1/2022,GRD,Sarawak,1,0,1,Grenada
60156,12/1/2022,GRD,Selangor,3,3,0,Grenada
60157,12/1/2022,GRL,Johor,0,0,0,Greenland
60158,12/1/2022,GRL,Selangor,0,0,0,Greenland
60159,12/1/2022,GTM,Johor,1,1,0,Guatemala
60160,12/1/2022,GTM,Kedah,0,0,0,Guatemala
60161,12/1/2022,GTM,Pahang,0,0,0,Guatemala
60162,12/1/2022,GTM,Perak,0,0,0,Guatemala
60163,12/1/2022,GTM,Pulau Pinang,1,1,0,Guatemala
60164,12/1/2022,GTM,Sabah,0,0,0,Guatemala
60165,12/1/2022,GTM,Sarawak,0,0,0,Guatemala
60166,12/1/2022,GTM,Selangor,14,8,6,Guatemala
60167,12/1/2022,GTM,W.P. Labuan,0,0,0,Guatemala
60168,12/1/2022,GUY,Johor,0,0,0,Guyana
60169,12/1/2022,GUY,Kedah,0,0,0,Guyana
60170,12/1/2022,GUY,Pulau Pinang,0,0,0,Guyana
60171,12/1/2022,GUY,Sarawak,0,0,0,Guyana
60172,12/1/2022,GUY,Selangor,6,4,2,Guyana
60173,12/1/2022,HKG,Johor,5,3,2,Hong Kong
60174,12/1/2022,HKG,Kedah,3,3,0,Hong Kong
60175,12/1/2022,HKG,Kelantan,0,0,0,Hong Kong
60176,12/1/2022,HKG,Pahang,9,6,3,Hong Kong
60177,12/1/2022,HKG,Perak,45,22,23,Hong Kong
60178,12/1/2022,HKG,Perlis,3,1,2,Hong Kong
60179,12/1/2022,HKG,Pulau Pinang,0,0,0,Hong Kong
60180,12/1/2022,HKG,Sabah,4,2,2,Hong Kong
60181,12/1/2022,HKG,Sarawak,2,1,1,Hong Kong
60182,12/1/2022,HKG,Selangor,53,30,23,Hong Kong
60183,12/1/2022,HKG,Terengganu,0,0,0,Hong Kong
60184,12/1/2022,HMD,Johor,0,0,0,Heard Island and McDonald Islands
60185,12/1/2022,HND,Johor,4,3,1,Honduras
60186,12/1/2022,HND,Kedah,0,0,0,Honduras
60187,12/1/2022,HND,Perak,0,0,0,Honduras
60188,12/1/2022,HND,Pulau Pinang,1,1,0,Honduras
60189,12/1/2022,HND,Sabah,0,0,0,Honduras
60190,12/1/2022,HND,Sarawak,0,0,0,Honduras
60191,12/1/2022,HND,Selangor,8,2,6,Honduras
60192,12/1/2022,HRV,Johor,36,32,4,Croatia
60193,12/1/2022,HRV,Kedah,4,1,3,Croatia
60194,12/1/2022,HRV,Kelantan,0,0,0,Croatia
60195,12/1/2022,HRV,Melaka,0,0,0,Croatia
60196,12/1/2022,HRV,Pahang,0,0,0,Croatia
60197,12/1/2022,HRV,Perak,0,0,0,Croatia
60198,12/1/2022,HRV,Perlis,0,0,0,Croatia
60199,12/1/2022,HRV,Pulau Pinang,3,2,1,Croatia
60200,12/1/2022,HRV,Sabah,0,0,0,Croatia
60201,12/1/2022,HRV,Sarawak,2,1,1,Croatia
60202,12/1/2022,HRV,Selangor,133,77,56,Croatia
60203,12/1/2022,HTI,Johor,0,0,0,Haiti
60204,12/1/2022,HTI,Kedah,0,0,0,Haiti
60205,12/1/2022,HTI,Kelantan,0,0,0,Haiti
60206,12/1/2022,HTI,Perak,0,0,0,Haiti
60207,12/1/2022,HTI,Pulau Pinang,0,0,0,Haiti
60208,12/1/2022,HTI,Sabah,0,0,0,Haiti
60209,12/1/2022,HTI,Selangor,4,3,1,Haiti
60210,12/1/2022,HUN,Johor,108,66,42,Hungary
60211,12/1/2022,HUN,Kedah,42,19,23,Hungary
60212,12/1/2022,HUN,Kelantan,1,1,0,Hungary
60213,12/1/2022,HUN,Pahang,3,2,1,Hungary
60214,12/1/2022,HUN,Perak,0,0,0,Hungary
60215,12/1/2022,HUN,Perlis,6,4,2,Hungary
60216,12/1/2022,HUN,Pulau Pinang,42,19,23,Hungary
60217,12/1/2022,HUN,Sabah,59,29,30,Hungary
60218,12/1/2022,HUN,Sarawak,6,5,1,Hungary
60219,12/1/2022,HUN,Selangor,427,213,214,Hungary
60220,12/1/2022,HUN,W.P. Labuan,0,0,0,Hungary
60221,12/1/2022,IDN,Johor,109403,54653,54750,Indonesia
60222,12/1/2022,IDN,Kedah,3686,1512,2174,Indonesia
60223,12/1/2022,IDN,Kelantan,101,69,32,Indonesia
60224,12/1/2022,IDN,Melaka,7953,3512,4441,Indonesia
60225,12/1/2022,IDN,Negeri Sembilan,7001,4507,2494,Indonesia
60226,12/1/2022,IDN,Pahang,14,3,11,Indonesia
60227,12/1/2022,IDN,Perak,186,57,129,Indonesia
60228,12/1/2022,IDN,Perlis,435,161,274,Indonesia
60229,12/1/2022,IDN,Pulau Pinang,27822,11043,16779,Indonesia
60230,12/1/2022,IDN,Sabah,5497,2483,3014,Indonesia
60231,12/1/2022,IDN,Sarawak,39388,18824,20564,Indonesia
60232,12/1/2022,IDN,Selangor,95045,45009,50036,Indonesia
60233,12/1/2022,IDN,Terengganu,0,0,0,Indonesia
60234,12/1/2022,IDN,W.P. Labuan,82,46,36,Indonesia
60235,12/1/2022,IND,Johor,17995,11880,6115,India
60236,12/1/2022,IND,Kedah,459,249,210,India
60237,12/1/2022,IND,Kelantan,3,3,0,India
60238,12/1/2022,IND,Melaka,3,2,1,India
60239,12/1/2022,IND,Negeri Sembilan,0,0,0,India
60240,12/1/2022,IND,Pahang,9,5,4,India
60241,12/1/2022,IND,Perak,214,159,55,India
60242,12/1/2022,IND,Perlis,42,35,7,India
60243,12/1/2022,IND,Pulau Pinang,633,414,219,India
60244,12/1/2022,IND,Sabah,199,131,68,India
60245,12/1/2022,IND,Sarawak,1235,954,281,India
60246,12/1/2022,IND,Selangor,41083,27944,13139,India
60247,12/1/2022,IND,Terengganu,0,0,0,India
60248,12/1/2022,IND,W.P. Labuan,72,58,14,India
60249,12/1/2022,IOT,Pulau Pinang,0,0,0,British Indian Ocean Territory
60250,12/1/2022,IOT,Selangor,0,0,0,British Indian Ocean Territory
60251,12/1/2022,IRL,Johor,206,130,76,Ireland
60252,12/1/2022,IRL,Kedah,86,45,41,Ireland
60253,12/1/2022,IRL,Kelantan,0,0,0,Ireland
60254,12/1/2022,IRL,Negeri Sembilan,0,0,0,Ireland
60255,12/1/2022,IRL,Pahang,1,0,1,Ireland
60256,12/1/2022,IRL,Perak,3,1,2,Ireland
60257,12/1/2022,IRL,Perlis,7,5,2,Ireland
60258,12/1/2022,IRL,Pulau Pinang,55,35,20,Ireland
60259,12/1/2022,IRL,Sabah,21,13,8,Ireland
60260,12/1/2022,IRL,Sarawak,31,20,11,Ireland
60261,12/1/2022,IRL,Selangor,920,542,378,Ireland
60262,12/1/2022,IRL,Terengganu,0,0,0,Ireland
60263,12/1/2022,IRL,W.P. Labuan,0,0,0,Ireland
60264,12/1/2022,IRN,Johor,62,46,16,Iran
60265,12/1/2022,IRN,Kedah,6,4,2,Iran
60266,12/1/2022,IRN,Kelantan,0,0,0,Iran
60267,12/1/2022,IRN,Perak,0,0,0,Iran
60268,12/1/2022,IRN,Perlis,0,0,0,Iran
60269,12/1/2022,IRN,Pulau Pinang,13,8,5,Iran
60270,12/1/2022,IRN,Sabah,5,4,1,Iran
60271,12/1/2022,IRN,Sarawak,5,3,2,Iran
60272,12/1/2022,IRN,Selangor,854,474,380,Iran
60273,12/1/2022,IRN,W.P. Labuan,0,0,0,Iran
60274,12/1/2022,IRQ,Johor,15,9,6,Iraq
60275,12/1/2022,IRQ,Kedah,3,1,2,Iraq
60276,12/1/2022,IRQ,Kelantan,0,0,0,Iraq
60277,12/1/2022,IRQ,Melaka,0,0,0,Iraq
60278,12/1/2022,IRQ,Pahang,0,0,0,Iraq
60279,12/1/2022,IRQ,Perak,0,0,0,Iraq
60280,12/1/2022,IRQ,Perlis,0,0,0,Iraq
60281,12/1/2022,IRQ,Pulau Pinang,3,3,0,Iraq
60282,12/1/2022,IRQ,Sabah,0,0,0,Iraq
60283,12/1/2022,IRQ,Sarawak,0,0,0,Iraq
60284,12/1/2022,IRQ,Selangor,728,502,226,Iraq
60285,12/1/2022,ISL,Johor,12,8,4,Iceland
60286,12/1/2022,ISL,Kedah,1,1,0,Iceland
60287,12/1/2022,ISL,Kelantan,0,0,0,Iceland
60288,12/1/2022,ISL,Perak,0,0,0,Iceland
60289,12/1/2022,ISL,Perlis,0,0,0,Iceland
60290,12/1/2022,ISL,Pulau Pinang,2,1,1,Iceland
60291,12/1/2022,ISL,Sabah,12,7,5,Iceland
60292,12/1/2022,ISL,Sarawak,0,0,0,Iceland
60293,12/1/2022,ISL,Selangor,7,3,4,Iceland
60294,12/1/2022,ISL,W.P. Labuan,0,0,0,Iceland
60295,12/1/2022,ISR,Pulau Pinang,0,0,0,Israel
60296,12/1/2022,ITA,Johor,352,260,92,Italy
60297,12/1/2022,ITA,Kedah,170,105,65,Italy
60298,12/1/2022,ITA,Kelantan,0,0,0,Italy
60299,12/1/2022,ITA,Melaka,0,0,0,Italy
60300,12/1/2022,ITA,Negeri Sembilan,0,0,0,Italy
60301,12/1/2022,ITA,Pahang,3,2,1,Italy
60302,12/1/2022,ITA,Perak,12,10,2,Italy
60303,12/1/2022,ITA,Perlis,23,12,11,Italy
60304,12/1/2022,ITA,Pulau Pinang,83,55,28,Italy
60305,12/1/2022,ITA,Sabah,24,16,8,Italy
60306,12/1/2022,ITA,Sarawak,39,28,11,Italy
60307,12/1/2022,ITA,Selangor,1657,1051,606,Italy
60308,12/1/2022,ITA,W.P. Labuan,2,1,1,Italy
60309,12/1/2022,JAM,Johor,1,0,1,Jamaica
60310,12/1/2022,JAM,Kedah,2,0,2,Jamaica
60311,12/1/2022,JAM,Perak,0,0,0,Jamaica
60312,12/1/2022,JAM,Pulau Pinang,0,0,0,Jamaica
60313,12/1/2022,JAM,Sabah,6,4,2,Jamaica
60314,12/1/2022,JAM,Sarawak,0,0,0,Jamaica
60315,12/1/2022,JAM,Selangor,14,11,3,Jamaica
60316,12/1/2022,JAM,W.P. Labuan,0,0,0,Jamaica
60317,12/1/2022,JOR,Johor,23,10,13,Jordan
60318,12/1/2022,JOR,Kedah,2,2,0,Jordan
60319,12/1/2022,JOR,Kelantan,0,0,0,Jordan
60320,12/1/2022,JOR,Melaka,0,0,0,Jordan
60321,12/1/2022,JOR,Perlis,0,0,0,Jordan
60322,12/1/2022,JOR,Pulau Pinang,2,2,0,Jordan
60323,12/1/2022,JOR,Sabah,0,0,0,Jordan
60324,12/1/2022,JOR,Sarawak,0,0,0,Jordan
60325,12/1/2022,JOR,Selangor,496,300,196,Jordan
60326,12/1/2022,JOR,W.P. Labuan,0,0,0,Jordan
60327,12/1/2022,JPN,Johor,4606,3182,1424,Japan
60328,12/1/2022,JPN,Kedah,380,199,181,Japan
60329,12/1/2022,JPN,Kelantan,2,2,0,Japan
60330,12/1/2022,JPN,Melaka,1,1,0,Japan
60331,12/1/2022,JPN,Negeri Sembilan,0,0,0,Japan
60332,12/1/2022,JPN,Pahang,10,5,5,Japan
60333,12/1/2022,JPN,Perak,52,30,22,Japan
60334,12/1/2022,JPN,Perlis,54,39,15,Japan
60335,12/1/2022,JPN,Pulau Pinang,1076,711,365,Japan
60336,12/1/2022,JPN,Sabah,449,239,210,Japan
60337,12/1/2022,JPN,Sarawak,178,94,84,Japan
60338,12/1/2022,JPN,Selangor,12123,7561,4562,Japan
60339,12/1/2022,JPN,W.P. Labuan,7,5,2,Japan
60340,12/1/2022,KAZ,Johor,44,16,28,Kazakhstan
60341,12/1/2022,KAZ,Kedah,11,7,4,Kazakhstan
60342,12/1/2022,KAZ,Kelantan,1,0,1,Kazakhstan
60343,12/1/2022,KAZ,Melaka,0,0,0,Kazakhstan
60344,12/1/2022,KAZ,Perak,0,0,0,Kazakhstan
60345,12/1/2022,KAZ,Perlis,17,8,9,Kazakhstan
60346,12/1/2022,KAZ,Pulau Pinang,14,7,7,Kazakhstan
60347,12/1/2022,KAZ,Sabah,2,1,1,Kazakhstan
60348,12/1/2022,KAZ,Sarawak,7,0,7,Kazakhstan
60349,12/1/2022,KAZ,Selangor,460,188,272,Kazakhstan
60350,12/1/2022,KAZ,W.P. Labuan,0,0,0,Kazakhstan
60351,12/1/2022,KEN,Johor,68,33,35,Kenya
60352,12/1/2022,KEN,Kedah,8,4,4,Kenya
60353,12/1/2022,KEN,Kelantan,0,0,0,Kenya
60354,12/1/2022,KEN,Perak,0,0,0,Kenya
60355,12/1/2022,KEN,Perlis,0,0,0,Kenya
60356,12/1/2022,KEN,Pulau Pinang,2,1,1,Kenya
60357,12/1/2022,KEN,Sabah,4,2,2,Kenya
60358,12/1/2022,KEN,Sarawak,2,0,2,Kenya
60359,12/1/2022,KEN,Selangor,363,187,176,Kenya
60360,12/1/2022,KGZ,Johor,21,7,14,Kyrgyzstan
60361,12/1/2022,KGZ,Kedah,1,1,0,Kyrgyzstan
60362,12/1/2022,KGZ,Kelantan,0,0,0,Kyrgyzstan
60363,12/1/2022,KGZ,Perak,0,0,0,Kyrgyzstan
60364,12/1/2022,KGZ,Perlis,0,0,0,Kyrgyzstan
60365,12/1/2022,KGZ,Pulau Pinang,1,1,0,Kyrgyzstan
60366,12/1/2022,KGZ,Sabah,0,0,0,Kyrgyzstan
60367,12/1/2022,KGZ,Sarawak,0,0,0,Kyrgyzstan
60368,12/1/2022,KGZ,Selangor,156,68,88,Kyrgyzstan
60369,12/1/2022,KHM,Johor,2035,824,1211,Cambodia
60370,12/1/2022,KHM,Kedah,179,134,45,Cambodia
60371,12/1/2022,KHM,Kelantan,495,280,215,Cambodia
60372,12/1/2022,KHM,Melaka,0,0,0,Cambodia
60373,12/1/2022,KHM,Negeri Sembilan,0,0,0,Cambodia
60374,12/1/2022,KHM,Pahang,0,0,0,Cambodia
60375,12/1/2022,KHM,Perak,13,7,6,Cambodia
60376,12/1/2022,KHM,Perlis,513,285,228,Cambodia
60377,12/1/2022,KHM,Pulau Pinang,12,4,8,Cambodia
60378,12/1/2022,KHM,Sabah,2,1,1,Cambodia
60379,12/1/2022,KHM,Sarawak,4,1,3,Cambodia
60380,12/1/2022,KHM,Selangor,3427,1557,1870,Cambodia
60381,12/1/2022,KHM,W.P. Labuan,0,0,0,Cambodia
60382,12/1/2022,KIR,Johor,0,0,0,Kiribati
60383,12/1/2022,KIR,Sabah,0,0,0,Kiribati
60384,12/1/2022,KIR,Selangor,0,0,0,Kiribati
60385,12/1/2022,KNA,Johor,9,6,3,Saint Kitts and Nevis
60386,12/1/2022,KNA,Kedah,5,2,3,Saint Kitts and Nevis
60387,12/1/2022,KNA,Perlis,0,0,0,Saint Kitts and Nevis
60388,12/1/2022,KNA,Pulau Pinang,9,8,1,Saint Kitts and Nevis
60389,12/1/2022,KNA,Sabah,1,1,0,Saint Kitts and Nevis
60390,12/1/2022,KNA,Selangor,58,37,21,Saint Kitts and Nevis
60391,12/1/2022,KNA,W.P. Labuan,0,0,0,Saint Kitts and Nevis
60392,12/1/2022,KOR,Johor,9911,5334,4577,"Korea, Republic of (South Korea)"
60393,12/1/2022,KOR,Kedah,243,114,129,"Korea, Republic of (South Korea)"
60394,12/1/2022,KOR,Kelantan,0,0,0,"Korea, Republic of (South Korea)"
60395,12/1/2022,KOR,Melaka,0,0,0,"Korea, Republic of (South Korea)"
60396,12/1/2022,KOR,Negeri Sembilan,0,0,0,"Korea, Republic of (South Korea)"
60397,12/1/2022,KOR,Pahang,10,3,7,"Korea, Republic of (South Korea)"
60398,12/1/2022,KOR,Perak,10,2,8,"Korea, Republic of (South Korea)"
60399,12/1/2022,KOR,Perlis,85,65,20,"Korea, Republic of (South Korea)"
60400,12/1/2022,KOR,Pulau Pinang,387,215,172,"Korea, Republic of (South Korea)"
60401,12/1/2022,KOR,Sabah,12363,5398,6965,"Korea, Republic of (South Korea)"
60402,12/1/2022,KOR,Sarawak,230,132,98,"Korea, Republic of (South Korea)"
60403,12/1/2022,KOR,Selangor,11169,6041,5128,"Korea, Republic of (South Korea)"
60404,12/1/2022,KOR,Terengganu,0,0,0,"Korea, Republic of (South Korea)"
60405,12/1/2022,KOR,W.P. Labuan,7,6,1,"Korea, Republic of (South Korea)"
60406,12/1/2022,KWT,Johor,9,6,3,Kuwait
60407,12/1/2022,KWT,Kedah,1,0,1,Kuwait
60408,12/1/2022,KWT,Kelantan,0,0,0,Kuwait
60409,12/1/2022,KWT,Perak,0,0,0,Kuwait
60410,12/1/2022,KWT,Perlis,0,0,0,Kuwait
60411,12/1/2022,KWT,Pulau Pinang,1,1,0,Kuwait
60412,12/1/2022,KWT,Sabah,0,0,0,Kuwait
60413,12/1/2022,KWT,Sarawak,4,2,2,Kuwait
60414,12/1/2022,KWT,Selangor,444,270,174,Kuwait
60415,12/1/2022,KWT,W.P. Labuan,0,0,0,Kuwait
60416,12/1/2022,LAO,Johor,158,46,112,Lao People's Democratic Republic
60417,12/1/2022,LAO,Kedah,749,73,676,Lao People's Democratic Republic
60418,12/1/2022,LAO,Kelantan,121,12,109,Lao People's Democratic Republic
60419,12/1/2022,LAO,Melaka,0,0,0,Lao People's Democratic Republic
60420,12/1/2022,LAO,Perak,17,4,13,Lao People's Democratic Republic
60421,12/1/2022,LAO,Perlis,217,76,141,Lao People's Democratic Republic
60422,12/1/2022,LAO,Pulau Pinang,11,0,11,Lao People's Democratic Republic
60423,12/1/2022,LAO,Sabah,1,0,1,Lao People's Democratic Republic
60424,12/1/2022,LAO,Sarawak,11,2,9,Lao People's Democratic Republic
60425,12/1/2022,LAO,Selangor,211,84,127,Lao People's Democratic Republic
60426,12/1/2022,LAO,W.P. Labuan,0,0,0,Lao People's Democratic Republic
60427,12/1/2022,LBN,Johor,23,12,11,Lebanon
60428,12/1/2022,LBN,Kedah,1,0,1,Lebanon
60429,12/1/2022,LBN,Kelantan,0,0,0,Lebanon
60430,12/1/2022,LBN,Pahang,0,0,0,Lebanon
60431,12/1/2022,LBN,Perak,0,0,0,Lebanon
60432,12/1/2022,LBN,Perlis,1,1,0,Lebanon
60433,12/1/2022,LBN,Pulau Pinang,4,4,0,Lebanon
60434,12/1/2022,LBN,Sabah,0,0,0,Lebanon
60435,12/1/2022,LBN,Sarawak,1,1,0,Lebanon
60436,12/1/2022,LBN,Selangor,233,137,96,Lebanon
60437,12/1/2022,LBN,W.P. Labuan,0,0,0,Lebanon
60438,12/1/2022,LBR,Johor,1,1,0,Liberia
60439,12/1/2022,LBR,Kedah,0,0,0,Liberia
60440,12/1/2022,LBR,Sabah,0,0,0,Liberia
60441,12/1/2022,LBR,Sarawak,0,0,0,Liberia
60442,12/1/2022,LBR,Selangor,12,11,1,Liberia
60443,12/1/2022,LBY,Johor,0,0,0,Libyan Arab Jamahiriya
60444,12/1/2022,LBY,Kedah,1,1,0,Libyan Arab Jamahiriya
60445,12/1/2022,LBY,Perlis,0,0,0,Libyan Arab Jamahiriya
60446,12/1/2022,LBY,Pulau Pinang,1,1,0,Libyan Arab Jamahiriya
60447,12/1/2022,LBY,Sabah,0,0,0,Libyan Arab Jamahiriya
60448,12/1/2022,LBY,Sarawak,1,1,0,Libyan Arab Jamahiriya
60449,12/1/2022,LBY,Selangor,200,138,62,Libyan Arab Jamahiriya
60450,12/1/2022,LCA,Johor,2,2,0,Saint Lucia
60451,12/1/2022,LCA,Kedah,0,0,0,Saint Lucia
60452,12/1/2022,LCA,Pulau Pinang,1,0,1,Saint Lucia
60453,12/1/2022,LCA,Sarawak,6,3,3,Saint Lucia
60454,12/1/2022,LCA,Selangor,9,7,2,Saint Lucia
60455,12/1/2022,LIE,Johor,1,1,0,Liechtenstein
60456,12/1/2022,LIE,Kedah,5,3,2,Liechtenstein
60457,12/1/2022,LIE,Perlis,0,0,0,Liechtenstein
60458,12/1/2022,LIE,Pulau Pinang,0,0,0,Liechtenstein
60459,12/1/2022,LIE,Sabah,0,0,0,Liechtenstein
60460,12/1/2022,LIE,Sarawak,0,0,0,Liechtenstein
60461,12/1/2022,LIE,Selangor,5,3,2,Liechtenstein
60462,12/1/2022,LKA,Johor,1116,675,441,Sri Lanka
60463,12/1/2022,LKA,Kedah,11,5,6,Sri Lanka
60464,12/1/2022,LKA,Kelantan,0,0,0,Sri Lanka
60465,12/1/2022,LKA,Melaka,0,0,0,Sri Lanka
60466,12/1/2022,LKA,Pahang,0,0,0,Sri Lanka
60467,12/1/2022,LKA,Perak,10,4,6,Sri Lanka
60468,12/1/2022,LKA,Perlis,1,1,0,Sri Lanka
60469,12/1/2022,LKA,Pulau Pinang,15,13,2,Sri Lanka
60470,12/1/2022,LKA,Sabah,12,7,5,Sri Lanka
60471,12/1/2022,LKA,Sarawak,29,17,12,Sri Lanka
60472,12/1/2022,LKA,Selangor,3681,2244,1437,Sri Lanka
60473,12/1/2022,LKA,W.P. Labuan,2,2,0,Sri Lanka
60474,12/1/2022,LSO,Johor,0,0,0,Lesotho
60475,12/1/2022,LSO,Kedah,0,0,0,Lesotho
60476,12/1/2022,LSO,Pulau Pinang,0,0,0,Lesotho
60477,12/1/2022,LSO,Sarawak,0,0,0,Lesotho
60478,12/1/2022,LSO,Selangor,6,3,3,Lesotho
60479,12/1/2022,LTU,Johor,37,18,19,Lithuania
60480,12/1/2022,LTU,Kedah,25,9,16,Lithuania
60481,12/1/2022,LTU,Kelantan,0,0,0,Lithuania
60482,12/1/2022,LTU,Pahang,0,0,0,Lithuania
60483,12/1/2022,LTU,Perak,0,0,0,Lithuania
60484,12/1/2022,LTU,Perlis,9,4,5,Lithuania
60485,12/1/2022,LTU,Pulau Pinang,6,6,0,Lithuania
60486,12/1/2022,LTU,Sabah,5,4,1,Lithuania
60487,12/1/2022,LTU,Sarawak,7,4,3,Lithuania
60488,12/1/2022,LTU,Selangor,205,101,104,Lithuania
60489,12/1/2022,LTU,W.P. Labuan,0,0,0,Lithuania
60490,12/1/2022,LUX,Johor,2,1,1,Luxembourg
60491,12/1/2022,LUX,Kedah,4,2,2,Luxembourg
60492,12/1/2022,LUX,Kelantan,0,0,0,Luxembourg
60493,12/1/2022,LUX,Perak,0,0,0,Luxembourg
60494,12/1/2022,LUX,Perlis,0,0,0,Luxembourg
60495,12/1/2022,LUX,Pulau Pinang,3,1,2,Luxembourg
60496,12/1/2022,LUX,Sabah,2,1,1,Luxembourg
60497,12/1/2022,LUX,Sarawak,0,0,0,Luxembourg
60498,12/1/2022,LUX,Selangor,39,19,20,Luxembourg
60499,12/1/2022,LVA,Johor,19,12,7,Latvia
60500,12/1/2022,LVA,Kedah,10,4,6,Latvia
60501,12/1/2022,LVA,Kelantan,0,0,0,Latvia
60502,12/1/2022,LVA,Pahang,0,0,0,Latvia
60503,12/1/2022,LVA,Perak,1,1,0,Latvia
60504,12/1/2022,LVA,Perlis,6,3,3,Latvia
60505,12/1/2022,LVA,Pulau Pinang,3,2,1,Latvia
60506,12/1/2022,LVA,Sabah,0,0,0,Latvia
60507,12/1/2022,LVA,Sarawak,8,3,5,Latvia
60508,12/1/2022,LVA,Selangor,120,65,55,Latvia
60509,12/1/2022,LVA,W.P. Labuan,0,0,0,Latvia
60510,12/1/2022,MAC,Johor,0,0,0,Macao
60511,12/1/2022,MAC,Pahang,0,0,0,Macao
60512,12/1/2022,MAC,Perak,3,2,1,Macao
60513,12/1/2022,MAC,Selangor,6,2,4,Macao
60514,12/1/2022,MAC,W.P. Labuan,0,0,0,Macao
60515,12/1/2022,MAR,Johor,60,29,31,Morocco
60516,12/1/2022,MAR,Kedah,5,3,2,Morocco
60517,12/1/2022,MAR,Kelantan,0,0,0,Morocco
60518,12/1/2022,MAR,Melaka,1,0,1,Morocco
60519,12/1/2022,MAR,Pahang,0,0,0,Morocco
60520,12/1/2022,MAR,Perak,0,0,0,Morocco
60521,12/1/2022,MAR,Perlis,1,0,1,Morocco
60522,12/1/2022,MAR,Pulau Pinang,15,14,1,Morocco
60523,12/1/2022,MAR,Sabah,3,3,0,Morocco
60524,12/1/2022,MAR,Sarawak,10,7,3,Morocco
60525,12/1/2022,MAR,Selangor,386,211,175,Morocco
60526,12/1/2022,MAR,W.P. Labuan,1,1,0,Morocco
60527,12/1/2022,MCO,Johor,1,1,0,Monaco
60528,12/1/2022,MCO,Kedah,0,0,0,Monaco
60529,12/1/2022,MCO,Sabah,0,0,0,Monaco
60530,12/1/2022,MCO,Selangor,0,0,0,Monaco
60531,12/1/2022,MDA,Johor,8,3,5,"Moldova, Republic of"
60532,12/1/2022,MDA,Kedah,0,0,0,"Moldova, Republic of"
60533,12/1/2022,MDA,Kelantan,0,0,0,"Moldova, Republic of"
60534,12/1/2022,MDA,Negeri Sembilan,0,0,0,"Moldova, Republic of"
60535,12/1/2022,MDA,Perlis,0,0,0,"Moldova, Republic of"
60536,12/1/2022,MDA,Pulau Pinang,3,3,0,"Moldova, Republic of"
60537,12/1/2022,MDA,Sabah,0,0,0,"Moldova, Republic of"
60538,12/1/2022,MDA,Sarawak,0,0,0,"Moldova, Republic of"
60539,12/1/2022,MDA,Selangor,13,8,5,"Moldova, Republic of"
60540,12/1/2022,MDG,Johor,3,1,2,Madagascar
60541,12/1/2022,MDG,Kedah,0,0,0,Madagascar
60542,12/1/2022,MDG,Perak,0,0,0,Madagascar
60543,12/1/2022,MDG,Perlis,0,0,0,Madagascar
60544,12/1/2022,MDG,Pulau Pinang,1,0,1,Madagascar
60545,12/1/2022,MDG,Sabah,0,0,0,Madagascar
60546,12/1/2022,MDG,Sarawak,0,0,0,Madagascar
60547,12/1/2022,MDG,Selangor,32,14,18,Madagascar
60548,12/1/2022,MDV,Johor,174,86,88,Maldives
60549,12/1/2022,MDV,Kedah,0,0,0,Maldives
60550,12/1/2022,MDV,Kelantan,0,0,0,Maldives
60551,12/1/2022,MDV,Perak,2,1,1,Maldives
60552,12/1/2022,MDV,Perlis,5,2,3,Maldives
60553,12/1/2022,MDV,Pulau Pinang,2,1,1,Maldives
60554,12/1/2022,MDV,Sabah,0,0,0,Maldives
60555,12/1/2022,MDV,Sarawak,1,0,1,Maldives
60556,12/1/2022,MDV,Selangor,2847,1392,1455,Maldives
60557,12/1/2022,MEX,Johor,101,47,54,Mexico
60558,12/1/2022,MEX,Kedah,7,4,3,Mexico
60559,12/1/2022,MEX,Kelantan,0,0,0,Mexico
60560,12/1/2022,MEX,Pahang,0,0,0,Mexico
60561,12/1/2022,MEX,Perak,3,2,1,Mexico
60562,12/1/2022,MEX,Perlis,1,0,1,Mexico
60563,12/1/2022,MEX,Pulau Pinang,22,17,5,Mexico
60564,12/1/2022,MEX,Sabah,7,4,3,Mexico
60565,12/1/2022,MEX,Sarawak,3,2,1,Mexico
60566,12/1/2022,MEX,Selangor,338,185,153,Mexico
60567,12/1/2022,MEX,W.P. Labuan,0,0,0,Mexico
60568,12/1/2022,MHL,Johor,0,0,0,Marshall Islands
60569,12/1/2022,MHL,Kedah,0,0,0,Marshall Islands
60570,12/1/2022,MHL,Perak,0,0,0,Marshall Islands
60571,12/1/2022,MHL,Pulau Pinang,0,0,0,Marshall Islands
60572,12/1/2022,MHL,Sabah,0,0,0,Marshall Islands
60573,12/1/2022,MHL,Selangor,0,0,0,Marshall Islands
60574,12/1/2022,MKD,Johor,5,2,3,"Macedonia, the former Yugoslav Republic of"
60575,12/1/2022,MKD,Kedah,1,1,0,"Macedonia, the former Yugoslav Republic of"
60576,12/1/2022,MKD,Perak,0,0,0,"Macedonia, the former Yugoslav Republic of"
60577,12/1/2022,MKD,Pulau Pinang,0,0,0,"Macedonia, the former Yugoslav Republic of"
60578,12/1/2022,MKD,Sabah,0,0,0,"Macedonia, the former Yugoslav Republic of"
60579,12/1/2022,MKD,Sarawak,1,0,1,"Macedonia, the former Yugoslav Republic of"
60580,12/1/2022,MKD,Selangor,21,9,12,"Macedonia, the former Yugoslav Republic of"
60581,12/1/2022,MLI,Johor,5,5,0,Mali
60582,12/1/2022,MLI,Sabah,0,0,0,Mali
60583,12/1/2022,MLI,Selangor,3,3,0,Mali
60584,12/1/2022,MLT,Johor,6,5,1,Malta
60585,12/1/2022,MLT,Kedah,7,4,3,Malta
60586,12/1/2022,MLT,Kelantan,0,0,0,Malta
60587,12/1/2022,MLT,Perak,0,0,0,Malta
60588,12/1/2022,MLT,Perlis,0,0,0,Malta
60589,12/1/2022,MLT,Pulau Pinang,2,1,1,Malta
60590,12/1/2022,MLT,Sabah,0,0,0,Malta
60591,12/1/2022,MLT,Sarawak,1,1,0,Malta
60592,12/1/2022,MLT,Selangor,39,25,14,Malta
60593,12/1/2022,MLT,W.P. Labuan,0,0,0,Malta
60594,12/1/2022,MMR,Johor,4608,1237,3371,Myanmar
60595,12/1/2022,MMR,Kedah,72,8,64,Myanmar
60596,12/1/2022,MMR,Kelantan,2,1,1,Myanmar
60597,12/1/2022,MMR,Negeri Sembilan,0,0,0,Myanmar
60598,12/1/2022,MMR,Pahang,0,0,0,Myanmar
60599,12/1/2022,MMR,Perak,32,5,27,Myanmar
60600,12/1/2022,MMR,Perlis,14,2,12,Myanmar
60601,12/1/2022,MMR,Pulau Pinang,176,61,115,Myanmar
60602,12/1/2022,MMR,Sabah,21,4,17,Myanmar
60603,12/1/2022,MMR,Sarawak,108,37,71,Myanmar
60604,12/1/2022,MMR,Selangor,8288,5817,2471,Myanmar
60605,12/1/2022,MMR,Terengganu,0,0,0,Myanmar
60606,12/1/2022,MMR,W.P. Labuan,1,1,0,Myanmar
60607,12/1/2022,MNE,Johor,1,1,0,Montenegro
60608,12/1/2022,MNE,Kedah,0,0,0,Montenegro
60609,12/1/2022,MNE,Pulau Pinang,0,0,0,Montenegro
60610,12/1/2022,MNE,Sabah,0,0,0,Montenegro
60611,12/1/2022,MNE,Sarawak,0,0,0,Montenegro
60612,12/1/2022,MNE,Selangor,6,6,0,Montenegro
60613,12/1/2022,MNG,Johor,264,121,143,Mongolia
60614,12/1/2022,MNG,Kedah,10,3,7,Mongolia
60615,12/1/2022,MNG,Kelantan,0,0,0,Mongolia
60616,12/1/2022,MNG,Perak,0,0,0,Mongolia
60617,12/1/2022,MNG,Perlis,7,5,2,Mongolia
60618,12/1/2022,MNG,Pulau Pinang,19,10,9,Mongolia
60619,12/1/2022,MNG,Sabah,30,14,16,Mongolia
60620,12/1/2022,MNG,Sarawak,0,0,0,Mongolia
60621,12/1/2022,MNG,Selangor,350,128,222,Mongolia
60622,12/1/2022,MNP,Selangor,0,0,0,Northern Mariana Islands
60623,12/1/2022,MOZ,Johor,2,1,1,Mozambique
60624,12/1/2022,MOZ,Kedah,11,7,4,Mozambique
60625,12/1/2022,MOZ,Perak,0,0,0,Mozambique
60626,12/1/2022,MOZ,Pulau Pinang,0,0,0,Mozambique
60627,12/1/2022,MOZ,Sabah,0,0,0,Mozambique
60628,12/1/2022,MOZ,Sarawak,0,0,0,Mozambique
60629,12/1/2022,MOZ,Selangor,9,2,7,Mozambique
60630,12/1/2022,MRT,Johor,3,3,0,Mauritania
60631,12/1/2022,MRT,Kedah,0,0,0,Mauritania
60632,12/1/2022,MRT,Pulau Pinang,0,0,0,Mauritania
60633,12/1/2022,MRT,Sabah,0,0,0,Mauritania
60634,12/1/2022,MRT,Sarawak,0,0,0,Mauritania
60635,12/1/2022,MRT,Selangor,12,8,4,Mauritania
60636,12/1/2022,MUS,Johor,266,142,124,Mauritius
60637,12/1/2022,MUS,Kedah,1,0,1,Mauritius
60638,12/1/2022,MUS,Kelantan,0,0,0,Mauritius
60639,12/1/2022,MUS,Pahang,0,0,0,Mauritius
60640,12/1/2022,MUS,Perak,4,1,3,Mauritius
60641,12/1/2022,MUS,Perlis,5,3,2,Mauritius
60642,12/1/2022,MUS,Pulau Pinang,17,7,10,Mauritius
60643,12/1/2022,MUS,Sabah,1,1,0,Mauritius
60644,12/1/2022,MUS,Sarawak,1,1,0,Mauritius
60645,12/1/2022,MUS,Selangor,1985,932,1053,Mauritius
60646,12/1/2022,MWI,Johor,10,4,6,Malawi
60647,12/1/2022,MWI,Pulau Pinang,1,1,0,Malawi
60648,12/1/2022,MWI,Sabah,0,0,0,Malawi
60649,12/1/2022,MWI,Sarawak,0,0,0,Malawi
60650,12/1/2022,MWI,Selangor,10,4,6,Malawi
60651,12/1/2022,MYT,Selangor,0,0,0,Mayotte
60652,12/1/2022,NAM,Johor,1,0,1,Namibia
60653,12/1/2022,NAM,Kedah,0,0,0,Namibia
60654,12/1/2022,NAM,Perak,0,0,0,Namibia
60655,12/1/2022,NAM,Perlis,0,0,0,Namibia
60656,12/1/2022,NAM,Pulau Pinang,0,0,0,Namibia
60657,12/1/2022,NAM,Sabah,0,0,0,Namibia
60658,12/1/2022,NAM,Sarawak,0,0,0,Namibia
60659,12/1/2022,NAM,Selangor,16,6,10,Namibia
60660,12/1/2022,NCL,Selangor,0,0,0,New Caledonia
60661,12/1/2022,NER,Johor,0,0,0,Niger
60662,12/1/2022,NER,Sabah,0,0,0,Niger
60663,12/1/2022,NER,Selangor,3,1,2,Niger
60664,12/1/2022,NGA,Johor,30,26,4,Nigeria
60665,12/1/2022,NGA,Kedah,4,4,0,Nigeria
60666,12/1/2022,NGA,Perlis,0,0,0,Nigeria
60667,12/1/2022,NGA,Pulau Pinang,2,1,1,Nigeria
60668,12/1/2022,NGA,Sabah,0,0,0,Nigeria
60669,12/1/2022,NGA,Sarawak,13,8,5,Nigeria
60670,12/1/2022,NGA,Selangor,242,178,64,Nigeria
60671,12/1/2022,NIC,Johor,1,1,0,Nicaragua
60672,12/1/2022,NIC,Kedah,0,0,0,Nicaragua
60673,12/1/2022,NIC,Pulau Pinang,0,0,0,Nicaragua
60674,12/1/2022,NIC,Sabah,0,0,0,Nicaragua
60675,12/1/2022,NIC,Selangor,5,2,3,Nicaragua
60676,12/1/2022,NLD,Johor,788,541,247,Netherlands
60677,12/1/2022,NLD,Kedah,240,124,116,Netherlands
60678,12/1/2022,NLD,Kelantan,2,2,0,Netherlands
60679,12/1/2022,NLD,Melaka,0,0,0,Netherlands
60680,12/1/2022,NLD,Negeri Sembilan,2,1,1,Netherlands
60681,12/1/2022,NLD,Pahang,6,5,1,Netherlands
60682,12/1/2022,NLD,Perak,12,9,3,Netherlands
60683,12/1/2022,NLD,Perlis,24,17,7,Netherlands
60684,12/1/2022,NLD,Pulau Pinang,167,100,67,Netherlands
60685,12/1/2022,NLD,Sabah,33,20,13,Netherlands
60686,12/1/2022,NLD,Sarawak,132,82,50,Netherlands
60687,12/1/2022,NLD,Selangor,2656,1615,1041,Netherlands
60688,12/1/2022,NLD,Terengganu,0,0,0,Netherlands
60689,12/1/2022,NLD,W.P. Labuan,1,1,0,Netherlands
60690,12/1/2022,NOR,Johor,147,94,53,Norway
60691,12/1/2022,NOR,Kedah,40,24,16,Norway
60692,12/1/2022,NOR,Kelantan,0,0,0,Norway
60693,12/1/2022,NOR,Melaka,0,0,0,Norway
60694,12/1/2022,NOR,Pahang,0,0,0,Norway
60695,12/1/2022,NOR,Perak,0,0,0,Norway
60696,12/1/2022,NOR,Perlis,10,7,3,Norway
60697,12/1/2022,NOR,Pulau Pinang,16,12,4,Norway
60698,12/1/2022,NOR,Sabah,5,4,1,Norway
60699,12/1/2022,NOR,Sarawak,19,12,7,Norway
60700,12/1/2022,NOR,Selangor,562,348,214,Norway
60701,12/1/2022,NOR,W.P. Labuan,1,1,0,Norway
60702,12/1/2022,NPL,Johor,486,404,82,Nepal
60703,12/1/2022,NPL,Kedah,18,11,7,Nepal
60704,12/1/2022,NPL,Pahang,0,0,0,Nepal
60705,12/1/2022,NPL,Perak,0,0,0,Nepal
60706,12/1/2022,NPL,Perlis,2,2,0,Nepal
60707,12/1/2022,NPL,Pulau Pinang,25,24,1,Nepal
60708,12/1/2022,NPL,Sabah,6,4,2,Nepal
60709,12/1/2022,NPL,Sarawak,457,318,139,Nepal
60710,12/1/2022,NPL,Selangor,25621,24929,692,Nepal
60711,12/1/2022,NPL,W.P. Labuan,77,75,2,Nepal
60712,12/1/2022,NRU,Johor,0,0,0,Nauru
60713,12/1/2022,NRU,Pulau Pinang,0,0,0,Nauru
60714,12/1/2022,NRU,Selangor,1,1,0,Nauru
60715,12/1/2022,NZL,Johor,773,437,336,New Zealand
60716,12/1/2022,NZL,Kedah,75,39,36,New Zealand
60717,12/1/2022,NZL,Kelantan,3,0,3,New Zealand
60718,12/1/2022,NZL,Melaka,0,0,0,New Zealand
60719,12/1/2022,NZL,Negeri Sembilan,0,0,0,New Zealand
60720,12/1/2022,NZL,Pahang,0,0,0,New Zealand
60721,12/1/2022,NZL,Perak,32,20,12,New Zealand
60722,12/1/2022,NZL,Perlis,10,4,6,New Zealand
60723,12/1/2022,NZL,Pulau Pinang,222,124,98,New Zealand
60724,12/1/2022,NZL,Sabah,64,27,37,New Zealand
60725,12/1/2022,NZL,Sarawak,157,83,74,New Zealand
60726,12/1/2022,NZL,Selangor,3309,1852,1457,New Zealand
60727,12/1/2022,NZL,Terengganu,0,0,0,New Zealand
60728,12/1/2022,NZL,W.P. Labuan,2,2,0,New Zealand
60729,12/1/2022,OMN,Johor,31,22,9,Oman
60730,12/1/2022,OMN,Kedah,1,1,0,Oman
60731,12/1/2022,OMN,Kelantan,2,1,1,Oman
60732,12/1/2022,OMN,Melaka,0,0,0,Oman
60733,12/1/2022,OMN,Perak,0,0,0,Oman
60734,12/1/2022,OMN,Perlis,0,0,0,Oman
60735,12/1/2022,OMN,Pulau Pinang,5,3,2,Oman
60736,12/1/2022,OMN,Sabah,3,3,0,Oman
60737,12/1/2022,OMN,Sarawak,6,3,3,Oman
60738,12/1/2022,OMN,Selangor,533,325,208,Oman
60739,12/1/2022,PAK,Johor,779,554,225,Pakistan
60740,12/1/2022,PAK,Kedah,123,86,37,Pakistan
60741,12/1/2022,PAK,Kelantan,4,4,0,Pakistan
60742,12/1/2022,PAK,Melaka,0,0,0,Pakistan
60743,12/1/2022,PAK,Negeri Sembilan,1,1,0,Pakistan
60744,12/1/2022,PAK,Pahang,5,2,3,Pakistan
60745,12/1/2022,PAK,Perak,41,41,0,Pakistan
60746,12/1/2022,PAK,Perlis,30,28,2,Pakistan
60747,12/1/2022,PAK,Pulau Pinang,49,46,3,Pakistan
60748,12/1/2022,PAK,Sabah,34,31,3,Pakistan
60749,12/1/2022,PAK,Sarawak,204,160,44,Pakistan
60750,12/1/2022,PAK,Selangor,10196,8776,1420,Pakistan
60751,12/1/2022,PAK,W.P. Labuan,8,6,2,Pakistan
60752,12/1/2022,PAN,Johor,5,1,4,Panama
60753,12/1/2022,PAN,Kedah,0,0,0,Panama
60754,12/1/2022,PAN,Perak,0,0,0,Panama
60755,12/1/2022,PAN,Perlis,0,0,0,Panama
60756,12/1/2022,PAN,Pulau Pinang,0,0,0,Panama
60757,12/1/2022,PAN,Sabah,1,1,0,Panama
60758,12/1/2022,PAN,Sarawak,0,0,0,Panama
60759,12/1/2022,PAN,Selangor,16,9,7,Panama
60760,12/1/2022,PER,Johor,26,15,11,Peru
60761,12/1/2022,PER,Kedah,1,0,1,Peru
60762,12/1/2022,PER,Kelantan,0,0,0,Peru
60763,12/1/2022,PER,Pahang,0,0,0,Peru
60764,12/1/2022,PER,Perak,0,0,0,Peru
60765,12/1/2022,PER,Perlis,3,0,3,Peru
60766,12/1/2022,PER,Pulau Pinang,3,2,1,Peru
60767,12/1/2022,PER,Sabah,0,0,0,Peru
60768,12/1/2022,PER,Sarawak,0,0,0,Peru
60769,12/1/2022,PER,Selangor,89,46,43,Peru
60770,12/1/2022,PER,W.P. Labuan,0,0,0,Peru
60771,12/1/2022,PHL,Johor,19506,6147,13359,Philippines
60772,12/1/2022,PHL,Kedah,426,141,285,Philippines
60773,12/1/2022,PHL,Kelantan,19,13,6,Philippines
60774,12/1/2022,PHL,Melaka,0,0,0,Philippines
60775,12/1/2022,PHL,Negeri Sembilan,0,0,0,Philippines
60776,12/1/2022,PHL,Pahang,5,2,3,Philippines
60777,12/1/2022,PHL,Perak,100,31,69,Philippines
60778,12/1/2022,PHL,Perlis,88,29,59,Philippines
60779,12/1/2022,PHL,Pulau Pinang,399,114,285,Philippines
60780,12/1/2022,PHL,Sabah,1705,695,1010,Philippines
60781,12/1/2022,PHL,Sarawak,2342,847,1495,Philippines
60782,12/1/2022,PHL,Selangor,15026,5792,9234,Philippines
60783,12/1/2022,PHL,Terengganu,0,0,0,Philippines
60784,12/1/2022,PHL,W.P. Labuan,140,49,91,Philippines
60785,12/1/2022,PLW,Johor,3,3,0,Palau
60786,12/1/2022,PLW,Pulau Pinang,0,0,0,Palau
60787,12/1/2022,PLW,Selangor,0,0,0,Palau
60788,12/1/2022,PNG,Johor,13,7,6,Papua New Guinea
60789,12/1/2022,PNG,Kedah,0,0,0,Papua New Guinea
60790,12/1/2022,PNG,Kelantan,0,0,0,Papua New Guinea
60791,12/1/2022,PNG,Perak,0,0,0,Papua New Guinea
60792,12/1/2022,PNG,Pulau Pinang,0,0,0,Papua New Guinea
60793,12/1/2022,PNG,Sabah,1,0,1,Papua New Guinea
60794,12/1/2022,PNG,Sarawak,7,3,4,Papua New Guinea
60795,12/1/2022,PNG,Selangor,33,17,16,Papua New Guinea
60796,12/1/2022,POL,Johor,272,159,113,Poland
60797,12/1/2022,POL,Kedah,98,44,54,Poland
60798,12/1/2022,POL,Kelantan,2,1,1,Poland
60799,12/1/2022,POL,Melaka,0,0,0,Poland
60800,12/1/2022,POL,Negeri Sembilan,0,0,0,Poland
60801,12/1/2022,POL,Pahang,0,0,0,Poland
60802,12/1/2022,POL,Perak,1,1,0,Poland
60803,12/1/2022,POL,Perlis,22,14,8,Poland
60804,12/1/2022,POL,Pulau Pinang,55,27,28,Poland
60805,12/1/2022,POL,Sabah,22,13,9,Poland
60806,12/1/2022,POL,Sarawak,28,14,14,Poland
60807,12/1/2022,POL,Selangor,668,357,311,Poland
60808,12/1/2022,POL,Terengganu,0,0,0,Poland
60809,12/1/2022,POL,W.P. Labuan,2,1,1,Poland
60810,12/1/2022,PRK,Selangor,0,0,0,"Korea, Democratic People's Republic of"
60811,12/1/2022,PRT,Johor,128,72,56,Portugal
60812,12/1/2022,PRT,Kedah,40,21,19,Portugal
60813,12/1/2022,PRT,Kelantan,0,0,0,Portugal
60814,12/1/2022,PRT,Melaka,0,0,0,Portugal
60815,12/1/2022,PRT,Pahang,0,0,0,Portugal
60816,12/1/2022,PRT,Perak,6,2,4,Portugal
60817,12/1/2022,PRT,Perlis,0,0,0,Portugal
60818,12/1/2022,PRT,Pulau Pinang,13,6,7,Portugal
60819,12/1/2022,PRT,Sabah,3,2,1,Portugal
60820,12/1/2022,PRT,Sarawak,5,1,4,Portugal
60821,12/1/2022,PRT,Selangor,456,261,195,Portugal
60822,12/1/2022,PRT,W.P. Labuan,0,0,0,Portugal
60823,12/1/2022,PRY,Johor,1,1,0,Paraguay
60824,12/1/2022,PRY,Kedah,0,0,0,Paraguay
60825,12/1/2022,PRY,Perak,0,0,0,Paraguay
60826,12/1/2022,PRY,Perlis,0,0,0,Paraguay
60827,12/1/2022,PRY,Pulau Pinang,6,6,0,Paraguay
60828,12/1/2022,PRY,Sabah,0,0,0,Paraguay
60829,12/1/2022,PRY,Sarawak,0,0,0,Paraguay
60830,12/1/2022,PRY,Selangor,5,3,2,Paraguay
60831,12/1/2022,PSE,Johor,6,5,1,"Palestinian Territory, Occupied"
60832,12/1/2022,PSE,Kedah,0,0,0,"Palestinian Territory, Occupied"
60833,12/1/2022,PSE,Kelantan,3,2,1,"Palestinian Territory, Occupied"
60834,12/1/2022,PSE,Melaka,0,0,0,"Palestinian Territory, Occupied"
60835,12/1/2022,PSE,Perak,0,0,0,"Palestinian Territory, Occupied"
60836,12/1/2022,PSE,Perlis,0,0,0,"Palestinian Territory, Occupied"
60837,12/1/2022,PSE,Pulau Pinang,2,1,1,"Palestinian Territory, Occupied"
60838,12/1/2022,PSE,Sabah,0,0,0,"Palestinian Territory, Occupied"
60839,12/1/2022,PSE,Sarawak,1,1,0,"Palestinian Territory, Occupied"
60840,12/1/2022,PSE,Selangor,207,137,70,"Palestinian Territory, Occupied"
60841,12/1/2022,QAT,Johor,12,4,8,Qatar
60842,12/1/2022,QAT,Kedah,0,0,0,Qatar
60843,12/1/2022,QAT,Perlis,0,0,0,Qatar
60844,12/1/2022,QAT,Pulau Pinang,0,0,0,Qatar
60845,12/1/2022,QAT,Sabah,0,0,0,Qatar
60846,12/1/2022,QAT,Sarawak,0,0,0,Qatar
60847,12/1/2022,QAT,Selangor,54,32,22,Qatar
60848,12/1/2022,REU,Johor,0,0,0,Reunion
60849,12/1/2022,REU,Sarawak,0,0,0,Reunion
60850,12/1/2022,ROU,Johor,141,77,64,Romania
60851,12/1/2022,ROU,Kedah,34,21,13,Romania
60852,12/1/2022,ROU,Kelantan,0,0,0,Romania
60853,12/1/2022,ROU,Negeri Sembilan,0,0,0,Romania
60854,12/1/2022,ROU,Pahang,0,0,0,Romania
60855,12/1/2022,ROU,Perak,4,3,1,Romania
60856,12/1/2022,ROU,Perlis,4,3,1,Romania
60857,12/1/2022,ROU,Pulau Pinang,20,9,11,Romania
60858,12/1/2022,ROU,Sabah,5,2,3,Romania
60859,12/1/2022,ROU,Sarawak,22,13,9,Romania
60860,12/1/2022,ROU,Selangor,553,290,263,Romania
60861,12/1/2022,ROU,W.P. Labuan,0,0,0,Romania
60862,12/1/2022,RUS,Johor,448,221,227,Russia
60863,12/1/2022,RUS,Kedah,569,312,257,Russia
60864,12/1/2022,RUS,Kelantan,39,26,13,Russia
60865,12/1/2022,RUS,Melaka,2,1,1,Russia
60866,12/1/2022,RUS,Negeri Sembilan,0,0,0,Russia
60867,12/1/2022,RUS,Pahang,0,0,0,Russia
60868,12/1/2022,RUS,Perak,10,5,5,Russia
60869,12/1/2022,RUS,Perlis,552,320,232,Russia
60870,12/1/2022,RUS,Pulau Pinang,329,173,156,Russia
60871,12/1/2022,RUS,Sabah,53,27,26,Russia
60872,12/1/2022,RUS,Sarawak,69,35,34,Russia
60873,12/1/2022,RUS,Selangor,10820,5835,4985,Russia
60874,12/1/2022,RUS,W.P. Labuan,0,0,0,Russia
60875,12/1/2022,RWA,Johor,1,0,1,Rwanda
60876,12/1/2022,RWA,Kedah,0,0,0,Rwanda
60877,12/1/2022,RWA,Pulau Pinang,0,0,0,Rwanda
60878,12/1/2022,RWA,Selangor,5,2,3,Rwanda
60879,12/1/2022,SAU,Johor,73,53,20,Saudi Arabia
60880,12/1/2022,SAU,Kedah,15,7,8,Saudi Arabia
60881,12/1/2022,SAU,Kelantan,0,0,0,Saudi Arabia
60882,12/1/2022,SAU,Melaka,0,0,0,Saudi Arabia
60883,12/1/2022,SAU,Perak,0,0,0,Saudi Arabia
60884,12/1/2022,SAU,Perlis,7,4,3,Saudi Arabia
60885,12/1/2022,SAU,Pulau Pinang,4,3,1,Saudi Arabia
60886,12/1/2022,SAU,Sabah,5,3,2,Saudi Arabia
60887,12/1/2022,SAU,Sarawak,15,9,6,Saudi Arabia
60888,12/1/2022,SAU,Selangor,2309,1305,1004,Saudi Arabia
60889,12/1/2022,SAU,W.P. Labuan,1,1,0,Saudi Arabia
60890,12/1/2022,SDN,Johor,8,2,6,Sudan
60891,12/1/2022,SDN,Kedah,1,1,0,Sudan
60892,12/1/2022,SDN,Kelantan,0,0,0,Sudan
60893,12/1/2022,SDN,Perlis,0,0,0,Sudan
60894,12/1/2022,SDN,Pulau Pinang,1,0,1,Sudan
60895,12/1/2022,SDN,Sabah,0,0,0,Sudan
60896,12/1/2022,SDN,Sarawak,5,4,1,Sudan
60897,12/1/2022,SDN,Selangor,835,468,367,Sudan
60898,12/1/2022,SDN,W.P. Labuan,0,0,0,Sudan
60899,12/1/2022,SEN,Johor,3,1,2,Senegal
60900,12/1/2022,SEN,Kedah,0,0,0,Senegal
60901,12/1/2022,SEN,Kelantan,0,0,0,Senegal
60902,12/1/2022,SEN,Perak,0,0,0,Senegal
60903,12/1/2022,SEN,Perlis,0,0,0,Senegal
60904,12/1/2022,SEN,Pulau Pinang,0,0,0,Senegal
60905,12/1/2022,SEN,Sabah,0,0,0,Senegal
60906,12/1/2022,SEN,Sarawak,0,0,0,Senegal
60907,12/1/2022,SEN,Selangor,12,9,3,Senegal
60908,12/1/2022,SGP,Johor,1151986,631496,520490,Singapore
60909,12/1/2022,SGP,Kedah,6597,3389,3208,Singapore
60910,12/1/2022,SGP,Kelantan,46,28,18,Singapore
60911,12/1/2022,SGP,Melaka,16,14,2,Singapore
60912,12/1/2022,SGP,Negeri Sembilan,1,1,0,Singapore
60913,12/1/2022,SGP,Pahang,564,281,283,Singapore
60914,12/1/2022,SGP,Perak,7950,3875,4075,Singapore
60915,12/1/2022,SGP,Perlis,571,279,292,Singapore
60916,12/1/2022,SGP,Pulau Pinang,20185,9923,10262,Singapore
60917,12/1/2022,SGP,Sabah,4405,2210,2195,Singapore
60918,12/1/2022,SGP,Sarawak,6115,3114,3001,Singapore
60919,12/1/2022,SGP,Selangor,68868,33621,35247,Singapore
60920,12/1/2022,SGP,Terengganu,0,0,0,Singapore
60921,12/1/2022,SGP,W.P. Labuan,18,15,3,Singapore
60922,12/1/2022,SGS,Johor,0,0,0,South Georgia and the South Sandwich Islands
60923,12/1/2022,SGS,Sabah,0,0,0,South Georgia and the South Sandwich Islands
60924,12/1/2022,SGS,Selangor,0,0,0,South Georgia and the South Sandwich Islands
60925,12/1/2022,SHN,Sarawak,0,0,0,"Saint Helena, Ascension and Tristan da Cunha"
60926,12/1/2022,SLB,Johor,0,0,0,Solomon Islands
60927,12/1/2022,SLB,Perlis,0,0,0,Solomon Islands
60928,12/1/2022,SLB,Pulau Pinang,0,0,0,Solomon Islands
60929,12/1/2022,SLB,Sabah,0,0,0,Solomon Islands
60930,12/1/2022,SLB,Sarawak,3,3,0,Solomon Islands
60931,12/1/2022,SLB,Selangor,6,4,2,Solomon Islands
60932,12/1/2022,SLB,W.P. Labuan,0,0,0,Solomon Islands
60933,12/1/2022,SLE,Johor,1,1,0,Sierra Leone
60934,12/1/2022,SLE,Kedah,0,0,0,Sierra Leone
60935,12/1/2022,SLE,Perak,0,0,0,Sierra Leone
60936,12/1/2022,SLE,Pulau Pinang,0,0,0,Sierra Leone
60937,12/1/2022,SLE,Sabah,0,0,0,Sierra Leone
60938,12/1/2022,SLE,Selangor,12,10,2,Sierra Leone
60939,12/1/2022,SLV,Johor,0,0,0,El Salvador
60940,12/1/2022,SLV,Kedah,1,1,0,El Salvador
60941,12/1/2022,SLV,Perak,0,0,0,El Salvador
60942,12/1/2022,SLV,Perlis,0,0,0,El Salvador
60943,12/1/2022,SLV,Pulau Pinang,2,2,0,El Salvador
60944,12/1/2022,SLV,Sabah,0,0,0,El Salvador
60945,12/1/2022,SLV,Selangor,11,7,4,El Salvador
60946,12/1/2022,SLV,W.P. Labuan,0,0,0,El Salvador
60947,12/1/2022,SMR,Johor,0,0,0,San Marino
60948,12/1/2022,SMR,Selangor,0,0,0,San Marino
60949,12/1/2022,SOM,Johor,0,0,0,Somalia
60950,12/1/2022,SOM,Kedah,0,0,0,Somalia
60951,12/1/2022,SOM,Kelantan,0,0,0,Somalia
60952,12/1/2022,SOM,Perlis,0,0,0,Somalia
60953,12/1/2022,SOM,Sabah,0,0,0,Somalia
60954,12/1/2022,SOM,Sarawak,0,0,0,Somalia
60955,12/1/2022,SOM,Selangor,174,117,57,Somalia
60956,12/1/2022,SRB,Johor,10,5,5,Serbia
60957,12/1/2022,SRB,Kedah,0,0,0,Serbia
60958,12/1/2022,SRB,Kelantan,0,0,0,Serbia
60959,12/1/2022,SRB,Pahang,0,0,0,Serbia
60960,12/1/2022,SRB,Perak,0,0,0,Serbia
60961,12/1/2022,SRB,Perlis,0,0,0,Serbia
60962,12/1/2022,SRB,Pulau Pinang,0,0,0,Serbia
60963,12/1/2022,SRB,Sabah,1,1,0,Serbia
60964,12/1/2022,SRB,Sarawak,0,0,0,Serbia
60965,12/1/2022,SRB,Selangor,69,41,28,Serbia
60966,12/1/2022,STP,Selangor,1,1,0,Sao Tome and Principe
60967,12/1/2022,SUR,Johor,1,1,0,Suriname
60968,12/1/2022,SUR,Kedah,0,0,0,Suriname
60969,12/1/2022,SUR,Kelantan,0,0,0,Suriname
60970,12/1/2022,SUR,Perak,0,0,0,Suriname
60971,12/1/2022,SUR,Perlis,0,0,0,Suriname
60972,12/1/2022,SUR,Pulau Pinang,0,0,0,Suriname
60973,12/1/2022,SUR,Sabah,0,0,0,Suriname
60974,12/1/2022,SUR,Sarawak,0,0,0,Suriname
60975,12/1/2022,SUR,Selangor,19,8,11,Suriname
60976,12/1/2022,SVK,Johor,30,15,15,Slovakia
60977,12/1/2022,SVK,Kedah,55,28,27,Slovakia
60978,12/1/2022,SVK,Kelantan,1,0,1,Slovakia
60979,12/1/2022,SVK,Negeri Sembilan,0,0,0,Slovakia
60980,12/1/2022,SVK,Pahang,0,0,0,Slovakia
60981,12/1/2022,SVK,Perak,0,0,0,Slovakia
60982,12/1/2022,SVK,Perlis,1,0,1,Slovakia
60983,12/1/2022,SVK,Pulau Pinang,8,8,0,Slovakia
60984,12/1/2022,SVK,Sabah,9,5,4,Slovakia
60985,12/1/2022,SVK,Sarawak,7,3,4,Slovakia
60986,12/1/2022,SVK,Selangor,232,115,117,Slovakia
60987,12/1/2022,SVK,W.P. Labuan,0,0,0,Slovakia
60988,12/1/2022,SVN,Johor,7,2,5,Slovenia
60989,12/1/2022,SVN,Kedah,13,7,6,Slovenia
60990,12/1/2022,SVN,Kelantan,0,0,0,Slovenia
60991,12/1/2022,SVN,Perak,0,0,0,Slovenia
60992,12/1/2022,SVN,Perlis,2,2,0,Slovenia
60993,12/1/2022,SVN,Pulau Pinang,0,0,0,Slovenia
60994,12/1/2022,SVN,Sabah,0,0,0,Slovenia
60995,12/1/2022,SVN,Sarawak,1,0,1,Slovenia
60996,12/1/2022,SVN,Selangor,67,40,27,Slovenia
60997,12/1/2022,SVN,W.P. Labuan,0,0,0,Slovenia
60998,12/1/2022,SWE,Johor,256,139,117,Sweden
60999,12/1/2022,SWE,Kedah,189,99,90,Sweden
61000,12/1/2022,SWE,Kelantan,0,0,0,Sweden
61001,12/1/2022,SWE,Melaka,0,0,0,Sweden
61002,12/1/2022,SWE,Negeri Sembilan,0,0,0,Sweden
61003,12/1/2022,SWE,Pahang,0,0,0,Sweden
61004,12/1/2022,SWE,Perak,7,3,4,Sweden
61005,12/1/2022,SWE,Perlis,26,18,8,Sweden
61006,12/1/2022,SWE,Pulau Pinang,72,43,29,Sweden
61007,12/1/2022,SWE,Sabah,39,21,18,Sweden
61008,12/1/2022,SWE,Sarawak,32,23,9,Sweden
61009,12/1/2022,SWE,Selangor,1159,663,496,Sweden
61010,12/1/2022,SWE,W.P. Labuan,0,0,0,Sweden
61011,12/1/2022,SWZ,Johor,1,1,0,Swaziland
61012,12/1/2022,SWZ,Kedah,0,0,0,Swaziland
61013,12/1/2022,SWZ,Pulau Pinang,0,0,0,Swaziland
61014,12/1/2022,SWZ,Sabah,0,0,0,Swaziland
61015,12/1/2022,SWZ,Selangor,22,14,8,Swaziland
61016,12/1/2022,SYC,Johor,3,3,0,Seychelles
61017,12/1/2022,SYC,Kedah,0,0,0,Seychelles
61018,12/1/2022,SYC,Pulau Pinang,0,0,0,Seychelles
61019,12/1/2022,SYC,Sabah,0,0,0,Seychelles
61020,12/1/2022,SYC,Sarawak,0,0,0,Seychelles
61021,12/1/2022,SYC,Selangor,71,24,47,Seychelles
61022,12/1/2022,SYR,Johor,23,8,15,Syrian Arab Republic
61023,12/1/2022,SYR,Kedah,0,0,0,Syrian Arab Republic
61024,12/1/2022,SYR,Kelantan,0,0,0,Syrian Arab Republic
61025,12/1/2022,SYR,Pahang,0,0,0,Syrian Arab Republic
61026,12/1/2022,SYR,Perlis,0,0,0,Syrian Arab Republic
61027,12/1/2022,SYR,Pulau Pinang,1,1,0,Syrian Arab Republic
61028,12/1/2022,SYR,Sabah,0,0,0,Syrian Arab Republic
61029,12/1/2022,SYR,Sarawak,14,10,4,Syrian Arab Republic
61030,12/1/2022,SYR,Selangor,439,284,155,Syrian Arab Republic
61031,12/1/2022,SYR,W.P. Labuan,2,2,0,Syrian Arab Republic
61032,12/1/2022,TCA,Perlis,0,0,0,Turks and Caicos
61033,12/1/2022,TCD,Johor,1,1,0,Chad
61034,12/1/2022,TCD,Kedah,0,0,0,Chad
61035,12/1/2022,TCD,Perlis,0,0,0,Chad
61036,12/1/2022,TCD,Selangor,18,10,8,Chad
61037,12/1/2022,TGO,Johor,2,1,1,Togo
61038,12/1/2022,TGO,Perak,0,0,0,Togo
61039,12/1/2022,TGO,Pulau Pinang,0,0,0,Togo
61040,12/1/2022,TGO,Selangor,3,3,0,Togo
61041,12/1/2022,THA,Johor,5450,1568,3882,Thailand
61042,12/1/2022,THA,Kedah,57007,33206,23801,Thailand
61043,12/1/2022,THA,Kelantan,25530,12900,12630,Thailand
61044,12/1/2022,THA,Melaka,2,0,2,Thailand
61045,12/1/2022,THA,Negeri Sembilan,2,1,1,Thailand
61046,12/1/2022,THA,Pahang,0,0,0,Thailand
61047,12/1/2022,THA,Perak,8624,4023,4601,Thailand
61048,12/1/2022,THA,Perlis,50271,30816,19455,Thailand
61049,12/1/2022,THA,Pulau Pinang,1651,647,1004,Thailand
61050,12/1/2022,THA,Sabah,113,26,87,Thailand
61051,12/1/2022,THA,Sarawak,345,127,218,Thailand
61052,12/1/2022,THA,Selangor,10889,4288,6601,Thailand
61053,12/1/2022,THA,Terengganu,0,0,0,Thailand
61054,12/1/2022,THA,W.P. Labuan,2,2,0,Thailand
61055,12/1/2022,TJK,Johor,1,1,0,Tajikistan
61056,12/1/2022,TJK,Kedah,1,0,1,Tajikistan
61057,12/1/2022,TJK,Perlis,0,0,0,Tajikistan
61058,12/1/2022,TJK,Pulau Pinang,0,0,0,Tajikistan
61059,12/1/2022,TJK,Sabah,0,0,0,Tajikistan
61060,12/1/2022,TJK,Selangor,98,66,32,Tajikistan
61061,12/1/2022,TKL,Selangor,0,0,0,Tokelau
61062,12/1/2022,TKM,Johor,1,1,0,Turkmenistan
61063,12/1/2022,TKM,Kedah,0,0,0,Turkmenistan
61064,12/1/2022,TKM,Kelantan,0,0,0,Turkmenistan
61065,12/1/2022,TKM,Perlis,0,0,0,Turkmenistan
61066,12/1/2022,TKM,Pulau Pinang,0,0,0,Turkmenistan
61067,12/1/2022,TKM,Sabah,0,0,0,Turkmenistan
61068,12/1/2022,TKM,Sarawak,0,0,0,Turkmenistan
61069,12/1/2022,TKM,Selangor,56,38,18,Turkmenistan
61070,12/1/2022,TLS,Johor,12,7,5,Timor-Leste
61071,12/1/2022,TLS,Kedah,0,0,0,Timor-Leste
61072,12/1/2022,TLS,Perlis,0,0,0,Timor-Leste
61073,12/1/2022,TLS,Pulau Pinang,6,3,3,Timor-Leste
61074,12/1/2022,TLS,Sabah,1,0,1,Timor-Leste
61075,12/1/2022,TLS,Sarawak,2,0,2,Timor-Leste
61076,12/1/2022,TLS,Selangor,219,112,107,Timor-Leste
61077,12/1/2022,TON,Johor,0,0,0,Tonga
61078,12/1/2022,TON,Pulau Pinang,1,0,1,Tonga
61079,12/1/2022,TON,Sarawak,0,0,0,Tonga
61080,12/1/2022,TON,Selangor,6,6,0,Tonga
61081,12/1/2022,TTO,Johor,1,1,0,Trinidad and Tobago
61082,12/1/2022,TTO,Kedah,0,0,0,Trinidad and Tobago
61083,12/1/2022,TTO,Pahang,0,0,0,Trinidad and Tobago
61084,12/1/2022,TTO,Pulau Pinang,0,0,0,Trinidad and Tobago
61085,12/1/2022,TTO,Sabah,0,0,0,Trinidad and Tobago
61086,12/1/2022,TTO,Sarawak,5,4,1,Trinidad and Tobago
61087,12/1/2022,TTO,Selangor,27,15,12,Trinidad and Tobago
61088,12/1/2022,TUN,Johor,32,16,16,Tunisia
61089,12/1/2022,TUN,Kedah,2,1,1,Tunisia
61090,12/1/2022,TUN,Kelantan,0,0,0,Tunisia
61091,12/1/2022,TUN,Melaka,0,0,0,Tunisia
61092,12/1/2022,TUN,Perak,0,0,0,Tunisia
61093,12/1/2022,TUN,Perlis,0,0,0,Tunisia
61094,12/1/2022,TUN,Pulau Pinang,4,3,1,Tunisia
61095,12/1/2022,TUN,Sabah,1,1,0,Tunisia
61096,12/1/2022,TUN,Sarawak,1,1,0,Tunisia
61097,12/1/2022,TUN,Selangor,286,148,138,Tunisia
61098,12/1/2022,TUN,W.P. Labuan,0,0,0,Tunisia
61099,12/1/2022,TUR,Johor,198,124,74,Turkey
61100,12/1/2022,TUR,Kedah,27,17,10,Turkey
61101,12/1/2022,TUR,Kelantan,2,1,1,Turkey
61102,12/1/2022,TUR,Melaka,0,0,0,Turkey
61103,12/1/2022,TUR,Negeri Sembilan,0,0,0,Turkey
61104,12/1/2022,TUR,Pahang,0,0,0,Turkey
61105,12/1/2022,TUR,Perak,1,1,0,Turkey
61106,12/1/2022,TUR,Perlis,10,8,2,Turkey
61107,12/1/2022,TUR,Pulau Pinang,30,18,12,Turkey
61108,12/1/2022,TUR,Sabah,5,4,1,Turkey
61109,12/1/2022,TUR,Sarawak,35,22,13,Turkey
61110,12/1/2022,TUR,Selangor,888,625,263,Turkey
61111,12/1/2022,TUR,W.P. Labuan,0,0,0,Turkey
61112,12/1/2022,TUV,Selangor,0,0,0,Tuvalu
61113,12/1/2022,TWN,Johor,2844,1176,1668,Taiwan
61114,12/1/2022,TWN,Kedah,73,37,36,Taiwan
61115,12/1/2022,TWN,Kelantan,1,0,1,Taiwan
61116,12/1/2022,TWN,Melaka,0,0,0,Taiwan
61117,12/1/2022,TWN,Negeri Sembilan,0,0,0,Taiwan
61118,12/1/2022,TWN,Pahang,4,2,2,Taiwan
61119,12/1/2022,TWN,Perak,35,18,17,Taiwan
61120,12/1/2022,TWN,Perlis,12,6,6,Taiwan
61121,12/1/2022,TWN,Pulau Pinang,1388,789,599,Taiwan
61122,12/1/2022,TWN,Sabah,429,216,213,Taiwan
61123,12/1/2022,TWN,Sarawak,233,105,128,Taiwan
61124,12/1/2022,TWN,Selangor,5564,3004,2560,Taiwan
61125,12/1/2022,TWN,W.P. Labuan,3,1,2,Taiwan
61126,12/1/2022,TZA,Johor,42,22,20,"Tanzania, United Republic of"
61127,12/1/2022,TZA,Kedah,0,0,0,"Tanzania, United Republic of"
61128,12/1/2022,TZA,Perak,0,0,0,"Tanzania, United Republic of"
61129,12/1/2022,TZA,Perlis,0,0,0,"Tanzania, United Republic of"
61130,12/1/2022,TZA,Pulau Pinang,0,0,0,"Tanzania, United Republic of"
61131,12/1/2022,TZA,Sabah,3,2,1,"Tanzania, United Republic of"
61132,12/1/2022,TZA,Sarawak,3,3,0,"Tanzania, United Republic of"
61133,12/1/2022,TZA,Selangor,154,67,87,"Tanzania, United Republic of"
61134,12/1/2022,UGA,Johor,13,7,6,Uganda
61135,12/1/2022,UGA,Kedah,7,3,4,Uganda
61136,12/1/2022,UGA,Perak,0,0,0,Uganda
61137,12/1/2022,UGA,Perlis,1,1,0,Uganda
61138,12/1/2022,UGA,Pulau Pinang,0,0,0,Uganda
61139,12/1/2022,UGA,Sabah,2,1,1,Uganda
61140,12/1/2022,UGA,Sarawak,0,0,0,Uganda
61141,12/1/2022,UGA,Selangor,114,52,62,Uganda
61142,12/1/2022,UKR,Johor,100,49,51,Ukraine
61143,12/1/2022,UKR,Kedah,35,15,20,Ukraine
61144,12/1/2022,UKR,Kelantan,6,2,4,Ukraine
61145,12/1/2022,UKR,Melaka,6,6,0,Ukraine
61146,12/1/2022,UKR,Negeri Sembilan,0,0,0,Ukraine
61147,12/1/2022,UKR,Pahang,3,0,3,Ukraine
61148,12/1/2022,UKR,Perak,1,0,1,Ukraine
61149,12/1/2022,UKR,Perlis,32,10,22,Ukraine
61150,12/1/2022,UKR,Pulau Pinang,26,9,17,Ukraine
61151,12/1/2022,UKR,Sabah,3,2,1,Ukraine
61152,12/1/2022,UKR,Sarawak,6,3,3,Ukraine
61153,12/1/2022,UKR,Selangor,728,371,357,Ukraine
61154,12/1/2022,UKR,W.P. Labuan,1,0,1,Ukraine
61155,12/1/2022,URY,Johor,5,2,3,Uruguay
61156,12/1/2022,URY,Kedah,6,3,3,Uruguay
61157,12/1/2022,URY,Kelantan,0,0,0,Uruguay
61158,12/1/2022,URY,Perak,0,0,0,Uruguay
61159,12/1/2022,URY,Perlis,0,0,0,Uruguay
61160,12/1/2022,URY,Pulau Pinang,0,0,0,Uruguay
61161,12/1/2022,URY,Sabah,1,1,0,Uruguay
61162,12/1/2022,URY,Sarawak,0,0,0,Uruguay
61163,12/1/2022,URY,Selangor,37,20,17,Uruguay
61164,12/1/2022,URY,W.P. Labuan,0,0,0,Uruguay
61165,12/1/2022,USA,Johor,3784,2252,1532,United States Of America
61166,12/1/2022,USA,Kedah,430,238,192,United States Of America
61167,12/1/2022,USA,Kelantan,5,4,1,United States Of America
61168,12/1/2022,USA,Melaka,2,2,0,United States Of America
61169,12/1/2022,USA,Negeri Sembilan,1,1,0,United States Of America
61170,12/1/2022,USA,Pahang,5,3,2,United States Of America
61171,12/1/2022,USA,Perak,140,79,61,United States Of America
61172,12/1/2022,USA,Perlis,78,48,30,United States Of America
61173,12/1/2022,USA,Pulau Pinang,1698,991,707,United States Of America
61174,12/1/2022,USA,Sabah,348,203,145,United States Of America
61175,12/1/2022,USA,Sarawak,326,177,149,United States Of America
61176,12/1/2022,USA,Selangor,12311,7090,5221,United States Of America
61177,12/1/2022,USA,Terengganu,0,0,0,United States Of America
61178,12/1/2022,USA,W.P. Labuan,9,8,1,United States Of America
61179,12/1/2022,UZB,Johor,95,75,20,Uzbekistan
61180,12/1/2022,UZB,Kedah,39,18,21,Uzbekistan
61181,12/1/2022,UZB,Kelantan,0,0,0,Uzbekistan
61182,12/1/2022,UZB,Perak,0,0,0,Uzbekistan
61183,12/1/2022,UZB,Perlis,5,3,2,Uzbekistan
61184,12/1/2022,UZB,Pulau Pinang,15,5,10,Uzbekistan
61185,12/1/2022,UZB,Sabah,13,7,6,Uzbekistan
61186,12/1/2022,UZB,Sarawak,1,0,1,Uzbekistan
61187,12/1/2022,UZB,Selangor,1492,873,619,Uzbekistan
61188,12/1/2022,VAT,Johor,1,1,0,Holy See (Vatican City State)
61189,12/1/2022,VAT,Sarawak,1,1,0,Holy See (Vatican City State)
61190,12/1/2022,VAT,Selangor,0,0,0,Holy See (Vatican City State)
61191,12/1/2022,VCT,Johor,0,0,0,Saint Vincent and the Grenadines
61192,12/1/2022,VCT,Kedah,0,0,0,Saint Vincent and the Grenadines
61193,12/1/2022,VCT,Pulau Pinang,0,0,0,Saint Vincent and the Grenadines
61194,12/1/2022,VCT,Sarawak,0,0,0,Saint Vincent and the Grenadines
61195,12/1/2022,VCT,Selangor,1,1,0,Saint Vincent and the Grenadines
61196,12/1/2022,VEN,Johor,16,8,8,Venezuela
61197,12/1/2022,VEN,Kedah,1,0,1,Venezuela
61198,12/1/2022,VEN,Kelantan,0,0,0,Venezuela
61199,12/1/2022,VEN,Melaka,0,0,0,Venezuela
61200,12/1/2022,VEN,Perak,0,0,0,Venezuela
61201,12/1/2022,VEN,Perlis,0,0,0,Venezuela
61202,12/1/2022,VEN,Pulau Pinang,0,0,0,Venezuela
61203,12/1/2022,VEN,Sabah,0,0,0,Venezuela
61204,12/1/2022,VEN,Sarawak,11,6,5,Venezuela
61205,12/1/2022,VEN,Selangor,44,21,23,Venezuela
61206,12/1/2022,VEN,W.P. Labuan,0,0,0,Venezuela
61207,12/1/2022,VNM,Johor,9714,2706,7008,Vietnam
61208,12/1/2022,VNM,Kedah,216,21,195,Vietnam
61209,12/1/2022,VNM,Kelantan,6,4,2,Vietnam
61210,12/1/2022,VNM,Melaka,1,0,1,Vietnam
61211,12/1/2022,VNM,Negeri Sembilan,0,0,0,Vietnam
61212,12/1/2022,VNM,Pahang,1,1,0,Vietnam
61213,12/1/2022,VNM,Perak,100,10,90,Vietnam
61214,12/1/2022,VNM,Perlis,208,10,198,Vietnam
61215,12/1/2022,VNM,Pulau Pinang,998,235,763,Vietnam
61216,12/1/2022,VNM,Sabah,13,3,10,Vietnam
61217,12/1/2022,VNM,Sarawak,180,35,145,Vietnam
61218,12/1/2022,VNM,Selangor,10936,3507,7429,Vietnam
61219,12/1/2022,VNM,Terengganu,0,0,0,Vietnam
61220,12/1/2022,VNM,W.P. Labuan,2,1,1,Vietnam
61221,12/1/2022,VUT,Johor,23,13,10,Vanuatu
61222,12/1/2022,VUT,Kedah,0,0,0,Vanuatu
61223,12/1/2022,VUT,Pulau Pinang,5,2,3,Vanuatu
61224,12/1/2022,VUT,Sabah,3,2,1,Vanuatu
61225,12/1/2022,VUT,Sarawak,0,0,0,Vanuatu
61226,12/1/2022,VUT,Selangor,50,40,10,Vanuatu
61227,12/1/2022,WSM,Johor,0,0,0,Samoa
61228,12/1/2022,WSM,Sarawak,0,0,0,Samoa
61229,12/1/2022,WSM,Selangor,2,0,2,Samoa
61230,12/1/2022,YEM,Johor,33,25,8,Yemen
61231,12/1/2022,YEM,Kedah,1,1,0,Yemen
61232,12/1/2022,YEM,Kelantan,0,0,0,Yemen
61233,12/1/2022,YEM,Melaka,2,2,0,Yemen
61234,12/1/2022,YEM,Pahang,1,1,0,Yemen
61235,12/1/2022,YEM,Perak,0,0,0,Yemen
61236,12/1/2022,YEM,Perlis,3,3,0,Yemen
61237,12/1/2022,YEM,Pulau Pinang,1,1,0,Yemen
61238,12/1/2022,YEM,Sabah,2,2,0,Yemen
61239,12/1/2022,YEM,Sarawak,3,2,1,Yemen
61240,12/1/2022,YEM,Selangor,878,609,269,Yemen
61241,12/1/2022,YEM,W.P. Labuan,0,0,0,Yemen
61242,12/1/2022,ZAF,Johor,394,230,164,South Africa
61243,12/1/2022,ZAF,Kedah,41,22,19,South Africa
61244,12/1/2022,ZAF,Kelantan,0,0,0,South Africa
61245,12/1/2022,ZAF,Melaka,1,1,0,South Africa
61246,12/1/2022,ZAF,Pahang,0,0,0,South Africa
61247,12/1/2022,ZAF,Perak,1,1,0,South Africa
61248,12/1/2022,ZAF,Perlis,15,8,7,South Africa
61249,12/1/2022,ZAF,Pulau Pinang,61,31,30,South Africa
61250,12/1/2022,ZAF,Sabah,19,7,12,South Africa
61251,12/1/2022,ZAF,Sarawak,172,69,103,South Africa
61252,12/1/2022,ZAF,Selangor,1913,986,927,South Africa
61253,12/1/2022,ZAF,Terengganu,0,0,0,South Africa
61254,12/1/2022,ZAF,W.P. Labuan,1,0,1,South Africa
61255,12/1/2022,ZMB,Johor,1,0,1,Zambia
61256,12/1/2022,ZMB,Kedah,1,0,1,Zambia
61257,12/1/2022,ZMB,Perak,0,0,0,Zambia
61258,12/1/2022,ZMB,Perlis,0,0,0,Zambia
61259,12/1/2022,ZMB,Pulau Pinang,1,1,0,Zambia
61260,12/1/2022,ZMB,Sabah,1,1,0,Zambia
61261,12/1/2022,ZMB,Sarawak,0,0,0,Zambia
61262,12/1/2022,ZMB,Selangor,59,32,27,Zambia
61263,12/1/2022,ZWE,Johor,30,13,17,Zimbabwe
61264,12/1/2022,ZWE,Kedah,0,0,0,Zimbabwe
61265,12/1/2022,ZWE,Kelantan,0,0,0,Zimbabwe
61266,12/1/2022,ZWE,Perak,0,0,0,Zimbabwe
61267,12/1/2022,ZWE,Perlis,0,0,0,Zimbabwe
61268,12/1/2022,ZWE,Pulau Pinang,5,3,2,Zimbabwe
61269,12/1/2022,ZWE,Sabah,0,0,0,Zimbabwe
61270,12/1/2022,ZWE,Sarawak,1,1,0,Zimbabwe
61271,12/1/2022,ZWE,Selangor,135,49,86,Zimbabwe
61272,1/1/2023,ABW,Kedah,0,0,0,Aruba
61273,1/1/2023,ABW,Pulau Pinang,0,0,0,Aruba
61274,1/1/2023,AFG,Johor,3,3,0,Afghanistan
61275,1/1/2023,AFG,Kedah,0,0,0,Afghanistan
61276,1/1/2023,AFG,Perlis,0,0,0,Afghanistan
61277,1/1/2023,AFG,Pulau Pinang,0,0,0,Afghanistan
61278,1/1/2023,AFG,Sarawak,0,0,0,Afghanistan
61279,1/1/2023,AFG,Selangor,57,46,11,Afghanistan
61280,1/1/2023,AGO,Johor,0,0,0,Angola
61281,1/1/2023,AGO,Kedah,0,0,0,Angola
61282,1/1/2023,AGO,Sabah,0,0,0,Angola
61283,1/1/2023,AGO,Selangor,1,1,0,Angola
61284,1/1/2023,AIA,Selangor,0,0,0,Anguilla
61285,1/1/2023,ALB,Johor,21,13,8,Albania
61286,1/1/2023,ALB,Kedah,2,2,0,Albania
61287,1/1/2023,ALB,Perak,0,0,0,Albania
61288,1/1/2023,ALB,Perlis,0,0,0,Albania
61289,1/1/2023,ALB,Pulau Pinang,1,0,1,Albania
61290,1/1/2023,ALB,Sabah,0,0,0,Albania
61291,1/1/2023,ALB,Sarawak,1,1,0,Albania
61292,1/1/2023,ALB,Selangor,30,18,12,Albania
61293,1/1/2023,AND,Johor,0,0,0,Andorra
61294,1/1/2023,AND,Kedah,1,0,1,Andorra
61295,1/1/2023,AND,Perlis,0,0,0,Andorra
61296,1/1/2023,AND,Pulau Pinang,0,0,0,Andorra
61297,1/1/2023,AND,Selangor,2,1,1,Andorra
61298,1/1/2023,ANT,Selangor,0,0,0,Netherlands Antilles
61299,1/1/2023,ARE,Johor,10,8,2,United Arab Emirates
61300,1/1/2023,ARE,Kedah,0,0,0,United Arab Emirates
61301,1/1/2023,ARE,Kelantan,0,0,0,United Arab Emirates
61302,1/1/2023,ARE,Perak,0,0,0,United Arab Emirates
61303,1/1/2023,ARE,Perlis,0,0,0,United Arab Emirates
61304,1/1/2023,ARE,Pulau Pinang,1,1,0,United Arab Emirates
61305,1/1/2023,ARE,Sabah,0,0,0,United Arab Emirates
61306,1/1/2023,ARE,Sarawak,0,0,0,United Arab Emirates
61307,1/1/2023,ARE,Selangor,275,168,107,United Arab Emirates
61308,1/1/2023,ARG,Johor,90,54,36,Argentina
61309,1/1/2023,ARG,Kedah,163,82,81,Argentina
61310,1/1/2023,ARG,Kelantan,2,0,2,Argentina
61311,1/1/2023,ARG,Melaka,0,0,0,Argentina
61312,1/1/2023,ARG,Perak,0,0,0,Argentina
61313,1/1/2023,ARG,Perlis,1,0,1,Argentina
61314,1/1/2023,ARG,Pulau Pinang,10,6,4,Argentina
61315,1/1/2023,ARG,Sabah,0,0,0,Argentina
61316,1/1/2023,ARG,Sarawak,1,1,0,Argentina
61317,1/1/2023,ARG,Selangor,443,236,207,Argentina
61318,1/1/2023,ARG,W.P. Labuan,0,0,0,Argentina
61319,1/1/2023,ARM,Johor,6,3,3,Armenia
61320,1/1/2023,ARM,Kedah,0,0,0,Armenia
61321,1/1/2023,ARM,Kelantan,0,0,0,Armenia
61322,1/1/2023,ARM,Perak,0,0,0,Armenia
61323,1/1/2023,ARM,Perlis,0,0,0,Armenia
61324,1/1/2023,ARM,Pulau Pinang,1,0,1,Armenia
61325,1/1/2023,ARM,Sabah,0,0,0,Armenia
61326,1/1/2023,ARM,Sarawak,0,0,0,Armenia
61327,1/1/2023,ARM,Selangor,49,24,25,Armenia
61328,1/1/2023,ATA,Selangor,0,0,0,Antarctica
61329,1/1/2023,ATG,Johor,9,5,4,Antigua and Barbuda
61330,1/1/2023,ATG,Kedah,0,0,0,Antigua and Barbuda
61331,1/1/2023,ATG,Pulau Pinang,0,0,0,Antigua and Barbuda
61332,1/1/2023,ATG,Sarawak,0,0,0,Antigua and Barbuda
61333,1/1/2023,ATG,Selangor,13,7,6,Antigua and Barbuda
61334,1/1/2023,AUS,Johor,6459,3580,2879,Australia
61335,1/1/2023,AUS,Kedah,814,438,376,Australia
61336,1/1/2023,AUS,Kelantan,5,5,0,Australia
61337,1/1/2023,AUS,Melaka,0,0,0,Australia
61338,1/1/2023,AUS,Negeri Sembilan,0,0,0,Australia
61339,1/1/2023,AUS,Pahang,26,13,13,Australia
61340,1/1/2023,AUS,Perak,348,173,175,Australia
61341,1/1/2023,AUS,Perlis,122,75,47,Australia
61342,1/1/2023,AUS,Pulau Pinang,2518,1325,1193,Australia
61343,1/1/2023,AUS,Sabah,626,315,311,Australia
61344,1/1/2023,AUS,Sarawak,900,464,436,Australia
61345,1/1/2023,AUS,Selangor,31592,17342,14250,Australia
61346,1/1/2023,AUS,Terengganu,0,0,0,Australia
61347,1/1/2023,AUS,W.P. Labuan,11,11,0,Australia
61348,1/1/2023,AUT,Johor,142,86,56,Austria
61349,1/1/2023,AUT,Kedah,131,64,67,Austria
61350,1/1/2023,AUT,Kelantan,3,3,0,Austria
61351,1/1/2023,AUT,Melaka,0,0,0,Austria
61352,1/1/2023,AUT,Negeri Sembilan,0,0,0,Austria
61353,1/1/2023,AUT,Pahang,0,0,0,Austria
61354,1/1/2023,AUT,Perak,0,0,0,Austria
61355,1/1/2023,AUT,Perlis,19,14,5,Austria
61356,1/1/2023,AUT,Pulau Pinang,92,60,32,Austria
61357,1/1/2023,AUT,Sabah,9,7,2,Austria
61358,1/1/2023,AUT,Sarawak,10,7,3,Austria
61359,1/1/2023,AUT,Selangor,823,497,326,Austria
61360,1/1/2023,AUT,Terengganu,0,0,0,Austria
61361,1/1/2023,AUT,W.P. Labuan,1,1,0,Austria
61362,1/1/2023,AZE,Johor,4,2,2,Azerbaijan
61363,1/1/2023,AZE,Kedah,3,3,0,Azerbaijan
61364,1/1/2023,AZE,Kelantan,0,0,0,Azerbaijan
61365,1/1/2023,AZE,Melaka,0,0,0,Azerbaijan
61366,1/1/2023,AZE,Perlis,0,0,0,Azerbaijan
61367,1/1/2023,AZE,Pulau Pinang,0,0,0,Azerbaijan
61368,1/1/2023,AZE,Sabah,0,0,0,Azerbaijan
61369,1/1/2023,AZE,Sarawak,0,0,0,Azerbaijan
61370,1/1/2023,AZE,Selangor,79,43,36,Azerbaijan
61371,1/1/2023,AZE,W.P. Labuan,0,0,0,Azerbaijan
61372,1/1/2023,BDI,Pulau Pinang,0,0,0,Burundi
61373,1/1/2023,BDI,Sarawak,1,1,0,Burundi
61374,1/1/2023,BDI,Selangor,9,4,5,Burundi
61375,1/1/2023,BEL,Johor,181,120,61,Belgium
61376,1/1/2023,BEL,Kedah,88,51,37,Belgium
61377,1/1/2023,BEL,Kelantan,0,0,0,Belgium
61378,1/1/2023,BEL,Melaka,0,0,0,Belgium
61379,1/1/2023,BEL,Negeri Sembilan,0,0,0,Belgium
61380,1/1/2023,BEL,Pahang,0,0,0,Belgium
61381,1/1/2023,BEL,Perak,6,4,2,Belgium
61382,1/1/2023,BEL,Perlis,32,18,14,Belgium
61383,1/1/2023,BEL,Pulau Pinang,42,29,13,Belgium
61384,1/1/2023,BEL,Sabah,12,7,5,Belgium
61385,1/1/2023,BEL,Sarawak,18,11,7,Belgium
61386,1/1/2023,BEL,Selangor,751,490,261,Belgium
61387,1/1/2023,BEL,W.P. Labuan,0,0,0,Belgium
61388,1/1/2023,BEN,Johor,0,0,0,Benin
61389,1/1/2023,BEN,Kedah,0,0,0,Benin
61390,1/1/2023,BEN,Perak,0,0,0,Benin
61391,1/1/2023,BEN,Pulau Pinang,0,0,0,Benin
61392,1/1/2023,BEN,Sabah,0,0,0,Benin
61393,1/1/2023,BEN,Sarawak,0,0,0,Benin
61394,1/1/2023,BEN,Selangor,10,6,4,Benin
61395,1/1/2023,BFA,Perak,0,0,0,Burkina Faso
61396,1/1/2023,BFA,Pulau Pinang,1,1,0,Burkina Faso
61397,1/1/2023,BFA,Selangor,6,5,1,Burkina Faso
61398,1/1/2023,BGD,Johor,5102,4614,488,Bangladesh
61399,1/1/2023,BGD,Kedah,64,38,26,Bangladesh
61400,1/1/2023,BGD,Kelantan,1,1,0,Bangladesh
61401,1/1/2023,BGD,Melaka,0,0,0,Bangladesh
61402,1/1/2023,BGD,Negeri Sembilan,0,0,0,Bangladesh
61403,1/1/2023,BGD,Pahang,1,1,0,Bangladesh
61404,1/1/2023,BGD,Perak,0,0,0,Bangladesh
61405,1/1/2023,BGD,Perlis,1,1,0,Bangladesh
61406,1/1/2023,BGD,Pulau Pinang,831,820,11,Bangladesh
61407,1/1/2023,BGD,Sabah,3,2,1,Bangladesh
61408,1/1/2023,BGD,Sarawak,35,31,4,Bangladesh
61409,1/1/2023,BGD,Selangor,45792,43860,1932,Bangladesh
61410,1/1/2023,BGD,W.P. Labuan,8,5,3,Bangladesh
61411,1/1/2023,BGR,Johor,41,25,16,Bulgaria
61412,1/1/2023,BGR,Kedah,12,7,5,Bulgaria
61413,1/1/2023,BGR,Kelantan,0,0,0,Bulgaria
61414,1/1/2023,BGR,Pahang,0,0,0,Bulgaria
61415,1/1/2023,BGR,Perak,1,1,0,Bulgaria
61416,1/1/2023,BGR,Perlis,4,3,1,Bulgaria
61417,1/1/2023,BGR,Pulau Pinang,13,10,3,Bulgaria
61418,1/1/2023,BGR,Sabah,9,4,5,Bulgaria
61419,1/1/2023,BGR,Sarawak,4,3,1,Bulgaria
61420,1/1/2023,BGR,Selangor,204,120,84,Bulgaria
61421,1/1/2023,BGR,W.P. Labuan,0,0,0,Bulgaria
61422,1/1/2023,BHR,Johor,40,23,17,Bahrain
61423,1/1/2023,BHR,Kedah,1,0,1,Bahrain
61424,1/1/2023,BHR,Kelantan,2,1,1,Bahrain
61425,1/1/2023,BHR,Perlis,1,1,0,Bahrain
61426,1/1/2023,BHR,Pulau Pinang,2,1,1,Bahrain
61427,1/1/2023,BHR,Sabah,0,0,0,Bahrain
61428,1/1/2023,BHR,Sarawak,0,0,0,Bahrain
61429,1/1/2023,BHR,Selangor,193,116,77,Bahrain
61430,1/1/2023,BHS,Johor,2,2,0,Bahamas
61431,1/1/2023,BHS,Kedah,2,2,0,Bahamas
61432,1/1/2023,BHS,Perak,0,0,0,Bahamas
61433,1/1/2023,BHS,Sabah,0,0,0,Bahamas
61434,1/1/2023,BHS,Sarawak,0,0,0,Bahamas
61435,1/1/2023,BHS,Selangor,18,6,12,Bahamas
61436,1/1/2023,BIH,Johor,3,2,1,Bosnia and Herzegovina
61437,1/1/2023,BIH,Kedah,2,2,0,Bosnia and Herzegovina
61438,1/1/2023,BIH,Perlis,0,0,0,Bosnia and Herzegovina
61439,1/1/2023,BIH,Pulau Pinang,3,2,1,Bosnia and Herzegovina
61440,1/1/2023,BIH,Sabah,0,0,0,Bosnia and Herzegovina
61441,1/1/2023,BIH,Sarawak,0,0,0,Bosnia and Herzegovina
61442,1/1/2023,BIH,Selangor,70,39,31,Bosnia and Herzegovina
61443,1/1/2023,BLR,Johor,20,6,14,Belarus
61444,1/1/2023,BLR,Kedah,23,13,10,Belarus
61445,1/1/2023,BLR,Kelantan,4,2,2,Belarus
61446,1/1/2023,BLR,Pahang,0,0,0,Belarus
61447,1/1/2023,BLR,Perak,0,0,0,Belarus
61448,1/1/2023,BLR,Perlis,1,0,1,Belarus
61449,1/1/2023,BLR,Pulau Pinang,7,4,3,Belarus
61450,1/1/2023,BLR,Sabah,4,1,3,Belarus
61451,1/1/2023,BLR,Sarawak,10,4,6,Belarus
61452,1/1/2023,BLR,Selangor,487,226,261,Belarus
61453,1/1/2023,BLR,W.P. Labuan,0,0,0,Belarus
61454,1/1/2023,BLZ,Johor,2,0,2,Belize
61455,1/1/2023,BLZ,Pulau Pinang,0,0,0,Belize
61456,1/1/2023,BLZ,Sarawak,0,0,0,Belize
61457,1/1/2023,BLZ,Selangor,19,10,9,Belize
61458,1/1/2023,BMU,Selangor,0,0,0,Bermuda
61459,1/1/2023,BOL,Johor,6,4,2,Bolivia
61460,1/1/2023,BOL,Kedah,0,0,0,Bolivia
61461,1/1/2023,BOL,Melaka,1,1,0,Bolivia
61462,1/1/2023,BOL,Perak,0,0,0,Bolivia
61463,1/1/2023,BOL,Perlis,1,1,0,Bolivia
61464,1/1/2023,BOL,Pulau Pinang,1,1,0,Bolivia
61465,1/1/2023,BOL,Sabah,0,0,0,Bolivia
61466,1/1/2023,BOL,Sarawak,1,0,1,Bolivia
61467,1/1/2023,BOL,Selangor,39,23,16,Bolivia
61468,1/1/2023,BRA,Johor,260,147,113,Brazil
61469,1/1/2023,BRA,Kedah,102,53,49,Brazil
61470,1/1/2023,BRA,Kelantan,0,0,0,Brazil
61471,1/1/2023,BRA,Melaka,0,0,0,Brazil
61472,1/1/2023,BRA,Pahang,0,0,0,Brazil
61473,1/1/2023,BRA,Perak,0,0,0,Brazil
61474,1/1/2023,BRA,Perlis,12,7,5,Brazil
61475,1/1/2023,BRA,Pulau Pinang,26,16,10,Brazil
61476,1/1/2023,BRA,Sabah,3,3,0,Brazil
61477,1/1/2023,BRA,Sarawak,4,3,1,Brazil
61478,1/1/2023,BRA,Selangor,848,456,392,Brazil
61479,1/1/2023,BRA,W.P. Labuan,0,0,0,Brazil
61480,1/1/2023,BRB,Johor,0,0,0,Barbados
61481,1/1/2023,BRB,Kedah,1,1,0,Barbados
61482,1/1/2023,BRB,Perlis,0,0,0,Barbados
61483,1/1/2023,BRB,Pulau Pinang,0,0,0,Barbados
61484,1/1/2023,BRB,Selangor,10,4,6,Barbados
61485,1/1/2023,BRN,Johor,308,160,148,Brunei Darussalam
61486,1/1/2023,BRN,Kedah,17,8,9,Brunei Darussalam
61487,1/1/2023,BRN,Kelantan,1,1,0,Brunei Darussalam
61488,1/1/2023,BRN,Melaka,6,3,3,Brunei Darussalam
61489,1/1/2023,BRN,Pahang,0,0,0,Brunei Darussalam
61490,1/1/2023,BRN,Perak,2,1,1,Brunei Darussalam
61491,1/1/2023,BRN,Perlis,19,13,6,Brunei Darussalam
61492,1/1/2023,BRN,Pulau Pinang,10,2,8,Brunei Darussalam
61493,1/1/2023,BRN,Sabah,686,308,378,Brunei Darussalam
61494,1/1/2023,BRN,Sarawak,86761,47354,39407,Brunei Darussalam
61495,1/1/2023,BRN,Selangor,4105,2054,2051,Brunei Darussalam
61496,1/1/2023,BRN,W.P. Labuan,1210,846,364,Brunei Darussalam
61497,1/1/2023,BTN,Johor,10,5,5,Bhutan
61498,1/1/2023,BTN,Kedah,0,0,0,Bhutan
61499,1/1/2023,BTN,Perak,0,0,0,Bhutan
61500,1/1/2023,BTN,Perlis,2,1,1,Bhutan
61501,1/1/2023,BTN,Pulau Pinang,2,2,0,Bhutan
61502,1/1/2023,BTN,Sabah,0,0,0,Bhutan
61503,1/1/2023,BTN,Sarawak,0,0,0,Bhutan
61504,1/1/2023,BTN,Selangor,17,11,6,Bhutan
61505,1/1/2023,BWA,Johor,1,0,1,Botswana
61506,1/1/2023,BWA,Kedah,0,0,0,Botswana
61507,1/1/2023,BWA,Perlis,0,0,0,Botswana
61508,1/1/2023,BWA,Pulau Pinang,0,0,0,Botswana
61509,1/1/2023,BWA,Sabah,0,0,0,Botswana
61510,1/1/2023,BWA,Sarawak,0,0,0,Botswana
61511,1/1/2023,BWA,Selangor,17,8,9,Botswana
61512,1/1/2023,CAF,Kedah,0,0,0,Central African Republic
61513,1/1/2023,CAF,Selangor,0,0,0,Central African Republic
61514,1/1/2023,CAN,Johor,1444,814,630,Canada
61515,1/1/2023,CAN,Kedah,292,152,140,Canada
61516,1/1/2023,CAN,Kelantan,3,1,2,Canada
61517,1/1/2023,CAN,Melaka,1,1,0,Canada
61518,1/1/2023,CAN,Negeri Sembilan,0,0,0,Canada
61519,1/1/2023,CAN,Pahang,2,2,0,Canada
61520,1/1/2023,CAN,Perak,34,18,16,Canada
61521,1/1/2023,CAN,Perlis,78,48,30,Canada
61522,1/1/2023,CAN,Pulau Pinang,554,312,242,Canada
61523,1/1/2023,CAN,Sabah,169,76,93,Canada
61524,1/1/2023,CAN,Sarawak,396,223,173,Canada
61525,1/1/2023,CAN,Selangor,4335,2501,1834,Canada
61526,1/1/2023,CAN,Terengganu,0,0,0,Canada
61527,1/1/2023,CAN,W.P. Labuan,6,5,1,Canada
61528,1/1/2023,CCK,Selangor,0,0,0,Cocos (Keeling) Islands
61529,1/1/2023,CHE,Johor,322,200,122,Switzerland
61530,1/1/2023,CHE,Kedah,215,117,98,Switzerland
61531,1/1/2023,CHE,Kelantan,2,1,1,Switzerland
61532,1/1/2023,CHE,Melaka,0,0,0,Switzerland
61533,1/1/2023,CHE,Negeri Sembilan,0,0,0,Switzerland
61534,1/1/2023,CHE,Pahang,4,3,1,Switzerland
61535,1/1/2023,CHE,Perak,3,3,0,Switzerland
61536,1/1/2023,CHE,Perlis,45,29,16,Switzerland
61537,1/1/2023,CHE,Pulau Pinang,154,89,65,Switzerland
61538,1/1/2023,CHE,Sabah,19,11,8,Switzerland
61539,1/1/2023,CHE,Sarawak,20,11,9,Switzerland
61540,1/1/2023,CHE,Selangor,1109,651,458,Switzerland
61541,1/1/2023,CHE,W.P. Labuan,0,0,0,Switzerland
61542,1/1/2023,CHL,Johor,31,15,16,Chile
61543,1/1/2023,CHL,Kedah,30,17,13,Chile
61544,1/1/2023,CHL,Kelantan,0,0,0,Chile
61545,1/1/2023,CHL,Melaka,0,0,0,Chile
61546,1/1/2023,CHL,Pahang,0,0,0,Chile
61547,1/1/2023,CHL,Perak,0,0,0,Chile
61548,1/1/2023,CHL,Perlis,6,4,2,Chile
61549,1/1/2023,CHL,Pulau Pinang,7,6,1,Chile
61550,1/1/2023,CHL,Sabah,1,1,0,Chile
61551,1/1/2023,CHL,Sarawak,0,0,0,Chile
61552,1/1/2023,CHL,Selangor,167,83,84,Chile
61553,1/1/2023,CHN,Johor,22538,9459,13079,China
61554,1/1/2023,CHN,Kedah,549,243,306,China
61555,1/1/2023,CHN,Kelantan,17,7,10,China
61556,1/1/2023,CHN,Melaka,1,1,0,China
61557,1/1/2023,CHN,Pahang,17,8,9,China
61558,1/1/2023,CHN,Perak,109,40,69,China
61559,1/1/2023,CHN,Perlis,88,37,51,China
61560,1/1/2023,CHN,Pulau Pinang,2863,1375,1488,China
61561,1/1/2023,CHN,Sabah,1694,814,880,China
61562,1/1/2023,CHN,Sarawak,614,274,340,China
61563,1/1/2023,CHN,Selangor,28763,14551,14212,China
61564,1/1/2023,CHN,Terengganu,0,0,0,China
61565,1/1/2023,CHN,W.P. Labuan,37,34,3,China
61566,1/1/2023,CIV,Johor,0,0,0,C��te d'Iv
61567,1/1/2023,CIV,Kedah,0,0,0,C��te d'Iv
61568,1/1/2023,CIV,Pulau Pinang,0,0,0,C��te d'Iv
61569,1/1/2023,CIV,Sabah,0,0,0,C��te d'Iv
61570,1/1/2023,CIV,Sarawak,0,0,0,C��te d'Iv
61571,1/1/2023,CIV,Selangor,8,6,2,C��te d'Iv
61572,1/1/2023,CMR,Johor,4,4,0,Cameroon
61573,1/1/2023,CMR,Kedah,0,0,0,Cameroon
61574,1/1/2023,CMR,Pulau Pinang,0,0,0,Cameroon
61575,1/1/2023,CMR,Sabah,0,0,0,Cameroon
61576,1/1/2023,CMR,Sarawak,0,0,0,Cameroon
61577,1/1/2023,CMR,Selangor,19,14,5,Cameroon
61578,1/1/2023,COD,Johor,0,0,0,"Congo, the Democratic Republic of the"
61579,1/1/2023,COD,Pulau Pinang,0,0,0,"Congo, the Democratic Republic of the"
61580,1/1/2023,COD,Sarawak,2,1,1,"Congo, the Democratic Republic of the"
61581,1/1/2023,COD,Selangor,12,8,4,"Congo, the Democratic Republic of the"
61582,1/1/2023,COG,Johor,0,0,0,Congo
61583,1/1/2023,COG,Kedah,0,0,0,Congo
61584,1/1/2023,COG,Selangor,0,0,0,Congo
61585,1/1/2023,COK,Selangor,0,0,0,Cook Islands
61586,1/1/2023,COL,Johor,35,14,21,Colombia
61587,1/1/2023,COL,Kedah,0,0,0,Colombia
61588,1/1/2023,COL,Perak,1,1,0,Colombia
61589,1/1/2023,COL,Pulau Pinang,1,1,0,Colombia
61590,1/1/2023,COL,Sabah,0,0,0,Colombia
61591,1/1/2023,COL,Sarawak,1,1,0,Colombia
61592,1/1/2023,COL,Selangor,186,99,87,Colombia
61593,1/1/2023,COL,W.P. Labuan,0,0,0,Colombia
61594,1/1/2023,COM,Johor,1,0,1,Comoros
61595,1/1/2023,COM,Kedah,0,0,0,Comoros
61596,1/1/2023,COM,Selangor,15,11,4,Comoros
61597,1/1/2023,CPV,Johor,0,0,0,Cape Verde
61598,1/1/2023,CPV,Kedah,2,2,0,Cape Verde
61599,1/1/2023,CPV,Pulau Pinang,0,0,0,Cape Verde
61600,1/1/2023,CPV,Sabah,0,0,0,Cape Verde
61601,1/1/2023,CPV,Selangor,3,0,3,Cape Verde
61602,1/1/2023,CRI,Johor,15,9,6,Costa Rica
61603,1/1/2023,CRI,Kedah,1,0,1,Costa Rica
61604,1/1/2023,CRI,Perak,0,0,0,Costa Rica
61605,1/1/2023,CRI,Perlis,0,0,0,Costa Rica
61606,1/1/2023,CRI,Pulau Pinang,9,4,5,Costa Rica
61607,1/1/2023,CRI,Sabah,0,0,0,Costa Rica
61608,1/1/2023,CRI,Sarawak,0,0,0,Costa Rica
61609,1/1/2023,CRI,Selangor,48,26,22,Costa Rica
61610,1/1/2023,CUB,Johor,3,2,1,Cuba
61611,1/1/2023,CUB,Kedah,1,0,1,Cuba
61612,1/1/2023,CUB,Perlis,0,0,0,Cuba
61613,1/1/2023,CUB,Pulau Pinang,0,0,0,Cuba
61614,1/1/2023,CUB,Sabah,0,0,0,Cuba
61615,1/1/2023,CUB,Sarawak,0,0,0,Cuba
61616,1/1/2023,CUB,Selangor,19,5,14,Cuba
61617,1/1/2023,CYP,Johor,10,5,5,Cyprus
61618,1/1/2023,CYP,Kedah,5,1,4,Cyprus
61619,1/1/2023,CYP,Perak,0,0,0,Cyprus
61620,1/1/2023,CYP,Perlis,0,0,0,Cyprus
61621,1/1/2023,CYP,Pulau Pinang,4,3,1,Cyprus
61622,1/1/2023,CYP,Sabah,0,0,0,Cyprus
61623,1/1/2023,CYP,Sarawak,6,0,6,Cyprus
61624,1/1/2023,CYP,Selangor,47,33,14,Cyprus
61625,1/1/2023,CZE,Johor,93,53,40,Czech Republic
61626,1/1/2023,CZE,Kedah,112,68,44,Czech Republic
61627,1/1/2023,CZE,Kelantan,0,0,0,Czech Republic
61628,1/1/2023,CZE,Melaka,0,0,0,Czech Republic
61629,1/1/2023,CZE,Negeri Sembilan,0,0,0,Czech Republic
61630,1/1/2023,CZE,Perak,0,0,0,Czech Republic
61631,1/1/2023,CZE,Perlis,16,9,7,Czech Republic
61632,1/1/2023,CZE,Pulau Pinang,35,19,16,Czech Republic
61633,1/1/2023,CZE,Sabah,13,9,4,Czech Republic
61634,1/1/2023,CZE,Sarawak,6,4,2,Czech Republic
61635,1/1/2023,CZE,Selangor,515,285,230,Czech Republic
61636,1/1/2023,CZE,W.P. Labuan,0,0,0,Czech Republic
61637,1/1/2023,DEU,Johor,2128,1312,816,Germany
61638,1/1/2023,DEU,Kedah,1174,630,544,Germany
61639,1/1/2023,DEU,Kelantan,7,6,1,Germany
61640,1/1/2023,DEU,Melaka,5,3,2,Germany
61641,1/1/2023,DEU,Negeri Sembilan,0,0,0,Germany
61642,1/1/2023,DEU,Pahang,3,2,1,Germany
61643,1/1/2023,DEU,Perak,26,16,10,Germany
61644,1/1/2023,DEU,Perlis,241,154,87,Germany
61645,1/1/2023,DEU,Pulau Pinang,699,447,252,Germany
61646,1/1/2023,DEU,Sabah,115,73,42,Germany
61647,1/1/2023,DEU,Sarawak,188,114,74,Germany
61648,1/1/2023,DEU,Selangor,7921,4583,3338,Germany
61649,1/1/2023,DEU,Terengganu,0,0,0,Germany
61650,1/1/2023,DEU,W.P. Labuan,5,3,2,Germany
61651,1/1/2023,DJI,Johor,0,0,0,Djibouti
61652,1/1/2023,DJI,Selangor,15,8,7,Djibouti
61653,1/1/2023,DMA,Johor,3,3,0,Dominica
61654,1/1/2023,DMA,Kedah,1,1,0,Dominica
61655,1/1/2023,DMA,Pulau Pinang,0,0,0,Dominica
61656,1/1/2023,DMA,Sabah,0,0,0,Dominica
61657,1/1/2023,DMA,Sarawak,0,0,0,Dominica
61658,1/1/2023,DMA,Selangor,35,25,10,Dominica
61659,1/1/2023,DMA,W.P. Labuan,0,0,0,Dominica
61660,1/1/2023,DNK,Johor,278,187,91,Denmark
61661,1/1/2023,DNK,Kedah,231,119,112,Denmark
61662,1/1/2023,DNK,Kelantan,5,4,1,Denmark
61663,1/1/2023,DNK,Melaka,0,0,0,Denmark
61664,1/1/2023,DNK,Negeri Sembilan,0,0,0,Denmark
61665,1/1/2023,DNK,Pahang,0,0,0,Denmark
61666,1/1/2023,DNK,Perak,1,1,0,Denmark
61667,1/1/2023,DNK,Perlis,33,26,7,Denmark
61668,1/1/2023,DNK,Pulau Pinang,85,56,29,Denmark
61669,1/1/2023,DNK,Sabah,52,21,31,Denmark
61670,1/1/2023,DNK,Sarawak,13,8,5,Denmark
61671,1/1/2023,DNK,Selangor,1016,562,454,Denmark
61672,1/1/2023,DNK,W.P. Labuan,0,0,0,Denmark
61673,1/1/2023,DOM,Johor,2,1,1,Dominican Republic
61674,1/1/2023,DOM,Kedah,0,0,0,Dominican Republic
61675,1/1/2023,DOM,Perak,0,0,0,Dominican Republic
61676,1/1/2023,DOM,Perlis,0,0,0,Dominican Republic
61677,1/1/2023,DOM,Pulau Pinang,0,0,0,Dominican Republic
61678,1/1/2023,DOM,Sabah,0,0,0,Dominican Republic
61679,1/1/2023,DOM,Sarawak,0,0,0,Dominican Republic
61680,1/1/2023,DOM,Selangor,12,8,4,Dominican Republic
61681,1/1/2023,DZA,Johor,13,12,1,Algeria
61682,1/1/2023,DZA,Kedah,3,3,0,Algeria
61683,1/1/2023,DZA,Kelantan,0,0,0,Algeria
61684,1/1/2023,DZA,Melaka,0,0,0,Algeria
61685,1/1/2023,DZA,Perak,0,0,0,Algeria
61686,1/1/2023,DZA,Perlis,1,1,0,Algeria
61687,1/1/2023,DZA,Pulau Pinang,2,2,0,Algeria
61688,1/1/2023,DZA,Sabah,0,0,0,Algeria
61689,1/1/2023,DZA,Sarawak,12,10,2,Algeria
61690,1/1/2023,DZA,Selangor,469,308,161,Algeria
61691,1/1/2023,DZA,W.P. Labuan,0,0,0,Algeria
61692,1/1/2023,ECU,Johor,6,1,5,Ecuador
61693,1/1/2023,ECU,Kedah,0,0,0,Ecuador
61694,1/1/2023,ECU,Perak,0,0,0,Ecuador
61695,1/1/2023,ECU,Perlis,0,0,0,Ecuador
61696,1/1/2023,ECU,Pulau Pinang,1,1,0,Ecuador
61697,1/1/2023,ECU,Sabah,1,0,1,Ecuador
61698,1/1/2023,ECU,Sarawak,0,0,0,Ecuador
61699,1/1/2023,ECU,Selangor,30,14,16,Ecuador
61700,1/1/2023,EGY,Johor,168,133,35,Egypt
61701,1/1/2023,EGY,Kedah,3,3,0,Egypt
61702,1/1/2023,EGY,Kelantan,0,0,0,Egypt
61703,1/1/2023,EGY,Melaka,1,1,0,Egypt
61704,1/1/2023,EGY,Pahang,0,0,0,Egypt
61705,1/1/2023,EGY,Perak,0,0,0,Egypt
61706,1/1/2023,EGY,Perlis,2,1,1,Egypt
61707,1/1/2023,EGY,Pulau Pinang,10,8,2,Egypt
61708,1/1/2023,EGY,Sabah,6,6,0,Egypt
61709,1/1/2023,EGY,Sarawak,134,89,45,Egypt
61710,1/1/2023,EGY,Selangor,1345,903,442,Egypt
61711,1/1/2023,EGY,Terengganu,0,0,0,Egypt
61712,1/1/2023,EGY,W.P. Labuan,0,0,0,Egypt
61713,1/1/2023,ERI,Johor,0,0,0,Eritrea
61714,1/1/2023,ERI,Pulau Pinang,0,0,0,Eritrea
61715,1/1/2023,ERI,Sabah,0,0,0,Eritrea
61716,1/1/2023,ERI,Selangor,12,7,5,Eritrea
61717,1/1/2023,ESP,Johor,396,240,156,Spain
61718,1/1/2023,ESP,Kedah,300,158,142,Spain
61719,1/1/2023,ESP,Kelantan,5,2,3,Spain
61720,1/1/2023,ESP,Melaka,0,0,0,Spain
61721,1/1/2023,ESP,Negeri Sembilan,1,1,0,Spain
61722,1/1/2023,ESP,Pahang,0,0,0,Spain
61723,1/1/2023,ESP,Perak,1,1,0,Spain
61724,1/1/2023,ESP,Perlis,43,33,10,Spain
61725,1/1/2023,ESP,Pulau Pinang,60,40,20,Spain
61726,1/1/2023,ESP,Sabah,35,21,14,Spain
61727,1/1/2023,ESP,Sarawak,22,14,8,Spain
61728,1/1/2023,ESP,Selangor,1744,1026,718,Spain
61729,1/1/2023,ESP,W.P. Labuan,0,0,0,Spain
61730,1/1/2023,EST,Johor,42,23,19,Estonia
61731,1/1/2023,EST,Kedah,54,26,28,Estonia
61732,1/1/2023,EST,Kelantan,0,0,0,Estonia
61733,1/1/2023,EST,Pahang,0,0,0,Estonia
61734,1/1/2023,EST,Perak,0,0,0,Estonia
61735,1/1/2023,EST,Perlis,5,3,2,Estonia
61736,1/1/2023,EST,Pulau Pinang,26,12,14,Estonia
61737,1/1/2023,EST,Sabah,9,4,5,Estonia
61738,1/1/2023,EST,Sarawak,2,1,1,Estonia
61739,1/1/2023,EST,Selangor,205,108,97,Estonia
61740,1/1/2023,EST,W.P. Labuan,0,0,0,Estonia
61741,1/1/2023,ETH,Johor,2,2,0,Ethiopia
61742,1/1/2023,ETH,Kedah,0,0,0,Ethiopia
61743,1/1/2023,ETH,Pulau Pinang,0,0,0,Ethiopia
61744,1/1/2023,ETH,Sarawak,0,0,0,Ethiopia
61745,1/1/2023,ETH,Selangor,34,21,13,Ethiopia
61746,1/1/2023,FIN,Johor,222,140,82,Finland
61747,1/1/2023,FIN,Kedah,158,85,73,Finland
61748,1/1/2023,FIN,Kelantan,2,0,2,Finland
61749,1/1/2023,FIN,Melaka,0,0,0,Finland
61750,1/1/2023,FIN,Negeri Sembilan,0,0,0,Finland
61751,1/1/2023,FIN,Pahang,0,0,0,Finland
61752,1/1/2023,FIN,Perak,3,2,1,Finland
61753,1/1/2023,FIN,Perlis,16,13,3,Finland
61754,1/1/2023,FIN,Pulau Pinang,61,38,23,Finland
61755,1/1/2023,FIN,Sabah,24,13,11,Finland
61756,1/1/2023,FIN,Sarawak,12,5,7,Finland
61757,1/1/2023,FIN,Selangor,747,428,319,Finland
61758,1/1/2023,FIN,W.P. Labuan,0,0,0,Finland
61759,1/1/2023,FJI,Johor,41,16,25,Fiji
61760,1/1/2023,FJI,Kedah,0,0,0,Fiji
61761,1/1/2023,FJI,Kelantan,0,0,0,Fiji
61762,1/1/2023,FJI,Perak,1,1,0,Fiji
61763,1/1/2023,FJI,Perlis,1,0,1,Fiji
61764,1/1/2023,FJI,Pulau Pinang,3,2,1,Fiji
61765,1/1/2023,FJI,Sabah,2,2,0,Fiji
61766,1/1/2023,FJI,Sarawak,0,0,0,Fiji
61767,1/1/2023,FJI,Selangor,91,41,50,Fiji
61768,1/1/2023,FRA,Johor,1595,988,607,France
61769,1/1/2023,FRA,Kedah,707,381,326,France
61770,1/1/2023,FRA,Kelantan,11,7,4,France
61771,1/1/2023,FRA,Melaka,4,2,2,France
61772,1/1/2023,FRA,Negeri Sembilan,0,0,0,France
61773,1/1/2023,FRA,Pahang,10,7,3,France
61774,1/1/2023,FRA,Perak,15,10,5,France
61775,1/1/2023,FRA,Perlis,145,93,52,France
61776,1/1/2023,FRA,Pulau Pinang,324,216,108,France
61777,1/1/2023,FRA,Sabah,109,59,50,France
61778,1/1/2023,FRA,Sarawak,49,35,14,France
61779,1/1/2023,FRA,Selangor,6034,3593,2441,France
61780,1/1/2023,FRA,Terengganu,0,0,0,France
61781,1/1/2023,FRA,W.P. Labuan,1,1,0,France
61782,1/1/2023,FSM,Johor,0,0,0,"Micronesia, Federated States of"
61783,1/1/2023,FSM,Pulau Pinang,0,0,0,"Micronesia, Federated States of"
61784,1/1/2023,FSM,Selangor,0,0,0,"Micronesia, Federated States of"
61785,1/1/2023,GAB,Johor,1,1,0,Gabon
61786,1/1/2023,GAB,Pulau Pinang,0,0,0,Gabon
61787,1/1/2023,GAB,Sarawak,0,0,0,Gabon
61788,1/1/2023,GAB,Selangor,10,6,4,Gabon
61789,1/1/2023,GBR,Johor,3944,2471,1473,United Kingdom
61790,1/1/2023,GBR,Kedah,1689,931,758,United Kingdom
61791,1/1/2023,GBR,Kelantan,10,7,3,United Kingdom
61792,1/1/2023,GBR,Melaka,8,6,2,United Kingdom
61793,1/1/2023,GBR,Negeri Sembilan,1,1,0,United Kingdom
61794,1/1/2023,GBR,Pahang,5,5,0,United Kingdom
61795,1/1/2023,GBR,Perak,73,44,29,United Kingdom
61796,1/1/2023,GBR,Perlis,244,158,86,United Kingdom
61797,1/1/2023,GBR,Pulau Pinang,1568,919,649,United Kingdom
61798,1/1/2023,GBR,Sabah,476,278,198,United Kingdom
61799,1/1/2023,GBR,Sarawak,1028,646,382,United Kingdom
61800,1/1/2023,GBR,Selangor,15954,9588,6366,United Kingdom
61801,1/1/2023,GBR,Terengganu,0,0,0,United Kingdom
61802,1/1/2023,GBR,W.P. Labuan,40,32,8,United Kingdom
61803,1/1/2023,GEO,Johor,6,6,0,Georgia
61804,1/1/2023,GEO,Kedah,1,1,0,Georgia
61805,1/1/2023,GEO,Melaka,0,0,0,Georgia
61806,1/1/2023,GEO,Perak,0,0,0,Georgia
61807,1/1/2023,GEO,Perlis,0,0,0,Georgia
61808,1/1/2023,GEO,Pulau Pinang,1,0,1,Georgia
61809,1/1/2023,GEO,Sabah,0,0,0,Georgia
61810,1/1/2023,GEO,Sarawak,0,0,0,Georgia
61811,1/1/2023,GEO,Selangor,49,27,22,Georgia
61812,1/1/2023,GHA,Johor,4,4,0,Ghana
61813,1/1/2023,GHA,Kedah,0,0,0,Ghana
61814,1/1/2023,GHA,Kelantan,0,0,0,Ghana
61815,1/1/2023,GHA,Pulau Pinang,2,1,1,Ghana
61816,1/1/2023,GHA,Sabah,0,0,0,Ghana
61817,1/1/2023,GHA,Sarawak,2,1,1,Ghana
61818,1/1/2023,GHA,Selangor,53,45,8,Ghana
61819,1/1/2023,GIB,Johor,0,0,0,Gibraltar
61820,1/1/2023,GIB,Sarawak,0,0,0,Gibraltar
61821,1/1/2023,GIN,Johor,4,3,1,Guinea
61822,1/1/2023,GIN,Kedah,1,1,0,Guinea
61823,1/1/2023,GIN,Kelantan,0,0,0,Guinea
61824,1/1/2023,GIN,Perlis,0,0,0,Guinea
61825,1/1/2023,GIN,Pulau Pinang,0,0,0,Guinea
61826,1/1/2023,GIN,Sabah,0,0,0,Guinea
61827,1/1/2023,GIN,Sarawak,0,0,0,Guinea
61828,1/1/2023,GIN,Selangor,49,35,14,Guinea
61829,1/1/2023,GLP,Selangor,0,0,0,Guadeloupe
61830,1/1/2023,GMB,Johor,0,0,0,Gambia
61831,1/1/2023,GMB,Kedah,0,0,0,Gambia
61832,1/1/2023,GMB,Kelantan,0,0,0,Gambia
61833,1/1/2023,GMB,Pulau Pinang,1,1,0,Gambia
61834,1/1/2023,GMB,Sabah,0,0,0,Gambia
61835,1/1/2023,GMB,Sarawak,0,0,0,Gambia
61836,1/1/2023,GMB,Selangor,11,8,3,Gambia
61837,1/1/2023,GNB,Johor,0,0,0,Guinea-Bissau
61838,1/1/2023,GNB,Selangor,0,0,0,Guinea-Bissau
61839,1/1/2023,GNQ,Johor,0,0,0,Equatorial Guinea
61840,1/1/2023,GNQ,Selangor,4,1,3,Equatorial Guinea
61841,1/1/2023,GRC,Johor,60,41,19,Greece
61842,1/1/2023,GRC,Kedah,19,10,9,Greece
61843,1/1/2023,GRC,Kelantan,0,0,0,Greece
61844,1/1/2023,GRC,Melaka,0,0,0,Greece
61845,1/1/2023,GRC,Negeri Sembilan,1,1,0,Greece
61846,1/1/2023,GRC,Pahang,0,0,0,Greece
61847,1/1/2023,GRC,Perak,0,0,0,Greece
61848,1/1/2023,GRC,Perlis,1,1,0,Greece
61849,1/1/2023,GRC,Pulau Pinang,6,5,1,Greece
61850,1/1/2023,GRC,Sabah,2,2,0,Greece
61851,1/1/2023,GRC,Sarawak,1,0,1,Greece
61852,1/1/2023,GRC,Selangor,219,161,58,Greece
61853,1/1/2023,GRD,Johor,15,8,7,Grenada
61854,1/1/2023,GRD,Kedah,0,0,0,Grenada
61855,1/1/2023,GRD,Pulau Pinang,0,0,0,Grenada
61856,1/1/2023,GRD,Sabah,0,0,0,Grenada
61857,1/1/2023,GRD,Sarawak,0,0,0,Grenada
61858,1/1/2023,GRD,Selangor,17,10,7,Grenada
61859,1/1/2023,GRL,Johor,0,0,0,Greenland
61860,1/1/2023,GRL,Selangor,0,0,0,Greenland
61861,1/1/2023,GTM,Johor,1,1,0,Guatemala
61862,1/1/2023,GTM,Kedah,1,0,1,Guatemala
61863,1/1/2023,GTM,Pahang,0,0,0,Guatemala
61864,1/1/2023,GTM,Perak,0,0,0,Guatemala
61865,1/1/2023,GTM,Pulau Pinang,3,2,1,Guatemala
61866,1/1/2023,GTM,Sabah,0,0,0,Guatemala
61867,1/1/2023,GTM,Sarawak,0,0,0,Guatemala
61868,1/1/2023,GTM,Selangor,15,8,7,Guatemala
61869,1/1/2023,GTM,W.P. Labuan,0,0,0,Guatemala
61870,1/1/2023,GUY,Johor,0,0,0,Guyana
61871,1/1/2023,GUY,Kedah,0,0,0,Guyana
61872,1/1/2023,GUY,Pulau Pinang,0,0,0,Guyana
61873,1/1/2023,GUY,Sarawak,0,0,0,Guyana
61874,1/1/2023,GUY,Selangor,0,0,0,Guyana
61875,1/1/2023,HKG,Johor,5,2,3,Hong Kong
61876,1/1/2023,HKG,Kedah,2,1,1,Hong Kong
61877,1/1/2023,HKG,Kelantan,0,0,0,Hong Kong
61878,1/1/2023,HKG,Pahang,1,0,1,Hong Kong
61879,1/1/2023,HKG,Perak,37,17,20,Hong Kong
61880,1/1/2023,HKG,Perlis,5,2,3,Hong Kong
61881,1/1/2023,HKG,Pulau Pinang,0,0,0,Hong Kong
61882,1/1/2023,HKG,Sabah,0,0,0,Hong Kong
61883,1/1/2023,HKG,Sarawak,0,0,0,Hong Kong
61884,1/1/2023,HKG,Selangor,14,10,4,Hong Kong
61885,1/1/2023,HKG,Terengganu,0,0,0,Hong Kong
61886,1/1/2023,HMD,Johor,0,0,0,Heard Island and McDonald Islands
61887,1/1/2023,HND,Johor,4,1,3,Honduras
61888,1/1/2023,HND,Kedah,0,0,0,Honduras
61889,1/1/2023,HND,Perak,0,0,0,Honduras
61890,1/1/2023,HND,Pulau Pinang,3,1,2,Honduras
61891,1/1/2023,HND,Sabah,0,0,0,Honduras
61892,1/1/2023,HND,Sarawak,0,0,0,Honduras
61893,1/1/2023,HND,Selangor,21,10,11,Honduras
61894,1/1/2023,HRV,Johor,36,26,10,Croatia
61895,1/1/2023,HRV,Kedah,11,5,6,Croatia
61896,1/1/2023,HRV,Kelantan,0,0,0,Croatia
61897,1/1/2023,HRV,Melaka,0,0,0,Croatia
61898,1/1/2023,HRV,Pahang,0,0,0,Croatia
61899,1/1/2023,HRV,Perak,0,0,0,Croatia
61900,1/1/2023,HRV,Perlis,0,0,0,Croatia
61901,1/1/2023,HRV,Pulau Pinang,10,7,3,Croatia
61902,1/1/2023,HRV,Sabah,2,0,2,Croatia
61903,1/1/2023,HRV,Sarawak,3,3,0,Croatia
61904,1/1/2023,HRV,Selangor,175,107,68,Croatia
61905,1/1/2023,HTI,Johor,0,0,0,Haiti
61906,1/1/2023,HTI,Kedah,0,0,0,Haiti
61907,1/1/2023,HTI,Kelantan,0,0,0,Haiti
61908,1/1/2023,HTI,Perak,0,0,0,Haiti
61909,1/1/2023,HTI,Pulau Pinang,0,0,0,Haiti
61910,1/1/2023,HTI,Sabah,0,0,0,Haiti
61911,1/1/2023,HTI,Selangor,6,4,2,Haiti
61912,1/1/2023,HUN,Johor,90,63,27,Hungary
61913,1/1/2023,HUN,Kedah,49,22,27,Hungary
61914,1/1/2023,HUN,Kelantan,0,0,0,Hungary
61915,1/1/2023,HUN,Pahang,0,0,0,Hungary
61916,1/1/2023,HUN,Perak,0,0,0,Hungary
61917,1/1/2023,HUN,Perlis,5,3,2,Hungary
61918,1/1/2023,HUN,Pulau Pinang,31,17,14,Hungary
61919,1/1/2023,HUN,Sabah,1,1,0,Hungary
61920,1/1/2023,HUN,Sarawak,6,5,1,Hungary
61921,1/1/2023,HUN,Selangor,460,244,216,Hungary
61922,1/1/2023,HUN,W.P. Labuan,0,0,0,Hungary
61923,1/1/2023,IDN,Johor,105128,55208,49920,Indonesia
61924,1/1/2023,IDN,Kedah,4720,1849,2871,Indonesia
61925,1/1/2023,IDN,Kelantan,120,79,41,Indonesia
61926,1/1/2023,IDN,Melaka,5322,2392,2930,Indonesia
61927,1/1/2023,IDN,Negeri Sembilan,8075,5572,2503,Indonesia
61928,1/1/2023,IDN,Pahang,7,2,5,Indonesia
61929,1/1/2023,IDN,Perak,171,44,127,Indonesia
61930,1/1/2023,IDN,Perlis,620,224,396,Indonesia
61931,1/1/2023,IDN,Pulau Pinang,33065,11879,21186,Indonesia
61932,1/1/2023,IDN,Sabah,5351,2675,2676,Indonesia
61933,1/1/2023,IDN,Sarawak,40632,21623,19009,Indonesia
61934,1/1/2023,IDN,Selangor,97722,46409,51313,Indonesia
61935,1/1/2023,IDN,Terengganu,0,0,0,Indonesia
61936,1/1/2023,IDN,W.P. Labuan,44,28,16,Indonesia
61937,1/1/2023,IND,Johor,15320,10961,4359,India
61938,1/1/2023,IND,Kedah,509,314,195,India
61939,1/1/2023,IND,Kelantan,1,1,0,India
61940,1/1/2023,IND,Melaka,0,0,0,India
61941,1/1/2023,IND,Negeri Sembilan,0,0,0,India
61942,1/1/2023,IND,Pahang,9,8,1,India
61943,1/1/2023,IND,Perak,259,206,53,India
61944,1/1/2023,IND,Perlis,61,55,6,India
61945,1/1/2023,IND,Pulau Pinang,552,405,147,India
61946,1/1/2023,IND,Sabah,201,149,52,India
61947,1/1/2023,IND,Sarawak,903,722,181,India
61948,1/1/2023,IND,Selangor,38155,26397,11758,India
61949,1/1/2023,IND,Terengganu,0,0,0,India
61950,1/1/2023,IND,W.P. Labuan,38,30,8,India
61951,1/1/2023,IOT,Pulau Pinang,1,0,1,British Indian Ocean Territory
61952,1/1/2023,IOT,Selangor,0,0,0,British Indian Ocean Territory
61953,1/1/2023,IRL,Johor,249,163,86,Ireland
61954,1/1/2023,IRL,Kedah,120,68,52,Ireland
61955,1/1/2023,IRL,Kelantan,0,0,0,Ireland
61956,1/1/2023,IRL,Negeri Sembilan,0,0,0,Ireland
61957,1/1/2023,IRL,Pahang,0,0,0,Ireland
61958,1/1/2023,IRL,Perak,5,3,2,Ireland
61959,1/1/2023,IRL,Perlis,16,8,8,Ireland
61960,1/1/2023,IRL,Pulau Pinang,79,50,29,Ireland
61961,1/1/2023,IRL,Sabah,26,16,10,Ireland
61962,1/1/2023,IRL,Sarawak,28,14,14,Ireland
61963,1/1/2023,IRL,Selangor,1211,727,484,Ireland
61964,1/1/2023,IRL,Terengganu,0,0,0,Ireland
61965,1/1/2023,IRL,W.P. Labuan,0,0,0,Ireland
61966,1/1/2023,IRN,Johor,81,62,19,Iran
61967,1/1/2023,IRN,Kedah,5,3,2,Iran
61968,1/1/2023,IRN,Kelantan,0,0,0,Iran
61969,1/1/2023,IRN,Perak,1,1,0,Iran
61970,1/1/2023,IRN,Perlis,3,3,0,Iran
61971,1/1/2023,IRN,Pulau Pinang,5,1,4,Iran
61972,1/1/2023,IRN,Sabah,3,1,2,Iran
61973,1/1/2023,IRN,Sarawak,7,3,4,Iran
61974,1/1/2023,IRN,Selangor,879,499,380,Iran
61975,1/1/2023,IRN,W.P. Labuan,0,0,0,Iran
61976,1/1/2023,IRQ,Johor,23,20,3,Iraq
61977,1/1/2023,IRQ,Kedah,5,2,3,Iraq
61978,1/1/2023,IRQ,Kelantan,0,0,0,Iraq
61979,1/1/2023,IRQ,Melaka,0,0,0,Iraq
61980,1/1/2023,IRQ,Pahang,0,0,0,Iraq
61981,1/1/2023,IRQ,Perak,1,0,1,Iraq
61982,1/1/2023,IRQ,Perlis,0,0,0,Iraq
61983,1/1/2023,IRQ,Pulau Pinang,2,2,0,Iraq
61984,1/1/2023,IRQ,Sabah,0,0,0,Iraq
61985,1/1/2023,IRQ,Sarawak,0,0,0,Iraq
61986,1/1/2023,IRQ,Selangor,631,431,200,Iraq
61987,1/1/2023,ISL,Johor,3,3,0,Iceland
61988,1/1/2023,ISL,Kedah,0,0,0,Iceland
61989,1/1/2023,ISL,Kelantan,0,0,0,Iceland
61990,1/1/2023,ISL,Perak,2,1,1,Iceland
61991,1/1/2023,ISL,Perlis,0,0,0,Iceland
61992,1/1/2023,ISL,Pulau Pinang,2,0,2,Iceland
61993,1/1/2023,ISL,Sabah,1,1,0,Iceland
61994,1/1/2023,ISL,Sarawak,0,0,0,Iceland
61995,1/1/2023,ISL,Selangor,25,13,12,Iceland
61996,1/1/2023,ISL,W.P. Labuan,0,0,0,Iceland
61997,1/1/2023,ISR,Pulau Pinang,0,0,0,Israel
61998,1/1/2023,ITA,Johor,538,360,178,Italy
61999,1/1/2023,ITA,Kedah,617,345,272,Italy
62000,1/1/2023,ITA,Kelantan,3,2,1,Italy
62001,1/1/2023,ITA,Melaka,0,0,0,Italy
62002,1/1/2023,ITA,Negeri Sembilan,0,0,0,Italy
62003,1/1/2023,ITA,Pahang,0,0,0,Italy
62004,1/1/2023,ITA,Perak,5,5,0,Italy
62005,1/1/2023,ITA,Perlis,48,38,10,Italy
62006,1/1/2023,ITA,Pulau Pinang,103,72,31,Italy
62007,1/1/2023,ITA,Sabah,31,19,12,Italy
62008,1/1/2023,ITA,Sarawak,33,26,7,Italy
62009,1/1/2023,ITA,Selangor,2387,1555,832,Italy
62010,1/1/2023,ITA,W.P. Labuan,1,1,0,Italy
62011,1/1/2023,JAM,Johor,0,0,0,Jamaica
62012,1/1/2023,JAM,Kedah,2,1,1,Jamaica
62013,1/1/2023,JAM,Perak,0,0,0,Jamaica
62014,1/1/2023,JAM,Pulau Pinang,1,0,1,Jamaica
62015,1/1/2023,JAM,Sabah,0,0,0,Jamaica
62016,1/1/2023,JAM,Sarawak,0,0,0,Jamaica
62017,1/1/2023,JAM,Selangor,12,4,8,Jamaica
62018,1/1/2023,JAM,W.P. Labuan,0,0,0,Jamaica
62019,1/1/2023,JOR,Johor,6,3,3,Jordan
62020,1/1/2023,JOR,Kedah,1,1,0,Jordan
62021,1/1/2023,JOR,Kelantan,0,0,0,Jordan
62022,1/1/2023,JOR,Melaka,0,0,0,Jordan
62023,1/1/2023,JOR,Perlis,1,1,0,Jordan
62024,1/1/2023,JOR,Pulau Pinang,2,2,0,Jordan
62025,1/1/2023,JOR,Sabah,1,1,0,Jordan
62026,1/1/2023,JOR,Sarawak,0,0,0,Jordan
62027,1/1/2023,JOR,Selangor,776,469,307,Jordan
62028,1/1/2023,JOR,W.P. Labuan,0,0,0,Jordan
62029,1/1/2023,JPN,Johor,4873,3230,1643,Japan
62030,1/1/2023,JPN,Kedah,569,283,286,Japan
62031,1/1/2023,JPN,Kelantan,15,14,1,Japan
62032,1/1/2023,JPN,Melaka,1,1,0,Japan
62033,1/1/2023,JPN,Negeri Sembilan,0,0,0,Japan
62034,1/1/2023,JPN,Pahang,32,19,13,Japan
62035,1/1/2023,JPN,Perak,49,28,21,Japan
62036,1/1/2023,JPN,Perlis,68,46,22,Japan
62037,1/1/2023,JPN,Pulau Pinang,1145,765,380,Japan
62038,1/1/2023,JPN,Sabah,371,189,182,Japan
62039,1/1/2023,JPN,Sarawak,131,79,52,Japan
62040,1/1/2023,JPN,Selangor,12107,7473,4634,Japan
62041,1/1/2023,JPN,W.P. Labuan,11,5,6,Japan
62042,1/1/2023,KAZ,Johor,35,19,16,Kazakhstan
62043,1/1/2023,KAZ,Kedah,40,23,17,Kazakhstan
62044,1/1/2023,KAZ,Kelantan,2,0,2,Kazakhstan
62045,1/1/2023,KAZ,Melaka,0,0,0,Kazakhstan
62046,1/1/2023,KAZ,Perak,0,0,0,Kazakhstan
62047,1/1/2023,KAZ,Perlis,5,2,3,Kazakhstan
62048,1/1/2023,KAZ,Pulau Pinang,10,5,5,Kazakhstan
62049,1/1/2023,KAZ,Sabah,2,1,1,Kazakhstan
62050,1/1/2023,KAZ,Sarawak,1,0,1,Kazakhstan
62051,1/1/2023,KAZ,Selangor,552,231,321,Kazakhstan
62052,1/1/2023,KAZ,W.P. Labuan,0,0,0,Kazakhstan
62053,1/1/2023,KEN,Johor,35,15,20,Kenya
62054,1/1/2023,KEN,Kedah,1,0,1,Kenya
62055,1/1/2023,KEN,Kelantan,0,0,0,Kenya
62056,1/1/2023,KEN,Perak,0,0,0,Kenya
62057,1/1/2023,KEN,Perlis,2,1,1,Kenya
62058,1/1/2023,KEN,Pulau Pinang,3,0,3,Kenya
62059,1/1/2023,KEN,Sabah,1,1,0,Kenya
62060,1/1/2023,KEN,Sarawak,1,1,0,Kenya
62061,1/1/2023,KEN,Selangor,286,145,141,Kenya
62062,1/1/2023,KGZ,Johor,13,6,7,Kyrgyzstan
62063,1/1/2023,KGZ,Kedah,5,5,0,Kyrgyzstan
62064,1/1/2023,KGZ,Kelantan,0,0,0,Kyrgyzstan
62065,1/1/2023,KGZ,Perak,0,0,0,Kyrgyzstan
62066,1/1/2023,KGZ,Perlis,2,0,2,Kyrgyzstan
62067,1/1/2023,KGZ,Pulau Pinang,6,2,4,Kyrgyzstan
62068,1/1/2023,KGZ,Sabah,0,0,0,Kyrgyzstan
62069,1/1/2023,KGZ,Sarawak,0,0,0,Kyrgyzstan
62070,1/1/2023,KGZ,Selangor,232,138,94,Kyrgyzstan
62071,1/1/2023,KHM,Johor,2470,1075,1395,Cambodia
62072,1/1/2023,KHM,Kedah,298,263,35,Cambodia
62073,1/1/2023,KHM,Kelantan,827,605,222,Cambodia
62074,1/1/2023,KHM,Melaka,3,2,1,Cambodia
62075,1/1/2023,KHM,Negeri Sembilan,0,0,0,Cambodia
62076,1/1/2023,KHM,Pahang,0,0,0,Cambodia
62077,1/1/2023,KHM,Perak,5,2,3,Cambodia
62078,1/1/2023,KHM,Perlis,939,652,287,Cambodia
62079,1/1/2023,KHM,Pulau Pinang,41,19,22,Cambodia
62080,1/1/2023,KHM,Sabah,2,0,2,Cambodia
62081,1/1/2023,KHM,Sarawak,11,1,10,Cambodia
62082,1/1/2023,KHM,Selangor,3764,1716,2048,Cambodia
62083,1/1/2023,KHM,W.P. Labuan,0,0,0,Cambodia
62084,1/1/2023,KIR,Johor,0,0,0,Kiribati
62085,1/1/2023,KIR,Sabah,0,0,0,Kiribati
62086,1/1/2023,KIR,Selangor,0,0,0,Kiribati
62087,1/1/2023,KNA,Johor,16,13,3,Saint Kitts and Nevis
62088,1/1/2023,KNA,Kedah,2,2,0,Saint Kitts and Nevis
62089,1/1/2023,KNA,Perlis,0,0,0,Saint Kitts and Nevis
62090,1/1/2023,KNA,Pulau Pinang,0,0,0,Saint Kitts and Nevis
62091,1/1/2023,KNA,Sabah,1,1,0,Saint Kitts and Nevis
62092,1/1/2023,KNA,Selangor,51,35,16,Saint Kitts and Nevis
62093,1/1/2023,KNA,W.P. Labuan,0,0,0,Saint Kitts and Nevis
62094,1/1/2023,KOR,Johor,17050,8543,8507,"Korea, Republic of (South Korea)"
62095,1/1/2023,KOR,Kedah,439,213,226,"Korea, Republic of (South Korea)"
62096,1/1/2023,KOR,Kelantan,3,1,2,"Korea, Republic of (South Korea)"
62097,1/1/2023,KOR,Melaka,0,0,0,"Korea, Republic of (South Korea)"
62098,1/1/2023,KOR,Negeri Sembilan,0,0,0,"Korea, Republic of (South Korea)"
62099,1/1/2023,KOR,Pahang,1,0,1,"Korea, Republic of (South Korea)"
62100,1/1/2023,KOR,Perak,18,8,10,"Korea, Republic of (South Korea)"
62101,1/1/2023,KOR,Perlis,101,72,29,"Korea, Republic of (South Korea)"
62102,1/1/2023,KOR,Pulau Pinang,547,302,245,"Korea, Republic of (South Korea)"
62103,1/1/2023,KOR,Sabah,21648,9448,12200,"Korea, Republic of (South Korea)"
62104,1/1/2023,KOR,Sarawak,286,147,139,"Korea, Republic of (South Korea)"
62105,1/1/2023,KOR,Selangor,16612,8423,8189,"Korea, Republic of (South Korea)"
62106,1/1/2023,KOR,Terengganu,0,0,0,"Korea, Republic of (South Korea)"
62107,1/1/2023,KOR,W.P. Labuan,5,1,4,"Korea, Republic of (South Korea)"
62108,1/1/2023,KWT,Johor,59,31,28,Kuwait
62109,1/1/2023,KWT,Kedah,12,5,7,Kuwait
62110,1/1/2023,KWT,Kelantan,0,0,0,Kuwait
62111,1/1/2023,KWT,Perak,0,0,0,Kuwait
62112,1/1/2023,KWT,Perlis,0,0,0,Kuwait
62113,1/1/2023,KWT,Pulau Pinang,8,5,3,Kuwait
62114,1/1/2023,KWT,Sabah,0,0,0,Kuwait
62115,1/1/2023,KWT,Sarawak,5,2,3,Kuwait
62116,1/1/2023,KWT,Selangor,1191,616,575,Kuwait
62117,1/1/2023,KWT,W.P. Labuan,0,0,0,Kuwait
62118,1/1/2023,LAO,Johor,151,55,96,Lao People's Democratic Republic
62119,1/1/2023,LAO,Kedah,951,137,814,Lao People's Democratic Republic
62120,1/1/2023,LAO,Kelantan,157,24,133,Lao People's Democratic Republic
62121,1/1/2023,LAO,Melaka,0,0,0,Lao People's Democratic Republic
62122,1/1/2023,LAO,Perak,19,2,17,Lao People's Democratic Republic
62123,1/1/2023,LAO,Perlis,299,143,156,Lao People's Democratic Republic
62124,1/1/2023,LAO,Pulau Pinang,26,8,18,Lao People's Democratic Republic
62125,1/1/2023,LAO,Sabah,4,2,2,Lao People's Democratic Republic
62126,1/1/2023,LAO,Sarawak,13,7,6,Lao People's Democratic Republic
62127,1/1/2023,LAO,Selangor,183,60,123,Lao People's Democratic Republic
62128,1/1/2023,LAO,W.P. Labuan,0,0,0,Lao People's Democratic Republic
62129,1/1/2023,LBN,Johor,12,9,3,Lebanon
62130,1/1/2023,LBN,Kedah,3,1,2,Lebanon
62131,1/1/2023,LBN,Kelantan,0,0,0,Lebanon
62132,1/1/2023,LBN,Pahang,1,0,1,Lebanon
62133,1/1/2023,LBN,Perak,0,0,0,Lebanon
62134,1/1/2023,LBN,Perlis,0,0,0,Lebanon
62135,1/1/2023,LBN,Pulau Pinang,3,3,0,Lebanon
62136,1/1/2023,LBN,Sabah,1,1,0,Lebanon
62137,1/1/2023,LBN,Sarawak,0,0,0,Lebanon
62138,1/1/2023,LBN,Selangor,167,99,68,Lebanon
62139,1/1/2023,LBN,W.P. Labuan,0,0,0,Lebanon
62140,1/1/2023,LBR,Johor,2,2,0,Liberia
62141,1/1/2023,LBR,Kedah,0,0,0,Liberia
62142,1/1/2023,LBR,Sabah,0,0,0,Liberia
62143,1/1/2023,LBR,Sarawak,0,0,0,Liberia
62144,1/1/2023,LBR,Selangor,12,12,0,Liberia
62145,1/1/2023,LBY,Johor,3,2,1,Libyan Arab Jamahiriya
62146,1/1/2023,LBY,Kedah,2,2,0,Libyan Arab Jamahiriya
62147,1/1/2023,LBY,Perlis,0,0,0,Libyan Arab Jamahiriya
62148,1/1/2023,LBY,Pulau Pinang,1,1,0,Libyan Arab Jamahiriya
62149,1/1/2023,LBY,Sabah,0,0,0,Libyan Arab Jamahiriya
62150,1/1/2023,LBY,Sarawak,2,1,1,Libyan Arab Jamahiriya
62151,1/1/2023,LBY,Selangor,270,205,65,Libyan Arab Jamahiriya
62152,1/1/2023,LCA,Johor,12,7,5,Saint Lucia
62153,1/1/2023,LCA,Kedah,0,0,0,Saint Lucia
62154,1/1/2023,LCA,Pulau Pinang,1,0,1,Saint Lucia
62155,1/1/2023,LCA,Sarawak,0,0,0,Saint Lucia
62156,1/1/2023,LCA,Selangor,10,5,5,Saint Lucia
62157,1/1/2023,LIE,Johor,0,0,0,Liechtenstein
62158,1/1/2023,LIE,Kedah,1,0,1,Liechtenstein
62159,1/1/2023,LIE,Perlis,0,0,0,Liechtenstein
62160,1/1/2023,LIE,Pulau Pinang,0,0,0,Liechtenstein
62161,1/1/2023,LIE,Sabah,0,0,0,Liechtenstein
62162,1/1/2023,LIE,Sarawak,0,0,0,Liechtenstein
62163,1/1/2023,LIE,Selangor,5,3,2,Liechtenstein
62164,1/1/2023,LKA,Johor,1096,701,395,Sri Lanka
62165,1/1/2023,LKA,Kedah,55,28,27,Sri Lanka
62166,1/1/2023,LKA,Kelantan,0,0,0,Sri Lanka
62167,1/1/2023,LKA,Melaka,0,0,0,Sri Lanka
62168,1/1/2023,LKA,Pahang,0,0,0,Sri Lanka
62169,1/1/2023,LKA,Perak,3,2,1,Sri Lanka
62170,1/1/2023,LKA,Perlis,4,4,0,Sri Lanka
62171,1/1/2023,LKA,Pulau Pinang,20,16,4,Sri Lanka
62172,1/1/2023,LKA,Sabah,15,8,7,Sri Lanka
62173,1/1/2023,LKA,Sarawak,29,18,11,Sri Lanka
62174,1/1/2023,LKA,Selangor,2688,1708,980,Sri Lanka
62175,1/1/2023,LKA,W.P. Labuan,0,0,0,Sri Lanka
62176,1/1/2023,LSO,Johor,0,0,0,Lesotho
62177,1/1/2023,LSO,Kedah,0,0,0,Lesotho
62178,1/1/2023,LSO,Pulau Pinang,1,0,1,Lesotho
62179,1/1/2023,LSO,Sarawak,0,0,0,Lesotho
62180,1/1/2023,LSO,Selangor,4,3,1,Lesotho
62181,1/1/2023,LTU,Johor,58,23,35,Lithuania
62182,1/1/2023,LTU,Kedah,35,14,21,Lithuania
62183,1/1/2023,LTU,Kelantan,0,0,0,Lithuania
62184,1/1/2023,LTU,Pahang,0,0,0,Lithuania
62185,1/1/2023,LTU,Perak,0,0,0,Lithuania
62186,1/1/2023,LTU,Perlis,7,4,3,Lithuania
62187,1/1/2023,LTU,Pulau Pinang,8,4,4,Lithuania
62188,1/1/2023,LTU,Sabah,3,2,1,Lithuania
62189,1/1/2023,LTU,Sarawak,1,0,1,Lithuania
62190,1/1/2023,LTU,Selangor,330,171,159,Lithuania
62191,1/1/2023,LTU,W.P. Labuan,0,0,0,Lithuania
62192,1/1/2023,LUX,Johor,7,7,0,Luxembourg
62193,1/1/2023,LUX,Kedah,5,2,3,Luxembourg
62194,1/1/2023,LUX,Kelantan,0,0,0,Luxembourg
62195,1/1/2023,LUX,Perak,0,0,0,Luxembourg
62196,1/1/2023,LUX,Perlis,3,3,0,Luxembourg
62197,1/1/2023,LUX,Pulau Pinang,1,1,0,Luxembourg
62198,1/1/2023,LUX,Sabah,2,0,2,Luxembourg
62199,1/1/2023,LUX,Sarawak,0,0,0,Luxembourg
62200,1/1/2023,LUX,Selangor,50,33,17,Luxembourg
62201,1/1/2023,LVA,Johor,35,16,19,Latvia
62202,1/1/2023,LVA,Kedah,32,15,17,Latvia
62203,1/1/2023,LVA,Kelantan,0,0,0,Latvia
62204,1/1/2023,LVA,Pahang,0,0,0,Latvia
62205,1/1/2023,LVA,Perak,0,0,0,Latvia
62206,1/1/2023,LVA,Perlis,5,4,1,Latvia
62207,1/1/2023,LVA,Pulau Pinang,4,2,2,Latvia
62208,1/1/2023,LVA,Sabah,2,1,1,Latvia
62209,1/1/2023,LVA,Sarawak,8,2,6,Latvia
62210,1/1/2023,LVA,Selangor,200,101,99,Latvia
62211,1/1/2023,LVA,W.P. Labuan,0,0,0,Latvia
62212,1/1/2023,MAC,Johor,0,0,0,Macao
62213,1/1/2023,MAC,Pahang,0,0,0,Macao
62214,1/1/2023,MAC,Perak,0,0,0,Macao
62215,1/1/2023,MAC,Selangor,2,1,1,Macao
62216,1/1/2023,MAC,W.P. Labuan,0,0,0,Macao
62217,1/1/2023,MAR,Johor,82,63,19,Morocco
62218,1/1/2023,MAR,Kedah,11,10,1,Morocco
62219,1/1/2023,MAR,Kelantan,0,0,0,Morocco
62220,1/1/2023,MAR,Melaka,0,0,0,Morocco
62221,1/1/2023,MAR,Pahang,0,0,0,Morocco
62222,1/1/2023,MAR,Perak,0,0,0,Morocco
62223,1/1/2023,MAR,Perlis,2,2,0,Morocco
62224,1/1/2023,MAR,Pulau Pinang,6,6,0,Morocco
62225,1/1/2023,MAR,Sabah,5,3,2,Morocco
62226,1/1/2023,MAR,Sarawak,3,3,0,Morocco
62227,1/1/2023,MAR,Selangor,430,259,171,Morocco
62228,1/1/2023,MAR,W.P. Labuan,0,0,0,Morocco
62229,1/1/2023,MCO,Johor,0,0,0,Monaco
62230,1/1/2023,MCO,Kedah,0,0,0,Monaco
62231,1/1/2023,MCO,Sabah,0,0,0,Monaco
62232,1/1/2023,MCO,Selangor,0,0,0,Monaco
62233,1/1/2023,MDA,Johor,1,1,0,"Moldova, Republic of"
62234,1/1/2023,MDA,Kedah,0,0,0,"Moldova, Republic of"
62235,1/1/2023,MDA,Kelantan,0,0,0,"Moldova, Republic of"
62236,1/1/2023,MDA,Negeri Sembilan,0,0,0,"Moldova, Republic of"
62237,1/1/2023,MDA,Perlis,1,1,0,"Moldova, Republic of"
62238,1/1/2023,MDA,Pulau Pinang,2,2,0,"Moldova, Republic of"
62239,1/1/2023,MDA,Sabah,0,0,0,"Moldova, Republic of"
62240,1/1/2023,MDA,Sarawak,2,0,2,"Moldova, Republic of"
62241,1/1/2023,MDA,Selangor,22,10,12,"Moldova, Republic of"
62242,1/1/2023,MDG,Johor,6,2,4,Madagascar
62243,1/1/2023,MDG,Kedah,0,0,0,Madagascar
62244,1/1/2023,MDG,Perak,0,0,0,Madagascar
62245,1/1/2023,MDG,Perlis,0,0,0,Madagascar
62246,1/1/2023,MDG,Pulau Pinang,1,0,1,Madagascar
62247,1/1/2023,MDG,Sabah,0,0,0,Madagascar
62248,1/1/2023,MDG,Sarawak,0,0,0,Madagascar
62249,1/1/2023,MDG,Selangor,20,13,7,Madagascar
62250,1/1/2023,MDV,Johor,169,86,83,Maldives
62251,1/1/2023,MDV,Kedah,1,0,1,Maldives
62252,1/1/2023,MDV,Kelantan,0,0,0,Maldives
62253,1/1/2023,MDV,Perak,0,0,0,Maldives
62254,1/1/2023,MDV,Perlis,0,0,0,Maldives
62255,1/1/2023,MDV,Pulau Pinang,8,3,5,Maldives
62256,1/1/2023,MDV,Sabah,0,0,0,Maldives
62257,1/1/2023,MDV,Sarawak,0,0,0,Maldives
62258,1/1/2023,MDV,Selangor,2046,1045,1001,Maldives
62259,1/1/2023,MEX,Johor,95,62,33,Mexico
62260,1/1/2023,MEX,Kedah,8,2,6,Mexico
62261,1/1/2023,MEX,Kelantan,1,1,0,Mexico
62262,1/1/2023,MEX,Pahang,0,0,0,Mexico
62263,1/1/2023,MEX,Perak,2,1,1,Mexico
62264,1/1/2023,MEX,Perlis,7,3,4,Mexico
62265,1/1/2023,MEX,Pulau Pinang,20,11,9,Mexico
62266,1/1/2023,MEX,Sabah,4,2,2,Mexico
62267,1/1/2023,MEX,Sarawak,4,2,2,Mexico
62268,1/1/2023,MEX,Selangor,411,207,204,Mexico
62269,1/1/2023,MEX,W.P. Labuan,0,0,0,Mexico
62270,1/1/2023,MHL,Johor,2,2,0,Marshall Islands
62271,1/1/2023,MHL,Kedah,0,0,0,Marshall Islands
62272,1/1/2023,MHL,Perak,0,0,0,Marshall Islands
62273,1/1/2023,MHL,Pulau Pinang,1,1,0,Marshall Islands
62274,1/1/2023,MHL,Sabah,0,0,0,Marshall Islands
62275,1/1/2023,MHL,Selangor,6,2,4,Marshall Islands
62276,1/1/2023,MKD,Johor,1,1,0,"Macedonia, the former Yugoslav Republic of"
62277,1/1/2023,MKD,Kedah,3,1,2,"Macedonia, the former Yugoslav Republic of"
62278,1/1/2023,MKD,Perak,0,0,0,"Macedonia, the former Yugoslav Republic of"
62279,1/1/2023,MKD,Pulau Pinang,1,0,1,"Macedonia, the former Yugoslav Republic of"
62280,1/1/2023,MKD,Sabah,1,1,0,"Macedonia, the former Yugoslav Republic of"
62281,1/1/2023,MKD,Sarawak,1,0,1,"Macedonia, the former Yugoslav Republic of"
62282,1/1/2023,MKD,Selangor,24,12,12,"Macedonia, the former Yugoslav Republic of"
62283,1/1/2023,MLI,Johor,2,2,0,Mali
62284,1/1/2023,MLI,Sabah,0,0,0,Mali
62285,1/1/2023,MLI,Selangor,16,14,2,Mali
62286,1/1/2023,MLT,Johor,10,6,4,Malta
62287,1/1/2023,MLT,Kedah,1,0,1,Malta
62288,1/1/2023,MLT,Kelantan,1,1,0,Malta
62289,1/1/2023,MLT,Perak,0,0,0,Malta
62290,1/1/2023,MLT,Perlis,0,0,0,Malta
62291,1/1/2023,MLT,Pulau Pinang,3,2,1,Malta
62292,1/1/2023,MLT,Sabah,2,1,1,Malta
62293,1/1/2023,MLT,Sarawak,1,1,0,Malta
62294,1/1/2023,MLT,Selangor,60,31,29,Malta
62295,1/1/2023,MLT,W.P. Labuan,0,0,0,Malta
62296,1/1/2023,MMR,Johor,4954,1508,3446,Myanmar
62297,1/1/2023,MMR,Kedah,59,9,50,Myanmar
62298,1/1/2023,MMR,Kelantan,4,1,3,Myanmar
62299,1/1/2023,MMR,Negeri Sembilan,0,0,0,Myanmar
62300,1/1/2023,MMR,Pahang,1,1,0,Myanmar
62301,1/1/2023,MMR,Perak,24,6,18,Myanmar
62302,1/1/2023,MMR,Perlis,12,1,11,Myanmar
62303,1/1/2023,MMR,Pulau Pinang,212,100,112,Myanmar
62304,1/1/2023,MMR,Sabah,23,6,17,Myanmar
62305,1/1/2023,MMR,Sarawak,80,35,45,Myanmar
62306,1/1/2023,MMR,Selangor,6605,4497,2108,Myanmar
62307,1/1/2023,MMR,Terengganu,0,0,0,Myanmar
62308,1/1/2023,MMR,W.P. Labuan,0,0,0,Myanmar
62309,1/1/2023,MNE,Johor,1,1,0,Montenegro
62310,1/1/2023,MNE,Kedah,0,0,0,Montenegro
62311,1/1/2023,MNE,Pulau Pinang,0,0,0,Montenegro
62312,1/1/2023,MNE,Sabah,0,0,0,Montenegro
62313,1/1/2023,MNE,Sarawak,0,0,0,Montenegro
62314,1/1/2023,MNE,Selangor,6,4,2,Montenegro
62315,1/1/2023,MNG,Johor,575,271,304,Mongolia
62316,1/1/2023,MNG,Kedah,17,8,9,Mongolia
62317,1/1/2023,MNG,Kelantan,0,0,0,Mongolia
62318,1/1/2023,MNG,Perak,0,0,0,Mongolia
62319,1/1/2023,MNG,Perlis,14,10,4,Mongolia
62320,1/1/2023,MNG,Pulau Pinang,24,11,13,Mongolia
62321,1/1/2023,MNG,Sabah,17,8,9,Mongolia
62322,1/1/2023,MNG,Sarawak,0,0,0,Mongolia
62323,1/1/2023,MNG,Selangor,571,266,305,Mongolia
62324,1/1/2023,MNP,Selangor,0,0,0,Northern Mariana Islands
62325,1/1/2023,MOZ,Johor,0,0,0,Mozambique
62326,1/1/2023,MOZ,Kedah,3,3,0,Mozambique
62327,1/1/2023,MOZ,Perak,0,0,0,Mozambique
62328,1/1/2023,MOZ,Pulau Pinang,4,2,2,Mozambique
62329,1/1/2023,MOZ,Sabah,0,0,0,Mozambique
62330,1/1/2023,MOZ,Sarawak,0,0,0,Mozambique
62331,1/1/2023,MOZ,Selangor,39,17,22,Mozambique
62332,1/1/2023,MRT,Johor,0,0,0,Mauritania
62333,1/1/2023,MRT,Kedah,0,0,0,Mauritania
62334,1/1/2023,MRT,Pulau Pinang,0,0,0,Mauritania
62335,1/1/2023,MRT,Sabah,0,0,0,Mauritania
62336,1/1/2023,MRT,Sarawak,0,0,0,Mauritania
62337,1/1/2023,MRT,Selangor,18,12,6,Mauritania
62338,1/1/2023,MUS,Johor,132,69,63,Mauritius
62339,1/1/2023,MUS,Kedah,4,1,3,Mauritius
62340,1/1/2023,MUS,Kelantan,0,0,0,Mauritius
62341,1/1/2023,MUS,Pahang,0,0,0,Mauritius
62342,1/1/2023,MUS,Perak,1,1,0,Mauritius
62343,1/1/2023,MUS,Perlis,0,0,0,Mauritius
62344,1/1/2023,MUS,Pulau Pinang,14,5,9,Mauritius
62345,1/1/2023,MUS,Sabah,1,1,0,Mauritius
62346,1/1/2023,MUS,Sarawak,3,3,0,Mauritius
62347,1/1/2023,MUS,Selangor,1266,653,613,Mauritius
62348,1/1/2023,MWI,Johor,0,0,0,Malawi
62349,1/1/2023,MWI,Pulau Pinang,0,0,0,Malawi
62350,1/1/2023,MWI,Sabah,0,0,0,Malawi
62351,1/1/2023,MWI,Sarawak,0,0,0,Malawi
62352,1/1/2023,MWI,Selangor,19,12,7,Malawi
62353,1/1/2023,MYT,Selangor,0,0,0,Mayotte
62354,1/1/2023,NAM,Johor,1,0,1,Namibia
62355,1/1/2023,NAM,Kedah,0,0,0,Namibia
62356,1/1/2023,NAM,Perak,0,0,0,Namibia
62357,1/1/2023,NAM,Perlis,0,0,0,Namibia
62358,1/1/2023,NAM,Pulau Pinang,0,0,0,Namibia
62359,1/1/2023,NAM,Sabah,0,0,0,Namibia
62360,1/1/2023,NAM,Sarawak,0,0,0,Namibia
62361,1/1/2023,NAM,Selangor,11,4,7,Namibia
62362,1/1/2023,NCL,Selangor,0,0,0,New Caledonia
62363,1/1/2023,NER,Johor,0,0,0,Niger
62364,1/1/2023,NER,Sabah,0,0,0,Niger
62365,1/1/2023,NER,Selangor,0,0,0,Niger
62366,1/1/2023,NGA,Johor,26,26,0,Nigeria
62367,1/1/2023,NGA,Kedah,1,1,0,Nigeria
62368,1/1/2023,NGA,Perlis,0,0,0,Nigeria
62369,1/1/2023,NGA,Pulau Pinang,0,0,0,Nigeria
62370,1/1/2023,NGA,Sabah,0,0,0,Nigeria
62371,1/1/2023,NGA,Sarawak,3,2,1,Nigeria
62372,1/1/2023,NGA,Selangor,334,264,70,Nigeria
62373,1/1/2023,NIC,Johor,4,0,4,Nicaragua
62374,1/1/2023,NIC,Kedah,0,0,0,Nicaragua
62375,1/1/2023,NIC,Pulau Pinang,0,0,0,Nicaragua
62376,1/1/2023,NIC,Sabah,0,0,0,Nicaragua
62377,1/1/2023,NIC,Selangor,6,1,5,Nicaragua
62378,1/1/2023,NLD,Johor,927,609,318,Netherlands
62379,1/1/2023,NLD,Kedah,499,252,247,Netherlands
62380,1/1/2023,NLD,Kelantan,5,5,0,Netherlands
62381,1/1/2023,NLD,Melaka,1,1,0,Netherlands
62382,1/1/2023,NLD,Negeri Sembilan,0,0,0,Netherlands
62383,1/1/2023,NLD,Pahang,0,0,0,Netherlands
62384,1/1/2023,NLD,Perak,11,9,2,Netherlands
62385,1/1/2023,NLD,Perlis,42,30,12,Netherlands
62386,1/1/2023,NLD,Pulau Pinang,245,156,89,Netherlands
62387,1/1/2023,NLD,Sabah,75,47,28,Netherlands
62388,1/1/2023,NLD,Sarawak,118,80,38,Netherlands
62389,1/1/2023,NLD,Selangor,3524,2040,1484,Netherlands
62390,1/1/2023,NLD,Terengganu,0,0,0,Netherlands
62391,1/1/2023,NLD,W.P. Labuan,4,0,4,Netherlands
62392,1/1/2023,NOR,Johor,162,104,58,Norway
62393,1/1/2023,NOR,Kedah,104,53,51,Norway
62394,1/1/2023,NOR,Kelantan,0,0,0,Norway
62395,1/1/2023,NOR,Melaka,0,0,0,Norway
62396,1/1/2023,NOR,Pahang,0,0,0,Norway
62397,1/1/2023,NOR,Perak,0,0,0,Norway
62398,1/1/2023,NOR,Perlis,21,13,8,Norway
62399,1/1/2023,NOR,Pulau Pinang,45,28,17,Norway
62400,1/1/2023,NOR,Sabah,15,14,1,Norway
62401,1/1/2023,NOR,Sarawak,8,7,1,Norway
62402,1/1/2023,NOR,Selangor,693,420,273,Norway
62403,1/1/2023,NOR,W.P. Labuan,5,3,2,Norway
62404,1/1/2023,NPL,Johor,1181,983,198,Nepal
62405,1/1/2023,NPL,Kedah,11,8,3,Nepal
62406,1/1/2023,NPL,Pahang,0,0,0,Nepal
62407,1/1/2023,NPL,Perak,0,0,0,Nepal
62408,1/1/2023,NPL,Perlis,0,0,0,Nepal
62409,1/1/2023,NPL,Pulau Pinang,26,26,0,Nepal
62410,1/1/2023,NPL,Sabah,3,3,0,Nepal
62411,1/1/2023,NPL,Sarawak,232,169,63,Nepal
62412,1/1/2023,NPL,Selangor,16929,16159,770,Nepal
62413,1/1/2023,NPL,W.P. Labuan,30,28,2,Nepal
62414,1/1/2023,NRU,Johor,0,0,0,Nauru
62415,1/1/2023,NRU,Pulau Pinang,0,0,0,Nauru
62416,1/1/2023,NRU,Selangor,1,1,0,Nauru
62417,1/1/2023,NZL,Johor,856,494,362,New Zealand
62418,1/1/2023,NZL,Kedah,114,68,46,New Zealand
62419,1/1/2023,NZL,Kelantan,1,1,0,New Zealand
62420,1/1/2023,NZL,Melaka,1,1,0,New Zealand
62421,1/1/2023,NZL,Negeri Sembilan,0,0,0,New Zealand
62422,1/1/2023,NZL,Pahang,0,0,0,New Zealand
62423,1/1/2023,NZL,Perak,29,16,13,New Zealand
62424,1/1/2023,NZL,Perlis,33,19,14,New Zealand
62425,1/1/2023,NZL,Pulau Pinang,224,139,85,New Zealand
62426,1/1/2023,NZL,Sabah,86,47,39,New Zealand
62427,1/1/2023,NZL,Sarawak,174,86,88,New Zealand
62428,1/1/2023,NZL,Selangor,3031,1765,1266,New Zealand
62429,1/1/2023,NZL,Terengganu,0,0,0,New Zealand
62430,1/1/2023,NZL,W.P. Labuan,6,5,1,New Zealand
62431,1/1/2023,OMN,Johor,48,22,26,Oman
62432,1/1/2023,OMN,Kedah,0,0,0,Oman
62433,1/1/2023,OMN,Kelantan,0,0,0,Oman
62434,1/1/2023,OMN,Melaka,0,0,0,Oman
62435,1/1/2023,OMN,Perak,0,0,0,Oman
62436,1/1/2023,OMN,Perlis,0,0,0,Oman
62437,1/1/2023,OMN,Pulau Pinang,5,4,1,Oman
62438,1/1/2023,OMN,Sabah,0,0,0,Oman
62439,1/1/2023,OMN,Sarawak,14,7,7,Oman
62440,1/1/2023,OMN,Selangor,779,460,319,Oman
62441,1/1/2023,PAK,Johor,665,486,179,Pakistan
62442,1/1/2023,PAK,Kedah,97,76,21,Pakistan
62443,1/1/2023,PAK,Kelantan,8,8,0,Pakistan
62444,1/1/2023,PAK,Melaka,0,0,0,Pakistan
62445,1/1/2023,PAK,Negeri Sembilan,0,0,0,Pakistan
62446,1/1/2023,PAK,Pahang,0,0,0,Pakistan
62447,1/1/2023,PAK,Perak,49,47,2,Pakistan
62448,1/1/2023,PAK,Perlis,35,34,1,Pakistan
62449,1/1/2023,PAK,Pulau Pinang,127,114,13,Pakistan
62450,1/1/2023,PAK,Sabah,12,10,2,Pakistan
62451,1/1/2023,PAK,Sarawak,90,67,23,Pakistan
62452,1/1/2023,PAK,Selangor,11473,10061,1412,Pakistan
62453,1/1/2023,PAK,W.P. Labuan,5,4,1,Pakistan
62454,1/1/2023,PAN,Johor,25,10,15,Panama
62455,1/1/2023,PAN,Kedah,0,0,0,Panama
62456,1/1/2023,PAN,Perak,0,0,0,Panama
62457,1/1/2023,PAN,Perlis,0,0,0,Panama
62458,1/1/2023,PAN,Pulau Pinang,2,0,2,Panama
62459,1/1/2023,PAN,Sabah,0,0,0,Panama
62460,1/1/2023,PAN,Sarawak,0,0,0,Panama
62461,1/1/2023,PAN,Selangor,13,3,10,Panama
62462,1/1/2023,PER,Johor,27,16,11,Peru
62463,1/1/2023,PER,Kedah,1,1,0,Peru
62464,1/1/2023,PER,Kelantan,0,0,0,Peru
62465,1/1/2023,PER,Pahang,0,0,0,Peru
62466,1/1/2023,PER,Perak,1,1,0,Peru
62467,1/1/2023,PER,Perlis,0,0,0,Peru
62468,1/1/2023,PER,Pulau Pinang,1,1,0,Peru
62469,1/1/2023,PER,Sabah,1,1,0,Peru
62470,1/1/2023,PER,Sarawak,1,1,0,Peru
62471,1/1/2023,PER,Selangor,110,56,54,Peru
62472,1/1/2023,PER,W.P. Labuan,0,0,0,Peru
62473,1/1/2023,PHL,Johor,15410,4502,10908,Philippines
62474,1/1/2023,PHL,Kedah,506,189,317,Philippines
62475,1/1/2023,PHL,Kelantan,14,4,10,Philippines
62476,1/1/2023,PHL,Melaka,1,0,1,Philippines
62477,1/1/2023,PHL,Negeri Sembilan,2,1,1,Philippines
62478,1/1/2023,PHL,Pahang,9,2,7,Philippines
62479,1/1/2023,PHL,Perak,56,12,44,Philippines
62480,1/1/2023,PHL,Perlis,129,40,89,Philippines
62481,1/1/2023,PHL,Pulau Pinang,429,159,270,Philippines
62482,1/1/2023,PHL,Sabah,1792,723,1069,Philippines
62483,1/1/2023,PHL,Sarawak,2200,831,1369,Philippines
62484,1/1/2023,PHL,Selangor,15849,5688,10161,Philippines
62485,1/1/2023,PHL,Terengganu,0,0,0,Philippines
62486,1/1/2023,PHL,W.P. Labuan,91,32,59,Philippines
62487,1/1/2023,PLW,Johor,0,0,0,Palau
62488,1/1/2023,PLW,Pulau Pinang,0,0,0,Palau
62489,1/1/2023,PLW,Selangor,0,0,0,Palau
62490,1/1/2023,PNG,Johor,13,6,7,Papua New Guinea
62491,1/1/2023,PNG,Kedah,0,0,0,Papua New Guinea
62492,1/1/2023,PNG,Kelantan,0,0,0,Papua New Guinea
62493,1/1/2023,PNG,Perak,1,1,0,Papua New Guinea
62494,1/1/2023,PNG,Pulau Pinang,0,0,0,Papua New Guinea
62495,1/1/2023,PNG,Sabah,1,0,1,Papua New Guinea
62496,1/1/2023,PNG,Sarawak,7,1,6,Papua New Guinea
62497,1/1/2023,PNG,Selangor,55,31,24,Papua New Guinea
62498,1/1/2023,POL,Johor,610,327,283,Poland
62499,1/1/2023,POL,Kedah,230,122,108,Poland
62500,1/1/2023,POL,Kelantan,4,2,2,Poland
62501,1/1/2023,POL,Melaka,0,0,0,Poland
62502,1/1/2023,POL,Negeri Sembilan,0,0,0,Poland
62503,1/1/2023,POL,Pahang,0,0,0,Poland
62504,1/1/2023,POL,Perak,3,0,3,Poland
62505,1/1/2023,POL,Perlis,40,24,16,Poland
62506,1/1/2023,POL,Pulau Pinang,60,34,26,Poland
62507,1/1/2023,POL,Sabah,37,17,20,Poland
62508,1/1/2023,POL,Sarawak,28,12,16,Poland
62509,1/1/2023,POL,Selangor,1183,632,551,Poland
62510,1/1/2023,POL,Terengganu,0,0,0,Poland
62511,1/1/2023,POL,W.P. Labuan,0,0,0,Poland
62512,1/1/2023,PRK,Selangor,0,0,0,"Korea, Democratic People's Republic of"
62513,1/1/2023,PRT,Johor,112,63,49,Portugal
62514,1/1/2023,PRT,Kedah,58,35,23,Portugal
62515,1/1/2023,PRT,Kelantan,0,0,0,Portugal
62516,1/1/2023,PRT,Melaka,0,0,0,Portugal
62517,1/1/2023,PRT,Pahang,0,0,0,Portugal
62518,1/1/2023,PRT,Perak,3,3,0,Portugal
62519,1/1/2023,PRT,Perlis,3,3,0,Portugal
62520,1/1/2023,PRT,Pulau Pinang,18,7,11,Portugal
62521,1/1/2023,PRT,Sabah,3,1,2,Portugal
62522,1/1/2023,PRT,Sarawak,14,9,5,Portugal
62523,1/1/2023,PRT,Selangor,443,255,188,Portugal
62524,1/1/2023,PRT,W.P. Labuan,0,0,0,Portugal
62525,1/1/2023,PRY,Johor,9,6,3,Paraguay
62526,1/1/2023,PRY,Kedah,0,0,0,Paraguay
62527,1/1/2023,PRY,Perak,0,0,0,Paraguay
62528,1/1/2023,PRY,Perlis,0,0,0,Paraguay
62529,1/1/2023,PRY,Pulau Pinang,0,0,0,Paraguay
62530,1/1/2023,PRY,Sabah,0,0,0,Paraguay
62531,1/1/2023,PRY,Sarawak,0,0,0,Paraguay
62532,1/1/2023,PRY,Selangor,19,12,7,Paraguay
62533,1/1/2023,PSE,Johor,9,6,3,"Palestinian Territory, Occupied"
62534,1/1/2023,PSE,Kedah,1,0,1,"Palestinian Territory, Occupied"
62535,1/1/2023,PSE,Kelantan,1,1,0,"Palestinian Territory, Occupied"
62536,1/1/2023,PSE,Melaka,0,0,0,"Palestinian Territory, Occupied"
62537,1/1/2023,PSE,Perak,4,3,1,"Palestinian Territory, Occupied"
62538,1/1/2023,PSE,Perlis,0,0,0,"Palestinian Territory, Occupied"
62539,1/1/2023,PSE,Pulau Pinang,0,0,0,"Palestinian Territory, Occupied"
62540,1/1/2023,PSE,Sabah,0,0,0,"Palestinian Territory, Occupied"
62541,1/1/2023,PSE,Sarawak,2,2,0,"Palestinian Territory, Occupied"
62542,1/1/2023,PSE,Selangor,257,177,80,"Palestinian Territory, Occupied"
62543,1/1/2023,QAT,Johor,2,2,0,Qatar
62544,1/1/2023,QAT,Kedah,0,0,0,Qatar
62545,1/1/2023,QAT,Perlis,1,1,0,Qatar
62546,1/1/2023,QAT,Pulau Pinang,2,1,1,Qatar
62547,1/1/2023,QAT,Sabah,0,0,0,Qatar
62548,1/1/2023,QAT,Sarawak,3,2,1,Qatar
62549,1/1/2023,QAT,Selangor,64,41,23,Qatar
62550,1/1/2023,REU,Johor,0,0,0,Reunion
62551,1/1/2023,REU,Sarawak,0,0,0,Reunion
62552,1/1/2023,ROU,Johor,171,104,67,Romania
62553,1/1/2023,ROU,Kedah,73,38,35,Romania
62554,1/1/2023,ROU,Kelantan,0,0,0,Romania
62555,1/1/2023,ROU,Negeri Sembilan,0,0,0,Romania
62556,1/1/2023,ROU,Pahang,1,1,0,Romania
62557,1/1/2023,ROU,Perak,1,1,0,Romania
62558,1/1/2023,ROU,Perlis,4,2,2,Romania
62559,1/1/2023,ROU,Pulau Pinang,31,22,9,Romania
62560,1/1/2023,ROU,Sabah,19,9,10,Romania
62561,1/1/2023,ROU,Sarawak,10,7,3,Romania
62562,1/1/2023,ROU,Selangor,719,371,348,Romania
62563,1/1/2023,ROU,W.P. Labuan,0,0,0,Romania
62564,1/1/2023,RUS,Johor,370,187,183,Russia
62565,1/1/2023,RUS,Kedah,918,490,428,Russia
62566,1/1/2023,RUS,Kelantan,78,37,41,Russia
62567,1/1/2023,RUS,Melaka,0,0,0,Russia
62568,1/1/2023,RUS,Negeri Sembilan,0,0,0,Russia
62569,1/1/2023,RUS,Pahang,0,0,0,Russia
62570,1/1/2023,RUS,Perak,2,1,1,Russia
62571,1/1/2023,RUS,Perlis,510,290,220,Russia
62572,1/1/2023,RUS,Pulau Pinang,475,250,225,Russia
62573,1/1/2023,RUS,Sabah,63,37,26,Russia
62574,1/1/2023,RUS,Sarawak,61,23,38,Russia
62575,1/1/2023,RUS,Selangor,14260,7333,6927,Russia
62576,1/1/2023,RUS,W.P. Labuan,4,2,2,Russia
62577,1/1/2023,RWA,Johor,0,0,0,Rwanda
62578,1/1/2023,RWA,Kedah,0,0,0,Rwanda
62579,1/1/2023,RWA,Pulau Pinang,0,0,0,Rwanda
62580,1/1/2023,RWA,Selangor,10,4,6,Rwanda
62581,1/1/2023,SAU,Johor,105,64,41,Saudi Arabia
62582,1/1/2023,SAU,Kedah,16,11,5,Saudi Arabia
62583,1/1/2023,SAU,Kelantan,1,1,0,Saudi Arabia
62584,1/1/2023,SAU,Melaka,0,0,0,Saudi Arabia
62585,1/1/2023,SAU,Perak,0,0,0,Saudi Arabia
62586,1/1/2023,SAU,Perlis,5,5,0,Saudi Arabia
62587,1/1/2023,SAU,Pulau Pinang,17,9,8,Saudi Arabia
62588,1/1/2023,SAU,Sabah,0,0,0,Saudi Arabia
62589,1/1/2023,SAU,Sarawak,16,11,5,Saudi Arabia
62590,1/1/2023,SAU,Selangor,2314,1339,975,Saudi Arabia
62591,1/1/2023,SAU,W.P. Labuan,1,1,0,Saudi Arabia
62592,1/1/2023,SDN,Johor,5,4,1,Sudan
62593,1/1/2023,SDN,Kedah,0,0,0,Sudan
62594,1/1/2023,SDN,Kelantan,1,0,1,Sudan
62595,1/1/2023,SDN,Perlis,0,0,0,Sudan
62596,1/1/2023,SDN,Pulau Pinang,0,0,0,Sudan
62597,1/1/2023,SDN,Sabah,0,0,0,Sudan
62598,1/1/2023,SDN,Sarawak,3,3,0,Sudan
62599,1/1/2023,SDN,Selangor,1102,622,480,Sudan
62600,1/1/2023,SDN,W.P. Labuan,0,0,0,Sudan
62601,1/1/2023,SEN,Johor,0,0,0,Senegal
62602,1/1/2023,SEN,Kedah,0,0,0,Senegal
62603,1/1/2023,SEN,Kelantan,0,0,0,Senegal
62604,1/1/2023,SEN,Perak,0,0,0,Senegal
62605,1/1/2023,SEN,Perlis,0,0,0,Senegal
62606,1/1/2023,SEN,Pulau Pinang,0,0,0,Senegal
62607,1/1/2023,SEN,Sabah,0,0,0,Senegal
62608,1/1/2023,SEN,Sarawak,0,0,0,Senegal
62609,1/1/2023,SEN,Selangor,24,17,7,Senegal
62610,1/1/2023,SGP,Johor,986919,567095,419824,Singapore
62611,1/1/2023,SGP,Kedah,3088,1644,1444,Singapore
62612,1/1/2023,SGP,Kelantan,70,50,20,Singapore
62613,1/1/2023,SGP,Melaka,16,14,2,Singapore
62614,1/1/2023,SGP,Negeri Sembilan,0,0,0,Singapore
62615,1/1/2023,SGP,Pahang,345,182,163,Singapore
62616,1/1/2023,SGP,Perak,4904,2430,2474,Singapore
62617,1/1/2023,SGP,Perlis,283,162,121,Singapore
62618,1/1/2023,SGP,Pulau Pinang,12369,6430,5939,Singapore
62619,1/1/2023,SGP,Sabah,2166,1159,1007,Singapore
62620,1/1/2023,SGP,Sarawak,3852,2138,1714,Singapore
62621,1/1/2023,SGP,Selangor,46820,23613,23207,Singapore
62622,1/1/2023,SGP,Terengganu,0,0,0,Singapore
62623,1/1/2023,SGP,W.P. Labuan,12,9,3,Singapore
62624,1/1/2023,SGS,Johor,0,0,0,South Georgia and the South Sandwich Islands
62625,1/1/2023,SGS,Sabah,0,0,0,South Georgia and the South Sandwich Islands
62626,1/1/2023,SGS,Selangor,0,0,0,South Georgia and the South Sandwich Islands
62627,1/1/2023,SHN,Sarawak,0,0,0,"Saint Helena, Ascension and Tristan da Cunha"
62628,1/1/2023,SLB,Johor,0,0,0,Solomon Islands
62629,1/1/2023,SLB,Perlis,0,0,0,Solomon Islands
62630,1/1/2023,SLB,Pulau Pinang,0,0,0,Solomon Islands
62631,1/1/2023,SLB,Sabah,0,0,0,Solomon Islands
62632,1/1/2023,SLB,Sarawak,8,0,8,Solomon Islands
62633,1/1/2023,SLB,Selangor,11,2,9,Solomon Islands
62634,1/1/2023,SLB,W.P. Labuan,0,0,0,Solomon Islands
62635,1/1/2023,SLE,Johor,3,1,2,Sierra Leone
62636,1/1/2023,SLE,Kedah,0,0,0,Sierra Leone
62637,1/1/2023,SLE,Perak,0,0,0,Sierra Leone
62638,1/1/2023,SLE,Pulau Pinang,0,0,0,Sierra Leone
62639,1/1/2023,SLE,Sabah,0,0,0,Sierra Leone
62640,1/1/2023,SLE,Selangor,21,14,7,Sierra Leone
62641,1/1/2023,SLV,Johor,1,1,0,El Salvador
62642,1/1/2023,SLV,Kedah,0,0,0,El Salvador
62643,1/1/2023,SLV,Perak,0,0,0,El Salvador
62644,1/1/2023,SLV,Perlis,0,0,0,El Salvador
62645,1/1/2023,SLV,Pulau Pinang,0,0,0,El Salvador
62646,1/1/2023,SLV,Sabah,0,0,0,El Salvador
62647,1/1/2023,SLV,Selangor,9,4,5,El Salvador
62648,1/1/2023,SLV,W.P. Labuan,0,0,0,El Salvador
62649,1/1/2023,SMR,Johor,0,0,0,San Marino
62650,1/1/2023,SMR,Selangor,2,2,0,San Marino
62651,1/1/2023,SOM,Johor,0,0,0,Somalia
62652,1/1/2023,SOM,Kedah,2,2,0,Somalia
62653,1/1/2023,SOM,Kelantan,0,0,0,Somalia
62654,1/1/2023,SOM,Perlis,0,0,0,Somalia
62655,1/1/2023,SOM,Sabah,0,0,0,Somalia
62656,1/1/2023,SOM,Sarawak,0,0,0,Somalia
62657,1/1/2023,SOM,Selangor,251,152,99,Somalia
62658,1/1/2023,SRB,Johor,7,3,4,Serbia
62659,1/1/2023,SRB,Kedah,3,2,1,Serbia
62660,1/1/2023,SRB,Kelantan,0,0,0,Serbia
62661,1/1/2023,SRB,Pahang,0,0,0,Serbia
62662,1/1/2023,SRB,Perak,0,0,0,Serbia
62663,1/1/2023,SRB,Perlis,0,0,0,Serbia
62664,1/1/2023,SRB,Pulau Pinang,0,0,0,Serbia
62665,1/1/2023,SRB,Sabah,0,0,0,Serbia
62666,1/1/2023,SRB,Sarawak,0,0,0,Serbia
62667,1/1/2023,SRB,Selangor,57,38,19,Serbia
62668,1/1/2023,STP,Selangor,3,3,0,Sao Tome and Principe
62669,1/1/2023,SUR,Johor,3,2,1,Suriname
62670,1/1/2023,SUR,Kedah,0,0,0,Suriname
62671,1/1/2023,SUR,Kelantan,1,1,0,Suriname
62672,1/1/2023,SUR,Perak,0,0,0,Suriname
62673,1/1/2023,SUR,Perlis,0,0,0,Suriname
62674,1/1/2023,SUR,Pulau Pinang,0,0,0,Suriname
62675,1/1/2023,SUR,Sabah,1,0,1,Suriname
62676,1/1/2023,SUR,Sarawak,0,0,0,Suriname
62677,1/1/2023,SUR,Selangor,6,4,2,Suriname
62678,1/1/2023,SVK,Johor,47,27,20,Slovakia
62679,1/1/2023,SVK,Kedah,129,72,57,Slovakia
62680,1/1/2023,SVK,Kelantan,2,1,1,Slovakia
62681,1/1/2023,SVK,Negeri Sembilan,0,0,0,Slovakia
62682,1/1/2023,SVK,Pahang,0,0,0,Slovakia
62683,1/1/2023,SVK,Perak,0,0,0,Slovakia
62684,1/1/2023,SVK,Perlis,8,5,3,Slovakia
62685,1/1/2023,SVK,Pulau Pinang,21,16,5,Slovakia
62686,1/1/2023,SVK,Sabah,11,7,4,Slovakia
62687,1/1/2023,SVK,Sarawak,2,1,1,Slovakia
62688,1/1/2023,SVK,Selangor,401,218,183,Slovakia
62689,1/1/2023,SVK,W.P. Labuan,2,1,1,Slovakia
62690,1/1/2023,SVN,Johor,21,12,9,Slovenia
62691,1/1/2023,SVN,Kedah,15,8,7,Slovenia
62692,1/1/2023,SVN,Kelantan,0,0,0,Slovenia
62693,1/1/2023,SVN,Perak,0,0,0,Slovenia
62694,1/1/2023,SVN,Perlis,0,0,0,Slovenia
62695,1/1/2023,SVN,Pulau Pinang,5,3,2,Slovenia
62696,1/1/2023,SVN,Sabah,1,0,1,Slovenia
62697,1/1/2023,SVN,Sarawak,1,0,1,Slovenia
62698,1/1/2023,SVN,Selangor,116,73,43,Slovenia
62699,1/1/2023,SVN,W.P. Labuan,0,0,0,Slovenia
62700,1/1/2023,SWE,Johor,272,157,115,Sweden
62701,1/1/2023,SWE,Kedah,423,206,217,Sweden
62702,1/1/2023,SWE,Kelantan,2,2,0,Sweden
62703,1/1/2023,SWE,Melaka,0,0,0,Sweden
62704,1/1/2023,SWE,Negeri Sembilan,0,0,0,Sweden
62705,1/1/2023,SWE,Pahang,0,0,0,Sweden
62706,1/1/2023,SWE,Perak,5,5,0,Sweden
62707,1/1/2023,SWE,Perlis,40,28,12,Sweden
62708,1/1/2023,SWE,Pulau Pinang,85,57,28,Sweden
62709,1/1/2023,SWE,Sabah,26,13,13,Sweden
62710,1/1/2023,SWE,Sarawak,9,5,4,Sweden
62711,1/1/2023,SWE,Selangor,1316,766,550,Sweden
62712,1/1/2023,SWE,W.P. Labuan,1,1,0,Sweden
62713,1/1/2023,SWZ,Johor,7,5,2,Swaziland
62714,1/1/2023,SWZ,Kedah,0,0,0,Swaziland
62715,1/1/2023,SWZ,Pulau Pinang,0,0,0,Swaziland
62716,1/1/2023,SWZ,Sabah,0,0,0,Swaziland
62717,1/1/2023,SWZ,Selangor,5,2,3,Swaziland
62718,1/1/2023,SYC,Johor,9,5,4,Seychelles
62719,1/1/2023,SYC,Kedah,0,0,0,Seychelles
62720,1/1/2023,SYC,Pulau Pinang,0,0,0,Seychelles
62721,1/1/2023,SYC,Sabah,0,0,0,Seychelles
62722,1/1/2023,SYC,Sarawak,0,0,0,Seychelles
62723,1/1/2023,SYC,Selangor,70,27,43,Seychelles
62724,1/1/2023,SYR,Johor,12,7,5,Syrian Arab Republic
62725,1/1/2023,SYR,Kedah,1,1,0,Syrian Arab Republic
62726,1/1/2023,SYR,Kelantan,0,0,0,Syrian Arab Republic
62727,1/1/2023,SYR,Pahang,0,0,0,Syrian Arab Republic
62728,1/1/2023,SYR,Perlis,0,0,0,Syrian Arab Republic
62729,1/1/2023,SYR,Pulau Pinang,1,1,0,Syrian Arab Republic
62730,1/1/2023,SYR,Sabah,4,1,3,Syrian Arab Republic
62731,1/1/2023,SYR,Sarawak,2,2,0,Syrian Arab Republic
62732,1/1/2023,SYR,Selangor,493,325,168,Syrian Arab Republic
62733,1/1/2023,SYR,W.P. Labuan,0,0,0,Syrian Arab Republic
62734,1/1/2023,TCA,Perlis,0,0,0,Turks and Caicos
62735,1/1/2023,TCD,Johor,0,0,0,Chad
62736,1/1/2023,TCD,Kedah,0,0,0,Chad
62737,1/1/2023,TCD,Perlis,0,0,0,Chad
62738,1/1/2023,TCD,Selangor,13,8,5,Chad
62739,1/1/2023,TGO,Johor,1,1,0,Togo
62740,1/1/2023,TGO,Perak,0,0,0,Togo
62741,1/1/2023,TGO,Pulau Pinang,0,0,0,Togo
62742,1/1/2023,TGO,Selangor,1,0,1,Togo
62743,1/1/2023,THA,Johor,6207,1770,4437,Thailand
62744,1/1/2023,THA,Kedah,62053,36668,25385,Thailand
62745,1/1/2023,THA,Kelantan,48524,25810,22714,Thailand
62746,1/1/2023,THA,Melaka,5,3,2,Thailand
62747,1/1/2023,THA,Negeri Sembilan,0,0,0,Thailand
62748,1/1/2023,THA,Pahang,0,0,0,Thailand
62749,1/1/2023,THA,Perak,8606,4001,4605,Thailand
62750,1/1/2023,THA,Perlis,54106,33481,20625,Thailand
62751,1/1/2023,THA,Pulau Pinang,1667,658,1009,Thailand
62752,1/1/2023,THA,Sabah,133,29,104,Thailand
62753,1/1/2023,THA,Sarawak,367,126,241,Thailand
62754,1/1/2023,THA,Selangor,9090,3460,5630,Thailand
62755,1/1/2023,THA,Terengganu,0,0,0,Thailand
62756,1/1/2023,THA,W.P. Labuan,5,2,3,Thailand
62757,1/1/2023,TJK,Johor,0,0,0,Tajikistan
62758,1/1/2023,TJK,Kedah,0,0,0,Tajikistan
62759,1/1/2023,TJK,Perlis,0,0,0,Tajikistan
62760,1/1/2023,TJK,Pulau Pinang,1,1,0,Tajikistan
62761,1/1/2023,TJK,Sabah,1,1,0,Tajikistan
62762,1/1/2023,TJK,Selangor,99,66,33,Tajikistan
62763,1/1/2023,TKL,Selangor,0,0,0,Tokelau
62764,1/1/2023,TKM,Johor,2,1,1,Turkmenistan
62765,1/1/2023,TKM,Kedah,1,1,0,Turkmenistan
62766,1/1/2023,TKM,Kelantan,0,0,0,Turkmenistan
62767,1/1/2023,TKM,Perlis,0,0,0,Turkmenistan
62768,1/1/2023,TKM,Pulau Pinang,0,0,0,Turkmenistan
62769,1/1/2023,TKM,Sabah,0,0,0,Turkmenistan
62770,1/1/2023,TKM,Sarawak,3,3,0,Turkmenistan
62771,1/1/2023,TKM,Selangor,107,55,52,Turkmenistan
62772,1/1/2023,TLS,Johor,4,1,3,Timor-Leste
62773,1/1/2023,TLS,Kedah,0,0,0,Timor-Leste
62774,1/1/2023,TLS,Perlis,0,0,0,Timor-Leste
62775,1/1/2023,TLS,Pulau Pinang,5,3,2,Timor-Leste
62776,1/1/2023,TLS,Sabah,4,4,0,Timor-Leste
62777,1/1/2023,TLS,Sarawak,2,0,2,Timor-Leste
62778,1/1/2023,TLS,Selangor,171,92,79,Timor-Leste
62779,1/1/2023,TON,Johor,0,0,0,Tonga
62780,1/1/2023,TON,Pulau Pinang,1,1,0,Tonga
62781,1/1/2023,TON,Sarawak,0,0,0,Tonga
62782,1/1/2023,TON,Selangor,13,8,5,Tonga
62783,1/1/2023,TTO,Johor,3,0,3,Trinidad and Tobago
62784,1/1/2023,TTO,Kedah,0,0,0,Trinidad and Tobago
62785,1/1/2023,TTO,Pahang,0,0,0,Trinidad and Tobago
62786,1/1/2023,TTO,Pulau Pinang,0,0,0,Trinidad and Tobago
62787,1/1/2023,TTO,Sabah,0,0,0,Trinidad and Tobago
62788,1/1/2023,TTO,Sarawak,2,0,2,Trinidad and Tobago
62789,1/1/2023,TTO,Selangor,21,14,7,Trinidad and Tobago
62790,1/1/2023,TUN,Johor,17,8,9,Tunisia
62791,1/1/2023,TUN,Kedah,5,3,2,Tunisia
62792,1/1/2023,TUN,Kelantan,0,0,0,Tunisia
62793,1/1/2023,TUN,Melaka,2,1,1,Tunisia
62794,1/1/2023,TUN,Perak,0,0,0,Tunisia
62795,1/1/2023,TUN,Perlis,0,0,0,Tunisia
62796,1/1/2023,TUN,Pulau Pinang,3,1,2,Tunisia
62797,1/1/2023,TUN,Sabah,2,1,1,Tunisia
62798,1/1/2023,TUN,Sarawak,2,0,2,Tunisia
62799,1/1/2023,TUN,Selangor,589,278,311,Tunisia
62800,1/1/2023,TUN,W.P. Labuan,0,0,0,Tunisia
62801,1/1/2023,TUR,Johor,251,167,84,Turkey
62802,1/1/2023,TUR,Kedah,56,35,21,Turkey
62803,1/1/2023,TUR,Kelantan,2,0,2,Turkey
62804,1/1/2023,TUR,Melaka,1,1,0,Turkey
62805,1/1/2023,TUR,Negeri Sembilan,0,0,0,Turkey
62806,1/1/2023,TUR,Pahang,1,0,1,Turkey
62807,1/1/2023,TUR,Perak,2,1,1,Turkey
62808,1/1/2023,TUR,Perlis,23,17,6,Turkey
62809,1/1/2023,TUR,Pulau Pinang,40,29,11,Turkey
62810,1/1/2023,TUR,Sabah,13,8,5,Turkey
62811,1/1/2023,TUR,Sarawak,24,18,6,Turkey
62812,1/1/2023,TUR,Selangor,952,648,304,Turkey
62813,1/1/2023,TUR,W.P. Labuan,0,0,0,Turkey
62814,1/1/2023,TUV,Selangor,0,0,0,Tuvalu
62815,1/1/2023,TWN,Johor,5464,2449,3015,Taiwan
62816,1/1/2023,TWN,Kedah,169,88,81,Taiwan
62817,1/1/2023,TWN,Kelantan,3,2,1,Taiwan
62818,1/1/2023,TWN,Melaka,1,1,0,Taiwan
62819,1/1/2023,TWN,Negeri Sembilan,0,0,0,Taiwan
62820,1/1/2023,TWN,Pahang,12,6,6,Taiwan
62821,1/1/2023,TWN,Perak,51,28,23,Taiwan
62822,1/1/2023,TWN,Perlis,32,14,18,Taiwan
62823,1/1/2023,TWN,Pulau Pinang,3376,1686,1690,Taiwan
62824,1/1/2023,TWN,Sabah,1244,553,691,Taiwan
62825,1/1/2023,TWN,Sarawak,483,192,291,Taiwan
62826,1/1/2023,TWN,Selangor,12199,5864,6335,Taiwan
62827,1/1/2023,TWN,W.P. Labuan,4,3,1,Taiwan
62828,1/1/2023,TZA,Johor,15,12,3,"Tanzania, United Republic of"
62829,1/1/2023,TZA,Kedah,2,2,0,"Tanzania, United Republic of"
62830,1/1/2023,TZA,Perak,0,0,0,"Tanzania, United Republic of"
62831,1/1/2023,TZA,Perlis,2,2,0,"Tanzania, United Republic of"
62832,1/1/2023,TZA,Pulau Pinang,0,0,0,"Tanzania, United Republic of"
62833,1/1/2023,TZA,Sabah,1,0,1,"Tanzania, United Republic of"
62834,1/1/2023,TZA,Sarawak,1,1,0,"Tanzania, United Republic of"
62835,1/1/2023,TZA,Selangor,119,51,68,"Tanzania, United Republic of"
62836,1/1/2023,UGA,Johor,25,9,16,Uganda
62837,1/1/2023,UGA,Kedah,3,0,3,Uganda
62838,1/1/2023,UGA,Perak,0,0,0,Uganda
62839,1/1/2023,UGA,Perlis,1,1,0,Uganda
62840,1/1/2023,UGA,Pulau Pinang,1,0,1,Uganda
62841,1/1/2023,UGA,Sabah,0,0,0,Uganda
62842,1/1/2023,UGA,Sarawak,0,0,0,Uganda
62843,1/1/2023,UGA,Selangor,69,33,36,Uganda
62844,1/1/2023,UKR,Johor,81,57,24,Ukraine
62845,1/1/2023,UKR,Kedah,70,32,38,Ukraine
62846,1/1/2023,UKR,Kelantan,2,2,0,Ukraine
62847,1/1/2023,UKR,Melaka,0,0,0,Ukraine
62848,1/1/2023,UKR,Negeri Sembilan,0,0,0,Ukraine
62849,1/1/2023,UKR,Pahang,3,2,1,Ukraine
62850,1/1/2023,UKR,Perak,2,1,1,Ukraine
62851,1/1/2023,UKR,Perlis,12,5,7,Ukraine
62852,1/1/2023,UKR,Pulau Pinang,34,18,16,Ukraine
62853,1/1/2023,UKR,Sabah,2,1,1,Ukraine
62854,1/1/2023,UKR,Sarawak,2,0,2,Ukraine
62855,1/1/2023,UKR,Selangor,1000,451,549,Ukraine
62856,1/1/2023,UKR,W.P. Labuan,0,0,0,Ukraine
62857,1/1/2023,URY,Johor,15,8,7,Uruguay
62858,1/1/2023,URY,Kedah,3,2,1,Uruguay
62859,1/1/2023,URY,Kelantan,2,1,1,Uruguay
62860,1/1/2023,URY,Perak,0,0,0,Uruguay
62861,1/1/2023,URY,Perlis,0,0,0,Uruguay
62862,1/1/2023,URY,Pulau Pinang,0,0,0,Uruguay
62863,1/1/2023,URY,Sabah,0,0,0,Uruguay
62864,1/1/2023,URY,Sarawak,0,0,0,Uruguay
62865,1/1/2023,URY,Selangor,49,23,26,Uruguay
62866,1/1/2023,URY,W.P. Labuan,0,0,0,Uruguay
62867,1/1/2023,USA,Johor,4101,2417,1684,United States Of America
62868,1/1/2023,USA,Kedah,577,303,274,United States Of America
62869,1/1/2023,USA,Kelantan,7,6,1,United States Of America
62870,1/1/2023,USA,Melaka,0,0,0,United States Of America
62871,1/1/2023,USA,Negeri Sembilan,0,0,0,United States Of America
62872,1/1/2023,USA,Pahang,6,5,1,United States Of America
62873,1/1/2023,USA,Perak,139,71,68,United States Of America
62874,1/1/2023,USA,Perlis,137,84,53,United States Of America
62875,1/1/2023,USA,Pulau Pinang,1739,1072,667,United States Of America
62876,1/1/2023,USA,Sabah,315,174,141,United States Of America
62877,1/1/2023,USA,Sarawak,251,144,107,United States Of America
62878,1/1/2023,USA,Selangor,13199,7574,5625,United States Of America
62879,1/1/2023,USA,Terengganu,0,0,0,United States Of America
62880,1/1/2023,USA,W.P. Labuan,12,8,4,United States Of America
62881,1/1/2023,UZB,Johor,93,78,15,Uzbekistan
62882,1/1/2023,UZB,Kedah,37,22,15,Uzbekistan
62883,1/1/2023,UZB,Kelantan,1,0,1,Uzbekistan
62884,1/1/2023,UZB,Perak,0,0,0,Uzbekistan
62885,1/1/2023,UZB,Perlis,2,1,1,Uzbekistan
62886,1/1/2023,UZB,Pulau Pinang,15,3,12,Uzbekistan
62887,1/1/2023,UZB,Sabah,6,4,2,Uzbekistan
62888,1/1/2023,UZB,Sarawak,2,1,1,Uzbekistan
62889,1/1/2023,UZB,Selangor,1930,1208,722,Uzbekistan
62890,1/1/2023,VAT,Johor,0,0,0,Holy See (Vatican City State)
62891,1/1/2023,VAT,Sarawak,0,0,0,Holy See (Vatican City State)
62892,1/1/2023,VAT,Selangor,0,0,0,Holy See (Vatican City State)
62893,1/1/2023,VCT,Johor,0,0,0,Saint Vincent and the Grenadines
62894,1/1/2023,VCT,Kedah,0,0,0,Saint Vincent and the Grenadines
62895,1/1/2023,VCT,Pulau Pinang,0,0,0,Saint Vincent and the Grenadines
62896,1/1/2023,VCT,Sarawak,0,0,0,Saint Vincent and the Grenadines
62897,1/1/2023,VCT,Selangor,4,1,3,Saint Vincent and the Grenadines
62898,1/1/2023,VEN,Johor,19,7,12,Venezuela
62899,1/1/2023,VEN,Kedah,1,0,1,Venezuela
62900,1/1/2023,VEN,Kelantan,0,0,0,Venezuela
62901,1/1/2023,VEN,Melaka,0,0,0,Venezuela
62902,1/1/2023,VEN,Perak,0,0,0,Venezuela
62903,1/1/2023,VEN,Perlis,0,0,0,Venezuela
62904,1/1/2023,VEN,Pulau Pinang,3,3,0,Venezuela
62905,1/1/2023,VEN,Sabah,0,0,0,Venezuela
62906,1/1/2023,VEN,Sarawak,1,1,0,Venezuela
62907,1/1/2023,VEN,Selangor,82,40,42,Venezuela
62908,1/1/2023,VEN,W.P. Labuan,0,0,0,Venezuela
62909,1/1/2023,VNM,Johor,9635,2835,6800,Vietnam
62910,1/1/2023,VNM,Kedah,287,48,239,Vietnam
62911,1/1/2023,VNM,Kelantan,7,3,4,Vietnam
62912,1/1/2023,VNM,Melaka,0,0,0,Vietnam
62913,1/1/2023,VNM,Negeri Sembilan,1,0,1,Vietnam
62914,1/1/2023,VNM,Pahang,3,1,2,Vietnam
62915,1/1/2023,VNM,Perak,79,3,76,Vietnam
62916,1/1/2023,VNM,Perlis,178,15,163,Vietnam
62917,1/1/2023,VNM,Pulau Pinang,1270,330,940,Vietnam
62918,1/1/2023,VNM,Sabah,18,4,14,Vietnam
62919,1/1/2023,VNM,Sarawak,158,33,125,Vietnam
62920,1/1/2023,VNM,Selangor,13425,4331,9094,Vietnam
62921,1/1/2023,VNM,Terengganu,0,0,0,Vietnam
62922,1/1/2023,VNM,W.P. Labuan,6,4,2,Vietnam
62923,1/1/2023,VUT,Johor,37,21,16,Vanuatu
62924,1/1/2023,VUT,Kedah,0,0,0,Vanuatu
62925,1/1/2023,VUT,Pulau Pinang,10,5,5,Vanuatu
62926,1/1/2023,VUT,Sabah,1,1,0,Vanuatu
62927,1/1/2023,VUT,Sarawak,0,0,0,Vanuatu
62928,1/1/2023,VUT,Selangor,39,34,5,Vanuatu
62929,1/1/2023,WSM,Johor,0,0,0,Samoa
62930,1/1/2023,WSM,Sarawak,0,0,0,Samoa
62931,1/1/2023,WSM,Selangor,0,0,0,Samoa
62932,1/1/2023,YEM,Johor,31,22,9,Yemen
62933,1/1/2023,YEM,Kedah,3,2,1,Yemen
62934,1/1/2023,YEM,Kelantan,4,4,0,Yemen
62935,1/1/2023,YEM,Melaka,5,3,2,Yemen
62936,1/1/2023,YEM,Pahang,0,0,0,Yemen
62937,1/1/2023,YEM,Perak,0,0,0,Yemen
62938,1/1/2023,YEM,Perlis,2,2,0,Yemen
62939,1/1/2023,YEM,Pulau Pinang,1,1,0,Yemen
62940,1/1/2023,YEM,Sabah,2,2,0,Yemen
62941,1/1/2023,YEM,Sarawak,0,0,0,Yemen
62942,1/1/2023,YEM,Selangor,1064,746,318,Yemen
62943,1/1/2023,YEM,W.P. Labuan,0,0,0,Yemen
62944,1/1/2023,ZAF,Johor,279,159,120,South Africa
62945,1/1/2023,ZAF,Kedah,75,41,34,South Africa
62946,1/1/2023,ZAF,Kelantan,0,0,0,South Africa
62947,1/1/2023,ZAF,Melaka,1,1,0,South Africa
62948,1/1/2023,ZAF,Pahang,2,0,2,South Africa
62949,1/1/2023,ZAF,Perak,2,2,0,South Africa
62950,1/1/2023,ZAF,Perlis,10,4,6,South Africa
62951,1/1/2023,ZAF,Pulau Pinang,42,24,18,South Africa
62952,1/1/2023,ZAF,Sabah,10,7,3,South Africa
62953,1/1/2023,ZAF,Sarawak,43,27,16,South Africa
62954,1/1/2023,ZAF,Selangor,1194,621,573,South Africa
62955,1/1/2023,ZAF,Terengganu,0,0,0,South Africa
62956,1/1/2023,ZAF,W.P. Labuan,16,7,9,South Africa
62957,1/1/2023,ZMB,Johor,2,1,1,Zambia
62958,1/1/2023,ZMB,Kedah,0,0,0,Zambia
62959,1/1/2023,ZMB,Perak,0,0,0,Zambia
62960,1/1/2023,ZMB,Perlis,0,0,0,Zambia
62961,1/1/2023,ZMB,Pulau Pinang,0,0,0,Zambia
62962,1/1/2023,ZMB,Sabah,0,0,0,Zambia
62963,1/1/2023,ZMB,Sarawak,0,0,0,Zambia
62964,1/1/2023,ZMB,Selangor,67,38,29,Zambia
62965,1/1/2023,ZWE,Johor,6,4,2,Zimbabwe
62966,1/1/2023,ZWE,Kedah,0,0,0,Zimbabwe
62967,1/1/2023,ZWE,Kelantan,0,0,0,Zimbabwe
62968,1/1/2023,ZWE,Perak,0,0,0,Zimbabwe
62969,1/1/2023,ZWE,Perlis,0,0,0,Zimbabwe
62970,1/1/2023,ZWE,Pulau Pinang,0,0,0,Zimbabwe
62971,1/1/2023,ZWE,Sabah,0,0,0,Zimbabwe
62972,1/1/2023,ZWE,Sarawak,0,0,0,Zimbabwe
62973,1/1/2023,ZWE,Selangor,119,59,60,Zimbabwe
62974,2/1/2023,ABW,Kedah,0,0,0,Aruba
62975,2/1/2023,ABW,Pulau Pinang,0,0,0,Aruba
62976,2/1/2023,AFG,Johor,0,0,0,Afghanistan
62977,2/1/2023,AFG,Kedah,0,0,0,Afghanistan
62978,2/1/2023,AFG,Perlis,0,0,0,Afghanistan
62979,2/1/2023,AFG,Pulau Pinang,0,0,0,Afghanistan
62980,2/1/2023,AFG,Sarawak,1,1,0,Afghanistan
62981,2/1/2023,AFG,Selangor,39,35,4,Afghanistan
62982,2/1/2023,AGO,Johor,0,0,0,Angola
62983,2/1/2023,AGO,Kedah,0,0,0,Angola
62984,2/1/2023,AGO,Sabah,0,0,0,Angola
62985,2/1/2023,AGO,Selangor,5,4,1,Angola
62986,2/1/2023,AIA,Selangor,0,0,0,Anguilla
62987,2/1/2023,ALB,Johor,9,7,2,Albania
62988,2/1/2023,ALB,Kedah,3,3,0,Albania
62989,2/1/2023,ALB,Perak,0,0,0,Albania
62990,2/1/2023,ALB,Perlis,1,0,1,Albania
62991,2/1/2023,ALB,Pulau Pinang,1,1,0,Albania
62992,2/1/2023,ALB,Sabah,0,0,0,Albania
62993,2/1/2023,ALB,Sarawak,0,0,0,Albania
62994,2/1/2023,ALB,Selangor,23,15,8,Albania
62995,2/1/2023,AND,Johor,0,0,0,Andorra
62996,2/1/2023,AND,Kedah,0,0,0,Andorra
62997,2/1/2023,AND,Perlis,0,0,0,Andorra
62998,2/1/2023,AND,Pulau Pinang,0,0,0,Andorra
62999,2/1/2023,AND,Selangor,5,3,2,Andorra
63000,2/1/2023,ANT,Selangor,0,0,0,Netherlands Antilles
63001,2/1/2023,ARE,Johor,9,6,3,United Arab Emirates
63002,2/1/2023,ARE,Kedah,0,0,0,United Arab Emirates
63003,2/1/2023,ARE,Kelantan,0,0,0,United Arab Emirates
63004,2/1/2023,ARE,Perak,0,0,0,United Arab Emirates
63005,2/1/2023,ARE,Perlis,0,0,0,United Arab Emirates
63006,2/1/2023,ARE,Pulau Pinang,2,2,0,United Arab Emirates
63007,2/1/2023,ARE,Sabah,1,1,0,United Arab Emirates
63008,2/1/2023,ARE,Sarawak,0,0,0,United Arab Emirates
63009,2/1/2023,ARE,Selangor,274,188,86,United Arab Emirates
63010,2/1/2023,ARG,Johor,70,46,24,Argentina
63011,2/1/2023,ARG,Kedah,71,34,37,Argentina
63012,2/1/2023,ARG,Kelantan,0,0,0,Argentina
63013,2/1/2023,ARG,Melaka,0,0,0,Argentina
63014,2/1/2023,ARG,Perak,0,0,0,Argentina
63015,2/1/2023,ARG,Perlis,5,3,2,Argentina
63016,2/1/2023,ARG,Pulau Pinang,4,2,2,Argentina
63017,2/1/2023,ARG,Sabah,3,2,1,Argentina
63018,2/1/2023,ARG,Sarawak,2,1,1,Argentina
63019,2/1/2023,ARG,Selangor,301,175,126,Argentina
63020,2/1/2023,ARG,W.P. Labuan,0,0,0,Argentina
63021,2/1/2023,ARM,Johor,0,0,0,Armenia
63022,2/1/2023,ARM,Kedah,1,0,1,Armenia
63023,2/1/2023,ARM,Kelantan,0,0,0,Armenia
63024,2/1/2023,ARM,Perak,0,0,0,Armenia
63025,2/1/2023,ARM,Perlis,0,0,0,Armenia
63026,2/1/2023,ARM,Pulau Pinang,4,1,3,Armenia
63027,2/1/2023,ARM,Sabah,3,1,2,Armenia
63028,2/1/2023,ARM,Sarawak,0,0,0,Armenia
63029,2/1/2023,ARM,Selangor,37,18,19,Armenia
63030,2/1/2023,ATA,Selangor,0,0,0,Antarctica
63031,2/1/2023,ATG,Johor,3,2,1,Antigua and Barbuda
63032,2/1/2023,ATG,Kedah,0,0,0,Antigua and Barbuda
63033,2/1/2023,ATG,Pulau Pinang,0,0,0,Antigua and Barbuda
63034,2/1/2023,ATG,Sarawak,0,0,0,Antigua and Barbuda
63035,2/1/2023,ATG,Selangor,12,9,3,Antigua and Barbuda
63036,2/1/2023,AUS,Johor,4214,2536,1678,Australia
63037,2/1/2023,AUS,Kedah,509,280,229,Australia
63038,2/1/2023,AUS,Kelantan,4,4,0,Australia
63039,2/1/2023,AUS,Melaka,4,4,0,Australia
63040,2/1/2023,AUS,Negeri Sembilan,1,1,0,Australia
63041,2/1/2023,AUS,Pahang,1,1,0,Australia
63042,2/1/2023,AUS,Perak,218,118,100,Australia
63043,2/1/2023,AUS,Perlis,81,54,27,Australia
63044,2/1/2023,AUS,Pulau Pinang,1650,914,736,Australia
63045,2/1/2023,AUS,Sabah,272,136,136,Australia
63046,2/1/2023,AUS,Sarawak,501,282,219,Australia
63047,2/1/2023,AUS,Selangor,15945,9512,6433,Australia
63048,2/1/2023,AUS,Terengganu,0,0,0,Australia
63049,2/1/2023,AUS,W.P. Labuan,13,7,6,Australia
63050,2/1/2023,AUT,Johor,178,97,81,Austria
63051,2/1/2023,AUT,Kedah,174,99,75,Austria
63052,2/1/2023,AUT,Kelantan,3,3,0,Austria
63053,2/1/2023,AUT,Melaka,1,1,0,Austria
63054,2/1/2023,AUT,Negeri Sembilan,0,0,0,Austria
63055,2/1/2023,AUT,Pahang,0,0,0,Austria
63056,2/1/2023,AUT,Perak,4,2,2,Austria
63057,2/1/2023,AUT,Perlis,28,21,7,Austria
63058,2/1/2023,AUT,Pulau Pinang,84,43,41,Austria
63059,2/1/2023,AUT,Sabah,15,9,6,Austria
63060,2/1/2023,AUT,Sarawak,11,7,4,Austria
63061,2/1/2023,AUT,Selangor,878,528,350,Austria
63062,2/1/2023,AUT,Terengganu,0,0,0,Austria
63063,2/1/2023,AUT,W.P. Labuan,4,4,0,Austria
63064,2/1/2023,AZE,Johor,2,2,0,Azerbaijan
63065,2/1/2023,AZE,Kedah,1,1,0,Azerbaijan
63066,2/1/2023,AZE,Kelantan,0,0,0,Azerbaijan
63067,2/1/2023,AZE,Melaka,0,0,0,Azerbaijan
63068,2/1/2023,AZE,Perlis,0,0,0,Azerbaijan
63069,2/1/2023,AZE,Pulau Pinang,2,2,0,Azerbaijan
63070,2/1/2023,AZE,Sabah,1,1,0,Azerbaijan
63071,2/1/2023,AZE,Sarawak,2,1,1,Azerbaijan
63072,2/1/2023,AZE,Selangor,69,41,28,Azerbaijan
63073,2/1/2023,AZE,W.P. Labuan,0,0,0,Azerbaijan
63074,2/1/2023,BDI,Pulau Pinang,0,0,0,Burundi
63075,2/1/2023,BDI,Sarawak,0,0,0,Burundi
63076,2/1/2023,BDI,Selangor,3,2,1,Burundi
63077,2/1/2023,BEL,Johor,231,159,72,Belgium
63078,2/1/2023,BEL,Kedah,121,60,61,Belgium
63079,2/1/2023,BEL,Kelantan,1,1,0,Belgium
63080,2/1/2023,BEL,Melaka,1,1,0,Belgium
63081,2/1/2023,BEL,Negeri Sembilan,1,0,1,Belgium
63082,2/1/2023,BEL,Pahang,5,3,2,Belgium
63083,2/1/2023,BEL,Perak,7,4,3,Belgium
63084,2/1/2023,BEL,Perlis,29,14,15,Belgium
63085,2/1/2023,BEL,Pulau Pinang,50,40,10,Belgium
63086,2/1/2023,BEL,Sabah,21,10,11,Belgium
63087,2/1/2023,BEL,Sarawak,29,12,17,Belgium
63088,2/1/2023,BEL,Selangor,979,624,355,Belgium
63089,2/1/2023,BEL,W.P. Labuan,0,0,0,Belgium
63090,2/1/2023,BEN,Johor,1,1,0,Benin
63091,2/1/2023,BEN,Kedah,0,0,0,Benin
63092,2/1/2023,BEN,Perak,0,0,0,Benin
63093,2/1/2023,BEN,Pulau Pinang,0,0,0,Benin
63094,2/1/2023,BEN,Sabah,0,0,0,Benin
63095,2/1/2023,BEN,Sarawak,1,1,0,Benin
63096,2/1/2023,BEN,Selangor,5,4,1,Benin
63097,2/1/2023,BFA,Perak,0,0,0,Burkina Faso
63098,2/1/2023,BFA,Pulau Pinang,0,0,0,Burkina Faso
63099,2/1/2023,BFA,Selangor,4,4,0,Burkina Faso
63100,2/1/2023,BGD,Johor,2295,1920,375,Bangladesh
63101,2/1/2023,BGD,Kedah,37,18,19,Bangladesh
63102,2/1/2023,BGD,Kelantan,1,1,0,Bangladesh
63103,2/1/2023,BGD,Melaka,1,1,0,Bangladesh
63104,2/1/2023,BGD,Negeri Sembilan,0,0,0,Bangladesh
63105,2/1/2023,BGD,Pahang,0,0,0,Bangladesh
63106,2/1/2023,BGD,Perak,17,17,0,Bangladesh
63107,2/1/2023,BGD,Perlis,4,4,0,Bangladesh
63108,2/1/2023,BGD,Pulau Pinang,648,636,12,Bangladesh
63109,2/1/2023,BGD,Sabah,2,2,0,Bangladesh
63110,2/1/2023,BGD,Sarawak,28,26,2,Bangladesh
63111,2/1/2023,BGD,Selangor,56313,54724,1589,Bangladesh
63112,2/1/2023,BGD,W.P. Labuan,4,4,0,Bangladesh
63113,2/1/2023,BGR,Johor,44,27,17,Bulgaria
63114,2/1/2023,BGR,Kedah,21,11,10,Bulgaria
63115,2/1/2023,BGR,Kelantan,0,0,0,Bulgaria
63116,2/1/2023,BGR,Pahang,0,0,0,Bulgaria
63117,2/1/2023,BGR,Perak,1,0,1,Bulgaria
63118,2/1/2023,BGR,Perlis,5,4,1,Bulgaria
63119,2/1/2023,BGR,Pulau Pinang,14,7,7,Bulgaria
63120,2/1/2023,BGR,Sabah,4,1,3,Bulgaria
63121,2/1/2023,BGR,Sarawak,2,1,1,Bulgaria
63122,2/1/2023,BGR,Selangor,250,140,110,Bulgaria
63123,2/1/2023,BGR,W.P. Labuan,0,0,0,Bulgaria
63124,2/1/2023,BHR,Johor,6,3,3,Bahrain
63125,2/1/2023,BHR,Kedah,2,2,0,Bahrain
63126,2/1/2023,BHR,Kelantan,1,1,0,Bahrain
63127,2/1/2023,BHR,Perlis,1,1,0,Bahrain
63128,2/1/2023,BHR,Pulau Pinang,3,3,0,Bahrain
63129,2/1/2023,BHR,Sabah,0,0,0,Bahrain
63130,2/1/2023,BHR,Sarawak,0,0,0,Bahrain
63131,2/1/2023,BHR,Selangor,105,56,49,Bahrain
63132,2/1/2023,BHS,Johor,5,1,4,Bahamas
63133,2/1/2023,BHS,Kedah,0,0,0,Bahamas
63134,2/1/2023,BHS,Perak,0,0,0,Bahamas
63135,2/1/2023,BHS,Sabah,0,0,0,Bahamas
63136,2/1/2023,BHS,Sarawak,0,0,0,Bahamas
63137,2/1/2023,BHS,Selangor,3,3,0,Bahamas
63138,2/1/2023,BIH,Johor,10,7,3,Bosnia and Herzegovina
63139,2/1/2023,BIH,Kedah,0,0,0,Bosnia and Herzegovina
63140,2/1/2023,BIH,Perlis,0,0,0,Bosnia and Herzegovina
63141,2/1/2023,BIH,Pulau Pinang,3,1,2,Bosnia and Herzegovina
63142,2/1/2023,BIH,Sabah,0,0,0,Bosnia and Herzegovina
63143,2/1/2023,BIH,Sarawak,1,1,0,Bosnia and Herzegovina
63144,2/1/2023,BIH,Selangor,55,32,23,Bosnia and Herzegovina
63145,2/1/2023,BLR,Johor,6,2,4,Belarus
63146,2/1/2023,BLR,Kedah,10,4,6,Belarus
63147,2/1/2023,BLR,Kelantan,2,2,0,Belarus
63148,2/1/2023,BLR,Pahang,0,0,0,Belarus
63149,2/1/2023,BLR,Perak,0,0,0,Belarus
63150,2/1/2023,BLR,Perlis,8,4,4,Belarus
63151,2/1/2023,BLR,Pulau Pinang,11,4,7,Belarus
63152,2/1/2023,BLR,Sabah,0,0,0,Belarus
63153,2/1/2023,BLR,Sarawak,0,0,0,Belarus
63154,2/1/2023,BLR,Selangor,476,237,239,Belarus
63155,2/1/2023,BLR,W.P. Labuan,0,0,0,Belarus
63156,2/1/2023,BLZ,Johor,7,3,4,Belize
63157,2/1/2023,BLZ,Pulau Pinang,0,0,0,Belize
63158,2/1/2023,BLZ,Sarawak,0,0,0,Belize
63159,2/1/2023,BLZ,Selangor,5,4,1,Belize
63160,2/1/2023,BMU,Selangor,0,0,0,Bermuda
63161,2/1/2023,BOL,Johor,1,0,1,Bolivia
63162,2/1/2023,BOL,Kedah,0,0,0,Bolivia
63163,2/1/2023,BOL,Melaka,0,0,0,Bolivia
63164,2/1/2023,BOL,Perak,0,0,0,Bolivia
63165,2/1/2023,BOL,Perlis,0,0,0,Bolivia
63166,2/1/2023,BOL,Pulau Pinang,0,0,0,Bolivia
63167,2/1/2023,BOL,Sabah,1,1,0,Bolivia
63168,2/1/2023,BOL,Sarawak,2,0,2,Bolivia
63169,2/1/2023,BOL,Selangor,12,6,6,Bolivia
63170,2/1/2023,BRA,Johor,155,91,64,Brazil
63171,2/1/2023,BRA,Kedah,72,34,38,Brazil
63172,2/1/2023,BRA,Kelantan,0,0,0,Brazil
63173,2/1/2023,BRA,Melaka,0,0,0,Brazil
63174,2/1/2023,BRA,Pahang,0,0,0,Brazil
63175,2/1/2023,BRA,Perak,1,0,1,Brazil
63176,2/1/2023,BRA,Perlis,5,2,3,Brazil
63177,2/1/2023,BRA,Pulau Pinang,27,14,13,Brazil
63178,2/1/2023,BRA,Sabah,7,6,1,Brazil
63179,2/1/2023,BRA,Sarawak,5,3,2,Brazil
63180,2/1/2023,BRA,Selangor,694,401,293,Brazil
63181,2/1/2023,BRA,W.P. Labuan,2,1,1,Brazil
63182,2/1/2023,BRB,Johor,0,0,0,Barbados
63183,2/1/2023,BRB,Kedah,0,0,0,Barbados
63184,2/1/2023,BRB,Perlis,0,0,0,Barbados
63185,2/1/2023,BRB,Pulau Pinang,0,0,0,Barbados
63186,2/1/2023,BRB,Selangor,4,2,2,Barbados
63187,2/1/2023,BRN,Johor,446,224,222,Brunei Darussalam
63188,2/1/2023,BRN,Kedah,23,15,8,Brunei Darussalam
63189,2/1/2023,BRN,Kelantan,1,1,0,Brunei Darussalam
63190,2/1/2023,BRN,Melaka,0,0,0,Brunei Darussalam
63191,2/1/2023,BRN,Pahang,0,0,0,Brunei Darussalam
63192,2/1/2023,BRN,Perak,7,7,0,Brunei Darussalam
63193,2/1/2023,BRN,Perlis,8,2,6,Brunei Darussalam
63194,2/1/2023,BRN,Pulau Pinang,11,8,3,Brunei Darussalam
63195,2/1/2023,BRN,Sabah,754,313,441,Brunei Darussalam
63196,2/1/2023,BRN,Sarawak,84606,46519,38087,Brunei Darussalam
63197,2/1/2023,BRN,Selangor,4262,2120,2142,Brunei Darussalam
63198,2/1/2023,BRN,W.P. Labuan,1362,910,452,Brunei Darussalam
63199,2/1/2023,BTN,Johor,4,4,0,Bhutan
63200,2/1/2023,BTN,Kedah,0,0,0,Bhutan
63201,2/1/2023,BTN,Perak,0,0,0,Bhutan
63202,2/1/2023,BTN,Perlis,0,0,0,Bhutan
63203,2/1/2023,BTN,Pulau Pinang,3,2,1,Bhutan
63204,2/1/2023,BTN,Sabah,0,0,0,Bhutan
63205,2/1/2023,BTN,Sarawak,0,0,0,Bhutan
63206,2/1/2023,BTN,Selangor,18,12,6,Bhutan
63207,2/1/2023,BWA,Johor,0,0,0,Botswana
63208,2/1/2023,BWA,Kedah,0,0,0,Botswana
63209,2/1/2023,BWA,Perlis,0,0,0,Botswana
63210,2/1/2023,BWA,Pulau Pinang,0,0,0,Botswana
63211,2/1/2023,BWA,Sabah,0,0,0,Botswana
63212,2/1/2023,BWA,Sarawak,0,0,0,Botswana
63213,2/1/2023,BWA,Selangor,12,2,10,Botswana
63214,2/1/2023,CAF,Kedah,0,0,0,Central African Republic
63215,2/1/2023,CAF,Selangor,0,0,0,Central African Republic
63216,2/1/2023,CAN,Johor,1490,814,676,Canada
63217,2/1/2023,CAN,Kedah,343,179,164,Canada
63218,2/1/2023,CAN,Kelantan,2,1,1,Canada
63219,2/1/2023,CAN,Melaka,0,0,0,Canada
63220,2/1/2023,CAN,Negeri Sembilan,0,0,0,Canada
63221,2/1/2023,CAN,Pahang,1,1,0,Canada
63222,2/1/2023,CAN,Perak,43,25,18,Canada
63223,2/1/2023,CAN,Perlis,82,50,32,Canada
63224,2/1/2023,CAN,Pulau Pinang,646,339,307,Canada
63225,2/1/2023,CAN,Sabah,183,99,84,Canada
63226,2/1/2023,CAN,Sarawak,400,222,178,Canada
63227,2/1/2023,CAN,Selangor,4360,2563,1797,Canada
63228,2/1/2023,CAN,Terengganu,0,0,0,Canada
63229,2/1/2023,CAN,W.P. Labuan,9,6,3,Canada
63230,2/1/2023,CCK,Selangor,0,0,0,Cocos (Keeling) Islands
63231,2/1/2023,CHE,Johor,335,198,137,Switzerland
63232,2/1/2023,CHE,Kedah,218,111,107,Switzerland
63233,2/1/2023,CHE,Kelantan,3,3,0,Switzerland
63234,2/1/2023,CHE,Melaka,0,0,0,Switzerland
63235,2/1/2023,CHE,Negeri Sembilan,0,0,0,Switzerland
63236,2/1/2023,CHE,Pahang,0,0,0,Switzerland
63237,2/1/2023,CHE,Perak,9,5,4,Switzerland
63238,2/1/2023,CHE,Perlis,52,35,17,Switzerland
63239,2/1/2023,CHE,Pulau Pinang,151,91,60,Switzerland
63240,2/1/2023,CHE,Sabah,28,14,14,Switzerland
63241,2/1/2023,CHE,Sarawak,43,19,24,Switzerland
63242,2/1/2023,CHE,Selangor,1268,749,519,Switzerland
63243,2/1/2023,CHE,W.P. Labuan,2,2,0,Switzerland
63244,2/1/2023,CHL,Johor,27,9,18,Chile
63245,2/1/2023,CHL,Kedah,22,11,11,Chile
63246,2/1/2023,CHL,Kelantan,1,0,1,Chile
63247,2/1/2023,CHL,Melaka,0,0,0,Chile
63248,2/1/2023,CHL,Pahang,0,0,0,Chile
63249,2/1/2023,CHL,Perak,0,0,0,Chile
63250,2/1/2023,CHL,Perlis,4,2,2,Chile
63251,2/1/2023,CHL,Pulau Pinang,5,1,4,Chile
63252,2/1/2023,CHL,Sabah,4,2,2,Chile
63253,2/1/2023,CHL,Sarawak,1,1,0,Chile
63254,2/1/2023,CHL,Selangor,266,128,138,Chile
63255,2/1/2023,CHN,Johor,19461,8292,11169,China
63256,2/1/2023,CHN,Kedah,477,195,282,China
63257,2/1/2023,CHN,Kelantan,2,0,2,China
63258,2/1/2023,CHN,Melaka,0,0,0,China
63259,2/1/2023,CHN,Pahang,1,1,0,China
63260,2/1/2023,CHN,Perak,193,79,114,China
63261,2/1/2023,CHN,Perlis,64,42,22,China
63262,2/1/2023,CHN,Pulau Pinang,3144,1682,1462,China
63263,2/1/2023,CHN,Sabah,1049,560,489,China
63264,2/1/2023,CHN,Sarawak,600,315,285,China
63265,2/1/2023,CHN,Selangor,39835,23650,16185,China
63266,2/1/2023,CHN,Terengganu,0,0,0,China
63267,2/1/2023,CHN,W.P. Labuan,66,61,5,China
63268,2/1/2023,CIV,Johor,1,0,1,C��te d'Iv
63269,2/1/2023,CIV,Kedah,0,0,0,C��te d'Iv
63270,2/1/2023,CIV,Pulau Pinang,0,0,0,C��te d'Iv
63271,2/1/2023,CIV,Sabah,0,0,0,C��te d'Iv
63272,2/1/2023,CIV,Sarawak,0,0,0,C��te d'Iv
63273,2/1/2023,CIV,Selangor,26,21,5,C��te d'Iv
63274,2/1/2023,CMR,Johor,0,0,0,Cameroon
63275,2/1/2023,CMR,Kedah,0,0,0,Cameroon
63276,2/1/2023,CMR,Pulau Pinang,1,1,0,Cameroon
63277,2/1/2023,CMR,Sabah,0,0,0,Cameroon
63278,2/1/2023,CMR,Sarawak,0,0,0,Cameroon
63279,2/1/2023,CMR,Selangor,15,10,5,Cameroon
63280,2/1/2023,COD,Johor,3,3,0,"Congo, the Democratic Republic of the"
63281,2/1/2023,COD,Pulau Pinang,0,0,0,"Congo, the Democratic Republic of the"
63282,2/1/2023,COD,Sarawak,0,0,0,"Congo, the Democratic Republic of the"
63283,2/1/2023,COD,Selangor,3,3,0,"Congo, the Democratic Republic of the"
63284,2/1/2023,COG,Johor,0,0,0,Congo
63285,2/1/2023,COG,Kedah,0,0,0,Congo
63286,2/1/2023,COG,Selangor,2,2,0,Congo
63287,2/1/2023,COK,Selangor,0,0,0,Cook Islands
63288,2/1/2023,COL,Johor,25,13,12,Colombia
63289,2/1/2023,COL,Kedah,0,0,0,Colombia
63290,2/1/2023,COL,Perak,0,0,0,Colombia
63291,2/1/2023,COL,Pulau Pinang,1,0,1,Colombia
63292,2/1/2023,COL,Sabah,1,1,0,Colombia
63293,2/1/2023,COL,Sarawak,0,0,0,Colombia
63294,2/1/2023,COL,Selangor,103,54,49,Colombia
63295,2/1/2023,COL,W.P. Labuan,0,0,0,Colombia
63296,2/1/2023,COM,Johor,5,3,2,Comoros
63297,2/1/2023,COM,Kedah,0,0,0,Comoros
63298,2/1/2023,COM,Selangor,17,6,11,Comoros
63299,2/1/2023,CPV,Johor,0,0,0,Cape Verde
63300,2/1/2023,CPV,Kedah,0,0,0,Cape Verde
63301,2/1/2023,CPV,Pulau Pinang,0,0,0,Cape Verde
63302,2/1/2023,CPV,Sabah,1,1,0,Cape Verde
63303,2/1/2023,CPV,Selangor,1,1,0,Cape Verde
63304,2/1/2023,CRI,Johor,3,2,1,Costa Rica
63305,2/1/2023,CRI,Kedah,1,0,1,Costa Rica
63306,2/1/2023,CRI,Perak,0,0,0,Costa Rica
63307,2/1/2023,CRI,Perlis,0,0,0,Costa Rica
63308,2/1/2023,CRI,Pulau Pinang,2,1,1,Costa Rica
63309,2/1/2023,CRI,Sabah,0,0,0,Costa Rica
63310,2/1/2023,CRI,Sarawak,0,0,0,Costa Rica
63311,2/1/2023,CRI,Selangor,44,28,16,Costa Rica
63312,2/1/2023,CUB,Johor,3,2,1,Cuba
63313,2/1/2023,CUB,Kedah,0,0,0,Cuba
63314,2/1/2023,CUB,Perlis,0,0,0,Cuba
63315,2/1/2023,CUB,Pulau Pinang,0,0,0,Cuba
63316,2/1/2023,CUB,Sabah,1,0,1,Cuba
63317,2/1/2023,CUB,Sarawak,0,0,0,Cuba
63318,2/1/2023,CUB,Selangor,15,7,8,Cuba
63319,2/1/2023,CYP,Johor,11,9,2,Cyprus
63320,2/1/2023,CYP,Kedah,2,1,1,Cyprus
63321,2/1/2023,CYP,Perak,0,0,0,Cyprus
63322,2/1/2023,CYP,Perlis,0,0,0,Cyprus
63323,2/1/2023,CYP,Pulau Pinang,2,1,1,Cyprus
63324,2/1/2023,CYP,Sabah,0,0,0,Cyprus
63325,2/1/2023,CYP,Sarawak,0,0,0,Cyprus
63326,2/1/2023,CYP,Selangor,32,21,11,Cyprus
63327,2/1/2023,CZE,Johor,143,74,69,Czech Republic
63328,2/1/2023,CZE,Kedah,170,89,81,Czech Republic
63329,2/1/2023,CZE,Kelantan,3,3,0,Czech Republic
63330,2/1/2023,CZE,Melaka,0,0,0,Czech Republic
63331,2/1/2023,CZE,Negeri Sembilan,0,0,0,Czech Republic
63332,2/1/2023,CZE,Perak,1,0,1,Czech Republic
63333,2/1/2023,CZE,Perlis,10,3,7,Czech Republic
63334,2/1/2023,CZE,Pulau Pinang,29,17,12,Czech Republic
63335,2/1/2023,CZE,Sabah,18,12,6,Czech Republic
63336,2/1/2023,CZE,Sarawak,11,7,4,Czech Republic
63337,2/1/2023,CZE,Selangor,629,372,257,Czech Republic
63338,2/1/2023,CZE,W.P. Labuan,6,3,3,Czech Republic
63339,2/1/2023,DEU,Johor,2361,1448,913,Germany
63340,2/1/2023,DEU,Kedah,1167,570,597,Germany
63341,2/1/2023,DEU,Kelantan,18,13,5,Germany
63342,2/1/2023,DEU,Melaka,6,5,1,Germany
63343,2/1/2023,DEU,Negeri Sembilan,0,0,0,Germany
63344,2/1/2023,DEU,Pahang,5,4,1,Germany
63345,2/1/2023,DEU,Perak,27,18,9,Germany
63346,2/1/2023,DEU,Perlis,235,142,93,Germany
63347,2/1/2023,DEU,Pulau Pinang,847,578,269,Germany
63348,2/1/2023,DEU,Sabah,138,84,54,Germany
63349,2/1/2023,DEU,Sarawak,245,141,104,Germany
63350,2/1/2023,DEU,Selangor,8981,5352,3629,Germany
63351,2/1/2023,DEU,Terengganu,0,0,0,Germany
63352,2/1/2023,DEU,W.P. Labuan,17,12,5,Germany
63353,2/1/2023,DJI,Johor,0,0,0,Djibouti
63354,2/1/2023,DJI,Selangor,5,3,2,Djibouti
63355,2/1/2023,DMA,Johor,4,4,0,Dominica
63356,2/1/2023,DMA,Kedah,0,0,0,Dominica
63357,2/1/2023,DMA,Pulau Pinang,1,1,0,Dominica
63358,2/1/2023,DMA,Sabah,0,0,0,Dominica
63359,2/1/2023,DMA,Sarawak,0,0,0,Dominica
63360,2/1/2023,DMA,Selangor,37,28,9,Dominica
63361,2/1/2023,DMA,W.P. Labuan,0,0,0,Dominica
63362,2/1/2023,DNK,Johor,321,219,102,Denmark
63363,2/1/2023,DNK,Kedah,368,178,190,Denmark
63364,2/1/2023,DNK,Kelantan,0,0,0,Denmark
63365,2/1/2023,DNK,Melaka,0,0,0,Denmark
63366,2/1/2023,DNK,Negeri Sembilan,3,3,0,Denmark
63367,2/1/2023,DNK,Pahang,0,0,0,Denmark
63368,2/1/2023,DNK,Perak,10,4,6,Denmark
63369,2/1/2023,DNK,Perlis,21,16,5,Denmark
63370,2/1/2023,DNK,Pulau Pinang,82,56,26,Denmark
63371,2/1/2023,DNK,Sabah,53,29,24,Denmark
63372,2/1/2023,DNK,Sarawak,20,11,9,Denmark
63373,2/1/2023,DNK,Selangor,1087,626,461,Denmark
63374,2/1/2023,DNK,W.P. Labuan,0,0,0,Denmark
63375,2/1/2023,DOM,Johor,4,3,1,Dominican Republic
63376,2/1/2023,DOM,Kedah,0,0,0,Dominican Republic
63377,2/1/2023,DOM,Perak,0,0,0,Dominican Republic
63378,2/1/2023,DOM,Perlis,0,0,0,Dominican Republic
63379,2/1/2023,DOM,Pulau Pinang,3,1,2,Dominican Republic
63380,2/1/2023,DOM,Sabah,0,0,0,Dominican Republic
63381,2/1/2023,DOM,Sarawak,0,0,0,Dominican Republic
63382,2/1/2023,DOM,Selangor,16,7,9,Dominican Republic
63383,2/1/2023,DZA,Johor,22,14,8,Algeria
63384,2/1/2023,DZA,Kedah,5,2,3,Algeria
63385,2/1/2023,DZA,Kelantan,1,1,0,Algeria
63386,2/1/2023,DZA,Melaka,0,0,0,Algeria
63387,2/1/2023,DZA,Perak,0,0,0,Algeria
63388,2/1/2023,DZA,Perlis,1,1,0,Algeria
63389,2/1/2023,DZA,Pulau Pinang,0,0,0,Algeria
63390,2/1/2023,DZA,Sabah,1,1,0,Algeria
63391,2/1/2023,DZA,Sarawak,5,5,0,Algeria
63392,2/1/2023,DZA,Selangor,369,256,113,Algeria
63393,2/1/2023,DZA,W.P. Labuan,0,0,0,Algeria
63394,2/1/2023,ECU,Johor,11,10,1,Ecuador
63395,2/1/2023,ECU,Kedah,0,0,0,Ecuador
63396,2/1/2023,ECU,Perak,0,0,0,Ecuador
63397,2/1/2023,ECU,Perlis,0,0,0,Ecuador
63398,2/1/2023,ECU,Pulau Pinang,1,0,1,Ecuador
63399,2/1/2023,ECU,Sabah,0,0,0,Ecuador
63400,2/1/2023,ECU,Sarawak,0,0,0,Ecuador
63401,2/1/2023,ECU,Selangor,44,30,14,Ecuador
63402,2/1/2023,EGY,Johor,181,150,31,Egypt
63403,2/1/2023,EGY,Kedah,7,3,4,Egypt
63404,2/1/2023,EGY,Kelantan,0,0,0,Egypt
63405,2/1/2023,EGY,Melaka,0,0,0,Egypt
63406,2/1/2023,EGY,Pahang,0,0,0,Egypt
63407,2/1/2023,EGY,Perak,0,0,0,Egypt
63408,2/1/2023,EGY,Perlis,2,2,0,Egypt
63409,2/1/2023,EGY,Pulau Pinang,10,8,2,Egypt
63410,2/1/2023,EGY,Sabah,6,5,1,Egypt
63411,2/1/2023,EGY,Sarawak,129,87,42,Egypt
63412,2/1/2023,EGY,Selangor,1442,996,446,Egypt
63413,2/1/2023,EGY,Terengganu,0,0,0,Egypt
63414,2/1/2023,EGY,W.P. Labuan,0,0,0,Egypt
63415,2/1/2023,ERI,Johor,1,0,1,Eritrea
63416,2/1/2023,ERI,Pulau Pinang,0,0,0,Eritrea
63417,2/1/2023,ERI,Sabah,0,0,0,Eritrea
63418,2/1/2023,ERI,Selangor,7,4,3,Eritrea
63419,2/1/2023,ESP,Johor,360,229,131,Spain
63420,2/1/2023,ESP,Kedah,184,94,90,Spain
63421,2/1/2023,ESP,Kelantan,5,3,2,Spain
63422,2/1/2023,ESP,Melaka,1,1,0,Spain
63423,2/1/2023,ESP,Negeri Sembilan,0,0,0,Spain
63424,2/1/2023,ESP,Pahang,0,0,0,Spain
63425,2/1/2023,ESP,Perak,6,4,2,Spain
63426,2/1/2023,ESP,Perlis,27,16,11,Spain
63427,2/1/2023,ESP,Pulau Pinang,97,61,36,Spain
63428,2/1/2023,ESP,Sabah,21,12,9,Spain
63429,2/1/2023,ESP,Sarawak,29,20,9,Spain
63430,2/1/2023,ESP,Selangor,1469,931,538,Spain
63431,2/1/2023,ESP,W.P. Labuan,4,2,2,Spain
63432,2/1/2023,EST,Johor,70,41,29,Estonia
63433,2/1/2023,EST,Kedah,91,45,46,Estonia
63434,2/1/2023,EST,Kelantan,0,0,0,Estonia
63435,2/1/2023,EST,Pahang,0,0,0,Estonia
63436,2/1/2023,EST,Perak,0,0,0,Estonia
63437,2/1/2023,EST,Perlis,4,3,1,Estonia
63438,2/1/2023,EST,Pulau Pinang,34,18,16,Estonia
63439,2/1/2023,EST,Sabah,12,5,7,Estonia
63440,2/1/2023,EST,Sarawak,12,6,6,Estonia
63441,2/1/2023,EST,Selangor,308,164,144,Estonia
63442,2/1/2023,EST,W.P. Labuan,4,1,3,Estonia
63443,2/1/2023,ETH,Johor,2,2,0,Ethiopia
63444,2/1/2023,ETH,Kedah,0,0,0,Ethiopia
63445,2/1/2023,ETH,Pulau Pinang,1,1,0,Ethiopia
63446,2/1/2023,ETH,Sarawak,0,0,0,Ethiopia
63447,2/1/2023,ETH,Selangor,29,23,6,Ethiopia
63448,2/1/2023,FIN,Johor,184,120,64,Finland
63449,2/1/2023,FIN,Kedah,184,91,93,Finland
63450,2/1/2023,FIN,Kelantan,4,2,2,Finland
63451,2/1/2023,FIN,Melaka,0,0,0,Finland
63452,2/1/2023,FIN,Negeri Sembilan,0,0,0,Finland
63453,2/1/2023,FIN,Pahang,0,0,0,Finland
63454,2/1/2023,FIN,Perak,8,4,4,Finland
63455,2/1/2023,FIN,Perlis,14,12,2,Finland
63456,2/1/2023,FIN,Pulau Pinang,60,35,25,Finland
63457,2/1/2023,FIN,Sabah,24,13,11,Finland
63458,2/1/2023,FIN,Sarawak,19,12,7,Finland
63459,2/1/2023,FIN,Selangor,660,371,289,Finland
63460,2/1/2023,FIN,W.P. Labuan,6,5,1,Finland
63461,2/1/2023,FJI,Johor,41,19,22,Fiji
63462,2/1/2023,FJI,Kedah,1,1,0,Fiji
63463,2/1/2023,FJI,Kelantan,0,0,0,Fiji
63464,2/1/2023,FJI,Perak,0,0,0,Fiji
63465,2/1/2023,FJI,Perlis,0,0,0,Fiji
63466,2/1/2023,FJI,Pulau Pinang,5,1,4,Fiji
63467,2/1/2023,FJI,Sabah,0,0,0,Fiji
63468,2/1/2023,FJI,Sarawak,1,0,1,Fiji
63469,2/1/2023,FJI,Selangor,57,36,21,Fiji
63470,2/1/2023,FRA,Johor,1781,1100,681,France
63471,2/1/2023,FRA,Kedah,1029,546,483,France
63472,2/1/2023,FRA,Kelantan,21,13,8,France
63473,2/1/2023,FRA,Melaka,3,2,1,France
63474,2/1/2023,FRA,Negeri Sembilan,1,1,0,France
63475,2/1/2023,FRA,Pahang,4,3,1,France
63476,2/1/2023,FRA,Perak,53,32,21,France
63477,2/1/2023,FRA,Perlis,162,106,56,France
63478,2/1/2023,FRA,Pulau Pinang,421,267,154,France
63479,2/1/2023,FRA,Sabah,92,58,34,France
63480,2/1/2023,FRA,Sarawak,101,71,30,France
63481,2/1/2023,FRA,Selangor,6983,4205,2778,France
63482,2/1/2023,FRA,Terengganu,0,0,0,France
63483,2/1/2023,FRA,W.P. Labuan,4,3,1,France
63484,2/1/2023,FSM,Johor,0,0,0,"Micronesia, Federated States of"
63485,2/1/2023,FSM,Pulau Pinang,0,0,0,"Micronesia, Federated States of"
63486,2/1/2023,FSM,Selangor,0,0,0,"Micronesia, Federated States of"
63487,2/1/2023,GAB,Johor,0,0,0,Gabon
63488,2/1/2023,GAB,Pulau Pinang,0,0,0,Gabon
63489,2/1/2023,GAB,Sarawak,0,0,0,Gabon
63490,2/1/2023,GAB,Selangor,2,1,1,Gabon
63491,2/1/2023,GBR,Johor,4190,2769,1421,United Kingdom
63492,2/1/2023,GBR,Kedah,1502,798,704,United Kingdom
63493,2/1/2023,GBR,Kelantan,18,16,2,United Kingdom
63494,2/1/2023,GBR,Melaka,1,1,0,United Kingdom
63495,2/1/2023,GBR,Negeri Sembilan,1,1,0,United Kingdom
63496,2/1/2023,GBR,Pahang,9,6,3,United Kingdom
63497,2/1/2023,GBR,Perak,126,69,57,United Kingdom
63498,2/1/2023,GBR,Perlis,239,163,76,United Kingdom
63499,2/1/2023,GBR,Pulau Pinang,1713,1002,711,United Kingdom
63500,2/1/2023,GBR,Sabah,464,243,221,United Kingdom
63501,2/1/2023,GBR,Sarawak,1124,677,447,United Kingdom
63502,2/1/2023,GBR,Selangor,14459,8875,5584,United Kingdom
63503,2/1/2023,GBR,Terengganu,0,0,0,United Kingdom
63504,2/1/2023,GBR,W.P. Labuan,40,23,17,United Kingdom
63505,2/1/2023,GEO,Johor,4,1,3,Georgia
63506,2/1/2023,GEO,Kedah,3,1,2,Georgia
63507,2/1/2023,GEO,Melaka,0,0,0,Georgia
63508,2/1/2023,GEO,Perak,0,0,0,Georgia
63509,2/1/2023,GEO,Perlis,2,1,1,Georgia
63510,2/1/2023,GEO,Pulau Pinang,1,0,1,Georgia
63511,2/1/2023,GEO,Sabah,0,0,0,Georgia
63512,2/1/2023,GEO,Sarawak,0,0,0,Georgia
63513,2/1/2023,GEO,Selangor,75,59,16,Georgia
63514,2/1/2023,GHA,Johor,2,2,0,Ghana
63515,2/1/2023,GHA,Kedah,0,0,0,Ghana
63516,2/1/2023,GHA,Kelantan,1,1,0,Ghana
63517,2/1/2023,GHA,Pulau Pinang,1,1,0,Ghana
63518,2/1/2023,GHA,Sabah,1,1,0,Ghana
63519,2/1/2023,GHA,Sarawak,3,1,2,Ghana
63520,2/1/2023,GHA,Selangor,48,34,14,Ghana
63521,2/1/2023,GIB,Johor,0,0,0,Gibraltar
63522,2/1/2023,GIB,Sarawak,0,0,0,Gibraltar
63523,2/1/2023,GIN,Johor,4,1,3,Guinea
63524,2/1/2023,GIN,Kedah,0,0,0,Guinea
63525,2/1/2023,GIN,Kelantan,0,0,0,Guinea
63526,2/1/2023,GIN,Perlis,0,0,0,Guinea
63527,2/1/2023,GIN,Pulau Pinang,0,0,0,Guinea
63528,2/1/2023,GIN,Sabah,1,0,1,Guinea
63529,2/1/2023,GIN,Sarawak,0,0,0,Guinea
63530,2/1/2023,GIN,Selangor,41,33,8,Guinea
63531,2/1/2023,GLP,Selangor,0,0,0,Guadeloupe
63532,2/1/2023,GMB,Johor,1,1,0,Gambia
63533,2/1/2023,GMB,Kedah,0,0,0,Gambia
63534,2/1/2023,GMB,Kelantan,0,0,0,Gambia
63535,2/1/2023,GMB,Pulau Pinang,0,0,0,Gambia
63536,2/1/2023,GMB,Sabah,0,0,0,Gambia
63537,2/1/2023,GMB,Sarawak,0,0,0,Gambia
63538,2/1/2023,GMB,Selangor,7,5,2,Gambia
63539,2/1/2023,GNB,Johor,0,0,0,Guinea-Bissau
63540,2/1/2023,GNB,Selangor,0,0,0,Guinea-Bissau
63541,2/1/2023,GNQ,Johor,0,0,0,Equatorial Guinea
63542,2/1/2023,GNQ,Selangor,1,1,0,Equatorial Guinea
63543,2/1/2023,GRC,Johor,50,40,10,Greece
63544,2/1/2023,GRC,Kedah,43,26,17,Greece
63545,2/1/2023,GRC,Kelantan,0,0,0,Greece
63546,2/1/2023,GRC,Melaka,0,0,0,Greece
63547,2/1/2023,GRC,Negeri Sembilan,0,0,0,Greece
63548,2/1/2023,GRC,Pahang,0,0,0,Greece
63549,2/1/2023,GRC,Perak,0,0,0,Greece
63550,2/1/2023,GRC,Perlis,9,5,4,Greece
63551,2/1/2023,GRC,Pulau Pinang,11,10,1,Greece
63552,2/1/2023,GRC,Sabah,4,4,0,Greece
63553,2/1/2023,GRC,Sarawak,3,2,1,Greece
63554,2/1/2023,GRC,Selangor,277,200,77,Greece
63555,2/1/2023,GRD,Johor,3,2,1,Grenada
63556,2/1/2023,GRD,Kedah,0,0,0,Grenada
63557,2/1/2023,GRD,Pulau Pinang,0,0,0,Grenada
63558,2/1/2023,GRD,Sabah,1,1,0,Grenada
63559,2/1/2023,GRD,Sarawak,0,0,0,Grenada
63560,2/1/2023,GRD,Selangor,6,6,0,Grenada
63561,2/1/2023,GRL,Johor,0,0,0,Greenland
63562,2/1/2023,GRL,Selangor,0,0,0,Greenland
63563,2/1/2023,GTM,Johor,0,0,0,Guatemala
63564,2/1/2023,GTM,Kedah,0,0,0,Guatemala
63565,2/1/2023,GTM,Pahang,0,0,0,Guatemala
63566,2/1/2023,GTM,Perak,0,0,0,Guatemala
63567,2/1/2023,GTM,Pulau Pinang,0,0,0,Guatemala
63568,2/1/2023,GTM,Sabah,0,0,0,Guatemala
63569,2/1/2023,GTM,Sarawak,0,0,0,Guatemala
63570,2/1/2023,GTM,Selangor,23,10,13,Guatemala
63571,2/1/2023,GTM,W.P. Labuan,0,0,0,Guatemala
63572,2/1/2023,GUY,Johor,4,1,3,Guyana
63573,2/1/2023,GUY,Kedah,0,0,0,Guyana
63574,2/1/2023,GUY,Pulau Pinang,0,0,0,Guyana
63575,2/1/2023,GUY,Sarawak,0,0,0,Guyana
63576,2/1/2023,GUY,Selangor,12,7,5,Guyana
63577,2/1/2023,HKG,Johor,4,2,2,Hong Kong
63578,2/1/2023,HKG,Kedah,3,3,0,Hong Kong
63579,2/1/2023,HKG,Kelantan,0,0,0,Hong Kong
63580,2/1/2023,HKG,Pahang,0,0,0,Hong Kong
63581,2/1/2023,HKG,Perak,34,17,17,Hong Kong
63582,2/1/2023,HKG,Perlis,4,2,2,Hong Kong
63583,2/1/2023,HKG,Pulau Pinang,0,0,0,Hong Kong
63584,2/1/2023,HKG,Sabah,2,1,1,Hong Kong
63585,2/1/2023,HKG,Sarawak,0,0,0,Hong Kong
63586,2/1/2023,HKG,Selangor,2,1,1,Hong Kong
63587,2/1/2023,HKG,Terengganu,0,0,0,Hong Kong
63588,2/1/2023,HMD,Johor,0,0,0,Heard Island and McDonald Islands
63589,2/1/2023,HND,Johor,1,1,0,Honduras
63590,2/1/2023,HND,Kedah,0,0,0,Honduras
63591,2/1/2023,HND,Perak,0,0,0,Honduras
63592,2/1/2023,HND,Pulau Pinang,1,0,1,Honduras
63593,2/1/2023,HND,Sabah,0,0,0,Honduras
63594,2/1/2023,HND,Sarawak,0,0,0,Honduras
63595,2/1/2023,HND,Selangor,29,20,9,Honduras
63596,2/1/2023,HRV,Johor,55,45,10,Croatia
63597,2/1/2023,HRV,Kedah,10,4,6,Croatia
63598,2/1/2023,HRV,Kelantan,6,6,0,Croatia
63599,2/1/2023,HRV,Melaka,0,0,0,Croatia
63600,2/1/2023,HRV,Pahang,0,0,0,Croatia
63601,2/1/2023,HRV,Perak,0,0,0,Croatia
63602,2/1/2023,HRV,Perlis,0,0,0,Croatia
63603,2/1/2023,HRV,Pulau Pinang,9,8,1,Croatia
63604,2/1/2023,HRV,Sabah,4,3,1,Croatia
63605,2/1/2023,HRV,Sarawak,3,3,0,Croatia
63606,2/1/2023,HRV,Selangor,139,86,53,Croatia
63607,2/1/2023,HTI,Johor,4,3,1,Haiti
63608,2/1/2023,HTI,Kedah,0,0,0,Haiti
63609,2/1/2023,HTI,Kelantan,1,1,0,Haiti
63610,2/1/2023,HTI,Perak,0,0,0,Haiti
63611,2/1/2023,HTI,Pulau Pinang,0,0,0,Haiti
63612,2/1/2023,HTI,Sabah,0,0,0,Haiti
63613,2/1/2023,HTI,Selangor,4,4,0,Haiti
63614,2/1/2023,HUN,Johor,93,61,32,Hungary
63615,2/1/2023,HUN,Kedah,59,32,27,Hungary
63616,2/1/2023,HUN,Kelantan,1,0,1,Hungary
63617,2/1/2023,HUN,Pahang,0,0,0,Hungary
63618,2/1/2023,HUN,Perak,0,0,0,Hungary
63619,2/1/2023,HUN,Perlis,3,0,3,Hungary
63620,2/1/2023,HUN,Pulau Pinang,33,22,11,Hungary
63621,2/1/2023,HUN,Sabah,8,6,2,Hungary
63622,2/1/2023,HUN,Sarawak,13,7,6,Hungary
63623,2/1/2023,HUN,Selangor,741,399,342,Hungary
63624,2/1/2023,HUN,W.P. Labuan,0,0,0,Hungary
63625,2/1/2023,IDN,Johor,91426,49248,42178,Indonesia
63626,2/1/2023,IDN,Kedah,3939,1460,2479,Indonesia
63627,2/1/2023,IDN,Kelantan,153,97,56,Indonesia
63628,2/1/2023,IDN,Melaka,5198,2292,2906,Indonesia
63629,2/1/2023,IDN,Negeri Sembilan,9819,6587,3232,Indonesia
63630,2/1/2023,IDN,Pahang,3,1,2,Indonesia
63631,2/1/2023,IDN,Perak,142,41,101,Indonesia
63632,2/1/2023,IDN,Perlis,496,196,300,Indonesia
63633,2/1/2023,IDN,Pulau Pinang,32124,12557,19567,Indonesia
63634,2/1/2023,IDN,Sabah,4504,2149,2355,Indonesia
63635,2/1/2023,IDN,Sarawak,35011,18720,16291,Indonesia
63636,2/1/2023,IDN,Selangor,83391,41316,42075,Indonesia
63637,2/1/2023,IDN,Terengganu,3,3,0,Indonesia
63638,2/1/2023,IDN,W.P. Labuan,50,30,20,Indonesia
63639,2/1/2023,IND,Johor,13413,9737,3676,India
63640,2/1/2023,IND,Kedah,424,246,178,India
63641,2/1/2023,IND,Kelantan,2,2,0,India
63642,2/1/2023,IND,Melaka,1,1,0,India
63643,2/1/2023,IND,Negeri Sembilan,0,0,0,India
63644,2/1/2023,IND,Pahang,0,0,0,India
63645,2/1/2023,IND,Perak,403,340,63,India
63646,2/1/2023,IND,Perlis,48,35,13,India
63647,2/1/2023,IND,Pulau Pinang,626,457,169,India
63648,2/1/2023,IND,Sabah,174,131,43,India
63649,2/1/2023,IND,Sarawak,1090,805,285,India
63650,2/1/2023,IND,Selangor,36026,26746,9280,India
63651,2/1/2023,IND,Terengganu,0,0,0,India
63652,2/1/2023,IND,W.P. Labuan,107,85,22,India
63653,2/1/2023,IOT,Pulau Pinang,0,0,0,British Indian Ocean Territory
63654,2/1/2023,IOT,Selangor,0,0,0,British Indian Ocean Territory
63655,2/1/2023,IRL,Johor,227,156,71,Ireland
63656,2/1/2023,IRL,Kedah,99,61,38,Ireland
63657,2/1/2023,IRL,Kelantan,3,2,1,Ireland
63658,2/1/2023,IRL,Negeri Sembilan,0,0,0,Ireland
63659,2/1/2023,IRL,Pahang,1,0,1,Ireland
63660,2/1/2023,IRL,Perak,7,4,3,Ireland
63661,2/1/2023,IRL,Perlis,26,16,10,Ireland
63662,2/1/2023,IRL,Pulau Pinang,120,71,49,Ireland
63663,2/1/2023,IRL,Sabah,17,11,6,Ireland
63664,2/1/2023,IRL,Sarawak,42,21,21,Ireland
63665,2/1/2023,IRL,Selangor,1087,654,433,Ireland
63666,2/1/2023,IRL,Terengganu,0,0,0,Ireland
63667,2/1/2023,IRL,W.P. Labuan,3,1,2,Ireland
63668,2/1/2023,IRN,Johor,83,61,22,Iran
63669,2/1/2023,IRN,Kedah,6,3,3,Iran
63670,2/1/2023,IRN,Kelantan,0,0,0,Iran
63671,2/1/2023,IRN,Perak,0,0,0,Iran
63672,2/1/2023,IRN,Perlis,15,9,6,Iran
63673,2/1/2023,IRN,Pulau Pinang,4,2,2,Iran
63674,2/1/2023,IRN,Sabah,3,2,1,Iran
63675,2/1/2023,IRN,Sarawak,4,2,2,Iran
63676,2/1/2023,IRN,Selangor,861,469,392,Iran
63677,2/1/2023,IRN,W.P. Labuan,0,0,0,Iran
63678,2/1/2023,IRQ,Johor,28,24,4,Iraq
63679,2/1/2023,IRQ,Kedah,0,0,0,Iraq
63680,2/1/2023,IRQ,Kelantan,0,0,0,Iraq
63681,2/1/2023,IRQ,Melaka,0,0,0,Iraq
63682,2/1/2023,IRQ,Pahang,0,0,0,Iraq
63683,2/1/2023,IRQ,Perak,0,0,0,Iraq
63684,2/1/2023,IRQ,Perlis,0,0,0,Iraq
63685,2/1/2023,IRQ,Pulau Pinang,1,1,0,Iraq
63686,2/1/2023,IRQ,Sabah,0,0,0,Iraq
63687,2/1/2023,IRQ,Sarawak,0,0,0,Iraq
63688,2/1/2023,IRQ,Selangor,793,539,254,Iraq
63689,2/1/2023,ISL,Johor,4,2,2,Iceland
63690,2/1/2023,ISL,Kedah,3,1,2,Iceland
63691,2/1/2023,ISL,Kelantan,0,0,0,Iceland
63692,2/1/2023,ISL,Perak,0,0,0,Iceland
63693,2/1/2023,ISL,Perlis,1,1,0,Iceland
63694,2/1/2023,ISL,Pulau Pinang,3,1,2,Iceland
63695,2/1/2023,ISL,Sabah,1,1,0,Iceland
63696,2/1/2023,ISL,Sarawak,0,0,0,Iceland
63697,2/1/2023,ISL,Selangor,37,17,20,Iceland
63698,2/1/2023,ISL,W.P. Labuan,0,0,0,Iceland
63699,2/1/2023,ISR,Pulau Pinang,0,0,0,Israel
63700,2/1/2023,ITA,Johor,544,385,159,Italy
63701,2/1/2023,ITA,Kedah,547,291,256,Italy
63702,2/1/2023,ITA,Kelantan,8,6,2,Italy
63703,2/1/2023,ITA,Melaka,0,0,0,Italy
63704,2/1/2023,ITA,Negeri Sembilan,1,1,0,Italy
63705,2/1/2023,ITA,Pahang,0,0,0,Italy
63706,2/1/2023,ITA,Perak,9,7,2,Italy
63707,2/1/2023,ITA,Perlis,55,44,11,Italy
63708,2/1/2023,ITA,Pulau Pinang,126,89,37,Italy
63709,2/1/2023,ITA,Sabah,34,22,12,Italy
63710,2/1/2023,ITA,Sarawak,37,24,13,Italy
63711,2/1/2023,ITA,Selangor,2576,1763,813,Italy
63712,2/1/2023,ITA,W.P. Labuan,9,4,5,Italy
63713,2/1/2023,JAM,Johor,0,0,0,Jamaica
63714,2/1/2023,JAM,Kedah,0,0,0,Jamaica
63715,2/1/2023,JAM,Perak,0,0,0,Jamaica
63716,2/1/2023,JAM,Pulau Pinang,4,1,3,Jamaica
63717,2/1/2023,JAM,Sabah,0,0,0,Jamaica
63718,2/1/2023,JAM,Sarawak,0,0,0,Jamaica
63719,2/1/2023,JAM,Selangor,11,5,6,Jamaica
63720,2/1/2023,JAM,W.P. Labuan,0,0,0,Jamaica
63721,2/1/2023,JOR,Johor,11,7,4,Jordan
63722,2/1/2023,JOR,Kedah,6,4,2,Jordan
63723,2/1/2023,JOR,Kelantan,0,0,0,Jordan
63724,2/1/2023,JOR,Melaka,0,0,0,Jordan
63725,2/1/2023,JOR,Perlis,1,1,0,Jordan
63726,2/1/2023,JOR,Pulau Pinang,2,1,1,Jordan
63727,2/1/2023,JOR,Sabah,2,2,0,Jordan
63728,2/1/2023,JOR,Sarawak,0,0,0,Jordan
63729,2/1/2023,JOR,Selangor,527,330,197,Jordan
63730,2/1/2023,JOR,W.P. Labuan,0,0,0,Jordan
63731,2/1/2023,JPN,Johor,5069,3560,1509,Japan
63732,2/1/2023,JPN,Kedah,334,160,174,Japan
63733,2/1/2023,JPN,Kelantan,7,5,2,Japan
63734,2/1/2023,JPN,Melaka,0,0,0,Japan
63735,2/1/2023,JPN,Negeri Sembilan,0,0,0,Japan
63736,2/1/2023,JPN,Pahang,4,3,1,Japan
63737,2/1/2023,JPN,Perak,85,59,26,Japan
63738,2/1/2023,JPN,Perlis,65,54,11,Japan
63739,2/1/2023,JPN,Pulau Pinang,1145,817,328,Japan
63740,2/1/2023,JPN,Sabah,298,152,146,Japan
63741,2/1/2023,JPN,Sarawak,228,133,95,Japan
63742,2/1/2023,JPN,Selangor,16124,10292,5832,Japan
63743,2/1/2023,JPN,W.P. Labuan,7,5,2,Japan
63744,2/1/2023,KAZ,Johor,42,13,29,Kazakhstan
63745,2/1/2023,KAZ,Kedah,23,11,12,Kazakhstan
63746,2/1/2023,KAZ,Kelantan,3,1,2,Kazakhstan
63747,2/1/2023,KAZ,Melaka,0,0,0,Kazakhstan
63748,2/1/2023,KAZ,Perak,0,0,0,Kazakhstan
63749,2/1/2023,KAZ,Perlis,10,6,4,Kazakhstan
63750,2/1/2023,KAZ,Pulau Pinang,16,9,7,Kazakhstan
63751,2/1/2023,KAZ,Sabah,4,2,2,Kazakhstan
63752,2/1/2023,KAZ,Sarawak,8,0,8,Kazakhstan
63753,2/1/2023,KAZ,Selangor,552,225,327,Kazakhstan
63754,2/1/2023,KAZ,W.P. Labuan,1,0,1,Kazakhstan
63755,2/1/2023,KEN,Johor,33,15,18,Kenya
63756,2/1/2023,KEN,Kedah,3,1,2,Kenya
63757,2/1/2023,KEN,Kelantan,0,0,0,Kenya
63758,2/1/2023,KEN,Perak,0,0,0,Kenya
63759,2/1/2023,KEN,Perlis,0,0,0,Kenya
63760,2/1/2023,KEN,Pulau Pinang,0,0,0,Kenya
63761,2/1/2023,KEN,Sabah,2,1,1,Kenya
63762,2/1/2023,KEN,Sarawak,2,0,2,Kenya
63763,2/1/2023,KEN,Selangor,208,103,105,Kenya
63764,2/1/2023,KGZ,Johor,27,14,13,Kyrgyzstan
63765,2/1/2023,KGZ,Kedah,6,4,2,Kyrgyzstan
63766,2/1/2023,KGZ,Kelantan,0,0,0,Kyrgyzstan
63767,2/1/2023,KGZ,Perak,0,0,0,Kyrgyzstan
63768,2/1/2023,KGZ,Perlis,1,0,1,Kyrgyzstan
63769,2/1/2023,KGZ,Pulau Pinang,1,0,1,Kyrgyzstan
63770,2/1/2023,KGZ,Sabah,2,1,1,Kyrgyzstan
63771,2/1/2023,KGZ,Sarawak,0,0,0,Kyrgyzstan
63772,2/1/2023,KGZ,Selangor,173,92,81,Kyrgyzstan
63773,2/1/2023,KHM,Johor,1991,830,1161,Cambodia
63774,2/1/2023,KHM,Kedah,168,134,34,Cambodia
63775,2/1/2023,KHM,Kelantan,1314,1077,237,Cambodia
63776,2/1/2023,KHM,Melaka,0,0,0,Cambodia
63777,2/1/2023,KHM,Negeri Sembilan,0,0,0,Cambodia
63778,2/1/2023,KHM,Pahang,0,0,0,Cambodia
63779,2/1/2023,KHM,Perak,9,5,4,Cambodia
63780,2/1/2023,KHM,Perlis,693,418,275,Cambodia
63781,2/1/2023,KHM,Pulau Pinang,32,17,15,Cambodia
63782,2/1/2023,KHM,Sabah,1,1,0,Cambodia
63783,2/1/2023,KHM,Sarawak,1,0,1,Cambodia
63784,2/1/2023,KHM,Selangor,3447,1715,1732,Cambodia
63785,2/1/2023,KHM,W.P. Labuan,1,0,1,Cambodia
63786,2/1/2023,KIR,Johor,0,0,0,Kiribati
63787,2/1/2023,KIR,Sabah,0,0,0,Kiribati
63788,2/1/2023,KIR,Selangor,1,0,1,Kiribati
63789,2/1/2023,KNA,Johor,21,16,5,Saint Kitts and Nevis
63790,2/1/2023,KNA,Kedah,0,0,0,Saint Kitts and Nevis
63791,2/1/2023,KNA,Perlis,0,0,0,Saint Kitts and Nevis
63792,2/1/2023,KNA,Pulau Pinang,1,1,0,Saint Kitts and Nevis
63793,2/1/2023,KNA,Sabah,0,0,0,Saint Kitts and Nevis
63794,2/1/2023,KNA,Selangor,44,39,5,Saint Kitts and Nevis
63795,2/1/2023,KNA,W.P. Labuan,0,0,0,Saint Kitts and Nevis
63796,2/1/2023,KOR,Johor,12972,6643,6329,"Korea, Republic of (South Korea)"
63797,2/1/2023,KOR,Kedah,404,181,223,"Korea, Republic of (South Korea)"
63798,2/1/2023,KOR,Kelantan,1,1,0,"Korea, Republic of (South Korea)"
63799,2/1/2023,KOR,Melaka,0,0,0,"Korea, Republic of (South Korea)"
63800,2/1/2023,KOR,Negeri Sembilan,0,0,0,"Korea, Republic of (South Korea)"
63801,2/1/2023,KOR,Pahang,1,0,1,"Korea, Republic of (South Korea)"
63802,2/1/2023,KOR,Perak,50,20,30,"Korea, Republic of (South Korea)"
63803,2/1/2023,KOR,Perlis,69,42,27,"Korea, Republic of (South Korea)"
63804,2/1/2023,KOR,Pulau Pinang,520,288,232,"Korea, Republic of (South Korea)"
63805,2/1/2023,KOR,Sabah,20731,8885,11846,"Korea, Republic of (South Korea)"
63806,2/1/2023,KOR,Sarawak,246,138,108,"Korea, Republic of (South Korea)"
63807,2/1/2023,KOR,Selangor,13525,7320,6205,"Korea, Republic of (South Korea)"
63808,2/1/2023,KOR,Terengganu,0,0,0,"Korea, Republic of (South Korea)"
63809,2/1/2023,KOR,W.P. Labuan,6,4,2,"Korea, Republic of (South Korea)"
63810,2/1/2023,KWT,Johor,26,13,13,Kuwait
63811,2/1/2023,KWT,Kedah,2,1,1,Kuwait
63812,2/1/2023,KWT,Kelantan,1,1,0,Kuwait
63813,2/1/2023,KWT,Perak,0,0,0,Kuwait
63814,2/1/2023,KWT,Perlis,0,0,0,Kuwait
63815,2/1/2023,KWT,Pulau Pinang,0,0,0,Kuwait
63816,2/1/2023,KWT,Sabah,0,0,0,Kuwait
63817,2/1/2023,KWT,Sarawak,0,0,0,Kuwait
63818,2/1/2023,KWT,Selangor,369,221,148,Kuwait
63819,2/1/2023,KWT,W.P. Labuan,0,0,0,Kuwait
63820,2/1/2023,LAO,Johor,139,38,101,Lao People's Democratic Republic
63821,2/1/2023,LAO,Kedah,937,108,829,Lao People's Democratic Republic
63822,2/1/2023,LAO,Kelantan,803,671,132,Lao People's Democratic Republic
63823,2/1/2023,LAO,Melaka,0,0,0,Lao People's Democratic Republic
63824,2/1/2023,LAO,Perak,21,4,17,Lao People's Democratic Republic
63825,2/1/2023,LAO,Perlis,332,150,182,Lao People's Democratic Republic
63826,2/1/2023,LAO,Pulau Pinang,10,3,7,Lao People's Democratic Republic
63827,2/1/2023,LAO,Sabah,6,1,5,Lao People's Democratic Republic
63828,2/1/2023,LAO,Sarawak,6,0,6,Lao People's Democratic Republic
63829,2/1/2023,LAO,Selangor,197,85,112,Lao People's Democratic Republic
63830,2/1/2023,LAO,W.P. Labuan,0,0,0,Lao People's Democratic Republic
63831,2/1/2023,LBN,Johor,20,12,8,Lebanon
63832,2/1/2023,LBN,Kedah,3,2,1,Lebanon
63833,2/1/2023,LBN,Kelantan,0,0,0,Lebanon
63834,2/1/2023,LBN,Pahang,0,0,0,Lebanon
63835,2/1/2023,LBN,Perak,0,0,0,Lebanon
63836,2/1/2023,LBN,Perlis,0,0,0,Lebanon
63837,2/1/2023,LBN,Pulau Pinang,3,3,0,Lebanon
63838,2/1/2023,LBN,Sabah,0,0,0,Lebanon
63839,2/1/2023,LBN,Sarawak,2,2,0,Lebanon
63840,2/1/2023,LBN,Selangor,217,134,83,Lebanon
63841,2/1/2023,LBN,W.P. Labuan,0,0,0,Lebanon
63842,2/1/2023,LBR,Johor,2,0,2,Liberia
63843,2/1/2023,LBR,Kedah,0,0,0,Liberia
63844,2/1/2023,LBR,Sabah,0,0,0,Liberia
63845,2/1/2023,LBR,Sarawak,0,0,0,Liberia
63846,2/1/2023,LBR,Selangor,5,4,1,Liberia
63847,2/1/2023,LBY,Johor,2,1,1,Libyan Arab Jamahiriya
63848,2/1/2023,LBY,Kedah,1,1,0,Libyan Arab Jamahiriya
63849,2/1/2023,LBY,Perlis,0,0,0,Libyan Arab Jamahiriya
63850,2/1/2023,LBY,Pulau Pinang,0,0,0,Libyan Arab Jamahiriya
63851,2/1/2023,LBY,Sabah,0,0,0,Libyan Arab Jamahiriya
63852,2/1/2023,LBY,Sarawak,12,7,5,Libyan Arab Jamahiriya
63853,2/1/2023,LBY,Selangor,264,169,95,Libyan Arab Jamahiriya
63854,2/1/2023,LCA,Johor,7,5,2,Saint Lucia
63855,2/1/2023,LCA,Kedah,0,0,0,Saint Lucia
63856,2/1/2023,LCA,Pulau Pinang,1,1,0,Saint Lucia
63857,2/1/2023,LCA,Sarawak,0,0,0,Saint Lucia
63858,2/1/2023,LCA,Selangor,3,2,1,Saint Lucia
63859,2/1/2023,LIE,Johor,0,0,0,Liechtenstein
63860,2/1/2023,LIE,Kedah,1,0,1,Liechtenstein
63861,2/1/2023,LIE,Perlis,0,0,0,Liechtenstein
63862,2/1/2023,LIE,Pulau Pinang,1,1,0,Liechtenstein
63863,2/1/2023,LIE,Sabah,0,0,0,Liechtenstein
63864,2/1/2023,LIE,Sarawak,0,0,0,Liechtenstein
63865,2/1/2023,LIE,Selangor,3,0,3,Liechtenstein
63866,2/1/2023,LKA,Johor,808,552,256,Sri Lanka
63867,2/1/2023,LKA,Kedah,13,9,4,Sri Lanka
63868,2/1/2023,LKA,Kelantan,0,0,0,Sri Lanka
63869,2/1/2023,LKA,Melaka,0,0,0,Sri Lanka
63870,2/1/2023,LKA,Pahang,0,0,0,Sri Lanka
63871,2/1/2023,LKA,Perak,2,2,0,Sri Lanka
63872,2/1/2023,LKA,Perlis,1,1,0,Sri Lanka
63873,2/1/2023,LKA,Pulau Pinang,19,16,3,Sri Lanka
63874,2/1/2023,LKA,Sabah,3,2,1,Sri Lanka
63875,2/1/2023,LKA,Sarawak,14,10,4,Sri Lanka
63876,2/1/2023,LKA,Selangor,3096,2011,1085,Sri Lanka
63877,2/1/2023,LKA,W.P. Labuan,0,0,0,Sri Lanka
63878,2/1/2023,LSO,Johor,0,0,0,Lesotho
63879,2/1/2023,LSO,Kedah,0,0,0,Lesotho
63880,2/1/2023,LSO,Pulau Pinang,0,0,0,Lesotho
63881,2/1/2023,LSO,Sarawak,0,0,0,Lesotho
63882,2/1/2023,LSO,Selangor,4,2,2,Lesotho
63883,2/1/2023,LTU,Johor,99,46,53,Lithuania
63884,2/1/2023,LTU,Kedah,99,48,51,Lithuania
63885,2/1/2023,LTU,Kelantan,0,0,0,Lithuania
63886,2/1/2023,LTU,Pahang,0,0,0,Lithuania
63887,2/1/2023,LTU,Perak,6,2,4,Lithuania
63888,2/1/2023,LTU,Perlis,11,7,4,Lithuania
63889,2/1/2023,LTU,Pulau Pinang,22,12,10,Lithuania
63890,2/1/2023,LTU,Sabah,6,3,3,Lithuania
63891,2/1/2023,LTU,Sarawak,12,6,6,Lithuania
63892,2/1/2023,LTU,Selangor,475,233,242,Lithuania
63893,2/1/2023,LTU,W.P. Labuan,6,3,3,Lithuania
63894,2/1/2023,LUX,Johor,8,6,2,Luxembourg
63895,2/1/2023,LUX,Kedah,0,0,0,Luxembourg
63896,2/1/2023,LUX,Kelantan,0,0,0,Luxembourg
63897,2/1/2023,LUX,Perak,0,0,0,Luxembourg
63898,2/1/2023,LUX,Perlis,0,0,0,Luxembourg
63899,2/1/2023,LUX,Pulau Pinang,4,1,3,Luxembourg
63900,2/1/2023,LUX,Sabah,0,0,0,Luxembourg
63901,2/1/2023,LUX,Sarawak,0,0,0,Luxembourg
63902,2/1/2023,LUX,Selangor,36,26,10,Luxembourg
63903,2/1/2023,LVA,Johor,54,25,29,Latvia
63904,2/1/2023,LVA,Kedah,27,10,17,Latvia
63905,2/1/2023,LVA,Kelantan,1,0,1,Latvia
63906,2/1/2023,LVA,Pahang,0,0,0,Latvia
63907,2/1/2023,LVA,Perak,0,0,0,Latvia
63908,2/1/2023,LVA,Perlis,3,1,2,Latvia
63909,2/1/2023,LVA,Pulau Pinang,6,2,4,Latvia
63910,2/1/2023,LVA,Sabah,1,0,1,Latvia
63911,2/1/2023,LVA,Sarawak,18,5,13,Latvia
63912,2/1/2023,LVA,Selangor,199,92,107,Latvia
63913,2/1/2023,LVA,W.P. Labuan,7,0,7,Latvia
63914,2/1/2023,MAC,Johor,0,0,0,Macao
63915,2/1/2023,MAC,Pahang,0,0,0,Macao
63916,2/1/2023,MAC,Perak,2,0,2,Macao
63917,2/1/2023,MAC,Selangor,1,0,1,Macao
63918,2/1/2023,MAC,W.P. Labuan,0,0,0,Macao
63919,2/1/2023,MAR,Johor,71,51,20,Morocco
63920,2/1/2023,MAR,Kedah,7,5,2,Morocco
63921,2/1/2023,MAR,Kelantan,0,0,0,Morocco
63922,2/1/2023,MAR,Melaka,0,0,0,Morocco
63923,2/1/2023,MAR,Pahang,0,0,0,Morocco
63924,2/1/2023,MAR,Perak,0,0,0,Morocco
63925,2/1/2023,MAR,Perlis,3,3,0,Morocco
63926,2/1/2023,MAR,Pulau Pinang,15,12,3,Morocco
63927,2/1/2023,MAR,Sabah,1,1,0,Morocco
63928,2/1/2023,MAR,Sarawak,2,2,0,Morocco
63929,2/1/2023,MAR,Selangor,637,349,288,Morocco
63930,2/1/2023,MAR,W.P. Labuan,2,2,0,Morocco
63931,2/1/2023,MCO,Johor,2,2,0,Monaco
63932,2/1/2023,MCO,Kedah,2,1,1,Monaco
63933,2/1/2023,MCO,Sabah,0,0,0,Monaco
63934,2/1/2023,MCO,Selangor,4,2,2,Monaco
63935,2/1/2023,MDA,Johor,2,1,1,"Moldova, Republic of"
63936,2/1/2023,MDA,Kedah,3,1,2,"Moldova, Republic of"
63937,2/1/2023,MDA,Kelantan,0,0,0,"Moldova, Republic of"
63938,2/1/2023,MDA,Negeri Sembilan,0,0,0,"Moldova, Republic of"
63939,2/1/2023,MDA,Perlis,0,0,0,"Moldova, Republic of"
63940,2/1/2023,MDA,Pulau Pinang,1,1,0,"Moldova, Republic of"
63941,2/1/2023,MDA,Sabah,0,0,0,"Moldova, Republic of"
63942,2/1/2023,MDA,Sarawak,0,0,0,"Moldova, Republic of"
63943,2/1/2023,MDA,Selangor,42,20,22,"Moldova, Republic of"
63944,2/1/2023,MDG,Johor,11,6,5,Madagascar
63945,2/1/2023,MDG,Kedah,0,0,0,Madagascar
63946,2/1/2023,MDG,Perak,0,0,0,Madagascar
63947,2/1/2023,MDG,Perlis,0,0,0,Madagascar
63948,2/1/2023,MDG,Pulau Pinang,1,0,1,Madagascar
63949,2/1/2023,MDG,Sabah,0,0,0,Madagascar
63950,2/1/2023,MDG,Sarawak,0,0,0,Madagascar
63951,2/1/2023,MDG,Selangor,19,6,13,Madagascar
63952,2/1/2023,MDV,Johor,121,63,58,Maldives
63953,2/1/2023,MDV,Kedah,2,1,1,Maldives
63954,2/1/2023,MDV,Kelantan,0,0,0,Maldives
63955,2/1/2023,MDV,Perak,0,0,0,Maldives
63956,2/1/2023,MDV,Perlis,0,0,0,Maldives
63957,2/1/2023,MDV,Pulau Pinang,1,1,0,Maldives
63958,2/1/2023,MDV,Sabah,1,1,0,Maldives
63959,2/1/2023,MDV,Sarawak,1,0,1,Maldives
63960,2/1/2023,MDV,Selangor,1681,914,767,Maldives
63961,2/1/2023,MEX,Johor,105,55,50,Mexico
63962,2/1/2023,MEX,Kedah,11,7,4,Mexico
63963,2/1/2023,MEX,Kelantan,0,0,0,Mexico
63964,2/1/2023,MEX,Pahang,0,0,0,Mexico
63965,2/1/2023,MEX,Perak,0,0,0,Mexico
63966,2/1/2023,MEX,Perlis,3,2,1,Mexico
63967,2/1/2023,MEX,Pulau Pinang,20,14,6,Mexico
63968,2/1/2023,MEX,Sabah,4,1,3,Mexico
63969,2/1/2023,MEX,Sarawak,1,1,0,Mexico
63970,2/1/2023,MEX,Selangor,383,205,178,Mexico
63971,2/1/2023,MEX,W.P. Labuan,0,0,0,Mexico
63972,2/1/2023,MHL,Johor,0,0,0,Marshall Islands
63973,2/1/2023,MHL,Kedah,0,0,0,Marshall Islands
63974,2/1/2023,MHL,Perak,0,0,0,Marshall Islands
63975,2/1/2023,MHL,Pulau Pinang,0,0,0,Marshall Islands
63976,2/1/2023,MHL,Sabah,0,0,0,Marshall Islands
63977,2/1/2023,MHL,Selangor,2,2,0,Marshall Islands
63978,2/1/2023,MKD,Johor,4,2,2,"Macedonia, the former Yugoslav Republic of"
63979,2/1/2023,MKD,Kedah,0,0,0,"Macedonia, the former Yugoslav Republic of"
63980,2/1/2023,MKD,Perak,0,0,0,"Macedonia, the former Yugoslav Republic of"
63981,2/1/2023,MKD,Pulau Pinang,0,0,0,"Macedonia, the former Yugoslav Republic of"
63982,2/1/2023,MKD,Sabah,0,0,0,"Macedonia, the former Yugoslav Republic of"
63983,2/1/2023,MKD,Sarawak,1,0,1,"Macedonia, the former Yugoslav Republic of"
63984,2/1/2023,MKD,Selangor,22,14,8,"Macedonia, the former Yugoslav Republic of"
63985,2/1/2023,MLI,Johor,3,3,0,Mali
63986,2/1/2023,MLI,Sabah,0,0,0,Mali
63987,2/1/2023,MLI,Selangor,3,1,2,Mali
63988,2/1/2023,MLT,Johor,13,9,4,Malta
63989,2/1/2023,MLT,Kedah,5,3,2,Malta
63990,2/1/2023,MLT,Kelantan,0,0,0,Malta
63991,2/1/2023,MLT,Perak,0,0,0,Malta
63992,2/1/2023,MLT,Perlis,1,1,0,Malta
63993,2/1/2023,MLT,Pulau Pinang,2,1,1,Malta
63994,2/1/2023,MLT,Sabah,0,0,0,Malta
63995,2/1/2023,MLT,Sarawak,0,0,0,Malta
63996,2/1/2023,MLT,Selangor,35,23,12,Malta
63997,2/1/2023,MLT,W.P. Labuan,0,0,0,Malta
63998,2/1/2023,MMR,Johor,2968,923,2045,Myanmar
63999,2/1/2023,MMR,Kedah,31,2,29,Myanmar
64000,2/1/2023,MMR,Kelantan,1,0,1,Myanmar
64001,2/1/2023,MMR,Negeri Sembilan,0,0,0,Myanmar
64002,2/1/2023,MMR,Pahang,0,0,0,Myanmar
64003,2/1/2023,MMR,Perak,21,9,12,Myanmar
64004,2/1/2023,MMR,Perlis,3,0,3,Myanmar
64005,2/1/2023,MMR,Pulau Pinang,149,79,70,Myanmar
64006,2/1/2023,MMR,Sabah,8,1,7,Myanmar
64007,2/1/2023,MMR,Sarawak,77,35,42,Myanmar
64008,2/1/2023,MMR,Selangor,7233,5164,2069,Myanmar
64009,2/1/2023,MMR,Terengganu,0,0,0,Myanmar
64010,2/1/2023,MMR,W.P. Labuan,3,2,1,Myanmar
64011,2/1/2023,MNE,Johor,1,1,0,Montenegro
64012,2/1/2023,MNE,Kedah,0,0,0,Montenegro
64013,2/1/2023,MNE,Pulau Pinang,0,0,0,Montenegro
64014,2/1/2023,MNE,Sabah,1,1,0,Montenegro
64015,2/1/2023,MNE,Sarawak,0,0,0,Montenegro
64016,2/1/2023,MNE,Selangor,7,6,1,Montenegro
64017,2/1/2023,MNG,Johor,167,73,94,Mongolia
64018,2/1/2023,MNG,Kedah,12,5,7,Mongolia
64019,2/1/2023,MNG,Kelantan,0,0,0,Mongolia
64020,2/1/2023,MNG,Perak,0,0,0,Mongolia
64021,2/1/2023,MNG,Perlis,18,13,5,Mongolia
64022,2/1/2023,MNG,Pulau Pinang,6,2,4,Mongolia
64023,2/1/2023,MNG,Sabah,0,0,0,Mongolia
64024,2/1/2023,MNG,Sarawak,0,0,0,Mongolia
64025,2/1/2023,MNG,Selangor,446,162,284,Mongolia
64026,2/1/2023,MNP,Selangor,0,0,0,Northern Mariana Islands
64027,2/1/2023,MOZ,Johor,1,1,0,Mozambique
64028,2/1/2023,MOZ,Kedah,0,0,0,Mozambique
64029,2/1/2023,MOZ,Perak,0,0,0,Mozambique
64030,2/1/2023,MOZ,Pulau Pinang,0,0,0,Mozambique
64031,2/1/2023,MOZ,Sabah,0,0,0,Mozambique
64032,2/1/2023,MOZ,Sarawak,1,1,0,Mozambique
64033,2/1/2023,MOZ,Selangor,11,6,5,Mozambique
64034,2/1/2023,MRT,Johor,0,0,0,Mauritania
64035,2/1/2023,MRT,Kedah,0,0,0,Mauritania
64036,2/1/2023,MRT,Pulau Pinang,0,0,0,Mauritania
64037,2/1/2023,MRT,Sabah,0,0,0,Mauritania
64038,2/1/2023,MRT,Sarawak,0,0,0,Mauritania
64039,2/1/2023,MRT,Selangor,14,11,3,Mauritania
64040,2/1/2023,MUS,Johor,92,55,37,Mauritius
64041,2/1/2023,MUS,Kedah,4,4,0,Mauritius
64042,2/1/2023,MUS,Kelantan,0,0,0,Mauritius
64043,2/1/2023,MUS,Pahang,0,0,0,Mauritius
64044,2/1/2023,MUS,Perak,4,2,2,Mauritius
64045,2/1/2023,MUS,Perlis,2,2,0,Mauritius
64046,2/1/2023,MUS,Pulau Pinang,6,4,2,Mauritius
64047,2/1/2023,MUS,Sabah,5,2,3,Mauritius
64048,2/1/2023,MUS,Sarawak,1,0,1,Mauritius
64049,2/1/2023,MUS,Selangor,1064,522,542,Mauritius
64050,2/1/2023,MWI,Johor,0,0,0,Malawi
64051,2/1/2023,MWI,Pulau Pinang,0,0,0,Malawi
64052,2/1/2023,MWI,Sabah,0,0,0,Malawi
64053,2/1/2023,MWI,Sarawak,0,0,0,Malawi
64054,2/1/2023,MWI,Selangor,17,9,8,Malawi
64055,2/1/2023,MYT,Selangor,0,0,0,Mayotte
64056,2/1/2023,NAM,Johor,0,0,0,Namibia
64057,2/1/2023,NAM,Kedah,0,0,0,Namibia
64058,2/1/2023,NAM,Perak,0,0,0,Namibia
64059,2/1/2023,NAM,Perlis,0,0,0,Namibia
64060,2/1/2023,NAM,Pulau Pinang,0,0,0,Namibia
64061,2/1/2023,NAM,Sabah,0,0,0,Namibia
64062,2/1/2023,NAM,Sarawak,0,0,0,Namibia
64063,2/1/2023,NAM,Selangor,19,10,9,Namibia
64064,2/1/2023,NCL,Selangor,0,0,0,New Caledonia
64065,2/1/2023,NER,Johor,0,0,0,Niger
64066,2/1/2023,NER,Sabah,0,0,0,Niger
64067,2/1/2023,NER,Selangor,1,0,1,Niger
64068,2/1/2023,NGA,Johor,20,19,1,Nigeria
64069,2/1/2023,NGA,Kedah,0,0,0,Nigeria
64070,2/1/2023,NGA,Perlis,0,0,0,Nigeria
64071,2/1/2023,NGA,Pulau Pinang,1,1,0,Nigeria
64072,2/1/2023,NGA,Sabah,0,0,0,Nigeria
64073,2/1/2023,NGA,Sarawak,11,5,6,Nigeria
64074,2/1/2023,NGA,Selangor,374,295,79,Nigeria
64075,2/1/2023,NIC,Johor,1,0,1,Nicaragua
64076,2/1/2023,NIC,Kedah,1,0,1,Nicaragua
64077,2/1/2023,NIC,Pulau Pinang,0,0,0,Nicaragua
64078,2/1/2023,NIC,Sabah,0,0,0,Nicaragua
64079,2/1/2023,NIC,Selangor,7,7,0,Nicaragua
64080,2/1/2023,NLD,Johor,856,569,287,Netherlands
64081,2/1/2023,NLD,Kedah,449,228,221,Netherlands
64082,2/1/2023,NLD,Kelantan,0,0,0,Netherlands
64083,2/1/2023,NLD,Melaka,4,3,1,Netherlands
64084,2/1/2023,NLD,Negeri Sembilan,0,0,0,Netherlands
64085,2/1/2023,NLD,Pahang,1,0,1,Netherlands
64086,2/1/2023,NLD,Perak,13,7,6,Netherlands
64087,2/1/2023,NLD,Perlis,67,44,23,Netherlands
64088,2/1/2023,NLD,Pulau Pinang,202,123,79,Netherlands
64089,2/1/2023,NLD,Sabah,87,51,36,Netherlands
64090,2/1/2023,NLD,Sarawak,152,102,50,Netherlands
64091,2/1/2023,NLD,Selangor,3340,2014,1326,Netherlands
64092,2/1/2023,NLD,Terengganu,0,0,0,Netherlands
64093,2/1/2023,NLD,W.P. Labuan,9,4,5,Netherlands
64094,2/1/2023,NOR,Johor,146,88,58,Norway
64095,2/1/2023,NOR,Kedah,119,57,62,Norway
64096,2/1/2023,NOR,Kelantan,17,9,8,Norway
64097,2/1/2023,NOR,Melaka,0,0,0,Norway
64098,2/1/2023,NOR,Pahang,0,0,0,Norway
64099,2/1/2023,NOR,Perak,2,1,1,Norway
64100,2/1/2023,NOR,Perlis,15,7,8,Norway
64101,2/1/2023,NOR,Pulau Pinang,33,18,15,Norway
64102,2/1/2023,NOR,Sabah,3,1,2,Norway
64103,2/1/2023,NOR,Sarawak,38,26,12,Norway
64104,2/1/2023,NOR,Selangor,668,398,270,Norway
64105,2/1/2023,NOR,W.P. Labuan,0,0,0,Norway
64106,2/1/2023,NPL,Johor,400,295,105,Nepal
64107,2/1/2023,NPL,Kedah,2,1,1,Nepal
64108,2/1/2023,NPL,Pahang,0,0,0,Nepal
64109,2/1/2023,NPL,Perak,0,0,0,Nepal
64110,2/1/2023,NPL,Perlis,0,0,0,Nepal
64111,2/1/2023,NPL,Pulau Pinang,24,22,2,Nepal
64112,2/1/2023,NPL,Sabah,0,0,0,Nepal
64113,2/1/2023,NPL,Sarawak,173,111,62,Nepal
64114,2/1/2023,NPL,Selangor,17521,16869,652,Nepal
64115,2/1/2023,NPL,W.P. Labuan,28,25,3,Nepal
64116,2/1/2023,NRU,Johor,0,0,0,Nauru
64117,2/1/2023,NRU,Pulau Pinang,0,0,0,Nauru
64118,2/1/2023,NRU,Selangor,0,0,0,Nauru
64119,2/1/2023,NZL,Johor,562,342,220,New Zealand
64120,2/1/2023,NZL,Kedah,72,46,26,New Zealand
64121,2/1/2023,NZL,Kelantan,1,1,0,New Zealand
64122,2/1/2023,NZL,Melaka,1,1,0,New Zealand
64123,2/1/2023,NZL,Negeri Sembilan,0,0,0,New Zealand
64124,2/1/2023,NZL,Pahang,0,0,0,New Zealand
64125,2/1/2023,NZL,Perak,13,8,5,New Zealand
64126,2/1/2023,NZL,Perlis,31,18,13,New Zealand
64127,2/1/2023,NZL,Pulau Pinang,128,69,59,New Zealand
64128,2/1/2023,NZL,Sabah,42,20,22,New Zealand
64129,2/1/2023,NZL,Sarawak,87,42,45,New Zealand
64130,2/1/2023,NZL,Selangor,1997,1209,788,New Zealand
64131,2/1/2023,NZL,Terengganu,0,0,0,New Zealand
64132,2/1/2023,NZL,W.P. Labuan,4,3,1,New Zealand
64133,2/1/2023,OMN,Johor,19,11,8,Oman
64134,2/1/2023,OMN,Kedah,3,2,1,Oman
64135,2/1/2023,OMN,Kelantan,0,0,0,Oman
64136,2/1/2023,OMN,Melaka,0,0,0,Oman
64137,2/1/2023,OMN,Perak,0,0,0,Oman
64138,2/1/2023,OMN,Perlis,0,0,0,Oman
64139,2/1/2023,OMN,Pulau Pinang,6,3,3,Oman
64140,2/1/2023,OMN,Sabah,0,0,0,Oman
64141,2/1/2023,OMN,Sarawak,16,5,11,Oman
64142,2/1/2023,OMN,Selangor,726,435,291,Oman
64143,2/1/2023,PAK,Johor,687,522,165,Pakistan
64144,2/1/2023,PAK,Kedah,38,28,10,Pakistan
64145,2/1/2023,PAK,Kelantan,7,7,0,Pakistan
64146,2/1/2023,PAK,Melaka,0,0,0,Pakistan
64147,2/1/2023,PAK,Negeri Sembilan,0,0,0,Pakistan
64148,2/1/2023,PAK,Pahang,0,0,0,Pakistan
64149,2/1/2023,PAK,Perak,49,48,1,Pakistan
64150,2/1/2023,PAK,Perlis,36,35,1,Pakistan
64151,2/1/2023,PAK,Pulau Pinang,82,76,6,Pakistan
64152,2/1/2023,PAK,Sabah,15,11,4,Pakistan
64153,2/1/2023,PAK,Sarawak,123,95,28,Pakistan
64154,2/1/2023,PAK,Selangor,12934,11788,1146,Pakistan
64155,2/1/2023,PAK,W.P. Labuan,1,1,0,Pakistan
64156,2/1/2023,PAN,Johor,2,1,1,Panama
64157,2/1/2023,PAN,Kedah,0,0,0,Panama
64158,2/1/2023,PAN,Perak,0,0,0,Panama
64159,2/1/2023,PAN,Perlis,0,0,0,Panama
64160,2/1/2023,PAN,Pulau Pinang,1,1,0,Panama
64161,2/1/2023,PAN,Sabah,0,0,0,Panama
64162,2/1/2023,PAN,Sarawak,0,0,0,Panama
64163,2/1/2023,PAN,Selangor,44,18,26,Panama
64164,2/1/2023,PER,Johor,51,30,21,Peru
64165,2/1/2023,PER,Kedah,9,3,6,Peru
64166,2/1/2023,PER,Kelantan,0,0,0,Peru
64167,2/1/2023,PER,Pahang,0,0,0,Peru
64168,2/1/2023,PER,Perak,0,0,0,Peru
64169,2/1/2023,PER,Perlis,0,0,0,Peru
64170,2/1/2023,PER,Pulau Pinang,1,0,1,Peru
64171,2/1/2023,PER,Sabah,0,0,0,Peru
64172,2/1/2023,PER,Sarawak,0,0,0,Peru
64173,2/1/2023,PER,Selangor,69,38,31,Peru
64174,2/1/2023,PER,W.P. Labuan,0,0,0,Peru
64175,2/1/2023,PHL,Johor,15098,5021,10077,Philippines
64176,2/1/2023,PHL,Kedah,456,154,302,Philippines
64177,2/1/2023,PHL,Kelantan,27,17,10,Philippines
64178,2/1/2023,PHL,Melaka,0,0,0,Philippines
64179,2/1/2023,PHL,Negeri Sembilan,0,0,0,Philippines
64180,2/1/2023,PHL,Pahang,12,11,1,Philippines
64181,2/1/2023,PHL,Perak,92,37,55,Philippines
64182,2/1/2023,PHL,Perlis,53,14,39,Philippines
64183,2/1/2023,PHL,Pulau Pinang,417,150,267,Philippines
64184,2/1/2023,PHL,Sabah,1261,624,637,Philippines
64185,2/1/2023,PHL,Sarawak,2303,916,1387,Philippines
64186,2/1/2023,PHL,Selangor,11651,4886,6765,Philippines
64187,2/1/2023,PHL,Terengganu,0,0,0,Philippines
64188,2/1/2023,PHL,W.P. Labuan,79,22,57,Philippines
64189,2/1/2023,PLW,Johor,0,0,0,Palau
64190,2/1/2023,PLW,Pulau Pinang,0,0,0,Palau
64191,2/1/2023,PLW,Selangor,4,1,3,Palau
64192,2/1/2023,PNG,Johor,7,5,2,Papua New Guinea
64193,2/1/2023,PNG,Kedah,0,0,0,Papua New Guinea
64194,2/1/2023,PNG,Kelantan,0,0,0,Papua New Guinea
64195,2/1/2023,PNG,Perak,0,0,0,Papua New Guinea
64196,2/1/2023,PNG,Pulau Pinang,4,4,0,Papua New Guinea
64197,2/1/2023,PNG,Sabah,1,0,1,Papua New Guinea
64198,2/1/2023,PNG,Sarawak,6,1,5,Papua New Guinea
64199,2/1/2023,PNG,Selangor,49,32,17,Papua New Guinea
64200,2/1/2023,POL,Johor,675,309,366,Poland
64201,2/1/2023,POL,Kedah,327,159,168,Poland
64202,2/1/2023,POL,Kelantan,1,1,0,Poland
64203,2/1/2023,POL,Melaka,0,0,0,Poland
64204,2/1/2023,POL,Negeri Sembilan,0,0,0,Poland
64205,2/1/2023,POL,Pahang,0,0,0,Poland
64206,2/1/2023,POL,Perak,0,0,0,Poland
64207,2/1/2023,POL,Perlis,44,24,20,Poland
64208,2/1/2023,POL,Pulau Pinang,69,41,28,Poland
64209,2/1/2023,POL,Sabah,19,9,10,Poland
64210,2/1/2023,POL,Sarawak,41,18,23,Poland
64211,2/1/2023,POL,Selangor,1394,766,628,Poland
64212,2/1/2023,POL,Terengganu,0,0,0,Poland
64213,2/1/2023,POL,W.P. Labuan,3,2,1,Poland
64214,2/1/2023,PRK,Selangor,0,0,0,"Korea, Democratic People's Republic of"
64215,2/1/2023,PRT,Johor,133,73,60,Portugal
64216,2/1/2023,PRT,Kedah,58,30,28,Portugal
64217,2/1/2023,PRT,Kelantan,0,0,0,Portugal
64218,2/1/2023,PRT,Melaka,0,0,0,Portugal
64219,2/1/2023,PRT,Pahang,0,0,0,Portugal
64220,2/1/2023,PRT,Perak,2,1,1,Portugal
64221,2/1/2023,PRT,Perlis,9,4,5,Portugal
64222,2/1/2023,PRT,Pulau Pinang,29,17,12,Portugal
64223,2/1/2023,PRT,Sabah,15,10,5,Portugal
64224,2/1/2023,PRT,Sarawak,13,6,7,Portugal
64225,2/1/2023,PRT,Selangor,542,316,226,Portugal
64226,2/1/2023,PRT,W.P. Labuan,2,1,1,Portugal
64227,2/1/2023,PRY,Johor,10,8,2,Paraguay
64228,2/1/2023,PRY,Kedah,0,0,0,Paraguay
64229,2/1/2023,PRY,Perak,0,0,0,Paraguay
64230,2/1/2023,PRY,Perlis,0,0,0,Paraguay
64231,2/1/2023,PRY,Pulau Pinang,0,0,0,Paraguay
64232,2/1/2023,PRY,Sabah,0,0,0,Paraguay
64233,2/1/2023,PRY,Sarawak,0,0,0,Paraguay
64234,2/1/2023,PRY,Selangor,8,4,4,Paraguay
64235,2/1/2023,PSE,Johor,7,7,0,"Palestinian Territory, Occupied"
64236,2/1/2023,PSE,Kedah,1,1,0,"Palestinian Territory, Occupied"
64237,2/1/2023,PSE,Kelantan,0,0,0,"Palestinian Territory, Occupied"
64238,2/1/2023,PSE,Melaka,0,0,0,"Palestinian Territory, Occupied"
64239,2/1/2023,PSE,Perak,0,0,0,"Palestinian Territory, Occupied"
64240,2/1/2023,PSE,Perlis,0,0,0,"Palestinian Territory, Occupied"
64241,2/1/2023,PSE,Pulau Pinang,0,0,0,"Palestinian Territory, Occupied"
64242,2/1/2023,PSE,Sabah,0,0,0,"Palestinian Territory, Occupied"
64243,2/1/2023,PSE,Sarawak,1,1,0,"Palestinian Territory, Occupied"
64244,2/1/2023,PSE,Selangor,241,171,70,"Palestinian Territory, Occupied"
64245,2/1/2023,QAT,Johor,8,7,1,Qatar
64246,2/1/2023,QAT,Kedah,0,0,0,Qatar
64247,2/1/2023,QAT,Perlis,0,0,0,Qatar
64248,2/1/2023,QAT,Pulau Pinang,0,0,0,Qatar
64249,2/1/2023,QAT,Sabah,0,0,0,Qatar
64250,2/1/2023,QAT,Sarawak,0,0,0,Qatar
64251,2/1/2023,QAT,Selangor,121,77,44,Qatar
64252,2/1/2023,REU,Johor,0,0,0,Reunion
64253,2/1/2023,REU,Sarawak,0,0,0,Reunion
64254,2/1/2023,ROU,Johor,137,77,60,Romania
64255,2/1/2023,ROU,Kedah,92,45,47,Romania
64256,2/1/2023,ROU,Kelantan,1,1,0,Romania
64257,2/1/2023,ROU,Negeri Sembilan,0,0,0,Romania
64258,2/1/2023,ROU,Pahang,1,1,0,Romania
64259,2/1/2023,ROU,Perak,1,0,1,Romania
64260,2/1/2023,ROU,Perlis,11,6,5,Romania
64261,2/1/2023,ROU,Pulau Pinang,31,14,17,Romania
64262,2/1/2023,ROU,Sabah,4,2,2,Romania
64263,2/1/2023,ROU,Sarawak,5,5,0,Romania
64264,2/1/2023,ROU,Selangor,558,299,259,Romania
64265,2/1/2023,ROU,W.P. Labuan,0,0,0,Romania
64266,2/1/2023,RUS,Johor,334,182,152,Russia
64267,2/1/2023,RUS,Kedah,660,347,313,Russia
64268,2/1/2023,RUS,Kelantan,99,52,47,Russia
64269,2/1/2023,RUS,Melaka,4,2,2,Russia
64270,2/1/2023,RUS,Negeri Sembilan,0,0,0,Russia
64271,2/1/2023,RUS,Pahang,0,0,0,Russia
64272,2/1/2023,RUS,Perak,10,6,4,Russia
64273,2/1/2023,RUS,Perlis,808,451,357,Russia
64274,2/1/2023,RUS,Pulau Pinang,281,156,125,Russia
64275,2/1/2023,RUS,Sabah,43,18,25,Russia
64276,2/1/2023,RUS,Sarawak,75,36,39,Russia
64277,2/1/2023,RUS,Selangor,13648,7048,6600,Russia
64278,2/1/2023,RUS,W.P. Labuan,14,7,7,Russia
64279,2/1/2023,RWA,Johor,0,0,0,Rwanda
64280,2/1/2023,RWA,Kedah,0,0,0,Rwanda
64281,2/1/2023,RWA,Pulau Pinang,0,0,0,Rwanda
64282,2/1/2023,RWA,Selangor,7,2,5,Rwanda
64283,2/1/2023,SAU,Johor,106,68,38,Saudi Arabia
64284,2/1/2023,SAU,Kedah,4,3,1,Saudi Arabia
64285,2/1/2023,SAU,Kelantan,8,4,4,Saudi Arabia
64286,2/1/2023,SAU,Melaka,0,0,0,Saudi Arabia
64287,2/1/2023,SAU,Perak,0,0,0,Saudi Arabia
64288,2/1/2023,SAU,Perlis,4,4,0,Saudi Arabia
64289,2/1/2023,SAU,Pulau Pinang,7,5,2,Saudi Arabia
64290,2/1/2023,SAU,Sabah,3,3,0,Saudi Arabia
64291,2/1/2023,SAU,Sarawak,9,9,0,Saudi Arabia
64292,2/1/2023,SAU,Selangor,2178,1341,837,Saudi Arabia
64293,2/1/2023,SAU,W.P. Labuan,0,0,0,Saudi Arabia
64294,2/1/2023,SDN,Johor,5,4,1,Sudan
64295,2/1/2023,SDN,Kedah,0,0,0,Sudan
64296,2/1/2023,SDN,Kelantan,0,0,0,Sudan
64297,2/1/2023,SDN,Perlis,0,0,0,Sudan
64298,2/1/2023,SDN,Pulau Pinang,0,0,0,Sudan
64299,2/1/2023,SDN,Sabah,0,0,0,Sudan
64300,2/1/2023,SDN,Sarawak,5,4,1,Sudan
64301,2/1/2023,SDN,Selangor,927,536,391,Sudan
64302,2/1/2023,SDN,W.P. Labuan,0,0,0,Sudan
64303,2/1/2023,SEN,Johor,0,0,0,Senegal
64304,2/1/2023,SEN,Kedah,0,0,0,Senegal
64305,2/1/2023,SEN,Kelantan,0,0,0,Senegal
64306,2/1/2023,SEN,Perak,0,0,0,Senegal
64307,2/1/2023,SEN,Perlis,0,0,0,Senegal
64308,2/1/2023,SEN,Pulau Pinang,0,0,0,Senegal
64309,2/1/2023,SEN,Sabah,0,0,0,Senegal
64310,2/1/2023,SEN,Sarawak,0,0,0,Senegal
64311,2/1/2023,SEN,Selangor,30,15,15,Senegal
64312,2/1/2023,SGP,Johor,881960,518353,363607,Singapore
64313,2/1/2023,SGP,Kedah,2844,1570,1274,Singapore
64314,2/1/2023,SGP,Kelantan,43,28,15,Singapore
64315,2/1/2023,SGP,Melaka,13,6,7,Singapore
64316,2/1/2023,SGP,Negeri Sembilan,0,0,0,Singapore
64317,2/1/2023,SGP,Pahang,165,85,80,Singapore
64318,2/1/2023,SGP,Perak,4255,1968,2287,Singapore
64319,2/1/2023,SGP,Perlis,155,99,56,Singapore
64320,2/1/2023,SGP,Pulau Pinang,11326,5887,5439,Singapore
64321,2/1/2023,SGP,Sabah,1957,1089,868,Singapore
64322,2/1/2023,SGP,Sarawak,3166,1751,1415,Singapore
64323,2/1/2023,SGP,Selangor,33742,17638,16104,Singapore
64324,2/1/2023,SGP,Terengganu,0,0,0,Singapore
64325,2/1/2023,SGP,W.P. Labuan,7,6,1,Singapore
64326,2/1/2023,SGS,Johor,0,0,0,South Georgia and the South Sandwich Islands
64327,2/1/2023,SGS,Sabah,0,0,0,South Georgia and the South Sandwich Islands
64328,2/1/2023,SGS,Selangor,0,0,0,South Georgia and the South Sandwich Islands
64329,2/1/2023,SHN,Sarawak,0,0,0,"Saint Helena, Ascension and Tristan da Cunha"
64330,2/1/2023,SLB,Johor,0,0,0,Solomon Islands
64331,2/1/2023,SLB,Perlis,0,0,0,Solomon Islands
64332,2/1/2023,SLB,Pulau Pinang,0,0,0,Solomon Islands
64333,2/1/2023,SLB,Sabah,0,0,0,Solomon Islands
64334,2/1/2023,SLB,Sarawak,2,1,1,Solomon Islands
64335,2/1/2023,SLB,Selangor,0,0,0,Solomon Islands
64336,2/1/2023,SLB,W.P. Labuan,0,0,0,Solomon Islands
64337,2/1/2023,SLE,Johor,6,3,3,Sierra Leone
64338,2/1/2023,SLE,Kedah,0,0,0,Sierra Leone
64339,2/1/2023,SLE,Perak,0,0,0,Sierra Leone
64340,2/1/2023,SLE,Pulau Pinang,0,0,0,Sierra Leone
64341,2/1/2023,SLE,Sabah,0,0,0,Sierra Leone
64342,2/1/2023,SLE,Selangor,17,9,8,Sierra Leone
64343,2/1/2023,SLV,Johor,1,0,1,El Salvador
64344,2/1/2023,SLV,Kedah,0,0,0,El Salvador
64345,2/1/2023,SLV,Perak,0,0,0,El Salvador
64346,2/1/2023,SLV,Perlis,0,0,0,El Salvador
64347,2/1/2023,SLV,Pulau Pinang,2,1,1,El Salvador
64348,2/1/2023,SLV,Sabah,0,0,0,El Salvador
64349,2/1/2023,SLV,Selangor,14,8,6,El Salvador
64350,2/1/2023,SLV,W.P. Labuan,0,0,0,El Salvador
64351,2/1/2023,SMR,Johor,0,0,0,San Marino
64352,2/1/2023,SMR,Selangor,4,4,0,San Marino
64353,2/1/2023,SOM,Johor,0,0,0,Somalia
64354,2/1/2023,SOM,Kedah,0,0,0,Somalia
64355,2/1/2023,SOM,Kelantan,0,0,0,Somalia
64356,2/1/2023,SOM,Perlis,0,0,0,Somalia
64357,2/1/2023,SOM,Sabah,1,0,1,Somalia
64358,2/1/2023,SOM,Sarawak,0,0,0,Somalia
64359,2/1/2023,SOM,Selangor,215,133,82,Somalia
64360,2/1/2023,SRB,Johor,5,2,3,Serbia
64361,2/1/2023,SRB,Kedah,0,0,0,Serbia
64362,2/1/2023,SRB,Kelantan,0,0,0,Serbia
64363,2/1/2023,SRB,Pahang,0,0,0,Serbia
64364,2/1/2023,SRB,Perak,0,0,0,Serbia
64365,2/1/2023,SRB,Perlis,1,0,1,Serbia
64366,2/1/2023,SRB,Pulau Pinang,2,0,2,Serbia
64367,2/1/2023,SRB,Sabah,1,1,0,Serbia
64368,2/1/2023,SRB,Sarawak,1,0,1,Serbia
64369,2/1/2023,SRB,Selangor,67,38,29,Serbia
64370,2/1/2023,STP,Selangor,2,1,1,Sao Tome and Principe
64371,2/1/2023,SUR,Johor,1,0,1,Suriname
64372,2/1/2023,SUR,Kedah,0,0,0,Suriname
64373,2/1/2023,SUR,Kelantan,0,0,0,Suriname
64374,2/1/2023,SUR,Perak,0,0,0,Suriname
64375,2/1/2023,SUR,Perlis,0,0,0,Suriname
64376,2/1/2023,SUR,Pulau Pinang,0,0,0,Suriname
64377,2/1/2023,SUR,Sabah,0,0,0,Suriname
64378,2/1/2023,SUR,Sarawak,0,0,0,Suriname
64379,2/1/2023,SUR,Selangor,14,10,4,Suriname
64380,2/1/2023,SVK,Johor,44,27,17,Slovakia
64381,2/1/2023,SVK,Kedah,131,61,70,Slovakia
64382,2/1/2023,SVK,Kelantan,0,0,0,Slovakia
64383,2/1/2023,SVK,Negeri Sembilan,0,0,0,Slovakia
64384,2/1/2023,SVK,Pahang,0,0,0,Slovakia
64385,2/1/2023,SVK,Perak,0,0,0,Slovakia
64386,2/1/2023,SVK,Perlis,7,3,4,Slovakia
64387,2/1/2023,SVK,Pulau Pinang,24,14,10,Slovakia
64388,2/1/2023,SVK,Sabah,9,3,6,Slovakia
64389,2/1/2023,SVK,Sarawak,4,2,2,Slovakia
64390,2/1/2023,SVK,Selangor,411,229,182,Slovakia
64391,2/1/2023,SVK,W.P. Labuan,3,3,0,Slovakia
64392,2/1/2023,SVN,Johor,21,8,13,Slovenia
64393,2/1/2023,SVN,Kedah,52,29,23,Slovenia
64394,2/1/2023,SVN,Kelantan,0,0,0,Slovenia
64395,2/1/2023,SVN,Perak,0,0,0,Slovenia
64396,2/1/2023,SVN,Perlis,6,3,3,Slovenia
64397,2/1/2023,SVN,Pulau Pinang,2,0,2,Slovenia
64398,2/1/2023,SVN,Sabah,2,2,0,Slovenia
64399,2/1/2023,SVN,Sarawak,1,0,1,Slovenia
64400,2/1/2023,SVN,Selangor,147,76,71,Slovenia
64401,2/1/2023,SVN,W.P. Labuan,8,2,6,Slovenia
64402,2/1/2023,SWE,Johor,255,138,117,Sweden
64403,2/1/2023,SWE,Kedah,475,205,270,Sweden
64404,2/1/2023,SWE,Kelantan,2,1,1,Sweden
64405,2/1/2023,SWE,Melaka,1,1,0,Sweden
64406,2/1/2023,SWE,Negeri Sembilan,0,0,0,Sweden
64407,2/1/2023,SWE,Pahang,2,1,1,Sweden
64408,2/1/2023,SWE,Perak,8,7,1,Sweden
64409,2/1/2023,SWE,Perlis,21,17,4,Sweden
64410,2/1/2023,SWE,Pulau Pinang,122,77,45,Sweden
64411,2/1/2023,SWE,Sabah,45,20,25,Sweden
64412,2/1/2023,SWE,Sarawak,22,18,4,Sweden
64413,2/1/2023,SWE,Selangor,1457,838,619,Sweden
64414,2/1/2023,SWE,W.P. Labuan,2,2,0,Sweden
64415,2/1/2023,SWZ,Johor,1,0,1,Swaziland
64416,2/1/2023,SWZ,Kedah,0,0,0,Swaziland
64417,2/1/2023,SWZ,Pulau Pinang,0,0,0,Swaziland
64418,2/1/2023,SWZ,Sabah,0,0,0,Swaziland
64419,2/1/2023,SWZ,Selangor,14,4,10,Swaziland
64420,2/1/2023,SYC,Johor,1,0,1,Seychelles
64421,2/1/2023,SYC,Kedah,0,0,0,Seychelles
64422,2/1/2023,SYC,Pulau Pinang,0,0,0,Seychelles
64423,2/1/2023,SYC,Sabah,0,0,0,Seychelles
64424,2/1/2023,SYC,Sarawak,1,1,0,Seychelles
64425,2/1/2023,SYC,Selangor,55,15,40,Seychelles
64426,2/1/2023,SYR,Johor,8,6,2,Syrian Arab Republic
64427,2/1/2023,SYR,Kedah,1,1,0,Syrian Arab Republic
64428,2/1/2023,SYR,Kelantan,0,0,0,Syrian Arab Republic
64429,2/1/2023,SYR,Pahang,0,0,0,Syrian Arab Republic
64430,2/1/2023,SYR,Perlis,0,0,0,Syrian Arab Republic
64431,2/1/2023,SYR,Pulau Pinang,0,0,0,Syrian Arab Republic
64432,2/1/2023,SYR,Sabah,1,1,0,Syrian Arab Republic
64433,2/1/2023,SYR,Sarawak,0,0,0,Syrian Arab Republic
64434,2/1/2023,SYR,Selangor,512,337,175,Syrian Arab Republic
64435,2/1/2023,SYR,W.P. Labuan,1,1,0,Syrian Arab Republic
64436,2/1/2023,TCA,Perlis,1,0,1,Turks and Caicos
64437,2/1/2023,TCD,Johor,0,0,0,Chad
64438,2/1/2023,TCD,Kedah,0,0,0,Chad
64439,2/1/2023,TCD,Perlis,0,0,0,Chad
64440,2/1/2023,TCD,Selangor,10,8,2,Chad
64441,2/1/2023,TGO,Johor,2,1,1,Togo
64442,2/1/2023,TGO,Perak,0,0,0,Togo
64443,2/1/2023,TGO,Pulau Pinang,0,0,0,Togo
64444,2/1/2023,TGO,Selangor,3,2,1,Togo
64445,2/1/2023,THA,Johor,5181,1418,3763,Thailand
64446,2/1/2023,THA,Kedah,61904,37209,24695,Thailand
64447,2/1/2023,THA,Kelantan,48527,25575,22952,Thailand
64448,2/1/2023,THA,Melaka,9,6,3,Thailand
64449,2/1/2023,THA,Negeri Sembilan,1,1,0,Thailand
64450,2/1/2023,THA,Pahang,1,0,1,Thailand
64451,2/1/2023,THA,Perak,9690,4601,5089,Thailand
64452,2/1/2023,THA,Perlis,52242,32191,20051,Thailand
64453,2/1/2023,THA,Pulau Pinang,1700,684,1016,Thailand
64454,2/1/2023,THA,Sabah,143,47,96,Thailand
64455,2/1/2023,THA,Sarawak,292,101,191,Thailand
64456,2/1/2023,THA,Selangor,9860,3971,5889,Thailand
64457,2/1/2023,THA,Terengganu,0,0,0,Thailand
64458,2/1/2023,THA,W.P. Labuan,5,2,3,Thailand
64459,2/1/2023,TJK,Johor,4,1,3,Tajikistan
64460,2/1/2023,TJK,Kedah,0,0,0,Tajikistan
64461,2/1/2023,TJK,Perlis,0,0,0,Tajikistan
64462,2/1/2023,TJK,Pulau Pinang,2,2,0,Tajikistan
64463,2/1/2023,TJK,Sabah,0,0,0,Tajikistan
64464,2/1/2023,TJK,Selangor,88,52,36,Tajikistan
64465,2/1/2023,TKL,Selangor,0,0,0,Tokelau
64466,2/1/2023,TKM,Johor,3,1,2,Turkmenistan
64467,2/1/2023,TKM,Kedah,0,0,0,Turkmenistan
64468,2/1/2023,TKM,Kelantan,1,0,1,Turkmenistan
64469,2/1/2023,TKM,Perlis,0,0,0,Turkmenistan
64470,2/1/2023,TKM,Pulau Pinang,0,0,0,Turkmenistan
64471,2/1/2023,TKM,Sabah,0,0,0,Turkmenistan
64472,2/1/2023,TKM,Sarawak,1,1,0,Turkmenistan
64473,2/1/2023,TKM,Selangor,49,31,18,Turkmenistan
64474,2/1/2023,TLS,Johor,4,3,1,Timor-Leste
64475,2/1/2023,TLS,Kedah,2,1,1,Timor-Leste
64476,2/1/2023,TLS,Perlis,0,0,0,Timor-Leste
64477,2/1/2023,TLS,Pulau Pinang,1,0,1,Timor-Leste
64478,2/1/2023,TLS,Sabah,0,0,0,Timor-Leste
64479,2/1/2023,TLS,Sarawak,4,0,4,Timor-Leste
64480,2/1/2023,TLS,Selangor,92,41,51,Timor-Leste
64481,2/1/2023,TON,Johor,0,0,0,Tonga
64482,2/1/2023,TON,Pulau Pinang,2,1,1,Tonga
64483,2/1/2023,TON,Sarawak,0,0,0,Tonga
64484,2/1/2023,TON,Selangor,8,6,2,Tonga
64485,2/1/2023,TTO,Johor,2,2,0,Trinidad and Tobago
64486,2/1/2023,TTO,Kedah,0,0,0,Trinidad and Tobago
64487,2/1/2023,TTO,Pahang,0,0,0,Trinidad and Tobago
64488,2/1/2023,TTO,Pulau Pinang,0,0,0,Trinidad and Tobago
64489,2/1/2023,TTO,Sabah,0,0,0,Trinidad and Tobago
64490,2/1/2023,TTO,Sarawak,0,0,0,Trinidad and Tobago
64491,2/1/2023,TTO,Selangor,15,7,8,Trinidad and Tobago
64492,2/1/2023,TUN,Johor,8,4,4,Tunisia
64493,2/1/2023,TUN,Kedah,0,0,0,Tunisia
64494,2/1/2023,TUN,Kelantan,0,0,0,Tunisia
64495,2/1/2023,TUN,Melaka,0,0,0,Tunisia
64496,2/1/2023,TUN,Perak,0,0,0,Tunisia
64497,2/1/2023,TUN,Perlis,1,0,1,Tunisia
64498,2/1/2023,TUN,Pulau Pinang,2,2,0,Tunisia
64499,2/1/2023,TUN,Sabah,1,0,1,Tunisia
64500,2/1/2023,TUN,Sarawak,2,2,0,Tunisia
64501,2/1/2023,TUN,Selangor,275,170,105,Tunisia
64502,2/1/2023,TUN,W.P. Labuan,2,0,2,Tunisia
64503,2/1/2023,TUR,Johor,198,143,55,Turkey
64504,2/1/2023,TUR,Kedah,44,26,18,Turkey
64505,2/1/2023,TUR,Kelantan,2,2,0,Turkey
64506,2/1/2023,TUR,Melaka,0,0,0,Turkey
64507,2/1/2023,TUR,Negeri Sembilan,0,0,0,Turkey
64508,2/1/2023,TUR,Pahang,0,0,0,Turkey
64509,2/1/2023,TUR,Perak,1,1,0,Turkey
64510,2/1/2023,TUR,Perlis,29,26,3,Turkey
64511,2/1/2023,TUR,Pulau Pinang,47,31,16,Turkey
64512,2/1/2023,TUR,Sabah,11,7,4,Turkey
64513,2/1/2023,TUR,Sarawak,8,7,1,Turkey
64514,2/1/2023,TUR,Selangor,912,632,280,Turkey
64515,2/1/2023,TUR,W.P. Labuan,0,0,0,Turkey
64516,2/1/2023,TUV,Selangor,0,0,0,Tuvalu
64517,2/1/2023,TWN,Johor,4132,1820,2312,Taiwan
64518,2/1/2023,TWN,Kedah,133,53,80,Taiwan
64519,2/1/2023,TWN,Kelantan,0,0,0,Taiwan
64520,2/1/2023,TWN,Melaka,0,0,0,Taiwan
64521,2/1/2023,TWN,Negeri Sembilan,0,0,0,Taiwan
64522,2/1/2023,TWN,Pahang,0,0,0,Taiwan
64523,2/1/2023,TWN,Perak,63,34,29,Taiwan
64524,2/1/2023,TWN,Perlis,26,10,16,Taiwan
64525,2/1/2023,TWN,Pulau Pinang,2360,1261,1099,Taiwan
64526,2/1/2023,TWN,Sabah,839,420,419,Taiwan
64527,2/1/2023,TWN,Sarawak,401,172,229,Taiwan
64528,2/1/2023,TWN,Selangor,8699,4481,4218,Taiwan
64529,2/1/2023,TWN,W.P. Labuan,22,8,14,Taiwan
64530,2/1/2023,TZA,Johor,21,10,11,"Tanzania, United Republic of"
64531,2/1/2023,TZA,Kedah,0,0,0,"Tanzania, United Republic of"
64532,2/1/2023,TZA,Perak,1,1,0,"Tanzania, United Republic of"
64533,2/1/2023,TZA,Perlis,0,0,0,"Tanzania, United Republic of"
64534,2/1/2023,TZA,Pulau Pinang,2,1,1,"Tanzania, United Republic of"
64535,2/1/2023,TZA,Sabah,0,0,0,"Tanzania, United Republic of"
64536,2/1/2023,TZA,Sarawak,5,5,0,"Tanzania, United Republic of"
64537,2/1/2023,TZA,Selangor,93,50,43,"Tanzania, United Republic of"
64538,2/1/2023,UGA,Johor,6,4,2,Uganda
64539,2/1/2023,UGA,Kedah,0,0,0,Uganda
64540,2/1/2023,UGA,Perak,0,0,0,Uganda
64541,2/1/2023,UGA,Perlis,1,0,1,Uganda
64542,2/1/2023,UGA,Pulau Pinang,0,0,0,Uganda
64543,2/1/2023,UGA,Sabah,0,0,0,Uganda
64544,2/1/2023,UGA,Sarawak,1,1,0,Uganda
64545,2/1/2023,UGA,Selangor,74,38,36,Uganda
64546,2/1/2023,UKR,Johor,119,69,50,Ukraine
64547,2/1/2023,UKR,Kedah,49,12,37,Ukraine
64548,2/1/2023,UKR,Kelantan,6,5,1,Ukraine
64549,2/1/2023,UKR,Melaka,0,0,0,Ukraine
64550,2/1/2023,UKR,Negeri Sembilan,0,0,0,Ukraine
64551,2/1/2023,UKR,Pahang,0,0,0,Ukraine
64552,2/1/2023,UKR,Perak,2,1,1,Ukraine
64553,2/1/2023,UKR,Perlis,21,9,12,Ukraine
64554,2/1/2023,UKR,Pulau Pinang,25,11,14,Ukraine
64555,2/1/2023,UKR,Sabah,7,3,4,Ukraine
64556,2/1/2023,UKR,Sarawak,1,1,0,Ukraine
64557,2/1/2023,UKR,Selangor,1031,483,548,Ukraine
64558,2/1/2023,UKR,W.P. Labuan,0,0,0,Ukraine
64559,2/1/2023,URY,Johor,74,28,46,Uruguay
64560,2/1/2023,URY,Kedah,1,1,0,Uruguay
64561,2/1/2023,URY,Kelantan,0,0,0,Uruguay
64562,2/1/2023,URY,Perak,0,0,0,Uruguay
64563,2/1/2023,URY,Perlis,0,0,0,Uruguay
64564,2/1/2023,URY,Pulau Pinang,1,0,1,Uruguay
64565,2/1/2023,URY,Sabah,1,1,0,Uruguay
64566,2/1/2023,URY,Sarawak,0,0,0,Uruguay
64567,2/1/2023,URY,Selangor,111,53,58,Uruguay
64568,2/1/2023,URY,W.P. Labuan,0,0,0,Uruguay
64569,2/1/2023,USA,Johor,3786,2213,1573,United States Of America
64570,2/1/2023,USA,Kedah,556,306,250,United States Of America
64571,2/1/2023,USA,Kelantan,16,11,5,United States Of America
64572,2/1/2023,USA,Melaka,5,2,3,United States Of America
64573,2/1/2023,USA,Negeri Sembilan,0,0,0,United States Of America
64574,2/1/2023,USA,Pahang,2,1,1,United States Of America
64575,2/1/2023,USA,Perak,141,80,61,United States Of America
64576,2/1/2023,USA,Perlis,139,90,49,United States Of America
64577,2/1/2023,USA,Pulau Pinang,1796,1141,655,United States Of America
64578,2/1/2023,USA,Sabah,344,177,167,United States Of America
64579,2/1/2023,USA,Sarawak,282,159,123,United States Of America
64580,2/1/2023,USA,Selangor,11171,6822,4349,United States Of America
64581,2/1/2023,USA,Terengganu,0,0,0,United States Of America
64582,2/1/2023,USA,W.P. Labuan,5,4,1,United States Of America
64583,2/1/2023,UZB,Johor,92,81,11,Uzbekistan
64584,2/1/2023,UZB,Kedah,15,7,8,Uzbekistan
64585,2/1/2023,UZB,Kelantan,1,1,0,Uzbekistan
64586,2/1/2023,UZB,Perak,0,0,0,Uzbekistan
64587,2/1/2023,UZB,Perlis,6,4,2,Uzbekistan
64588,2/1/2023,UZB,Pulau Pinang,14,2,12,Uzbekistan
64589,2/1/2023,UZB,Sabah,1,1,0,Uzbekistan
64590,2/1/2023,UZB,Sarawak,0,0,0,Uzbekistan
64591,2/1/2023,UZB,Selangor,1321,768,553,Uzbekistan
64592,2/1/2023,VAT,Johor,0,0,0,Holy See (Vatican City State)
64593,2/1/2023,VAT,Sarawak,0,0,0,Holy See (Vatican City State)
64594,2/1/2023,VAT,Selangor,1,1,0,Holy See (Vatican City State)
64595,2/1/2023,VCT,Johor,0,0,0,Saint Vincent and the Grenadines
64596,2/1/2023,VCT,Kedah,0,0,0,Saint Vincent and the Grenadines
64597,2/1/2023,VCT,Pulau Pinang,0,0,0,Saint Vincent and the Grenadines
64598,2/1/2023,VCT,Sarawak,0,0,0,Saint Vincent and the Grenadines
64599,2/1/2023,VCT,Selangor,1,1,0,Saint Vincent and the Grenadines
64600,2/1/2023,VEN,Johor,17,8,9,Venezuela
64601,2/1/2023,VEN,Kedah,0,0,0,Venezuela
64602,2/1/2023,VEN,Kelantan,0,0,0,Venezuela
64603,2/1/2023,VEN,Melaka,0,0,0,Venezuela
64604,2/1/2023,VEN,Perak,0,0,0,Venezuela
64605,2/1/2023,VEN,Perlis,0,0,0,Venezuela
64606,2/1/2023,VEN,Pulau Pinang,2,1,1,Venezuela
64607,2/1/2023,VEN,Sabah,0,0,0,Venezuela
64608,2/1/2023,VEN,Sarawak,5,3,2,Venezuela
64609,2/1/2023,VEN,Selangor,48,24,24,Venezuela
64610,2/1/2023,VEN,W.P. Labuan,0,0,0,Venezuela
64611,2/1/2023,VNM,Johor,10757,3249,7508,Vietnam
64612,2/1/2023,VNM,Kedah,247,29,218,Vietnam
64613,2/1/2023,VNM,Kelantan,5,1,4,Vietnam
64614,2/1/2023,VNM,Melaka,0,0,0,Vietnam
64615,2/1/2023,VNM,Negeri Sembilan,0,0,0,Vietnam
64616,2/1/2023,VNM,Pahang,0,0,0,Vietnam
64617,2/1/2023,VNM,Perak,108,22,86,Vietnam
64618,2/1/2023,VNM,Perlis,180,16,164,Vietnam
64619,2/1/2023,VNM,Pulau Pinang,1378,432,946,Vietnam
64620,2/1/2023,VNM,Sabah,19,4,15,Vietnam
64621,2/1/2023,VNM,Sarawak,169,24,145,Vietnam
64622,2/1/2023,VNM,Selangor,13413,4726,8687,Vietnam
64623,2/1/2023,VNM,Terengganu,0,0,0,Vietnam
64624,2/1/2023,VNM,W.P. Labuan,5,3,2,Vietnam
64625,2/1/2023,VUT,Johor,19,13,6,Vanuatu
64626,2/1/2023,VUT,Kedah,0,0,0,Vanuatu
64627,2/1/2023,VUT,Pulau Pinang,3,3,0,Vanuatu
64628,2/1/2023,VUT,Sabah,1,1,0,Vanuatu
64629,2/1/2023,VUT,Sarawak,0,0,0,Vanuatu
64630,2/1/2023,VUT,Selangor,37,33,4,Vanuatu
64631,2/1/2023,WSM,Johor,1,1,0,Samoa
64632,2/1/2023,WSM,Sarawak,0,0,0,Samoa
64633,2/1/2023,WSM,Selangor,1,1,0,Samoa
64634,2/1/2023,YEM,Johor,22,12,10,Yemen
64635,2/1/2023,YEM,Kedah,0,0,0,Yemen
64636,2/1/2023,YEM,Kelantan,0,0,0,Yemen
64637,2/1/2023,YEM,Melaka,0,0,0,Yemen
64638,2/1/2023,YEM,Pahang,0,0,0,Yemen
64639,2/1/2023,YEM,Perak,0,0,0,Yemen
64640,2/1/2023,YEM,Perlis,1,1,0,Yemen
64641,2/1/2023,YEM,Pulau Pinang,5,5,0,Yemen
64642,2/1/2023,YEM,Sabah,0,0,0,Yemen
64643,2/1/2023,YEM,Sarawak,5,2,3,Yemen
64644,2/1/2023,YEM,Selangor,1012,743,269,Yemen
64645,2/1/2023,YEM,W.P. Labuan,0,0,0,Yemen
64646,2/1/2023,ZAF,Johor,279,176,103,South Africa
64647,2/1/2023,ZAF,Kedah,44,25,19,South Africa
64648,2/1/2023,ZAF,Kelantan,1,1,0,South Africa
64649,2/1/2023,ZAF,Melaka,0,0,0,South Africa
64650,2/1/2023,ZAF,Pahang,0,0,0,South Africa
64651,2/1/2023,ZAF,Perak,2,1,1,South Africa
64652,2/1/2023,ZAF,Perlis,10,5,5,South Africa
64653,2/1/2023,ZAF,Pulau Pinang,37,19,18,South Africa
64654,2/1/2023,ZAF,Sabah,6,1,5,South Africa
64655,2/1/2023,ZAF,Sarawak,86,40,46,South Africa
64656,2/1/2023,ZAF,Selangor,668,403,265,South Africa
64657,2/1/2023,ZAF,Terengganu,0,0,0,South Africa
64658,2/1/2023,ZAF,W.P. Labuan,1,1,0,South Africa
64659,2/1/2023,ZMB,Johor,7,3,4,Zambia
64660,2/1/2023,ZMB,Kedah,0,0,0,Zambia
64661,2/1/2023,ZMB,Perak,0,0,0,Zambia
64662,2/1/2023,ZMB,Perlis,0,0,0,Zambia
64663,2/1/2023,ZMB,Pulau Pinang,0,0,0,Zambia
64664,2/1/2023,ZMB,Sabah,0,0,0,Zambia
64665,2/1/2023,ZMB,Sarawak,2,1,1,Zambia
64666,2/1/2023,ZMB,Selangor,43,26,17,Zambia
64667,2/1/2023,ZWE,Johor,8,4,4,Zimbabwe
64668,2/1/2023,ZWE,Kedah,0,0,0,Zimbabwe
64669,2/1/2023,ZWE,Kelantan,0,0,0,Zimbabwe
64670,2/1/2023,ZWE,Perak,0,0,0,Zimbabwe
64671,2/1/2023,ZWE,Perlis,1,0,1,Zimbabwe
64672,2/1/2023,ZWE,Pulau Pinang,0,0,0,Zimbabwe
64673,2/1/2023,ZWE,Sabah,1,0,1,Zimbabwe
64674,2/1/2023,ZWE,Sarawak,0,0,0,Zimbabwe
64675,2/1/2023,ZWE,Selangor,79,40,39,Zimbabwe
64676,3/1/2023,ABW,Kedah,0,0,0,Aruba
64677,3/1/2023,ABW,Pulau Pinang,0,0,0,Aruba
64678,3/1/2023,AFG,Johor,1,1,0,Afghanistan
64679,3/1/2023,AFG,Kedah,0,0,0,Afghanistan
64680,3/1/2023,AFG,Perlis,0,0,0,Afghanistan
64681,3/1/2023,AFG,Pulau Pinang,0,0,0,Afghanistan
64682,3/1/2023,AFG,Sarawak,0,0,0,Afghanistan
64683,3/1/2023,AFG,Selangor,29,25,4,Afghanistan
64684,3/1/2023,AGO,Johor,1,1,0,Angola
64685,3/1/2023,AGO,Kedah,2,2,0,Angola
64686,3/1/2023,AGO,Sabah,0,0,0,Angola
64687,3/1/2023,AGO,Selangor,19,17,2,Angola
64688,3/1/2023,AIA,Selangor,0,0,0,Anguilla
64689,3/1/2023,ALB,Johor,10,9,1,Albania
64690,3/1/2023,ALB,Kedah,3,0,3,Albania
64691,3/1/2023,ALB,Perak,0,0,0,Albania
64692,3/1/2023,ALB,Perlis,0,0,0,Albania
64693,3/1/2023,ALB,Pulau Pinang,0,0,0,Albania
64694,3/1/2023,ALB,Sabah,1,0,1,Albania
64695,3/1/2023,ALB,Sarawak,1,1,0,Albania
64696,3/1/2023,ALB,Selangor,36,25,11,Albania
64697,3/1/2023,AND,Johor,0,0,0,Andorra
64698,3/1/2023,AND,Kedah,0,0,0,Andorra
64699,3/1/2023,AND,Perlis,0,0,0,Andorra
64700,3/1/2023,AND,Pulau Pinang,0,0,0,Andorra
64701,3/1/2023,AND,Selangor,0,0,0,Andorra
64702,3/1/2023,ANT,Selangor,0,0,0,Netherlands Antilles
64703,3/1/2023,ARE,Johor,15,14,1,United Arab Emirates
64704,3/1/2023,ARE,Kedah,0,0,0,United Arab Emirates
64705,3/1/2023,ARE,Kelantan,0,0,0,United Arab Emirates
64706,3/1/2023,ARE,Perak,0,0,0,United Arab Emirates
64707,3/1/2023,ARE,Perlis,0,0,0,United Arab Emirates
64708,3/1/2023,ARE,Pulau Pinang,1,1,0,United Arab Emirates
64709,3/1/2023,ARE,Sabah,0,0,0,United Arab Emirates
64710,3/1/2023,ARE,Sarawak,1,1,0,United Arab Emirates
64711,3/1/2023,ARE,Selangor,224,158,66,United Arab Emirates
64712,3/1/2023,ARG,Johor,62,39,23,Argentina
64713,3/1/2023,ARG,Kedah,69,35,34,Argentina
64714,3/1/2023,ARG,Kelantan,0,0,0,Argentina
64715,3/1/2023,ARG,Melaka,1,1,0,Argentina
64716,3/1/2023,ARG,Perak,1,1,0,Argentina
64717,3/1/2023,ARG,Perlis,16,6,10,Argentina
64718,3/1/2023,ARG,Pulau Pinang,13,7,6,Argentina
64719,3/1/2023,ARG,Sabah,1,0,1,Argentina
64720,3/1/2023,ARG,Sarawak,0,0,0,Argentina
64721,3/1/2023,ARG,Selangor,373,203,170,Argentina
64722,3/1/2023,ARG,W.P. Labuan,0,0,0,Argentina
64723,3/1/2023,ARM,Johor,3,2,1,Armenia
64724,3/1/2023,ARM,Kedah,0,0,0,Armenia
64725,3/1/2023,ARM,Kelantan,0,0,0,Armenia
64726,3/1/2023,ARM,Perak,0,0,0,Armenia
64727,3/1/2023,ARM,Perlis,0,0,0,Armenia
64728,3/1/2023,ARM,Pulau Pinang,0,0,0,Armenia
64729,3/1/2023,ARM,Sabah,0,0,0,Armenia
64730,3/1/2023,ARM,Sarawak,0,0,0,Armenia
64731,3/1/2023,ARM,Selangor,128,51,77,Armenia
64732,3/1/2023,ATA,Selangor,0,0,0,Antarctica
64733,3/1/2023,ATG,Johor,8,7,1,Antigua and Barbuda
64734,3/1/2023,ATG,Kedah,5,2,3,Antigua and Barbuda
64735,3/1/2023,ATG,Pulau Pinang,0,0,0,Antigua and Barbuda
64736,3/1/2023,ATG,Sarawak,0,0,0,Antigua and Barbuda
64737,3/1/2023,ATG,Selangor,17,9,8,Antigua and Barbuda
64738,3/1/2023,AUS,Johor,4283,2546,1737,Australia
64739,3/1/2023,AUS,Kedah,508,293,215,Australia
64740,3/1/2023,AUS,Kelantan,13,10,3,Australia
64741,3/1/2023,AUS,Melaka,1,1,0,Australia
64742,3/1/2023,AUS,Negeri Sembilan,1,1,0,Australia
64743,3/1/2023,AUS,Pahang,2,2,0,Australia
64744,3/1/2023,AUS,Perak,183,101,82,Australia
64745,3/1/2023,AUS,Perlis,74,48,26,Australia
64746,3/1/2023,AUS,Pulau Pinang,1589,872,717,Australia
64747,3/1/2023,AUS,Sabah,439,228,211,Australia
64748,3/1/2023,AUS,Sarawak,639,359,280,Australia
64749,3/1/2023,AUS,Selangor,18900,11159,7741,Australia
64750,3/1/2023,AUS,Terengganu,0,0,0,Australia
64751,3/1/2023,AUS,W.P. Labuan,3,2,1,Australia
64752,3/1/2023,AUT,Johor,149,95,54,Austria
64753,3/1/2023,AUT,Kedah,106,55,51,Austria
64754,3/1/2023,AUT,Kelantan,4,4,0,Austria
64755,3/1/2023,AUT,Melaka,3,2,1,Austria
64756,3/1/2023,AUT,Negeri Sembilan,0,0,0,Austria
64757,3/1/2023,AUT,Pahang,0,0,0,Austria
64758,3/1/2023,AUT,Perak,1,0,1,Austria
64759,3/1/2023,AUT,Perlis,14,10,4,Austria
64760,3/1/2023,AUT,Pulau Pinang,91,67,24,Austria
64761,3/1/2023,AUT,Sabah,18,11,7,Austria
64762,3/1/2023,AUT,Sarawak,28,21,7,Austria
64763,3/1/2023,AUT,Selangor,701,450,251,Austria
64764,3/1/2023,AUT,Terengganu,0,0,0,Austria
64765,3/1/2023,AUT,W.P. Labuan,0,0,0,Austria
64766,3/1/2023,AZE,Johor,8,4,4,Azerbaijan
64767,3/1/2023,AZE,Kedah,10,7,3,Azerbaijan
64768,3/1/2023,AZE,Kelantan,0,0,0,Azerbaijan
64769,3/1/2023,AZE,Melaka,0,0,0,Azerbaijan
64770,3/1/2023,AZE,Perlis,0,0,0,Azerbaijan
64771,3/1/2023,AZE,Pulau Pinang,2,1,1,Azerbaijan
64772,3/1/2023,AZE,Sabah,0,0,0,Azerbaijan
64773,3/1/2023,AZE,Sarawak,4,2,2,Azerbaijan
64774,3/1/2023,AZE,Selangor,219,101,118,Azerbaijan
64775,3/1/2023,AZE,W.P. Labuan,0,0,0,Azerbaijan
64776,3/1/2023,BDI,Pulau Pinang,0,0,0,Burundi
64777,3/1/2023,BDI,Sarawak,0,0,0,Burundi
64778,3/1/2023,BDI,Selangor,4,1,3,Burundi
64779,3/1/2023,BEL,Johor,230,159,71,Belgium
64780,3/1/2023,BEL,Kedah,130,69,61,Belgium
64781,3/1/2023,BEL,Kelantan,5,3,2,Belgium
64782,3/1/2023,BEL,Melaka,0,0,0,Belgium
64783,3/1/2023,BEL,Negeri Sembilan,0,0,0,Belgium
64784,3/1/2023,BEL,Pahang,0,0,0,Belgium
64785,3/1/2023,BEL,Perak,1,1,0,Belgium
64786,3/1/2023,BEL,Perlis,24,11,13,Belgium
64787,3/1/2023,BEL,Pulau Pinang,65,40,25,Belgium
64788,3/1/2023,BEL,Sabah,10,6,4,Belgium
64789,3/1/2023,BEL,Sarawak,23,11,12,Belgium
64790,3/1/2023,BEL,Selangor,939,606,333,Belgium
64791,3/1/2023,BEL,W.P. Labuan,0,0,0,Belgium
64792,3/1/2023,BEN,Johor,2,2,0,Benin
64793,3/1/2023,BEN,Kedah,0,0,0,Benin
64794,3/1/2023,BEN,Perak,0,0,0,Benin
64795,3/1/2023,BEN,Pulau Pinang,0,0,0,Benin
64796,3/1/2023,BEN,Sabah,1,1,0,Benin
64797,3/1/2023,BEN,Sarawak,0,0,0,Benin
64798,3/1/2023,BEN,Selangor,8,6,2,Benin
64799,3/1/2023,BFA,Perak,0,0,0,Burkina Faso
64800,3/1/2023,BFA,Pulau Pinang,1,1,0,Burkina Faso
64801,3/1/2023,BFA,Selangor,4,4,0,Burkina Faso
64802,3/1/2023,BGD,Johor,2780,2342,438,Bangladesh
64803,3/1/2023,BGD,Kedah,34,22,12,Bangladesh
64804,3/1/2023,BGD,Kelantan,1,1,0,Bangladesh
64805,3/1/2023,BGD,Melaka,0,0,0,Bangladesh
64806,3/1/2023,BGD,Negeri Sembilan,0,0,0,Bangladesh
64807,3/1/2023,BGD,Pahang,1,1,0,Bangladesh
64808,3/1/2023,BGD,Perak,0,0,0,Bangladesh
64809,3/1/2023,BGD,Perlis,4,4,0,Bangladesh
64810,3/1/2023,BGD,Pulau Pinang,755,739,16,Bangladesh
64811,3/1/2023,BGD,Sabah,4,3,1,Bangladesh
64812,3/1/2023,BGD,Sarawak,82,77,5,Bangladesh
64813,3/1/2023,BGD,Selangor,59315,57741,1574,Bangladesh
64814,3/1/2023,BGD,W.P. Labuan,1,1,0,Bangladesh
64815,3/1/2023,BGR,Johor,46,22,24,Bulgaria
64816,3/1/2023,BGR,Kedah,24,14,10,Bulgaria
64817,3/1/2023,BGR,Kelantan,0,0,0,Bulgaria
64818,3/1/2023,BGR,Pahang,0,0,0,Bulgaria
64819,3/1/2023,BGR,Perak,0,0,0,Bulgaria
64820,3/1/2023,BGR,Perlis,2,1,1,Bulgaria
64821,3/1/2023,BGR,Pulau Pinang,7,5,2,Bulgaria
64822,3/1/2023,BGR,Sabah,5,3,2,Bulgaria
64823,3/1/2023,BGR,Sarawak,2,1,1,Bulgaria
64824,3/1/2023,BGR,Selangor,265,132,133,Bulgaria
64825,3/1/2023,BGR,W.P. Labuan,0,0,0,Bulgaria
64826,3/1/2023,BHR,Johor,1,1,0,Bahrain
64827,3/1/2023,BHR,Kedah,0,0,0,Bahrain
64828,3/1/2023,BHR,Kelantan,0,0,0,Bahrain
64829,3/1/2023,BHR,Perlis,0,0,0,Bahrain
64830,3/1/2023,BHR,Pulau Pinang,1,1,0,Bahrain
64831,3/1/2023,BHR,Sabah,0,0,0,Bahrain
64832,3/1/2023,BHR,Sarawak,0,0,0,Bahrain
64833,3/1/2023,BHR,Selangor,72,46,26,Bahrain
64834,3/1/2023,BHS,Johor,1,1,0,Bahamas
64835,3/1/2023,BHS,Kedah,0,0,0,Bahamas
64836,3/1/2023,BHS,Perak,0,0,0,Bahamas
64837,3/1/2023,BHS,Sabah,0,0,0,Bahamas
64838,3/1/2023,BHS,Sarawak,0,0,0,Bahamas
64839,3/1/2023,BHS,Selangor,16,9,7,Bahamas
64840,3/1/2023,BIH,Johor,9,2,7,Bosnia and Herzegovina
64841,3/1/2023,BIH,Kedah,2,1,1,Bosnia and Herzegovina
64842,3/1/2023,BIH,Perlis,0,0,0,Bosnia and Herzegovina
64843,3/1/2023,BIH,Pulau Pinang,0,0,0,Bosnia and Herzegovina
64844,3/1/2023,BIH,Sabah,2,1,1,Bosnia and Herzegovina
64845,3/1/2023,BIH,Sarawak,1,1,0,Bosnia and Herzegovina
64846,3/1/2023,BIH,Selangor,59,32,27,Bosnia and Herzegovina
64847,3/1/2023,BLR,Johor,23,4,19,Belarus
64848,3/1/2023,BLR,Kedah,23,14,9,Belarus
64849,3/1/2023,BLR,Kelantan,1,0,1,Belarus
64850,3/1/2023,BLR,Pahang,0,0,0,Belarus
64851,3/1/2023,BLR,Perak,0,0,0,Belarus
64852,3/1/2023,BLR,Perlis,3,1,2,Belarus
64853,3/1/2023,BLR,Pulau Pinang,6,2,4,Belarus
64854,3/1/2023,BLR,Sabah,6,2,4,Belarus
64855,3/1/2023,BLR,Sarawak,1,0,1,Belarus
64856,3/1/2023,BLR,Selangor,526,259,267,Belarus
64857,3/1/2023,BLR,W.P. Labuan,0,0,0,Belarus
64858,3/1/2023,BLZ,Johor,1,0,1,Belize
64859,3/1/2023,BLZ,Pulau Pinang,0,0,0,Belize
64860,3/1/2023,BLZ,Sarawak,0,0,0,Belize
64861,3/1/2023,BLZ,Selangor,8,4,4,Belize
64862,3/1/2023,BMU,Selangor,0,0,0,Bermuda
64863,3/1/2023,BOL,Johor,0,0,0,Bolivia
64864,3/1/2023,BOL,Kedah,0,0,0,Bolivia
64865,3/1/2023,BOL,Melaka,1,1,0,Bolivia
64866,3/1/2023,BOL,Perak,0,0,0,Bolivia
64867,3/1/2023,BOL,Perlis,0,0,0,Bolivia
64868,3/1/2023,BOL,Pulau Pinang,2,0,2,Bolivia
64869,3/1/2023,BOL,Sabah,0,0,0,Bolivia
64870,3/1/2023,BOL,Sarawak,1,1,0,Bolivia
64871,3/1/2023,BOL,Selangor,12,9,3,Bolivia
64872,3/1/2023,BRA,Johor,246,157,89,Brazil
64873,3/1/2023,BRA,Kedah,85,39,46,Brazil
64874,3/1/2023,BRA,Kelantan,2,1,1,Brazil
64875,3/1/2023,BRA,Melaka,2,2,0,Brazil
64876,3/1/2023,BRA,Pahang,1,1,0,Brazil
64877,3/1/2023,BRA,Perak,1,1,0,Brazil
64878,3/1/2023,BRA,Perlis,6,3,3,Brazil
64879,3/1/2023,BRA,Pulau Pinang,28,18,10,Brazil
64880,3/1/2023,BRA,Sabah,14,8,6,Brazil
64881,3/1/2023,BRA,Sarawak,7,6,1,Brazil
64882,3/1/2023,BRA,Selangor,778,455,323,Brazil
64883,3/1/2023,BRA,W.P. Labuan,0,0,0,Brazil
64884,3/1/2023,BRB,Johor,2,0,2,Barbados
64885,3/1/2023,BRB,Kedah,0,0,0,Barbados
64886,3/1/2023,BRB,Perlis,0,0,0,Barbados
64887,3/1/2023,BRB,Pulau Pinang,0,0,0,Barbados
64888,3/1/2023,BRB,Selangor,1,1,0,Barbados
64889,3/1/2023,BRN,Johor,366,194,172,Brunei Darussalam
64890,3/1/2023,BRN,Kedah,38,28,10,Brunei Darussalam
64891,3/1/2023,BRN,Kelantan,5,3,2,Brunei Darussalam
64892,3/1/2023,BRN,Melaka,3,3,0,Brunei Darussalam
64893,3/1/2023,BRN,Pahang,0,0,0,Brunei Darussalam
64894,3/1/2023,BRN,Perak,6,4,2,Brunei Darussalam
64895,3/1/2023,BRN,Perlis,20,9,11,Brunei Darussalam
64896,3/1/2023,BRN,Pulau Pinang,23,11,12,Brunei Darussalam
64897,3/1/2023,BRN,Sabah,623,275,348,Brunei Darussalam
64898,3/1/2023,BRN,Sarawak,90248,49820,40428,Brunei Darussalam
64899,3/1/2023,BRN,Selangor,4819,2330,2489,Brunei Darussalam
64900,3/1/2023,BRN,W.P. Labuan,992,686,306,Brunei Darussalam
64901,3/1/2023,BTN,Johor,17,11,6,Bhutan
64902,3/1/2023,BTN,Kedah,0,0,0,Bhutan
64903,3/1/2023,BTN,Perak,0,0,0,Bhutan
64904,3/1/2023,BTN,Perlis,0,0,0,Bhutan
64905,3/1/2023,BTN,Pulau Pinang,0,0,0,Bhutan
64906,3/1/2023,BTN,Sabah,0,0,0,Bhutan
64907,3/1/2023,BTN,Sarawak,1,1,0,Bhutan
64908,3/1/2023,BTN,Selangor,48,40,8,Bhutan
64909,3/1/2023,BWA,Johor,0,0,0,Botswana
64910,3/1/2023,BWA,Kedah,0,0,0,Botswana
64911,3/1/2023,BWA,Perlis,0,0,0,Botswana
64912,3/1/2023,BWA,Pulau Pinang,0,0,0,Botswana
64913,3/1/2023,BWA,Sabah,0,0,0,Botswana
64914,3/1/2023,BWA,Sarawak,0,0,0,Botswana
64915,3/1/2023,BWA,Selangor,13,8,5,Botswana
64916,3/1/2023,CAF,Kedah,0,0,0,Central African Republic
64917,3/1/2023,CAF,Selangor,0,0,0,Central African Republic
64918,3/1/2023,CAN,Johor,1589,899,690,Canada
64919,3/1/2023,CAN,Kedah,298,168,130,Canada
64920,3/1/2023,CAN,Kelantan,6,5,1,Canada
64921,3/1/2023,CAN,Melaka,3,2,1,Canada
64922,3/1/2023,CAN,Negeri Sembilan,0,0,0,Canada
64923,3/1/2023,CAN,Pahang,0,0,0,Canada
64924,3/1/2023,CAN,Perak,43,20,23,Canada
64925,3/1/2023,CAN,Perlis,71,42,29,Canada
64926,3/1/2023,CAN,Pulau Pinang,549,305,244,Canada
64927,3/1/2023,CAN,Sabah,221,109,112,Canada
64928,3/1/2023,CAN,Sarawak,471,260,211,Canada
64929,3/1/2023,CAN,Selangor,4673,2709,1964,Canada
64930,3/1/2023,CAN,Terengganu,5,5,0,Canada
64931,3/1/2023,CAN,W.P. Labuan,3,3,0,Canada
64932,3/1/2023,CCK,Selangor,0,0,0,Cocos (Keeling) Islands
64933,3/1/2023,CHE,Johor,353,212,141,Switzerland
64934,3/1/2023,CHE,Kedah,211,119,92,Switzerland
64935,3/1/2023,CHE,Kelantan,2,2,0,Switzerland
64936,3/1/2023,CHE,Melaka,0,0,0,Switzerland
64937,3/1/2023,CHE,Negeri Sembilan,0,0,0,Switzerland
64938,3/1/2023,CHE,Pahang,0,0,0,Switzerland
64939,3/1/2023,CHE,Perak,9,5,4,Switzerland
64940,3/1/2023,CHE,Perlis,25,16,9,Switzerland
64941,3/1/2023,CHE,Pulau Pinang,156,98,58,Switzerland
64942,3/1/2023,CHE,Sabah,39,18,21,Switzerland
64943,3/1/2023,CHE,Sarawak,45,22,23,Switzerland
64944,3/1/2023,CHE,Selangor,1305,798,507,Switzerland
64945,3/1/2023,CHE,W.P. Labuan,0,0,0,Switzerland
64946,3/1/2023,CHL,Johor,19,12,7,Chile
64947,3/1/2023,CHL,Kedah,17,8,9,Chile
64948,3/1/2023,CHL,Kelantan,1,1,0,Chile
64949,3/1/2023,CHL,Melaka,0,0,0,Chile
64950,3/1/2023,CHL,Pahang,0,0,0,Chile
64951,3/1/2023,CHL,Perak,0,0,0,Chile
64952,3/1/2023,CHL,Perlis,2,1,1,Chile
64953,3/1/2023,CHL,Pulau Pinang,5,3,2,Chile
64954,3/1/2023,CHL,Sabah,2,1,1,Chile
64955,3/1/2023,CHL,Sarawak,2,1,1,Chile
64956,3/1/2023,CHL,Selangor,199,108,91,Chile
64957,3/1/2023,CHN,Johor,28268,11991,16277,China
64958,3/1/2023,CHN,Kedah,669,307,362,China
64959,3/1/2023,CHN,Kelantan,4,3,1,China
64960,3/1/2023,CHN,Melaka,4,4,0,China
64961,3/1/2023,CHN,Pahang,8,5,3,China
64962,3/1/2023,CHN,Perak,162,63,99,China
64963,3/1/2023,CHN,Perlis,112,40,72,China
64964,3/1/2023,CHN,Pulau Pinang,5099,2686,2413,China
64965,3/1/2023,CHN,Sabah,5054,2563,2491,China
64966,3/1/2023,CHN,Sarawak,919,455,464,China
64967,3/1/2023,CHN,Selangor,62452,34414,28038,China
64968,3/1/2023,CHN,Terengganu,0,0,0,China
64969,3/1/2023,CHN,W.P. Labuan,23,19,4,China
64970,3/1/2023,CIV,Johor,1,0,1,C��te d'Iv
64971,3/1/2023,CIV,Kedah,0,0,0,C��te d'Iv
64972,3/1/2023,CIV,Pulau Pinang,0,0,0,C��te d'Iv
64973,3/1/2023,CIV,Sabah,0,0,0,C��te d'Iv
64974,3/1/2023,CIV,Sarawak,0,0,0,C��te d'Iv
64975,3/1/2023,CIV,Selangor,12,8,4,C��te d'Iv
64976,3/1/2023,CMR,Johor,1,1,0,Cameroon
64977,3/1/2023,CMR,Kedah,0,0,0,Cameroon
64978,3/1/2023,CMR,Pulau Pinang,0,0,0,Cameroon
64979,3/1/2023,CMR,Sabah,0,0,0,Cameroon
64980,3/1/2023,CMR,Sarawak,0,0,0,Cameroon
64981,3/1/2023,CMR,Selangor,25,18,7,Cameroon
64982,3/1/2023,COD,Johor,3,3,0,"Congo, the Democratic Republic of the"
64983,3/1/2023,COD,Pulau Pinang,0,0,0,"Congo, the Democratic Republic of the"
64984,3/1/2023,COD,Sarawak,0,0,0,"Congo, the Democratic Republic of the"
64985,3/1/2023,COD,Selangor,11,9,2,"Congo, the Democratic Republic of the"
64986,3/1/2023,COG,Johor,0,0,0,Congo
64987,3/1/2023,COG,Kedah,0,0,0,Congo
64988,3/1/2023,COG,Selangor,0,0,0,Congo
64989,3/1/2023,COK,Selangor,0,0,0,Cook Islands
64990,3/1/2023,COL,Johor,13,7,6,Colombia
64991,3/1/2023,COL,Kedah,4,0,4,Colombia
64992,3/1/2023,COL,Perak,0,0,0,Colombia
64993,3/1/2023,COL,Pulau Pinang,3,1,2,Colombia
64994,3/1/2023,COL,Sabah,0,0,0,Colombia
64995,3/1/2023,COL,Sarawak,2,1,1,Colombia
64996,3/1/2023,COL,Selangor,143,72,71,Colombia
64997,3/1/2023,COL,W.P. Labuan,0,0,0,Colombia
64998,3/1/2023,COM,Johor,0,0,0,Comoros
64999,3/1/2023,COM,Kedah,0,0,0,Comoros
65000,3/1/2023,COM,Selangor,11,3,8,Comoros
65001,3/1/2023,CPV,Johor,2,0,2,Cape Verde
65002,3/1/2023,CPV,Kedah,0,0,0,Cape Verde
65003,3/1/2023,CPV,Pulau Pinang,0,0,0,Cape Verde
65004,3/1/2023,CPV,Sabah,0,0,0,Cape Verde
65005,3/1/2023,CPV,Selangor,1,1,0,Cape Verde
65006,3/1/2023,CRI,Johor,14,10,4,Costa Rica
65007,3/1/2023,CRI,Kedah,0,0,0,Costa Rica
65008,3/1/2023,CRI,Perak,0,0,0,Costa Rica
65009,3/1/2023,CRI,Perlis,0,0,0,Costa Rica
65010,3/1/2023,CRI,Pulau Pinang,3,3,0,Costa Rica
65011,3/1/2023,CRI,Sabah,1,1,0,Costa Rica
65012,3/1/2023,CRI,Sarawak,0,0,0,Costa Rica
65013,3/1/2023,CRI,Selangor,48,27,21,Costa Rica
65014,3/1/2023,CUB,Johor,2,1,1,Cuba
65015,3/1/2023,CUB,Kedah,0,0,0,Cuba
65016,3/1/2023,CUB,Perlis,0,0,0,Cuba
65017,3/1/2023,CUB,Pulau Pinang,1,1,0,Cuba
65018,3/1/2023,CUB,Sabah,0,0,0,Cuba
65019,3/1/2023,CUB,Sarawak,0,0,0,Cuba
65020,3/1/2023,CUB,Selangor,20,11,9,Cuba
65021,3/1/2023,CYP,Johor,9,4,5,Cyprus
65022,3/1/2023,CYP,Kedah,0,0,0,Cyprus
65023,3/1/2023,CYP,Perak,0,0,0,Cyprus
65024,3/1/2023,CYP,Perlis,3,2,1,Cyprus
65025,3/1/2023,CYP,Pulau Pinang,2,2,0,Cyprus
65026,3/1/2023,CYP,Sabah,0,0,0,Cyprus
65027,3/1/2023,CYP,Sarawak,2,1,1,Cyprus
65028,3/1/2023,CYP,Selangor,75,47,28,Cyprus
65029,3/1/2023,CZE,Johor,146,88,58,Czech Republic
65030,3/1/2023,CZE,Kedah,156,72,84,Czech Republic
65031,3/1/2023,CZE,Kelantan,4,2,2,Czech Republic
65032,3/1/2023,CZE,Melaka,0,0,0,Czech Republic
65033,3/1/2023,CZE,Negeri Sembilan,0,0,0,Czech Republic
65034,3/1/2023,CZE,Perak,0,0,0,Czech Republic
65035,3/1/2023,CZE,Perlis,14,11,3,Czech Republic
65036,3/1/2023,CZE,Pulau Pinang,51,31,20,Czech Republic
65037,3/1/2023,CZE,Sabah,23,12,11,Czech Republic
65038,3/1/2023,CZE,Sarawak,21,15,6,Czech Republic
65039,3/1/2023,CZE,Selangor,744,438,306,Czech Republic
65040,3/1/2023,CZE,W.P. Labuan,6,4,2,Czech Republic
65041,3/1/2023,DEU,Johor,2655,1542,1113,Germany
65042,3/1/2023,DEU,Kedah,1183,596,587,Germany
65043,3/1/2023,DEU,Kelantan,13,7,6,Germany
65044,3/1/2023,DEU,Melaka,3,3,0,Germany
65045,3/1/2023,DEU,Negeri Sembilan,1,1,0,Germany
65046,3/1/2023,DEU,Pahang,4,3,1,Germany
65047,3/1/2023,DEU,Perak,31,16,15,Germany
65048,3/1/2023,DEU,Perlis,209,120,89,Germany
65049,3/1/2023,DEU,Pulau Pinang,860,596,264,Germany
65050,3/1/2023,DEU,Sabah,160,91,69,Germany
65051,3/1/2023,DEU,Sarawak,272,140,132,Germany
65052,3/1/2023,DEU,Selangor,7648,4761,2887,Germany
65053,3/1/2023,DEU,Terengganu,0,0,0,Germany
65054,3/1/2023,DEU,W.P. Labuan,9,4,5,Germany
65055,3/1/2023,DJI,Johor,0,0,0,Djibouti
65056,3/1/2023,DJI,Selangor,4,1,3,Djibouti
65057,3/1/2023,DMA,Johor,17,13,4,Dominica
65058,3/1/2023,DMA,Kedah,1,1,0,Dominica
65059,3/1/2023,DMA,Pulau Pinang,1,1,0,Dominica
65060,3/1/2023,DMA,Sabah,1,0,1,Dominica
65061,3/1/2023,DMA,Sarawak,0,0,0,Dominica
65062,3/1/2023,DMA,Selangor,45,35,10,Dominica
65063,3/1/2023,DMA,W.P. Labuan,0,0,0,Dominica
65064,3/1/2023,DNK,Johor,238,163,75,Denmark
65065,3/1/2023,DNK,Kedah,190,80,110,Denmark
65066,3/1/2023,DNK,Kelantan,1,1,0,Denmark
65067,3/1/2023,DNK,Melaka,0,0,0,Denmark
65068,3/1/2023,DNK,Negeri Sembilan,0,0,0,Denmark
65069,3/1/2023,DNK,Pahang,0,0,0,Denmark
65070,3/1/2023,DNK,Perak,8,3,5,Denmark
65071,3/1/2023,DNK,Perlis,25,16,9,Denmark
65072,3/1/2023,DNK,Pulau Pinang,52,39,13,Denmark
65073,3/1/2023,DNK,Sabah,69,31,38,Denmark
65074,3/1/2023,DNK,Sarawak,45,22,23,Denmark
65075,3/1/2023,DNK,Selangor,1215,697,518,Denmark
65076,3/1/2023,DNK,W.P. Labuan,1,1,0,Denmark
65077,3/1/2023,DOM,Johor,0,0,0,Dominican Republic
65078,3/1/2023,DOM,Kedah,0,0,0,Dominican Republic
65079,3/1/2023,DOM,Perak,0,0,0,Dominican Republic
65080,3/1/2023,DOM,Perlis,0,0,0,Dominican Republic
65081,3/1/2023,DOM,Pulau Pinang,3,1,2,Dominican Republic
65082,3/1/2023,DOM,Sabah,0,0,0,Dominican Republic
65083,3/1/2023,DOM,Sarawak,0,0,0,Dominican Republic
65084,3/1/2023,DOM,Selangor,67,40,27,Dominican Republic
65085,3/1/2023,DZA,Johor,20,16,4,Algeria
65086,3/1/2023,DZA,Kedah,2,2,0,Algeria
65087,3/1/2023,DZA,Kelantan,0,0,0,Algeria
65088,3/1/2023,DZA,Melaka,0,0,0,Algeria
65089,3/1/2023,DZA,Perak,1,1,0,Algeria
65090,3/1/2023,DZA,Perlis,2,2,0,Algeria
65091,3/1/2023,DZA,Pulau Pinang,2,1,1,Algeria
65092,3/1/2023,DZA,Sabah,1,1,0,Algeria
65093,3/1/2023,DZA,Sarawak,0,0,0,Algeria
65094,3/1/2023,DZA,Selangor,386,281,105,Algeria
65095,3/1/2023,DZA,W.P. Labuan,0,0,0,Algeria
65096,3/1/2023,ECU,Johor,12,7,5,Ecuador
65097,3/1/2023,ECU,Kedah,2,1,1,Ecuador
65098,3/1/2023,ECU,Perak,0,0,0,Ecuador
65099,3/1/2023,ECU,Perlis,0,0,0,Ecuador
65100,3/1/2023,ECU,Pulau Pinang,0,0,0,Ecuador
65101,3/1/2023,ECU,Sabah,0,0,0,Ecuador
65102,3/1/2023,ECU,Sarawak,0,0,0,Ecuador
65103,3/1/2023,ECU,Selangor,67,35,32,Ecuador
65104,3/1/2023,EGY,Johor,250,216,34,Egypt
65105,3/1/2023,EGY,Kedah,9,6,3,Egypt
65106,3/1/2023,EGY,Kelantan,0,0,0,Egypt
65107,3/1/2023,EGY,Melaka,2,2,0,Egypt
65108,3/1/2023,EGY,Pahang,1,1,0,Egypt
65109,3/1/2023,EGY,Perak,1,1,0,Egypt
65110,3/1/2023,EGY,Perlis,2,2,0,Egypt
65111,3/1/2023,EGY,Pulau Pinang,5,4,1,Egypt
65112,3/1/2023,EGY,Sabah,0,0,0,Egypt
65113,3/1/2023,EGY,Sarawak,105,70,35,Egypt
65114,3/1/2023,EGY,Selangor,1178,907,271,Egypt
65115,3/1/2023,EGY,Terengganu,2,2,0,Egypt
65116,3/1/2023,EGY,W.P. Labuan,1,1,0,Egypt
65117,3/1/2023,ERI,Johor,2,1,1,Eritrea
65118,3/1/2023,ERI,Pulau Pinang,0,0,0,Eritrea
65119,3/1/2023,ERI,Sabah,0,0,0,Eritrea
65120,3/1/2023,ERI,Selangor,27,17,10,Eritrea
65121,3/1/2023,ESP,Johor,431,258,173,Spain
65122,3/1/2023,ESP,Kedah,196,106,90,Spain
65123,3/1/2023,ESP,Kelantan,4,2,2,Spain
65124,3/1/2023,ESP,Melaka,0,0,0,Spain
65125,3/1/2023,ESP,Negeri Sembilan,0,0,0,Spain
65126,3/1/2023,ESP,Pahang,0,0,0,Spain
65127,3/1/2023,ESP,Perak,1,1,0,Spain
65128,3/1/2023,ESP,Perlis,19,9,10,Spain
65129,3/1/2023,ESP,Pulau Pinang,94,53,41,Spain
65130,3/1/2023,ESP,Sabah,41,25,16,Spain
65131,3/1/2023,ESP,Sarawak,37,25,12,Spain
65132,3/1/2023,ESP,Selangor,1955,1153,802,Spain
65133,3/1/2023,ESP,W.P. Labuan,0,0,0,Spain
65134,3/1/2023,EST,Johor,45,24,21,Estonia
65135,3/1/2023,EST,Kedah,88,51,37,Estonia
65136,3/1/2023,EST,Kelantan,0,0,0,Estonia
65137,3/1/2023,EST,Pahang,0,0,0,Estonia
65138,3/1/2023,EST,Perak,0,0,0,Estonia
65139,3/1/2023,EST,Perlis,4,1,3,Estonia
65140,3/1/2023,EST,Pulau Pinang,17,9,8,Estonia
65141,3/1/2023,EST,Sabah,1,0,1,Estonia
65142,3/1/2023,EST,Sarawak,5,3,2,Estonia
65143,3/1/2023,EST,Selangor,268,131,137,Estonia
65144,3/1/2023,EST,W.P. Labuan,0,0,0,Estonia
65145,3/1/2023,ETH,Johor,2,2,0,Ethiopia
65146,3/1/2023,ETH,Kedah,0,0,0,Ethiopia
65147,3/1/2023,ETH,Pulau Pinang,0,0,0,Ethiopia
65148,3/1/2023,ETH,Sarawak,0,0,0,Ethiopia
65149,3/1/2023,ETH,Selangor,20,17,3,Ethiopia
65150,3/1/2023,FIN,Johor,191,107,84,Finland
65151,3/1/2023,FIN,Kedah,132,71,61,Finland
65152,3/1/2023,FIN,Kelantan,1,1,0,Finland
65153,3/1/2023,FIN,Melaka,0,0,0,Finland
65154,3/1/2023,FIN,Negeri Sembilan,0,0,0,Finland
65155,3/1/2023,FIN,Pahang,0,0,0,Finland
65156,3/1/2023,FIN,Perak,7,4,3,Finland
65157,3/1/2023,FIN,Perlis,12,8,4,Finland
65158,3/1/2023,FIN,Pulau Pinang,65,38,27,Finland
65159,3/1/2023,FIN,Sabah,29,18,11,Finland
65160,3/1/2023,FIN,Sarawak,15,9,6,Finland
65161,3/1/2023,FIN,Selangor,671,376,295,Finland
65162,3/1/2023,FIN,W.P. Labuan,2,2,0,Finland
65163,3/1/2023,FJI,Johor,42,25,17,Fiji
65164,3/1/2023,FJI,Kedah,3,1,2,Fiji
65165,3/1/2023,FJI,Kelantan,0,0,0,Fiji
65166,3/1/2023,FJI,Perak,0,0,0,Fiji
65167,3/1/2023,FJI,Perlis,0,0,0,Fiji
65168,3/1/2023,FJI,Pulau Pinang,7,5,2,Fiji
65169,3/1/2023,FJI,Sabah,3,0,3,Fiji
65170,3/1/2023,FJI,Sarawak,2,1,1,Fiji
65171,3/1/2023,FJI,Selangor,93,51,42,Fiji
65172,3/1/2023,FRA,Johor,1756,1074,682,France
65173,3/1/2023,FRA,Kedah,950,500,450,France
65174,3/1/2023,FRA,Kelantan,32,18,14,France
65175,3/1/2023,FRA,Melaka,2,2,0,France
65176,3/1/2023,FRA,Negeri Sembilan,1,1,0,France
65177,3/1/2023,FRA,Pahang,10,7,3,France
65178,3/1/2023,FRA,Perak,32,16,16,France
65179,3/1/2023,FRA,Perlis,131,90,41,France
65180,3/1/2023,FRA,Pulau Pinang,453,281,172,France
65181,3/1/2023,FRA,Sabah,110,64,46,France
65182,3/1/2023,FRA,Sarawak,138,80,58,France
65183,3/1/2023,FRA,Selangor,7694,4574,3120,France
65184,3/1/2023,FRA,Terengganu,0,0,0,France
65185,3/1/2023,FRA,W.P. Labuan,2,2,0,France
65186,3/1/2023,FSM,Johor,0,0,0,"Micronesia, Federated States of"
65187,3/1/2023,FSM,Pulau Pinang,0,0,0,"Micronesia, Federated States of"
65188,3/1/2023,FSM,Selangor,1,0,1,"Micronesia, Federated States of"
65189,3/1/2023,GAB,Johor,0,0,0,Gabon
65190,3/1/2023,GAB,Pulau Pinang,0,0,0,Gabon
65191,3/1/2023,GAB,Sarawak,0,0,0,Gabon
65192,3/1/2023,GAB,Selangor,4,2,2,Gabon
65193,3/1/2023,GBR,Johor,4531,2864,1667,United Kingdom
65194,3/1/2023,GBR,Kedah,1489,791,698,United Kingdom
65195,3/1/2023,GBR,Kelantan,20,18,2,United Kingdom
65196,3/1/2023,GBR,Melaka,6,3,3,United Kingdom
65197,3/1/2023,GBR,Negeri Sembilan,1,1,0,United Kingdom
65198,3/1/2023,GBR,Pahang,4,4,0,United Kingdom
65199,3/1/2023,GBR,Perak,96,53,43,United Kingdom
65200,3/1/2023,GBR,Perlis,251,168,83,United Kingdom
65201,3/1/2023,GBR,Pulau Pinang,1604,919,685,United Kingdom
65202,3/1/2023,GBR,Sabah,699,375,324,United Kingdom
65203,3/1/2023,GBR,Sarawak,1484,876,608,United Kingdom
65204,3/1/2023,GBR,Selangor,16846,10148,6698,United Kingdom
65205,3/1/2023,GBR,Terengganu,0,0,0,United Kingdom
65206,3/1/2023,GBR,W.P. Labuan,21,14,7,United Kingdom
65207,3/1/2023,GEO,Johor,12,11,1,Georgia
65208,3/1/2023,GEO,Kedah,2,1,1,Georgia
65209,3/1/2023,GEO,Melaka,0,0,0,Georgia
65210,3/1/2023,GEO,Perak,0,0,0,Georgia
65211,3/1/2023,GEO,Perlis,5,3,2,Georgia
65212,3/1/2023,GEO,Pulau Pinang,1,1,0,Georgia
65213,3/1/2023,GEO,Sabah,0,0,0,Georgia
65214,3/1/2023,GEO,Sarawak,0,0,0,Georgia
65215,3/1/2023,GEO,Selangor,73,48,25,Georgia
65216,3/1/2023,GHA,Johor,14,14,0,Ghana
65217,3/1/2023,GHA,Kedah,0,0,0,Ghana
65218,3/1/2023,GHA,Kelantan,0,0,0,Ghana
65219,3/1/2023,GHA,Pulau Pinang,0,0,0,Ghana
65220,3/1/2023,GHA,Sabah,0,0,0,Ghana
65221,3/1/2023,GHA,Sarawak,0,0,0,Ghana
65222,3/1/2023,GHA,Selangor,66,46,20,Ghana
65223,3/1/2023,GIB,Johor,0,0,0,Gibraltar
65224,3/1/2023,GIB,Sarawak,0,0,0,Gibraltar
65225,3/1/2023,GIN,Johor,1,1,0,Guinea
65226,3/1/2023,GIN,Kedah,1,1,0,Guinea
65227,3/1/2023,GIN,Kelantan,2,2,0,Guinea
65228,3/1/2023,GIN,Perlis,0,0,0,Guinea
65229,3/1/2023,GIN,Pulau Pinang,0,0,0,Guinea
65230,3/1/2023,GIN,Sabah,0,0,0,Guinea
65231,3/1/2023,GIN,Sarawak,0,0,0,Guinea
65232,3/1/2023,GIN,Selangor,56,40,16,Guinea
65233,3/1/2023,GLP,Selangor,0,0,0,Guadeloupe
65234,3/1/2023,GMB,Johor,1,0,1,Gambia
65235,3/1/2023,GMB,Kedah,0,0,0,Gambia
65236,3/1/2023,GMB,Kelantan,0,0,0,Gambia
65237,3/1/2023,GMB,Pulau Pinang,0,0,0,Gambia
65238,3/1/2023,GMB,Sabah,1,1,0,Gambia
65239,3/1/2023,GMB,Sarawak,0,0,0,Gambia
65240,3/1/2023,GMB,Selangor,17,11,6,Gambia
65241,3/1/2023,GNB,Johor,3,3,0,Guinea-Bissau
65242,3/1/2023,GNB,Selangor,0,0,0,Guinea-Bissau
65243,3/1/2023,GNQ,Johor,0,0,0,Equatorial Guinea
65244,3/1/2023,GNQ,Selangor,2,2,0,Equatorial Guinea
65245,3/1/2023,GRC,Johor,59,43,16,Greece
65246,3/1/2023,GRC,Kedah,26,14,12,Greece
65247,3/1/2023,GRC,Kelantan,1,1,0,Greece
65248,3/1/2023,GRC,Melaka,0,0,0,Greece
65249,3/1/2023,GRC,Negeri Sembilan,0,0,0,Greece
65250,3/1/2023,GRC,Pahang,3,3,0,Greece
65251,3/1/2023,GRC,Perak,1,0,1,Greece
65252,3/1/2023,GRC,Perlis,2,2,0,Greece
65253,3/1/2023,GRC,Pulau Pinang,14,11,3,Greece
65254,3/1/2023,GRC,Sabah,5,3,2,Greece
65255,3/1/2023,GRC,Sarawak,3,2,1,Greece
65256,3/1/2023,GRC,Selangor,253,187,66,Greece
65257,3/1/2023,GRD,Johor,4,3,1,Grenada
65258,3/1/2023,GRD,Kedah,0,0,0,Grenada
65259,3/1/2023,GRD,Pulau Pinang,0,0,0,Grenada
65260,3/1/2023,GRD,Sabah,0,0,0,Grenada
65261,3/1/2023,GRD,Sarawak,0,0,0,Grenada
65262,3/1/2023,GRD,Selangor,9,8,1,Grenada
65263,3/1/2023,GRL,Johor,0,0,0,Greenland
65264,3/1/2023,GRL,Selangor,0,0,0,Greenland
65265,3/1/2023,GTM,Johor,6,3,3,Guatemala
65266,3/1/2023,GTM,Kedah,0,0,0,Guatemala
65267,3/1/2023,GTM,Pahang,0,0,0,Guatemala
65268,3/1/2023,GTM,Perak,0,0,0,Guatemala
65269,3/1/2023,GTM,Pulau Pinang,1,1,0,Guatemala
65270,3/1/2023,GTM,Sabah,0,0,0,Guatemala
65271,3/1/2023,GTM,Sarawak,0,0,0,Guatemala
65272,3/1/2023,GTM,Selangor,25,13,12,Guatemala
65273,3/1/2023,GTM,W.P. Labuan,0,0,0,Guatemala
65274,3/1/2023,GUY,Johor,1,0,1,Guyana
65275,3/1/2023,GUY,Kedah,0,0,0,Guyana
65276,3/1/2023,GUY,Pulau Pinang,0,0,0,Guyana
65277,3/1/2023,GUY,Sarawak,0,0,0,Guyana
65278,3/1/2023,GUY,Selangor,5,3,2,Guyana
65279,3/1/2023,HKG,Johor,8,3,5,Hong Kong
65280,3/1/2023,HKG,Kedah,0,0,0,Hong Kong
65281,3/1/2023,HKG,Kelantan,0,0,0,Hong Kong
65282,3/1/2023,HKG,Pahang,0,0,0,Hong Kong
65283,3/1/2023,HKG,Perak,45,16,29,Hong Kong
65284,3/1/2023,HKG,Perlis,3,2,1,Hong Kong
65285,3/1/2023,HKG,Pulau Pinang,0,0,0,Hong Kong
65286,3/1/2023,HKG,Sabah,102,54,48,Hong Kong
65287,3/1/2023,HKG,Sarawak,0,0,0,Hong Kong
65288,3/1/2023,HKG,Selangor,5,4,1,Hong Kong
65289,3/1/2023,HKG,Terengganu,0,0,0,Hong Kong
65290,3/1/2023,HMD,Johor,0,0,0,Heard Island and McDonald Islands
65291,3/1/2023,HND,Johor,2,1,1,Honduras
65292,3/1/2023,HND,Kedah,0,0,0,Honduras
65293,3/1/2023,HND,Perak,0,0,0,Honduras
65294,3/1/2023,HND,Pulau Pinang,0,0,0,Honduras
65295,3/1/2023,HND,Sabah,2,0,2,Honduras
65296,3/1/2023,HND,Sarawak,0,0,0,Honduras
65297,3/1/2023,HND,Selangor,10,2,8,Honduras
65298,3/1/2023,HRV,Johor,57,45,12,Croatia
65299,3/1/2023,HRV,Kedah,6,5,1,Croatia
65300,3/1/2023,HRV,Kelantan,0,0,0,Croatia
65301,3/1/2023,HRV,Melaka,0,0,0,Croatia
65302,3/1/2023,HRV,Pahang,0,0,0,Croatia
65303,3/1/2023,HRV,Perak,0,0,0,Croatia
65304,3/1/2023,HRV,Perlis,1,1,0,Croatia
65305,3/1/2023,HRV,Pulau Pinang,9,4,5,Croatia
65306,3/1/2023,HRV,Sabah,1,0,1,Croatia
65307,3/1/2023,HRV,Sarawak,4,2,2,Croatia
65308,3/1/2023,HRV,Selangor,139,104,35,Croatia
65309,3/1/2023,HTI,Johor,1,1,0,Haiti
65310,3/1/2023,HTI,Kedah,0,0,0,Haiti
65311,3/1/2023,HTI,Kelantan,0,0,0,Haiti
65312,3/1/2023,HTI,Perak,0,0,0,Haiti
65313,3/1/2023,HTI,Pulau Pinang,0,0,0,Haiti
65314,3/1/2023,HTI,Sabah,0,0,0,Haiti
65315,3/1/2023,HTI,Selangor,3,2,1,Haiti
65316,3/1/2023,HUN,Johor,101,57,44,Hungary
65317,3/1/2023,HUN,Kedah,44,23,21,Hungary
65318,3/1/2023,HUN,Kelantan,0,0,0,Hungary
65319,3/1/2023,HUN,Pahang,0,0,0,Hungary
65320,3/1/2023,HUN,Perak,4,3,1,Hungary
65321,3/1/2023,HUN,Perlis,5,3,2,Hungary
65322,3/1/2023,HUN,Pulau Pinang,27,17,10,Hungary
65323,3/1/2023,HUN,Sabah,11,6,5,Hungary
65324,3/1/2023,HUN,Sarawak,19,8,11,Hungary
65325,3/1/2023,HUN,Selangor,481,274,207,Hungary
65326,3/1/2023,HUN,W.P. Labuan,0,0,0,Hungary
65327,3/1/2023,IDN,Johor,97877,52135,45742,Indonesia
65328,3/1/2023,IDN,Kedah,3817,1458,2359,Indonesia
65329,3/1/2023,IDN,Kelantan,141,91,50,Indonesia
65330,3/1/2023,IDN,Melaka,4491,2035,2456,Indonesia
65331,3/1/2023,IDN,Negeri Sembilan,8443,5513,2930,Indonesia
65332,3/1/2023,IDN,Pahang,4,0,4,Indonesia
65333,3/1/2023,IDN,Perak,181,61,120,Indonesia
65334,3/1/2023,IDN,Perlis,440,173,267,Indonesia
65335,3/1/2023,IDN,Pulau Pinang,32495,13104,19391,Indonesia
65336,3/1/2023,IDN,Sabah,4963,2455,2508,Indonesia
65337,3/1/2023,IDN,Sarawak,34456,18391,16065,Indonesia
65338,3/1/2023,IDN,Selangor,88888,43351,45537,Indonesia
65339,3/1/2023,IDN,Terengganu,3,3,0,Indonesia
65340,3/1/2023,IDN,W.P. Labuan,54,39,15,Indonesia
65341,3/1/2023,IND,Johor,18870,12982,5888,India
65342,3/1/2023,IND,Kedah,879,496,383,India
65343,3/1/2023,IND,Kelantan,3,3,0,India
65344,3/1/2023,IND,Melaka,3,3,0,India
65345,3/1/2023,IND,Negeri Sembilan,0,0,0,India
65346,3/1/2023,IND,Pahang,3,3,0,India
65347,3/1/2023,IND,Perak,516,429,87,India
65348,3/1/2023,IND,Perlis,32,26,6,India
65349,3/1/2023,IND,Pulau Pinang,723,523,200,India
65350,3/1/2023,IND,Sabah,243,174,69,India
65351,3/1/2023,IND,Sarawak,1147,924,223,India
65352,3/1/2023,IND,Selangor,39734,29937,9797,India
65353,3/1/2023,IND,Terengganu,0,0,0,India
65354,3/1/2023,IND,W.P. Labuan,35,33,2,India
65355,3/1/2023,IOT,Pulau Pinang,0,0,0,British Indian Ocean Territory
65356,3/1/2023,IOT,Selangor,0,0,0,British Indian Ocean Territory
65357,3/1/2023,IRL,Johor,271,185,86,Ireland
65358,3/1/2023,IRL,Kedah,97,51,46,Ireland
65359,3/1/2023,IRL,Kelantan,3,3,0,Ireland
65360,3/1/2023,IRL,Negeri Sembilan,0,0,0,Ireland
65361,3/1/2023,IRL,Pahang,0,0,0,Ireland
65362,3/1/2023,IRL,Perak,4,2,2,Ireland
65363,3/1/2023,IRL,Perlis,16,11,5,Ireland
65364,3/1/2023,IRL,Pulau Pinang,98,55,43,Ireland
65365,3/1/2023,IRL,Sabah,30,15,15,Ireland
65366,3/1/2023,IRL,Sarawak,60,27,33,Ireland
65367,3/1/2023,IRL,Selangor,1164,661,503,Ireland
65368,3/1/2023,IRL,Terengganu,0,0,0,Ireland
65369,3/1/2023,IRL,W.P. Labuan,3,1,2,Ireland
65370,3/1/2023,IRN,Johor,266,146,120,Iran
65371,3/1/2023,IRN,Kedah,12,6,6,Iran
65372,3/1/2023,IRN,Kelantan,0,0,0,Iran
65373,3/1/2023,IRN,Perak,0,0,0,Iran
65374,3/1/2023,IRN,Perlis,7,5,2,Iran
65375,3/1/2023,IRN,Pulau Pinang,15,10,5,Iran
65376,3/1/2023,IRN,Sabah,1,0,1,Iran
65377,3/1/2023,IRN,Sarawak,18,11,7,Iran
65378,3/1/2023,IRN,Selangor,2780,1416,1364,Iran
65379,3/1/2023,IRN,W.P. Labuan,0,0,0,Iran
65380,3/1/2023,IRQ,Johor,20,17,3,Iraq
65381,3/1/2023,IRQ,Kedah,1,1,0,Iraq
65382,3/1/2023,IRQ,Kelantan,0,0,0,Iraq
65383,3/1/2023,IRQ,Melaka,0,0,0,Iraq
65384,3/1/2023,IRQ,Pahang,0,0,0,Iraq
65385,3/1/2023,IRQ,Perak,0,0,0,Iraq
65386,3/1/2023,IRQ,Perlis,1,1,0,Iraq
65387,3/1/2023,IRQ,Pulau Pinang,0,0,0,Iraq
65388,3/1/2023,IRQ,Sabah,0,0,0,Iraq
65389,3/1/2023,IRQ,Sarawak,1,1,0,Iraq
65390,3/1/2023,IRQ,Selangor,733,540,193,Iraq
65391,3/1/2023,ISL,Johor,4,3,1,Iceland
65392,3/1/2023,ISL,Kedah,4,2,2,Iceland
65393,3/1/2023,ISL,Kelantan,0,0,0,Iceland
65394,3/1/2023,ISL,Perak,0,0,0,Iceland
65395,3/1/2023,ISL,Perlis,0,0,0,Iceland
65396,3/1/2023,ISL,Pulau Pinang,0,0,0,Iceland
65397,3/1/2023,ISL,Sabah,0,0,0,Iceland
65398,3/1/2023,ISL,Sarawak,0,0,0,Iceland
65399,3/1/2023,ISL,Selangor,48,25,23,Iceland
65400,3/1/2023,ISL,W.P. Labuan,0,0,0,Iceland
65401,3/1/2023,ISR,Pulau Pinang,0,0,0,Israel
65402,3/1/2023,ITA,Johor,591,428,163,Italy
65403,3/1/2023,ITA,Kedah,411,218,193,Italy
65404,3/1/2023,ITA,Kelantan,5,5,0,Italy
65405,3/1/2023,ITA,Melaka,0,0,0,Italy
65406,3/1/2023,ITA,Negeri Sembilan,0,0,0,Italy
65407,3/1/2023,ITA,Pahang,0,0,0,Italy
65408,3/1/2023,ITA,Perak,3,2,1,Italy
65409,3/1/2023,ITA,Perlis,42,30,12,Italy
65410,3/1/2023,ITA,Pulau Pinang,143,109,34,Italy
65411,3/1/2023,ITA,Sabah,34,22,12,Italy
65412,3/1/2023,ITA,Sarawak,73,45,28,Italy
65413,3/1/2023,ITA,Selangor,2623,1720,903,Italy
65414,3/1/2023,ITA,W.P. Labuan,1,1,0,Italy
65415,3/1/2023,JAM,Johor,5,0,5,Jamaica
65416,3/1/2023,JAM,Kedah,1,0,1,Jamaica
65417,3/1/2023,JAM,Perak,0,0,0,Jamaica
65418,3/1/2023,JAM,Pulau Pinang,1,1,0,Jamaica
65419,3/1/2023,JAM,Sabah,0,0,0,Jamaica
65420,3/1/2023,JAM,Sarawak,0,0,0,Jamaica
65421,3/1/2023,JAM,Selangor,17,7,10,Jamaica
65422,3/1/2023,JAM,W.P. Labuan,0,0,0,Jamaica
65423,3/1/2023,JOR,Johor,13,9,4,Jordan
65424,3/1/2023,JOR,Kedah,8,3,5,Jordan
65425,3/1/2023,JOR,Kelantan,1,1,0,Jordan
65426,3/1/2023,JOR,Melaka,0,0,0,Jordan
65427,3/1/2023,JOR,Perlis,1,1,0,Jordan
65428,3/1/2023,JOR,Pulau Pinang,5,4,1,Jordan
65429,3/1/2023,JOR,Sabah,0,0,0,Jordan
65430,3/1/2023,JOR,Sarawak,0,0,0,Jordan
65431,3/1/2023,JOR,Selangor,558,373,185,Jordan
65432,3/1/2023,JOR,W.P. Labuan,0,0,0,Jordan
65433,3/1/2023,JPN,Johor,5620,3761,1859,Japan
65434,3/1/2023,JPN,Kedah,282,131,151,Japan
65435,3/1/2023,JPN,Kelantan,10,7,3,Japan
65436,3/1/2023,JPN,Melaka,3,3,0,Japan
65437,3/1/2023,JPN,Negeri Sembilan,0,0,0,Japan
65438,3/1/2023,JPN,Pahang,2,1,1,Japan
65439,3/1/2023,JPN,Perak,43,24,19,Japan
65440,3/1/2023,JPN,Perlis,122,93,29,Japan
65441,3/1/2023,JPN,Pulau Pinang,1021,724,297,Japan
65442,3/1/2023,JPN,Sabah,525,250,275,Japan
65443,3/1/2023,JPN,Sarawak,230,141,89,Japan
65444,3/1/2023,JPN,Selangor,17959,11204,6755,Japan
65445,3/1/2023,JPN,W.P. Labuan,17,7,10,Japan
65446,3/1/2023,KAZ,Johor,62,29,33,Kazakhstan
65447,3/1/2023,KAZ,Kedah,19,9,10,Kazakhstan
65448,3/1/2023,KAZ,Kelantan,4,0,4,Kazakhstan
65449,3/1/2023,KAZ,Melaka,0,0,0,Kazakhstan
65450,3/1/2023,KAZ,Perak,0,0,0,Kazakhstan
65451,3/1/2023,KAZ,Perlis,3,2,1,Kazakhstan
65452,3/1/2023,KAZ,Pulau Pinang,6,2,4,Kazakhstan
65453,3/1/2023,KAZ,Sabah,4,0,4,Kazakhstan
65454,3/1/2023,KAZ,Sarawak,3,1,2,Kazakhstan
65455,3/1/2023,KAZ,Selangor,719,310,409,Kazakhstan
65456,3/1/2023,KAZ,W.P. Labuan,0,0,0,Kazakhstan
65457,3/1/2023,KEN,Johor,253,108,145,Kenya
65458,3/1/2023,KEN,Kedah,1,1,0,Kenya
65459,3/1/2023,KEN,Kelantan,0,0,0,Kenya
65460,3/1/2023,KEN,Perak,0,0,0,Kenya
65461,3/1/2023,KEN,Perlis,0,0,0,Kenya
65462,3/1/2023,KEN,Pulau Pinang,1,0,1,Kenya
65463,3/1/2023,KEN,Sabah,1,1,0,Kenya
65464,3/1/2023,KEN,Sarawak,6,4,2,Kenya
65465,3/1/2023,KEN,Selangor,292,171,121,Kenya
65466,3/1/2023,KGZ,Johor,17,10,7,Kyrgyzstan
65467,3/1/2023,KGZ,Kedah,2,1,1,Kyrgyzstan
65468,3/1/2023,KGZ,Kelantan,1,0,1,Kyrgyzstan
65469,3/1/2023,KGZ,Perak,0,0,0,Kyrgyzstan
65470,3/1/2023,KGZ,Perlis,0,0,0,Kyrgyzstan
65471,3/1/2023,KGZ,Pulau Pinang,1,1,0,Kyrgyzstan
65472,3/1/2023,KGZ,Sabah,0,0,0,Kyrgyzstan
65473,3/1/2023,KGZ,Sarawak,0,0,0,Kyrgyzstan
65474,3/1/2023,KGZ,Selangor,189,85,104,Kyrgyzstan
65475,3/1/2023,KHM,Johor,2081,846,1235,Cambodia
65476,3/1/2023,KHM,Kedah,172,108,64,Cambodia
65477,3/1/2023,KHM,Kelantan,832,510,322,Cambodia
65478,3/1/2023,KHM,Melaka,0,0,0,Cambodia
65479,3/1/2023,KHM,Negeri Sembilan,0,0,0,Cambodia
65480,3/1/2023,KHM,Pahang,0,0,0,Cambodia
65481,3/1/2023,KHM,Perak,6,2,4,Cambodia
65482,3/1/2023,KHM,Perlis,679,401,278,Cambodia
65483,3/1/2023,KHM,Pulau Pinang,46,23,23,Cambodia
65484,3/1/2023,KHM,Sabah,5,3,2,Cambodia
65485,3/1/2023,KHM,Sarawak,6,2,4,Cambodia
65486,3/1/2023,KHM,Selangor,3951,1790,2161,Cambodia
65487,3/1/2023,KHM,W.P. Labuan,0,0,0,Cambodia
65488,3/1/2023,KIR,Johor,3,3,0,Kiribati
65489,3/1/2023,KIR,Sabah,0,0,0,Kiribati
65490,3/1/2023,KIR,Selangor,2,2,0,Kiribati
65491,3/1/2023,KNA,Johor,28,18,10,Saint Kitts and Nevis
65492,3/1/2023,KNA,Kedah,0,0,0,Saint Kitts and Nevis
65493,3/1/2023,KNA,Perlis,0,0,0,Saint Kitts and Nevis
65494,3/1/2023,KNA,Pulau Pinang,0,0,0,Saint Kitts and Nevis
65495,3/1/2023,KNA,Sabah,1,0,1,Saint Kitts and Nevis
65496,3/1/2023,KNA,Selangor,49,39,10,Saint Kitts and Nevis
65497,3/1/2023,KNA,W.P. Labuan,0,0,0,Saint Kitts and Nevis
65498,3/1/2023,KOR,Johor,8421,4565,3856,"Korea, Republic of (South Korea)"
65499,3/1/2023,KOR,Kedah,258,134,124,"Korea, Republic of (South Korea)"
65500,3/1/2023,KOR,Kelantan,2,2,0,"Korea, Republic of (South Korea)"
65501,3/1/2023,KOR,Melaka,0,0,0,"Korea, Republic of (South Korea)"
65502,3/1/2023,KOR,Negeri Sembilan,0,0,0,"Korea, Republic of (South Korea)"
65503,3/1/2023,KOR,Pahang,2,1,1,"Korea, Republic of (South Korea)"
65504,3/1/2023,KOR,Perak,18,9,9,"Korea, Republic of (South Korea)"
65505,3/1/2023,KOR,Perlis,87,58,29,"Korea, Republic of (South Korea)"
65506,3/1/2023,KOR,Pulau Pinang,426,255,171,"Korea, Republic of (South Korea)"
65507,3/1/2023,KOR,Sabah,16116,6347,9769,"Korea, Republic of (South Korea)"
65508,3/1/2023,KOR,Sarawak,246,137,109,"Korea, Republic of (South Korea)"
65509,3/1/2023,KOR,Selangor,9891,5724,4167,"Korea, Republic of (South Korea)"
65510,3/1/2023,KOR,Terengganu,0,0,0,"Korea, Republic of (South Korea)"
65511,3/1/2023,KOR,W.P. Labuan,13,11,2,"Korea, Republic of (South Korea)"
65512,3/1/2023,KWT,Johor,7,6,1,Kuwait
65513,3/1/2023,KWT,Kedah,3,1,2,Kuwait
65514,3/1/2023,KWT,Kelantan,2,1,1,Kuwait
65515,3/1/2023,KWT,Perak,0,0,0,Kuwait
65516,3/1/2023,KWT,Perlis,0,0,0,Kuwait
65517,3/1/2023,KWT,Pulau Pinang,1,1,0,Kuwait
65518,3/1/2023,KWT,Sabah,0,0,0,Kuwait
65519,3/1/2023,KWT,Sarawak,0,0,0,Kuwait
65520,3/1/2023,KWT,Selangor,213,139,74,Kuwait
65521,3/1/2023,KWT,W.P. Labuan,0,0,0,Kuwait
65522,3/1/2023,LAO,Johor,158,39,119,Lao People's Democratic Republic
65523,3/1/2023,LAO,Kedah,1144,122,1022,Lao People's Democratic Republic
65524,3/1/2023,LAO,Kelantan,346,170,176,Lao People's Democratic Republic
65525,3/1/2023,LAO,Melaka,0,0,0,Lao People's Democratic Republic
65526,3/1/2023,LAO,Perak,12,3,9,Lao People's Democratic Republic
65527,3/1/2023,LAO,Perlis,220,83,137,Lao People's Democratic Republic
65528,3/1/2023,LAO,Pulau Pinang,18,4,14,Lao People's Democratic Republic
65529,3/1/2023,LAO,Sabah,9,5,4,Lao People's Democratic Republic
65530,3/1/2023,LAO,Sarawak,15,6,9,Lao People's Democratic Republic
65531,3/1/2023,LAO,Selangor,216,66,150,Lao People's Democratic Republic
65532,3/1/2023,LAO,W.P. Labuan,0,0,0,Lao People's Democratic Republic
65533,3/1/2023,LBN,Johor,9,8,1,Lebanon
65534,3/1/2023,LBN,Kedah,6,5,1,Lebanon
65535,3/1/2023,LBN,Kelantan,0,0,0,Lebanon
65536,3/1/2023,LBN,Pahang,0,0,0,Lebanon
65537,3/1/2023,LBN,Perak,0,0,0,Lebanon
65538,3/1/2023,LBN,Perlis,0,0,0,Lebanon
65539,3/1/2023,LBN,Pulau Pinang,4,3,1,Lebanon
65540,3/1/2023,LBN,Sabah,3,2,1,Lebanon
65541,3/1/2023,LBN,Sarawak,1,1,0,Lebanon
65542,3/1/2023,LBN,Selangor,201,134,67,Lebanon
65543,3/1/2023,LBN,W.P. Labuan,0,0,0,Lebanon
65544,3/1/2023,LBR,Johor,2,2,0,Liberia
65545,3/1/2023,LBR,Kedah,0,0,0,Liberia
65546,3/1/2023,LBR,Sabah,0,0,0,Liberia
65547,3/1/2023,LBR,Sarawak,0,0,0,Liberia
65548,3/1/2023,LBR,Selangor,6,5,1,Liberia
65549,3/1/2023,LBY,Johor,2,2,0,Libyan Arab Jamahiriya
65550,3/1/2023,LBY,Kedah,0,0,0,Libyan Arab Jamahiriya
65551,3/1/2023,LBY,Perlis,0,0,0,Libyan Arab Jamahiriya
65552,3/1/2023,LBY,Pulau Pinang,1,1,0,Libyan Arab Jamahiriya
65553,3/1/2023,LBY,Sabah,0,0,0,Libyan Arab Jamahiriya
65554,3/1/2023,LBY,Sarawak,3,3,0,Libyan Arab Jamahiriya
65555,3/1/2023,LBY,Selangor,228,172,56,Libyan Arab Jamahiriya
65556,3/1/2023,LCA,Johor,5,5,0,Saint Lucia
65557,3/1/2023,LCA,Kedah,0,0,0,Saint Lucia
65558,3/1/2023,LCA,Pulau Pinang,0,0,0,Saint Lucia
65559,3/1/2023,LCA,Sarawak,0,0,0,Saint Lucia
65560,3/1/2023,LCA,Selangor,11,9,2,Saint Lucia
65561,3/1/2023,LIE,Johor,1,1,0,Liechtenstein
65562,3/1/2023,LIE,Kedah,0,0,0,Liechtenstein
65563,3/1/2023,LIE,Perlis,0,0,0,Liechtenstein
65564,3/1/2023,LIE,Pulau Pinang,0,0,0,Liechtenstein
65565,3/1/2023,LIE,Sabah,0,0,0,Liechtenstein
65566,3/1/2023,LIE,Sarawak,0,0,0,Liechtenstein
65567,3/1/2023,LIE,Selangor,3,2,1,Liechtenstein
65568,3/1/2023,LKA,Johor,1159,775,384,Sri Lanka
65569,3/1/2023,LKA,Kedah,43,22,21,Sri Lanka
65570,3/1/2023,LKA,Kelantan,0,0,0,Sri Lanka
65571,3/1/2023,LKA,Melaka,0,0,0,Sri Lanka
65572,3/1/2023,LKA,Pahang,0,0,0,Sri Lanka
65573,3/1/2023,LKA,Perak,0,0,0,Sri Lanka
65574,3/1/2023,LKA,Perlis,1,1,0,Sri Lanka
65575,3/1/2023,LKA,Pulau Pinang,26,16,10,Sri Lanka
65576,3/1/2023,LKA,Sabah,13,8,5,Sri Lanka
65577,3/1/2023,LKA,Sarawak,26,14,12,Sri Lanka
65578,3/1/2023,LKA,Selangor,3231,2243,988,Sri Lanka
65579,3/1/2023,LKA,W.P. Labuan,0,0,0,Sri Lanka
65580,3/1/2023,LSO,Johor,1,1,0,Lesotho
65581,3/1/2023,LSO,Kedah,0,0,0,Lesotho
65582,3/1/2023,LSO,Pulau Pinang,0,0,0,Lesotho
65583,3/1/2023,LSO,Sarawak,0,0,0,Lesotho
65584,3/1/2023,LSO,Selangor,4,1,3,Lesotho
65585,3/1/2023,LTU,Johor,119,46,73,Lithuania
65586,3/1/2023,LTU,Kedah,39,13,26,Lithuania
65587,3/1/2023,LTU,Kelantan,0,0,0,Lithuania
65588,3/1/2023,LTU,Pahang,0,0,0,Lithuania
65589,3/1/2023,LTU,Perak,1,0,1,Lithuania
65590,3/1/2023,LTU,Perlis,7,5,2,Lithuania
65591,3/1/2023,LTU,Pulau Pinang,7,2,5,Lithuania
65592,3/1/2023,LTU,Sabah,6,3,3,Lithuania
65593,3/1/2023,LTU,Sarawak,42,15,27,Lithuania
65594,3/1/2023,LTU,Selangor,447,206,241,Lithuania
65595,3/1/2023,LTU,W.P. Labuan,0,0,0,Lithuania
65596,3/1/2023,LUX,Johor,6,6,0,Luxembourg
65597,3/1/2023,LUX,Kedah,9,5,4,Luxembourg
65598,3/1/2023,LUX,Kelantan,0,0,0,Luxembourg
65599,3/1/2023,LUX,Perak,0,0,0,Luxembourg
65600,3/1/2023,LUX,Perlis,1,0,1,Luxembourg
65601,3/1/2023,LUX,Pulau Pinang,1,0,1,Luxembourg
65602,3/1/2023,LUX,Sabah,0,0,0,Luxembourg
65603,3/1/2023,LUX,Sarawak,0,0,0,Luxembourg
65604,3/1/2023,LUX,Selangor,54,33,21,Luxembourg
65605,3/1/2023,LVA,Johor,55,23,32,Latvia
65606,3/1/2023,LVA,Kedah,18,8,10,Latvia
65607,3/1/2023,LVA,Kelantan,0,0,0,Latvia
65608,3/1/2023,LVA,Pahang,2,2,0,Latvia
65609,3/1/2023,LVA,Perak,0,0,0,Latvia
65610,3/1/2023,LVA,Perlis,4,2,2,Latvia
65611,3/1/2023,LVA,Pulau Pinang,1,1,0,Latvia
65612,3/1/2023,LVA,Sabah,9,2,7,Latvia
65613,3/1/2023,LVA,Sarawak,61,21,40,Latvia
65614,3/1/2023,LVA,Selangor,335,155,180,Latvia
65615,3/1/2023,LVA,W.P. Labuan,0,0,0,Latvia
65616,3/1/2023,MAC,Johor,0,0,0,Macao
65617,3/1/2023,MAC,Pahang,1,0,1,Macao
65618,3/1/2023,MAC,Perak,2,1,1,Macao
65619,3/1/2023,MAC,Selangor,0,0,0,Macao
65620,3/1/2023,MAC,W.P. Labuan,0,0,0,Macao
65621,3/1/2023,MAR,Johor,68,47,21,Morocco
65622,3/1/2023,MAR,Kedah,3,2,1,Morocco
65623,3/1/2023,MAR,Kelantan,0,0,0,Morocco
65624,3/1/2023,MAR,Melaka,0,0,0,Morocco
65625,3/1/2023,MAR,Pahang,0,0,0,Morocco
65626,3/1/2023,MAR,Perak,0,0,0,Morocco
65627,3/1/2023,MAR,Perlis,3,3,0,Morocco
65628,3/1/2023,MAR,Pulau Pinang,19,16,3,Morocco
65629,3/1/2023,MAR,Sabah,5,3,2,Morocco
65630,3/1/2023,MAR,Sarawak,12,9,3,Morocco
65631,3/1/2023,MAR,Selangor,522,298,224,Morocco
65632,3/1/2023,MAR,W.P. Labuan,0,0,0,Morocco
65633,3/1/2023,MCO,Johor,0,0,0,Monaco
65634,3/1/2023,MCO,Kedah,0,0,0,Monaco
65635,3/1/2023,MCO,Sabah,0,0,0,Monaco
65636,3/1/2023,MCO,Selangor,1,1,0,Monaco
65637,3/1/2023,MDA,Johor,0,0,0,"Moldova, Republic of"
65638,3/1/2023,MDA,Kedah,0,0,0,"Moldova, Republic of"
65639,3/1/2023,MDA,Kelantan,0,0,0,"Moldova, Republic of"
65640,3/1/2023,MDA,Negeri Sembilan,1,1,0,"Moldova, Republic of"
65641,3/1/2023,MDA,Perlis,0,0,0,"Moldova, Republic of"
65642,3/1/2023,MDA,Pulau Pinang,1,0,1,"Moldova, Republic of"
65643,3/1/2023,MDA,Sabah,0,0,0,"Moldova, Republic of"
65644,3/1/2023,MDA,Sarawak,0,0,0,"Moldova, Republic of"
65645,3/1/2023,MDA,Selangor,35,21,14,"Moldova, Republic of"
65646,3/1/2023,MDG,Johor,24,6,18,Madagascar
65647,3/1/2023,MDG,Kedah,3,2,1,Madagascar
65648,3/1/2023,MDG,Perak,0,0,0,Madagascar
65649,3/1/2023,MDG,Perlis,0,0,0,Madagascar
65650,3/1/2023,MDG,Pulau Pinang,2,1,1,Madagascar
65651,3/1/2023,MDG,Sabah,0,0,0,Madagascar
65652,3/1/2023,MDG,Sarawak,0,0,0,Madagascar
65653,3/1/2023,MDG,Selangor,75,26,49,Madagascar
65654,3/1/2023,MDV,Johor,76,52,24,Maldives
65655,3/1/2023,MDV,Kedah,1,1,0,Maldives
65656,3/1/2023,MDV,Kelantan,0,0,0,Maldives
65657,3/1/2023,MDV,Perak,1,1,0,Maldives
65658,3/1/2023,MDV,Perlis,0,0,0,Maldives
65659,3/1/2023,MDV,Pulau Pinang,5,3,2,Maldives
65660,3/1/2023,MDV,Sabah,1,1,0,Maldives
65661,3/1/2023,MDV,Sarawak,0,0,0,Maldives
65662,3/1/2023,MDV,Selangor,1804,1037,767,Maldives
65663,3/1/2023,MEX,Johor,124,58,66,Mexico
65664,3/1/2023,MEX,Kedah,19,5,14,Mexico
65665,3/1/2023,MEX,Kelantan,0,0,0,Mexico
65666,3/1/2023,MEX,Pahang,0,0,0,Mexico
65667,3/1/2023,MEX,Perak,1,1,0,Mexico
65668,3/1/2023,MEX,Perlis,4,2,2,Mexico
65669,3/1/2023,MEX,Pulau Pinang,20,16,4,Mexico
65670,3/1/2023,MEX,Sabah,6,3,3,Mexico
65671,3/1/2023,MEX,Sarawak,12,5,7,Mexico
65672,3/1/2023,MEX,Selangor,486,262,224,Mexico
65673,3/1/2023,MEX,W.P. Labuan,0,0,0,Mexico
65674,3/1/2023,MHL,Johor,0,0,0,Marshall Islands
65675,3/1/2023,MHL,Kedah,0,0,0,Marshall Islands
65676,3/1/2023,MHL,Perak,0,0,0,Marshall Islands
65677,3/1/2023,MHL,Pulau Pinang,0,0,0,Marshall Islands
65678,3/1/2023,MHL,Sabah,1,1,0,Marshall Islands
65679,3/1/2023,MHL,Selangor,3,3,0,Marshall Islands
65680,3/1/2023,MKD,Johor,4,1,3,"Macedonia, the former Yugoslav Republic of"
65681,3/1/2023,MKD,Kedah,0,0,0,"Macedonia, the former Yugoslav Republic of"
65682,3/1/2023,MKD,Perak,0,0,0,"Macedonia, the former Yugoslav Republic of"
65683,3/1/2023,MKD,Pulau Pinang,1,1,0,"Macedonia, the former Yugoslav Republic of"
65684,3/1/2023,MKD,Sabah,1,0,1,"Macedonia, the former Yugoslav Republic of"
65685,3/1/2023,MKD,Sarawak,1,0,1,"Macedonia, the former Yugoslav Republic of"
65686,3/1/2023,MKD,Selangor,54,31,23,"Macedonia, the former Yugoslav Republic of"
65687,3/1/2023,MLI,Johor,1,1,0,Mali
65688,3/1/2023,MLI,Sabah,0,0,0,Mali
65689,3/1/2023,MLI,Selangor,6,5,1,Mali
65690,3/1/2023,MLT,Johor,6,2,4,Malta
65691,3/1/2023,MLT,Kedah,7,6,1,Malta
65692,3/1/2023,MLT,Kelantan,0,0,0,Malta
65693,3/1/2023,MLT,Perak,0,0,0,Malta
65694,3/1/2023,MLT,Perlis,2,2,0,Malta
65695,3/1/2023,MLT,Pulau Pinang,4,1,3,Malta
65696,3/1/2023,MLT,Sabah,0,0,0,Malta
65697,3/1/2023,MLT,Sarawak,4,3,1,Malta
65698,3/1/2023,MLT,Selangor,44,30,14,Malta
65699,3/1/2023,MLT,W.P. Labuan,0,0,0,Malta
65700,3/1/2023,MMR,Johor,4218,1186,3032,Myanmar
65701,3/1/2023,MMR,Kedah,66,19,47,Myanmar
65702,3/1/2023,MMR,Kelantan,1,0,1,Myanmar
65703,3/1/2023,MMR,Negeri Sembilan,0,0,0,Myanmar
65704,3/1/2023,MMR,Pahang,2,0,2,Myanmar
65705,3/1/2023,MMR,Perak,16,3,13,Myanmar
65706,3/1/2023,MMR,Perlis,5,0,5,Myanmar
65707,3/1/2023,MMR,Pulau Pinang,176,104,72,Myanmar
65708,3/1/2023,MMR,Sabah,17,5,12,Myanmar
65709,3/1/2023,MMR,Sarawak,75,36,39,Myanmar
65710,3/1/2023,MMR,Selangor,7170,5120,2050,Myanmar
65711,3/1/2023,MMR,Terengganu,0,0,0,Myanmar
65712,3/1/2023,MMR,W.P. Labuan,2,1,1,Myanmar
65713,3/1/2023,MNE,Johor,3,3,0,Montenegro
65714,3/1/2023,MNE,Kedah,0,0,0,Montenegro
65715,3/1/2023,MNE,Pulau Pinang,0,0,0,Montenegro
65716,3/1/2023,MNE,Sabah,0,0,0,Montenegro
65717,3/1/2023,MNE,Sarawak,0,0,0,Montenegro
65718,3/1/2023,MNE,Selangor,10,10,0,Montenegro
65719,3/1/2023,MNG,Johor,172,66,106,Mongolia
65720,3/1/2023,MNG,Kedah,4,2,2,Mongolia
65721,3/1/2023,MNG,Kelantan,0,0,0,Mongolia
65722,3/1/2023,MNG,Perak,0,0,0,Mongolia
65723,3/1/2023,MNG,Perlis,12,5,7,Mongolia
65724,3/1/2023,MNG,Pulau Pinang,8,2,6,Mongolia
65725,3/1/2023,MNG,Sabah,3,0,3,Mongolia
65726,3/1/2023,MNG,Sarawak,1,1,0,Mongolia
65727,3/1/2023,MNG,Selangor,291,117,174,Mongolia
65728,3/1/2023,MNP,Selangor,1,0,1,Northern Mariana Islands
65729,3/1/2023,MOZ,Johor,0,0,0,Mozambique
65730,3/1/2023,MOZ,Kedah,0,0,0,Mozambique
65731,3/1/2023,MOZ,Perak,0,0,0,Mozambique
65732,3/1/2023,MOZ,Pulau Pinang,0,0,0,Mozambique
65733,3/1/2023,MOZ,Sabah,0,0,0,Mozambique
65734,3/1/2023,MOZ,Sarawak,0,0,0,Mozambique
65735,3/1/2023,MOZ,Selangor,14,5,9,Mozambique
65736,3/1/2023,MRT,Johor,0,0,0,Mauritania
65737,3/1/2023,MRT,Kedah,1,1,0,Mauritania
65738,3/1/2023,MRT,Pulau Pinang,0,0,0,Mauritania
65739,3/1/2023,MRT,Sabah,0,0,0,Mauritania
65740,3/1/2023,MRT,Sarawak,0,0,0,Mauritania
65741,3/1/2023,MRT,Selangor,22,20,2,Mauritania
65742,3/1/2023,MUS,Johor,215,106,109,Mauritius
65743,3/1/2023,MUS,Kedah,5,4,1,Mauritius
65744,3/1/2023,MUS,Kelantan,0,0,0,Mauritius
65745,3/1/2023,MUS,Pahang,0,0,0,Mauritius
65746,3/1/2023,MUS,Perak,3,2,1,Mauritius
65747,3/1/2023,MUS,Perlis,1,1,0,Mauritius
65748,3/1/2023,MUS,Pulau Pinang,4,3,1,Mauritius
65749,3/1/2023,MUS,Sabah,2,1,1,Mauritius
65750,3/1/2023,MUS,Sarawak,1,1,0,Mauritius
65751,3/1/2023,MUS,Selangor,1753,915,838,Mauritius
65752,3/1/2023,MWI,Johor,3,2,1,Malawi
65753,3/1/2023,MWI,Pulau Pinang,0,0,0,Malawi
65754,3/1/2023,MWI,Sabah,0,0,0,Malawi
65755,3/1/2023,MWI,Sarawak,0,0,0,Malawi
65756,3/1/2023,MWI,Selangor,21,9,12,Malawi
65757,3/1/2023,MYT,Selangor,0,0,0,Mayotte
65758,3/1/2023,NAM,Johor,1,1,0,Namibia
65759,3/1/2023,NAM,Kedah,0,0,0,Namibia
65760,3/1/2023,NAM,Perak,0,0,0,Namibia
65761,3/1/2023,NAM,Perlis,0,0,0,Namibia
65762,3/1/2023,NAM,Pulau Pinang,0,0,0,Namibia
65763,3/1/2023,NAM,Sabah,0,0,0,Namibia
65764,3/1/2023,NAM,Sarawak,0,0,0,Namibia
65765,3/1/2023,NAM,Selangor,14,6,8,Namibia
65766,3/1/2023,NCL,Selangor,0,0,0,New Caledonia
65767,3/1/2023,NER,Johor,0,0,0,Niger
65768,3/1/2023,NER,Sabah,0,0,0,Niger
65769,3/1/2023,NER,Selangor,1,1,0,Niger
65770,3/1/2023,NGA,Johor,20,18,2,Nigeria
65771,3/1/2023,NGA,Kedah,2,0,2,Nigeria
65772,3/1/2023,NGA,Perlis,0,0,0,Nigeria
65773,3/1/2023,NGA,Pulau Pinang,3,3,0,Nigeria
65774,3/1/2023,NGA,Sabah,0,0,0,Nigeria
65775,3/1/2023,NGA,Sarawak,6,3,3,Nigeria
65776,3/1/2023,NGA,Selangor,466,371,95,Nigeria
65777,3/1/2023,NIC,Johor,0,0,0,Nicaragua
65778,3/1/2023,NIC,Kedah,0,0,0,Nicaragua
65779,3/1/2023,NIC,Pulau Pinang,0,0,0,Nicaragua
65780,3/1/2023,NIC,Sabah,0,0,0,Nicaragua
65781,3/1/2023,NIC,Selangor,2,1,1,Nicaragua
65782,3/1/2023,NLD,Johor,1034,683,351,Netherlands
65783,3/1/2023,NLD,Kedah,496,231,265,Netherlands
65784,3/1/2023,NLD,Kelantan,4,2,2,Netherlands
65785,3/1/2023,NLD,Melaka,2,2,0,Netherlands
65786,3/1/2023,NLD,Negeri Sembilan,0,0,0,Netherlands
65787,3/1/2023,NLD,Pahang,0,0,0,Netherlands
65788,3/1/2023,NLD,Perak,18,12,6,Netherlands
65789,3/1/2023,NLD,Perlis,37,24,13,Netherlands
65790,3/1/2023,NLD,Pulau Pinang,247,154,93,Netherlands
65791,3/1/2023,NLD,Sabah,73,40,33,Netherlands
65792,3/1/2023,NLD,Sarawak,163,102,61,Netherlands
65793,3/1/2023,NLD,Selangor,3749,2253,1496,Netherlands
65794,3/1/2023,NLD,Terengganu,0,0,0,Netherlands
65795,3/1/2023,NLD,W.P. Labuan,3,2,1,Netherlands
65796,3/1/2023,NOR,Johor,197,129,68,Norway
65797,3/1/2023,NOR,Kedah,90,34,56,Norway
65798,3/1/2023,NOR,Kelantan,2,1,1,Norway
65799,3/1/2023,NOR,Melaka,0,0,0,Norway
65800,3/1/2023,NOR,Pahang,0,0,0,Norway
65801,3/1/2023,NOR,Perak,1,1,0,Norway
65802,3/1/2023,NOR,Perlis,22,9,13,Norway
65803,3/1/2023,NOR,Pulau Pinang,28,19,9,Norway
65804,3/1/2023,NOR,Sabah,10,6,4,Norway
65805,3/1/2023,NOR,Sarawak,18,13,5,Norway
65806,3/1/2023,NOR,Selangor,773,465,308,Norway
65807,3/1/2023,NOR,W.P. Labuan,0,0,0,Norway
65808,3/1/2023,NPL,Johor,442,326,116,Nepal
65809,3/1/2023,NPL,Kedah,11,8,3,Nepal
65810,3/1/2023,NPL,Pahang,0,0,0,Nepal
65811,3/1/2023,NPL,Perak,0,0,0,Nepal
65812,3/1/2023,NPL,Perlis,0,0,0,Nepal
65813,3/1/2023,NPL,Pulau Pinang,30,30,0,Nepal
65814,3/1/2023,NPL,Sabah,7,6,1,Nepal
65815,3/1/2023,NPL,Sarawak,341,256,85,Nepal
65816,3/1/2023,NPL,Selangor,18301,17762,539,Nepal
65817,3/1/2023,NPL,W.P. Labuan,66,63,3,Nepal
65818,3/1/2023,NRU,Johor,0,0,0,Nauru
65819,3/1/2023,NRU,Pulau Pinang,0,0,0,Nauru
65820,3/1/2023,NRU,Selangor,0,0,0,Nauru
65821,3/1/2023,NZL,Johor,561,363,198,New Zealand
65822,3/1/2023,NZL,Kedah,77,46,31,New Zealand
65823,3/1/2023,NZL,Kelantan,5,2,3,New Zealand
65824,3/1/2023,NZL,Melaka,0,0,0,New Zealand
65825,3/1/2023,NZL,Negeri Sembilan,0,0,0,New Zealand
65826,3/1/2023,NZL,Pahang,0,0,0,New Zealand
65827,3/1/2023,NZL,Perak,18,8,10,New Zealand
65828,3/1/2023,NZL,Perlis,20,12,8,New Zealand
65829,3/1/2023,NZL,Pulau Pinang,141,77,64,New Zealand
65830,3/1/2023,NZL,Sabah,55,28,27,New Zealand
65831,3/1/2023,NZL,Sarawak,145,81,64,New Zealand
65832,3/1/2023,NZL,Selangor,2177,1307,870,New Zealand
65833,3/1/2023,NZL,Terengganu,2,2,0,New Zealand
65834,3/1/2023,NZL,W.P. Labuan,4,3,1,New Zealand
65835,3/1/2023,OMN,Johor,12,7,5,Oman
65836,3/1/2023,OMN,Kedah,0,0,0,Oman
65837,3/1/2023,OMN,Kelantan,0,0,0,Oman
65838,3/1/2023,OMN,Melaka,0,0,0,Oman
65839,3/1/2023,OMN,Perak,0,0,0,Oman
65840,3/1/2023,OMN,Perlis,0,0,0,Oman
65841,3/1/2023,OMN,Pulau Pinang,1,0,1,Oman
65842,3/1/2023,OMN,Sabah,0,0,0,Oman
65843,3/1/2023,OMN,Sarawak,5,2,3,Oman
65844,3/1/2023,OMN,Selangor,458,300,158,Oman
65845,3/1/2023,PAK,Johor,735,543,192,Pakistan
65846,3/1/2023,PAK,Kedah,122,113,9,Pakistan
65847,3/1/2023,PAK,Kelantan,11,11,0,Pakistan
65848,3/1/2023,PAK,Melaka,0,0,0,Pakistan
65849,3/1/2023,PAK,Negeri Sembilan,1,1,0,Pakistan
65850,3/1/2023,PAK,Pahang,0,0,0,Pakistan
65851,3/1/2023,PAK,Perak,28,26,2,Pakistan
65852,3/1/2023,PAK,Perlis,34,31,3,Pakistan
65853,3/1/2023,PAK,Pulau Pinang,67,63,4,Pakistan
65854,3/1/2023,PAK,Sabah,14,8,6,Pakistan
65855,3/1/2023,PAK,Sarawak,123,105,18,Pakistan
65856,3/1/2023,PAK,Selangor,14252,13035,1217,Pakistan
65857,3/1/2023,PAK,W.P. Labuan,2,2,0,Pakistan
65858,3/1/2023,PAN,Johor,1,1,0,Panama
65859,3/1/2023,PAN,Kedah,1,0,1,Panama
65860,3/1/2023,PAN,Perak,0,0,0,Panama
65861,3/1/2023,PAN,Perlis,1,1,0,Panama
65862,3/1/2023,PAN,Pulau Pinang,1,1,0,Panama
65863,3/1/2023,PAN,Sabah,0,0,0,Panama
65864,3/1/2023,PAN,Sarawak,0,0,0,Panama
65865,3/1/2023,PAN,Selangor,24,11,13,Panama
65866,3/1/2023,PER,Johor,27,20,7,Peru
65867,3/1/2023,PER,Kedah,9,4,5,Peru
65868,3/1/2023,PER,Kelantan,0,0,0,Peru
65869,3/1/2023,PER,Pahang,0,0,0,Peru
65870,3/1/2023,PER,Perak,0,0,0,Peru
65871,3/1/2023,PER,Perlis,1,1,0,Peru
65872,3/1/2023,PER,Pulau Pinang,4,4,0,Peru
65873,3/1/2023,PER,Sabah,3,1,2,Peru
65874,3/1/2023,PER,Sarawak,1,0,1,Peru
65875,3/1/2023,PER,Selangor,73,45,28,Peru
65876,3/1/2023,PER,W.P. Labuan,0,0,0,Peru
65877,3/1/2023,PHL,Johor,17453,5455,11998,Philippines
65878,3/1/2023,PHL,Kedah,509,164,345,Philippines
65879,3/1/2023,PHL,Kelantan,19,13,6,Philippines
65880,3/1/2023,PHL,Melaka,1,0,1,Philippines
65881,3/1/2023,PHL,Negeri Sembilan,0,0,0,Philippines
65882,3/1/2023,PHL,Pahang,10,10,0,Philippines
65883,3/1/2023,PHL,Perak,53,8,45,Philippines
65884,3/1/2023,PHL,Perlis,62,21,41,Philippines
65885,3/1/2023,PHL,Pulau Pinang,523,207,316,Philippines
65886,3/1/2023,PHL,Sabah,1589,732,857,Philippines
65887,3/1/2023,PHL,Sarawak,2289,893,1396,Philippines
65888,3/1/2023,PHL,Selangor,14815,5807,9008,Philippines
65889,3/1/2023,PHL,Terengganu,1,1,0,Philippines
65890,3/1/2023,PHL,W.P. Labuan,104,37,67,Philippines
65891,3/1/2023,PLW,Johor,0,0,0,Palau
65892,3/1/2023,PLW,Pulau Pinang,1,1,0,Palau
65893,3/1/2023,PLW,Selangor,0,0,0,Palau
65894,3/1/2023,PNG,Johor,16,6,10,Papua New Guinea
65895,3/1/2023,PNG,Kedah,0,0,0,Papua New Guinea
65896,3/1/2023,PNG,Kelantan,0,0,0,Papua New Guinea
65897,3/1/2023,PNG,Perak,0,0,0,Papua New Guinea
65898,3/1/2023,PNG,Pulau Pinang,0,0,0,Papua New Guinea
65899,3/1/2023,PNG,Sabah,1,1,0,Papua New Guinea
65900,3/1/2023,PNG,Sarawak,7,5,2,Papua New Guinea
65901,3/1/2023,PNG,Selangor,81,45,36,Papua New Guinea
65902,3/1/2023,POL,Johor,513,255,258,Poland
65903,3/1/2023,POL,Kedah,248,124,124,Poland
65904,3/1/2023,POL,Kelantan,2,0,2,Poland
65905,3/1/2023,POL,Melaka,0,0,0,Poland
65906,3/1/2023,POL,Negeri Sembilan,0,0,0,Poland
65907,3/1/2023,POL,Pahang,0,0,0,Poland
65908,3/1/2023,POL,Perak,4,1,3,Poland
65909,3/1/2023,POL,Perlis,31,21,10,Poland
65910,3/1/2023,POL,Pulau Pinang,71,36,35,Poland
65911,3/1/2023,POL,Sabah,64,39,25,Poland
65912,3/1/2023,POL,Sarawak,56,26,30,Poland
65913,3/1/2023,POL,Selangor,1379,734,645,Poland
65914,3/1/2023,POL,Terengganu,0,0,0,Poland
65915,3/1/2023,POL,W.P. Labuan,1,1,0,Poland
65916,3/1/2023,PRK,Selangor,0,0,0,"Korea, Democratic People's Republic of"
65917,3/1/2023,PRT,Johor,144,83,61,Portugal
65918,3/1/2023,PRT,Kedah,80,38,42,Portugal
65919,3/1/2023,PRT,Kelantan,0,0,0,Portugal
65920,3/1/2023,PRT,Melaka,0,0,0,Portugal
65921,3/1/2023,PRT,Pahang,0,0,0,Portugal
65922,3/1/2023,PRT,Perak,3,2,1,Portugal
65923,3/1/2023,PRT,Perlis,12,7,5,Portugal
65924,3/1/2023,PRT,Pulau Pinang,47,21,26,Portugal
65925,3/1/2023,PRT,Sabah,12,8,4,Portugal
65926,3/1/2023,PRT,Sarawak,11,7,4,Portugal
65927,3/1/2023,PRT,Selangor,580,346,234,Portugal
65928,3/1/2023,PRT,W.P. Labuan,0,0,0,Portugal
65929,3/1/2023,PRY,Johor,3,0,3,Paraguay
65930,3/1/2023,PRY,Kedah,0,0,0,Paraguay
65931,3/1/2023,PRY,Perak,0,0,0,Paraguay
65932,3/1/2023,PRY,Perlis,0,0,0,Paraguay
65933,3/1/2023,PRY,Pulau Pinang,0,0,0,Paraguay
65934,3/1/2023,PRY,Sabah,0,0,0,Paraguay
65935,3/1/2023,PRY,Sarawak,0,0,0,Paraguay
65936,3/1/2023,PRY,Selangor,11,5,6,Paraguay
65937,3/1/2023,PSE,Johor,27,26,1,"Palestinian Territory, Occupied"
65938,3/1/2023,PSE,Kedah,0,0,0,"Palestinian Territory, Occupied"
65939,3/1/2023,PSE,Kelantan,0,0,0,"Palestinian Territory, Occupied"
65940,3/1/2023,PSE,Melaka,0,0,0,"Palestinian Territory, Occupied"
65941,3/1/2023,PSE,Perak,0,0,0,"Palestinian Territory, Occupied"
65942,3/1/2023,PSE,Perlis,0,0,0,"Palestinian Territory, Occupied"
65943,3/1/2023,PSE,Pulau Pinang,0,0,0,"Palestinian Territory, Occupied"
65944,3/1/2023,PSE,Sabah,0,0,0,"Palestinian Territory, Occupied"
65945,3/1/2023,PSE,Sarawak,0,0,0,"Palestinian Territory, Occupied"
65946,3/1/2023,PSE,Selangor,249,204,45,"Palestinian Territory, Occupied"
65947,3/1/2023,QAT,Johor,4,3,1,Qatar
65948,3/1/2023,QAT,Kedah,1,1,0,Qatar
65949,3/1/2023,QAT,Perlis,0,0,0,Qatar
65950,3/1/2023,QAT,Pulau Pinang,0,0,0,Qatar
65951,3/1/2023,QAT,Sabah,0,0,0,Qatar
65952,3/1/2023,QAT,Sarawak,1,1,0,Qatar
65953,3/1/2023,QAT,Selangor,89,50,39,Qatar
65954,3/1/2023,REU,Johor,0,0,0,Reunion
65955,3/1/2023,REU,Sarawak,0,0,0,Reunion
65956,3/1/2023,ROU,Johor,158,86,72,Romania
65957,3/1/2023,ROU,Kedah,28,12,16,Romania
65958,3/1/2023,ROU,Kelantan,0,0,0,Romania
65959,3/1/2023,ROU,Negeri Sembilan,0,0,0,Romania
65960,3/1/2023,ROU,Pahang,0,0,0,Romania
65961,3/1/2023,ROU,Perak,0,0,0,Romania
65962,3/1/2023,ROU,Perlis,8,3,5,Romania
65963,3/1/2023,ROU,Pulau Pinang,18,9,9,Romania
65964,3/1/2023,ROU,Sabah,29,19,10,Romania
65965,3/1/2023,ROU,Sarawak,14,13,1,Romania
65966,3/1/2023,ROU,Selangor,647,344,303,Romania
65967,3/1/2023,ROU,W.P. Labuan,0,0,0,Romania
65968,3/1/2023,RUS,Johor,434,216,218,Russia
65969,3/1/2023,RUS,Kedah,694,355,339,Russia
65970,3/1/2023,RUS,Kelantan,70,36,34,Russia
65971,3/1/2023,RUS,Melaka,0,0,0,Russia
65972,3/1/2023,RUS,Negeri Sembilan,0,0,0,Russia
65973,3/1/2023,RUS,Pahang,1,1,0,Russia
65974,3/1/2023,RUS,Perak,3,1,2,Russia
65975,3/1/2023,RUS,Perlis,489,279,210,Russia
65976,3/1/2023,RUS,Pulau Pinang,221,111,110,Russia
65977,3/1/2023,RUS,Sabah,54,23,31,Russia
65978,3/1/2023,RUS,Sarawak,78,39,39,Russia
65979,3/1/2023,RUS,Selangor,14201,7235,6966,Russia
65980,3/1/2023,RUS,W.P. Labuan,2,1,1,Russia
65981,3/1/2023,RWA,Johor,0,0,0,Rwanda
65982,3/1/2023,RWA,Kedah,0,0,0,Rwanda
65983,3/1/2023,RWA,Pulau Pinang,0,0,0,Rwanda
65984,3/1/2023,RWA,Selangor,9,7,2,Rwanda
65985,3/1/2023,SAU,Johor,105,65,40,Saudi Arabia
65986,3/1/2023,SAU,Kedah,24,12,12,Saudi Arabia
65987,3/1/2023,SAU,Kelantan,1,1,0,Saudi Arabia
65988,3/1/2023,SAU,Melaka,0,0,0,Saudi Arabia
65989,3/1/2023,SAU,Perak,0,0,0,Saudi Arabia
65990,3/1/2023,SAU,Perlis,3,3,0,Saudi Arabia
65991,3/1/2023,SAU,Pulau Pinang,22,10,12,Saudi Arabia
65992,3/1/2023,SAU,Sabah,1,1,0,Saudi Arabia
65993,3/1/2023,SAU,Sarawak,7,7,0,Saudi Arabia
65994,3/1/2023,SAU,Selangor,2328,1291,1037,Saudi Arabia
65995,3/1/2023,SAU,W.P. Labuan,0,0,0,Saudi Arabia
65996,3/1/2023,SDN,Johor,5,5,0,Sudan
65997,3/1/2023,SDN,Kedah,4,1,3,Sudan
65998,3/1/2023,SDN,Kelantan,0,0,0,Sudan
65999,3/1/2023,SDN,Perlis,2,2,0,Sudan
66000,3/1/2023,SDN,Pulau Pinang,1,1,0,Sudan
66001,3/1/2023,SDN,Sabah,0,0,0,Sudan
66002,3/1/2023,SDN,Sarawak,11,6,5,Sudan
66003,3/1/2023,SDN,Selangor,925,567,358,Sudan
66004,3/1/2023,SDN,W.P. Labuan,0,0,0,Sudan
66005,3/1/2023,SEN,Johor,3,0,3,Senegal
66006,3/1/2023,SEN,Kedah,0,0,0,Senegal
66007,3/1/2023,SEN,Kelantan,0,0,0,Senegal
66008,3/1/2023,SEN,Perak,0,0,0,Senegal
66009,3/1/2023,SEN,Perlis,0,0,0,Senegal
66010,3/1/2023,SEN,Pulau Pinang,0,0,0,Senegal
66011,3/1/2023,SEN,Sabah,0,0,0,Senegal
66012,3/1/2023,SEN,Sarawak,0,0,0,Senegal
66013,3/1/2023,SEN,Selangor,48,37,11,Senegal
66014,3/1/2023,SGP,Johor,1059355,604758,454597,Singapore
66015,3/1/2023,SGP,Kedah,3602,1985,1617,Singapore
66016,3/1/2023,SGP,Kelantan,76,56,20,Singapore
66017,3/1/2023,SGP,Melaka,18,11,7,Singapore
66018,3/1/2023,SGP,Negeri Sembilan,0,0,0,Singapore
66019,3/1/2023,SGP,Pahang,194,96,98,Singapore
66020,3/1/2023,SGP,Perak,6743,3165,3578,Singapore
66021,3/1/2023,SGP,Perlis,239,140,99,Singapore
66022,3/1/2023,SGP,Pulau Pinang,17485,8836,8649,Singapore
66023,3/1/2023,SGP,Sabah,3829,1942,1887,Singapore
66024,3/1/2023,SGP,Sarawak,5212,2778,2434,Singapore
66025,3/1/2023,SGP,Selangor,43708,23088,20620,Singapore
66026,3/1/2023,SGP,Terengganu,2,2,0,Singapore
66027,3/1/2023,SGP,W.P. Labuan,10,10,0,Singapore
66028,3/1/2023,SGS,Johor,0,0,0,South Georgia and the South Sandwich Islands
66029,3/1/2023,SGS,Sabah,0,0,0,South Georgia and the South Sandwich Islands
66030,3/1/2023,SGS,Selangor,0,0,0,South Georgia and the South Sandwich Islands
66031,3/1/2023,SHN,Sarawak,0,0,0,"Saint Helena, Ascension and Tristan da Cunha"
66032,3/1/2023,SLB,Johor,0,0,0,Solomon Islands
66033,3/1/2023,SLB,Perlis,0,0,0,Solomon Islands
66034,3/1/2023,SLB,Pulau Pinang,0,0,0,Solomon Islands
66035,3/1/2023,SLB,Sabah,0,0,0,Solomon Islands
66036,3/1/2023,SLB,Sarawak,4,1,3,Solomon Islands
66037,3/1/2023,SLB,Selangor,5,2,3,Solomon Islands
66038,3/1/2023,SLB,W.P. Labuan,0,0,0,Solomon Islands
66039,3/1/2023,SLE,Johor,3,3,0,Sierra Leone
66040,3/1/2023,SLE,Kedah,0,0,0,Sierra Leone
66041,3/1/2023,SLE,Perak,0,0,0,Sierra Leone
66042,3/1/2023,SLE,Pulau Pinang,0,0,0,Sierra Leone
66043,3/1/2023,SLE,Sabah,0,0,0,Sierra Leone
66044,3/1/2023,SLE,Selangor,23,17,6,Sierra Leone
66045,3/1/2023,SLV,Johor,4,1,3,El Salvador
66046,3/1/2023,SLV,Kedah,0,0,0,El Salvador
66047,3/1/2023,SLV,Perak,0,0,0,El Salvador
66048,3/1/2023,SLV,Perlis,1,1,0,El Salvador
66049,3/1/2023,SLV,Pulau Pinang,1,1,0,El Salvador
66050,3/1/2023,SLV,Sabah,2,2,0,El Salvador
66051,3/1/2023,SLV,Selangor,10,6,4,El Salvador
66052,3/1/2023,SLV,W.P. Labuan,0,0,0,El Salvador
66053,3/1/2023,SMR,Johor,0,0,0,San Marino
66054,3/1/2023,SMR,Selangor,1,1,0,San Marino
66055,3/1/2023,SOM,Johor,0,0,0,Somalia
66056,3/1/2023,SOM,Kedah,0,0,0,Somalia
66057,3/1/2023,SOM,Kelantan,1,0,1,Somalia
66058,3/1/2023,SOM,Perlis,0,0,0,Somalia
66059,3/1/2023,SOM,Sabah,0,0,0,Somalia
66060,3/1/2023,SOM,Sarawak,0,0,0,Somalia
66061,3/1/2023,SOM,Selangor,250,163,87,Somalia
66062,3/1/2023,SRB,Johor,16,12,4,Serbia
66063,3/1/2023,SRB,Kedah,12,8,4,Serbia
66064,3/1/2023,SRB,Kelantan,0,0,0,Serbia
66065,3/1/2023,SRB,Pahang,0,0,0,Serbia
66066,3/1/2023,SRB,Perak,0,0,0,Serbia
66067,3/1/2023,SRB,Perlis,0,0,0,Serbia
66068,3/1/2023,SRB,Pulau Pinang,1,0,1,Serbia
66069,3/1/2023,SRB,Sabah,0,0,0,Serbia
66070,3/1/2023,SRB,Sarawak,1,0,1,Serbia
66071,3/1/2023,SRB,Selangor,56,35,21,Serbia
66072,3/1/2023,STP,Selangor,2,1,1,Sao Tome and Principe
66073,3/1/2023,SUR,Johor,6,2,4,Suriname
66074,3/1/2023,SUR,Kedah,0,0,0,Suriname
66075,3/1/2023,SUR,Kelantan,0,0,0,Suriname
66076,3/1/2023,SUR,Perak,0,0,0,Suriname
66077,3/1/2023,SUR,Perlis,1,1,0,Suriname
66078,3/1/2023,SUR,Pulau Pinang,1,1,0,Suriname
66079,3/1/2023,SUR,Sabah,0,0,0,Suriname
66080,3/1/2023,SUR,Sarawak,0,0,0,Suriname
66081,3/1/2023,SUR,Selangor,8,6,2,Suriname
66082,3/1/2023,SVK,Johor,65,39,26,Slovakia
66083,3/1/2023,SVK,Kedah,100,57,43,Slovakia
66084,3/1/2023,SVK,Kelantan,3,2,1,Slovakia
66085,3/1/2023,SVK,Negeri Sembilan,0,0,0,Slovakia
66086,3/1/2023,SVK,Pahang,0,0,0,Slovakia
66087,3/1/2023,SVK,Perak,1,1,0,Slovakia
66088,3/1/2023,SVK,Perlis,9,8,1,Slovakia
66089,3/1/2023,SVK,Pulau Pinang,10,7,3,Slovakia
66090,3/1/2023,SVK,Sabah,10,3,7,Slovakia
66091,3/1/2023,SVK,Sarawak,6,6,0,Slovakia
66092,3/1/2023,SVK,Selangor,351,188,163,Slovakia
66093,3/1/2023,SVK,W.P. Labuan,10,6,4,Slovakia
66094,3/1/2023,SVN,Johor,20,10,10,Slovenia
66095,3/1/2023,SVN,Kedah,21,12,9,Slovenia
66096,3/1/2023,SVN,Kelantan,0,0,0,Slovenia
66097,3/1/2023,SVN,Perak,0,0,0,Slovenia
66098,3/1/2023,SVN,Perlis,2,2,0,Slovenia
66099,3/1/2023,SVN,Pulau Pinang,9,2,7,Slovenia
66100,3/1/2023,SVN,Sabah,3,1,2,Slovenia
66101,3/1/2023,SVN,Sarawak,0,0,0,Slovenia
66102,3/1/2023,SVN,Selangor,119,64,55,Slovenia
66103,3/1/2023,SVN,W.P. Labuan,0,0,0,Slovenia
66104,3/1/2023,SWE,Johor,249,139,110,Sweden
66105,3/1/2023,SWE,Kedah,348,154,194,Sweden
66106,3/1/2023,SWE,Kelantan,8,5,3,Sweden
66107,3/1/2023,SWE,Melaka,0,0,0,Sweden
66108,3/1/2023,SWE,Negeri Sembilan,0,0,0,Sweden
66109,3/1/2023,SWE,Pahang,0,0,0,Sweden
66110,3/1/2023,SWE,Perak,8,7,1,Sweden
66111,3/1/2023,SWE,Perlis,30,21,9,Sweden
66112,3/1/2023,SWE,Pulau Pinang,65,47,18,Sweden
66113,3/1/2023,SWE,Sabah,39,20,19,Sweden
66114,3/1/2023,SWE,Sarawak,23,18,5,Sweden
66115,3/1/2023,SWE,Selangor,1388,833,555,Sweden
66116,3/1/2023,SWE,W.P. Labuan,1,0,1,Sweden
66117,3/1/2023,SWZ,Johor,0,0,0,Swaziland
66118,3/1/2023,SWZ,Kedah,0,0,0,Swaziland
66119,3/1/2023,SWZ,Pulau Pinang,0,0,0,Swaziland
66120,3/1/2023,SWZ,Sabah,0,0,0,Swaziland
66121,3/1/2023,SWZ,Selangor,11,2,9,Swaziland
66122,3/1/2023,SYC,Johor,3,2,1,Seychelles
66123,3/1/2023,SYC,Kedah,0,0,0,Seychelles
66124,3/1/2023,SYC,Pulau Pinang,0,0,0,Seychelles
66125,3/1/2023,SYC,Sabah,0,0,0,Seychelles
66126,3/1/2023,SYC,Sarawak,0,0,0,Seychelles
66127,3/1/2023,SYC,Selangor,61,23,38,Seychelles
66128,3/1/2023,SYR,Johor,9,6,3,Syrian Arab Republic
66129,3/1/2023,SYR,Kedah,0,0,0,Syrian Arab Republic
66130,3/1/2023,SYR,Kelantan,0,0,0,Syrian Arab Republic
66131,3/1/2023,SYR,Pahang,0,0,0,Syrian Arab Republic
66132,3/1/2023,SYR,Perlis,1,1,0,Syrian Arab Republic
66133,3/1/2023,SYR,Pulau Pinang,1,1,0,Syrian Arab Republic
66134,3/1/2023,SYR,Sabah,0,0,0,Syrian Arab Republic
66135,3/1/2023,SYR,Sarawak,2,2,0,Syrian Arab Republic
66136,3/1/2023,SYR,Selangor,561,405,156,Syrian Arab Republic
66137,3/1/2023,SYR,W.P. Labuan,0,0,0,Syrian Arab Republic
66138,3/1/2023,TCA,Perlis,0,0,0,Turks and Caicos
66139,3/1/2023,TCD,Johor,2,2,0,Chad
66140,3/1/2023,TCD,Kedah,2,2,0,Chad
66141,3/1/2023,TCD,Perlis,1,1,0,Chad
66142,3/1/2023,TCD,Selangor,27,17,10,Chad
66143,3/1/2023,TGO,Johor,2,2,0,Togo
66144,3/1/2023,TGO,Perak,0,0,0,Togo
66145,3/1/2023,TGO,Pulau Pinang,0,0,0,Togo
66146,3/1/2023,TGO,Selangor,8,8,0,Togo
66147,3/1/2023,THA,Johor,7143,2179,4964,Thailand
66148,3/1/2023,THA,Kedah,78894,46381,32513,Thailand
66149,3/1/2023,THA,Kelantan,56877,28776,28101,Thailand
66150,3/1/2023,THA,Melaka,35,24,11,Thailand
66151,3/1/2023,THA,Negeri Sembilan,1,1,0,Thailand
66152,3/1/2023,THA,Pahang,2,1,1,Thailand
66153,3/1/2023,THA,Perak,12610,5880,6730,Thailand
66154,3/1/2023,THA,Perlis,65383,39899,25484,Thailand
66155,3/1/2023,THA,Pulau Pinang,2231,925,1306,Thailand
66156,3/1/2023,THA,Sabah,216,82,134,Thailand
66157,3/1/2023,THA,Sarawak,389,144,245,Thailand
66158,3/1/2023,THA,Selangor,13308,5196,8112,Thailand
66159,3/1/2023,THA,Terengganu,2,2,0,Thailand
66160,3/1/2023,THA,W.P. Labuan,2,2,0,Thailand
66161,3/1/2023,TJK,Johor,1,1,0,Tajikistan
66162,3/1/2023,TJK,Kedah,0,0,0,Tajikistan
66163,3/1/2023,TJK,Perlis,0,0,0,Tajikistan
66164,3/1/2023,TJK,Pulau Pinang,0,0,0,Tajikistan
66165,3/1/2023,TJK,Sabah,0,0,0,Tajikistan
66166,3/1/2023,TJK,Selangor,105,65,40,Tajikistan
66167,3/1/2023,TKL,Selangor,0,0,0,Tokelau
66168,3/1/2023,TKM,Johor,0,0,0,Turkmenistan
66169,3/1/2023,TKM,Kedah,2,1,1,Turkmenistan
66170,3/1/2023,TKM,Kelantan,0,0,0,Turkmenistan
66171,3/1/2023,TKM,Perlis,0,0,0,Turkmenistan
66172,3/1/2023,TKM,Pulau Pinang,0,0,0,Turkmenistan
66173,3/1/2023,TKM,Sabah,0,0,0,Turkmenistan
66174,3/1/2023,TKM,Sarawak,2,2,0,Turkmenistan
66175,3/1/2023,TKM,Selangor,109,78,31,Turkmenistan
66176,3/1/2023,TLS,Johor,6,6,0,Timor-Leste
66177,3/1/2023,TLS,Kedah,0,0,0,Timor-Leste
66178,3/1/2023,TLS,Perlis,0,0,0,Timor-Leste
66179,3/1/2023,TLS,Pulau Pinang,7,2,5,Timor-Leste
66180,3/1/2023,TLS,Sabah,0,0,0,Timor-Leste
66181,3/1/2023,TLS,Sarawak,0,0,0,Timor-Leste
66182,3/1/2023,TLS,Selangor,190,113,77,Timor-Leste
66183,3/1/2023,TON,Johor,0,0,0,Tonga
66184,3/1/2023,TON,Pulau Pinang,0,0,0,Tonga
66185,3/1/2023,TON,Sarawak,0,0,0,Tonga
66186,3/1/2023,TON,Selangor,11,4,7,Tonga
66187,3/1/2023,TTO,Johor,4,3,1,Trinidad and Tobago
66188,3/1/2023,TTO,Kedah,0,0,0,Trinidad and Tobago
66189,3/1/2023,TTO,Pahang,0,0,0,Trinidad and Tobago
66190,3/1/2023,TTO,Pulau Pinang,0,0,0,Trinidad and Tobago
66191,3/1/2023,TTO,Sabah,0,0,0,Trinidad and Tobago
66192,3/1/2023,TTO,Sarawak,4,3,1,Trinidad and Tobago
66193,3/1/2023,TTO,Selangor,25,19,6,Trinidad and Tobago
66194,3/1/2023,TUN,Johor,14,9,5,Tunisia
66195,3/1/2023,TUN,Kedah,6,4,2,Tunisia
66196,3/1/2023,TUN,Kelantan,1,1,0,Tunisia
66197,3/1/2023,TUN,Melaka,0,0,0,Tunisia
66198,3/1/2023,TUN,Perak,0,0,0,Tunisia
66199,3/1/2023,TUN,Perlis,0,0,0,Tunisia
66200,3/1/2023,TUN,Pulau Pinang,3,2,1,Tunisia
66201,3/1/2023,TUN,Sabah,0,0,0,Tunisia
66202,3/1/2023,TUN,Sarawak,1,1,0,Tunisia
66203,3/1/2023,TUN,Selangor,339,197,142,Tunisia
66204,3/1/2023,TUN,W.P. Labuan,0,0,0,Tunisia
66205,3/1/2023,TUR,Johor,247,182,65,Turkey
66206,3/1/2023,TUR,Kedah,46,35,11,Turkey
66207,3/1/2023,TUR,Kelantan,6,4,2,Turkey
66208,3/1/2023,TUR,Melaka,0,0,0,Turkey
66209,3/1/2023,TUR,Negeri Sembilan,0,0,0,Turkey
66210,3/1/2023,TUR,Pahang,0,0,0,Turkey
66211,3/1/2023,TUR,Perak,1,0,1,Turkey
66212,3/1/2023,TUR,Perlis,18,16,2,Turkey
66213,3/1/2023,TUR,Pulau Pinang,47,33,14,Turkey
66214,3/1/2023,TUR,Sabah,5,3,2,Turkey
66215,3/1/2023,TUR,Sarawak,18,10,8,Turkey
66216,3/1/2023,TUR,Selangor,1300,935,365,Turkey
66217,3/1/2023,TUR,W.P. Labuan,1,1,0,Turkey
66218,3/1/2023,TUV,Selangor,0,0,0,Tuvalu
66219,3/1/2023,TWN,Johor,3971,1698,2273,Taiwan
66220,3/1/2023,TWN,Kedah,117,65,52,Taiwan
66221,3/1/2023,TWN,Kelantan,5,3,2,Taiwan
66222,3/1/2023,TWN,Melaka,3,1,2,Taiwan
66223,3/1/2023,TWN,Negeri Sembilan,0,0,0,Taiwan
66224,3/1/2023,TWN,Pahang,1,0,1,Taiwan
66225,3/1/2023,TWN,Perak,40,20,20,Taiwan
66226,3/1/2023,TWN,Perlis,10,6,4,Taiwan
66227,3/1/2023,TWN,Pulau Pinang,2738,1419,1319,Taiwan
66228,3/1/2023,TWN,Sabah,1019,486,533,Taiwan
66229,3/1/2023,TWN,Sarawak,323,138,185,Taiwan
66230,3/1/2023,TWN,Selangor,10593,5326,5267,Taiwan
66231,3/1/2023,TWN,W.P. Labuan,5,3,2,Taiwan
66232,3/1/2023,TZA,Johor,17,7,10,"Tanzania, United Republic of"
66233,3/1/2023,TZA,Kedah,0,0,0,"Tanzania, United Republic of"
66234,3/1/2023,TZA,Perak,1,1,0,"Tanzania, United Republic of"
66235,3/1/2023,TZA,Perlis,0,0,0,"Tanzania, United Republic of"
66236,3/1/2023,TZA,Pulau Pinang,0,0,0,"Tanzania, United Republic of"
66237,3/1/2023,TZA,Sabah,0,0,0,"Tanzania, United Republic of"
66238,3/1/2023,TZA,Sarawak,6,6,0,"Tanzania, United Republic of"
66239,3/1/2023,TZA,Selangor,106,55,51,"Tanzania, United Republic of"
66240,3/1/2023,UGA,Johor,15,9,6,Uganda
66241,3/1/2023,UGA,Kedah,2,1,1,Uganda
66242,3/1/2023,UGA,Perak,0,0,0,Uganda
66243,3/1/2023,UGA,Perlis,0,0,0,Uganda
66244,3/1/2023,UGA,Pulau Pinang,1,0,1,Uganda
66245,3/1/2023,UGA,Sabah,0,0,0,Uganda
66246,3/1/2023,UGA,Sarawak,1,1,0,Uganda
66247,3/1/2023,UGA,Selangor,67,30,37,Uganda
66248,3/1/2023,UKR,Johor,114,63,51,Ukraine
66249,3/1/2023,UKR,Kedah,55,29,26,Ukraine
66250,3/1/2023,UKR,Kelantan,2,1,1,Ukraine
66251,3/1/2023,UKR,Melaka,0,0,0,Ukraine
66252,3/1/2023,UKR,Negeri Sembilan,0,0,0,Ukraine
66253,3/1/2023,UKR,Pahang,3,3,0,Ukraine
66254,3/1/2023,UKR,Perak,0,0,0,Ukraine
66255,3/1/2023,UKR,Perlis,9,6,3,Ukraine
66256,3/1/2023,UKR,Pulau Pinang,17,10,7,Ukraine
66257,3/1/2023,UKR,Sabah,9,2,7,Ukraine
66258,3/1/2023,UKR,Sarawak,7,7,0,Ukraine
66259,3/1/2023,UKR,Selangor,1193,540,653,Ukraine
66260,3/1/2023,UKR,W.P. Labuan,9,2,7,Ukraine
66261,3/1/2023,URY,Johor,58,17,41,Uruguay
66262,3/1/2023,URY,Kedah,2,0,2,Uruguay
66263,3/1/2023,URY,Kelantan,0,0,0,Uruguay
66264,3/1/2023,URY,Perak,0,0,0,Uruguay
66265,3/1/2023,URY,Perlis,0,0,0,Uruguay
66266,3/1/2023,URY,Pulau Pinang,0,0,0,Uruguay
66267,3/1/2023,URY,Sabah,2,1,1,Uruguay
66268,3/1/2023,URY,Sarawak,0,0,0,Uruguay
66269,3/1/2023,URY,Selangor,131,56,75,Uruguay
66270,3/1/2023,URY,W.P. Labuan,0,0,0,Uruguay
66271,3/1/2023,USA,Johor,4316,2512,1804,United States Of America
66272,3/1/2023,USA,Kedah,579,304,275,United States Of America
66273,3/1/2023,USA,Kelantan,11,10,1,United States Of America
66274,3/1/2023,USA,Melaka,8,6,2,United States Of America
66275,3/1/2023,USA,Negeri Sembilan,0,0,0,United States Of America
66276,3/1/2023,USA,Pahang,0,0,0,United States Of America
66277,3/1/2023,USA,Perak,110,67,43,United States Of America
66278,3/1/2023,USA,Perlis,142,94,48,United States Of America
66279,3/1/2023,USA,Pulau Pinang,1870,1094,776,United States Of America
66280,3/1/2023,USA,Sabah,565,291,274,United States Of America
66281,3/1/2023,USA,Sarawak,423,233,190,United States Of America
66282,3/1/2023,USA,Selangor,13532,7999,5533,United States Of America
66283,3/1/2023,USA,Terengganu,0,0,0,United States Of America
66284,3/1/2023,USA,W.P. Labuan,14,12,2,United States Of America
66285,3/1/2023,UZB,Johor,99,79,20,Uzbekistan
66286,3/1/2023,UZB,Kedah,9,5,4,Uzbekistan
66287,3/1/2023,UZB,Kelantan,0,0,0,Uzbekistan
66288,3/1/2023,UZB,Perak,1,1,0,Uzbekistan
66289,3/1/2023,UZB,Perlis,5,4,1,Uzbekistan
66290,3/1/2023,UZB,Pulau Pinang,12,5,7,Uzbekistan
66291,3/1/2023,UZB,Sabah,4,4,0,Uzbekistan
66292,3/1/2023,UZB,Sarawak,0,0,0,Uzbekistan
66293,3/1/2023,UZB,Selangor,1356,818,538,Uzbekistan
66294,3/1/2023,VAT,Johor,0,0,0,Holy See (Vatican City State)
66295,3/1/2023,VAT,Sarawak,0,0,0,Holy See (Vatican City State)
66296,3/1/2023,VAT,Selangor,0,0,0,Holy See (Vatican City State)
66297,3/1/2023,VCT,Johor,0,0,0,Saint Vincent and the Grenadines
66298,3/1/2023,VCT,Kedah,0,0,0,Saint Vincent and the Grenadines
66299,3/1/2023,VCT,Pulau Pinang,0,0,0,Saint Vincent and the Grenadines
66300,3/1/2023,VCT,Sarawak,2,2,0,Saint Vincent and the Grenadines
66301,3/1/2023,VCT,Selangor,2,2,0,Saint Vincent and the Grenadines
66302,3/1/2023,VEN,Johor,7,2,5,Venezuela
66303,3/1/2023,VEN,Kedah,5,2,3,Venezuela
66304,3/1/2023,VEN,Kelantan,0,0,0,Venezuela
66305,3/1/2023,VEN,Melaka,0,0,0,Venezuela
66306,3/1/2023,VEN,Perak,0,0,0,Venezuela
66307,3/1/2023,VEN,Perlis,0,0,0,Venezuela
66308,3/1/2023,VEN,Pulau Pinang,1,0,1,Venezuela
66309,3/1/2023,VEN,Sabah,3,1,2,Venezuela
66310,3/1/2023,VEN,Sarawak,5,5,0,Venezuela
66311,3/1/2023,VEN,Selangor,73,44,29,Venezuela
66312,3/1/2023,VEN,W.P. Labuan,0,0,0,Venezuela
66313,3/1/2023,VNM,Johor,13546,4103,9443,Vietnam
66314,3/1/2023,VNM,Kedah,296,40,256,Vietnam
66315,3/1/2023,VNM,Kelantan,10,5,5,Vietnam
66316,3/1/2023,VNM,Melaka,0,0,0,Vietnam
66317,3/1/2023,VNM,Negeri Sembilan,0,0,0,Vietnam
66318,3/1/2023,VNM,Pahang,0,0,0,Vietnam
66319,3/1/2023,VNM,Perak,112,14,98,Vietnam
66320,3/1/2023,VNM,Perlis,269,18,251,Vietnam
66321,3/1/2023,VNM,Pulau Pinang,1423,445,978,Vietnam
66322,3/1/2023,VNM,Sabah,33,8,25,Vietnam
66323,3/1/2023,VNM,Sarawak,203,42,161,Vietnam
66324,3/1/2023,VNM,Selangor,18317,6156,12161,Vietnam
66325,3/1/2023,VNM,Terengganu,0,0,0,Vietnam
66326,3/1/2023,VNM,W.P. Labuan,0,0,0,Vietnam
66327,3/1/2023,VUT,Johor,41,25,16,Vanuatu
66328,3/1/2023,VUT,Kedah,1,1,0,Vanuatu
66329,3/1/2023,VUT,Pulau Pinang,6,4,2,Vanuatu
66330,3/1/2023,VUT,Sabah,0,0,0,Vanuatu
66331,3/1/2023,VUT,Sarawak,0,0,0,Vanuatu
66332,3/1/2023,VUT,Selangor,64,52,12,Vanuatu
66333,3/1/2023,WSM,Johor,0,0,0,Samoa
66334,3/1/2023,WSM,Sarawak,0,0,0,Samoa
66335,3/1/2023,WSM,Selangor,6,3,3,Samoa
66336,3/1/2023,YEM,Johor,36,26,10,Yemen
66337,3/1/2023,YEM,Kedah,11,10,1,Yemen
66338,3/1/2023,YEM,Kelantan,1,0,1,Yemen
66339,3/1/2023,YEM,Melaka,1,1,0,Yemen
66340,3/1/2023,YEM,Pahang,0,0,0,Yemen
66341,3/1/2023,YEM,Perak,0,0,0,Yemen
66342,3/1/2023,YEM,Perlis,0,0,0,Yemen
66343,3/1/2023,YEM,Pulau Pinang,2,1,1,Yemen
66344,3/1/2023,YEM,Sabah,2,2,0,Yemen
66345,3/1/2023,YEM,Sarawak,5,3,2,Yemen
66346,3/1/2023,YEM,Selangor,962,714,248,Yemen
66347,3/1/2023,YEM,W.P. Labuan,0,0,0,Yemen
66348,3/1/2023,ZAF,Johor,242,148,94,South Africa
66349,3/1/2023,ZAF,Kedah,46,29,17,South Africa
66350,3/1/2023,ZAF,Kelantan,3,3,0,South Africa
66351,3/1/2023,ZAF,Melaka,0,0,0,South Africa
66352,3/1/2023,ZAF,Pahang,0,0,0,South Africa
66353,3/1/2023,ZAF,Perak,1,1,0,South Africa
66354,3/1/2023,ZAF,Perlis,8,5,3,South Africa
66355,3/1/2023,ZAF,Pulau Pinang,31,19,12,South Africa
66356,3/1/2023,ZAF,Sabah,22,10,12,South Africa
66357,3/1/2023,ZAF,Sarawak,96,51,45,South Africa
66358,3/1/2023,ZAF,Selangor,735,436,299,South Africa
66359,3/1/2023,ZAF,Terengganu,1,1,0,South Africa
66360,3/1/2023,ZAF,W.P. Labuan,0,0,0,South Africa
66361,3/1/2023,ZMB,Johor,4,3,1,Zambia
66362,3/1/2023,ZMB,Kedah,1,1,0,Zambia
66363,3/1/2023,ZMB,Perak,0,0,0,Zambia
66364,3/1/2023,ZMB,Perlis,0,0,0,Zambia
66365,3/1/2023,ZMB,Pulau Pinang,1,1,0,Zambia
66366,3/1/2023,ZMB,Sabah,0,0,0,Zambia
66367,3/1/2023,ZMB,Sarawak,2,1,1,Zambia
66368,3/1/2023,ZMB,Selangor,56,29,27,Zambia
66369,3/1/2023,ZWE,Johor,8,2,6,Zimbabwe
66370,3/1/2023,ZWE,Kedah,4,1,3,Zimbabwe
66371,3/1/2023,ZWE,Kelantan,0,0,0,Zimbabwe
66372,3/1/2023,ZWE,Perak,0,0,0,Zimbabwe
66373,3/1/2023,ZWE,Perlis,3,2,1,Zimbabwe
66374,3/1/2023,ZWE,Pulau Pinang,1,0,1,Zimbabwe
66375,3/1/2023,ZWE,Sabah,0,0,0,Zimbabwe
66376,3/1/2023,ZWE,Sarawak,3,3,0,Zimbabwe
66377,3/1/2023,ZWE,Selangor,102,44,58,Zimbabwe
66378,4/1/2023,ABW,Kedah,0,0,0,Aruba
66379,4/1/2023,ABW,Pulau Pinang,0,0,0,Aruba
66380,4/1/2023,AFG,Johor,2,2,0,Afghanistan
66381,4/1/2023,AFG,Kedah,1,1,0,Afghanistan
66382,4/1/2023,AFG,Perlis,0,0,0,Afghanistan
66383,4/1/2023,AFG,Pulau Pinang,0,0,0,Afghanistan
66384,4/1/2023,AFG,Sarawak,1,1,0,Afghanistan
66385,4/1/2023,AFG,Selangor,31,23,8,Afghanistan
66386,4/1/2023,AGO,Johor,2,0,2,Angola
66387,4/1/2023,AGO,Kedah,0,0,0,Angola
66388,4/1/2023,AGO,Sabah,0,0,0,Angola
66389,4/1/2023,AGO,Selangor,0,0,0,Angola
66390,4/1/2023,AIA,Selangor,0,0,0,Anguilla
66391,4/1/2023,ALB,Johor,14,13,1,Albania
66392,4/1/2023,ALB,Kedah,1,1,0,Albania
66393,4/1/2023,ALB,Perak,0,0,0,Albania
66394,4/1/2023,ALB,Perlis,1,1,0,Albania
66395,4/1/2023,ALB,Pulau Pinang,1,1,0,Albania
66396,4/1/2023,ALB,Sabah,1,1,0,Albania
66397,4/1/2023,ALB,Sarawak,0,0,0,Albania
66398,4/1/2023,ALB,Selangor,27,18,9,Albania
66399,4/1/2023,AND,Johor,0,0,0,Andorra
66400,4/1/2023,AND,Kedah,0,0,0,Andorra
66401,4/1/2023,AND,Perlis,0,0,0,Andorra
66402,4/1/2023,AND,Pulau Pinang,0,0,0,Andorra
66403,4/1/2023,AND,Selangor,4,2,2,Andorra
66404,4/1/2023,ANT,Selangor,0,0,0,Netherlands Antilles
66405,4/1/2023,ARE,Johor,17,15,2,United Arab Emirates
66406,4/1/2023,ARE,Kedah,1,1,0,United Arab Emirates
66407,4/1/2023,ARE,Kelantan,0,0,0,United Arab Emirates
66408,4/1/2023,ARE,Perak,0,0,0,United Arab Emirates
66409,4/1/2023,ARE,Perlis,0,0,0,United Arab Emirates
66410,4/1/2023,ARE,Pulau Pinang,1,0,1,United Arab Emirates
66411,4/1/2023,ARE,Sabah,0,0,0,United Arab Emirates
66412,4/1/2023,ARE,Sarawak,0,0,0,United Arab Emirates
66413,4/1/2023,ARE,Selangor,191,110,81,United Arab Emirates
66414,4/1/2023,ARG,Johor,54,31,23,Argentina
66415,4/1/2023,ARG,Kedah,84,35,49,Argentina
66416,4/1/2023,ARG,Kelantan,1,1,0,Argentina
66417,4/1/2023,ARG,Melaka,2,1,1,Argentina
66418,4/1/2023,ARG,Perak,0,0,0,Argentina
66419,4/1/2023,ARG,Perlis,0,0,0,Argentina
66420,4/1/2023,ARG,Pulau Pinang,5,4,1,Argentina
66421,4/1/2023,ARG,Sabah,0,0,0,Argentina
66422,4/1/2023,ARG,Sarawak,2,2,0,Argentina
66423,4/1/2023,ARG,Selangor,375,196,179,Argentina
66424,4/1/2023,ARG,W.P. Labuan,0,0,0,Argentina
66425,4/1/2023,ARM,Johor,2,1,1,Armenia
66426,4/1/2023,ARM,Kedah,0,0,0,Armenia
66427,4/1/2023,ARM,Kelantan,0,0,0,Armenia
66428,4/1/2023,ARM,Perak,0,0,0,Armenia
66429,4/1/2023,ARM,Perlis,0,0,0,Armenia
66430,4/1/2023,ARM,Pulau Pinang,3,2,1,Armenia
66431,4/1/2023,ARM,Sabah,0,0,0,Armenia
66432,4/1/2023,ARM,Sarawak,0,0,0,Armenia
66433,4/1/2023,ARM,Selangor,45,31,14,Armenia
66434,4/1/2023,ATA,Selangor,0,0,0,Antarctica
66435,4/1/2023,ATG,Johor,7,4,3,Antigua and Barbuda
66436,4/1/2023,ATG,Kedah,0,0,0,Antigua and Barbuda
66437,4/1/2023,ATG,Pulau Pinang,0,0,0,Antigua and Barbuda
66438,4/1/2023,ATG,Sarawak,1,1,0,Antigua and Barbuda
66439,4/1/2023,ATG,Selangor,11,9,2,Antigua and Barbuda
66440,4/1/2023,AUS,Johor,6016,3378,2638,Australia
66441,4/1/2023,AUS,Kedah,816,430,386,Australia
66442,4/1/2023,AUS,Kelantan,12,8,4,Australia
66443,4/1/2023,AUS,Melaka,3,1,2,Australia
66444,4/1/2023,AUS,Negeri Sembilan,0,0,0,Australia
66445,4/1/2023,AUS,Pahang,42,26,16,Australia
66446,4/1/2023,AUS,Perak,223,109,114,Australia
66447,4/1/2023,AUS,Perlis,69,42,27,Australia
66448,4/1/2023,AUS,Pulau Pinang,1989,1089,900,Australia
66449,4/1/2023,AUS,Sabah,610,311,299,Australia
66450,4/1/2023,AUS,Sarawak,706,399,307,Australia
66451,4/1/2023,AUS,Selangor,22882,12855,10027,Australia
66452,4/1/2023,AUS,Terengganu,0,0,0,Australia
66453,4/1/2023,AUS,W.P. Labuan,15,8,7,Australia
66454,4/1/2023,AUT,Johor,156,97,59,Austria
66455,4/1/2023,AUT,Kedah,76,38,38,Austria
66456,4/1/2023,AUT,Kelantan,4,2,2,Austria
66457,4/1/2023,AUT,Melaka,0,0,0,Austria
66458,4/1/2023,AUT,Negeri Sembilan,0,0,0,Austria
66459,4/1/2023,AUT,Pahang,0,0,0,Austria
66460,4/1/2023,AUT,Perak,2,2,0,Austria
66461,4/1/2023,AUT,Perlis,11,5,6,Austria
66462,4/1/2023,AUT,Pulau Pinang,62,40,22,Austria
66463,4/1/2023,AUT,Sabah,13,10,3,Austria
66464,4/1/2023,AUT,Sarawak,11,6,5,Austria
66465,4/1/2023,AUT,Selangor,643,393,250,Austria
66466,4/1/2023,AUT,Terengganu,0,0,0,Austria
66467,4/1/2023,AUT,W.P. Labuan,0,0,0,Austria
66468,4/1/2023,AZE,Johor,3,1,2,Azerbaijan
66469,4/1/2023,AZE,Kedah,0,0,0,Azerbaijan
66470,4/1/2023,AZE,Kelantan,1,1,0,Azerbaijan
66471,4/1/2023,AZE,Melaka,0,0,0,Azerbaijan
66472,4/1/2023,AZE,Perlis,0,0,0,Azerbaijan
66473,4/1/2023,AZE,Pulau Pinang,1,0,1,Azerbaijan
66474,4/1/2023,AZE,Sabah,0,0,0,Azerbaijan
66475,4/1/2023,AZE,Sarawak,4,2,2,Azerbaijan
66476,4/1/2023,AZE,Selangor,73,37,36,Azerbaijan
66477,4/1/2023,AZE,W.P. Labuan,0,0,0,Azerbaijan
66478,4/1/2023,BDI,Pulau Pinang,0,0,0,Burundi
66479,4/1/2023,BDI,Sarawak,0,0,0,Burundi
66480,4/1/2023,BDI,Selangor,5,3,2,Burundi
66481,4/1/2023,BEL,Johor,230,153,77,Belgium
66482,4/1/2023,BEL,Kedah,93,53,40,Belgium
66483,4/1/2023,BEL,Kelantan,3,2,1,Belgium
66484,4/1/2023,BEL,Melaka,0,0,0,Belgium
66485,4/1/2023,BEL,Negeri Sembilan,0,0,0,Belgium
66486,4/1/2023,BEL,Pahang,0,0,0,Belgium
66487,4/1/2023,BEL,Perak,1,1,0,Belgium
66488,4/1/2023,BEL,Perlis,10,6,4,Belgium
66489,4/1/2023,BEL,Pulau Pinang,48,39,9,Belgium
66490,4/1/2023,BEL,Sabah,16,11,5,Belgium
66491,4/1/2023,BEL,Sarawak,15,8,7,Belgium
66492,4/1/2023,BEL,Selangor,1025,597,428,Belgium
66493,4/1/2023,BEL,W.P. Labuan,0,0,0,Belgium
66494,4/1/2023,BEN,Johor,2,1,1,Benin
66495,4/1/2023,BEN,Kedah,0,0,0,Benin
66496,4/1/2023,BEN,Perak,0,0,0,Benin
66497,4/1/2023,BEN,Pulau Pinang,0,0,0,Benin
66498,4/1/2023,BEN,Sabah,0,0,0,Benin
66499,4/1/2023,BEN,Sarawak,0,0,0,Benin
66500,4/1/2023,BEN,Selangor,9,4,5,Benin
66501,4/1/2023,BFA,Perak,0,0,0,Burkina Faso
66502,4/1/2023,BFA,Pulau Pinang,0,0,0,Burkina Faso
66503,4/1/2023,BFA,Selangor,1,1,0,Burkina Faso
66504,4/1/2023,BGD,Johor,3886,3385,501,Bangladesh
66505,4/1/2023,BGD,Kedah,96,51,45,Bangladesh
66506,4/1/2023,BGD,Kelantan,0,0,0,Bangladesh
66507,4/1/2023,BGD,Melaka,0,0,0,Bangladesh
66508,4/1/2023,BGD,Negeri Sembilan,0,0,0,Bangladesh
66509,4/1/2023,BGD,Pahang,0,0,0,Bangladesh
66510,4/1/2023,BGD,Perak,3,2,1,Bangladesh
66511,4/1/2023,BGD,Perlis,5,5,0,Bangladesh
66512,4/1/2023,BGD,Pulau Pinang,260,242,18,Bangladesh
66513,4/1/2023,BGD,Sabah,2,1,1,Bangladesh
66514,4/1/2023,BGD,Sarawak,59,35,24,Bangladesh
66515,4/1/2023,BGD,Selangor,38998,37421,1577,Bangladesh
66516,4/1/2023,BGD,W.P. Labuan,2,2,0,Bangladesh
66517,4/1/2023,BGR,Johor,41,24,17,Bulgaria
66518,4/1/2023,BGR,Kedah,8,3,5,Bulgaria
66519,4/1/2023,BGR,Kelantan,0,0,0,Bulgaria
66520,4/1/2023,BGR,Pahang,0,0,0,Bulgaria
66521,4/1/2023,BGR,Perak,0,0,0,Bulgaria
66522,4/1/2023,BGR,Perlis,2,2,0,Bulgaria
66523,4/1/2023,BGR,Pulau Pinang,8,5,3,Bulgaria
66524,4/1/2023,BGR,Sabah,2,0,2,Bulgaria
66525,4/1/2023,BGR,Sarawak,4,2,2,Bulgaria
66526,4/1/2023,BGR,Selangor,269,143,126,Bulgaria
66527,4/1/2023,BGR,W.P. Labuan,0,0,0,Bulgaria
66528,4/1/2023,BHR,Johor,1,1,0,Bahrain
66529,4/1/2023,BHR,Kedah,3,1,2,Bahrain
66530,4/1/2023,BHR,Kelantan,0,0,0,Bahrain
66531,4/1/2023,BHR,Perlis,0,0,0,Bahrain
66532,4/1/2023,BHR,Pulau Pinang,1,1,0,Bahrain
66533,4/1/2023,BHR,Sabah,0,0,0,Bahrain
66534,4/1/2023,BHR,Sarawak,1,1,0,Bahrain
66535,4/1/2023,BHR,Selangor,54,34,20,Bahrain
66536,4/1/2023,BHS,Johor,0,0,0,Bahamas
66537,4/1/2023,BHS,Kedah,0,0,0,Bahamas
66538,4/1/2023,BHS,Perak,0,0,0,Bahamas
66539,4/1/2023,BHS,Sabah,0,0,0,Bahamas
66540,4/1/2023,BHS,Sarawak,0,0,0,Bahamas
66541,4/1/2023,BHS,Selangor,4,2,2,Bahamas
66542,4/1/2023,BIH,Johor,17,8,9,Bosnia and Herzegovina
66543,4/1/2023,BIH,Kedah,0,0,0,Bosnia and Herzegovina
66544,4/1/2023,BIH,Perlis,0,0,0,Bosnia and Herzegovina
66545,4/1/2023,BIH,Pulau Pinang,0,0,0,Bosnia and Herzegovina
66546,4/1/2023,BIH,Sabah,1,0,1,Bosnia and Herzegovina
66547,4/1/2023,BIH,Sarawak,1,1,0,Bosnia and Herzegovina
66548,4/1/2023,BIH,Selangor,40,24,16,Bosnia and Herzegovina
66549,4/1/2023,BLR,Johor,10,2,8,Belarus
66550,4/1/2023,BLR,Kedah,12,6,6,Belarus
66551,4/1/2023,BLR,Kelantan,8,5,3,Belarus
66552,4/1/2023,BLR,Pahang,0,0,0,Belarus
66553,4/1/2023,BLR,Perak,0,0,0,Belarus
66554,4/1/2023,BLR,Perlis,2,1,1,Belarus
66555,4/1/2023,BLR,Pulau Pinang,3,2,1,Belarus
66556,4/1/2023,BLR,Sabah,3,2,1,Belarus
66557,4/1/2023,BLR,Sarawak,3,1,2,Belarus
66558,4/1/2023,BLR,Selangor,539,265,274,Belarus
66559,4/1/2023,BLR,W.P. Labuan,0,0,0,Belarus
66560,4/1/2023,BLZ,Johor,2,0,2,Belize
66561,4/1/2023,BLZ,Pulau Pinang,1,1,0,Belize
66562,4/1/2023,BLZ,Sarawak,0,0,0,Belize
66563,4/1/2023,BLZ,Selangor,9,6,3,Belize
66564,4/1/2023,BMU,Selangor,0,0,0,Bermuda
66565,4/1/2023,BOL,Johor,2,1,1,Bolivia
66566,4/1/2023,BOL,Kedah,1,0,1,Bolivia
66567,4/1/2023,BOL,Melaka,0,0,0,Bolivia
66568,4/1/2023,BOL,Perak,0,0,0,Bolivia
66569,4/1/2023,BOL,Perlis,0,0,0,Bolivia
66570,4/1/2023,BOL,Pulau Pinang,2,1,1,Bolivia
66571,4/1/2023,BOL,Sabah,0,0,0,Bolivia
66572,4/1/2023,BOL,Sarawak,2,1,1,Bolivia
66573,4/1/2023,BOL,Selangor,21,14,7,Bolivia
66574,4/1/2023,BRA,Johor,255,139,116,Brazil
66575,4/1/2023,BRA,Kedah,88,41,47,Brazil
66576,4/1/2023,BRA,Kelantan,1,1,0,Brazil
66577,4/1/2023,BRA,Melaka,0,0,0,Brazil
66578,4/1/2023,BRA,Pahang,0,0,0,Brazil
66579,4/1/2023,BRA,Perak,14,9,5,Brazil
66580,4/1/2023,BRA,Perlis,15,7,8,Brazil
66581,4/1/2023,BRA,Pulau Pinang,31,19,12,Brazil
66582,4/1/2023,BRA,Sabah,17,8,9,Brazil
66583,4/1/2023,BRA,Sarawak,20,13,7,Brazil
66584,4/1/2023,BRA,Selangor,868,469,399,Brazil
66585,4/1/2023,BRA,W.P. Labuan,0,0,0,Brazil
66586,4/1/2023,BRB,Johor,3,1,2,Barbados
66587,4/1/2023,BRB,Kedah,0,0,0,Barbados
66588,4/1/2023,BRB,Perlis,0,0,0,Barbados
66589,4/1/2023,BRB,Pulau Pinang,0,0,0,Barbados
66590,4/1/2023,BRB,Selangor,6,4,2,Barbados
66591,4/1/2023,BRN,Johor,557,312,245,Brunei Darussalam
66592,4/1/2023,BRN,Kedah,13,1,12,Brunei Darussalam
66593,4/1/2023,BRN,Kelantan,12,5,7,Brunei Darussalam
66594,4/1/2023,BRN,Melaka,6,3,3,Brunei Darussalam
66595,4/1/2023,BRN,Pahang,0,0,0,Brunei Darussalam
66596,4/1/2023,BRN,Perak,3,2,1,Brunei Darussalam
66597,4/1/2023,BRN,Perlis,7,4,3,Brunei Darussalam
66598,4/1/2023,BRN,Pulau Pinang,23,10,13,Brunei Darussalam
66599,4/1/2023,BRN,Sabah,1135,505,630,Brunei Darussalam
66600,4/1/2023,BRN,Sarawak,114421,61107,53314,Brunei Darussalam
66601,4/1/2023,BRN,Selangor,5228,2439,2789,Brunei Darussalam
66602,4/1/2023,BRN,W.P. Labuan,1526,872,654,Brunei Darussalam
66603,4/1/2023,BTN,Johor,10,4,6,Bhutan
66604,4/1/2023,BTN,Kedah,2,2,0,Bhutan
66605,4/1/2023,BTN,Perak,0,0,0,Bhutan
66606,4/1/2023,BTN,Perlis,0,0,0,Bhutan
66607,4/1/2023,BTN,Pulau Pinang,0,0,0,Bhutan
66608,4/1/2023,BTN,Sabah,1,1,0,Bhutan
66609,4/1/2023,BTN,Sarawak,0,0,0,Bhutan
66610,4/1/2023,BTN,Selangor,12,7,5,Bhutan
66611,4/1/2023,BWA,Johor,6,3,3,Botswana
66612,4/1/2023,BWA,Kedah,0,0,0,Botswana
66613,4/1/2023,BWA,Perlis,0,0,0,Botswana
66614,4/1/2023,BWA,Pulau Pinang,0,0,0,Botswana
66615,4/1/2023,BWA,Sabah,0,0,0,Botswana
66616,4/1/2023,BWA,Sarawak,0,0,0,Botswana
66617,4/1/2023,BWA,Selangor,9,3,6,Botswana
66618,4/1/2023,CAF,Kedah,0,0,0,Central African Republic
66619,4/1/2023,CAF,Selangor,0,0,0,Central African Republic
66620,4/1/2023,CAN,Johor,1274,707,567,Canada
66621,4/1/2023,CAN,Kedah,214,118,96,Canada
66622,4/1/2023,CAN,Kelantan,5,4,1,Canada
66623,4/1/2023,CAN,Melaka,0,0,0,Canada
66624,4/1/2023,CAN,Negeri Sembilan,0,0,0,Canada
66625,4/1/2023,CAN,Pahang,5,2,3,Canada
66626,4/1/2023,CAN,Perak,50,27,23,Canada
66627,4/1/2023,CAN,Perlis,47,29,18,Canada
66628,4/1/2023,CAN,Pulau Pinang,545,296,249,Canada
66629,4/1/2023,CAN,Sabah,207,109,98,Canada
66630,4/1/2023,CAN,Sarawak,480,255,225,Canada
66631,4/1/2023,CAN,Selangor,3835,2125,1710,Canada
66632,4/1/2023,CAN,Terengganu,0,0,0,Canada
66633,4/1/2023,CAN,W.P. Labuan,5,5,0,Canada
66634,4/1/2023,CCK,Selangor,0,0,0,Cocos (Keeling) Islands
66635,4/1/2023,CHE,Johor,420,266,154,Switzerland
66636,4/1/2023,CHE,Kedah,206,106,100,Switzerland
66637,4/1/2023,CHE,Kelantan,2,2,0,Switzerland
66638,4/1/2023,CHE,Melaka,3,1,2,Switzerland
66639,4/1/2023,CHE,Negeri Sembilan,0,0,0,Switzerland
66640,4/1/2023,CHE,Pahang,8,5,3,Switzerland
66641,4/1/2023,CHE,Perak,3,2,1,Switzerland
66642,4/1/2023,CHE,Perlis,35,17,18,Switzerland
66643,4/1/2023,CHE,Pulau Pinang,117,68,49,Switzerland
66644,4/1/2023,CHE,Sabah,61,35,26,Switzerland
66645,4/1/2023,CHE,Sarawak,65,30,35,Switzerland
66646,4/1/2023,CHE,Selangor,1290,765,525,Switzerland
66647,4/1/2023,CHE,W.P. Labuan,0,0,0,Switzerland
66648,4/1/2023,CHL,Johor,21,10,11,Chile
66649,4/1/2023,CHL,Kedah,17,8,9,Chile
66650,4/1/2023,CHL,Kelantan,0,0,0,Chile
66651,4/1/2023,CHL,Melaka,0,0,0,Chile
66652,4/1/2023,CHL,Pahang,4,1,3,Chile
66653,4/1/2023,CHL,Perak,0,0,0,Chile
66654,4/1/2023,CHL,Perlis,3,1,2,Chile
66655,4/1/2023,CHL,Pulau Pinang,9,5,4,Chile
66656,4/1/2023,CHL,Sabah,5,2,3,Chile
66657,4/1/2023,CHL,Sarawak,2,2,0,Chile
66658,4/1/2023,CHL,Selangor,192,94,98,Chile
66659,4/1/2023,CHN,Johor,36651,16061,20590,China
66660,4/1/2023,CHN,Kedah,977,411,566,China
66661,4/1/2023,CHN,Kelantan,5,1,4,China
66662,4/1/2023,CHN,Melaka,0,0,0,China
66663,4/1/2023,CHN,Pahang,31,13,18,China
66664,4/1/2023,CHN,Perak,254,121,133,China
66665,4/1/2023,CHN,Perlis,95,36,59,China
66666,4/1/2023,CHN,Pulau Pinang,6448,3336,3112,China
66667,4/1/2023,CHN,Sabah,8519,4159,4360,China
66668,4/1/2023,CHN,Sarawak,905,435,470,China
66669,4/1/2023,CHN,Selangor,70631,36720,33911,China
66670,4/1/2023,CHN,Terengganu,0,0,0,China
66671,4/1/2023,CHN,W.P. Labuan,67,65,2,China
66672,4/1/2023,CIV,Johor,0,0,0,C��te d'Iv
66673,4/1/2023,CIV,Kedah,0,0,0,C��te d'Iv
66674,4/1/2023,CIV,Pulau Pinang,2,0,2,C��te d'Iv
66675,4/1/2023,CIV,Sabah,0,0,0,C��te d'Iv
66676,4/1/2023,CIV,Sarawak,0,0,0,C��te d'Iv
66677,4/1/2023,CIV,Selangor,10,6,4,C��te d'Iv
66678,4/1/2023,CMR,Johor,0,0,0,Cameroon
66679,4/1/2023,CMR,Kedah,0,0,0,Cameroon
66680,4/1/2023,CMR,Pulau Pinang,2,2,0,Cameroon
66681,4/1/2023,CMR,Sabah,1,1,0,Cameroon
66682,4/1/2023,CMR,Sarawak,0,0,0,Cameroon
66683,4/1/2023,CMR,Selangor,16,13,3,Cameroon
66684,4/1/2023,COD,Johor,2,2,0,"Congo, the Democratic Republic of the"
66685,4/1/2023,COD,Pulau Pinang,0,0,0,"Congo, the Democratic Republic of the"
66686,4/1/2023,COD,Sarawak,0,0,0,"Congo, the Democratic Republic of the"
66687,4/1/2023,COD,Selangor,6,5,1,"Congo, the Democratic Republic of the"
66688,4/1/2023,COG,Johor,0,0,0,Congo
66689,4/1/2023,COG,Kedah,0,0,0,Congo
66690,4/1/2023,COG,Selangor,0,0,0,Congo
66691,4/1/2023,COK,Selangor,0,0,0,Cook Islands
66692,4/1/2023,COL,Johor,36,15,21,Colombia
66693,4/1/2023,COL,Kedah,4,1,3,Colombia
66694,4/1/2023,COL,Perak,0,0,0,Colombia
66695,4/1/2023,COL,Pulau Pinang,2,2,0,Colombia
66696,4/1/2023,COL,Sabah,2,1,1,Colombia
66697,4/1/2023,COL,Sarawak,5,3,2,Colombia
66698,4/1/2023,COL,Selangor,155,78,77,Colombia
66699,4/1/2023,COL,W.P. Labuan,0,0,0,Colombia
66700,4/1/2023,COM,Johor,0,0,0,Comoros
66701,4/1/2023,COM,Kedah,0,0,0,Comoros
66702,4/1/2023,COM,Selangor,6,4,2,Comoros
66703,4/1/2023,CPV,Johor,0,0,0,Cape Verde
66704,4/1/2023,CPV,Kedah,0,0,0,Cape Verde
66705,4/1/2023,CPV,Pulau Pinang,0,0,0,Cape Verde
66706,4/1/2023,CPV,Sabah,0,0,0,Cape Verde
66707,4/1/2023,CPV,Selangor,0,0,0,Cape Verde
66708,4/1/2023,CRI,Johor,10,7,3,Costa Rica
66709,4/1/2023,CRI,Kedah,0,0,0,Costa Rica
66710,4/1/2023,CRI,Perak,0,0,0,Costa Rica
66711,4/1/2023,CRI,Perlis,0,0,0,Costa Rica
66712,4/1/2023,CRI,Pulau Pinang,4,3,1,Costa Rica
66713,4/1/2023,CRI,Sabah,0,0,0,Costa Rica
66714,4/1/2023,CRI,Sarawak,0,0,0,Costa Rica
66715,4/1/2023,CRI,Selangor,82,42,40,Costa Rica
66716,4/1/2023,CUB,Johor,8,3,5,Cuba
66717,4/1/2023,CUB,Kedah,0,0,0,Cuba
66718,4/1/2023,CUB,Perlis,0,0,0,Cuba
66719,4/1/2023,CUB,Pulau Pinang,1,1,0,Cuba
66720,4/1/2023,CUB,Sabah,1,1,0,Cuba
66721,4/1/2023,CUB,Sarawak,0,0,0,Cuba
66722,4/1/2023,CUB,Selangor,19,13,6,Cuba
66723,4/1/2023,CYP,Johor,15,9,6,Cyprus
66724,4/1/2023,CYP,Kedah,2,1,1,Cyprus
66725,4/1/2023,CYP,Perak,0,0,0,Cyprus
66726,4/1/2023,CYP,Perlis,0,0,0,Cyprus
66727,4/1/2023,CYP,Pulau Pinang,2,2,0,Cyprus
66728,4/1/2023,CYP,Sabah,0,0,0,Cyprus
66729,4/1/2023,CYP,Sarawak,1,1,0,Cyprus
66730,4/1/2023,CYP,Selangor,53,34,19,Cyprus
66731,4/1/2023,CZE,Johor,89,55,34,Czech Republic
66732,4/1/2023,CZE,Kedah,60,29,31,Czech Republic
66733,4/1/2023,CZE,Kelantan,7,3,4,Czech Republic
66734,4/1/2023,CZE,Melaka,0,0,0,Czech Republic
66735,4/1/2023,CZE,Negeri Sembilan,0,0,0,Czech Republic
66736,4/1/2023,CZE,Perak,2,2,0,Czech Republic
66737,4/1/2023,CZE,Perlis,3,3,0,Czech Republic
66738,4/1/2023,CZE,Pulau Pinang,19,11,8,Czech Republic
66739,4/1/2023,CZE,Sabah,30,21,9,Czech Republic
66740,4/1/2023,CZE,Sarawak,12,5,7,Czech Republic
66741,4/1/2023,CZE,Selangor,546,326,220,Czech Republic
66742,4/1/2023,CZE,W.P. Labuan,4,2,2,Czech Republic
66743,4/1/2023,DEU,Johor,2235,1329,906,Germany
66744,4/1/2023,DEU,Kedah,939,510,429,Germany
66745,4/1/2023,DEU,Kelantan,17,11,6,Germany
66746,4/1/2023,DEU,Melaka,2,2,0,Germany
66747,4/1/2023,DEU,Negeri Sembilan,0,0,0,Germany
66748,4/1/2023,DEU,Pahang,8,4,4,Germany
66749,4/1/2023,DEU,Perak,34,23,11,Germany
66750,4/1/2023,DEU,Perlis,108,64,44,Germany
66751,4/1/2023,DEU,Pulau Pinang,561,363,198,Germany
66752,4/1/2023,DEU,Sabah,185,103,82,Germany
66753,4/1/2023,DEU,Sarawak,234,145,89,Germany
66754,4/1/2023,DEU,Selangor,6427,3816,2611,Germany
66755,4/1/2023,DEU,Terengganu,0,0,0,Germany
66756,4/1/2023,DEU,W.P. Labuan,20,11,9,Germany
66757,4/1/2023,DJI,Johor,0,0,0,Djibouti
66758,4/1/2023,DJI,Selangor,5,2,3,Djibouti
66759,4/1/2023,DMA,Johor,6,5,1,Dominica
66760,4/1/2023,DMA,Kedah,0,0,0,Dominica
66761,4/1/2023,DMA,Pulau Pinang,0,0,0,Dominica
66762,4/1/2023,DMA,Sabah,0,0,0,Dominica
66763,4/1/2023,DMA,Sarawak,3,2,1,Dominica
66764,4/1/2023,DMA,Selangor,19,17,2,Dominica
66765,4/1/2023,DMA,W.P. Labuan,0,0,0,Dominica
66766,4/1/2023,DNK,Johor,321,212,109,Denmark
66767,4/1/2023,DNK,Kedah,154,81,73,Denmark
66768,4/1/2023,DNK,Kelantan,1,1,0,Denmark
66769,4/1/2023,DNK,Melaka,0,0,0,Denmark
66770,4/1/2023,DNK,Negeri Sembilan,0,0,0,Denmark
66771,4/1/2023,DNK,Pahang,5,3,2,Denmark
66772,4/1/2023,DNK,Perak,1,0,1,Denmark
66773,4/1/2023,DNK,Perlis,11,4,7,Denmark
66774,4/1/2023,DNK,Pulau Pinang,49,32,17,Denmark
66775,4/1/2023,DNK,Sabah,36,18,18,Denmark
66776,4/1/2023,DNK,Sarawak,17,10,7,Denmark
66777,4/1/2023,DNK,Selangor,1026,593,433,Denmark
66778,4/1/2023,DNK,W.P. Labuan,0,0,0,Denmark
66779,4/1/2023,DOM,Johor,3,3,0,Dominican Republic
66780,4/1/2023,DOM,Kedah,0,0,0,Dominican Republic
66781,4/1/2023,DOM,Perak,0,0,0,Dominican Republic
66782,4/1/2023,DOM,Perlis,0,0,0,Dominican Republic
66783,4/1/2023,DOM,Pulau Pinang,3,0,3,Dominican Republic
66784,4/1/2023,DOM,Sabah,3,1,2,Dominican Republic
66785,4/1/2023,DOM,Sarawak,0,0,0,Dominican Republic
66786,4/1/2023,DOM,Selangor,28,15,13,Dominican Republic
66787,4/1/2023,DZA,Johor,16,15,1,Algeria
66788,4/1/2023,DZA,Kedah,1,1,0,Algeria
66789,4/1/2023,DZA,Kelantan,0,0,0,Algeria
66790,4/1/2023,DZA,Melaka,0,0,0,Algeria
66791,4/1/2023,DZA,Perak,0,0,0,Algeria
66792,4/1/2023,DZA,Perlis,1,1,0,Algeria
66793,4/1/2023,DZA,Pulau Pinang,0,0,0,Algeria
66794,4/1/2023,DZA,Sabah,0,0,0,Algeria
66795,4/1/2023,DZA,Sarawak,1,1,0,Algeria
66796,4/1/2023,DZA,Selangor,270,187,83,Algeria
66797,4/1/2023,DZA,W.P. Labuan,0,0,0,Algeria
66798,4/1/2023,ECU,Johor,16,8,8,Ecuador
66799,4/1/2023,ECU,Kedah,1,0,1,Ecuador
66800,4/1/2023,ECU,Perak,0,0,0,Ecuador
66801,4/1/2023,ECU,Perlis,2,1,1,Ecuador
66802,4/1/2023,ECU,Pulau Pinang,5,1,4,Ecuador
66803,4/1/2023,ECU,Sabah,2,1,1,Ecuador
66804,4/1/2023,ECU,Sarawak,0,0,0,Ecuador
66805,4/1/2023,ECU,Selangor,68,39,29,Ecuador
66806,4/1/2023,EGY,Johor,199,159,40,Egypt
66807,4/1/2023,EGY,Kedah,3,3,0,Egypt
66808,4/1/2023,EGY,Kelantan,1,1,0,Egypt
66809,4/1/2023,EGY,Melaka,0,0,0,Egypt
66810,4/1/2023,EGY,Pahang,1,1,0,Egypt
66811,4/1/2023,EGY,Perak,0,0,0,Egypt
66812,4/1/2023,EGY,Perlis,0,0,0,Egypt
66813,4/1/2023,EGY,Pulau Pinang,10,8,2,Egypt
66814,4/1/2023,EGY,Sabah,3,3,0,Egypt
66815,4/1/2023,EGY,Sarawak,149,106,43,Egypt
66816,4/1/2023,EGY,Selangor,1297,902,395,Egypt
66817,4/1/2023,EGY,Terengganu,0,0,0,Egypt
66818,4/1/2023,EGY,W.P. Labuan,2,1,1,Egypt
66819,4/1/2023,ERI,Johor,1,0,1,Eritrea
66820,4/1/2023,ERI,Pulau Pinang,0,0,0,Eritrea
66821,4/1/2023,ERI,Sabah,0,0,0,Eritrea
66822,4/1/2023,ERI,Selangor,17,7,10,Eritrea
66823,4/1/2023,ESP,Johor,511,312,199,Spain
66824,4/1/2023,ESP,Kedah,209,109,100,Spain
66825,4/1/2023,ESP,Kelantan,5,4,1,Spain
66826,4/1/2023,ESP,Melaka,0,0,0,Spain
66827,4/1/2023,ESP,Negeri Sembilan,0,0,0,Spain
66828,4/1/2023,ESP,Pahang,4,2,2,Spain
66829,4/1/2023,ESP,Perak,7,3,4,Spain
66830,4/1/2023,ESP,Perlis,28,13,15,Spain
66831,4/1/2023,ESP,Pulau Pinang,85,48,37,Spain
66832,4/1/2023,ESP,Sabah,46,28,18,Spain
66833,4/1/2023,ESP,Sarawak,41,27,14,Spain
66834,4/1/2023,ESP,Selangor,2144,1163,981,Spain
66835,4/1/2023,ESP,W.P. Labuan,2,1,1,Spain
66836,4/1/2023,EST,Johor,18,12,6,Estonia
66837,4/1/2023,EST,Kedah,23,13,10,Estonia
66838,4/1/2023,EST,Kelantan,0,0,0,Estonia
66839,4/1/2023,EST,Pahang,0,0,0,Estonia
66840,4/1/2023,EST,Perak,0,0,0,Estonia
66841,4/1/2023,EST,Perlis,6,2,4,Estonia
66842,4/1/2023,EST,Pulau Pinang,6,4,2,Estonia
66843,4/1/2023,EST,Sabah,1,1,0,Estonia
66844,4/1/2023,EST,Sarawak,6,5,1,Estonia
66845,4/1/2023,EST,Selangor,156,93,63,Estonia
66846,4/1/2023,EST,W.P. Labuan,0,0,0,Estonia
66847,4/1/2023,ETH,Johor,1,1,0,Ethiopia
66848,4/1/2023,ETH,Kedah,0,0,0,Ethiopia
66849,4/1/2023,ETH,Pulau Pinang,1,0,1,Ethiopia
66850,4/1/2023,ETH,Sarawak,0,0,0,Ethiopia
66851,4/1/2023,ETH,Selangor,19,13,6,Ethiopia
66852,4/1/2023,FIN,Johor,145,98,47,Finland
66853,4/1/2023,FIN,Kedah,97,49,48,Finland
66854,4/1/2023,FIN,Kelantan,0,0,0,Finland
66855,4/1/2023,FIN,Melaka,0,0,0,Finland
66856,4/1/2023,FIN,Negeri Sembilan,0,0,0,Finland
66857,4/1/2023,FIN,Pahang,0,0,0,Finland
66858,4/1/2023,FIN,Perak,1,1,0,Finland
66859,4/1/2023,FIN,Perlis,5,3,2,Finland
66860,4/1/2023,FIN,Pulau Pinang,27,19,8,Finland
66861,4/1/2023,FIN,Sabah,16,8,8,Finland
66862,4/1/2023,FIN,Sarawak,19,9,10,Finland
66863,4/1/2023,FIN,Selangor,503,267,236,Finland
66864,4/1/2023,FIN,W.P. Labuan,0,0,0,Finland
66865,4/1/2023,FJI,Johor,66,42,24,Fiji
66866,4/1/2023,FJI,Kedah,2,0,2,Fiji
66867,4/1/2023,FJI,Kelantan,0,0,0,Fiji
66868,4/1/2023,FJI,Perak,0,0,0,Fiji
66869,4/1/2023,FJI,Perlis,1,1,0,Fiji
66870,4/1/2023,FJI,Pulau Pinang,3,2,1,Fiji
66871,4/1/2023,FJI,Sabah,3,2,1,Fiji
66872,4/1/2023,FJI,Sarawak,1,0,1,Fiji
66873,4/1/2023,FJI,Selangor,101,49,52,Fiji
66874,4/1/2023,FRA,Johor,2284,1332,952,France
66875,4/1/2023,FRA,Kedah,658,344,314,France
66876,4/1/2023,FRA,Kelantan,26,21,5,France
66877,4/1/2023,FRA,Melaka,1,0,1,France
66878,4/1/2023,FRA,Negeri Sembilan,3,2,1,France
66879,4/1/2023,FRA,Pahang,27,15,12,France
66880,4/1/2023,FRA,Perak,30,19,11,France
66881,4/1/2023,FRA,Perlis,71,50,21,France
66882,4/1/2023,FRA,Pulau Pinang,439,267,172,France
66883,4/1/2023,FRA,Sabah,217,125,92,France
66884,4/1/2023,FRA,Sarawak,207,121,86,France
66885,4/1/2023,FRA,Selangor,6536,3816,2720,France
66886,4/1/2023,FRA,Terengganu,0,0,0,France
66887,4/1/2023,FRA,W.P. Labuan,2,1,1,France
66888,4/1/2023,FSM,Johor,0,0,0,"Micronesia, Federated States of"
66889,4/1/2023,FSM,Pulau Pinang,0,0,0,"Micronesia, Federated States of"
66890,4/1/2023,FSM,Selangor,0,0,0,"Micronesia, Federated States of"
66891,4/1/2023,GAB,Johor,1,1,0,Gabon
66892,4/1/2023,GAB,Pulau Pinang,0,0,0,Gabon
66893,4/1/2023,GAB,Sarawak,0,0,0,Gabon
66894,4/1/2023,GAB,Selangor,3,3,0,Gabon
66895,4/1/2023,GBR,Johor,4886,2955,1931,United Kingdom
66896,4/1/2023,GBR,Kedah,1785,899,886,United Kingdom
66897,4/1/2023,GBR,Kelantan,10,8,2,United Kingdom
66898,4/1/2023,GBR,Melaka,1,0,1,United Kingdom
66899,4/1/2023,GBR,Negeri Sembilan,0,0,0,United Kingdom
66900,4/1/2023,GBR,Pahang,34,18,16,United Kingdom
66901,4/1/2023,GBR,Perak,115,64,51,United Kingdom
66902,4/1/2023,GBR,Perlis,187,106,81,United Kingdom
66903,4/1/2023,GBR,Pulau Pinang,1598,889,709,United Kingdom
66904,4/1/2023,GBR,Sabah,965,512,453,United Kingdom
66905,4/1/2023,GBR,Sarawak,1562,947,615,United Kingdom
66906,4/1/2023,GBR,Selangor,17137,9882,7255,United Kingdom
66907,4/1/2023,GBR,Terengganu,0,0,0,United Kingdom
66908,4/1/2023,GBR,W.P. Labuan,87,66,21,United Kingdom
66909,4/1/2023,GEO,Johor,6,5,1,Georgia
66910,4/1/2023,GEO,Kedah,8,5,3,Georgia
66911,4/1/2023,GEO,Melaka,0,0,0,Georgia
66912,4/1/2023,GEO,Perak,0,0,0,Georgia
66913,4/1/2023,GEO,Perlis,0,0,0,Georgia
66914,4/1/2023,GEO,Pulau Pinang,1,0,1,Georgia
66915,4/1/2023,GEO,Sabah,0,0,0,Georgia
66916,4/1/2023,GEO,Sarawak,0,0,0,Georgia
66917,4/1/2023,GEO,Selangor,51,27,24,Georgia
66918,4/1/2023,GHA,Johor,10,7,3,Ghana
66919,4/1/2023,GHA,Kedah,3,3,0,Ghana
66920,4/1/2023,GHA,Kelantan,0,0,0,Ghana
66921,4/1/2023,GHA,Pulau Pinang,0,0,0,Ghana
66922,4/1/2023,GHA,Sabah,1,0,1,Ghana
66923,4/1/2023,GHA,Sarawak,0,0,0,Ghana
66924,4/1/2023,GHA,Selangor,37,24,13,Ghana
66925,4/1/2023,GIB,Johor,0,0,0,Gibraltar
66926,4/1/2023,GIB,Sarawak,0,0,0,Gibraltar
66927,4/1/2023,GIN,Johor,0,0,0,Guinea
66928,4/1/2023,GIN,Kedah,1,1,0,Guinea
66929,4/1/2023,GIN,Kelantan,0,0,0,Guinea
66930,4/1/2023,GIN,Perlis,1,1,0,Guinea
66931,4/1/2023,GIN,Pulau Pinang,0,0,0,Guinea
66932,4/1/2023,GIN,Sabah,0,0,0,Guinea
66933,4/1/2023,GIN,Sarawak,0,0,0,Guinea
66934,4/1/2023,GIN,Selangor,31,26,5,Guinea
66935,4/1/2023,GLP,Selangor,0,0,0,Guadeloupe
66936,4/1/2023,GMB,Johor,1,1,0,Gambia
66937,4/1/2023,GMB,Kedah,0,0,0,Gambia
66938,4/1/2023,GMB,Kelantan,0,0,0,Gambia
66939,4/1/2023,GMB,Pulau Pinang,0,0,0,Gambia
66940,4/1/2023,GMB,Sabah,0,0,0,Gambia
66941,4/1/2023,GMB,Sarawak,1,1,0,Gambia
66942,4/1/2023,GMB,Selangor,14,11,3,Gambia
66943,4/1/2023,GNB,Johor,0,0,0,Guinea-Bissau
66944,4/1/2023,GNB,Selangor,1,1,0,Guinea-Bissau
66945,4/1/2023,GNQ,Johor,0,0,0,Equatorial Guinea
66946,4/1/2023,GNQ,Selangor,2,0,2,Equatorial Guinea
66947,4/1/2023,GRC,Johor,52,41,11,Greece
66948,4/1/2023,GRC,Kedah,17,8,9,Greece
66949,4/1/2023,GRC,Kelantan,2,2,0,Greece
66950,4/1/2023,GRC,Melaka,0,0,0,Greece
66951,4/1/2023,GRC,Negeri Sembilan,0,0,0,Greece
66952,4/1/2023,GRC,Pahang,0,0,0,Greece
66953,4/1/2023,GRC,Perak,0,0,0,Greece
66954,4/1/2023,GRC,Perlis,3,3,0,Greece
66955,4/1/2023,GRC,Pulau Pinang,6,3,3,Greece
66956,4/1/2023,GRC,Sabah,8,5,3,Greece
66957,4/1/2023,GRC,Sarawak,16,6,10,Greece
66958,4/1/2023,GRC,Selangor,218,146,72,Greece
66959,4/1/2023,GRD,Johor,5,1,4,Grenada
66960,4/1/2023,GRD,Kedah,0,0,0,Grenada
66961,4/1/2023,GRD,Pulau Pinang,0,0,0,Grenada
66962,4/1/2023,GRD,Sabah,0,0,0,Grenada
66963,4/1/2023,GRD,Sarawak,0,0,0,Grenada
66964,4/1/2023,GRD,Selangor,11,10,1,Grenada
66965,4/1/2023,GRL,Johor,0,0,0,Greenland
66966,4/1/2023,GRL,Selangor,0,0,0,Greenland
66967,4/1/2023,GTM,Johor,3,2,1,Guatemala
66968,4/1/2023,GTM,Kedah,0,0,0,Guatemala
66969,4/1/2023,GTM,Pahang,0,0,0,Guatemala
66970,4/1/2023,GTM,Perak,0,0,0,Guatemala
66971,4/1/2023,GTM,Pulau Pinang,0,0,0,Guatemala
66972,4/1/2023,GTM,Sabah,0,0,0,Guatemala
66973,4/1/2023,GTM,Sarawak,0,0,0,Guatemala
66974,4/1/2023,GTM,Selangor,72,35,37,Guatemala
66975,4/1/2023,GTM,W.P. Labuan,0,0,0,Guatemala
66976,4/1/2023,GUY,Johor,0,0,0,Guyana
66977,4/1/2023,GUY,Kedah,0,0,0,Guyana
66978,4/1/2023,GUY,Pulau Pinang,0,0,0,Guyana
66979,4/1/2023,GUY,Sarawak,0,0,0,Guyana
66980,4/1/2023,GUY,Selangor,3,3,0,Guyana
66981,4/1/2023,HKG,Johor,4,2,2,Hong Kong
66982,4/1/2023,HKG,Kedah,0,0,0,Hong Kong
66983,4/1/2023,HKG,Kelantan,0,0,0,Hong Kong
66984,4/1/2023,HKG,Pahang,8,4,4,Hong Kong
66985,4/1/2023,HKG,Perak,67,24,43,Hong Kong
66986,4/1/2023,HKG,Perlis,8,6,2,Hong Kong
66987,4/1/2023,HKG,Pulau Pinang,1,0,1,Hong Kong
66988,4/1/2023,HKG,Sabah,42,15,27,Hong Kong
66989,4/1/2023,HKG,Sarawak,0,0,0,Hong Kong
66990,4/1/2023,HKG,Selangor,6,2,4,Hong Kong
66991,4/1/2023,HKG,Terengganu,0,0,0,Hong Kong
66992,4/1/2023,HMD,Johor,0,0,0,Heard Island and McDonald Islands
66993,4/1/2023,HND,Johor,2,1,1,Honduras
66994,4/1/2023,HND,Kedah,0,0,0,Honduras
66995,4/1/2023,HND,Perak,0,0,0,Honduras
66996,4/1/2023,HND,Pulau Pinang,0,0,0,Honduras
66997,4/1/2023,HND,Sabah,0,0,0,Honduras
66998,4/1/2023,HND,Sarawak,0,0,0,Honduras
66999,4/1/2023,HND,Selangor,22,11,11,Honduras
67000,4/1/2023,HRV,Johor,39,32,7,Croatia
67001,4/1/2023,HRV,Kedah,8,4,4,Croatia
67002,4/1/2023,HRV,Kelantan,0,0,0,Croatia
67003,4/1/2023,HRV,Melaka,0,0,0,Croatia
67004,4/1/2023,HRV,Pahang,0,0,0,Croatia
67005,4/1/2023,HRV,Perak,0,0,0,Croatia
67006,4/1/2023,HRV,Perlis,0,0,0,Croatia
67007,4/1/2023,HRV,Pulau Pinang,3,1,2,Croatia
67008,4/1/2023,HRV,Sabah,3,2,1,Croatia
67009,4/1/2023,HRV,Sarawak,5,5,0,Croatia
67010,4/1/2023,HRV,Selangor,138,83,55,Croatia
67011,4/1/2023,HTI,Johor,0,0,0,Haiti
67012,4/1/2023,HTI,Kedah,0,0,0,Haiti
67013,4/1/2023,HTI,Kelantan,0,0,0,Haiti
67014,4/1/2023,HTI,Perak,0,0,0,Haiti
67015,4/1/2023,HTI,Pulau Pinang,0,0,0,Haiti
67016,4/1/2023,HTI,Sabah,1,1,0,Haiti
67017,4/1/2023,HTI,Selangor,3,2,1,Haiti
67018,4/1/2023,HUN,Johor,64,31,33,Hungary
67019,4/1/2023,HUN,Kedah,26,12,14,Hungary
67020,4/1/2023,HUN,Kelantan,0,0,0,Hungary
67021,4/1/2023,HUN,Pahang,0,0,0,Hungary
67022,4/1/2023,HUN,Perak,2,2,0,Hungary
67023,4/1/2023,HUN,Perlis,6,2,4,Hungary
67024,4/1/2023,HUN,Pulau Pinang,31,20,11,Hungary
67025,4/1/2023,HUN,Sabah,12,6,6,Hungary
67026,4/1/2023,HUN,Sarawak,12,4,8,Hungary
67027,4/1/2023,HUN,Selangor,544,273,271,Hungary
67028,4/1/2023,HUN,W.P. Labuan,0,0,0,Hungary
67029,4/1/2023,IDN,Johor,85436,37705,47731,Indonesia
67030,4/1/2023,IDN,Kedah,4430,1644,2786,Indonesia
67031,4/1/2023,IDN,Kelantan,139,83,56,Indonesia
67032,4/1/2023,IDN,Melaka,5572,2515,3057,Indonesia
67033,4/1/2023,IDN,Negeri Sembilan,4328,2164,2164,Indonesia
67034,4/1/2023,IDN,Pahang,51,32,19,Indonesia
67035,4/1/2023,IDN,Perak,195,63,132,Indonesia
67036,4/1/2023,IDN,Perlis,563,226,337,Indonesia
67037,4/1/2023,IDN,Pulau Pinang,36741,14511,22230,Indonesia
67038,4/1/2023,IDN,Sabah,4607,2266,2341,Indonesia
67039,4/1/2023,IDN,Sarawak,42173,20538,21635,Indonesia
67040,4/1/2023,IDN,Selangor,108182,50214,57968,Indonesia
67041,4/1/2023,IDN,Terengganu,0,0,0,Indonesia
67042,4/1/2023,IDN,W.P. Labuan,82,40,42,Indonesia
67043,4/1/2023,IND,Johor,22714,15187,7527,India
67044,4/1/2023,IND,Kedah,1466,761,705,India
67045,4/1/2023,IND,Kelantan,5,5,0,India
67046,4/1/2023,IND,Melaka,1,1,0,India
67047,4/1/2023,IND,Negeri Sembilan,0,0,0,India
67048,4/1/2023,IND,Pahang,12,10,2,India
67049,4/1/2023,IND,Perak,525,426,99,India
67050,4/1/2023,IND,Perlis,67,54,13,India
67051,4/1/2023,IND,Pulau Pinang,991,645,346,India
67052,4/1/2023,IND,Sabah,329,198,131,India
67053,4/1/2023,IND,Sarawak,1630,1175,455,India
67054,4/1/2023,IND,Selangor,45077,31100,13977,India
67055,4/1/2023,IND,Terengganu,0,0,0,India
67056,4/1/2023,IND,W.P. Labuan,160,117,43,India
67057,4/1/2023,IOT,Pulau Pinang,0,0,0,British Indian Ocean Territory
67058,4/1/2023,IOT,Selangor,0,0,0,British Indian Ocean Territory
67059,4/1/2023,IRL,Johor,312,195,117,Ireland
67060,4/1/2023,IRL,Kedah,112,61,51,Ireland
67061,4/1/2023,IRL,Kelantan,0,0,0,Ireland
67062,4/1/2023,IRL,Negeri Sembilan,0,0,0,Ireland
67063,4/1/2023,IRL,Pahang,0,0,0,Ireland
67064,4/1/2023,IRL,Perak,13,6,7,Ireland
67065,4/1/2023,IRL,Perlis,10,9,1,Ireland
67066,4/1/2023,IRL,Pulau Pinang,110,63,47,Ireland
67067,4/1/2023,IRL,Sabah,41,25,16,Ireland
67068,4/1/2023,IRL,Sarawak,44,18,26,Ireland
67069,4/1/2023,IRL,Selangor,1135,648,487,Ireland
67070,4/1/2023,IRL,Terengganu,0,0,0,Ireland
67071,4/1/2023,IRL,W.P. Labuan,0,0,0,Ireland
67072,4/1/2023,IRN,Johor,251,143,108,Iran
67073,4/1/2023,IRN,Kedah,6,4,2,Iran
67074,4/1/2023,IRN,Kelantan,0,0,0,Iran
67075,4/1/2023,IRN,Perak,0,0,0,Iran
67076,4/1/2023,IRN,Perlis,5,5,0,Iran
67077,4/1/2023,IRN,Pulau Pinang,10,4,6,Iran
67078,4/1/2023,IRN,Sabah,2,0,2,Iran
67079,4/1/2023,IRN,Sarawak,9,5,4,Iran
67080,4/1/2023,IRN,Selangor,1101,599,502,Iran
67081,4/1/2023,IRN,W.P. Labuan,0,0,0,Iran
67082,4/1/2023,IRQ,Johor,27,23,4,Iraq
67083,4/1/2023,IRQ,Kedah,1,1,0,Iraq
67084,4/1/2023,IRQ,Kelantan,0,0,0,Iraq
67085,4/1/2023,IRQ,Melaka,0,0,0,Iraq
67086,4/1/2023,IRQ,Pahang,0,0,0,Iraq
67087,4/1/2023,IRQ,Perak,0,0,0,Iraq
67088,4/1/2023,IRQ,Perlis,0,0,0,Iraq
67089,4/1/2023,IRQ,Pulau Pinang,6,6,0,Iraq
67090,4/1/2023,IRQ,Sabah,0,0,0,Iraq
67091,4/1/2023,IRQ,Sarawak,4,2,2,Iraq
67092,4/1/2023,IRQ,Selangor,571,402,169,Iraq
67093,4/1/2023,ISL,Johor,4,3,1,Iceland
67094,4/1/2023,ISL,Kedah,0,0,0,Iceland
67095,4/1/2023,ISL,Kelantan,0,0,0,Iceland
67096,4/1/2023,ISL,Perak,2,1,1,Iceland
67097,4/1/2023,ISL,Perlis,1,1,0,Iceland
67098,4/1/2023,ISL,Pulau Pinang,4,4,0,Iceland
67099,4/1/2023,ISL,Sabah,13,7,6,Iceland
67100,4/1/2023,ISL,Sarawak,0,0,0,Iceland
67101,4/1/2023,ISL,Selangor,34,17,17,Iceland
67102,4/1/2023,ISL,W.P. Labuan,0,0,0,Iceland
67103,4/1/2023,ISR,Pulau Pinang,0,0,0,Israel
67104,4/1/2023,ITA,Johor,577,381,196,Italy
67105,4/1/2023,ITA,Kedah,222,136,86,Italy
67106,4/1/2023,ITA,Kelantan,3,3,0,Italy
67107,4/1/2023,ITA,Melaka,0,0,0,Italy
67108,4/1/2023,ITA,Negeri Sembilan,0,0,0,Italy
67109,4/1/2023,ITA,Pahang,0,0,0,Italy
67110,4/1/2023,ITA,Perak,2,1,1,Italy
67111,4/1/2023,ITA,Perlis,22,16,6,Italy
67112,4/1/2023,ITA,Pulau Pinang,102,72,30,Italy
67113,4/1/2023,ITA,Sabah,56,30,26,Italy
67114,4/1/2023,ITA,Sarawak,65,41,24,Italy
67115,4/1/2023,ITA,Selangor,2197,1400,797,Italy
67116,4/1/2023,ITA,W.P. Labuan,5,3,2,Italy
67117,4/1/2023,JAM,Johor,5,2,3,Jamaica
67118,4/1/2023,JAM,Kedah,0,0,0,Jamaica
67119,4/1/2023,JAM,Perak,0,0,0,Jamaica
67120,4/1/2023,JAM,Pulau Pinang,0,0,0,Jamaica
67121,4/1/2023,JAM,Sabah,0,0,0,Jamaica
67122,4/1/2023,JAM,Sarawak,0,0,0,Jamaica
67123,4/1/2023,JAM,Selangor,13,2,11,Jamaica
67124,4/1/2023,JAM,W.P. Labuan,0,0,0,Jamaica
67125,4/1/2023,JOR,Johor,17,11,6,Jordan
67126,4/1/2023,JOR,Kedah,3,1,2,Jordan
67127,4/1/2023,JOR,Kelantan,1,1,0,Jordan
67128,4/1/2023,JOR,Melaka,0,0,0,Jordan
67129,4/1/2023,JOR,Perlis,1,1,0,Jordan
67130,4/1/2023,JOR,Pulau Pinang,2,0,2,Jordan
67131,4/1/2023,JOR,Sabah,1,1,0,Jordan
67132,4/1/2023,JOR,Sarawak,5,3,2,Jordan
67133,4/1/2023,JOR,Selangor,419,272,147,Jordan
67134,4/1/2023,JOR,W.P. Labuan,0,0,0,Jordan
67135,4/1/2023,JPN,Johor,5487,3728,1759,Japan
67136,4/1/2023,JPN,Kedah,389,212,177,Japan
67137,4/1/2023,JPN,Kelantan,8,5,3,Japan
67138,4/1/2023,JPN,Melaka,2,2,0,Japan
67139,4/1/2023,JPN,Negeri Sembilan,0,0,0,Japan
67140,4/1/2023,JPN,Pahang,8,5,3,Japan
67141,4/1/2023,JPN,Perak,43,29,14,Japan
67142,4/1/2023,JPN,Perlis,60,50,10,Japan
67143,4/1/2023,JPN,Pulau Pinang,1092,711,381,Japan
67144,4/1/2023,JPN,Sabah,559,293,266,Japan
67145,4/1/2023,JPN,Sarawak,180,110,70,Japan
67146,4/1/2023,JPN,Selangor,14071,8501,5570,Japan
67147,4/1/2023,JPN,W.P. Labuan,7,5,2,Japan
67148,4/1/2023,KAZ,Johor,48,24,24,Kazakhstan
67149,4/1/2023,KAZ,Kedah,20,8,12,Kazakhstan
67150,4/1/2023,KAZ,Kelantan,3,3,0,Kazakhstan
67151,4/1/2023,KAZ,Melaka,0,0,0,Kazakhstan
67152,4/1/2023,KAZ,Perak,0,0,0,Kazakhstan
67153,4/1/2023,KAZ,Perlis,5,2,3,Kazakhstan
67154,4/1/2023,KAZ,Pulau Pinang,5,1,4,Kazakhstan
67155,4/1/2023,KAZ,Sabah,11,4,7,Kazakhstan
67156,4/1/2023,KAZ,Sarawak,3,0,3,Kazakhstan
67157,4/1/2023,KAZ,Selangor,558,229,329,Kazakhstan
67158,4/1/2023,KAZ,W.P. Labuan,0,0,0,Kazakhstan
67159,4/1/2023,KEN,Johor,55,33,22,Kenya
67160,4/1/2023,KEN,Kedah,3,1,2,Kenya
67161,4/1/2023,KEN,Kelantan,0,0,0,Kenya
67162,4/1/2023,KEN,Perak,0,0,0,Kenya
67163,4/1/2023,KEN,Perlis,0,0,0,Kenya
67164,4/1/2023,KEN,Pulau Pinang,9,6,3,Kenya
67165,4/1/2023,KEN,Sabah,1,0,1,Kenya
67166,4/1/2023,KEN,Sarawak,0,0,0,Kenya
67167,4/1/2023,KEN,Selangor,391,211,180,Kenya
67168,4/1/2023,KGZ,Johor,28,16,12,Kyrgyzstan
67169,4/1/2023,KGZ,Kedah,1,0,1,Kyrgyzstan
67170,4/1/2023,KGZ,Kelantan,3,3,0,Kyrgyzstan
67171,4/1/2023,KGZ,Perak,1,1,0,Kyrgyzstan
67172,4/1/2023,KGZ,Perlis,0,0,0,Kyrgyzstan
67173,4/1/2023,KGZ,Pulau Pinang,0,0,0,Kyrgyzstan
67174,4/1/2023,KGZ,Sabah,0,0,0,Kyrgyzstan
67175,4/1/2023,KGZ,Sarawak,1,1,0,Kyrgyzstan
67176,4/1/2023,KGZ,Selangor,136,58,78,Kyrgyzstan
67177,4/1/2023,KHM,Johor,3503,1474,2029,Cambodia
67178,4/1/2023,KHM,Kedah,231,173,58,Cambodia
67179,4/1/2023,KHM,Kelantan,462,251,211,Cambodia
67180,4/1/2023,KHM,Melaka,1,1,0,Cambodia
67181,4/1/2023,KHM,Negeri Sembilan,0,0,0,Cambodia
67182,4/1/2023,KHM,Pahang,1,0,1,Cambodia
67183,4/1/2023,KHM,Perak,13,2,11,Cambodia
67184,4/1/2023,KHM,Perlis,583,355,228,Cambodia
67185,4/1/2023,KHM,Pulau Pinang,34,18,16,Cambodia
67186,4/1/2023,KHM,Sabah,0,0,0,Cambodia
67187,4/1/2023,KHM,Sarawak,9,0,9,Cambodia
67188,4/1/2023,KHM,Selangor,5689,2517,3172,Cambodia
67189,4/1/2023,KHM,W.P. Labuan,1,0,1,Cambodia
67190,4/1/2023,KIR,Johor,0,0,0,Kiribati
67191,4/1/2023,KIR,Sabah,0,0,0,Kiribati
67192,4/1/2023,KIR,Selangor,1,1,0,Kiribati
67193,4/1/2023,KNA,Johor,41,33,8,Saint Kitts and Nevis
67194,4/1/2023,KNA,Kedah,6,4,2,Saint Kitts and Nevis
67195,4/1/2023,KNA,Perlis,0,0,0,Saint Kitts and Nevis
67196,4/1/2023,KNA,Pulau Pinang,9,7,2,Saint Kitts and Nevis
67197,4/1/2023,KNA,Sabah,3,2,1,Saint Kitts and Nevis
67198,4/1/2023,KNA,Selangor,66,47,19,Saint Kitts and Nevis
67199,4/1/2023,KNA,W.P. Labuan,0,0,0,Saint Kitts and Nevis
67200,4/1/2023,KOR,Johor,8372,4679,3693,"Korea, Republic of (South Korea)"
67201,4/1/2023,KOR,Kedah,283,148,135,"Korea, Republic of (South Korea)"
67202,4/1/2023,KOR,Kelantan,3,1,2,"Korea, Republic of (South Korea)"
67203,4/1/2023,KOR,Melaka,0,0,0,"Korea, Republic of (South Korea)"
67204,4/1/2023,KOR,Negeri Sembilan,4,3,1,"Korea, Republic of (South Korea)"
67205,4/1/2023,KOR,Pahang,7,3,4,"Korea, Republic of (South Korea)"
67206,4/1/2023,KOR,Perak,24,10,14,"Korea, Republic of (South Korea)"
67207,4/1/2023,KOR,Perlis,54,39,15,"Korea, Republic of (South Korea)"
67208,4/1/2023,KOR,Pulau Pinang,479,262,217,"Korea, Republic of (South Korea)"
67209,4/1/2023,KOR,Sabah,11789,4929,6860,"Korea, Republic of (South Korea)"
67210,4/1/2023,KOR,Sarawak,229,135,94,"Korea, Republic of (South Korea)"
67211,4/1/2023,KOR,Selangor,9420,5422,3998,"Korea, Republic of (South Korea)"
67212,4/1/2023,KOR,Terengganu,0,0,0,"Korea, Republic of (South Korea)"
67213,4/1/2023,KOR,W.P. Labuan,20,11,9,"Korea, Republic of (South Korea)"
67214,4/1/2023,KWT,Johor,13,3,10,Kuwait
67215,4/1/2023,KWT,Kedah,8,5,3,Kuwait
67216,4/1/2023,KWT,Kelantan,0,0,0,Kuwait
67217,4/1/2023,KWT,Perak,0,0,0,Kuwait
67218,4/1/2023,KWT,Perlis,0,0,0,Kuwait
67219,4/1/2023,KWT,Pulau Pinang,0,0,0,Kuwait
67220,4/1/2023,KWT,Sabah,0,0,0,Kuwait
67221,4/1/2023,KWT,Sarawak,0,0,0,Kuwait
67222,4/1/2023,KWT,Selangor,322,183,139,Kuwait
67223,4/1/2023,KWT,W.P. Labuan,0,0,0,Kuwait
67224,4/1/2023,LAO,Johor,153,48,105,Lao People's Democratic Republic
67225,4/1/2023,LAO,Kedah,987,99,888,Lao People's Democratic Republic
67226,4/1/2023,LAO,Kelantan,187,36,151,Lao People's Democratic Republic
67227,4/1/2023,LAO,Melaka,0,0,0,Lao People's Democratic Republic
67228,4/1/2023,LAO,Perak,13,2,11,Lao People's Democratic Republic
67229,4/1/2023,LAO,Perlis,274,113,161,Lao People's Democratic Republic
67230,4/1/2023,LAO,Pulau Pinang,24,6,18,Lao People's Democratic Republic
67231,4/1/2023,LAO,Sabah,0,0,0,Lao People's Democratic Republic
67232,4/1/2023,LAO,Sarawak,21,13,8,Lao People's Democratic Republic
67233,4/1/2023,LAO,Selangor,341,120,221,Lao People's Democratic Republic
67234,4/1/2023,LAO,W.P. Labuan,0,0,0,Lao People's Democratic Republic
67235,4/1/2023,LBN,Johor,17,13,4,Lebanon
67236,4/1/2023,LBN,Kedah,4,1,3,Lebanon
67237,4/1/2023,LBN,Kelantan,0,0,0,Lebanon
67238,4/1/2023,LBN,Pahang,0,0,0,Lebanon
67239,4/1/2023,LBN,Perak,0,0,0,Lebanon
67240,4/1/2023,LBN,Perlis,0,0,0,Lebanon
67241,4/1/2023,LBN,Pulau Pinang,2,1,1,Lebanon
67242,4/1/2023,LBN,Sabah,2,1,1,Lebanon
67243,4/1/2023,LBN,Sarawak,2,2,0,Lebanon
67244,4/1/2023,LBN,Selangor,235,150,85,Lebanon
67245,4/1/2023,LBN,W.P. Labuan,0,0,0,Lebanon
67246,4/1/2023,LBR,Johor,2,2,0,Liberia
67247,4/1/2023,LBR,Kedah,0,0,0,Liberia
67248,4/1/2023,LBR,Sabah,0,0,0,Liberia
67249,4/1/2023,LBR,Sarawak,0,0,0,Liberia
67250,4/1/2023,LBR,Selangor,5,3,2,Liberia
67251,4/1/2023,LBY,Johor,2,2,0,Libyan Arab Jamahiriya
67252,4/1/2023,LBY,Kedah,0,0,0,Libyan Arab Jamahiriya
67253,4/1/2023,LBY,Perlis,0,0,0,Libyan Arab Jamahiriya
67254,4/1/2023,LBY,Pulau Pinang,1,1,0,Libyan Arab Jamahiriya
67255,4/1/2023,LBY,Sabah,1,1,0,Libyan Arab Jamahiriya
67256,4/1/2023,LBY,Sarawak,9,6,3,Libyan Arab Jamahiriya
67257,4/1/2023,LBY,Selangor,126,100,26,Libyan Arab Jamahiriya
67258,4/1/2023,LCA,Johor,7,7,0,Saint Lucia
67259,4/1/2023,LCA,Kedah,0,0,0,Saint Lucia
67260,4/1/2023,LCA,Pulau Pinang,2,1,1,Saint Lucia
67261,4/1/2023,LCA,Sarawak,2,1,1,Saint Lucia
67262,4/1/2023,LCA,Selangor,11,5,6,Saint Lucia
67263,4/1/2023,LIE,Johor,3,3,0,Liechtenstein
67264,4/1/2023,LIE,Kedah,0,0,0,Liechtenstein
67265,4/1/2023,LIE,Perlis,0,0,0,Liechtenstein
67266,4/1/2023,LIE,Pulau Pinang,0,0,0,Liechtenstein
67267,4/1/2023,LIE,Sabah,0,0,0,Liechtenstein
67268,4/1/2023,LIE,Sarawak,0,0,0,Liechtenstein
67269,4/1/2023,LIE,Selangor,2,0,2,Liechtenstein
67270,4/1/2023,LKA,Johor,1406,871,535,Sri Lanka
67271,4/1/2023,LKA,Kedah,45,23,22,Sri Lanka
67272,4/1/2023,LKA,Kelantan,0,0,0,Sri Lanka
67273,4/1/2023,LKA,Melaka,0,0,0,Sri Lanka
67274,4/1/2023,LKA,Pahang,0,0,0,Sri Lanka
67275,4/1/2023,LKA,Perak,7,3,4,Sri Lanka
67276,4/1/2023,LKA,Perlis,4,4,0,Sri Lanka
67277,4/1/2023,LKA,Pulau Pinang,42,21,21,Sri Lanka
67278,4/1/2023,LKA,Sabah,4,3,1,Sri Lanka
67279,4/1/2023,LKA,Sarawak,33,21,12,Sri Lanka
67280,4/1/2023,LKA,Selangor,3762,2329,1433,Sri Lanka
67281,4/1/2023,LKA,W.P. Labuan,9,8,1,Sri Lanka
67282,4/1/2023,LSO,Johor,2,1,1,Lesotho
67283,4/1/2023,LSO,Kedah,0,0,0,Lesotho
67284,4/1/2023,LSO,Pulau Pinang,0,0,0,Lesotho
67285,4/1/2023,LSO,Sarawak,0,0,0,Lesotho
67286,4/1/2023,LSO,Selangor,5,1,4,Lesotho
67287,4/1/2023,LTU,Johor,54,21,33,Lithuania
67288,4/1/2023,LTU,Kedah,36,14,22,Lithuania
67289,4/1/2023,LTU,Kelantan,0,0,0,Lithuania
67290,4/1/2023,LTU,Pahang,0,0,0,Lithuania
67291,4/1/2023,LTU,Perak,5,2,3,Lithuania
67292,4/1/2023,LTU,Perlis,5,5,0,Lithuania
67293,4/1/2023,LTU,Pulau Pinang,4,1,3,Lithuania
67294,4/1/2023,LTU,Sabah,3,2,1,Lithuania
67295,4/1/2023,LTU,Sarawak,5,3,2,Lithuania
67296,4/1/2023,LTU,Selangor,361,172,189,Lithuania
67297,4/1/2023,LTU,W.P. Labuan,0,0,0,Lithuania
67298,4/1/2023,LUX,Johor,7,4,3,Luxembourg
67299,4/1/2023,LUX,Kedah,9,5,4,Luxembourg
67300,4/1/2023,LUX,Kelantan,0,0,0,Luxembourg
67301,4/1/2023,LUX,Perak,1,1,0,Luxembourg
67302,4/1/2023,LUX,Perlis,0,0,0,Luxembourg
67303,4/1/2023,LUX,Pulau Pinang,6,3,3,Luxembourg
67304,4/1/2023,LUX,Sabah,3,0,3,Luxembourg
67305,4/1/2023,LUX,Sarawak,1,0,1,Luxembourg
67306,4/1/2023,LUX,Selangor,41,21,20,Luxembourg
67307,4/1/2023,LVA,Johor,13,10,3,Latvia
67308,4/1/2023,LVA,Kedah,6,1,5,Latvia
67309,4/1/2023,LVA,Kelantan,0,0,0,Latvia
67310,4/1/2023,LVA,Pahang,0,0,0,Latvia
67311,4/1/2023,LVA,Perak,0,0,0,Latvia
67312,4/1/2023,LVA,Perlis,1,1,0,Latvia
67313,4/1/2023,LVA,Pulau Pinang,2,1,1,Latvia
67314,4/1/2023,LVA,Sabah,1,1,0,Latvia
67315,4/1/2023,LVA,Sarawak,7,3,4,Latvia
67316,4/1/2023,LVA,Selangor,194,109,85,Latvia
67317,4/1/2023,LVA,W.P. Labuan,0,0,0,Latvia
67318,4/1/2023,MAC,Johor,0,0,0,Macao
67319,4/1/2023,MAC,Pahang,0,0,0,Macao
67320,4/1/2023,MAC,Perak,8,5,3,Macao
67321,4/1/2023,MAC,Selangor,0,0,0,Macao
67322,4/1/2023,MAC,W.P. Labuan,0,0,0,Macao
67323,4/1/2023,MAR,Johor,77,50,27,Morocco
67324,4/1/2023,MAR,Kedah,6,3,3,Morocco
67325,4/1/2023,MAR,Kelantan,1,1,0,Morocco
67326,4/1/2023,MAR,Melaka,0,0,0,Morocco
67327,4/1/2023,MAR,Pahang,0,0,0,Morocco
67328,4/1/2023,MAR,Perak,0,0,0,Morocco
67329,4/1/2023,MAR,Perlis,1,1,0,Morocco
67330,4/1/2023,MAR,Pulau Pinang,15,12,3,Morocco
67331,4/1/2023,MAR,Sabah,1,1,0,Morocco
67332,4/1/2023,MAR,Sarawak,13,11,2,Morocco
67333,4/1/2023,MAR,Selangor,428,228,200,Morocco
67334,4/1/2023,MAR,W.P. Labuan,0,0,0,Morocco
67335,4/1/2023,MCO,Johor,0,0,0,Monaco
67336,4/1/2023,MCO,Kedah,0,0,0,Monaco
67337,4/1/2023,MCO,Sabah,0,0,0,Monaco
67338,4/1/2023,MCO,Selangor,3,1,2,Monaco
67339,4/1/2023,MDA,Johor,2,2,0,"Moldova, Republic of"
67340,4/1/2023,MDA,Kedah,4,3,1,"Moldova, Republic of"
67341,4/1/2023,MDA,Kelantan,0,0,0,"Moldova, Republic of"
67342,4/1/2023,MDA,Negeri Sembilan,0,0,0,"Moldova, Republic of"
67343,4/1/2023,MDA,Perlis,0,0,0,"Moldova, Republic of"
67344,4/1/2023,MDA,Pulau Pinang,0,0,0,"Moldova, Republic of"
67345,4/1/2023,MDA,Sabah,1,1,0,"Moldova, Republic of"
67346,4/1/2023,MDA,Sarawak,0,0,0,"Moldova, Republic of"
67347,4/1/2023,MDA,Selangor,17,7,10,"Moldova, Republic of"
67348,4/1/2023,MDG,Johor,17,8,9,Madagascar
67349,4/1/2023,MDG,Kedah,4,0,4,Madagascar
67350,4/1/2023,MDG,Perak,0,0,0,Madagascar
67351,4/1/2023,MDG,Perlis,0,0,0,Madagascar
67352,4/1/2023,MDG,Pulau Pinang,0,0,0,Madagascar
67353,4/1/2023,MDG,Sabah,0,0,0,Madagascar
67354,4/1/2023,MDG,Sarawak,0,0,0,Madagascar
67355,4/1/2023,MDG,Selangor,56,27,29,Madagascar
67356,4/1/2023,MDV,Johor,54,31,23,Maldives
67357,4/1/2023,MDV,Kedah,0,0,0,Maldives
67358,4/1/2023,MDV,Kelantan,0,0,0,Maldives
67359,4/1/2023,MDV,Perak,0,0,0,Maldives
67360,4/1/2023,MDV,Perlis,0,0,0,Maldives
67361,4/1/2023,MDV,Pulau Pinang,2,1,1,Maldives
67362,4/1/2023,MDV,Sabah,0,0,0,Maldives
67363,4/1/2023,MDV,Sarawak,1,0,1,Maldives
67364,4/1/2023,MDV,Selangor,1366,746,620,Maldives
67365,4/1/2023,MEX,Johor,166,90,76,Mexico
67366,4/1/2023,MEX,Kedah,11,1,10,Mexico
67367,4/1/2023,MEX,Kelantan,0,0,0,Mexico
67368,4/1/2023,MEX,Pahang,0,0,0,Mexico
67369,4/1/2023,MEX,Perak,0,0,0,Mexico
67370,4/1/2023,MEX,Perlis,2,2,0,Mexico
67371,4/1/2023,MEX,Pulau Pinang,34,21,13,Mexico
67372,4/1/2023,MEX,Sabah,9,4,5,Mexico
67373,4/1/2023,MEX,Sarawak,8,5,3,Mexico
67374,4/1/2023,MEX,Selangor,747,347,400,Mexico
67375,4/1/2023,MEX,W.P. Labuan,0,0,0,Mexico
67376,4/1/2023,MHL,Johor,1,1,0,Marshall Islands
67377,4/1/2023,MHL,Kedah,0,0,0,Marshall Islands
67378,4/1/2023,MHL,Perak,0,0,0,Marshall Islands
67379,4/1/2023,MHL,Pulau Pinang,1,1,0,Marshall Islands
67380,4/1/2023,MHL,Sabah,0,0,0,Marshall Islands
67381,4/1/2023,MHL,Selangor,7,6,1,Marshall Islands
67382,4/1/2023,MKD,Johor,2,1,1,"Macedonia, the former Yugoslav Republic of"
67383,4/1/2023,MKD,Kedah,0,0,0,"Macedonia, the former Yugoslav Republic of"
67384,4/1/2023,MKD,Perak,0,0,0,"Macedonia, the former Yugoslav Republic of"
67385,4/1/2023,MKD,Pulau Pinang,1,0,1,"Macedonia, the former Yugoslav Republic of"
67386,4/1/2023,MKD,Sabah,0,0,0,"Macedonia, the former Yugoslav Republic of"
67387,4/1/2023,MKD,Sarawak,1,0,1,"Macedonia, the former Yugoslav Republic of"
67388,4/1/2023,MKD,Selangor,48,28,20,"Macedonia, the former Yugoslav Republic of"
67389,4/1/2023,MLI,Johor,0,0,0,Mali
67390,4/1/2023,MLI,Sabah,0,0,0,Mali
67391,4/1/2023,MLI,Selangor,6,3,3,Mali
67392,4/1/2023,MLT,Johor,8,5,3,Malta
67393,4/1/2023,MLT,Kedah,0,0,0,Malta
67394,4/1/2023,MLT,Kelantan,0,0,0,Malta
67395,4/1/2023,MLT,Perak,0,0,0,Malta
67396,4/1/2023,MLT,Perlis,0,0,0,Malta
67397,4/1/2023,MLT,Pulau Pinang,10,6,4,Malta
67398,4/1/2023,MLT,Sabah,0,0,0,Malta
67399,4/1/2023,MLT,Sarawak,0,0,0,Malta
67400,4/1/2023,MLT,Selangor,41,25,16,Malta
67401,4/1/2023,MLT,W.P. Labuan,0,0,0,Malta
67402,4/1/2023,MMR,Johor,5054,1737,3317,Myanmar
67403,4/1/2023,MMR,Kedah,86,18,68,Myanmar
67404,4/1/2023,MMR,Kelantan,3,1,2,Myanmar
67405,4/1/2023,MMR,Negeri Sembilan,1,1,0,Myanmar
67406,4/1/2023,MMR,Pahang,3,0,3,Myanmar
67407,4/1/2023,MMR,Perak,17,3,14,Myanmar
67408,4/1/2023,MMR,Perlis,13,3,10,Myanmar
67409,4/1/2023,MMR,Pulau Pinang,208,94,114,Myanmar
67410,4/1/2023,MMR,Sabah,29,6,23,Myanmar
67411,4/1/2023,MMR,Sarawak,84,31,53,Myanmar
67412,4/1/2023,MMR,Selangor,6295,4199,2096,Myanmar
67413,4/1/2023,MMR,Terengganu,0,0,0,Myanmar
67414,4/1/2023,MMR,W.P. Labuan,3,1,2,Myanmar
67415,4/1/2023,MNE,Johor,1,1,0,Montenegro
67416,4/1/2023,MNE,Kedah,1,0,1,Montenegro
67417,4/1/2023,MNE,Pulau Pinang,0,0,0,Montenegro
67418,4/1/2023,MNE,Sabah,0,0,0,Montenegro
67419,4/1/2023,MNE,Sarawak,0,0,0,Montenegro
67420,4/1/2023,MNE,Selangor,25,14,11,Montenegro
67421,4/1/2023,MNG,Johor,106,45,61,Mongolia
67422,4/1/2023,MNG,Kedah,6,3,3,Mongolia
67423,4/1/2023,MNG,Kelantan,0,0,0,Mongolia
67424,4/1/2023,MNG,Perak,1,0,1,Mongolia
67425,4/1/2023,MNG,Perlis,4,3,1,Mongolia
67426,4/1/2023,MNG,Pulau Pinang,3,2,1,Mongolia
67427,4/1/2023,MNG,Sabah,3,0,3,Mongolia
67428,4/1/2023,MNG,Sarawak,0,0,0,Mongolia
67429,4/1/2023,MNG,Selangor,298,134,164,Mongolia
67430,4/1/2023,MNP,Selangor,0,0,0,Northern Mariana Islands
67431,4/1/2023,MOZ,Johor,3,1,2,Mozambique
67432,4/1/2023,MOZ,Kedah,0,0,0,Mozambique
67433,4/1/2023,MOZ,Perak,0,0,0,Mozambique
67434,4/1/2023,MOZ,Pulau Pinang,0,0,0,Mozambique
67435,4/1/2023,MOZ,Sabah,0,0,0,Mozambique
67436,4/1/2023,MOZ,Sarawak,0,0,0,Mozambique
67437,4/1/2023,MOZ,Selangor,15,8,7,Mozambique
67438,4/1/2023,MRT,Johor,0,0,0,Mauritania
67439,4/1/2023,MRT,Kedah,0,0,0,Mauritania
67440,4/1/2023,MRT,Pulau Pinang,0,0,0,Mauritania
67441,4/1/2023,MRT,Sabah,0,0,0,Mauritania
67442,4/1/2023,MRT,Sarawak,0,0,0,Mauritania
67443,4/1/2023,MRT,Selangor,11,8,3,Mauritania
67444,4/1/2023,MUS,Johor,196,102,94,Mauritius
67445,4/1/2023,MUS,Kedah,4,1,3,Mauritius
67446,4/1/2023,MUS,Kelantan,0,0,0,Mauritius
67447,4/1/2023,MUS,Pahang,0,0,0,Mauritius
67448,4/1/2023,MUS,Perak,3,1,2,Mauritius
67449,4/1/2023,MUS,Perlis,2,2,0,Mauritius
67450,4/1/2023,MUS,Pulau Pinang,10,3,7,Mauritius
67451,4/1/2023,MUS,Sabah,0,0,0,Mauritius
67452,4/1/2023,MUS,Sarawak,5,3,2,Mauritius
67453,4/1/2023,MUS,Selangor,1744,891,853,Mauritius
67454,4/1/2023,MWI,Johor,0,0,0,Malawi
67455,4/1/2023,MWI,Pulau Pinang,0,0,0,Malawi
67456,4/1/2023,MWI,Sabah,0,0,0,Malawi
67457,4/1/2023,MWI,Sarawak,0,0,0,Malawi
67458,4/1/2023,MWI,Selangor,13,7,6,Malawi
67459,4/1/2023,MYT,Selangor,0,0,0,Mayotte
67460,4/1/2023,NAM,Johor,0,0,0,Namibia
67461,4/1/2023,NAM,Kedah,1,0,1,Namibia
67462,4/1/2023,NAM,Perak,0,0,0,Namibia
67463,4/1/2023,NAM,Perlis,0,0,0,Namibia
67464,4/1/2023,NAM,Pulau Pinang,1,0,1,Namibia
67465,4/1/2023,NAM,Sabah,0,0,0,Namibia
67466,4/1/2023,NAM,Sarawak,0,0,0,Namibia
67467,4/1/2023,NAM,Selangor,19,7,12,Namibia
67468,4/1/2023,NCL,Selangor,0,0,0,New Caledonia
67469,4/1/2023,NER,Johor,0,0,0,Niger
67470,4/1/2023,NER,Sabah,0,0,0,Niger
67471,4/1/2023,NER,Selangor,6,4,2,Niger
67472,4/1/2023,NGA,Johor,28,25,3,Nigeria
67473,4/1/2023,NGA,Kedah,4,0,4,Nigeria
67474,4/1/2023,NGA,Perlis,1,1,0,Nigeria
67475,4/1/2023,NGA,Pulau Pinang,1,1,0,Nigeria
67476,4/1/2023,NGA,Sabah,1,1,0,Nigeria
67477,4/1/2023,NGA,Sarawak,5,4,1,Nigeria
67478,4/1/2023,NGA,Selangor,337,263,74,Nigeria
67479,4/1/2023,NIC,Johor,0,0,0,Nicaragua
67480,4/1/2023,NIC,Kedah,0,0,0,Nicaragua
67481,4/1/2023,NIC,Pulau Pinang,0,0,0,Nicaragua
67482,4/1/2023,NIC,Sabah,0,0,0,Nicaragua
67483,4/1/2023,NIC,Selangor,3,2,1,Nicaragua
67484,4/1/2023,NLD,Johor,916,580,336,Netherlands
67485,4/1/2023,NLD,Kedah,430,202,228,Netherlands
67486,4/1/2023,NLD,Kelantan,14,9,5,Netherlands
67487,4/1/2023,NLD,Melaka,1,0,1,Netherlands
67488,4/1/2023,NLD,Negeri Sembilan,0,0,0,Netherlands
67489,4/1/2023,NLD,Pahang,0,0,0,Netherlands
67490,4/1/2023,NLD,Perak,17,10,7,Netherlands
67491,4/1/2023,NLD,Perlis,40,23,17,Netherlands
67492,4/1/2023,NLD,Pulau Pinang,279,161,118,Netherlands
67493,4/1/2023,NLD,Sabah,111,62,49,Netherlands
67494,4/1/2023,NLD,Sarawak,150,91,59,Netherlands
67495,4/1/2023,NLD,Selangor,4113,2357,1756,Netherlands
67496,4/1/2023,NLD,Terengganu,0,0,0,Netherlands
67497,4/1/2023,NLD,W.P. Labuan,3,2,1,Netherlands
67498,4/1/2023,NOR,Johor,158,105,53,Norway
67499,4/1/2023,NOR,Kedah,113,54,59,Norway
67500,4/1/2023,NOR,Kelantan,4,4,0,Norway
67501,4/1/2023,NOR,Melaka,0,0,0,Norway
67502,4/1/2023,NOR,Pahang,0,0,0,Norway
67503,4/1/2023,NOR,Perak,3,2,1,Norway
67504,4/1/2023,NOR,Perlis,10,6,4,Norway
67505,4/1/2023,NOR,Pulau Pinang,33,24,9,Norway
67506,4/1/2023,NOR,Sabah,25,15,10,Norway
67507,4/1/2023,NOR,Sarawak,21,12,9,Norway
67508,4/1/2023,NOR,Selangor,534,320,214,Norway
67509,4/1/2023,NOR,W.P. Labuan,4,3,1,Norway
67510,4/1/2023,NPL,Johor,792,660,132,Nepal
67511,4/1/2023,NPL,Kedah,5,4,1,Nepal
67512,4/1/2023,NPL,Pahang,0,0,0,Nepal
67513,4/1/2023,NPL,Perak,0,0,0,Nepal
67514,4/1/2023,NPL,Perlis,2,2,0,Nepal
67515,4/1/2023,NPL,Pulau Pinang,26,21,5,Nepal
67516,4/1/2023,NPL,Sabah,6,6,0,Nepal
67517,4/1/2023,NPL,Sarawak,356,242,114,Nepal
67518,4/1/2023,NPL,Selangor,13569,13021,548,Nepal
67519,4/1/2023,NPL,W.P. Labuan,62,49,13,Nepal
67520,4/1/2023,NRU,Johor,0,0,0,Nauru
67521,4/1/2023,NRU,Pulau Pinang,0,0,0,Nauru
67522,4/1/2023,NRU,Selangor,3,3,0,Nauru
67523,4/1/2023,NZL,Johor,814,484,330,New Zealand
67524,4/1/2023,NZL,Kedah,137,82,55,New Zealand
67525,4/1/2023,NZL,Kelantan,6,5,1,New Zealand
67526,4/1/2023,NZL,Melaka,0,0,0,New Zealand
67527,4/1/2023,NZL,Negeri Sembilan,0,0,0,New Zealand
67528,4/1/2023,NZL,Pahang,9,5,4,New Zealand
67529,4/1/2023,NZL,Perak,14,5,9,New Zealand
67530,4/1/2023,NZL,Perlis,28,9,19,New Zealand
67531,4/1/2023,NZL,Pulau Pinang,246,137,109,New Zealand
67532,4/1/2023,NZL,Sabah,62,38,24,New Zealand
67533,4/1/2023,NZL,Sarawak,154,77,77,New Zealand
67534,4/1/2023,NZL,Selangor,2864,1646,1218,New Zealand
67535,4/1/2023,NZL,Terengganu,0,0,0,New Zealand
67536,4/1/2023,NZL,W.P. Labuan,0,0,0,New Zealand
67537,4/1/2023,OMN,Johor,14,7,7,Oman
67538,4/1/2023,OMN,Kedah,0,0,0,Oman
67539,4/1/2023,OMN,Kelantan,0,0,0,Oman
67540,4/1/2023,OMN,Melaka,0,0,0,Oman
67541,4/1/2023,OMN,Perak,0,0,0,Oman
67542,4/1/2023,OMN,Perlis,0,0,0,Oman
67543,4/1/2023,OMN,Pulau Pinang,0,0,0,Oman
67544,4/1/2023,OMN,Sabah,1,0,1,Oman
67545,4/1/2023,OMN,Sarawak,7,5,2,Oman
67546,4/1/2023,OMN,Selangor,301,197,104,Oman
67547,4/1/2023,PAK,Johor,646,480,166,Pakistan
67548,4/1/2023,PAK,Kedah,37,30,7,Pakistan
67549,4/1/2023,PAK,Kelantan,10,10,0,Pakistan
67550,4/1/2023,PAK,Melaka,0,0,0,Pakistan
67551,4/1/2023,PAK,Negeri Sembilan,0,0,0,Pakistan
67552,4/1/2023,PAK,Pahang,0,0,0,Pakistan
67553,4/1/2023,PAK,Perak,27,24,3,Pakistan
67554,4/1/2023,PAK,Perlis,20,19,1,Pakistan
67555,4/1/2023,PAK,Pulau Pinang,219,214,5,Pakistan
67556,4/1/2023,PAK,Sabah,20,15,5,Pakistan
67557,4/1/2023,PAK,Sarawak,140,114,26,Pakistan
67558,4/1/2023,PAK,Selangor,12969,12042,927,Pakistan
67559,4/1/2023,PAK,W.P. Labuan,7,4,3,Pakistan
67560,4/1/2023,PAN,Johor,11,6,5,Panama
67561,4/1/2023,PAN,Kedah,1,0,1,Panama
67562,4/1/2023,PAN,Perak,0,0,0,Panama
67563,4/1/2023,PAN,Perlis,0,0,0,Panama
67564,4/1/2023,PAN,Pulau Pinang,2,1,1,Panama
67565,4/1/2023,PAN,Sabah,1,0,1,Panama
67566,4/1/2023,PAN,Sarawak,0,0,0,Panama
67567,4/1/2023,PAN,Selangor,13,3,10,Panama
67568,4/1/2023,PER,Johor,34,18,16,Peru
67569,4/1/2023,PER,Kedah,8,5,3,Peru
67570,4/1/2023,PER,Kelantan,1,1,0,Peru
67571,4/1/2023,PER,Pahang,0,0,0,Peru
67572,4/1/2023,PER,Perak,0,0,0,Peru
67573,4/1/2023,PER,Perlis,1,1,0,Peru
67574,4/1/2023,PER,Pulau Pinang,3,1,2,Peru
67575,4/1/2023,PER,Sabah,2,1,1,Peru
67576,4/1/2023,PER,Sarawak,3,3,0,Peru
67577,4/1/2023,PER,Selangor,106,46,60,Peru
67578,4/1/2023,PER,W.P. Labuan,0,0,0,Peru
67579,4/1/2023,PHL,Johor,19124,6369,12755,Philippines
67580,4/1/2023,PHL,Kedah,526,156,370,Philippines
67581,4/1/2023,PHL,Kelantan,34,16,18,Philippines
67582,4/1/2023,PHL,Melaka,1,0,1,Philippines
67583,4/1/2023,PHL,Negeri Sembilan,0,0,0,Philippines
67584,4/1/2023,PHL,Pahang,27,21,6,Philippines
67585,4/1/2023,PHL,Perak,58,18,40,Philippines
67586,4/1/2023,PHL,Perlis,72,19,53,Philippines
67587,4/1/2023,PHL,Pulau Pinang,575,202,373,Philippines
67588,4/1/2023,PHL,Sabah,1434,593,841,Philippines
67589,4/1/2023,PHL,Sarawak,2959,1134,1825,Philippines
67590,4/1/2023,PHL,Selangor,13303,5437,7866,Philippines
67591,4/1/2023,PHL,Terengganu,0,0,0,Philippines
67592,4/1/2023,PHL,W.P. Labuan,122,56,66,Philippines
67593,4/1/2023,PLW,Johor,0,0,0,Palau
67594,4/1/2023,PLW,Pulau Pinang,0,0,0,Palau
67595,4/1/2023,PLW,Selangor,0,0,0,Palau
67596,4/1/2023,PNG,Johor,3,3,0,Papua New Guinea
67597,4/1/2023,PNG,Kedah,0,0,0,Papua New Guinea
67598,4/1/2023,PNG,Kelantan,0,0,0,Papua New Guinea
67599,4/1/2023,PNG,Perak,0,0,0,Papua New Guinea
67600,4/1/2023,PNG,Pulau Pinang,2,1,1,Papua New Guinea
67601,4/1/2023,PNG,Sabah,0,0,0,Papua New Guinea
67602,4/1/2023,PNG,Sarawak,5,2,3,Papua New Guinea
67603,4/1/2023,PNG,Selangor,35,22,13,Papua New Guinea
67604,4/1/2023,POL,Johor,368,217,151,Poland
67605,4/1/2023,POL,Kedah,111,49,62,Poland
67606,4/1/2023,POL,Kelantan,2,1,1,Poland
67607,4/1/2023,POL,Melaka,0,0,0,Poland
67608,4/1/2023,POL,Negeri Sembilan,0,0,0,Poland
67609,4/1/2023,POL,Pahang,2,0,2,Poland
67610,4/1/2023,POL,Perak,3,2,1,Poland
67611,4/1/2023,POL,Perlis,22,13,9,Poland
67612,4/1/2023,POL,Pulau Pinang,60,27,33,Poland
67613,4/1/2023,POL,Sabah,36,21,15,Poland
67614,4/1/2023,POL,Sarawak,31,9,22,Poland
67615,4/1/2023,POL,Selangor,1017,541,476,Poland
67616,4/1/2023,POL,Terengganu,0,0,0,Poland
67617,4/1/2023,POL,W.P. Labuan,0,0,0,Poland
67618,4/1/2023,PRK,Selangor,0,0,0,"Korea, Democratic People's Republic of"
67619,4/1/2023,PRT,Johor,145,71,74,Portugal
67620,4/1/2023,PRT,Kedah,116,61,55,Portugal
67621,4/1/2023,PRT,Kelantan,1,1,0,Portugal
67622,4/1/2023,PRT,Melaka,0,0,0,Portugal
67623,4/1/2023,PRT,Pahang,0,0,0,Portugal
67624,4/1/2023,PRT,Perak,0,0,0,Portugal
67625,4/1/2023,PRT,Perlis,4,1,3,Portugal
67626,4/1/2023,PRT,Pulau Pinang,31,19,12,Portugal
67627,4/1/2023,PRT,Sabah,31,12,19,Portugal
67628,4/1/2023,PRT,Sarawak,5,2,3,Portugal
67629,4/1/2023,PRT,Selangor,755,414,341,Portugal
67630,4/1/2023,PRT,W.P. Labuan,0,0,0,Portugal
67631,4/1/2023,PRY,Johor,2,1,1,Paraguay
67632,4/1/2023,PRY,Kedah,1,0,1,Paraguay
67633,4/1/2023,PRY,Perak,0,0,0,Paraguay
67634,4/1/2023,PRY,Perlis,0,0,0,Paraguay
67635,4/1/2023,PRY,Pulau Pinang,0,0,0,Paraguay
67636,4/1/2023,PRY,Sabah,0,0,0,Paraguay
67637,4/1/2023,PRY,Sarawak,0,0,0,Paraguay
67638,4/1/2023,PRY,Selangor,11,8,3,Paraguay
67639,4/1/2023,PSE,Johor,16,16,0,"Palestinian Territory, Occupied"
67640,4/1/2023,PSE,Kedah,0,0,0,"Palestinian Territory, Occupied"
67641,4/1/2023,PSE,Kelantan,0,0,0,"Palestinian Territory, Occupied"
67642,4/1/2023,PSE,Melaka,1,1,0,"Palestinian Territory, Occupied"
67643,4/1/2023,PSE,Perak,0,0,0,"Palestinian Territory, Occupied"
67644,4/1/2023,PSE,Perlis,0,0,0,"Palestinian Territory, Occupied"
67645,4/1/2023,PSE,Pulau Pinang,1,1,0,"Palestinian Territory, Occupied"
67646,4/1/2023,PSE,Sabah,1,1,0,"Palestinian Territory, Occupied"
67647,4/1/2023,PSE,Sarawak,11,8,3,"Palestinian Territory, Occupied"
67648,4/1/2023,PSE,Selangor,178,131,47,"Palestinian Territory, Occupied"
67649,4/1/2023,QAT,Johor,7,5,2,Qatar
67650,4/1/2023,QAT,Kedah,0,0,0,Qatar
67651,4/1/2023,QAT,Perlis,0,0,0,Qatar
67652,4/1/2023,QAT,Pulau Pinang,1,1,0,Qatar
67653,4/1/2023,QAT,Sabah,0,0,0,Qatar
67654,4/1/2023,QAT,Sarawak,0,0,0,Qatar
67655,4/1/2023,QAT,Selangor,135,90,45,Qatar
67656,4/1/2023,REU,Johor,0,0,0,Reunion
67657,4/1/2023,REU,Sarawak,0,0,0,Reunion
67658,4/1/2023,ROU,Johor,160,80,80,Romania
67659,4/1/2023,ROU,Kedah,45,26,19,Romania
67660,4/1/2023,ROU,Kelantan,1,1,0,Romania
67661,4/1/2023,ROU,Negeri Sembilan,0,0,0,Romania
67662,4/1/2023,ROU,Pahang,2,2,0,Romania
67663,4/1/2023,ROU,Perak,0,0,0,Romania
67664,4/1/2023,ROU,Perlis,2,1,1,Romania
67665,4/1/2023,ROU,Pulau Pinang,2,2,0,Romania
67666,4/1/2023,ROU,Sabah,7,4,3,Romania
67667,4/1/2023,ROU,Sarawak,10,8,2,Romania
67668,4/1/2023,ROU,Selangor,652,341,311,Romania
67669,4/1/2023,ROU,W.P. Labuan,0,0,0,Romania
67670,4/1/2023,RUS,Johor,409,206,203,Russia
67671,4/1/2023,RUS,Kedah,580,314,266,Russia
67672,4/1/2023,RUS,Kelantan,64,42,22,Russia
67673,4/1/2023,RUS,Melaka,2,2,0,Russia
67674,4/1/2023,RUS,Negeri Sembilan,0,0,0,Russia
67675,4/1/2023,RUS,Pahang,3,2,1,Russia
67676,4/1/2023,RUS,Perak,3,3,0,Russia
67677,4/1/2023,RUS,Perlis,368,200,168,Russia
67678,4/1/2023,RUS,Pulau Pinang,158,85,73,Russia
67679,4/1/2023,RUS,Sabah,54,16,38,Russia
67680,4/1/2023,RUS,Sarawak,87,41,46,Russia
67681,4/1/2023,RUS,Selangor,11358,5770,5588,Russia
67682,4/1/2023,RUS,W.P. Labuan,12,8,4,Russia
67683,4/1/2023,RWA,Johor,1,1,0,Rwanda
67684,4/1/2023,RWA,Kedah,0,0,0,Rwanda
67685,4/1/2023,RWA,Pulau Pinang,0,0,0,Rwanda
67686,4/1/2023,RWA,Selangor,4,2,2,Rwanda
67687,4/1/2023,SAU,Johor,103,54,49,Saudi Arabia
67688,4/1/2023,SAU,Kedah,6,5,1,Saudi Arabia
67689,4/1/2023,SAU,Kelantan,0,0,0,Saudi Arabia
67690,4/1/2023,SAU,Melaka,0,0,0,Saudi Arabia
67691,4/1/2023,SAU,Perak,0,0,0,Saudi Arabia
67692,4/1/2023,SAU,Perlis,4,4,0,Saudi Arabia
67693,4/1/2023,SAU,Pulau Pinang,9,5,4,Saudi Arabia
67694,4/1/2023,SAU,Sabah,2,2,0,Saudi Arabia
67695,4/1/2023,SAU,Sarawak,12,8,4,Saudi Arabia
67696,4/1/2023,SAU,Selangor,2211,1253,958,Saudi Arabia
67697,4/1/2023,SAU,W.P. Labuan,0,0,0,Saudi Arabia
67698,4/1/2023,SDN,Johor,12,10,2,Sudan
67699,4/1/2023,SDN,Kedah,0,0,0,Sudan
67700,4/1/2023,SDN,Kelantan,0,0,0,Sudan
67701,4/1/2023,SDN,Perlis,0,0,0,Sudan
67702,4/1/2023,SDN,Pulau Pinang,1,0,1,Sudan
67703,4/1/2023,SDN,Sabah,0,0,0,Sudan
67704,4/1/2023,SDN,Sarawak,3,1,2,Sudan
67705,4/1/2023,SDN,Selangor,451,256,195,Sudan
67706,4/1/2023,SDN,W.P. Labuan,0,0,0,Sudan
67707,4/1/2023,SEN,Johor,21,17,4,Senegal
67708,4/1/2023,SEN,Kedah,0,0,0,Senegal
67709,4/1/2023,SEN,Kelantan,0,0,0,Senegal
67710,4/1/2023,SEN,Perak,0,0,0,Senegal
67711,4/1/2023,SEN,Perlis,0,0,0,Senegal
67712,4/1/2023,SEN,Pulau Pinang,1,0,1,Senegal
67713,4/1/2023,SEN,Sabah,0,0,0,Senegal
67714,4/1/2023,SEN,Sarawak,0,0,0,Senegal
67715,4/1/2023,SEN,Selangor,58,48,10,Senegal
67716,4/1/2023,SGP,Johor,979155,563701,415454,Singapore
67717,4/1/2023,SGP,Kedah,3327,1785,1542,Singapore
67718,4/1/2023,SGP,Kelantan,34,24,10,Singapore
67719,4/1/2023,SGP,Melaka,26,17,9,Singapore
67720,4/1/2023,SGP,Negeri Sembilan,0,0,0,Singapore
67721,4/1/2023,SGP,Pahang,492,246,246,Singapore
67722,4/1/2023,SGP,Perak,5172,2437,2735,Singapore
67723,4/1/2023,SGP,Perlis,157,89,68,Singapore
67724,4/1/2023,SGP,Pulau Pinang,13384,6801,6583,Singapore
67725,4/1/2023,SGP,Sabah,2423,1331,1092,Singapore
67726,4/1/2023,SGP,Sarawak,4066,2328,1738,Singapore
67727,4/1/2023,SGP,Selangor,33575,17754,15821,Singapore
67728,4/1/2023,SGP,Terengganu,1,1,0,Singapore
67729,4/1/2023,SGP,W.P. Labuan,14,14,0,Singapore
67730,4/1/2023,SGS,Johor,0,0,0,South Georgia and the South Sandwich Islands
67731,4/1/2023,SGS,Sabah,0,0,0,South Georgia and the South Sandwich Islands
67732,4/1/2023,SGS,Selangor,1,0,1,South Georgia and the South Sandwich Islands
67733,4/1/2023,SHN,Sarawak,1,1,0,"Saint Helena, Ascension and Tristan da Cunha"
67734,4/1/2023,SLB,Johor,1,0,1,Solomon Islands
67735,4/1/2023,SLB,Perlis,0,0,0,Solomon Islands
67736,4/1/2023,SLB,Pulau Pinang,2,1,1,Solomon Islands
67737,4/1/2023,SLB,Sabah,0,0,0,Solomon Islands
67738,4/1/2023,SLB,Sarawak,5,1,4,Solomon Islands
67739,4/1/2023,SLB,Selangor,6,2,4,Solomon Islands
67740,4/1/2023,SLB,W.P. Labuan,0,0,0,Solomon Islands
67741,4/1/2023,SLE,Johor,3,2,1,Sierra Leone
67742,4/1/2023,SLE,Kedah,0,0,0,Sierra Leone
67743,4/1/2023,SLE,Perak,0,0,0,Sierra Leone
67744,4/1/2023,SLE,Pulau Pinang,0,0,0,Sierra Leone
67745,4/1/2023,SLE,Sabah,0,0,0,Sierra Leone
67746,4/1/2023,SLE,Selangor,10,10,0,Sierra Leone
67747,4/1/2023,SLV,Johor,0,0,0,El Salvador
67748,4/1/2023,SLV,Kedah,1,1,0,El Salvador
67749,4/1/2023,SLV,Perak,0,0,0,El Salvador
67750,4/1/2023,SLV,Perlis,0,0,0,El Salvador
67751,4/1/2023,SLV,Pulau Pinang,0,0,0,El Salvador
67752,4/1/2023,SLV,Sabah,0,0,0,El Salvador
67753,4/1/2023,SLV,Selangor,26,16,10,El Salvador
67754,4/1/2023,SLV,W.P. Labuan,0,0,0,El Salvador
67755,4/1/2023,SMR,Johor,2,2,0,San Marino
67756,4/1/2023,SMR,Selangor,7,0,7,San Marino
67757,4/1/2023,SOM,Johor,0,0,0,Somalia
67758,4/1/2023,SOM,Kedah,1,1,0,Somalia
67759,4/1/2023,SOM,Kelantan,0,0,0,Somalia
67760,4/1/2023,SOM,Perlis,0,0,0,Somalia
67761,4/1/2023,SOM,Sabah,0,0,0,Somalia
67762,4/1/2023,SOM,Sarawak,0,0,0,Somalia
67763,4/1/2023,SOM,Selangor,161,98,63,Somalia
67764,4/1/2023,SRB,Johor,4,2,2,Serbia
67765,4/1/2023,SRB,Kedah,2,2,0,Serbia
67766,4/1/2023,SRB,Kelantan,0,0,0,Serbia
67767,4/1/2023,SRB,Pahang,0,0,0,Serbia
67768,4/1/2023,SRB,Perak,0,0,0,Serbia
67769,4/1/2023,SRB,Perlis,0,0,0,Serbia
67770,4/1/2023,SRB,Pulau Pinang,1,0,1,Serbia
67771,4/1/2023,SRB,Sabah,0,0,0,Serbia
67772,4/1/2023,SRB,Sarawak,0,0,0,Serbia
67773,4/1/2023,SRB,Selangor,97,47,50,Serbia
67774,4/1/2023,STP,Selangor,0,0,0,Sao Tome and Principe
67775,4/1/2023,SUR,Johor,2,0,2,Suriname
67776,4/1/2023,SUR,Kedah,1,0,1,Suriname
67777,4/1/2023,SUR,Kelantan,0,0,0,Suriname
67778,4/1/2023,SUR,Perak,0,0,0,Suriname
67779,4/1/2023,SUR,Perlis,5,5,0,Suriname
67780,4/1/2023,SUR,Pulau Pinang,0,0,0,Suriname
67781,4/1/2023,SUR,Sabah,0,0,0,Suriname
67782,4/1/2023,SUR,Sarawak,0,0,0,Suriname
67783,4/1/2023,SUR,Selangor,16,11,5,Suriname
67784,4/1/2023,SVK,Johor,35,22,13,Slovakia
67785,4/1/2023,SVK,Kedah,75,39,36,Slovakia
67786,4/1/2023,SVK,Kelantan,1,1,0,Slovakia
67787,4/1/2023,SVK,Negeri Sembilan,0,0,0,Slovakia
67788,4/1/2023,SVK,Pahang,0,0,0,Slovakia
67789,4/1/2023,SVK,Perak,0,0,0,Slovakia
67790,4/1/2023,SVK,Perlis,2,2,0,Slovakia
67791,4/1/2023,SVK,Pulau Pinang,7,5,2,Slovakia
67792,4/1/2023,SVK,Sabah,5,4,1,Slovakia
67793,4/1/2023,SVK,Sarawak,2,1,1,Slovakia
67794,4/1/2023,SVK,Selangor,270,156,114,Slovakia
67795,4/1/2023,SVK,W.P. Labuan,4,4,0,Slovakia
67796,4/1/2023,SVN,Johor,35,19,16,Slovenia
67797,4/1/2023,SVN,Kedah,9,5,4,Slovenia
67798,4/1/2023,SVN,Kelantan,0,0,0,Slovenia
67799,4/1/2023,SVN,Perak,0,0,0,Slovenia
67800,4/1/2023,SVN,Perlis,0,0,0,Slovenia
67801,4/1/2023,SVN,Pulau Pinang,6,1,5,Slovenia
67802,4/1/2023,SVN,Sabah,2,2,0,Slovenia
67803,4/1/2023,SVN,Sarawak,1,1,0,Slovenia
67804,4/1/2023,SVN,Selangor,158,86,72,Slovenia
67805,4/1/2023,SVN,W.P. Labuan,0,0,0,Slovenia
67806,4/1/2023,SWE,Johor,261,153,108,Sweden
67807,4/1/2023,SWE,Kedah,179,76,103,Sweden
67808,4/1/2023,SWE,Kelantan,8,6,2,Sweden
67809,4/1/2023,SWE,Melaka,0,0,0,Sweden
67810,4/1/2023,SWE,Negeri Sembilan,0,0,0,Sweden
67811,4/1/2023,SWE,Pahang,0,0,0,Sweden
67812,4/1/2023,SWE,Perak,3,3,0,Sweden
67813,4/1/2023,SWE,Perlis,11,6,5,Sweden
67814,4/1/2023,SWE,Pulau Pinang,57,33,24,Sweden
67815,4/1/2023,SWE,Sabah,50,35,15,Sweden
67816,4/1/2023,SWE,Sarawak,9,8,1,Sweden
67817,4/1/2023,SWE,Selangor,983,605,378,Sweden
67818,4/1/2023,SWE,W.P. Labuan,1,1,0,Sweden
67819,4/1/2023,SWZ,Johor,0,0,0,Swaziland
67820,4/1/2023,SWZ,Kedah,0,0,0,Swaziland
67821,4/1/2023,SWZ,Pulau Pinang,0,0,0,Swaziland
67822,4/1/2023,SWZ,Sabah,0,0,0,Swaziland
67823,4/1/2023,SWZ,Selangor,18,8,10,Swaziland
67824,4/1/2023,SYC,Johor,0,0,0,Seychelles
67825,4/1/2023,SYC,Kedah,0,0,0,Seychelles
67826,4/1/2023,SYC,Pulau Pinang,0,0,0,Seychelles
67827,4/1/2023,SYC,Sabah,0,0,0,Seychelles
67828,4/1/2023,SYC,Sarawak,0,0,0,Seychelles
67829,4/1/2023,SYC,Selangor,87,40,47,Seychelles
67830,4/1/2023,SYR,Johor,12,9,3,Syrian Arab Republic
67831,4/1/2023,SYR,Kedah,1,1,0,Syrian Arab Republic
67832,4/1/2023,SYR,Kelantan,0,0,0,Syrian Arab Republic
67833,4/1/2023,SYR,Pahang,0,0,0,Syrian Arab Republic
67834,4/1/2023,SYR,Perlis,0,0,0,Syrian Arab Republic
67835,4/1/2023,SYR,Pulau Pinang,3,3,0,Syrian Arab Republic
67836,4/1/2023,SYR,Sabah,0,0,0,Syrian Arab Republic
67837,4/1/2023,SYR,Sarawak,2,2,0,Syrian Arab Republic
67838,4/1/2023,SYR,Selangor,486,317,169,Syrian Arab Republic
67839,4/1/2023,SYR,W.P. Labuan,0,0,0,Syrian Arab Republic
67840,4/1/2023,TCA,Perlis,0,0,0,Turks and Caicos
67841,4/1/2023,TCD,Johor,4,4,0,Chad
67842,4/1/2023,TCD,Kedah,0,0,0,Chad
67843,4/1/2023,TCD,Perlis,0,0,0,Chad
67844,4/1/2023,TCD,Selangor,18,13,5,Chad
67845,4/1/2023,TGO,Johor,4,4,0,Togo
67846,4/1/2023,TGO,Perak,0,0,0,Togo
67847,4/1/2023,TGO,Pulau Pinang,0,0,0,Togo
67848,4/1/2023,TGO,Selangor,5,3,2,Togo
67849,4/1/2023,THA,Johor,6807,2074,4733,Thailand
67850,4/1/2023,THA,Kedah,63470,35000,28470,Thailand
67851,4/1/2023,THA,Kelantan,45732,22705,23027,Thailand
67852,4/1/2023,THA,Melaka,1,0,1,Thailand
67853,4/1/2023,THA,Negeri Sembilan,3,3,0,Thailand
67854,4/1/2023,THA,Pahang,23,15,8,Thailand
67855,4/1/2023,THA,Perak,11797,5219,6578,Thailand
67856,4/1/2023,THA,Perlis,50770,29713,21057,Thailand
67857,4/1/2023,THA,Pulau Pinang,2532,1007,1525,Thailand
67858,4/1/2023,THA,Sabah,64,27,37,Thailand
67859,4/1/2023,THA,Sarawak,426,162,264,Thailand
67860,4/1/2023,THA,Selangor,13420,5257,8163,Thailand
67861,4/1/2023,THA,Terengganu,0,0,0,Thailand
67862,4/1/2023,THA,W.P. Labuan,12,9,3,Thailand
67863,4/1/2023,TJK,Johor,2,2,0,Tajikistan
67864,4/1/2023,TJK,Kedah,0,0,0,Tajikistan
67865,4/1/2023,TJK,Perlis,0,0,0,Tajikistan
67866,4/1/2023,TJK,Pulau Pinang,0,0,0,Tajikistan
67867,4/1/2023,TJK,Sabah,0,0,0,Tajikistan
67868,4/1/2023,TJK,Selangor,40,31,9,Tajikistan
67869,4/1/2023,TKL,Selangor,0,0,0,Tokelau
67870,4/1/2023,TKM,Johor,2,1,1,Turkmenistan
67871,4/1/2023,TKM,Kedah,0,0,0,Turkmenistan
67872,4/1/2023,TKM,Kelantan,0,0,0,Turkmenistan
67873,4/1/2023,TKM,Perlis,0,0,0,Turkmenistan
67874,4/1/2023,TKM,Pulau Pinang,0,0,0,Turkmenistan
67875,4/1/2023,TKM,Sabah,0,0,0,Turkmenistan
67876,4/1/2023,TKM,Sarawak,1,1,0,Turkmenistan
67877,4/1/2023,TKM,Selangor,48,28,20,Turkmenistan
67878,4/1/2023,TLS,Johor,0,0,0,Timor-Leste
67879,4/1/2023,TLS,Kedah,1,1,0,Timor-Leste
67880,4/1/2023,TLS,Perlis,0,0,0,Timor-Leste
67881,4/1/2023,TLS,Pulau Pinang,3,1,2,Timor-Leste
67882,4/1/2023,TLS,Sabah,0,0,0,Timor-Leste
67883,4/1/2023,TLS,Sarawak,1,1,0,Timor-Leste
67884,4/1/2023,TLS,Selangor,162,80,82,Timor-Leste
67885,4/1/2023,TON,Johor,0,0,0,Tonga
67886,4/1/2023,TON,Pulau Pinang,3,1,2,Tonga
67887,4/1/2023,TON,Sarawak,0,0,0,Tonga
67888,4/1/2023,TON,Selangor,11,6,5,Tonga
67889,4/1/2023,TTO,Johor,10,6,4,Trinidad and Tobago
67890,4/1/2023,TTO,Kedah,0,0,0,Trinidad and Tobago
67891,4/1/2023,TTO,Pahang,0,0,0,Trinidad and Tobago
67892,4/1/2023,TTO,Pulau Pinang,4,2,2,Trinidad and Tobago
67893,4/1/2023,TTO,Sabah,1,1,0,Trinidad and Tobago
67894,4/1/2023,TTO,Sarawak,1,1,0,Trinidad and Tobago
67895,4/1/2023,TTO,Selangor,25,13,12,Trinidad and Tobago
67896,4/1/2023,TUN,Johor,16,7,9,Tunisia
67897,4/1/2023,TUN,Kedah,9,7,2,Tunisia
67898,4/1/2023,TUN,Kelantan,0,0,0,Tunisia
67899,4/1/2023,TUN,Melaka,0,0,0,Tunisia
67900,4/1/2023,TUN,Perak,0,0,0,Tunisia
67901,4/1/2023,TUN,Perlis,0,0,0,Tunisia
67902,4/1/2023,TUN,Pulau Pinang,1,1,0,Tunisia
67903,4/1/2023,TUN,Sabah,4,4,0,Tunisia
67904,4/1/2023,TUN,Sarawak,2,1,1,Tunisia
67905,4/1/2023,TUN,Selangor,199,107,92,Tunisia
67906,4/1/2023,TUN,W.P. Labuan,0,0,0,Tunisia
67907,4/1/2023,TUR,Johor,223,153,70,Turkey
67908,4/1/2023,TUR,Kedah,53,30,23,Turkey
67909,4/1/2023,TUR,Kelantan,4,4,0,Turkey
67910,4/1/2023,TUR,Melaka,0,0,0,Turkey
67911,4/1/2023,TUR,Negeri Sembilan,0,0,0,Turkey
67912,4/1/2023,TUR,Pahang,0,0,0,Turkey
67913,4/1/2023,TUR,Perak,0,0,0,Turkey
67914,4/1/2023,TUR,Perlis,18,16,2,Turkey
67915,4/1/2023,TUR,Pulau Pinang,30,21,9,Turkey
67916,4/1/2023,TUR,Sabah,13,8,5,Turkey
67917,4/1/2023,TUR,Sarawak,24,19,5,Turkey
67918,4/1/2023,TUR,Selangor,1143,767,376,Turkey
67919,4/1/2023,TUR,W.P. Labuan,0,0,0,Turkey
67920,4/1/2023,TUV,Selangor,0,0,0,Tuvalu
67921,4/1/2023,TWN,Johor,5061,2205,2856,Taiwan
67922,4/1/2023,TWN,Kedah,166,74,92,Taiwan
67923,4/1/2023,TWN,Kelantan,1,0,1,Taiwan
67924,4/1/2023,TWN,Melaka,10,2,8,Taiwan
67925,4/1/2023,TWN,Negeri Sembilan,0,0,0,Taiwan
67926,4/1/2023,TWN,Pahang,3,1,2,Taiwan
67927,4/1/2023,TWN,Perak,63,35,28,Taiwan
67928,4/1/2023,TWN,Perlis,12,2,10,Taiwan
67929,4/1/2023,TWN,Pulau Pinang,2989,1442,1547,Taiwan
67930,4/1/2023,TWN,Sabah,1895,913,982,Taiwan
67931,4/1/2023,TWN,Sarawak,307,138,169,Taiwan
67932,4/1/2023,TWN,Selangor,12359,5939,6420,Taiwan
67933,4/1/2023,TWN,W.P. Labuan,13,6,7,Taiwan
67934,4/1/2023,TZA,Johor,2,1,1,"Tanzania, United Republic of"
67935,4/1/2023,TZA,Kedah,0,0,0,"Tanzania, United Republic of"
67936,4/1/2023,TZA,Perak,0,0,0,"Tanzania, United Republic of"
67937,4/1/2023,TZA,Perlis,0,0,0,"Tanzania, United Republic of"
67938,4/1/2023,TZA,Pulau Pinang,0,0,0,"Tanzania, United Republic of"
67939,4/1/2023,TZA,Sabah,1,0,1,"Tanzania, United Republic of"
67940,4/1/2023,TZA,Sarawak,3,3,0,"Tanzania, United Republic of"
67941,4/1/2023,TZA,Selangor,101,47,54,"Tanzania, United Republic of"
67942,4/1/2023,UGA,Johor,8,2,6,Uganda
67943,4/1/2023,UGA,Kedah,0,0,0,Uganda
67944,4/1/2023,UGA,Perak,0,0,0,Uganda
67945,4/1/2023,UGA,Perlis,1,0,1,Uganda
67946,4/1/2023,UGA,Pulau Pinang,0,0,0,Uganda
67947,4/1/2023,UGA,Sabah,1,1,0,Uganda
67948,4/1/2023,UGA,Sarawak,0,0,0,Uganda
67949,4/1/2023,UGA,Selangor,80,29,51,Uganda
67950,4/1/2023,UKR,Johor,85,40,45,Ukraine
67951,4/1/2023,UKR,Kedah,47,17,30,Ukraine
67952,4/1/2023,UKR,Kelantan,10,7,3,Ukraine
67953,4/1/2023,UKR,Melaka,1,1,0,Ukraine
67954,4/1/2023,UKR,Negeri Sembilan,0,0,0,Ukraine
67955,4/1/2023,UKR,Pahang,1,1,0,Ukraine
67956,4/1/2023,UKR,Perak,5,3,2,Ukraine
67957,4/1/2023,UKR,Perlis,13,8,5,Ukraine
67958,4/1/2023,UKR,Pulau Pinang,19,7,12,Ukraine
67959,4/1/2023,UKR,Sabah,18,12,6,Ukraine
67960,4/1/2023,UKR,Sarawak,8,7,1,Ukraine
67961,4/1/2023,UKR,Selangor,1100,465,635,Ukraine
67962,4/1/2023,UKR,W.P. Labuan,0,0,0,Ukraine
67963,4/1/2023,URY,Johor,16,10,6,Uruguay
67964,4/1/2023,URY,Kedah,1,1,0,Uruguay
67965,4/1/2023,URY,Kelantan,0,0,0,Uruguay
67966,4/1/2023,URY,Perak,0,0,0,Uruguay
67967,4/1/2023,URY,Perlis,0,0,0,Uruguay
67968,4/1/2023,URY,Pulau Pinang,0,0,0,Uruguay
67969,4/1/2023,URY,Sabah,2,1,1,Uruguay
67970,4/1/2023,URY,Sarawak,0,0,0,Uruguay
67971,4/1/2023,URY,Selangor,186,77,109,Uruguay
67972,4/1/2023,URY,W.P. Labuan,0,0,0,Uruguay
67973,4/1/2023,USA,Johor,3763,2235,1528,United States Of America
67974,4/1/2023,USA,Kedah,621,345,276,United States Of America
67975,4/1/2023,USA,Kelantan,15,6,9,United States Of America
67976,4/1/2023,USA,Melaka,1,0,1,United States Of America
67977,4/1/2023,USA,Negeri Sembilan,1,1,0,United States Of America
67978,4/1/2023,USA,Pahang,13,8,5,United States Of America
67979,4/1/2023,USA,Perak,115,55,60,United States Of America
67980,4/1/2023,USA,Perlis,113,70,43,United States Of America
67981,4/1/2023,USA,Pulau Pinang,1684,1023,661,United States Of America
67982,4/1/2023,USA,Sabah,671,336,335,United States Of America
67983,4/1/2023,USA,Sarawak,293,168,125,United States Of America
67984,4/1/2023,USA,Selangor,11293,6612,4681,United States Of America
67985,4/1/2023,USA,Terengganu,0,0,0,United States Of America
67986,4/1/2023,USA,W.P. Labuan,9,3,6,United States Of America
67987,4/1/2023,UZB,Johor,83,73,10,Uzbekistan
67988,4/1/2023,UZB,Kedah,14,6,8,Uzbekistan
67989,4/1/2023,UZB,Kelantan,0,0,0,Uzbekistan
67990,4/1/2023,UZB,Perak,0,0,0,Uzbekistan
67991,4/1/2023,UZB,Perlis,2,1,1,Uzbekistan
67992,4/1/2023,UZB,Pulau Pinang,9,2,7,Uzbekistan
67993,4/1/2023,UZB,Sabah,5,4,1,Uzbekistan
67994,4/1/2023,UZB,Sarawak,1,0,1,Uzbekistan
67995,4/1/2023,UZB,Selangor,668,387,281,Uzbekistan
67996,4/1/2023,VAT,Johor,0,0,0,Holy See (Vatican City State)
67997,4/1/2023,VAT,Sarawak,0,0,0,Holy See (Vatican City State)
67998,4/1/2023,VAT,Selangor,0,0,0,Holy See (Vatican City State)
67999,4/1/2023,VCT,Johor,0,0,0,Saint Vincent and the Grenadines
68000,4/1/2023,VCT,Kedah,0,0,0,Saint Vincent and the Grenadines
68001,4/1/2023,VCT,Pulau Pinang,0,0,0,Saint Vincent and the Grenadines
68002,4/1/2023,VCT,Sarawak,2,2,0,Saint Vincent and the Grenadines
68003,4/1/2023,VCT,Selangor,1,1,0,Saint Vincent and the Grenadines
68004,4/1/2023,VEN,Johor,5,3,2,Venezuela
68005,4/1/2023,VEN,Kedah,6,2,4,Venezuela
68006,4/1/2023,VEN,Kelantan,0,0,0,Venezuela
68007,4/1/2023,VEN,Melaka,0,0,0,Venezuela
68008,4/1/2023,VEN,Perak,0,0,0,Venezuela
68009,4/1/2023,VEN,Perlis,0,0,0,Venezuela
68010,4/1/2023,VEN,Pulau Pinang,1,1,0,Venezuela
68011,4/1/2023,VEN,Sabah,3,2,1,Venezuela
68012,4/1/2023,VEN,Sarawak,7,6,1,Venezuela
68013,4/1/2023,VEN,Selangor,77,43,34,Venezuela
68014,4/1/2023,VEN,W.P. Labuan,0,0,0,Venezuela
68015,4/1/2023,VNM,Johor,12560,3972,8588,Vietnam
68016,4/1/2023,VNM,Kedah,436,58,378,Vietnam
68017,4/1/2023,VNM,Kelantan,8,1,7,Vietnam
68018,4/1/2023,VNM,Melaka,1,1,0,Vietnam
68019,4/1/2023,VNM,Negeri Sembilan,0,0,0,Vietnam
68020,4/1/2023,VNM,Pahang,1,0,1,Vietnam
68021,4/1/2023,VNM,Perak,163,10,153,Vietnam
68022,4/1/2023,VNM,Perlis,244,29,215,Vietnam
68023,4/1/2023,VNM,Pulau Pinang,1380,429,951,Vietnam
68024,4/1/2023,VNM,Sabah,38,13,25,Vietnam
68025,4/1/2023,VNM,Sarawak,210,35,175,Vietnam
68026,4/1/2023,VNM,Selangor,14699,5375,9324,Vietnam
68027,4/1/2023,VNM,Terengganu,0,0,0,Vietnam
68028,4/1/2023,VNM,W.P. Labuan,2,1,1,Vietnam
68029,4/1/2023,VUT,Johor,23,20,3,Vanuatu
68030,4/1/2023,VUT,Kedah,2,1,1,Vanuatu
68031,4/1/2023,VUT,Pulau Pinang,4,4,0,Vanuatu
68032,4/1/2023,VUT,Sabah,1,1,0,Vanuatu
68033,4/1/2023,VUT,Sarawak,0,0,0,Vanuatu
68034,4/1/2023,VUT,Selangor,57,46,11,Vanuatu
68035,4/1/2023,WSM,Johor,1,0,1,Samoa
68036,4/1/2023,WSM,Sarawak,0,0,0,Samoa
68037,4/1/2023,WSM,Selangor,3,1,2,Samoa
68038,4/1/2023,YEM,Johor,33,24,9,Yemen
68039,4/1/2023,YEM,Kedah,2,2,0,Yemen
68040,4/1/2023,YEM,Kelantan,1,1,0,Yemen
68041,4/1/2023,YEM,Melaka,0,0,0,Yemen
68042,4/1/2023,YEM,Pahang,1,1,0,Yemen
68043,4/1/2023,YEM,Perak,1,1,0,Yemen
68044,4/1/2023,YEM,Perlis,1,1,0,Yemen
68045,4/1/2023,YEM,Pulau Pinang,1,1,0,Yemen
68046,4/1/2023,YEM,Sabah,1,1,0,Yemen
68047,4/1/2023,YEM,Sarawak,2,1,1,Yemen
68048,4/1/2023,YEM,Selangor,916,621,295,Yemen
68049,4/1/2023,YEM,W.P. Labuan,0,0,0,Yemen
68050,4/1/2023,ZAF,Johor,312,183,129,South Africa
68051,4/1/2023,ZAF,Kedah,89,40,49,South Africa
68052,4/1/2023,ZAF,Kelantan,2,1,1,South Africa
68053,4/1/2023,ZAF,Melaka,0,0,0,South Africa
68054,4/1/2023,ZAF,Pahang,2,2,0,South Africa
68055,4/1/2023,ZAF,Perak,1,1,0,South Africa
68056,4/1/2023,ZAF,Perlis,8,6,2,South Africa
68057,4/1/2023,ZAF,Pulau Pinang,46,22,24,South Africa
68058,4/1/2023,ZAF,Sabah,30,16,14,South Africa
68059,4/1/2023,ZAF,Sarawak,164,82,82,South Africa
68060,4/1/2023,ZAF,Selangor,1002,491,511,South Africa
68061,4/1/2023,ZAF,Terengganu,0,0,0,South Africa
68062,4/1/2023,ZAF,W.P. Labuan,7,4,3,South Africa
68063,4/1/2023,ZMB,Johor,1,1,0,Zambia
68064,4/1/2023,ZMB,Kedah,0,0,0,Zambia
68065,4/1/2023,ZMB,Perak,0,0,0,Zambia
68066,4/1/2023,ZMB,Perlis,0,0,0,Zambia
68067,4/1/2023,ZMB,Pulau Pinang,1,1,0,Zambia
68068,4/1/2023,ZMB,Sabah,0,0,0,Zambia
68069,4/1/2023,ZMB,Sarawak,2,2,0,Zambia
68070,4/1/2023,ZMB,Selangor,41,26,15,Zambia
68071,4/1/2023,ZWE,Johor,8,5,3,Zimbabwe
68072,4/1/2023,ZWE,Kedah,1,0,1,Zimbabwe
68073,4/1/2023,ZWE,Kelantan,0,0,0,Zimbabwe
68074,4/1/2023,ZWE,Perak,0,0,0,Zimbabwe
68075,4/1/2023,ZWE,Perlis,1,1,0,Zimbabwe
68076,4/1/2023,ZWE,Pulau Pinang,1,0,1,Zimbabwe
68077,4/1/2023,ZWE,Sabah,0,0,0,Zimbabwe
68078,4/1/2023,ZWE,Sarawak,0,0,0,Zimbabwe
68079,4/1/2023,ZWE,Selangor,94,40,54,Zimbabwe
68080,5/1/2023,ABW,Kedah,0,0,0,Aruba
68081,5/1/2023,ABW,Pulau Pinang,0,0,0,Aruba
68082,5/1/2023,AFG,Johor,2,2,0,Afghanistan
68083,5/1/2023,AFG,Kedah,1,1,0,Afghanistan
68084,5/1/2023,AFG,Perlis,0,0,0,Afghanistan
68085,5/1/2023,AFG,Pulau Pinang,0,0,0,Afghanistan
68086,5/1/2023,AFG,Sarawak,0,0,0,Afghanistan
68087,5/1/2023,AFG,Selangor,51,35,16,Afghanistan
68088,5/1/2023,AGO,Johor,0,0,0,Angola
68089,5/1/2023,AGO,Kedah,0,0,0,Angola
68090,5/1/2023,AGO,Sabah,0,0,0,Angola
68091,5/1/2023,AGO,Selangor,6,5,1,Angola
68092,5/1/2023,AIA,Selangor,0,0,0,Anguilla
68093,5/1/2023,ALB,Johor,17,13,4,Albania
68094,5/1/2023,ALB,Kedah,1,0,1,Albania
68095,5/1/2023,ALB,Perak,0,0,0,Albania
68096,5/1/2023,ALB,Perlis,0,0,0,Albania
68097,5/1/2023,ALB,Pulau Pinang,2,0,2,Albania
68098,5/1/2023,ALB,Sabah,0,0,0,Albania
68099,5/1/2023,ALB,Sarawak,0,0,0,Albania
68100,5/1/2023,ALB,Selangor,27,21,6,Albania
68101,5/1/2023,AND,Johor,0,0,0,Andorra
68102,5/1/2023,AND,Kedah,0,0,0,Andorra
68103,5/1/2023,AND,Perlis,0,0,0,Andorra
68104,5/1/2023,AND,Pulau Pinang,1,1,0,Andorra
68105,5/1/2023,AND,Selangor,2,1,1,Andorra
68106,5/1/2023,ANT,Selangor,0,0,0,Netherlands Antilles
68107,5/1/2023,ARE,Johor,14,10,4,United Arab Emirates
68108,5/1/2023,ARE,Kedah,81,78,3,United Arab Emirates
68109,5/1/2023,ARE,Kelantan,0,0,0,United Arab Emirates
68110,5/1/2023,ARE,Perak,0,0,0,United Arab Emirates
68111,5/1/2023,ARE,Perlis,0,0,0,United Arab Emirates
68112,5/1/2023,ARE,Pulau Pinang,0,0,0,United Arab Emirates
68113,5/1/2023,ARE,Sabah,0,0,0,United Arab Emirates
68114,5/1/2023,ARE,Sarawak,2,2,0,United Arab Emirates
68115,5/1/2023,ARE,Selangor,509,363,146,United Arab Emirates
68116,5/1/2023,ARG,Johor,64,39,25,Argentina
68117,5/1/2023,ARG,Kedah,36,14,22,Argentina
68118,5/1/2023,ARG,Kelantan,0,0,0,Argentina
68119,5/1/2023,ARG,Melaka,0,0,0,Argentina
68120,5/1/2023,ARG,Perak,2,1,1,Argentina
68121,5/1/2023,ARG,Perlis,10,6,4,Argentina
68122,5/1/2023,ARG,Pulau Pinang,4,1,3,Argentina
68123,5/1/2023,ARG,Sabah,3,2,1,Argentina
68124,5/1/2023,ARG,Sarawak,3,2,1,Argentina
68125,5/1/2023,ARG,Selangor,335,181,154,Argentina
68126,5/1/2023,ARG,W.P. Labuan,0,0,0,Argentina
68127,5/1/2023,ARM,Johor,19,4,15,Armenia
68128,5/1/2023,ARM,Kedah,0,0,0,Armenia
68129,5/1/2023,ARM,Kelantan,0,0,0,Armenia
68130,5/1/2023,ARM,Perak,0,0,0,Armenia
68131,5/1/2023,ARM,Perlis,0,0,0,Armenia
68132,5/1/2023,ARM,Pulau Pinang,4,2,2,Armenia
68133,5/1/2023,ARM,Sabah,1,1,0,Armenia
68134,5/1/2023,ARM,Sarawak,0,0,0,Armenia
68135,5/1/2023,ARM,Selangor,48,28,20,Armenia
68136,5/1/2023,ATA,Selangor,0,0,0,Antarctica
68137,5/1/2023,ATG,Johor,5,5,0,Antigua and Barbuda
68138,5/1/2023,ATG,Kedah,0,0,0,Antigua and Barbuda
68139,5/1/2023,ATG,Pulau Pinang,0,0,0,Antigua and Barbuda
68140,5/1/2023,ATG,Sarawak,0,0,0,Antigua and Barbuda
68141,5/1/2023,ATG,Selangor,9,7,2,Antigua and Barbuda
68142,5/1/2023,AUS,Johor,4250,2490,1760,Australia
68143,5/1/2023,AUS,Kedah,459,271,188,Australia
68144,5/1/2023,AUS,Kelantan,30,24,6,Australia
68145,5/1/2023,AUS,Melaka,2,1,1,Australia
68146,5/1/2023,AUS,Negeri Sembilan,1,1,0,Australia
68147,5/1/2023,AUS,Pahang,13,10,3,Australia
68148,5/1/2023,AUS,Perak,158,81,77,Australia
68149,5/1/2023,AUS,Perlis,59,32,27,Australia
68150,5/1/2023,AUS,Pulau Pinang,1621,872,749,Australia
68151,5/1/2023,AUS,Sabah,390,204,186,Australia
68152,5/1/2023,AUS,Sarawak,575,315,260,Australia
68153,5/1/2023,AUS,Selangor,18192,10579,7613,Australia
68154,5/1/2023,AUS,Terengganu,0,0,0,Australia
68155,5/1/2023,AUS,W.P. Labuan,7,2,5,Australia
68156,5/1/2023,AUT,Johor,138,94,44,Austria
68157,5/1/2023,AUT,Kedah,46,28,18,Austria
68158,5/1/2023,AUT,Kelantan,4,2,2,Austria
68159,5/1/2023,AUT,Melaka,0,0,0,Austria
68160,5/1/2023,AUT,Negeri Sembilan,0,0,0,Austria
68161,5/1/2023,AUT,Pahang,1,1,0,Austria
68162,5/1/2023,AUT,Perak,3,2,1,Austria
68163,5/1/2023,AUT,Perlis,11,7,4,Austria
68164,5/1/2023,AUT,Pulau Pinang,72,56,16,Austria
68165,5/1/2023,AUT,Sabah,9,2,7,Austria
68166,5/1/2023,AUT,Sarawak,44,24,20,Austria
68167,5/1/2023,AUT,Selangor,742,455,287,Austria
68168,5/1/2023,AUT,Terengganu,0,0,0,Austria
68169,5/1/2023,AUT,W.P. Labuan,0,0,0,Austria
68170,5/1/2023,AZE,Johor,5,1,4,Azerbaijan
68171,5/1/2023,AZE,Kedah,2,1,1,Azerbaijan
68172,5/1/2023,AZE,Kelantan,0,0,0,Azerbaijan
68173,5/1/2023,AZE,Melaka,0,0,0,Azerbaijan
68174,5/1/2023,AZE,Perlis,0,0,0,Azerbaijan
68175,5/1/2023,AZE,Pulau Pinang,0,0,0,Azerbaijan
68176,5/1/2023,AZE,Sabah,0,0,0,Azerbaijan
68177,5/1/2023,AZE,Sarawak,1,0,1,Azerbaijan
68178,5/1/2023,AZE,Selangor,119,75,44,Azerbaijan
68179,5/1/2023,AZE,W.P. Labuan,0,0,0,Azerbaijan
68180,5/1/2023,BDI,Pulau Pinang,0,0,0,Burundi
68181,5/1/2023,BDI,Sarawak,0,0,0,Burundi
68182,5/1/2023,BDI,Selangor,2,1,1,Burundi
68183,5/1/2023,BEL,Johor,242,133,109,Belgium
68184,5/1/2023,BEL,Kedah,84,45,39,Belgium
68185,5/1/2023,BEL,Kelantan,1,1,0,Belgium
68186,5/1/2023,BEL,Melaka,0,0,0,Belgium
68187,5/1/2023,BEL,Negeri Sembilan,0,0,0,Belgium
68188,5/1/2023,BEL,Pahang,0,0,0,Belgium
68189,5/1/2023,BEL,Perak,0,0,0,Belgium
68190,5/1/2023,BEL,Perlis,13,7,6,Belgium
68191,5/1/2023,BEL,Pulau Pinang,50,37,13,Belgium
68192,5/1/2023,BEL,Sabah,17,10,7,Belgium
68193,5/1/2023,BEL,Sarawak,25,12,13,Belgium
68194,5/1/2023,BEL,Selangor,1019,633,386,Belgium
68195,5/1/2023,BEL,W.P. Labuan,3,2,1,Belgium
68196,5/1/2023,BEN,Johor,0,0,0,Benin
68197,5/1/2023,BEN,Kedah,0,0,0,Benin
68198,5/1/2023,BEN,Perak,0,0,0,Benin
68199,5/1/2023,BEN,Pulau Pinang,0,0,0,Benin
68200,5/1/2023,BEN,Sabah,0,0,0,Benin
68201,5/1/2023,BEN,Sarawak,0,0,0,Benin
68202,5/1/2023,BEN,Selangor,12,9,3,Benin
68203,5/1/2023,BFA,Perak,0,0,0,Burkina Faso
68204,5/1/2023,BFA,Pulau Pinang,0,0,0,Burkina Faso
68205,5/1/2023,BFA,Selangor,14,13,1,Burkina Faso
68206,5/1/2023,BGD,Johor,2602,2243,359,Bangladesh
68207,5/1/2023,BGD,Kedah,37,25,12,Bangladesh
68208,5/1/2023,BGD,Kelantan,0,0,0,Bangladesh
68209,5/1/2023,BGD,Melaka,0,0,0,Bangladesh
68210,5/1/2023,BGD,Negeri Sembilan,0,0,0,Bangladesh
68211,5/1/2023,BGD,Pahang,0,0,0,Bangladesh
68212,5/1/2023,BGD,Perak,1,1,0,Bangladesh
68213,5/1/2023,BGD,Perlis,2,2,0,Bangladesh
68214,5/1/2023,BGD,Pulau Pinang,680,661,19,Bangladesh
68215,5/1/2023,BGD,Sabah,3,1,2,Bangladesh
68216,5/1/2023,BGD,Sarawak,50,45,5,Bangladesh
68217,5/1/2023,BGD,Selangor,45160,43891,1269,Bangladesh
68218,5/1/2023,BGD,W.P. Labuan,15,14,1,Bangladesh
68219,5/1/2023,BGR,Johor,50,32,18,Bulgaria
68220,5/1/2023,BGR,Kedah,4,2,2,Bulgaria
68221,5/1/2023,BGR,Kelantan,2,1,1,Bulgaria
68222,5/1/2023,BGR,Pahang,0,0,0,Bulgaria
68223,5/1/2023,BGR,Perak,0,0,0,Bulgaria
68224,5/1/2023,BGR,Perlis,0,0,0,Bulgaria
68225,5/1/2023,BGR,Pulau Pinang,6,4,2,Bulgaria
68226,5/1/2023,BGR,Sabah,0,0,0,Bulgaria
68227,5/1/2023,BGR,Sarawak,0,0,0,Bulgaria
68228,5/1/2023,BGR,Selangor,191,105,86,Bulgaria
68229,5/1/2023,BGR,W.P. Labuan,0,0,0,Bulgaria
68230,5/1/2023,BHR,Johor,6,3,3,Bahrain
68231,5/1/2023,BHR,Kedah,0,0,0,Bahrain
68232,5/1/2023,BHR,Kelantan,0,0,0,Bahrain
68233,5/1/2023,BHR,Perlis,0,0,0,Bahrain
68234,5/1/2023,BHR,Pulau Pinang,0,0,0,Bahrain
68235,5/1/2023,BHR,Sabah,0,0,0,Bahrain
68236,5/1/2023,BHR,Sarawak,0,0,0,Bahrain
68237,5/1/2023,BHR,Selangor,120,68,52,Bahrain
68238,5/1/2023,BHS,Johor,1,1,0,Bahamas
68239,5/1/2023,BHS,Kedah,0,0,0,Bahamas
68240,5/1/2023,BHS,Perak,0,0,0,Bahamas
68241,5/1/2023,BHS,Sabah,0,0,0,Bahamas
68242,5/1/2023,BHS,Sarawak,0,0,0,Bahamas
68243,5/1/2023,BHS,Selangor,9,6,3,Bahamas
68244,5/1/2023,BIH,Johor,13,9,4,Bosnia and Herzegovina
68245,5/1/2023,BIH,Kedah,0,0,0,Bosnia and Herzegovina
68246,5/1/2023,BIH,Perlis,0,0,0,Bosnia and Herzegovina
68247,5/1/2023,BIH,Pulau Pinang,2,2,0,Bosnia and Herzegovina
68248,5/1/2023,BIH,Sabah,0,0,0,Bosnia and Herzegovina
68249,5/1/2023,BIH,Sarawak,2,2,0,Bosnia and Herzegovina
68250,5/1/2023,BIH,Selangor,46,25,21,Bosnia and Herzegovina
68251,5/1/2023,BLR,Johor,10,4,6,Belarus
68252,5/1/2023,BLR,Kedah,10,6,4,Belarus
68253,5/1/2023,BLR,Kelantan,0,0,0,Belarus
68254,5/1/2023,BLR,Pahang,0,0,0,Belarus
68255,5/1/2023,BLR,Perak,0,0,0,Belarus
68256,5/1/2023,BLR,Perlis,3,3,0,Belarus
68257,5/1/2023,BLR,Pulau Pinang,3,2,1,Belarus
68258,5/1/2023,BLR,Sabah,0,0,0,Belarus
68259,5/1/2023,BLR,Sarawak,1,0,1,Belarus
68260,5/1/2023,BLR,Selangor,364,175,189,Belarus
68261,5/1/2023,BLR,W.P. Labuan,0,0,0,Belarus
68262,5/1/2023,BLZ,Johor,3,0,3,Belize
68263,5/1/2023,BLZ,Pulau Pinang,0,0,0,Belize
68264,5/1/2023,BLZ,Sarawak,0,0,0,Belize
68265,5/1/2023,BLZ,Selangor,6,2,4,Belize
68266,5/1/2023,BMU,Selangor,0,0,0,Bermuda
68267,5/1/2023,BOL,Johor,1,0,1,Bolivia
68268,5/1/2023,BOL,Kedah,1,1,0,Bolivia
68269,5/1/2023,BOL,Melaka,0,0,0,Bolivia
68270,5/1/2023,BOL,Perak,0,0,0,Bolivia
68271,5/1/2023,BOL,Perlis,0,0,0,Bolivia
68272,5/1/2023,BOL,Pulau Pinang,0,0,0,Bolivia
68273,5/1/2023,BOL,Sabah,1,1,0,Bolivia
68274,5/1/2023,BOL,Sarawak,0,0,0,Bolivia
68275,5/1/2023,BOL,Selangor,38,26,12,Bolivia
68276,5/1/2023,BRA,Johor,208,122,86,Brazil
68277,5/1/2023,BRA,Kedah,83,40,43,Brazil
68278,5/1/2023,BRA,Kelantan,0,0,0,Brazil
68279,5/1/2023,BRA,Melaka,0,0,0,Brazil
68280,5/1/2023,BRA,Pahang,0,0,0,Brazil
68281,5/1/2023,BRA,Perak,2,2,0,Brazil
68282,5/1/2023,BRA,Perlis,7,4,3,Brazil
68283,5/1/2023,BRA,Pulau Pinang,31,12,19,Brazil
68284,5/1/2023,BRA,Sabah,21,12,9,Brazil
68285,5/1/2023,BRA,Sarawak,7,4,3,Brazil
68286,5/1/2023,BRA,Selangor,772,463,309,Brazil
68287,5/1/2023,BRA,W.P. Labuan,0,0,0,Brazil
68288,5/1/2023,BRB,Johor,0,0,0,Barbados
68289,5/1/2023,BRB,Kedah,0,0,0,Barbados
68290,5/1/2023,BRB,Perlis,0,0,0,Barbados
68291,5/1/2023,BRB,Pulau Pinang,0,0,0,Barbados
68292,5/1/2023,BRB,Selangor,6,3,3,Barbados
68293,5/1/2023,BRN,Johor,330,185,145,Brunei Darussalam
68294,5/1/2023,BRN,Kedah,22,10,12,Brunei Darussalam
68295,5/1/2023,BRN,Kelantan,6,3,3,Brunei Darussalam
68296,5/1/2023,BRN,Melaka,0,0,0,Brunei Darussalam
68297,5/1/2023,BRN,Pahang,0,0,0,Brunei Darussalam
68298,5/1/2023,BRN,Perak,4,1,3,Brunei Darussalam
68299,5/1/2023,BRN,Perlis,5,2,3,Brunei Darussalam
68300,5/1/2023,BRN,Pulau Pinang,11,7,4,Brunei Darussalam
68301,5/1/2023,BRN,Sabah,729,303,426,Brunei Darussalam
68302,5/1/2023,BRN,Sarawak,84510,47743,36767,Brunei Darussalam
68303,5/1/2023,BRN,Selangor,3820,1898,1922,Brunei Darussalam
68304,5/1/2023,BRN,W.P. Labuan,1202,764,438,Brunei Darussalam
68305,5/1/2023,BTN,Johor,6,5,1,Bhutan
68306,5/1/2023,BTN,Kedah,0,0,0,Bhutan
68307,5/1/2023,BTN,Perak,0,0,0,Bhutan
68308,5/1/2023,BTN,Perlis,0,0,0,Bhutan
68309,5/1/2023,BTN,Pulau Pinang,1,1,0,Bhutan
68310,5/1/2023,BTN,Sabah,0,0,0,Bhutan
68311,5/1/2023,BTN,Sarawak,0,0,0,Bhutan
68312,5/1/2023,BTN,Selangor,35,27,8,Bhutan
68313,5/1/2023,BWA,Johor,0,0,0,Botswana
68314,5/1/2023,BWA,Kedah,0,0,0,Botswana
68315,5/1/2023,BWA,Perlis,0,0,0,Botswana
68316,5/1/2023,BWA,Pulau Pinang,0,0,0,Botswana
68317,5/1/2023,BWA,Sabah,0,0,0,Botswana
68318,5/1/2023,BWA,Sarawak,2,2,0,Botswana
68319,5/1/2023,BWA,Selangor,10,3,7,Botswana
68320,5/1/2023,CAF,Kedah,0,0,0,Central African Republic
68321,5/1/2023,CAF,Selangor,1,1,0,Central African Republic
68322,5/1/2023,CAN,Johor,1363,758,605,Canada
68323,5/1/2023,CAN,Kedah,160,88,72,Canada
68324,5/1/2023,CAN,Kelantan,11,8,3,Canada
68325,5/1/2023,CAN,Melaka,0,0,0,Canada
68326,5/1/2023,CAN,Negeri Sembilan,0,0,0,Canada
68327,5/1/2023,CAN,Pahang,0,0,0,Canada
68328,5/1/2023,CAN,Perak,31,16,15,Canada
68329,5/1/2023,CAN,Perlis,67,30,37,Canada
68330,5/1/2023,CAN,Pulau Pinang,416,237,179,Canada
68331,5/1/2023,CAN,Sabah,171,79,92,Canada
68332,5/1/2023,CAN,Sarawak,488,255,233,Canada
68333,5/1/2023,CAN,Selangor,3929,2222,1707,Canada
68334,5/1/2023,CAN,Terengganu,0,0,0,Canada
68335,5/1/2023,CAN,W.P. Labuan,6,3,3,Canada
68336,5/1/2023,CCK,Selangor,0,0,0,Cocos (Keeling) Islands
68337,5/1/2023,CHE,Johor,324,194,130,Switzerland
68338,5/1/2023,CHE,Kedah,150,79,71,Switzerland
68339,5/1/2023,CHE,Kelantan,0,0,0,Switzerland
68340,5/1/2023,CHE,Melaka,1,0,1,Switzerland
68341,5/1/2023,CHE,Negeri Sembilan,0,0,0,Switzerland
68342,5/1/2023,CHE,Pahang,5,2,3,Switzerland
68343,5/1/2023,CHE,Perak,3,1,2,Switzerland
68344,5/1/2023,CHE,Perlis,35,17,18,Switzerland
68345,5/1/2023,CHE,Pulau Pinang,124,87,37,Switzerland
68346,5/1/2023,CHE,Sabah,56,34,22,Switzerland
68347,5/1/2023,CHE,Sarawak,43,23,20,Switzerland
68348,5/1/2023,CHE,Selangor,1044,646,398,Switzerland
68349,5/1/2023,CHE,W.P. Labuan,2,1,1,Switzerland
68350,5/1/2023,CHL,Johor,21,11,10,Chile
68351,5/1/2023,CHL,Kedah,14,5,9,Chile
68352,5/1/2023,CHL,Kelantan,0,0,0,Chile
68353,5/1/2023,CHL,Melaka,0,0,0,Chile
68354,5/1/2023,CHL,Pahang,0,0,0,Chile
68355,5/1/2023,CHL,Perak,0,0,0,Chile
68356,5/1/2023,CHL,Perlis,4,2,2,Chile
68357,5/1/2023,CHL,Pulau Pinang,4,2,2,Chile
68358,5/1/2023,CHL,Sabah,2,1,1,Chile
68359,5/1/2023,CHL,Sarawak,2,1,1,Chile
68360,5/1/2023,CHL,Selangor,222,123,99,Chile
68361,5/1/2023,CHN,Johor,36806,16137,20669,China
68362,5/1/2023,CHN,Kedah,920,481,439,China
68363,5/1/2023,CHN,Kelantan,11,4,7,China
68364,5/1/2023,CHN,Melaka,2,1,1,China
68365,5/1/2023,CHN,Pahang,45,31,14,China
68366,5/1/2023,CHN,Perak,259,116,143,China
68367,5/1/2023,CHN,Perlis,84,45,39,China
68368,5/1/2023,CHN,Pulau Pinang,7202,4011,3191,China
68369,5/1/2023,CHN,Sabah,11645,5509,6136,China
68370,5/1/2023,CHN,Sarawak,785,360,425,China
68371,5/1/2023,CHN,Selangor,75302,39798,35504,China
68372,5/1/2023,CHN,Terengganu,0,0,0,China
68373,5/1/2023,CHN,W.P. Labuan,75,64,11,China
68374,5/1/2023,CIV,Johor,0,0,0,C��te d'Iv
68375,5/1/2023,CIV,Kedah,0,0,0,C��te d'Iv
68376,5/1/2023,CIV,Pulau Pinang,0,0,0,C��te d'Iv
68377,5/1/2023,CIV,Sabah,0,0,0,C��te d'Iv
68378,5/1/2023,CIV,Sarawak,0,0,0,C��te d'Iv
68379,5/1/2023,CIV,Selangor,37,28,9,C��te d'Iv
68380,5/1/2023,CMR,Johor,1,1,0,Cameroon
68381,5/1/2023,CMR,Kedah,0,0,0,Cameroon
68382,5/1/2023,CMR,Pulau Pinang,0,0,0,Cameroon
68383,5/1/2023,CMR,Sabah,0,0,0,Cameroon
68384,5/1/2023,CMR,Sarawak,0,0,0,Cameroon
68385,5/1/2023,CMR,Selangor,32,21,11,Cameroon
68386,5/1/2023,COD,Johor,0,0,0,"Congo, the Democratic Republic of the"
68387,5/1/2023,COD,Pulau Pinang,0,0,0,"Congo, the Democratic Republic of the"
68388,5/1/2023,COD,Sarawak,0,0,0,"Congo, the Democratic Republic of the"
68389,5/1/2023,COD,Selangor,16,12,4,"Congo, the Democratic Republic of the"
68390,5/1/2023,COG,Johor,0,0,0,Congo
68391,5/1/2023,COG,Kedah,0,0,0,Congo
68392,5/1/2023,COG,Selangor,0,0,0,Congo
68393,5/1/2023,COK,Selangor,0,0,0,Cook Islands
68394,5/1/2023,COL,Johor,29,13,16,Colombia
68395,5/1/2023,COL,Kedah,1,0,1,Colombia
68396,5/1/2023,COL,Perak,0,0,0,Colombia
68397,5/1/2023,COL,Pulau Pinang,7,4,3,Colombia
68398,5/1/2023,COL,Sabah,3,0,3,Colombia
68399,5/1/2023,COL,Sarawak,5,2,3,Colombia
68400,5/1/2023,COL,Selangor,188,91,97,Colombia
68401,5/1/2023,COL,W.P. Labuan,0,0,0,Colombia
68402,5/1/2023,COM,Johor,0,0,0,Comoros
68403,5/1/2023,COM,Kedah,1,1,0,Comoros
68404,5/1/2023,COM,Selangor,3,3,0,Comoros
68405,5/1/2023,CPV,Johor,0,0,0,Cape Verde
68406,5/1/2023,CPV,Kedah,0,0,0,Cape Verde
68407,5/1/2023,CPV,Pulau Pinang,0,0,0,Cape Verde
68408,5/1/2023,CPV,Sabah,0,0,0,Cape Verde
68409,5/1/2023,CPV,Selangor,1,0,1,Cape Verde
68410,5/1/2023,CRI,Johor,3,2,1,Costa Rica
68411,5/1/2023,CRI,Kedah,0,0,0,Costa Rica
68412,5/1/2023,CRI,Perak,0,0,0,Costa Rica
68413,5/1/2023,CRI,Perlis,0,0,0,Costa Rica
68414,5/1/2023,CRI,Pulau Pinang,11,8,3,Costa Rica
68415,5/1/2023,CRI,Sabah,4,2,2,Costa Rica
68416,5/1/2023,CRI,Sarawak,0,0,0,Costa Rica
68417,5/1/2023,CRI,Selangor,44,24,20,Costa Rica
68418,5/1/2023,CUB,Johor,1,1,0,Cuba
68419,5/1/2023,CUB,Kedah,0,0,0,Cuba
68420,5/1/2023,CUB,Perlis,0,0,0,Cuba
68421,5/1/2023,CUB,Pulau Pinang,0,0,0,Cuba
68422,5/1/2023,CUB,Sabah,0,0,0,Cuba
68423,5/1/2023,CUB,Sarawak,0,0,0,Cuba
68424,5/1/2023,CUB,Selangor,31,17,14,Cuba
68425,5/1/2023,CYP,Johor,9,3,6,Cyprus
68426,5/1/2023,CYP,Kedah,1,1,0,Cyprus
68427,5/1/2023,CYP,Perak,0,0,0,Cyprus
68428,5/1/2023,CYP,Perlis,0,0,0,Cyprus
68429,5/1/2023,CYP,Pulau Pinang,1,1,0,Cyprus
68430,5/1/2023,CYP,Sabah,0,0,0,Cyprus
68431,5/1/2023,CYP,Sarawak,0,0,0,Cyprus
68432,5/1/2023,CYP,Selangor,47,32,15,Cyprus
68433,5/1/2023,CZE,Johor,58,39,19,Czech Republic
68434,5/1/2023,CZE,Kedah,33,18,15,Czech Republic
68435,5/1/2023,CZE,Kelantan,0,0,0,Czech Republic
68436,5/1/2023,CZE,Melaka,0,0,0,Czech Republic
68437,5/1/2023,CZE,Negeri Sembilan,0,0,0,Czech Republic
68438,5/1/2023,CZE,Perak,1,1,0,Czech Republic
68439,5/1/2023,CZE,Perlis,4,1,3,Czech Republic
68440,5/1/2023,CZE,Pulau Pinang,16,11,5,Czech Republic
68441,5/1/2023,CZE,Sabah,15,10,5,Czech Republic
68442,5/1/2023,CZE,Sarawak,17,12,5,Czech Republic
68443,5/1/2023,CZE,Selangor,299,189,110,Czech Republic
68444,5/1/2023,CZE,W.P. Labuan,2,1,1,Czech Republic
68445,5/1/2023,DEU,Johor,1735,1109,626,Germany
68446,5/1/2023,DEU,Kedah,546,271,275,Germany
68447,5/1/2023,DEU,Kelantan,16,9,7,Germany
68448,5/1/2023,DEU,Melaka,6,6,0,Germany
68449,5/1/2023,DEU,Negeri Sembilan,1,1,0,Germany
68450,5/1/2023,DEU,Pahang,21,12,9,Germany
68451,5/1/2023,DEU,Perak,41,26,15,Germany
68452,5/1/2023,DEU,Perlis,114,70,44,Germany
68453,5/1/2023,DEU,Pulau Pinang,655,459,196,Germany
68454,5/1/2023,DEU,Sabah,127,68,59,Germany
68455,5/1/2023,DEU,Sarawak,241,135,106,Germany
68456,5/1/2023,DEU,Selangor,7816,4542,3274,Germany
68457,5/1/2023,DEU,Terengganu,0,0,0,Germany
68458,5/1/2023,DEU,W.P. Labuan,12,8,4,Germany
68459,5/1/2023,DJI,Johor,1,1,0,Djibouti
68460,5/1/2023,DJI,Selangor,39,21,18,Djibouti
68461,5/1/2023,DMA,Johor,7,7,0,Dominica
68462,5/1/2023,DMA,Kedah,0,0,0,Dominica
68463,5/1/2023,DMA,Pulau Pinang,2,2,0,Dominica
68464,5/1/2023,DMA,Sabah,0,0,0,Dominica
68465,5/1/2023,DMA,Sarawak,0,0,0,Dominica
68466,5/1/2023,DMA,Selangor,23,21,2,Dominica
68467,5/1/2023,DMA,W.P. Labuan,0,0,0,Dominica
68468,5/1/2023,DNK,Johor,252,181,71,Denmark
68469,5/1/2023,DNK,Kedah,41,26,15,Denmark
68470,5/1/2023,DNK,Kelantan,0,0,0,Denmark
68471,5/1/2023,DNK,Melaka,1,1,0,Denmark
68472,5/1/2023,DNK,Negeri Sembilan,0,0,0,Denmark
68473,5/1/2023,DNK,Pahang,1,1,0,Denmark
68474,5/1/2023,DNK,Perak,0,0,0,Denmark
68475,5/1/2023,DNK,Perlis,6,4,2,Denmark
68476,5/1/2023,DNK,Pulau Pinang,50,36,14,Denmark
68477,5/1/2023,DNK,Sabah,30,15,15,Denmark
68478,5/1/2023,DNK,Sarawak,12,8,4,Denmark
68479,5/1/2023,DNK,Selangor,743,500,243,Denmark
68480,5/1/2023,DNK,W.P. Labuan,2,0,2,Denmark
68481,5/1/2023,DOM,Johor,2,2,0,Dominican Republic
68482,5/1/2023,DOM,Kedah,0,0,0,Dominican Republic
68483,5/1/2023,DOM,Perak,0,0,0,Dominican Republic
68484,5/1/2023,DOM,Perlis,0,0,0,Dominican Republic
68485,5/1/2023,DOM,Pulau Pinang,1,0,1,Dominican Republic
68486,5/1/2023,DOM,Sabah,0,0,0,Dominican Republic
68487,5/1/2023,DOM,Sarawak,0,0,0,Dominican Republic
68488,5/1/2023,DOM,Selangor,19,12,7,Dominican Republic
68489,5/1/2023,DZA,Johor,24,19,5,Algeria
68490,5/1/2023,DZA,Kedah,5,5,0,Algeria
68491,5/1/2023,DZA,Kelantan,0,0,0,Algeria
68492,5/1/2023,DZA,Melaka,0,0,0,Algeria
68493,5/1/2023,DZA,Perak,0,0,0,Algeria
68494,5/1/2023,DZA,Perlis,0,0,0,Algeria
68495,5/1/2023,DZA,Pulau Pinang,1,1,0,Algeria
68496,5/1/2023,DZA,Sabah,4,4,0,Algeria
68497,5/1/2023,DZA,Sarawak,5,4,1,Algeria
68498,5/1/2023,DZA,Selangor,616,403,213,Algeria
68499,5/1/2023,DZA,W.P. Labuan,1,1,0,Algeria
68500,5/1/2023,ECU,Johor,5,1,4,Ecuador
68501,5/1/2023,ECU,Kedah,1,0,1,Ecuador
68502,5/1/2023,ECU,Perak,0,0,0,Ecuador
68503,5/1/2023,ECU,Perlis,0,0,0,Ecuador
68504,5/1/2023,ECU,Pulau Pinang,1,1,0,Ecuador
68505,5/1/2023,ECU,Sabah,0,0,0,Ecuador
68506,5/1/2023,ECU,Sarawak,0,0,0,Ecuador
68507,5/1/2023,ECU,Selangor,53,28,25,Ecuador
68508,5/1/2023,EGY,Johor,201,158,43,Egypt
68509,5/1/2023,EGY,Kedah,13,9,4,Egypt
68510,5/1/2023,EGY,Kelantan,3,1,2,Egypt
68511,5/1/2023,EGY,Melaka,1,1,0,Egypt
68512,5/1/2023,EGY,Pahang,0,0,0,Egypt
68513,5/1/2023,EGY,Perak,0,0,0,Egypt
68514,5/1/2023,EGY,Perlis,2,1,1,Egypt
68515,5/1/2023,EGY,Pulau Pinang,4,3,1,Egypt
68516,5/1/2023,EGY,Sabah,6,6,0,Egypt
68517,5/1/2023,EGY,Sarawak,155,113,42,Egypt
68518,5/1/2023,EGY,Selangor,1735,1299,436,Egypt
68519,5/1/2023,EGY,Terengganu,0,0,0,Egypt
68520,5/1/2023,EGY,W.P. Labuan,1,1,0,Egypt
68521,5/1/2023,ERI,Johor,0,0,0,Eritrea
68522,5/1/2023,ERI,Pulau Pinang,0,0,0,Eritrea
68523,5/1/2023,ERI,Sabah,0,0,0,Eritrea
68524,5/1/2023,ERI,Selangor,3,2,1,Eritrea
68525,5/1/2023,ESP,Johor,393,247,146,Spain
68526,5/1/2023,ESP,Kedah,86,51,35,Spain
68527,5/1/2023,ESP,Kelantan,7,5,2,Spain
68528,5/1/2023,ESP,Melaka,2,2,0,Spain
68529,5/1/2023,ESP,Negeri Sembilan,1,1,0,Spain
68530,5/1/2023,ESP,Pahang,0,0,0,Spain
68531,5/1/2023,ESP,Perak,4,3,1,Spain
68532,5/1/2023,ESP,Perlis,17,10,7,Spain
68533,5/1/2023,ESP,Pulau Pinang,77,41,36,Spain
68534,5/1/2023,ESP,Sabah,31,16,15,Spain
68535,5/1/2023,ESP,Sarawak,56,40,16,Spain
68536,5/1/2023,ESP,Selangor,1688,1027,661,Spain
68537,5/1/2023,ESP,W.P. Labuan,2,0,2,Spain
68538,5/1/2023,EST,Johor,37,22,15,Estonia
68539,5/1/2023,EST,Kedah,22,13,9,Estonia
68540,5/1/2023,EST,Kelantan,0,0,0,Estonia
68541,5/1/2023,EST,Pahang,0,0,0,Estonia
68542,5/1/2023,EST,Perak,0,0,0,Estonia
68543,5/1/2023,EST,Perlis,0,0,0,Estonia
68544,5/1/2023,EST,Pulau Pinang,1,1,0,Estonia
68545,5/1/2023,EST,Sabah,1,0,1,Estonia
68546,5/1/2023,EST,Sarawak,12,5,7,Estonia
68547,5/1/2023,EST,Selangor,97,51,46,Estonia
68548,5/1/2023,EST,W.P. Labuan,3,1,2,Estonia
68549,5/1/2023,ETH,Johor,13,5,8,Ethiopia
68550,5/1/2023,ETH,Kedah,0,0,0,Ethiopia
68551,5/1/2023,ETH,Pulau Pinang,0,0,0,Ethiopia
68552,5/1/2023,ETH,Sarawak,0,0,0,Ethiopia
68553,5/1/2023,ETH,Selangor,28,16,12,Ethiopia
68554,5/1/2023,FIN,Johor,124,72,52,Finland
68555,5/1/2023,FIN,Kedah,34,16,18,Finland
68556,5/1/2023,FIN,Kelantan,2,1,1,Finland
68557,5/1/2023,FIN,Melaka,0,0,0,Finland
68558,5/1/2023,FIN,Negeri Sembilan,0,0,0,Finland
68559,5/1/2023,FIN,Pahang,0,0,0,Finland
68560,5/1/2023,FIN,Perak,6,5,1,Finland
68561,5/1/2023,FIN,Perlis,7,7,0,Finland
68562,5/1/2023,FIN,Pulau Pinang,23,15,8,Finland
68563,5/1/2023,FIN,Sabah,13,5,8,Finland
68564,5/1/2023,FIN,Sarawak,11,7,4,Finland
68565,5/1/2023,FIN,Selangor,337,214,123,Finland
68566,5/1/2023,FIN,W.P. Labuan,1,0,1,Finland
68567,5/1/2023,FJI,Johor,95,54,41,Fiji
68568,5/1/2023,FJI,Kedah,0,0,0,Fiji
68569,5/1/2023,FJI,Kelantan,0,0,0,Fiji
68570,5/1/2023,FJI,Perak,0,0,0,Fiji
68571,5/1/2023,FJI,Perlis,1,1,0,Fiji
68572,5/1/2023,FJI,Pulau Pinang,4,3,1,Fiji
68573,5/1/2023,FJI,Sabah,0,0,0,Fiji
68574,5/1/2023,FJI,Sarawak,3,1,2,Fiji
68575,5/1/2023,FJI,Selangor,107,65,42,Fiji
68576,5/1/2023,FRA,Johor,1777,1089,688,France
68577,5/1/2023,FRA,Kedah,663,357,306,France
68578,5/1/2023,FRA,Kelantan,20,11,9,France
68579,5/1/2023,FRA,Melaka,4,1,3,France
68580,5/1/2023,FRA,Negeri Sembilan,0,0,0,France
68581,5/1/2023,FRA,Pahang,16,9,7,France
68582,5/1/2023,FRA,Perak,32,18,14,France
68583,5/1/2023,FRA,Perlis,97,65,32,France
68584,5/1/2023,FRA,Pulau Pinang,368,230,138,France
68585,5/1/2023,FRA,Sabah,122,71,51,France
68586,5/1/2023,FRA,Sarawak,137,95,42,France
68587,5/1/2023,FRA,Selangor,7387,4267,3120,France
68588,5/1/2023,FRA,Terengganu,0,0,0,France
68589,5/1/2023,FRA,W.P. Labuan,4,3,1,France
68590,5/1/2023,FSM,Johor,0,0,0,"Micronesia, Federated States of"
68591,5/1/2023,FSM,Pulau Pinang,0,0,0,"Micronesia, Federated States of"
68592,5/1/2023,FSM,Selangor,0,0,0,"Micronesia, Federated States of"
68593,5/1/2023,GAB,Johor,1,1,0,Gabon
68594,5/1/2023,GAB,Pulau Pinang,0,0,0,Gabon
68595,5/1/2023,GAB,Sarawak,0,0,0,Gabon
68596,5/1/2023,GAB,Selangor,12,7,5,Gabon
68597,5/1/2023,GBR,Johor,4306,2708,1598,United Kingdom
68598,5/1/2023,GBR,Kedah,1040,561,479,United Kingdom
68599,5/1/2023,GBR,Kelantan,7,6,1,United Kingdom
68600,5/1/2023,GBR,Melaka,1,1,0,United Kingdom
68601,5/1/2023,GBR,Negeri Sembilan,0,0,0,United Kingdom
68602,5/1/2023,GBR,Pahang,19,15,4,United Kingdom
68603,5/1/2023,GBR,Perak,82,53,29,United Kingdom
68604,5/1/2023,GBR,Perlis,153,99,54,United Kingdom
68605,5/1/2023,GBR,Pulau Pinang,1083,651,432,United Kingdom
68606,5/1/2023,GBR,Sabah,577,301,276,United Kingdom
68607,5/1/2023,GBR,Sarawak,1454,873,581,United Kingdom
68608,5/1/2023,GBR,Selangor,14201,8717,5484,United Kingdom
68609,5/1/2023,GBR,Terengganu,0,0,0,United Kingdom
68610,5/1/2023,GBR,W.P. Labuan,40,26,14,United Kingdom
68611,5/1/2023,GEO,Johor,4,4,0,Georgia
68612,5/1/2023,GEO,Kedah,2,2,0,Georgia
68613,5/1/2023,GEO,Melaka,0,0,0,Georgia
68614,5/1/2023,GEO,Perak,0,0,0,Georgia
68615,5/1/2023,GEO,Perlis,1,1,0,Georgia
68616,5/1/2023,GEO,Pulau Pinang,0,0,0,Georgia
68617,5/1/2023,GEO,Sabah,0,0,0,Georgia
68618,5/1/2023,GEO,Sarawak,0,0,0,Georgia
68619,5/1/2023,GEO,Selangor,55,30,25,Georgia
68620,5/1/2023,GHA,Johor,9,8,1,Ghana
68621,5/1/2023,GHA,Kedah,2,1,1,Ghana
68622,5/1/2023,GHA,Kelantan,0,0,0,Ghana
68623,5/1/2023,GHA,Pulau Pinang,0,0,0,Ghana
68624,5/1/2023,GHA,Sabah,0,0,0,Ghana
68625,5/1/2023,GHA,Sarawak,2,1,1,Ghana
68626,5/1/2023,GHA,Selangor,57,43,14,Ghana
68627,5/1/2023,GIB,Johor,0,0,0,Gibraltar
68628,5/1/2023,GIB,Sarawak,0,0,0,Gibraltar
68629,5/1/2023,GIN,Johor,20,15,5,Guinea
68630,5/1/2023,GIN,Kedah,0,0,0,Guinea
68631,5/1/2023,GIN,Kelantan,0,0,0,Guinea
68632,5/1/2023,GIN,Perlis,0,0,0,Guinea
68633,5/1/2023,GIN,Pulau Pinang,1,1,0,Guinea
68634,5/1/2023,GIN,Sabah,0,0,0,Guinea
68635,5/1/2023,GIN,Sarawak,1,1,0,Guinea
68636,5/1/2023,GIN,Selangor,56,45,11,Guinea
68637,5/1/2023,GLP,Selangor,0,0,0,Guadeloupe
68638,5/1/2023,GMB,Johor,6,3,3,Gambia
68639,5/1/2023,GMB,Kedah,0,0,0,Gambia
68640,5/1/2023,GMB,Kelantan,0,0,0,Gambia
68641,5/1/2023,GMB,Pulau Pinang,0,0,0,Gambia
68642,5/1/2023,GMB,Sabah,0,0,0,Gambia
68643,5/1/2023,GMB,Sarawak,0,0,0,Gambia
68644,5/1/2023,GMB,Selangor,26,21,5,Gambia
68645,5/1/2023,GNB,Johor,0,0,0,Guinea-Bissau
68646,5/1/2023,GNB,Selangor,1,1,0,Guinea-Bissau
68647,5/1/2023,GNQ,Johor,0,0,0,Equatorial Guinea
68648,5/1/2023,GNQ,Selangor,0,0,0,Equatorial Guinea
68649,5/1/2023,GRC,Johor,67,58,9,Greece
68650,5/1/2023,GRC,Kedah,8,7,1,Greece
68651,5/1/2023,GRC,Kelantan,0,0,0,Greece
68652,5/1/2023,GRC,Melaka,0,0,0,Greece
68653,5/1/2023,GRC,Negeri Sembilan,0,0,0,Greece
68654,5/1/2023,GRC,Pahang,1,1,0,Greece
68655,5/1/2023,GRC,Perak,0,0,0,Greece
68656,5/1/2023,GRC,Perlis,1,1,0,Greece
68657,5/1/2023,GRC,Pulau Pinang,6,6,0,Greece
68658,5/1/2023,GRC,Sabah,4,2,2,Greece
68659,5/1/2023,GRC,Sarawak,4,3,1,Greece
68660,5/1/2023,GRC,Selangor,155,119,36,Greece
68661,5/1/2023,GRD,Johor,6,3,3,Grenada
68662,5/1/2023,GRD,Kedah,0,0,0,Grenada
68663,5/1/2023,GRD,Pulau Pinang,1,1,0,Grenada
68664,5/1/2023,GRD,Sabah,0,0,0,Grenada
68665,5/1/2023,GRD,Sarawak,0,0,0,Grenada
68666,5/1/2023,GRD,Selangor,6,6,0,Grenada
68667,5/1/2023,GRL,Johor,0,0,0,Greenland
68668,5/1/2023,GRL,Selangor,0,0,0,Greenland
68669,5/1/2023,GTM,Johor,6,2,4,Guatemala
68670,5/1/2023,GTM,Kedah,0,0,0,Guatemala
68671,5/1/2023,GTM,Pahang,0,0,0,Guatemala
68672,5/1/2023,GTM,Perak,0,0,0,Guatemala
68673,5/1/2023,GTM,Pulau Pinang,0,0,0,Guatemala
68674,5/1/2023,GTM,Sabah,1,0,1,Guatemala
68675,5/1/2023,GTM,Sarawak,0,0,0,Guatemala
68676,5/1/2023,GTM,Selangor,19,11,8,Guatemala
68677,5/1/2023,GTM,W.P. Labuan,0,0,0,Guatemala
68678,5/1/2023,GUY,Johor,0,0,0,Guyana
68679,5/1/2023,GUY,Kedah,0,0,0,Guyana
68680,5/1/2023,GUY,Pulau Pinang,1,1,0,Guyana
68681,5/1/2023,GUY,Sarawak,0,0,0,Guyana
68682,5/1/2023,GUY,Selangor,4,1,3,Guyana
68683,5/1/2023,HKG,Johor,6,4,2,Hong Kong
68684,5/1/2023,HKG,Kedah,0,0,0,Hong Kong
68685,5/1/2023,HKG,Kelantan,0,0,0,Hong Kong
68686,5/1/2023,HKG,Pahang,3,1,2,Hong Kong
68687,5/1/2023,HKG,Perak,46,19,27,Hong Kong
68688,5/1/2023,HKG,Perlis,3,3,0,Hong Kong
68689,5/1/2023,HKG,Pulau Pinang,0,0,0,Hong Kong
68690,5/1/2023,HKG,Sabah,39,21,18,Hong Kong
68691,5/1/2023,HKG,Sarawak,0,0,0,Hong Kong
68692,5/1/2023,HKG,Selangor,19,7,12,Hong Kong
68693,5/1/2023,HKG,Terengganu,0,0,0,Hong Kong
68694,5/1/2023,HMD,Johor,0,0,0,Heard Island and McDonald Islands
68695,5/1/2023,HND,Johor,1,1,0,Honduras
68696,5/1/2023,HND,Kedah,0,0,0,Honduras
68697,5/1/2023,HND,Perak,0,0,0,Honduras
68698,5/1/2023,HND,Pulau Pinang,0,0,0,Honduras
68699,5/1/2023,HND,Sabah,0,0,0,Honduras
68700,5/1/2023,HND,Sarawak,0,0,0,Honduras
68701,5/1/2023,HND,Selangor,7,5,2,Honduras
68702,5/1/2023,HRV,Johor,38,35,3,Croatia
68703,5/1/2023,HRV,Kedah,8,5,3,Croatia
68704,5/1/2023,HRV,Kelantan,1,1,0,Croatia
68705,5/1/2023,HRV,Melaka,0,0,0,Croatia
68706,5/1/2023,HRV,Pahang,0,0,0,Croatia
68707,5/1/2023,HRV,Perak,0,0,0,Croatia
68708,5/1/2023,HRV,Perlis,0,0,0,Croatia
68709,5/1/2023,HRV,Pulau Pinang,7,5,2,Croatia
68710,5/1/2023,HRV,Sabah,1,1,0,Croatia
68711,5/1/2023,HRV,Sarawak,4,2,2,Croatia
68712,5/1/2023,HRV,Selangor,138,99,39,Croatia
68713,5/1/2023,HTI,Johor,4,4,0,Haiti
68714,5/1/2023,HTI,Kedah,0,0,0,Haiti
68715,5/1/2023,HTI,Kelantan,0,0,0,Haiti
68716,5/1/2023,HTI,Perak,0,0,0,Haiti
68717,5/1/2023,HTI,Pulau Pinang,0,0,0,Haiti
68718,5/1/2023,HTI,Sabah,0,0,0,Haiti
68719,5/1/2023,HTI,Selangor,5,5,0,Haiti
68720,5/1/2023,HUN,Johor,59,37,22,Hungary
68721,5/1/2023,HUN,Kedah,21,12,9,Hungary
68722,5/1/2023,HUN,Kelantan,0,0,0,Hungary
68723,5/1/2023,HUN,Pahang,0,0,0,Hungary
68724,5/1/2023,HUN,Perak,0,0,0,Hungary
68725,5/1/2023,HUN,Perlis,0,0,0,Hungary
68726,5/1/2023,HUN,Pulau Pinang,12,9,3,Hungary
68727,5/1/2023,HUN,Sabah,3,2,1,Hungary
68728,5/1/2023,HUN,Sarawak,5,1,4,Hungary
68729,5/1/2023,HUN,Selangor,334,188,146,Hungary
68730,5/1/2023,HUN,W.P. Labuan,0,0,0,Hungary
68731,5/1/2023,IDN,Johor,102377,54873,47504,Indonesia
68732,5/1/2023,IDN,Kedah,4628,1831,2797,Indonesia
68733,5/1/2023,IDN,Kelantan,88,52,36,Indonesia
68734,5/1/2023,IDN,Melaka,5199,2270,2929,Indonesia
68735,5/1/2023,IDN,Negeri Sembilan,14294,10157,4137,Indonesia
68736,5/1/2023,IDN,Pahang,33,22,11,Indonesia
68737,5/1/2023,IDN,Perak,177,50,127,Indonesia
68738,5/1/2023,IDN,Perlis,452,173,279,Indonesia
68739,5/1/2023,IDN,Pulau Pinang,37752,14698,23054,Indonesia
68740,5/1/2023,IDN,Sabah,6116,3204,2912,Indonesia
68741,5/1/2023,IDN,Sarawak,47222,27986,19236,Indonesia
68742,5/1/2023,IDN,Selangor,108569,52889,55680,Indonesia
68743,5/1/2023,IDN,Terengganu,1,1,0,Indonesia
68744,5/1/2023,IDN,W.P. Labuan,59,29,30,Indonesia
68745,5/1/2023,IND,Johor,24610,15682,8928,India
68746,5/1/2023,IND,Kedah,1429,726,703,India
68747,5/1/2023,IND,Kelantan,7,6,1,India
68748,5/1/2023,IND,Melaka,0,0,0,India
68749,5/1/2023,IND,Negeri Sembilan,0,0,0,India
68750,5/1/2023,IND,Pahang,5,4,1,India
68751,5/1/2023,IND,Perak,302,234,68,India
68752,5/1/2023,IND,Perlis,40,28,12,India
68753,5/1/2023,IND,Pulau Pinang,1042,715,327,India
68754,5/1/2023,IND,Sabah,280,192,88,India
68755,5/1/2023,IND,Sarawak,1411,1096,315,India
68756,5/1/2023,IND,Selangor,61760,40584,21176,India
68757,5/1/2023,IND,Terengganu,0,0,0,India
68758,5/1/2023,IND,W.P. Labuan,69,48,21,India
68759,5/1/2023,IOT,Pulau Pinang,0,0,0,British Indian Ocean Territory
68760,5/1/2023,IOT,Selangor,0,0,0,British Indian Ocean Territory
68761,5/1/2023,IRL,Johor,258,157,101,Ireland
68762,5/1/2023,IRL,Kedah,73,36,37,Ireland
68763,5/1/2023,IRL,Kelantan,3,2,1,Ireland
68764,5/1/2023,IRL,Negeri Sembilan,0,0,0,Ireland
68765,5/1/2023,IRL,Pahang,1,1,0,Ireland
68766,5/1/2023,IRL,Perak,6,3,3,Ireland
68767,5/1/2023,IRL,Perlis,26,20,6,Ireland
68768,5/1/2023,IRL,Pulau Pinang,103,78,25,Ireland
68769,5/1/2023,IRL,Sabah,19,9,10,Ireland
68770,5/1/2023,IRL,Sarawak,52,31,21,Ireland
68771,5/1/2023,IRL,Selangor,999,642,357,Ireland
68772,5/1/2023,IRL,Terengganu,0,0,0,Ireland
68773,5/1/2023,IRL,W.P. Labuan,2,2,0,Ireland
68774,5/1/2023,IRN,Johor,94,60,34,Iran
68775,5/1/2023,IRN,Kedah,22,11,11,Iran
68776,5/1/2023,IRN,Kelantan,2,1,1,Iran
68777,5/1/2023,IRN,Perak,0,0,0,Iran
68778,5/1/2023,IRN,Perlis,16,8,8,Iran
68779,5/1/2023,IRN,Pulau Pinang,9,4,5,Iran
68780,5/1/2023,IRN,Sabah,0,0,0,Iran
68781,5/1/2023,IRN,Sarawak,0,0,0,Iran
68782,5/1/2023,IRN,Selangor,1050,611,439,Iran
68783,5/1/2023,IRN,W.P. Labuan,0,0,0,Iran
68784,5/1/2023,IRQ,Johor,22,17,5,Iraq
68785,5/1/2023,IRQ,Kedah,0,0,0,Iraq
68786,5/1/2023,IRQ,Kelantan,0,0,0,Iraq
68787,5/1/2023,IRQ,Melaka,0,0,0,Iraq
68788,5/1/2023,IRQ,Pahang,0,0,0,Iraq
68789,5/1/2023,IRQ,Perak,0,0,0,Iraq
68790,5/1/2023,IRQ,Perlis,0,0,0,Iraq
68791,5/1/2023,IRQ,Pulau Pinang,0,0,0,Iraq
68792,5/1/2023,IRQ,Sabah,0,0,0,Iraq
68793,5/1/2023,IRQ,Sarawak,2,1,1,Iraq
68794,5/1/2023,IRQ,Selangor,852,597,255,Iraq
68795,5/1/2023,ISL,Johor,4,4,0,Iceland
68796,5/1/2023,ISL,Kedah,3,3,0,Iceland
68797,5/1/2023,ISL,Kelantan,0,0,0,Iceland
68798,5/1/2023,ISL,Perak,0,0,0,Iceland
68799,5/1/2023,ISL,Perlis,0,0,0,Iceland
68800,5/1/2023,ISL,Pulau Pinang,1,1,0,Iceland
68801,5/1/2023,ISL,Sabah,1,1,0,Iceland
68802,5/1/2023,ISL,Sarawak,4,3,1,Iceland
68803,5/1/2023,ISL,Selangor,35,13,22,Iceland
68804,5/1/2023,ISL,W.P. Labuan,0,0,0,Iceland
68805,5/1/2023,ISR,Pulau Pinang,1,1,0,Israel
68806,5/1/2023,ITA,Johor,515,383,132,Italy
68807,5/1/2023,ITA,Kedah,122,82,40,Italy
68808,5/1/2023,ITA,Kelantan,2,1,1,Italy
68809,5/1/2023,ITA,Melaka,0,0,0,Italy
68810,5/1/2023,ITA,Negeri Sembilan,0,0,0,Italy
68811,5/1/2023,ITA,Pahang,1,1,0,Italy
68812,5/1/2023,ITA,Perak,6,4,2,Italy
68813,5/1/2023,ITA,Perlis,14,12,2,Italy
68814,5/1/2023,ITA,Pulau Pinang,87,69,18,Italy
68815,5/1/2023,ITA,Sabah,32,18,14,Italy
68816,5/1/2023,ITA,Sarawak,63,32,31,Italy
68817,5/1/2023,ITA,Selangor,1995,1401,594,Italy
68818,5/1/2023,ITA,W.P. Labuan,0,0,0,Italy
68819,5/1/2023,JAM,Johor,1,0,1,Jamaica
68820,5/1/2023,JAM,Kedah,4,2,2,Jamaica
68821,5/1/2023,JAM,Perak,0,0,0,Jamaica
68822,5/1/2023,JAM,Pulau Pinang,2,2,0,Jamaica
68823,5/1/2023,JAM,Sabah,0,0,0,Jamaica
68824,5/1/2023,JAM,Sarawak,0,0,0,Jamaica
68825,5/1/2023,JAM,Selangor,23,11,12,Jamaica
68826,5/1/2023,JAM,W.P. Labuan,0,0,0,Jamaica
68827,5/1/2023,JOR,Johor,13,8,5,Jordan
68828,5/1/2023,JOR,Kedah,9,8,1,Jordan
68829,5/1/2023,JOR,Kelantan,1,0,1,Jordan
68830,5/1/2023,JOR,Melaka,1,1,0,Jordan
68831,5/1/2023,JOR,Perlis,1,1,0,Jordan
68832,5/1/2023,JOR,Pulau Pinang,9,6,3,Jordan
68833,5/1/2023,JOR,Sabah,1,1,0,Jordan
68834,5/1/2023,JOR,Sarawak,0,0,0,Jordan
68835,5/1/2023,JOR,Selangor,690,436,254,Jordan
68836,5/1/2023,JOR,W.P. Labuan,0,0,0,Jordan
68837,5/1/2023,JPN,Johor,5169,3541,1628,Japan
68838,5/1/2023,JPN,Kedah,312,158,154,Japan
68839,5/1/2023,JPN,Kelantan,10,9,1,Japan
68840,5/1/2023,JPN,Melaka,0,0,0,Japan
68841,5/1/2023,JPN,Negeri Sembilan,0,0,0,Japan
68842,5/1/2023,JPN,Pahang,7,7,0,Japan
68843,5/1/2023,JPN,Perak,75,56,19,Japan
68844,5/1/2023,JPN,Perlis,83,66,17,Japan
68845,5/1/2023,JPN,Pulau Pinang,1283,967,316,Japan
68846,5/1/2023,JPN,Sabah,361,189,172,Japan
68847,5/1/2023,JPN,Sarawak,211,121,90,Japan
68848,5/1/2023,JPN,Selangor,15311,9895,5416,Japan
68849,5/1/2023,JPN,W.P. Labuan,10,9,1,Japan
68850,5/1/2023,KAZ,Johor,42,22,20,Kazakhstan
68851,5/1/2023,KAZ,Kedah,12,5,7,Kazakhstan
68852,5/1/2023,KAZ,Kelantan,1,0,1,Kazakhstan
68853,5/1/2023,KAZ,Melaka,0,0,0,Kazakhstan
68854,5/1/2023,KAZ,Perak,0,0,0,Kazakhstan
68855,5/1/2023,KAZ,Perlis,0,0,0,Kazakhstan
68856,5/1/2023,KAZ,Pulau Pinang,5,2,3,Kazakhstan
68857,5/1/2023,KAZ,Sabah,1,1,0,Kazakhstan
68858,5/1/2023,KAZ,Sarawak,2,0,2,Kazakhstan
68859,5/1/2023,KAZ,Selangor,602,217,385,Kazakhstan
68860,5/1/2023,KAZ,W.P. Labuan,0,0,0,Kazakhstan
68861,5/1/2023,KEN,Johor,37,16,21,Kenya
68862,5/1/2023,KEN,Kedah,4,2,2,Kenya
68863,5/1/2023,KEN,Kelantan,0,0,0,Kenya
68864,5/1/2023,KEN,Perak,0,0,0,Kenya
68865,5/1/2023,KEN,Perlis,0,0,0,Kenya
68866,5/1/2023,KEN,Pulau Pinang,1,0,1,Kenya
68867,5/1/2023,KEN,Sabah,0,0,0,Kenya
68868,5/1/2023,KEN,Sarawak,4,3,1,Kenya
68869,5/1/2023,KEN,Selangor,327,164,163,Kenya
68870,5/1/2023,KGZ,Johor,32,24,8,Kyrgyzstan
68871,5/1/2023,KGZ,Kedah,1,1,0,Kyrgyzstan
68872,5/1/2023,KGZ,Kelantan,0,0,0,Kyrgyzstan
68873,5/1/2023,KGZ,Perak,0,0,0,Kyrgyzstan
68874,5/1/2023,KGZ,Perlis,0,0,0,Kyrgyzstan
68875,5/1/2023,KGZ,Pulau Pinang,1,0,1,Kyrgyzstan
68876,5/1/2023,KGZ,Sabah,0,0,0,Kyrgyzstan
68877,5/1/2023,KGZ,Sarawak,0,0,0,Kyrgyzstan
68878,5/1/2023,KGZ,Selangor,204,102,102,Kyrgyzstan
68879,5/1/2023,KHM,Johor,2888,1185,1703,Cambodia
68880,5/1/2023,KHM,Kedah,253,148,105,Cambodia
68881,5/1/2023,KHM,Kelantan,608,322,286,Cambodia
68882,5/1/2023,KHM,Melaka,0,0,0,Cambodia
68883,5/1/2023,KHM,Negeri Sembilan,0,0,0,Cambodia
68884,5/1/2023,KHM,Pahang,0,0,0,Cambodia
68885,5/1/2023,KHM,Perak,11,5,6,Cambodia
68886,5/1/2023,KHM,Perlis,816,519,297,Cambodia
68887,5/1/2023,KHM,Pulau Pinang,31,16,15,Cambodia
68888,5/1/2023,KHM,Sabah,0,0,0,Cambodia
68889,5/1/2023,KHM,Sarawak,16,4,12,Cambodia
68890,5/1/2023,KHM,Selangor,4822,2239,2583,Cambodia
68891,5/1/2023,KHM,W.P. Labuan,1,0,1,Cambodia
68892,5/1/2023,KIR,Johor,1,1,0,Kiribati
68893,5/1/2023,KIR,Sabah,0,0,0,Kiribati
68894,5/1/2023,KIR,Selangor,0,0,0,Kiribati
68895,5/1/2023,KNA,Johor,14,12,2,Saint Kitts and Nevis
68896,5/1/2023,KNA,Kedah,0,0,0,Saint Kitts and Nevis
68897,5/1/2023,KNA,Perlis,0,0,0,Saint Kitts and Nevis
68898,5/1/2023,KNA,Pulau Pinang,2,2,0,Saint Kitts and Nevis
68899,5/1/2023,KNA,Sabah,0,0,0,Saint Kitts and Nevis
68900,5/1/2023,KNA,Selangor,59,46,13,Saint Kitts and Nevis
68901,5/1/2023,KNA,W.P. Labuan,0,0,0,Saint Kitts and Nevis
68902,5/1/2023,KOR,Johor,7381,4226,3155,"Korea, Republic of (South Korea)"
68903,5/1/2023,KOR,Kedah,313,218,95,"Korea, Republic of (South Korea)"
68904,5/1/2023,KOR,Kelantan,0,0,0,"Korea, Republic of (South Korea)"
68905,5/1/2023,KOR,Melaka,1,1,0,"Korea, Republic of (South Korea)"
68906,5/1/2023,KOR,Negeri Sembilan,0,0,0,"Korea, Republic of (South Korea)"
68907,5/1/2023,KOR,Pahang,1,0,1,"Korea, Republic of (South Korea)"
68908,5/1/2023,KOR,Perak,34,15,19,"Korea, Republic of (South Korea)"
68909,5/1/2023,KOR,Perlis,62,47,15,"Korea, Republic of (South Korea)"
68910,5/1/2023,KOR,Pulau Pinang,487,303,184,"Korea, Republic of (South Korea)"
68911,5/1/2023,KOR,Sabah,14466,5891,8575,"Korea, Republic of (South Korea)"
68912,5/1/2023,KOR,Sarawak,248,145,103,"Korea, Republic of (South Korea)"
68913,5/1/2023,KOR,Selangor,10165,5951,4214,"Korea, Republic of (South Korea)"
68914,5/1/2023,KOR,Terengganu,0,0,0,"Korea, Republic of (South Korea)"
68915,5/1/2023,KOR,W.P. Labuan,15,14,1,"Korea, Republic of (South Korea)"
68916,5/1/2023,KWT,Johor,10,5,5,Kuwait
68917,5/1/2023,KWT,Kedah,11,7,4,Kuwait
68918,5/1/2023,KWT,Kelantan,1,1,0,Kuwait
68919,5/1/2023,KWT,Perak,0,0,0,Kuwait
68920,5/1/2023,KWT,Perlis,0,0,0,Kuwait
68921,5/1/2023,KWT,Pulau Pinang,1,1,0,Kuwait
68922,5/1/2023,KWT,Sabah,0,0,0,Kuwait
68923,5/1/2023,KWT,Sarawak,1,1,0,Kuwait
68924,5/1/2023,KWT,Selangor,387,243,144,Kuwait
68925,5/1/2023,KWT,W.P. Labuan,0,0,0,Kuwait
68926,5/1/2023,LAO,Johor,115,27,88,Lao People's Democratic Republic
68927,5/1/2023,LAO,Kedah,1312,121,1191,Lao People's Democratic Republic
68928,5/1/2023,LAO,Kelantan,227,13,214,Lao People's Democratic Republic
68929,5/1/2023,LAO,Melaka,0,0,0,Lao People's Democratic Republic
68930,5/1/2023,LAO,Perak,26,8,18,Lao People's Democratic Republic
68931,5/1/2023,LAO,Perlis,294,109,185,Lao People's Democratic Republic
68932,5/1/2023,LAO,Pulau Pinang,27,11,16,Lao People's Democratic Republic
68933,5/1/2023,LAO,Sabah,1,0,1,Lao People's Democratic Republic
68934,5/1/2023,LAO,Sarawak,11,5,6,Lao People's Democratic Republic
68935,5/1/2023,LAO,Selangor,256,91,165,Lao People's Democratic Republic
68936,5/1/2023,LAO,W.P. Labuan,0,0,0,Lao People's Democratic Republic
68937,5/1/2023,LBN,Johor,30,18,12,Lebanon
68938,5/1/2023,LBN,Kedah,5,1,4,Lebanon
68939,5/1/2023,LBN,Kelantan,0,0,0,Lebanon
68940,5/1/2023,LBN,Pahang,0,0,0,Lebanon
68941,5/1/2023,LBN,Perak,0,0,0,Lebanon
68942,5/1/2023,LBN,Perlis,0,0,0,Lebanon
68943,5/1/2023,LBN,Pulau Pinang,2,2,0,Lebanon
68944,5/1/2023,LBN,Sabah,1,1,0,Lebanon
68945,5/1/2023,LBN,Sarawak,1,1,0,Lebanon
68946,5/1/2023,LBN,Selangor,226,165,61,Lebanon
68947,5/1/2023,LBN,W.P. Labuan,0,0,0,Lebanon
68948,5/1/2023,LBR,Johor,2,1,1,Liberia
68949,5/1/2023,LBR,Kedah,0,0,0,Liberia
68950,5/1/2023,LBR,Sabah,0,0,0,Liberia
68951,5/1/2023,LBR,Sarawak,0,0,0,Liberia
68952,5/1/2023,LBR,Selangor,5,4,1,Liberia
68953,5/1/2023,LBY,Johor,1,1,0,Libyan Arab Jamahiriya
68954,5/1/2023,LBY,Kedah,0,0,0,Libyan Arab Jamahiriya
68955,5/1/2023,LBY,Perlis,0,0,0,Libyan Arab Jamahiriya
68956,5/1/2023,LBY,Pulau Pinang,1,1,0,Libyan Arab Jamahiriya
68957,5/1/2023,LBY,Sabah,1,1,0,Libyan Arab Jamahiriya
68958,5/1/2023,LBY,Sarawak,2,1,1,Libyan Arab Jamahiriya
68959,5/1/2023,LBY,Selangor,361,224,137,Libyan Arab Jamahiriya
68960,5/1/2023,LCA,Johor,11,11,0,Saint Lucia
68961,5/1/2023,LCA,Kedah,0,0,0,Saint Lucia
68962,5/1/2023,LCA,Pulau Pinang,0,0,0,Saint Lucia
68963,5/1/2023,LCA,Sarawak,1,1,0,Saint Lucia
68964,5/1/2023,LCA,Selangor,7,5,2,Saint Lucia
68965,5/1/2023,LIE,Johor,1,1,0,Liechtenstein
68966,5/1/2023,LIE,Kedah,0,0,0,Liechtenstein
68967,5/1/2023,LIE,Perlis,0,0,0,Liechtenstein
68968,5/1/2023,LIE,Pulau Pinang,0,0,0,Liechtenstein
68969,5/1/2023,LIE,Sabah,0,0,0,Liechtenstein
68970,5/1/2023,LIE,Sarawak,0,0,0,Liechtenstein
68971,5/1/2023,LIE,Selangor,2,1,1,Liechtenstein
68972,5/1/2023,LKA,Johor,1089,754,335,Sri Lanka
68973,5/1/2023,LKA,Kedah,41,25,16,Sri Lanka
68974,5/1/2023,LKA,Kelantan,8,7,1,Sri Lanka
68975,5/1/2023,LKA,Melaka,0,0,0,Sri Lanka
68976,5/1/2023,LKA,Pahang,0,0,0,Sri Lanka
68977,5/1/2023,LKA,Perak,2,2,0,Sri Lanka
68978,5/1/2023,LKA,Perlis,1,1,0,Sri Lanka
68979,5/1/2023,LKA,Pulau Pinang,30,24,6,Sri Lanka
68980,5/1/2023,LKA,Sabah,11,7,4,Sri Lanka
68981,5/1/2023,LKA,Sarawak,25,17,8,Sri Lanka
68982,5/1/2023,LKA,Selangor,3836,2679,1157,Sri Lanka
68983,5/1/2023,LKA,W.P. Labuan,0,0,0,Sri Lanka
68984,5/1/2023,LSO,Johor,0,0,0,Lesotho
68985,5/1/2023,LSO,Kedah,0,0,0,Lesotho
68986,5/1/2023,LSO,Pulau Pinang,0,0,0,Lesotho
68987,5/1/2023,LSO,Sarawak,0,0,0,Lesotho
68988,5/1/2023,LSO,Selangor,2,0,2,Lesotho
68989,5/1/2023,LTU,Johor,44,16,28,Lithuania
68990,5/1/2023,LTU,Kedah,17,8,9,Lithuania
68991,5/1/2023,LTU,Kelantan,1,1,0,Lithuania
68992,5/1/2023,LTU,Pahang,0,0,0,Lithuania
68993,5/1/2023,LTU,Perak,0,0,0,Lithuania
68994,5/1/2023,LTU,Perlis,2,1,1,Lithuania
68995,5/1/2023,LTU,Pulau Pinang,6,5,1,Lithuania
68996,5/1/2023,LTU,Sabah,0,0,0,Lithuania
68997,5/1/2023,LTU,Sarawak,25,11,14,Lithuania
68998,5/1/2023,LTU,Selangor,207,112,95,Lithuania
68999,5/1/2023,LTU,W.P. Labuan,0,0,0,Lithuania
69000,5/1/2023,LUX,Johor,5,3,2,Luxembourg
69001,5/1/2023,LUX,Kedah,9,4,5,Luxembourg
69002,5/1/2023,LUX,Kelantan,0,0,0,Luxembourg
69003,5/1/2023,LUX,Perak,0,0,0,Luxembourg
69004,5/1/2023,LUX,Perlis,0,0,0,Luxembourg
69005,5/1/2023,LUX,Pulau Pinang,4,2,2,Luxembourg
69006,5/1/2023,LUX,Sabah,0,0,0,Luxembourg
69007,5/1/2023,LUX,Sarawak,1,1,0,Luxembourg
69008,5/1/2023,LUX,Selangor,38,26,12,Luxembourg
69009,5/1/2023,LVA,Johor,19,7,12,Latvia
69010,5/1/2023,LVA,Kedah,8,3,5,Latvia
69011,5/1/2023,LVA,Kelantan,0,0,0,Latvia
69012,5/1/2023,LVA,Pahang,0,0,0,Latvia
69013,5/1/2023,LVA,Perak,2,0,2,Latvia
69014,5/1/2023,LVA,Perlis,4,2,2,Latvia
69015,5/1/2023,LVA,Pulau Pinang,2,0,2,Latvia
69016,5/1/2023,LVA,Sabah,0,0,0,Latvia
69017,5/1/2023,LVA,Sarawak,14,7,7,Latvia
69018,5/1/2023,LVA,Selangor,79,41,38,Latvia
69019,5/1/2023,LVA,W.P. Labuan,1,0,1,Latvia
69020,5/1/2023,MAC,Johor,1,0,1,Macao
69021,5/1/2023,MAC,Pahang,0,0,0,Macao
69022,5/1/2023,MAC,Perak,4,2,2,Macao
69023,5/1/2023,MAC,Selangor,3,1,2,Macao
69024,5/1/2023,MAC,W.P. Labuan,0,0,0,Macao
69025,5/1/2023,MAR,Johor,65,47,18,Morocco
69026,5/1/2023,MAR,Kedah,15,12,3,Morocco
69027,5/1/2023,MAR,Kelantan,0,0,0,Morocco
69028,5/1/2023,MAR,Melaka,0,0,0,Morocco
69029,5/1/2023,MAR,Pahang,0,0,0,Morocco
69030,5/1/2023,MAR,Perak,0,0,0,Morocco
69031,5/1/2023,MAR,Perlis,3,3,0,Morocco
69032,5/1/2023,MAR,Pulau Pinang,6,4,2,Morocco
69033,5/1/2023,MAR,Sabah,5,2,3,Morocco
69034,5/1/2023,MAR,Sarawak,3,3,0,Morocco
69035,5/1/2023,MAR,Selangor,807,416,391,Morocco
69036,5/1/2023,MAR,W.P. Labuan,0,0,0,Morocco
69037,5/1/2023,MCO,Johor,0,0,0,Monaco
69038,5/1/2023,MCO,Kedah,0,0,0,Monaco
69039,5/1/2023,MCO,Sabah,0,0,0,Monaco
69040,5/1/2023,MCO,Selangor,1,0,1,Monaco
69041,5/1/2023,MDA,Johor,9,4,5,"Moldova, Republic of"
69042,5/1/2023,MDA,Kedah,2,2,0,"Moldova, Republic of"
69043,5/1/2023,MDA,Kelantan,0,0,0,"Moldova, Republic of"
69044,5/1/2023,MDA,Negeri Sembilan,0,0,0,"Moldova, Republic of"
69045,5/1/2023,MDA,Perlis,1,0,1,"Moldova, Republic of"
69046,5/1/2023,MDA,Pulau Pinang,2,1,1,"Moldova, Republic of"
69047,5/1/2023,MDA,Sabah,0,0,0,"Moldova, Republic of"
69048,5/1/2023,MDA,Sarawak,0,0,0,"Moldova, Republic of"
69049,5/1/2023,MDA,Selangor,29,18,11,"Moldova, Republic of"
69050,5/1/2023,MDG,Johor,7,1,6,Madagascar
69051,5/1/2023,MDG,Kedah,2,0,2,Madagascar
69052,5/1/2023,MDG,Perak,0,0,0,Madagascar
69053,5/1/2023,MDG,Perlis,0,0,0,Madagascar
69054,5/1/2023,MDG,Pulau Pinang,0,0,0,Madagascar
69055,5/1/2023,MDG,Sabah,0,0,0,Madagascar
69056,5/1/2023,MDG,Sarawak,0,0,0,Madagascar
69057,5/1/2023,MDG,Selangor,55,27,28,Madagascar
69058,5/1/2023,MDV,Johor,91,48,43,Maldives
69059,5/1/2023,MDV,Kedah,3,2,1,Maldives
69060,5/1/2023,MDV,Kelantan,0,0,0,Maldives
69061,5/1/2023,MDV,Perak,1,0,1,Maldives
69062,5/1/2023,MDV,Perlis,0,0,0,Maldives
69063,5/1/2023,MDV,Pulau Pinang,5,3,2,Maldives
69064,5/1/2023,MDV,Sabah,3,3,0,Maldives
69065,5/1/2023,MDV,Sarawak,5,3,2,Maldives
69066,5/1/2023,MDV,Selangor,1785,1019,766,Maldives
69067,5/1/2023,MEX,Johor,168,83,85,Mexico
69068,5/1/2023,MEX,Kedah,6,4,2,Mexico
69069,5/1/2023,MEX,Kelantan,0,0,0,Mexico
69070,5/1/2023,MEX,Pahang,0,0,0,Mexico
69071,5/1/2023,MEX,Perak,1,1,0,Mexico
69072,5/1/2023,MEX,Perlis,0,0,0,Mexico
69073,5/1/2023,MEX,Pulau Pinang,28,16,12,Mexico
69074,5/1/2023,MEX,Sabah,7,2,5,Mexico
69075,5/1/2023,MEX,Sarawak,7,4,3,Mexico
69076,5/1/2023,MEX,Selangor,569,305,264,Mexico
69077,5/1/2023,MEX,W.P. Labuan,0,0,0,Mexico
69078,5/1/2023,MHL,Johor,3,2,1,Marshall Islands
69079,5/1/2023,MHL,Kedah,0,0,0,Marshall Islands
69080,5/1/2023,MHL,Perak,0,0,0,Marshall Islands
69081,5/1/2023,MHL,Pulau Pinang,0,0,0,Marshall Islands
69082,5/1/2023,MHL,Sabah,0,0,0,Marshall Islands
69083,5/1/2023,MHL,Selangor,2,2,0,Marshall Islands
69084,5/1/2023,MKD,Johor,11,5,6,"Macedonia, the former Yugoslav Republic of"
69085,5/1/2023,MKD,Kedah,19,6,13,"Macedonia, the former Yugoslav Republic of"
69086,5/1/2023,MKD,Perak,0,0,0,"Macedonia, the former Yugoslav Republic of"
69087,5/1/2023,MKD,Pulau Pinang,0,0,0,"Macedonia, the former Yugoslav Republic of"
69088,5/1/2023,MKD,Sabah,0,0,0,"Macedonia, the former Yugoslav Republic of"
69089,5/1/2023,MKD,Sarawak,1,0,1,"Macedonia, the former Yugoslav Republic of"
69090,5/1/2023,MKD,Selangor,38,23,15,"Macedonia, the former Yugoslav Republic of"
69091,5/1/2023,MLI,Johor,1,1,0,Mali
69092,5/1/2023,MLI,Sabah,0,0,0,Mali
69093,5/1/2023,MLI,Selangor,14,9,5,Mali
69094,5/1/2023,MLT,Johor,4,4,0,Malta
69095,5/1/2023,MLT,Kedah,1,1,0,Malta
69096,5/1/2023,MLT,Kelantan,0,0,0,Malta
69097,5/1/2023,MLT,Perak,0,0,0,Malta
69098,5/1/2023,MLT,Perlis,2,1,1,Malta
69099,5/1/2023,MLT,Pulau Pinang,1,1,0,Malta
69100,5/1/2023,MLT,Sabah,0,0,0,Malta
69101,5/1/2023,MLT,Sarawak,1,1,0,Malta
69102,5/1/2023,MLT,Selangor,33,19,14,Malta
69103,5/1/2023,MLT,W.P. Labuan,0,0,0,Malta
69104,5/1/2023,MMR,Johor,4099,1217,2882,Myanmar
69105,5/1/2023,MMR,Kedah,75,17,58,Myanmar
69106,5/1/2023,MMR,Kelantan,4,0,4,Myanmar
69107,5/1/2023,MMR,Negeri Sembilan,0,0,0,Myanmar
69108,5/1/2023,MMR,Pahang,6,1,5,Myanmar
69109,5/1/2023,MMR,Perak,25,4,21,Myanmar
69110,5/1/2023,MMR,Perlis,4,0,4,Myanmar
69111,5/1/2023,MMR,Pulau Pinang,357,210,147,Myanmar
69112,5/1/2023,MMR,Sabah,23,8,15,Myanmar
69113,5/1/2023,MMR,Sarawak,68,27,41,Myanmar
69114,5/1/2023,MMR,Selangor,8848,6404,2444,Myanmar
69115,5/1/2023,MMR,Terengganu,0,0,0,Myanmar
69116,5/1/2023,MMR,W.P. Labuan,2,1,1,Myanmar
69117,5/1/2023,MNE,Johor,2,2,0,Montenegro
69118,5/1/2023,MNE,Kedah,0,0,0,Montenegro
69119,5/1/2023,MNE,Pulau Pinang,0,0,0,Montenegro
69120,5/1/2023,MNE,Sabah,0,0,0,Montenegro
69121,5/1/2023,MNE,Sarawak,0,0,0,Montenegro
69122,5/1/2023,MNE,Selangor,11,8,3,Montenegro
69123,5/1/2023,MNG,Johor,125,44,81,Mongolia
69124,5/1/2023,MNG,Kedah,8,6,2,Mongolia
69125,5/1/2023,MNG,Kelantan,0,0,0,Mongolia
69126,5/1/2023,MNG,Perak,0,0,0,Mongolia
69127,5/1/2023,MNG,Perlis,7,5,2,Mongolia
69128,5/1/2023,MNG,Pulau Pinang,4,0,4,Mongolia
69129,5/1/2023,MNG,Sabah,10,3,7,Mongolia
69130,5/1/2023,MNG,Sarawak,1,0,1,Mongolia
69131,5/1/2023,MNG,Selangor,256,90,166,Mongolia
69132,5/1/2023,MNP,Selangor,0,0,0,Northern Mariana Islands
69133,5/1/2023,MOZ,Johor,0,0,0,Mozambique
69134,5/1/2023,MOZ,Kedah,0,0,0,Mozambique
69135,5/1/2023,MOZ,Perak,0,0,0,Mozambique
69136,5/1/2023,MOZ,Pulau Pinang,0,0,0,Mozambique
69137,5/1/2023,MOZ,Sabah,0,0,0,Mozambique
69138,5/1/2023,MOZ,Sarawak,0,0,0,Mozambique
69139,5/1/2023,MOZ,Selangor,71,34,37,Mozambique
69140,5/1/2023,MRT,Johor,2,2,0,Mauritania
69141,5/1/2023,MRT,Kedah,0,0,0,Mauritania
69142,5/1/2023,MRT,Pulau Pinang,0,0,0,Mauritania
69143,5/1/2023,MRT,Sabah,0,0,0,Mauritania
69144,5/1/2023,MRT,Sarawak,4,4,0,Mauritania
69145,5/1/2023,MRT,Selangor,8,7,1,Mauritania
69146,5/1/2023,MUS,Johor,142,76,66,Mauritius
69147,5/1/2023,MUS,Kedah,5,4,1,Mauritius
69148,5/1/2023,MUS,Kelantan,0,0,0,Mauritius
69149,5/1/2023,MUS,Pahang,0,0,0,Mauritius
69150,5/1/2023,MUS,Perak,0,0,0,Mauritius
69151,5/1/2023,MUS,Perlis,0,0,0,Mauritius
69152,5/1/2023,MUS,Pulau Pinang,7,6,1,Mauritius
69153,5/1/2023,MUS,Sabah,1,1,0,Mauritius
69154,5/1/2023,MUS,Sarawak,2,1,1,Mauritius
69155,5/1/2023,MUS,Selangor,1332,749,583,Mauritius
69156,5/1/2023,MWI,Johor,0,0,0,Malawi
69157,5/1/2023,MWI,Pulau Pinang,0,0,0,Malawi
69158,5/1/2023,MWI,Sabah,0,0,0,Malawi
69159,5/1/2023,MWI,Sarawak,2,0,2,Malawi
69160,5/1/2023,MWI,Selangor,16,11,5,Malawi
69161,5/1/2023,MYT,Selangor,0,0,0,Mayotte
69162,5/1/2023,NAM,Johor,4,3,1,Namibia
69163,5/1/2023,NAM,Kedah,0,0,0,Namibia
69164,5/1/2023,NAM,Perak,0,0,0,Namibia
69165,5/1/2023,NAM,Perlis,0,0,0,Namibia
69166,5/1/2023,NAM,Pulau Pinang,0,0,0,Namibia
69167,5/1/2023,NAM,Sabah,0,0,0,Namibia
69168,5/1/2023,NAM,Sarawak,0,0,0,Namibia
69169,5/1/2023,NAM,Selangor,20,3,17,Namibia
69170,5/1/2023,NCL,Selangor,0,0,0,New Caledonia
69171,5/1/2023,NER,Johor,1,1,0,Niger
69172,5/1/2023,NER,Sabah,0,0,0,Niger
69173,5/1/2023,NER,Selangor,5,4,1,Niger
69174,5/1/2023,NGA,Johor,35,32,3,Nigeria
69175,5/1/2023,NGA,Kedah,2,1,1,Nigeria
69176,5/1/2023,NGA,Perlis,0,0,0,Nigeria
69177,5/1/2023,NGA,Pulau Pinang,3,3,0,Nigeria
69178,5/1/2023,NGA,Sabah,0,0,0,Nigeria
69179,5/1/2023,NGA,Sarawak,3,2,1,Nigeria
69180,5/1/2023,NGA,Selangor,517,399,118,Nigeria
69181,5/1/2023,NIC,Johor,0,0,0,Nicaragua
69182,5/1/2023,NIC,Kedah,0,0,0,Nicaragua
69183,5/1/2023,NIC,Pulau Pinang,0,0,0,Nicaragua
69184,5/1/2023,NIC,Sabah,0,0,0,Nicaragua
69185,5/1/2023,NIC,Selangor,3,1,2,Nicaragua
69186,5/1/2023,NLD,Johor,937,622,315,Netherlands
69187,5/1/2023,NLD,Kedah,381,180,201,Netherlands
69188,5/1/2023,NLD,Kelantan,3,2,1,Netherlands
69189,5/1/2023,NLD,Melaka,0,0,0,Netherlands
69190,5/1/2023,NLD,Negeri Sembilan,0,0,0,Netherlands
69191,5/1/2023,NLD,Pahang,0,0,0,Netherlands
69192,5/1/2023,NLD,Perak,13,6,7,Netherlands
69193,5/1/2023,NLD,Perlis,28,17,11,Netherlands
69194,5/1/2023,NLD,Pulau Pinang,264,176,88,Netherlands
69195,5/1/2023,NLD,Sabah,102,51,51,Netherlands
69196,5/1/2023,NLD,Sarawak,189,123,66,Netherlands
69197,5/1/2023,NLD,Selangor,3927,2286,1641,Netherlands
69198,5/1/2023,NLD,Terengganu,0,0,0,Netherlands
69199,5/1/2023,NLD,W.P. Labuan,0,0,0,Netherlands
69200,5/1/2023,NOR,Johor,110,74,36,Norway
69201,5/1/2023,NOR,Kedah,31,16,15,Norway
69202,5/1/2023,NOR,Kelantan,0,0,0,Norway
69203,5/1/2023,NOR,Melaka,0,0,0,Norway
69204,5/1/2023,NOR,Pahang,0,0,0,Norway
69205,5/1/2023,NOR,Perak,1,1,0,Norway
69206,5/1/2023,NOR,Perlis,6,2,4,Norway
69207,5/1/2023,NOR,Pulau Pinang,17,10,7,Norway
69208,5/1/2023,NOR,Sabah,6,4,2,Norway
69209,5/1/2023,NOR,Sarawak,9,9,0,Norway
69210,5/1/2023,NOR,Selangor,466,310,156,Norway
69211,5/1/2023,NOR,W.P. Labuan,0,0,0,Norway
69212,5/1/2023,NPL,Johor,471,334,137,Nepal
69213,5/1/2023,NPL,Kedah,10,5,5,Nepal
69214,5/1/2023,NPL,Pahang,0,0,0,Nepal
69215,5/1/2023,NPL,Perak,1,1,0,Nepal
69216,5/1/2023,NPL,Perlis,0,0,0,Nepal
69217,5/1/2023,NPL,Pulau Pinang,31,23,8,Nepal
69218,5/1/2023,NPL,Sabah,4,3,1,Nepal
69219,5/1/2023,NPL,Sarawak,255,170,85,Nepal
69220,5/1/2023,NPL,Selangor,15437,14805,632,Nepal
69221,5/1/2023,NPL,W.P. Labuan,54,50,4,Nepal
69222,5/1/2023,NRU,Johor,1,0,1,Nauru
69223,5/1/2023,NRU,Pulau Pinang,0,0,0,Nauru
69224,5/1/2023,NRU,Selangor,2,2,0,Nauru
69225,5/1/2023,NZL,Johor,659,411,248,New Zealand
69226,5/1/2023,NZL,Kedah,75,43,32,New Zealand
69227,5/1/2023,NZL,Kelantan,0,0,0,New Zealand
69228,5/1/2023,NZL,Melaka,1,1,0,New Zealand
69229,5/1/2023,NZL,Negeri Sembilan,0,0,0,New Zealand
69230,5/1/2023,NZL,Pahang,3,2,1,New Zealand
69231,5/1/2023,NZL,Perak,20,12,8,New Zealand
69232,5/1/2023,NZL,Perlis,7,5,2,New Zealand
69233,5/1/2023,NZL,Pulau Pinang,199,122,77,New Zealand
69234,5/1/2023,NZL,Sabah,90,46,44,New Zealand
69235,5/1/2023,NZL,Sarawak,140,70,70,New Zealand
69236,5/1/2023,NZL,Selangor,2377,1435,942,New Zealand
69237,5/1/2023,NZL,Terengganu,0,0,0,New Zealand
69238,5/1/2023,NZL,W.P. Labuan,1,1,0,New Zealand
69239,5/1/2023,OMN,Johor,25,20,5,Oman
69240,5/1/2023,OMN,Kedah,6,3,3,Oman
69241,5/1/2023,OMN,Kelantan,0,0,0,Oman
69242,5/1/2023,OMN,Melaka,0,0,0,Oman
69243,5/1/2023,OMN,Perak,3,2,1,Oman
69244,5/1/2023,OMN,Perlis,7,5,2,Oman
69245,5/1/2023,OMN,Pulau Pinang,1,1,0,Oman
69246,5/1/2023,OMN,Sabah,1,1,0,Oman
69247,5/1/2023,OMN,Sarawak,15,8,7,Oman
69248,5/1/2023,OMN,Selangor,801,494,307,Oman
69249,5/1/2023,PAK,Johor,810,629,181,Pakistan
69250,5/1/2023,PAK,Kedah,76,52,24,Pakistan
69251,5/1/2023,PAK,Kelantan,4,4,0,Pakistan
69252,5/1/2023,PAK,Melaka,0,0,0,Pakistan
69253,5/1/2023,PAK,Negeri Sembilan,1,1,0,Pakistan
69254,5/1/2023,PAK,Pahang,0,0,0,Pakistan
69255,5/1/2023,PAK,Perak,18,18,0,Pakistan
69256,5/1/2023,PAK,Perlis,25,22,3,Pakistan
69257,5/1/2023,PAK,Pulau Pinang,133,119,14,Pakistan
69258,5/1/2023,PAK,Sabah,13,12,1,Pakistan
69259,5/1/2023,PAK,Sarawak,142,126,16,Pakistan
69260,5/1/2023,PAK,Selangor,13691,12546,1145,Pakistan
69261,5/1/2023,PAK,W.P. Labuan,0,0,0,Pakistan
69262,5/1/2023,PAN,Johor,2,1,1,Panama
69263,5/1/2023,PAN,Kedah,0,0,0,Panama
69264,5/1/2023,PAN,Perak,2,2,0,Panama
69265,5/1/2023,PAN,Perlis,0,0,0,Panama
69266,5/1/2023,PAN,Pulau Pinang,0,0,0,Panama
69267,5/1/2023,PAN,Sabah,0,0,0,Panama
69268,5/1/2023,PAN,Sarawak,0,0,0,Panama
69269,5/1/2023,PAN,Selangor,14,8,6,Panama
69270,5/1/2023,PER,Johor,20,16,4,Peru
69271,5/1/2023,PER,Kedah,5,2,3,Peru
69272,5/1/2023,PER,Kelantan,0,0,0,Peru
69273,5/1/2023,PER,Pahang,0,0,0,Peru
69274,5/1/2023,PER,Perak,0,0,0,Peru
69275,5/1/2023,PER,Perlis,0,0,0,Peru
69276,5/1/2023,PER,Pulau Pinang,2,0,2,Peru
69277,5/1/2023,PER,Sabah,1,0,1,Peru
69278,5/1/2023,PER,Sarawak,0,0,0,Peru
69279,5/1/2023,PER,Selangor,140,63,77,Peru
69280,5/1/2023,PER,W.P. Labuan,0,0,0,Peru
69281,5/1/2023,PHL,Johor,18515,5944,12571,Philippines
69282,5/1/2023,PHL,Kedah,581,161,420,Philippines
69283,5/1/2023,PHL,Kelantan,41,19,22,Philippines
69284,5/1/2023,PHL,Melaka,0,0,0,Philippines
69285,5/1/2023,PHL,Negeri Sembilan,0,0,0,Philippines
69286,5/1/2023,PHL,Pahang,36,27,9,Philippines
69287,5/1/2023,PHL,Perak,67,17,50,Philippines
69288,5/1/2023,PHL,Perlis,84,30,54,Philippines
69289,5/1/2023,PHL,Pulau Pinang,583,275,308,Philippines
69290,5/1/2023,PHL,Sabah,1086,460,626,Philippines
69291,5/1/2023,PHL,Sarawak,2556,999,1557,Philippines
69292,5/1/2023,PHL,Selangor,15100,6180,8920,Philippines
69293,5/1/2023,PHL,Terengganu,0,0,0,Philippines
69294,5/1/2023,PHL,W.P. Labuan,96,23,73,Philippines
69295,5/1/2023,PLW,Johor,0,0,0,Palau
69296,5/1/2023,PLW,Pulau Pinang,0,0,0,Palau
69297,5/1/2023,PLW,Selangor,0,0,0,Palau
69298,5/1/2023,PNG,Johor,12,7,5,Papua New Guinea
69299,5/1/2023,PNG,Kedah,2,1,1,Papua New Guinea
69300,5/1/2023,PNG,Kelantan,0,0,0,Papua New Guinea
69301,5/1/2023,PNG,Perak,0,0,0,Papua New Guinea
69302,5/1/2023,PNG,Pulau Pinang,3,1,2,Papua New Guinea
69303,5/1/2023,PNG,Sabah,0,0,0,Papua New Guinea
69304,5/1/2023,PNG,Sarawak,3,1,2,Papua New Guinea
69305,5/1/2023,PNG,Selangor,48,30,18,Papua New Guinea
69306,5/1/2023,POL,Johor,247,146,101,Poland
69307,5/1/2023,POL,Kedah,57,33,24,Poland
69308,5/1/2023,POL,Kelantan,3,1,2,Poland
69309,5/1/2023,POL,Melaka,0,0,0,Poland
69310,5/1/2023,POL,Negeri Sembilan,0,0,0,Poland
69311,5/1/2023,POL,Pahang,1,1,0,Poland
69312,5/1/2023,POL,Perak,4,2,2,Poland
69313,5/1/2023,POL,Perlis,16,10,6,Poland
69314,5/1/2023,POL,Pulau Pinang,47,25,22,Poland
69315,5/1/2023,POL,Sabah,34,17,17,Poland
69316,5/1/2023,POL,Sarawak,55,23,32,Poland
69317,5/1/2023,POL,Selangor,950,537,413,Poland
69318,5/1/2023,POL,Terengganu,0,0,0,Poland
69319,5/1/2023,POL,W.P. Labuan,3,2,1,Poland
69320,5/1/2023,PRK,Selangor,0,0,0,"Korea, Democratic People's Republic of"
69321,5/1/2023,PRT,Johor,131,85,46,Portugal
69322,5/1/2023,PRT,Kedah,36,16,20,Portugal
69323,5/1/2023,PRT,Kelantan,1,0,1,Portugal
69324,5/1/2023,PRT,Melaka,0,0,0,Portugal
69325,5/1/2023,PRT,Pahang,0,0,0,Portugal
69326,5/1/2023,PRT,Perak,0,0,0,Portugal
69327,5/1/2023,PRT,Perlis,6,5,1,Portugal
69328,5/1/2023,PRT,Pulau Pinang,39,20,19,Portugal
69329,5/1/2023,PRT,Sabah,9,8,1,Portugal
69330,5/1/2023,PRT,Sarawak,23,11,12,Portugal
69331,5/1/2023,PRT,Selangor,667,393,274,Portugal
69332,5/1/2023,PRT,W.P. Labuan,2,1,1,Portugal
69333,5/1/2023,PRY,Johor,2,0,2,Paraguay
69334,5/1/2023,PRY,Kedah,0,0,0,Paraguay
69335,5/1/2023,PRY,Perak,0,0,0,Paraguay
69336,5/1/2023,PRY,Perlis,0,0,0,Paraguay
69337,5/1/2023,PRY,Pulau Pinang,0,0,0,Paraguay
69338,5/1/2023,PRY,Sabah,0,0,0,Paraguay
69339,5/1/2023,PRY,Sarawak,0,0,0,Paraguay
69340,5/1/2023,PRY,Selangor,14,7,7,Paraguay
69341,5/1/2023,PSE,Johor,24,24,0,"Palestinian Territory, Occupied"
69342,5/1/2023,PSE,Kedah,1,1,0,"Palestinian Territory, Occupied"
69343,5/1/2023,PSE,Kelantan,0,0,0,"Palestinian Territory, Occupied"
69344,5/1/2023,PSE,Melaka,1,1,0,"Palestinian Territory, Occupied"
69345,5/1/2023,PSE,Perak,0,0,0,"Palestinian Territory, Occupied"
69346,5/1/2023,PSE,Perlis,0,0,0,"Palestinian Territory, Occupied"
69347,5/1/2023,PSE,Pulau Pinang,2,2,0,"Palestinian Territory, Occupied"
69348,5/1/2023,PSE,Sabah,1,1,0,"Palestinian Territory, Occupied"
69349,5/1/2023,PSE,Sarawak,2,1,1,"Palestinian Territory, Occupied"
69350,5/1/2023,PSE,Selangor,265,205,60,"Palestinian Territory, Occupied"
69351,5/1/2023,QAT,Johor,12,6,6,Qatar
69352,5/1/2023,QAT,Kedah,2,1,1,Qatar
69353,5/1/2023,QAT,Perlis,0,0,0,Qatar
69354,5/1/2023,QAT,Pulau Pinang,0,0,0,Qatar
69355,5/1/2023,QAT,Sabah,0,0,0,Qatar
69356,5/1/2023,QAT,Sarawak,1,1,0,Qatar
69357,5/1/2023,QAT,Selangor,108,75,33,Qatar
69358,5/1/2023,REU,Johor,0,0,0,Reunion
69359,5/1/2023,REU,Sarawak,0,0,0,Reunion
69360,5/1/2023,ROU,Johor,102,65,37,Romania
69361,5/1/2023,ROU,Kedah,12,5,7,Romania
69362,5/1/2023,ROU,Kelantan,0,0,0,Romania
69363,5/1/2023,ROU,Negeri Sembilan,0,0,0,Romania
69364,5/1/2023,ROU,Pahang,1,1,0,Romania
69365,5/1/2023,ROU,Perak,1,1,0,Romania
69366,5/1/2023,ROU,Perlis,6,3,3,Romania
69367,5/1/2023,ROU,Pulau Pinang,26,15,11,Romania
69368,5/1/2023,ROU,Sabah,2,1,1,Romania
69369,5/1/2023,ROU,Sarawak,11,9,2,Romania
69370,5/1/2023,ROU,Selangor,419,219,200,Romania
69371,5/1/2023,ROU,W.P. Labuan,0,0,0,Romania
69372,5/1/2023,RUS,Johor,418,209,209,Russia
69373,5/1/2023,RUS,Kedah,692,410,282,Russia
69374,5/1/2023,RUS,Kelantan,72,43,29,Russia
69375,5/1/2023,RUS,Melaka,1,1,0,Russia
69376,5/1/2023,RUS,Negeri Sembilan,0,0,0,Russia
69377,5/1/2023,RUS,Pahang,7,6,1,Russia
69378,5/1/2023,RUS,Perak,7,4,3,Russia
69379,5/1/2023,RUS,Perlis,300,168,132,Russia
69380,5/1/2023,RUS,Pulau Pinang,160,78,82,Russia
69381,5/1/2023,RUS,Sabah,47,28,19,Russia
69382,5/1/2023,RUS,Sarawak,77,41,36,Russia
69383,5/1/2023,RUS,Selangor,8734,4583,4151,Russia
69384,5/1/2023,RUS,W.P. Labuan,6,4,2,Russia
69385,5/1/2023,RWA,Johor,0,0,0,Rwanda
69386,5/1/2023,RWA,Kedah,0,0,0,Rwanda
69387,5/1/2023,RWA,Pulau Pinang,0,0,0,Rwanda
69388,5/1/2023,RWA,Selangor,10,6,4,Rwanda
69389,5/1/2023,SAU,Johor,109,66,43,Saudi Arabia
69390,5/1/2023,SAU,Kedah,12,6,6,Saudi Arabia
69391,5/1/2023,SAU,Kelantan,11,5,6,Saudi Arabia
69392,5/1/2023,SAU,Melaka,0,0,0,Saudi Arabia
69393,5/1/2023,SAU,Perak,3,1,2,Saudi Arabia
69394,5/1/2023,SAU,Perlis,7,2,5,Saudi Arabia
69395,5/1/2023,SAU,Pulau Pinang,35,19,16,Saudi Arabia
69396,5/1/2023,SAU,Sabah,0,0,0,Saudi Arabia
69397,5/1/2023,SAU,Sarawak,9,6,3,Saudi Arabia
69398,5/1/2023,SAU,Selangor,3381,2041,1340,Saudi Arabia
69399,5/1/2023,SAU,W.P. Labuan,0,0,0,Saudi Arabia
69400,5/1/2023,SDN,Johor,9,6,3,Sudan
69401,5/1/2023,SDN,Kedah,0,0,0,Sudan
69402,5/1/2023,SDN,Kelantan,0,0,0,Sudan
69403,5/1/2023,SDN,Perlis,0,0,0,Sudan
69404,5/1/2023,SDN,Pulau Pinang,0,0,0,Sudan
69405,5/1/2023,SDN,Sabah,0,0,0,Sudan
69406,5/1/2023,SDN,Sarawak,2,2,0,Sudan
69407,5/1/2023,SDN,Selangor,434,273,161,Sudan
69408,5/1/2023,SDN,W.P. Labuan,0,0,0,Sudan
69409,5/1/2023,SEN,Johor,21,20,1,Senegal
69410,5/1/2023,SEN,Kedah,1,0,1,Senegal
69411,5/1/2023,SEN,Kelantan,0,0,0,Senegal
69412,5/1/2023,SEN,Perak,0,0,0,Senegal
69413,5/1/2023,SEN,Perlis,0,0,0,Senegal
69414,5/1/2023,SEN,Pulau Pinang,2,1,1,Senegal
69415,5/1/2023,SEN,Sabah,0,0,0,Senegal
69416,5/1/2023,SEN,Sarawak,1,0,1,Senegal
69417,5/1/2023,SEN,Selangor,69,49,20,Senegal
69418,5/1/2023,SGP,Johor,1035130,606272,428858,Singapore
69419,5/1/2023,SGP,Kedah,4658,2620,2038,Singapore
69420,5/1/2023,SGP,Kelantan,52,39,13,Singapore
69421,5/1/2023,SGP,Melaka,18,11,7,Singapore
69422,5/1/2023,SGP,Negeri Sembilan,4,2,2,Singapore
69423,5/1/2023,SGP,Pahang,521,268,253,Singapore
69424,5/1/2023,SGP,Perak,5790,2691,3099,Singapore
69425,5/1/2023,SGP,Perlis,182,95,87,Singapore
69426,5/1/2023,SGP,Pulau Pinang,16984,8733,8251,Singapore
69427,5/1/2023,SGP,Sabah,3478,1843,1635,Singapore
69428,5/1/2023,SGP,Sarawak,4415,2542,1873,Singapore
69429,5/1/2023,SGP,Selangor,48167,24682,23485,Singapore
69430,5/1/2023,SGP,Terengganu,0,0,0,Singapore
69431,5/1/2023,SGP,W.P. Labuan,13,13,0,Singapore
69432,5/1/2023,SGS,Johor,0,0,0,South Georgia and the South Sandwich Islands
69433,5/1/2023,SGS,Sabah,0,0,0,South Georgia and the South Sandwich Islands
69434,5/1/2023,SGS,Selangor,0,0,0,South Georgia and the South Sandwich Islands
69435,5/1/2023,SHN,Sarawak,0,0,0,"Saint Helena, Ascension and Tristan da Cunha"
69436,5/1/2023,SLB,Johor,0,0,0,Solomon Islands
69437,5/1/2023,SLB,Perlis,0,0,0,Solomon Islands
69438,5/1/2023,SLB,Pulau Pinang,0,0,0,Solomon Islands
69439,5/1/2023,SLB,Sabah,1,0,1,Solomon Islands
69440,5/1/2023,SLB,Sarawak,3,1,2,Solomon Islands
69441,5/1/2023,SLB,Selangor,15,3,12,Solomon Islands
69442,5/1/2023,SLB,W.P. Labuan,0,0,0,Solomon Islands
69443,5/1/2023,SLE,Johor,1,1,0,Sierra Leone
69444,5/1/2023,SLE,Kedah,0,0,0,Sierra Leone
69445,5/1/2023,SLE,Perak,0,0,0,Sierra Leone
69446,5/1/2023,SLE,Pulau Pinang,0,0,0,Sierra Leone
69447,5/1/2023,SLE,Sabah,0,0,0,Sierra Leone
69448,5/1/2023,SLE,Selangor,11,8,3,Sierra Leone
69449,5/1/2023,SLV,Johor,5,3,2,El Salvador
69450,5/1/2023,SLV,Kedah,7,5,2,El Salvador
69451,5/1/2023,SLV,Perak,0,0,0,El Salvador
69452,5/1/2023,SLV,Perlis,0,0,0,El Salvador
69453,5/1/2023,SLV,Pulau Pinang,0,0,0,El Salvador
69454,5/1/2023,SLV,Sabah,0,0,0,El Salvador
69455,5/1/2023,SLV,Selangor,18,10,8,El Salvador
69456,5/1/2023,SLV,W.P. Labuan,0,0,0,El Salvador
69457,5/1/2023,SMR,Johor,0,0,0,San Marino
69458,5/1/2023,SMR,Selangor,3,2,1,San Marino
69459,5/1/2023,SOM,Johor,0,0,0,Somalia
69460,5/1/2023,SOM,Kedah,0,0,0,Somalia
69461,5/1/2023,SOM,Kelantan,0,0,0,Somalia
69462,5/1/2023,SOM,Perlis,0,0,0,Somalia
69463,5/1/2023,SOM,Sabah,0,0,0,Somalia
69464,5/1/2023,SOM,Sarawak,0,0,0,Somalia
69465,5/1/2023,SOM,Selangor,227,137,90,Somalia
69466,5/1/2023,SRB,Johor,4,1,3,Serbia
69467,5/1/2023,SRB,Kedah,0,0,0,Serbia
69468,5/1/2023,SRB,Kelantan,0,0,0,Serbia
69469,5/1/2023,SRB,Pahang,0,0,0,Serbia
69470,5/1/2023,SRB,Perak,0,0,0,Serbia
69471,5/1/2023,SRB,Perlis,0,0,0,Serbia
69472,5/1/2023,SRB,Pulau Pinang,5,3,2,Serbia
69473,5/1/2023,SRB,Sabah,1,0,1,Serbia
69474,5/1/2023,SRB,Sarawak,1,1,0,Serbia
69475,5/1/2023,SRB,Selangor,37,23,14,Serbia
69476,5/1/2023,STP,Selangor,4,4,0,Sao Tome and Principe
69477,5/1/2023,SUR,Johor,10,2,8,Suriname
69478,5/1/2023,SUR,Kedah,0,0,0,Suriname
69479,5/1/2023,SUR,Kelantan,0,0,0,Suriname
69480,5/1/2023,SUR,Perak,0,0,0,Suriname
69481,5/1/2023,SUR,Perlis,0,0,0,Suriname
69482,5/1/2023,SUR,Pulau Pinang,0,0,0,Suriname
69483,5/1/2023,SUR,Sabah,0,0,0,Suriname
69484,5/1/2023,SUR,Sarawak,0,0,0,Suriname
69485,5/1/2023,SUR,Selangor,27,17,10,Suriname
69486,5/1/2023,SVK,Johor,36,20,16,Slovakia
69487,5/1/2023,SVK,Kedah,37,15,22,Slovakia
69488,5/1/2023,SVK,Kelantan,0,0,0,Slovakia
69489,5/1/2023,SVK,Negeri Sembilan,0,0,0,Slovakia
69490,5/1/2023,SVK,Pahang,0,0,0,Slovakia
69491,5/1/2023,SVK,Perak,2,2,0,Slovakia
69492,5/1/2023,SVK,Perlis,1,0,1,Slovakia
69493,5/1/2023,SVK,Pulau Pinang,17,12,5,Slovakia
69494,5/1/2023,SVK,Sabah,3,2,1,Slovakia
69495,5/1/2023,SVK,Sarawak,1,1,0,Slovakia
69496,5/1/2023,SVK,Selangor,263,162,101,Slovakia
69497,5/1/2023,SVK,W.P. Labuan,1,1,0,Slovakia
69498,5/1/2023,SVN,Johor,16,10,6,Slovenia
69499,5/1/2023,SVN,Kedah,20,9,11,Slovenia
69500,5/1/2023,SVN,Kelantan,0,0,0,Slovenia
69501,5/1/2023,SVN,Perak,0,0,0,Slovenia
69502,5/1/2023,SVN,Perlis,0,0,0,Slovenia
69503,5/1/2023,SVN,Pulau Pinang,3,1,2,Slovenia
69504,5/1/2023,SVN,Sabah,0,0,0,Slovenia
69505,5/1/2023,SVN,Sarawak,0,0,0,Slovenia
69506,5/1/2023,SVN,Selangor,57,41,16,Slovenia
69507,5/1/2023,SVN,W.P. Labuan,0,0,0,Slovenia
69508,5/1/2023,SWE,Johor,224,144,80,Sweden
69509,5/1/2023,SWE,Kedah,45,24,21,Sweden
69510,5/1/2023,SWE,Kelantan,11,5,6,Sweden
69511,5/1/2023,SWE,Melaka,0,0,0,Sweden
69512,5/1/2023,SWE,Negeri Sembilan,0,0,0,Sweden
69513,5/1/2023,SWE,Pahang,0,0,0,Sweden
69514,5/1/2023,SWE,Perak,5,5,0,Sweden
69515,5/1/2023,SWE,Perlis,17,13,4,Sweden
69516,5/1/2023,SWE,Pulau Pinang,57,35,22,Sweden
69517,5/1/2023,SWE,Sabah,12,4,8,Sweden
69518,5/1/2023,SWE,Sarawak,26,15,11,Sweden
69519,5/1/2023,SWE,Selangor,653,413,240,Sweden
69520,5/1/2023,SWE,W.P. Labuan,2,2,0,Sweden
69521,5/1/2023,SWZ,Johor,0,0,0,Swaziland
69522,5/1/2023,SWZ,Kedah,0,0,0,Swaziland
69523,5/1/2023,SWZ,Pulau Pinang,0,0,0,Swaziland
69524,5/1/2023,SWZ,Sabah,0,0,0,Swaziland
69525,5/1/2023,SWZ,Selangor,5,1,4,Swaziland
69526,5/1/2023,SYC,Johor,5,0,5,Seychelles
69527,5/1/2023,SYC,Kedah,1,1,0,Seychelles
69528,5/1/2023,SYC,Pulau Pinang,0,0,0,Seychelles
69529,5/1/2023,SYC,Sabah,1,1,0,Seychelles
69530,5/1/2023,SYC,Sarawak,1,1,0,Seychelles
69531,5/1/2023,SYC,Selangor,52,20,32,Seychelles
69532,5/1/2023,SYR,Johor,18,9,9,Syrian Arab Republic
69533,5/1/2023,SYR,Kedah,2,2,0,Syrian Arab Republic
69534,5/1/2023,SYR,Kelantan,0,0,0,Syrian Arab Republic
69535,5/1/2023,SYR,Pahang,8,8,0,Syrian Arab Republic
69536,5/1/2023,SYR,Perlis,1,1,0,Syrian Arab Republic
69537,5/1/2023,SYR,Pulau Pinang,3,3,0,Syrian Arab Republic
69538,5/1/2023,SYR,Sabah,1,1,0,Syrian Arab Republic
69539,5/1/2023,SYR,Sarawak,4,3,1,Syrian Arab Republic
69540,5/1/2023,SYR,Selangor,585,420,165,Syrian Arab Republic
69541,5/1/2023,SYR,W.P. Labuan,0,0,0,Syrian Arab Republic
69542,5/1/2023,TCA,Perlis,0,0,0,Turks and Caicos
69543,5/1/2023,TCD,Johor,2,2,0,Chad
69544,5/1/2023,TCD,Kedah,0,0,0,Chad
69545,5/1/2023,TCD,Perlis,0,0,0,Chad
69546,5/1/2023,TCD,Selangor,25,23,2,Chad
69547,5/1/2023,TGO,Johor,0,0,0,Togo
69548,5/1/2023,TGO,Perak,0,0,0,Togo
69549,5/1/2023,TGO,Pulau Pinang,1,0,1,Togo
69550,5/1/2023,TGO,Selangor,5,5,0,Togo
69551,5/1/2023,THA,Johor,6574,1844,4730,Thailand
69552,5/1/2023,THA,Kedah,69698,39266,30432,Thailand
69553,5/1/2023,THA,Kelantan,50984,26984,24000,Thailand
69554,5/1/2023,THA,Melaka,1,1,0,Thailand
69555,5/1/2023,THA,Negeri Sembilan,0,0,0,Thailand
69556,5/1/2023,THA,Pahang,30,21,9,Thailand
69557,5/1/2023,THA,Perak,12545,5962,6583,Thailand
69558,5/1/2023,THA,Perlis,59332,35965,23367,Thailand
69559,5/1/2023,THA,Pulau Pinang,2280,979,1301,Thailand
69560,5/1/2023,THA,Sabah,30,11,19,Thailand
69561,5/1/2023,THA,Sarawak,449,180,269,Thailand
69562,5/1/2023,THA,Selangor,13273,5122,8151,Thailand
69563,5/1/2023,THA,Terengganu,0,0,0,Thailand
69564,5/1/2023,THA,W.P. Labuan,2,1,1,Thailand
69565,5/1/2023,TJK,Johor,4,1,3,Tajikistan
69566,5/1/2023,TJK,Kedah,2,1,1,Tajikistan
69567,5/1/2023,TJK,Perlis,0,0,0,Tajikistan
69568,5/1/2023,TJK,Pulau Pinang,0,0,0,Tajikistan
69569,5/1/2023,TJK,Sabah,3,3,0,Tajikistan
69570,5/1/2023,TJK,Selangor,85,62,23,Tajikistan
69571,5/1/2023,TKL,Selangor,0,0,0,Tokelau
69572,5/1/2023,TKM,Johor,0,0,0,Turkmenistan
69573,5/1/2023,TKM,Kedah,0,0,0,Turkmenistan
69574,5/1/2023,TKM,Kelantan,0,0,0,Turkmenistan
69575,5/1/2023,TKM,Perlis,0,0,0,Turkmenistan
69576,5/1/2023,TKM,Pulau Pinang,0,0,0,Turkmenistan
69577,5/1/2023,TKM,Sabah,0,0,0,Turkmenistan
69578,5/1/2023,TKM,Sarawak,1,1,0,Turkmenistan
69579,5/1/2023,TKM,Selangor,101,62,39,Turkmenistan
69580,5/1/2023,TLS,Johor,10,2,8,Timor-Leste
69581,5/1/2023,TLS,Kedah,0,0,0,Timor-Leste
69582,5/1/2023,TLS,Perlis,0,0,0,Timor-Leste
69583,5/1/2023,TLS,Pulau Pinang,3,3,0,Timor-Leste
69584,5/1/2023,TLS,Sabah,0,0,0,Timor-Leste
69585,5/1/2023,TLS,Sarawak,4,2,2,Timor-Leste
69586,5/1/2023,TLS,Selangor,199,116,83,Timor-Leste
69587,5/1/2023,TON,Johor,0,0,0,Tonga
69588,5/1/2023,TON,Pulau Pinang,1,0,1,Tonga
69589,5/1/2023,TON,Sarawak,0,0,0,Tonga
69590,5/1/2023,TON,Selangor,7,3,4,Tonga
69591,5/1/2023,TTO,Johor,6,4,2,Trinidad and Tobago
69592,5/1/2023,TTO,Kedah,3,1,2,Trinidad and Tobago
69593,5/1/2023,TTO,Pahang,0,0,0,Trinidad and Tobago
69594,5/1/2023,TTO,Pulau Pinang,1,1,0,Trinidad and Tobago
69595,5/1/2023,TTO,Sabah,1,0,1,Trinidad and Tobago
69596,5/1/2023,TTO,Sarawak,4,2,2,Trinidad and Tobago
69597,5/1/2023,TTO,Selangor,41,23,18,Trinidad and Tobago
69598,5/1/2023,TUN,Johor,15,10,5,Tunisia
69599,5/1/2023,TUN,Kedah,2,2,0,Tunisia
69600,5/1/2023,TUN,Kelantan,1,1,0,Tunisia
69601,5/1/2023,TUN,Melaka,0,0,0,Tunisia
69602,5/1/2023,TUN,Perak,0,0,0,Tunisia
69603,5/1/2023,TUN,Perlis,3,2,1,Tunisia
69604,5/1/2023,TUN,Pulau Pinang,4,4,0,Tunisia
69605,5/1/2023,TUN,Sabah,3,1,2,Tunisia
69606,5/1/2023,TUN,Sarawak,0,0,0,Tunisia
69607,5/1/2023,TUN,Selangor,651,344,307,Tunisia
69608,5/1/2023,TUN,W.P. Labuan,0,0,0,Tunisia
69609,5/1/2023,TUR,Johor,258,187,71,Turkey
69610,5/1/2023,TUR,Kedah,55,44,11,Turkey
69611,5/1/2023,TUR,Kelantan,4,4,0,Turkey
69612,5/1/2023,TUR,Melaka,3,3,0,Turkey
69613,5/1/2023,TUR,Negeri Sembilan,0,0,0,Turkey
69614,5/1/2023,TUR,Pahang,0,0,0,Turkey
69615,5/1/2023,TUR,Perak,4,3,1,Turkey
69616,5/1/2023,TUR,Perlis,28,22,6,Turkey
69617,5/1/2023,TUR,Pulau Pinang,24,18,6,Turkey
69618,5/1/2023,TUR,Sabah,6,4,2,Turkey
69619,5/1/2023,TUR,Sarawak,23,14,9,Turkey
69620,5/1/2023,TUR,Selangor,1290,930,360,Turkey
69621,5/1/2023,TUR,W.P. Labuan,0,0,0,Turkey
69622,5/1/2023,TUV,Selangor,1,1,0,Tuvalu
69623,5/1/2023,TWN,Johor,4729,2017,2712,Taiwan
69624,5/1/2023,TWN,Kedah,145,70,75,Taiwan
69625,5/1/2023,TWN,Kelantan,1,0,1,Taiwan
69626,5/1/2023,TWN,Melaka,8,5,3,Taiwan
69627,5/1/2023,TWN,Negeri Sembilan,0,0,0,Taiwan
69628,5/1/2023,TWN,Pahang,0,0,0,Taiwan
69629,5/1/2023,TWN,Perak,55,26,29,Taiwan
69630,5/1/2023,TWN,Perlis,24,6,18,Taiwan
69631,5/1/2023,TWN,Pulau Pinang,3940,2040,1900,Taiwan
69632,5/1/2023,TWN,Sabah,1221,606,615,Taiwan
69633,5/1/2023,TWN,Sarawak,293,150,143,Taiwan
69634,5/1/2023,TWN,Selangor,13399,6554,6845,Taiwan
69635,5/1/2023,TWN,W.P. Labuan,8,6,2,Taiwan
69636,5/1/2023,TZA,Johor,17,14,3,"Tanzania, United Republic of"
69637,5/1/2023,TZA,Kedah,5,2,3,"Tanzania, United Republic of"
69638,5/1/2023,TZA,Perak,0,0,0,"Tanzania, United Republic of"
69639,5/1/2023,TZA,Perlis,0,0,0,"Tanzania, United Republic of"
69640,5/1/2023,TZA,Pulau Pinang,0,0,0,"Tanzania, United Republic of"
69641,5/1/2023,TZA,Sabah,0,0,0,"Tanzania, United Republic of"
69642,5/1/2023,TZA,Sarawak,3,3,0,"Tanzania, United Republic of"
69643,5/1/2023,TZA,Selangor,137,63,74,"Tanzania, United Republic of"
69644,5/1/2023,UGA,Johor,7,2,5,Uganda
69645,5/1/2023,UGA,Kedah,1,0,1,Uganda
69646,5/1/2023,UGA,Perak,0,0,0,Uganda
69647,5/1/2023,UGA,Perlis,1,0,1,Uganda
69648,5/1/2023,UGA,Pulau Pinang,3,1,2,Uganda
69649,5/1/2023,UGA,Sabah,0,0,0,Uganda
69650,5/1/2023,UGA,Sarawak,1,0,1,Uganda
69651,5/1/2023,UGA,Selangor,111,64,47,Uganda
69652,5/1/2023,UKR,Johor,75,43,32,Ukraine
69653,5/1/2023,UKR,Kedah,28,10,18,Ukraine
69654,5/1/2023,UKR,Kelantan,0,0,0,Ukraine
69655,5/1/2023,UKR,Melaka,0,0,0,Ukraine
69656,5/1/2023,UKR,Negeri Sembilan,0,0,0,Ukraine
69657,5/1/2023,UKR,Pahang,3,3,0,Ukraine
69658,5/1/2023,UKR,Perak,0,0,0,Ukraine
69659,5/1/2023,UKR,Perlis,8,4,4,Ukraine
69660,5/1/2023,UKR,Pulau Pinang,31,17,14,Ukraine
69661,5/1/2023,UKR,Sabah,5,3,2,Ukraine
69662,5/1/2023,UKR,Sarawak,1,0,1,Ukraine
69663,5/1/2023,UKR,Selangor,934,433,501,Ukraine
69664,5/1/2023,UKR,W.P. Labuan,0,0,0,Ukraine
69665,5/1/2023,URY,Johor,24,12,12,Uruguay
69666,5/1/2023,URY,Kedah,0,0,0,Uruguay
69667,5/1/2023,URY,Kelantan,0,0,0,Uruguay
69668,5/1/2023,URY,Perak,0,0,0,Uruguay
69669,5/1/2023,URY,Perlis,0,0,0,Uruguay
69670,5/1/2023,URY,Pulau Pinang,1,1,0,Uruguay
69671,5/1/2023,URY,Sabah,0,0,0,Uruguay
69672,5/1/2023,URY,Sarawak,0,0,0,Uruguay
69673,5/1/2023,URY,Selangor,265,136,129,Uruguay
69674,5/1/2023,URY,W.P. Labuan,0,0,0,Uruguay
69675,5/1/2023,USA,Johor,4050,2362,1688,United States Of America
69676,5/1/2023,USA,Kedah,576,332,244,United States Of America
69677,5/1/2023,USA,Kelantan,13,8,5,United States Of America
69678,5/1/2023,USA,Melaka,1,0,1,United States Of America
69679,5/1/2023,USA,Negeri Sembilan,1,0,1,United States Of America
69680,5/1/2023,USA,Pahang,12,7,5,United States Of America
69681,5/1/2023,USA,Perak,118,71,47,United States Of America
69682,5/1/2023,USA,Perlis,91,54,37,United States Of America
69683,5/1/2023,USA,Pulau Pinang,1815,1163,652,United States Of America
69684,5/1/2023,USA,Sabah,357,187,170,United States Of America
69685,5/1/2023,USA,Sarawak,352,200,152,United States Of America
69686,5/1/2023,USA,Selangor,12392,7406,4986,United States Of America
69687,5/1/2023,USA,Terengganu,0,0,0,United States Of America
69688,5/1/2023,USA,W.P. Labuan,10,7,3,United States Of America
69689,5/1/2023,UZB,Johor,111,99,12,Uzbekistan
69690,5/1/2023,UZB,Kedah,11,9,2,Uzbekistan
69691,5/1/2023,UZB,Kelantan,0,0,0,Uzbekistan
69692,5/1/2023,UZB,Perak,0,0,0,Uzbekistan
69693,5/1/2023,UZB,Perlis,1,1,0,Uzbekistan
69694,5/1/2023,UZB,Pulau Pinang,10,2,8,Uzbekistan
69695,5/1/2023,UZB,Sabah,9,7,2,Uzbekistan
69696,5/1/2023,UZB,Sarawak,0,0,0,Uzbekistan
69697,5/1/2023,UZB,Selangor,817,492,325,Uzbekistan
69698,5/1/2023,VAT,Johor,0,0,0,Holy See (Vatican City State)
69699,5/1/2023,VAT,Sarawak,0,0,0,Holy See (Vatican City State)
69700,5/1/2023,VAT,Selangor,1,1,0,Holy See (Vatican City State)
69701,5/1/2023,VCT,Johor,1,1,0,Saint Vincent and the Grenadines
69702,5/1/2023,VCT,Kedah,0,0,0,Saint Vincent and the Grenadines
69703,5/1/2023,VCT,Pulau Pinang,0,0,0,Saint Vincent and the Grenadines
69704,5/1/2023,VCT,Sarawak,0,0,0,Saint Vincent and the Grenadines
69705,5/1/2023,VCT,Selangor,4,4,0,Saint Vincent and the Grenadines
69706,5/1/2023,VEN,Johor,16,11,5,Venezuela
69707,5/1/2023,VEN,Kedah,2,0,2,Venezuela
69708,5/1/2023,VEN,Kelantan,0,0,0,Venezuela
69709,5/1/2023,VEN,Melaka,0,0,0,Venezuela
69710,5/1/2023,VEN,Perak,0,0,0,Venezuela
69711,5/1/2023,VEN,Perlis,0,0,0,Venezuela
69712,5/1/2023,VEN,Pulau Pinang,2,2,0,Venezuela
69713,5/1/2023,VEN,Sabah,5,3,2,Venezuela
69714,5/1/2023,VEN,Sarawak,6,5,1,Venezuela
69715,5/1/2023,VEN,Selangor,85,49,36,Venezuela
69716,5/1/2023,VEN,W.P. Labuan,2,2,0,Venezuela
69717,5/1/2023,VNM,Johor,18818,5840,12978,Vietnam
69718,5/1/2023,VNM,Kedah,321,67,254,Vietnam
69719,5/1/2023,VNM,Kelantan,13,1,12,Vietnam
69720,5/1/2023,VNM,Melaka,0,0,0,Vietnam
69721,5/1/2023,VNM,Negeri Sembilan,0,0,0,Vietnam
69722,5/1/2023,VNM,Pahang,3,3,0,Vietnam
69723,5/1/2023,VNM,Perak,141,12,129,Vietnam
69724,5/1/2023,VNM,Perlis,233,24,209,Vietnam
69725,5/1/2023,VNM,Pulau Pinang,1554,465,1089,Vietnam
69726,5/1/2023,VNM,Sabah,22,5,17,Vietnam
69727,5/1/2023,VNM,Sarawak,256,50,206,Vietnam
69728,5/1/2023,VNM,Selangor,17961,6159,11802,Vietnam
69729,5/1/2023,VNM,Terengganu,0,0,0,Vietnam
69730,5/1/2023,VNM,W.P. Labuan,1,1,0,Vietnam
69731,5/1/2023,VUT,Johor,33,28,5,Vanuatu
69732,5/1/2023,VUT,Kedah,0,0,0,Vanuatu
69733,5/1/2023,VUT,Pulau Pinang,6,5,1,Vanuatu
69734,5/1/2023,VUT,Sabah,0,0,0,Vanuatu
69735,5/1/2023,VUT,Sarawak,0,0,0,Vanuatu
69736,5/1/2023,VUT,Selangor,60,52,8,Vanuatu
69737,5/1/2023,WSM,Johor,0,0,0,Samoa
69738,5/1/2023,WSM,Sarawak,1,0,1,Samoa
69739,5/1/2023,WSM,Selangor,1,0,1,Samoa
69740,5/1/2023,YEM,Johor,23,17,6,Yemen
69741,5/1/2023,YEM,Kedah,0,0,0,Yemen
69742,5/1/2023,YEM,Kelantan,0,0,0,Yemen
69743,5/1/2023,YEM,Melaka,0,0,0,Yemen
69744,5/1/2023,YEM,Pahang,0,0,0,Yemen
69745,5/1/2023,YEM,Perak,0,0,0,Yemen
69746,5/1/2023,YEM,Perlis,0,0,0,Yemen
69747,5/1/2023,YEM,Pulau Pinang,3,3,0,Yemen
69748,5/1/2023,YEM,Sabah,0,0,0,Yemen
69749,5/1/2023,YEM,Sarawak,4,1,3,Yemen
69750,5/1/2023,YEM,Selangor,1201,833,368,Yemen
69751,5/1/2023,YEM,W.P. Labuan,0,0,0,Yemen
69752,5/1/2023,ZAF,Johor,216,143,73,South Africa
69753,5/1/2023,ZAF,Kedah,33,21,12,South Africa
69754,5/1/2023,ZAF,Kelantan,3,2,1,South Africa
69755,5/1/2023,ZAF,Melaka,0,0,0,South Africa
69756,5/1/2023,ZAF,Pahang,0,0,0,South Africa
69757,5/1/2023,ZAF,Perak,1,0,1,South Africa
69758,5/1/2023,ZAF,Perlis,12,9,3,South Africa
69759,5/1/2023,ZAF,Pulau Pinang,35,21,14,South Africa
69760,5/1/2023,ZAF,Sabah,17,11,6,South Africa
69761,5/1/2023,ZAF,Sarawak,81,44,37,South Africa
69762,5/1/2023,ZAF,Selangor,768,443,325,South Africa
69763,5/1/2023,ZAF,Terengganu,0,0,0,South Africa
69764,5/1/2023,ZAF,W.P. Labuan,1,1,0,South Africa
69765,5/1/2023,ZMB,Johor,2,2,0,Zambia
69766,5/1/2023,ZMB,Kedah,0,0,0,Zambia
69767,5/1/2023,ZMB,Perak,0,0,0,Zambia
69768,5/1/2023,ZMB,Perlis,0,0,0,Zambia
69769,5/1/2023,ZMB,Pulau Pinang,0,0,0,Zambia
69770,5/1/2023,ZMB,Sabah,0,0,0,Zambia
69771,5/1/2023,ZMB,Sarawak,1,1,0,Zambia
69772,5/1/2023,ZMB,Selangor,46,19,27,Zambia
69773,5/1/2023,ZWE,Johor,17,10,7,Zimbabwe
69774,5/1/2023,ZWE,Kedah,2,1,1,Zimbabwe
69775,5/1/2023,ZWE,Kelantan,0,0,0,Zimbabwe
69776,5/1/2023,ZWE,Perak,0,0,0,Zimbabwe
69777,5/1/2023,ZWE,Perlis,1,1,0,Zimbabwe
69778,5/1/2023,ZWE,Pulau Pinang,0,0,0,Zimbabwe
69779,5/1/2023,ZWE,Sabah,0,0,0,Zimbabwe
69780,5/1/2023,ZWE,Sarawak,0,0,0,Zimbabwe
69781,5/1/2023,ZWE,Selangor,88,48,40,Zimbabwe
69782,6/1/2023,ABW,Kedah,0,0,0,Aruba
69783,6/1/2023,ABW,Pulau Pinang,0,0,0,Aruba
69784,6/1/2023,AFG,Johor,1,1,0,Afghanistan
69785,6/1/2023,AFG,Kedah,0,0,0,Afghanistan
69786,6/1/2023,AFG,Perlis,0,0,0,Afghanistan
69787,6/1/2023,AFG,Pulau Pinang,0,0,0,Afghanistan
69788,6/1/2023,AFG,Sarawak,0,0,0,Afghanistan
69789,6/1/2023,AFG,Selangor,43,33,10,Afghanistan
69790,6/1/2023,AGO,Johor,0,0,0,Angola
69791,6/1/2023,AGO,Kedah,0,0,0,Angola
69792,6/1/2023,AGO,Sabah,0,0,0,Angola
69793,6/1/2023,AGO,Selangor,12,8,4,Angola
69794,6/1/2023,AIA,Selangor,0,0,0,Anguilla
69795,6/1/2023,ALB,Johor,10,10,0,Albania
69796,6/1/2023,ALB,Kedah,0,0,0,Albania
69797,6/1/2023,ALB,Perak,0,0,0,Albania
69798,6/1/2023,ALB,Perlis,0,0,0,Albania
69799,6/1/2023,ALB,Pulau Pinang,0,0,0,Albania
69800,6/1/2023,ALB,Sabah,0,0,0,Albania
69801,6/1/2023,ALB,Sarawak,0,0,0,Albania
69802,6/1/2023,ALB,Selangor,16,10,6,Albania
69803,6/1/2023,AND,Johor,0,0,0,Andorra
69804,6/1/2023,AND,Kedah,0,0,0,Andorra
69805,6/1/2023,AND,Perlis,0,0,0,Andorra
69806,6/1/2023,AND,Pulau Pinang,0,0,0,Andorra
69807,6/1/2023,AND,Selangor,1,1,0,Andorra
69808,6/1/2023,ANT,Selangor,0,0,0,Netherlands Antilles
69809,6/1/2023,ARE,Johor,23,16,7,United Arab Emirates
69810,6/1/2023,ARE,Kedah,1,0,1,United Arab Emirates
69811,6/1/2023,ARE,Kelantan,2,2,0,United Arab Emirates
69812,6/1/2023,ARE,Perak,0,0,0,United Arab Emirates
69813,6/1/2023,ARE,Perlis,4,4,0,United Arab Emirates
69814,6/1/2023,ARE,Pulau Pinang,4,4,0,United Arab Emirates
69815,6/1/2023,ARE,Sabah,0,0,0,United Arab Emirates
69816,6/1/2023,ARE,Sarawak,0,0,0,United Arab Emirates
69817,6/1/2023,ARE,Selangor,732,395,337,United Arab Emirates
69818,6/1/2023,ARG,Johor,76,40,36,Argentina
69819,6/1/2023,ARG,Kedah,4,4,0,Argentina
69820,6/1/2023,ARG,Kelantan,0,0,0,Argentina
69821,6/1/2023,ARG,Melaka,0,0,0,Argentina
69822,6/1/2023,ARG,Perak,1,1,0,Argentina
69823,6/1/2023,ARG,Perlis,3,2,1,Argentina
69824,6/1/2023,ARG,Pulau Pinang,11,7,4,Argentina
69825,6/1/2023,ARG,Sabah,1,1,0,Argentina
69826,6/1/2023,ARG,Sarawak,1,1,0,Argentina
69827,6/1/2023,ARG,Selangor,216,124,92,Argentina
69828,6/1/2023,ARG,W.P. Labuan,0,0,0,Argentina
69829,6/1/2023,ARM,Johor,9,5,4,Armenia
69830,6/1/2023,ARM,Kedah,0,0,0,Armenia
69831,6/1/2023,ARM,Kelantan,0,0,0,Armenia
69832,6/1/2023,ARM,Perak,0,0,0,Armenia
69833,6/1/2023,ARM,Perlis,0,0,0,Armenia
69834,6/1/2023,ARM,Pulau Pinang,2,0,2,Armenia
69835,6/1/2023,ARM,Sabah,0,0,0,Armenia
69836,6/1/2023,ARM,Sarawak,0,0,0,Armenia
69837,6/1/2023,ARM,Selangor,101,32,69,Armenia
69838,6/1/2023,ATA,Selangor,0,0,0,Antarctica
69839,6/1/2023,ATG,Johor,3,3,0,Antigua and Barbuda
69840,6/1/2023,ATG,Kedah,0,0,0,Antigua and Barbuda
69841,6/1/2023,ATG,Pulau Pinang,0,0,0,Antigua and Barbuda
69842,6/1/2023,ATG,Sarawak,0,0,0,Antigua and Barbuda
69843,6/1/2023,ATG,Selangor,15,11,4,Antigua and Barbuda
69844,6/1/2023,AUS,Johor,4705,2736,1969,Australia
69845,6/1/2023,AUS,Kedah,593,310,283,Australia
69846,6/1/2023,AUS,Kelantan,11,5,6,Australia
69847,6/1/2023,AUS,Melaka,0,0,0,Australia
69848,6/1/2023,AUS,Negeri Sembilan,0,0,0,Australia
69849,6/1/2023,AUS,Pahang,32,16,16,Australia
69850,6/1/2023,AUS,Perak,182,98,84,Australia
69851,6/1/2023,AUS,Perlis,97,60,37,Australia
69852,6/1/2023,AUS,Pulau Pinang,1961,1027,934,Australia
69853,6/1/2023,AUS,Sabah,294,153,141,Australia
69854,6/1/2023,AUS,Sarawak,523,305,218,Australia
69855,6/1/2023,AUS,Selangor,17718,10048,7670,Australia
69856,6/1/2023,AUS,Terengganu,0,0,0,Australia
69857,6/1/2023,AUS,W.P. Labuan,21,17,4,Australia
69858,6/1/2023,AUT,Johor,101,62,39,Austria
69859,6/1/2023,AUT,Kedah,17,9,8,Austria
69860,6/1/2023,AUT,Kelantan,3,3,0,Austria
69861,6/1/2023,AUT,Melaka,1,1,0,Austria
69862,6/1/2023,AUT,Negeri Sembilan,0,0,0,Austria
69863,6/1/2023,AUT,Pahang,0,0,0,Austria
69864,6/1/2023,AUT,Perak,1,1,0,Austria
69865,6/1/2023,AUT,Perlis,5,4,1,Austria
69866,6/1/2023,AUT,Pulau Pinang,60,48,12,Austria
69867,6/1/2023,AUT,Sabah,9,6,3,Austria
69868,6/1/2023,AUT,Sarawak,13,10,3,Austria
69869,6/1/2023,AUT,Selangor,403,269,134,Austria
69870,6/1/2023,AUT,Terengganu,0,0,0,Austria
69871,6/1/2023,AUT,W.P. Labuan,0,0,0,Austria
69872,6/1/2023,AZE,Johor,5,3,2,Azerbaijan
69873,6/1/2023,AZE,Kedah,3,2,1,Azerbaijan
69874,6/1/2023,AZE,Kelantan,0,0,0,Azerbaijan
69875,6/1/2023,AZE,Melaka,0,0,0,Azerbaijan
69876,6/1/2023,AZE,Perlis,0,0,0,Azerbaijan
69877,6/1/2023,AZE,Pulau Pinang,0,0,0,Azerbaijan
69878,6/1/2023,AZE,Sabah,0,0,0,Azerbaijan
69879,6/1/2023,AZE,Sarawak,0,0,0,Azerbaijan
69880,6/1/2023,AZE,Selangor,80,54,26,Azerbaijan
69881,6/1/2023,AZE,W.P. Labuan,10,10,0,Azerbaijan
69882,6/1/2023,BDI,Pulau Pinang,0,0,0,Burundi
69883,6/1/2023,BDI,Sarawak,0,0,0,Burundi
69884,6/1/2023,BDI,Selangor,8,3,5,Burundi
69885,6/1/2023,BEL,Johor,209,132,77,Belgium
69886,6/1/2023,BEL,Kedah,29,13,16,Belgium
69887,6/1/2023,BEL,Kelantan,3,2,1,Belgium
69888,6/1/2023,BEL,Melaka,0,0,0,Belgium
69889,6/1/2023,BEL,Negeri Sembilan,0,0,0,Belgium
69890,6/1/2023,BEL,Pahang,2,2,0,Belgium
69891,6/1/2023,BEL,Perak,3,1,2,Belgium
69892,6/1/2023,BEL,Perlis,23,16,7,Belgium
69893,6/1/2023,BEL,Pulau Pinang,35,28,7,Belgium
69894,6/1/2023,BEL,Sabah,25,20,5,Belgium
69895,6/1/2023,BEL,Sarawak,27,16,11,Belgium
69896,6/1/2023,BEL,Selangor,826,490,336,Belgium
69897,6/1/2023,BEL,W.P. Labuan,0,0,0,Belgium
69898,6/1/2023,BEN,Johor,0,0,0,Benin
69899,6/1/2023,BEN,Kedah,0,0,0,Benin
69900,6/1/2023,BEN,Perak,1,1,0,Benin
69901,6/1/2023,BEN,Pulau Pinang,0,0,0,Benin
69902,6/1/2023,BEN,Sabah,0,0,0,Benin
69903,6/1/2023,BEN,Sarawak,0,0,0,Benin
69904,6/1/2023,BEN,Selangor,9,7,2,Benin
69905,6/1/2023,BFA,Perak,0,0,0,Burkina Faso
69906,6/1/2023,BFA,Pulau Pinang,0,0,0,Burkina Faso
69907,6/1/2023,BFA,Selangor,1,1,0,Burkina Faso
69908,6/1/2023,BGD,Johor,3887,3327,560,Bangladesh
69909,6/1/2023,BGD,Kedah,110,65,45,Bangladesh
69910,6/1/2023,BGD,Kelantan,3,3,0,Bangladesh
69911,6/1/2023,BGD,Melaka,0,0,0,Bangladesh
69912,6/1/2023,BGD,Negeri Sembilan,0,0,0,Bangladesh
69913,6/1/2023,BGD,Pahang,0,0,0,Bangladesh
69914,6/1/2023,BGD,Perak,4,2,2,Bangladesh
69915,6/1/2023,BGD,Perlis,3,3,0,Bangladesh
69916,6/1/2023,BGD,Pulau Pinang,308,288,20,Bangladesh
69917,6/1/2023,BGD,Sabah,6,3,3,Bangladesh
69918,6/1/2023,BGD,Sarawak,18,16,2,Bangladesh
69919,6/1/2023,BGD,Selangor,47417,46058,1359,Bangladesh
69920,6/1/2023,BGD,W.P. Labuan,12,12,0,Bangladesh
69921,6/1/2023,BGR,Johor,25,14,11,Bulgaria
69922,6/1/2023,BGR,Kedah,5,3,2,Bulgaria
69923,6/1/2023,BGR,Kelantan,0,0,0,Bulgaria
69924,6/1/2023,BGR,Pahang,0,0,0,Bulgaria
69925,6/1/2023,BGR,Perak,1,0,1,Bulgaria
69926,6/1/2023,BGR,Perlis,2,0,2,Bulgaria
69927,6/1/2023,BGR,Pulau Pinang,3,3,0,Bulgaria
69928,6/1/2023,BGR,Sabah,1,0,1,Bulgaria
69929,6/1/2023,BGR,Sarawak,3,3,0,Bulgaria
69930,6/1/2023,BGR,Selangor,112,58,54,Bulgaria
69931,6/1/2023,BGR,W.P. Labuan,1,0,1,Bulgaria
69932,6/1/2023,BHR,Johor,14,8,6,Bahrain
69933,6/1/2023,BHR,Kedah,4,2,2,Bahrain
69934,6/1/2023,BHR,Kelantan,0,0,0,Bahrain
69935,6/1/2023,BHR,Perlis,1,1,0,Bahrain
69936,6/1/2023,BHR,Pulau Pinang,1,1,0,Bahrain
69937,6/1/2023,BHR,Sabah,0,0,0,Bahrain
69938,6/1/2023,BHR,Sarawak,1,0,1,Bahrain
69939,6/1/2023,BHR,Selangor,254,138,116,Bahrain
69940,6/1/2023,BHS,Johor,0,0,0,Bahamas
69941,6/1/2023,BHS,Kedah,0,0,0,Bahamas
69942,6/1/2023,BHS,Perak,0,0,0,Bahamas
69943,6/1/2023,BHS,Sabah,0,0,0,Bahamas
69944,6/1/2023,BHS,Sarawak,0,0,0,Bahamas
69945,6/1/2023,BHS,Selangor,9,5,4,Bahamas
69946,6/1/2023,BIH,Johor,5,3,2,Bosnia and Herzegovina
69947,6/1/2023,BIH,Kedah,0,0,0,Bosnia and Herzegovina
69948,6/1/2023,BIH,Perlis,0,0,0,Bosnia and Herzegovina
69949,6/1/2023,BIH,Pulau Pinang,1,1,0,Bosnia and Herzegovina
69950,6/1/2023,BIH,Sabah,1,1,0,Bosnia and Herzegovina
69951,6/1/2023,BIH,Sarawak,1,1,0,Bosnia and Herzegovina
69952,6/1/2023,BIH,Selangor,32,21,11,Bosnia and Herzegovina
69953,6/1/2023,BLR,Johor,26,9,17,Belarus
69954,6/1/2023,BLR,Kedah,7,3,4,Belarus
69955,6/1/2023,BLR,Kelantan,1,0,1,Belarus
69956,6/1/2023,BLR,Pahang,0,0,0,Belarus
69957,6/1/2023,BLR,Perak,0,0,0,Belarus
69958,6/1/2023,BLR,Perlis,1,1,0,Belarus
69959,6/1/2023,BLR,Pulau Pinang,9,5,4,Belarus
69960,6/1/2023,BLR,Sabah,2,1,1,Belarus
69961,6/1/2023,BLR,Sarawak,0,0,0,Belarus
69962,6/1/2023,BLR,Selangor,184,71,113,Belarus
69963,6/1/2023,BLR,W.P. Labuan,0,0,0,Belarus
69964,6/1/2023,BLZ,Johor,1,1,0,Belize
69965,6/1/2023,BLZ,Pulau Pinang,0,0,0,Belize
69966,6/1/2023,BLZ,Sarawak,0,0,0,Belize
69967,6/1/2023,BLZ,Selangor,1,1,0,Belize
69968,6/1/2023,BMU,Selangor,0,0,0,Bermuda
69969,6/1/2023,BOL,Johor,3,2,1,Bolivia
69970,6/1/2023,BOL,Kedah,1,0,1,Bolivia
69971,6/1/2023,BOL,Melaka,0,0,0,Bolivia
69972,6/1/2023,BOL,Perak,0,0,0,Bolivia
69973,6/1/2023,BOL,Perlis,0,0,0,Bolivia
69974,6/1/2023,BOL,Pulau Pinang,1,0,1,Bolivia
69975,6/1/2023,BOL,Sabah,0,0,0,Bolivia
69976,6/1/2023,BOL,Sarawak,0,0,0,Bolivia
69977,6/1/2023,BOL,Selangor,4,1,3,Bolivia
69978,6/1/2023,BRA,Johor,237,136,101,Brazil
69979,6/1/2023,BRA,Kedah,21,8,13,Brazil
69980,6/1/2023,BRA,Kelantan,2,2,0,Brazil
69981,6/1/2023,BRA,Melaka,0,0,0,Brazil
69982,6/1/2023,BRA,Pahang,0,0,0,Brazil
69983,6/1/2023,BRA,Perak,3,2,1,Brazil
69984,6/1/2023,BRA,Perlis,1,1,0,Brazil
69985,6/1/2023,BRA,Pulau Pinang,16,11,5,Brazil
69986,6/1/2023,BRA,Sabah,5,1,4,Brazil
69987,6/1/2023,BRA,Sarawak,10,7,3,Brazil
69988,6/1/2023,BRA,Selangor,520,291,229,Brazil
69989,6/1/2023,BRA,W.P. Labuan,0,0,0,Brazil
69990,6/1/2023,BRB,Johor,6,2,4,Barbados
69991,6/1/2023,BRB,Kedah,0,0,0,Barbados
69992,6/1/2023,BRB,Perlis,0,0,0,Barbados
69993,6/1/2023,BRB,Pulau Pinang,0,0,0,Barbados
69994,6/1/2023,BRB,Selangor,9,5,4,Barbados
69995,6/1/2023,BRN,Johor,377,205,172,Brunei Darussalam
69996,6/1/2023,BRN,Kedah,5,5,0,Brunei Darussalam
69997,6/1/2023,BRN,Kelantan,10,7,3,Brunei Darussalam
69998,6/1/2023,BRN,Melaka,0,0,0,Brunei Darussalam
69999,6/1/2023,BRN,Pahang,0,0,0,Brunei Darussalam
70000,6/1/2023,BRN,Perak,3,2,1,Brunei Darussalam
70001,6/1/2023,BRN,Perlis,46,24,22,Brunei Darussalam
70002,6/1/2023,BRN,Pulau Pinang,11,5,6,Brunei Darussalam
70003,6/1/2023,BRN,Sabah,793,310,483,Brunei Darussalam
70004,6/1/2023,BRN,Sarawak,71268,39748,31520,Brunei Darussalam
70005,6/1/2023,BRN,Selangor,2820,1454,1366,Brunei Darussalam
70006,6/1/2023,BRN,W.P. Labuan,1035,686,349,Brunei Darussalam
70007,6/1/2023,BTN,Johor,12,7,5,Bhutan
70008,6/1/2023,BTN,Kedah,0,0,0,Bhutan
70009,6/1/2023,BTN,Perak,0,0,0,Bhutan
70010,6/1/2023,BTN,Perlis,0,0,0,Bhutan
70011,6/1/2023,BTN,Pulau Pinang,6,6,0,Bhutan
70012,6/1/2023,BTN,Sabah,0,0,0,Bhutan
70013,6/1/2023,BTN,Sarawak,0,0,0,Bhutan
70014,6/1/2023,BTN,Selangor,17,9,8,Bhutan
70015,6/1/2023,BWA,Johor,3,2,1,Botswana
70016,6/1/2023,BWA,Kedah,0,0,0,Botswana
70017,6/1/2023,BWA,Perlis,0,0,0,Botswana
70018,6/1/2023,BWA,Pulau Pinang,0,0,0,Botswana
70019,6/1/2023,BWA,Sabah,0,0,0,Botswana
70020,6/1/2023,BWA,Sarawak,0,0,0,Botswana
70021,6/1/2023,BWA,Selangor,14,10,4,Botswana
70022,6/1/2023,CAF,Kedah,0,0,0,Central African Republic
70023,6/1/2023,CAF,Selangor,0,0,0,Central African Republic
70024,6/1/2023,CAN,Johor,1140,633,507,Canada
70025,6/1/2023,CAN,Kedah,112,57,55,Canada
70026,6/1/2023,CAN,Kelantan,1,1,0,Canada
70027,6/1/2023,CAN,Melaka,2,1,1,Canada
70028,6/1/2023,CAN,Negeri Sembilan,0,0,0,Canada
70029,6/1/2023,CAN,Pahang,1,1,0,Canada
70030,6/1/2023,CAN,Perak,38,24,14,Canada
70031,6/1/2023,CAN,Perlis,35,19,16,Canada
70032,6/1/2023,CAN,Pulau Pinang,409,201,208,Canada
70033,6/1/2023,CAN,Sabah,67,36,31,Canada
70034,6/1/2023,CAN,Sarawak,253,132,121,Canada
70035,6/1/2023,CAN,Selangor,2375,1410,965,Canada
70036,6/1/2023,CAN,Terengganu,0,0,0,Canada
70037,6/1/2023,CAN,W.P. Labuan,1,1,0,Canada
70038,6/1/2023,CCK,Selangor,0,0,0,Cocos (Keeling) Islands
70039,6/1/2023,CHE,Johor,346,195,151,Switzerland
70040,6/1/2023,CHE,Kedah,80,43,37,Switzerland
70041,6/1/2023,CHE,Kelantan,2,2,0,Switzerland
70042,6/1/2023,CHE,Melaka,2,1,1,Switzerland
70043,6/1/2023,CHE,Negeri Sembilan,0,0,0,Switzerland
70044,6/1/2023,CHE,Pahang,9,6,3,Switzerland
70045,6/1/2023,CHE,Perak,5,4,1,Switzerland
70046,6/1/2023,CHE,Perlis,15,7,8,Switzerland
70047,6/1/2023,CHE,Pulau Pinang,76,47,29,Switzerland
70048,6/1/2023,CHE,Sabah,19,10,9,Switzerland
70049,6/1/2023,CHE,Sarawak,34,19,15,Switzerland
70050,6/1/2023,CHE,Selangor,723,456,267,Switzerland
70051,6/1/2023,CHE,W.P. Labuan,0,0,0,Switzerland
70052,6/1/2023,CHL,Johor,18,11,7,Chile
70053,6/1/2023,CHL,Kedah,6,3,3,Chile
70054,6/1/2023,CHL,Kelantan,0,0,0,Chile
70055,6/1/2023,CHL,Melaka,0,0,0,Chile
70056,6/1/2023,CHL,Pahang,0,0,0,Chile
70057,6/1/2023,CHL,Perak,0,0,0,Chile
70058,6/1/2023,CHL,Perlis,7,5,2,Chile
70059,6/1/2023,CHL,Pulau Pinang,12,6,6,Chile
70060,6/1/2023,CHL,Sabah,1,1,0,Chile
70061,6/1/2023,CHL,Sarawak,1,1,0,Chile
70062,6/1/2023,CHL,Selangor,145,78,67,Chile
70063,6/1/2023,CHN,Johor,41635,17973,23662,China
70064,6/1/2023,CHN,Kedah,895,387,508,China
70065,6/1/2023,CHN,Kelantan,3,1,2,China
70066,6/1/2023,CHN,Melaka,2,1,1,China
70067,6/1/2023,CHN,Pahang,21,6,15,China
70068,6/1/2023,CHN,Perak,248,116,132,China
70069,6/1/2023,CHN,Perlis,93,38,55,China
70070,6/1/2023,CHN,Pulau Pinang,8331,4361,3970,China
70071,6/1/2023,CHN,Sabah,5479,2637,2842,China
70072,6/1/2023,CHN,Sarawak,741,349,392,China
70073,6/1/2023,CHN,Selangor,52309,27061,25248,China
70074,6/1/2023,CHN,Terengganu,0,0,0,China
70075,6/1/2023,CHN,W.P. Labuan,58,48,10,China
70076,6/1/2023,CIV,Johor,2,0,2,C��te d'Iv
70077,6/1/2023,CIV,Kedah,0,0,0,C��te d'Iv
70078,6/1/2023,CIV,Pulau Pinang,0,0,0,C��te d'Iv
70079,6/1/2023,CIV,Sabah,0,0,0,C��te d'Iv
70080,6/1/2023,CIV,Sarawak,0,0,0,C��te d'Iv
70081,6/1/2023,CIV,Selangor,15,13,2,C��te d'Iv
70082,6/1/2023,CMR,Johor,3,3,0,Cameroon
70083,6/1/2023,CMR,Kedah,0,0,0,Cameroon
70084,6/1/2023,CMR,Pulau Pinang,0,0,0,Cameroon
70085,6/1/2023,CMR,Sabah,0,0,0,Cameroon
70086,6/1/2023,CMR,Sarawak,0,0,0,Cameroon
70087,6/1/2023,CMR,Selangor,19,15,4,Cameroon
70088,6/1/2023,COD,Johor,2,2,0,"Congo, the Democratic Republic of the"
70089,6/1/2023,COD,Pulau Pinang,0,0,0,"Congo, the Democratic Republic of the"
70090,6/1/2023,COD,Sarawak,0,0,0,"Congo, the Democratic Republic of the"
70091,6/1/2023,COD,Selangor,15,12,3,"Congo, the Democratic Republic of the"
70092,6/1/2023,COG,Johor,0,0,0,Congo
70093,6/1/2023,COG,Kedah,0,0,0,Congo
70094,6/1/2023,COG,Selangor,1,0,1,Congo
70095,6/1/2023,COK,Selangor,0,0,0,Cook Islands
70096,6/1/2023,COL,Johor,27,13,14,Colombia
70097,6/1/2023,COL,Kedah,0,0,0,Colombia
70098,6/1/2023,COL,Perak,0,0,0,Colombia
70099,6/1/2023,COL,Pulau Pinang,5,3,2,Colombia
70100,6/1/2023,COL,Sabah,1,0,1,Colombia
70101,6/1/2023,COL,Sarawak,0,0,0,Colombia
70102,6/1/2023,COL,Selangor,152,69,83,Colombia
70103,6/1/2023,COL,W.P. Labuan,0,0,0,Colombia
70104,6/1/2023,COM,Johor,2,0,2,Comoros
70105,6/1/2023,COM,Kedah,0,0,0,Comoros
70106,6/1/2023,COM,Selangor,34,24,10,Comoros
70107,6/1/2023,CPV,Johor,0,0,0,Cape Verde
70108,6/1/2023,CPV,Kedah,0,0,0,Cape Verde
70109,6/1/2023,CPV,Pulau Pinang,0,0,0,Cape Verde
70110,6/1/2023,CPV,Sabah,0,0,0,Cape Verde
70111,6/1/2023,CPV,Selangor,2,2,0,Cape Verde
70112,6/1/2023,CRI,Johor,9,6,3,Costa Rica
70113,6/1/2023,CRI,Kedah,1,0,1,Costa Rica
70114,6/1/2023,CRI,Perak,0,0,0,Costa Rica
70115,6/1/2023,CRI,Perlis,0,0,0,Costa Rica
70116,6/1/2023,CRI,Pulau Pinang,2,2,0,Costa Rica
70117,6/1/2023,CRI,Sabah,3,2,1,Costa Rica
70118,6/1/2023,CRI,Sarawak,0,0,0,Costa Rica
70119,6/1/2023,CRI,Selangor,30,13,17,Costa Rica
70120,6/1/2023,CUB,Johor,3,2,1,Cuba
70121,6/1/2023,CUB,Kedah,0,0,0,Cuba
70122,6/1/2023,CUB,Perlis,0,0,0,Cuba
70123,6/1/2023,CUB,Pulau Pinang,1,0,1,Cuba
70124,6/1/2023,CUB,Sabah,0,0,0,Cuba
70125,6/1/2023,CUB,Sarawak,0,0,0,Cuba
70126,6/1/2023,CUB,Selangor,21,12,9,Cuba
70127,6/1/2023,CYP,Johor,7,7,0,Cyprus
70128,6/1/2023,CYP,Kedah,0,0,0,Cyprus
70129,6/1/2023,CYP,Perak,0,0,0,Cyprus
70130,6/1/2023,CYP,Perlis,0,0,0,Cyprus
70131,6/1/2023,CYP,Pulau Pinang,2,1,1,Cyprus
70132,6/1/2023,CYP,Sabah,0,0,0,Cyprus
70133,6/1/2023,CYP,Sarawak,0,0,0,Cyprus
70134,6/1/2023,CYP,Selangor,67,51,16,Cyprus
70135,6/1/2023,CZE,Johor,105,73,32,Czech Republic
70136,6/1/2023,CZE,Kedah,19,11,8,Czech Republic
70137,6/1/2023,CZE,Kelantan,0,0,0,Czech Republic
70138,6/1/2023,CZE,Melaka,0,0,0,Czech Republic
70139,6/1/2023,CZE,Negeri Sembilan,0,0,0,Czech Republic
70140,6/1/2023,CZE,Perak,0,0,0,Czech Republic
70141,6/1/2023,CZE,Perlis,2,2,0,Czech Republic
70142,6/1/2023,CZE,Pulau Pinang,5,3,2,Czech Republic
70143,6/1/2023,CZE,Sabah,7,3,4,Czech Republic
70144,6/1/2023,CZE,Sarawak,13,9,4,Czech Republic
70145,6/1/2023,CZE,Selangor,251,150,101,Czech Republic
70146,6/1/2023,CZE,W.P. Labuan,1,1,0,Czech Republic
70147,6/1/2023,DEU,Johor,1893,1163,730,Germany
70148,6/1/2023,DEU,Kedah,313,161,152,Germany
70149,6/1/2023,DEU,Kelantan,13,10,3,Germany
70150,6/1/2023,DEU,Melaka,10,5,5,Germany
70151,6/1/2023,DEU,Negeri Sembilan,0,0,0,Germany
70152,6/1/2023,DEU,Pahang,15,7,8,Germany
70153,6/1/2023,DEU,Perak,32,19,13,Germany
70154,6/1/2023,DEU,Perlis,80,49,31,Germany
70155,6/1/2023,DEU,Pulau Pinang,510,383,127,Germany
70156,6/1/2023,DEU,Sabah,134,83,51,Germany
70157,6/1/2023,DEU,Sarawak,200,111,89,Germany
70158,6/1/2023,DEU,Selangor,4102,2595,1507,Germany
70159,6/1/2023,DEU,Terengganu,0,0,0,Germany
70160,6/1/2023,DEU,W.P. Labuan,5,4,1,Germany
70161,6/1/2023,DJI,Johor,0,0,0,Djibouti
70162,6/1/2023,DJI,Selangor,8,7,1,Djibouti
70163,6/1/2023,DMA,Johor,9,9,0,Dominica
70164,6/1/2023,DMA,Kedah,0,0,0,Dominica
70165,6/1/2023,DMA,Pulau Pinang,0,0,0,Dominica
70166,6/1/2023,DMA,Sabah,0,0,0,Dominica
70167,6/1/2023,DMA,Sarawak,2,1,1,Dominica
70168,6/1/2023,DMA,Selangor,37,30,7,Dominica
70169,6/1/2023,DMA,W.P. Labuan,0,0,0,Dominica
70170,6/1/2023,DNK,Johor,231,169,62,Denmark
70171,6/1/2023,DNK,Kedah,16,11,5,Denmark
70172,6/1/2023,DNK,Kelantan,6,5,1,Denmark
70173,6/1/2023,DNK,Melaka,0,0,0,Denmark
70174,6/1/2023,DNK,Negeri Sembilan,0,0,0,Denmark
70175,6/1/2023,DNK,Pahang,0,0,0,Denmark
70176,6/1/2023,DNK,Perak,8,5,3,Denmark
70177,6/1/2023,DNK,Perlis,10,5,5,Denmark
70178,6/1/2023,DNK,Pulau Pinang,50,37,13,Denmark
70179,6/1/2023,DNK,Sabah,24,16,8,Denmark
70180,6/1/2023,DNK,Sarawak,7,6,1,Denmark
70181,6/1/2023,DNK,Selangor,673,389,284,Denmark
70182,6/1/2023,DNK,W.P. Labuan,0,0,0,Denmark
70183,6/1/2023,DOM,Johor,2,0,2,Dominican Republic
70184,6/1/2023,DOM,Kedah,1,0,1,Dominican Republic
70185,6/1/2023,DOM,Perak,0,0,0,Dominican Republic
70186,6/1/2023,DOM,Perlis,0,0,0,Dominican Republic
70187,6/1/2023,DOM,Pulau Pinang,0,0,0,Dominican Republic
70188,6/1/2023,DOM,Sabah,0,0,0,Dominican Republic
70189,6/1/2023,DOM,Sarawak,0,0,0,Dominican Republic
70190,6/1/2023,DOM,Selangor,18,13,5,Dominican Republic
70191,6/1/2023,DZA,Johor,18,16,2,Algeria
70192,6/1/2023,DZA,Kedah,3,3,0,Algeria
70193,6/1/2023,DZA,Kelantan,0,0,0,Algeria
70194,6/1/2023,DZA,Melaka,0,0,0,Algeria
70195,6/1/2023,DZA,Perak,1,1,0,Algeria
70196,6/1/2023,DZA,Perlis,0,0,0,Algeria
70197,6/1/2023,DZA,Pulau Pinang,5,3,2,Algeria
70198,6/1/2023,DZA,Sabah,1,0,1,Algeria
70199,6/1/2023,DZA,Sarawak,8,7,1,Algeria
70200,6/1/2023,DZA,Selangor,467,305,162,Algeria
70201,6/1/2023,DZA,W.P. Labuan,0,0,0,Algeria
70202,6/1/2023,ECU,Johor,16,5,11,Ecuador
70203,6/1/2023,ECU,Kedah,0,0,0,Ecuador
70204,6/1/2023,ECU,Perak,0,0,0,Ecuador
70205,6/1/2023,ECU,Perlis,0,0,0,Ecuador
70206,6/1/2023,ECU,Pulau Pinang,2,0,2,Ecuador
70207,6/1/2023,ECU,Sabah,0,0,0,Ecuador
70208,6/1/2023,ECU,Sarawak,0,0,0,Ecuador
70209,6/1/2023,ECU,Selangor,46,17,29,Ecuador
70210,6/1/2023,EGY,Johor,228,176,52,Egypt
70211,6/1/2023,EGY,Kedah,8,7,1,Egypt
70212,6/1/2023,EGY,Kelantan,1,1,0,Egypt
70213,6/1/2023,EGY,Melaka,0,0,0,Egypt
70214,6/1/2023,EGY,Pahang,0,0,0,Egypt
70215,6/1/2023,EGY,Perak,3,2,1,Egypt
70216,6/1/2023,EGY,Perlis,6,3,3,Egypt
70217,6/1/2023,EGY,Pulau Pinang,12,11,1,Egypt
70218,6/1/2023,EGY,Sabah,5,5,0,Egypt
70219,6/1/2023,EGY,Sarawak,105,74,31,Egypt
70220,6/1/2023,EGY,Selangor,1495,1012,483,Egypt
70221,6/1/2023,EGY,Terengganu,0,0,0,Egypt
70222,6/1/2023,EGY,W.P. Labuan,1,1,0,Egypt
70223,6/1/2023,ERI,Johor,1,1,0,Eritrea
70224,6/1/2023,ERI,Pulau Pinang,0,0,0,Eritrea
70225,6/1/2023,ERI,Sabah,0,0,0,Eritrea
70226,6/1/2023,ERI,Selangor,24,13,11,Eritrea
70227,6/1/2023,ESP,Johor,476,316,160,Spain
70228,6/1/2023,ESP,Kedah,59,28,31,Spain
70229,6/1/2023,ESP,Kelantan,3,3,0,Spain
70230,6/1/2023,ESP,Melaka,0,0,0,Spain
70231,6/1/2023,ESP,Negeri Sembilan,0,0,0,Spain
70232,6/1/2023,ESP,Pahang,0,0,0,Spain
70233,6/1/2023,ESP,Perak,2,0,2,Spain
70234,6/1/2023,ESP,Perlis,18,15,3,Spain
70235,6/1/2023,ESP,Pulau Pinang,83,55,28,Spain
70236,6/1/2023,ESP,Sabah,29,14,15,Spain
70237,6/1/2023,ESP,Sarawak,42,26,16,Spain
70238,6/1/2023,ESP,Selangor,1499,856,643,Spain
70239,6/1/2023,ESP,W.P. Labuan,2,0,2,Spain
70240,6/1/2023,EST,Johor,25,16,9,Estonia
70241,6/1/2023,EST,Kedah,2,0,2,Estonia
70242,6/1/2023,EST,Kelantan,0,0,0,Estonia
70243,6/1/2023,EST,Pahang,0,0,0,Estonia
70244,6/1/2023,EST,Perak,0,0,0,Estonia
70245,6/1/2023,EST,Perlis,1,0,1,Estonia
70246,6/1/2023,EST,Pulau Pinang,4,4,0,Estonia
70247,6/1/2023,EST,Sabah,0,0,0,Estonia
70248,6/1/2023,EST,Sarawak,2,1,1,Estonia
70249,6/1/2023,EST,Selangor,60,29,31,Estonia
70250,6/1/2023,EST,W.P. Labuan,1,0,1,Estonia
70251,6/1/2023,ETH,Johor,1,0,1,Ethiopia
70252,6/1/2023,ETH,Kedah,0,0,0,Ethiopia
70253,6/1/2023,ETH,Pulau Pinang,0,0,0,Ethiopia
70254,6/1/2023,ETH,Sarawak,0,0,0,Ethiopia
70255,6/1/2023,ETH,Selangor,38,24,14,Ethiopia
70256,6/1/2023,FIN,Johor,148,83,65,Finland
70257,6/1/2023,FIN,Kedah,19,10,9,Finland
70258,6/1/2023,FIN,Kelantan,1,1,0,Finland
70259,6/1/2023,FIN,Melaka,0,0,0,Finland
70260,6/1/2023,FIN,Negeri Sembilan,0,0,0,Finland
70261,6/1/2023,FIN,Pahang,0,0,0,Finland
70262,6/1/2023,FIN,Perak,7,3,4,Finland
70263,6/1/2023,FIN,Perlis,7,6,1,Finland
70264,6/1/2023,FIN,Pulau Pinang,19,15,4,Finland
70265,6/1/2023,FIN,Sabah,9,3,6,Finland
70266,6/1/2023,FIN,Sarawak,9,5,4,Finland
70267,6/1/2023,FIN,Selangor,266,159,107,Finland
70268,6/1/2023,FIN,W.P. Labuan,0,0,0,Finland
70269,6/1/2023,FJI,Johor,71,27,44,Fiji
70270,6/1/2023,FJI,Kedah,0,0,0,Fiji
70271,6/1/2023,FJI,Kelantan,0,0,0,Fiji
70272,6/1/2023,FJI,Perak,0,0,0,Fiji
70273,6/1/2023,FJI,Perlis,0,0,0,Fiji
70274,6/1/2023,FJI,Pulau Pinang,4,1,3,Fiji
70275,6/1/2023,FJI,Sabah,0,0,0,Fiji
70276,6/1/2023,FJI,Sarawak,1,0,1,Fiji
70277,6/1/2023,FJI,Selangor,109,57,52,Fiji
70278,6/1/2023,FRA,Johor,1998,1171,827,France
70279,6/1/2023,FRA,Kedah,295,173,122,France
70280,6/1/2023,FRA,Kelantan,21,13,8,France
70281,6/1/2023,FRA,Melaka,3,2,1,France
70282,6/1/2023,FRA,Negeri Sembilan,0,0,0,France
70283,6/1/2023,FRA,Pahang,20,13,7,France
70284,6/1/2023,FRA,Perak,32,21,11,France
70285,6/1/2023,FRA,Perlis,82,47,35,France
70286,6/1/2023,FRA,Pulau Pinang,363,230,133,France
70287,6/1/2023,FRA,Sabah,105,67,38,France
70288,6/1/2023,FRA,Sarawak,126,78,48,France
70289,6/1/2023,FRA,Selangor,5098,3025,2073,France
70290,6/1/2023,FRA,Terengganu,0,0,0,France
70291,6/1/2023,FRA,W.P. Labuan,0,0,0,France
70292,6/1/2023,FSM,Johor,0,0,0,"Micronesia, Federated States of"
70293,6/1/2023,FSM,Pulau Pinang,0,0,0,"Micronesia, Federated States of"
70294,6/1/2023,FSM,Selangor,2,1,1,"Micronesia, Federated States of"
70295,6/1/2023,GAB,Johor,2,0,2,Gabon
70296,6/1/2023,GAB,Pulau Pinang,0,0,0,Gabon
70297,6/1/2023,GAB,Sarawak,0,0,0,Gabon
70298,6/1/2023,GAB,Selangor,7,3,4,Gabon
70299,6/1/2023,GBR,Johor,4561,2911,1650,United Kingdom
70300,6/1/2023,GBR,Kedah,671,367,304,United Kingdom
70301,6/1/2023,GBR,Kelantan,16,10,6,United Kingdom
70302,6/1/2023,GBR,Melaka,1,1,0,United Kingdom
70303,6/1/2023,GBR,Negeri Sembilan,0,0,0,United Kingdom
70304,6/1/2023,GBR,Pahang,14,10,4,United Kingdom
70305,6/1/2023,GBR,Perak,87,59,28,United Kingdom
70306,6/1/2023,GBR,Perlis,191,106,85,United Kingdom
70307,6/1/2023,GBR,Pulau Pinang,1122,711,411,United Kingdom
70308,6/1/2023,GBR,Sabah,391,231,160,United Kingdom
70309,6/1/2023,GBR,Sarawak,961,583,378,United Kingdom
70310,6/1/2023,GBR,Selangor,11393,6950,4443,United Kingdom
70311,6/1/2023,GBR,Terengganu,0,0,0,United Kingdom
70312,6/1/2023,GBR,W.P. Labuan,30,22,8,United Kingdom
70313,6/1/2023,GEO,Johor,9,5,4,Georgia
70314,6/1/2023,GEO,Kedah,2,1,1,Georgia
70315,6/1/2023,GEO,Melaka,0,0,0,Georgia
70316,6/1/2023,GEO,Perak,0,0,0,Georgia
70317,6/1/2023,GEO,Perlis,1,1,0,Georgia
70318,6/1/2023,GEO,Pulau Pinang,0,0,0,Georgia
70319,6/1/2023,GEO,Sabah,1,1,0,Georgia
70320,6/1/2023,GEO,Sarawak,0,0,0,Georgia
70321,6/1/2023,GEO,Selangor,42,24,18,Georgia
70322,6/1/2023,GHA,Johor,5,4,1,Ghana
70323,6/1/2023,GHA,Kedah,0,0,0,Ghana
70324,6/1/2023,GHA,Kelantan,0,0,0,Ghana
70325,6/1/2023,GHA,Pulau Pinang,2,1,1,Ghana
70326,6/1/2023,GHA,Sabah,2,1,1,Ghana
70327,6/1/2023,GHA,Sarawak,0,0,0,Ghana
70328,6/1/2023,GHA,Selangor,49,40,9,Ghana
70329,6/1/2023,GIB,Johor,0,0,0,Gibraltar
70330,6/1/2023,GIB,Sarawak,0,0,0,Gibraltar
70331,6/1/2023,GIN,Johor,1,1,0,Guinea
70332,6/1/2023,GIN,Kedah,0,0,0,Guinea
70333,6/1/2023,GIN,Kelantan,0,0,0,Guinea
70334,6/1/2023,GIN,Perlis,0,0,0,Guinea
70335,6/1/2023,GIN,Pulau Pinang,0,0,0,Guinea
70336,6/1/2023,GIN,Sabah,0,0,0,Guinea
70337,6/1/2023,GIN,Sarawak,0,0,0,Guinea
70338,6/1/2023,GIN,Selangor,41,26,15,Guinea
70339,6/1/2023,GLP,Selangor,0,0,0,Guadeloupe
70340,6/1/2023,GMB,Johor,1,1,0,Gambia
70341,6/1/2023,GMB,Kedah,0,0,0,Gambia
70342,6/1/2023,GMB,Kelantan,0,0,0,Gambia
70343,6/1/2023,GMB,Pulau Pinang,0,0,0,Gambia
70344,6/1/2023,GMB,Sabah,0,0,0,Gambia
70345,6/1/2023,GMB,Sarawak,0,0,0,Gambia
70346,6/1/2023,GMB,Selangor,25,18,7,Gambia
70347,6/1/2023,GNB,Johor,1,1,0,Guinea-Bissau
70348,6/1/2023,GNB,Selangor,0,0,0,Guinea-Bissau
70349,6/1/2023,GNQ,Johor,0,0,0,Equatorial Guinea
70350,6/1/2023,GNQ,Selangor,1,1,0,Equatorial Guinea
70351,6/1/2023,GRC,Johor,50,40,10,Greece
70352,6/1/2023,GRC,Kedah,3,2,1,Greece
70353,6/1/2023,GRC,Kelantan,0,0,0,Greece
70354,6/1/2023,GRC,Melaka,0,0,0,Greece
70355,6/1/2023,GRC,Negeri Sembilan,0,0,0,Greece
70356,6/1/2023,GRC,Pahang,0,0,0,Greece
70357,6/1/2023,GRC,Perak,0,0,0,Greece
70358,6/1/2023,GRC,Perlis,2,2,0,Greece
70359,6/1/2023,GRC,Pulau Pinang,4,3,1,Greece
70360,6/1/2023,GRC,Sabah,12,7,5,Greece
70361,6/1/2023,GRC,Sarawak,0,0,0,Greece
70362,6/1/2023,GRC,Selangor,134,106,28,Greece
70363,6/1/2023,GRD,Johor,5,1,4,Grenada
70364,6/1/2023,GRD,Kedah,3,0,3,Grenada
70365,6/1/2023,GRD,Pulau Pinang,0,0,0,Grenada
70366,6/1/2023,GRD,Sabah,0,0,0,Grenada
70367,6/1/2023,GRD,Sarawak,0,0,0,Grenada
70368,6/1/2023,GRD,Selangor,6,4,2,Grenada
70369,6/1/2023,GRL,Johor,0,0,0,Greenland
70370,6/1/2023,GRL,Selangor,0,0,0,Greenland
70371,6/1/2023,GTM,Johor,3,0,3,Guatemala
70372,6/1/2023,GTM,Kedah,0,0,0,Guatemala
70373,6/1/2023,GTM,Pahang,0,0,0,Guatemala
70374,6/1/2023,GTM,Perak,0,0,0,Guatemala
70375,6/1/2023,GTM,Pulau Pinang,1,1,0,Guatemala
70376,6/1/2023,GTM,Sabah,0,0,0,Guatemala
70377,6/1/2023,GTM,Sarawak,1,0,1,Guatemala
70378,6/1/2023,GTM,Selangor,12,9,3,Guatemala
70379,6/1/2023,GTM,W.P. Labuan,1,0,1,Guatemala
70380,6/1/2023,GUY,Johor,0,0,0,Guyana
70381,6/1/2023,GUY,Kedah,0,0,0,Guyana
70382,6/1/2023,GUY,Pulau Pinang,1,0,1,Guyana
70383,6/1/2023,GUY,Sarawak,0,0,0,Guyana
70384,6/1/2023,GUY,Selangor,3,2,1,Guyana
70385,6/1/2023,HKG,Johor,2,2,0,Hong Kong
70386,6/1/2023,HKG,Kedah,0,0,0,Hong Kong
70387,6/1/2023,HKG,Kelantan,0,0,0,Hong Kong
70388,6/1/2023,HKG,Pahang,0,0,0,Hong Kong
70389,6/1/2023,HKG,Perak,51,12,39,Hong Kong
70390,6/1/2023,HKG,Perlis,0,0,0,Hong Kong
70391,6/1/2023,HKG,Pulau Pinang,0,0,0,Hong Kong
70392,6/1/2023,HKG,Sabah,11,8,3,Hong Kong
70393,6/1/2023,HKG,Sarawak,0,0,0,Hong Kong
70394,6/1/2023,HKG,Selangor,7,1,6,Hong Kong
70395,6/1/2023,HKG,Terengganu,0,0,0,Hong Kong
70396,6/1/2023,HMD,Johor,0,0,0,Heard Island and McDonald Islands
70397,6/1/2023,HND,Johor,5,3,2,Honduras
70398,6/1/2023,HND,Kedah,1,1,0,Honduras
70399,6/1/2023,HND,Perak,0,0,0,Honduras
70400,6/1/2023,HND,Pulau Pinang,1,0,1,Honduras
70401,6/1/2023,HND,Sabah,0,0,0,Honduras
70402,6/1/2023,HND,Sarawak,0,0,0,Honduras
70403,6/1/2023,HND,Selangor,10,7,3,Honduras
70404,6/1/2023,HRV,Johor,29,23,6,Croatia
70405,6/1/2023,HRV,Kedah,2,1,1,Croatia
70406,6/1/2023,HRV,Kelantan,0,0,0,Croatia
70407,6/1/2023,HRV,Melaka,0,0,0,Croatia
70408,6/1/2023,HRV,Pahang,0,0,0,Croatia
70409,6/1/2023,HRV,Perak,0,0,0,Croatia
70410,6/1/2023,HRV,Perlis,0,0,0,Croatia
70411,6/1/2023,HRV,Pulau Pinang,2,2,0,Croatia
70412,6/1/2023,HRV,Sabah,0,0,0,Croatia
70413,6/1/2023,HRV,Sarawak,2,1,1,Croatia
70414,6/1/2023,HRV,Selangor,85,58,27,Croatia
70415,6/1/2023,HTI,Johor,0,0,0,Haiti
70416,6/1/2023,HTI,Kedah,0,0,0,Haiti
70417,6/1/2023,HTI,Kelantan,0,0,0,Haiti
70418,6/1/2023,HTI,Perak,0,0,0,Haiti
70419,6/1/2023,HTI,Pulau Pinang,0,0,0,Haiti
70420,6/1/2023,HTI,Sabah,0,0,0,Haiti
70421,6/1/2023,HTI,Selangor,2,2,0,Haiti
70422,6/1/2023,HUN,Johor,60,36,24,Hungary
70423,6/1/2023,HUN,Kedah,13,7,6,Hungary
70424,6/1/2023,HUN,Kelantan,0,0,0,Hungary
70425,6/1/2023,HUN,Pahang,0,0,0,Hungary
70426,6/1/2023,HUN,Perak,3,1,2,Hungary
70427,6/1/2023,HUN,Perlis,5,2,3,Hungary
70428,6/1/2023,HUN,Pulau Pinang,18,14,4,Hungary
70429,6/1/2023,HUN,Sabah,7,6,1,Hungary
70430,6/1/2023,HUN,Sarawak,6,5,1,Hungary
70431,6/1/2023,HUN,Selangor,254,148,106,Hungary
70432,6/1/2023,HUN,W.P. Labuan,0,0,0,Hungary
70433,6/1/2023,IDN,Johor,101577,46878,54699,Indonesia
70434,6/1/2023,IDN,Kedah,5320,1974,3346,Indonesia
70435,6/1/2023,IDN,Kelantan,109,59,50,Indonesia
70436,6/1/2023,IDN,Melaka,5091,2392,2699,Indonesia
70437,6/1/2023,IDN,Negeri Sembilan,5032,3302,1730,Indonesia
70438,6/1/2023,IDN,Pahang,28,18,10,Indonesia
70439,6/1/2023,IDN,Perak,250,59,191,Indonesia
70440,6/1/2023,IDN,Perlis,595,220,375,Indonesia
70441,6/1/2023,IDN,Pulau Pinang,42475,17224,25251,Indonesia
70442,6/1/2023,IDN,Sabah,4907,2323,2584,Indonesia
70443,6/1/2023,IDN,Sarawak,34662,17072,17590,Indonesia
70444,6/1/2023,IDN,Selangor,75546,35482,40064,Indonesia
70445,6/1/2023,IDN,Terengganu,0,0,0,Indonesia
70446,6/1/2023,IDN,W.P. Labuan,55,32,23,Indonesia
70447,6/1/2023,IND,Johor,28743,18283,10460,India
70448,6/1/2023,IND,Kedah,1697,881,816,India
70449,6/1/2023,IND,Kelantan,5,4,1,India
70450,6/1/2023,IND,Melaka,0,0,0,India
70451,6/1/2023,IND,Negeri Sembilan,0,0,0,India
70452,6/1/2023,IND,Pahang,5,5,0,India
70453,6/1/2023,IND,Perak,441,330,111,India
70454,6/1/2023,IND,Perlis,28,20,8,India
70455,6/1/2023,IND,Pulau Pinang,946,625,321,India
70456,6/1/2023,IND,Sabah,195,112,83,India
70457,6/1/2023,IND,Sarawak,1028,795,233,India
70458,6/1/2023,IND,Selangor,36628,24600,12028,India
70459,6/1/2023,IND,Terengganu,0,0,0,India
70460,6/1/2023,IND,W.P. Labuan,55,42,13,India
70461,6/1/2023,IOT,Pulau Pinang,0,0,0,British Indian Ocean Territory
70462,6/1/2023,IOT,Selangor,0,0,0,British Indian Ocean Territory
70463,6/1/2023,IRL,Johor,259,160,99,Ireland
70464,6/1/2023,IRL,Kedah,65,33,32,Ireland
70465,6/1/2023,IRL,Kelantan,0,0,0,Ireland
70466,6/1/2023,IRL,Negeri Sembilan,0,0,0,Ireland
70467,6/1/2023,IRL,Pahang,3,1,2,Ireland
70468,6/1/2023,IRL,Perak,8,4,4,Ireland
70469,6/1/2023,IRL,Perlis,14,8,6,Ireland
70470,6/1/2023,IRL,Pulau Pinang,106,62,44,Ireland
70471,6/1/2023,IRL,Sabah,22,15,7,Ireland
70472,6/1/2023,IRL,Sarawak,49,24,25,Ireland
70473,6/1/2023,IRL,Selangor,1087,645,442,Ireland
70474,6/1/2023,IRL,Terengganu,0,0,0,Ireland
70475,6/1/2023,IRL,W.P. Labuan,0,0,0,Ireland
70476,6/1/2023,IRN,Johor,182,103,79,Iran
70477,6/1/2023,IRN,Kedah,7,5,2,Iran
70478,6/1/2023,IRN,Kelantan,0,0,0,Iran
70479,6/1/2023,IRN,Perak,0,0,0,Iran
70480,6/1/2023,IRN,Perlis,0,0,0,Iran
70481,6/1/2023,IRN,Pulau Pinang,3,2,1,Iran
70482,6/1/2023,IRN,Sabah,0,0,0,Iran
70483,6/1/2023,IRN,Sarawak,8,6,2,Iran
70484,6/1/2023,IRN,Selangor,1119,593,526,Iran
70485,6/1/2023,IRN,W.P. Labuan,0,0,0,Iran
70486,6/1/2023,IRQ,Johor,28,20,8,Iraq
70487,6/1/2023,IRQ,Kedah,0,0,0,Iraq
70488,6/1/2023,IRQ,Kelantan,0,0,0,Iraq
70489,6/1/2023,IRQ,Melaka,0,0,0,Iraq
70490,6/1/2023,IRQ,Pahang,0,0,0,Iraq
70491,6/1/2023,IRQ,Perak,0,0,0,Iraq
70492,6/1/2023,IRQ,Perlis,0,0,0,Iraq
70493,6/1/2023,IRQ,Pulau Pinang,1,0,1,Iraq
70494,6/1/2023,IRQ,Sabah,0,0,0,Iraq
70495,6/1/2023,IRQ,Sarawak,0,0,0,Iraq
70496,6/1/2023,IRQ,Selangor,1349,838,511,Iraq
70497,6/1/2023,ISL,Johor,1,0,1,Iceland
70498,6/1/2023,ISL,Kedah,7,3,4,Iceland
70499,6/1/2023,ISL,Kelantan,0,0,0,Iceland
70500,6/1/2023,ISL,Perak,0,0,0,Iceland
70501,6/1/2023,ISL,Perlis,0,0,0,Iceland
70502,6/1/2023,ISL,Pulau Pinang,0,0,0,Iceland
70503,6/1/2023,ISL,Sabah,0,0,0,Iceland
70504,6/1/2023,ISL,Sarawak,0,0,0,Iceland
70505,6/1/2023,ISL,Selangor,22,12,10,Iceland
70506,6/1/2023,ISL,W.P. Labuan,0,0,0,Iceland
70507,6/1/2023,ISR,Pulau Pinang,0,0,0,Israel
70508,6/1/2023,ITA,Johor,502,338,164,Italy
70509,6/1/2023,ITA,Kedah,46,29,17,Italy
70510,6/1/2023,ITA,Kelantan,2,1,1,Italy
70511,6/1/2023,ITA,Melaka,0,0,0,Italy
70512,6/1/2023,ITA,Negeri Sembilan,0,0,0,Italy
70513,6/1/2023,ITA,Pahang,2,1,1,Italy
70514,6/1/2023,ITA,Perak,4,1,3,Italy
70515,6/1/2023,ITA,Perlis,19,10,9,Italy
70516,6/1/2023,ITA,Pulau Pinang,104,75,29,Italy
70517,6/1/2023,ITA,Sabah,16,11,5,Italy
70518,6/1/2023,ITA,Sarawak,52,36,16,Italy
70519,6/1/2023,ITA,Selangor,1743,1178,565,Italy
70520,6/1/2023,ITA,W.P. Labuan,1,1,0,Italy
70521,6/1/2023,JAM,Johor,2,1,1,Jamaica
70522,6/1/2023,JAM,Kedah,1,1,0,Jamaica
70523,6/1/2023,JAM,Perak,0,0,0,Jamaica
70524,6/1/2023,JAM,Pulau Pinang,1,0,1,Jamaica
70525,6/1/2023,JAM,Sabah,0,0,0,Jamaica
70526,6/1/2023,JAM,Sarawak,0,0,0,Jamaica
70527,6/1/2023,JAM,Selangor,25,13,12,Jamaica
70528,6/1/2023,JAM,W.P. Labuan,2,1,1,Jamaica
70529,6/1/2023,JOR,Johor,14,8,6,Jordan
70530,6/1/2023,JOR,Kedah,2,1,1,Jordan
70531,6/1/2023,JOR,Kelantan,0,0,0,Jordan
70532,6/1/2023,JOR,Melaka,0,0,0,Jordan
70533,6/1/2023,JOR,Perlis,1,1,0,Jordan
70534,6/1/2023,JOR,Pulau Pinang,9,6,3,Jordan
70535,6/1/2023,JOR,Sabah,6,2,4,Jordan
70536,6/1/2023,JOR,Sarawak,1,1,0,Jordan
70537,6/1/2023,JOR,Selangor,1022,621,401,Jordan
70538,6/1/2023,JOR,W.P. Labuan,0,0,0,Jordan
70539,6/1/2023,JPN,Johor,5269,3665,1604,Japan
70540,6/1/2023,JPN,Kedah,130,75,55,Japan
70541,6/1/2023,JPN,Kelantan,7,6,1,Japan
70542,6/1/2023,JPN,Melaka,1,1,0,Japan
70543,6/1/2023,JPN,Negeri Sembilan,0,0,0,Japan
70544,6/1/2023,JPN,Pahang,4,2,2,Japan
70545,6/1/2023,JPN,Perak,49,27,22,Japan
70546,6/1/2023,JPN,Perlis,51,38,13,Japan
70547,6/1/2023,JPN,Pulau Pinang,1071,771,300,Japan
70548,6/1/2023,JPN,Sabah,151,75,76,Japan
70549,6/1/2023,JPN,Sarawak,155,95,60,Japan
70550,6/1/2023,JPN,Selangor,10682,7221,3461,Japan
70551,6/1/2023,JPN,W.P. Labuan,15,8,7,Japan
70552,6/1/2023,KAZ,Johor,50,26,24,Kazakhstan
70553,6/1/2023,KAZ,Kedah,3,2,1,Kazakhstan
70554,6/1/2023,KAZ,Kelantan,1,0,1,Kazakhstan
70555,6/1/2023,KAZ,Melaka,0,0,0,Kazakhstan
70556,6/1/2023,KAZ,Perak,0,0,0,Kazakhstan
70557,6/1/2023,KAZ,Perlis,3,2,1,Kazakhstan
70558,6/1/2023,KAZ,Pulau Pinang,16,6,10,Kazakhstan
70559,6/1/2023,KAZ,Sabah,2,1,1,Kazakhstan
70560,6/1/2023,KAZ,Sarawak,1,0,1,Kazakhstan
70561,6/1/2023,KAZ,Selangor,556,231,325,Kazakhstan
70562,6/1/2023,KAZ,W.P. Labuan,0,0,0,Kazakhstan
70563,6/1/2023,KEN,Johor,55,28,27,Kenya
70564,6/1/2023,KEN,Kedah,1,1,0,Kenya
70565,6/1/2023,KEN,Kelantan,0,0,0,Kenya
70566,6/1/2023,KEN,Perak,0,0,0,Kenya
70567,6/1/2023,KEN,Perlis,0,0,0,Kenya
70568,6/1/2023,KEN,Pulau Pinang,3,0,3,Kenya
70569,6/1/2023,KEN,Sabah,5,2,3,Kenya
70570,6/1/2023,KEN,Sarawak,0,0,0,Kenya
70571,6/1/2023,KEN,Selangor,282,139,143,Kenya
70572,6/1/2023,KGZ,Johor,14,7,7,Kyrgyzstan
70573,6/1/2023,KGZ,Kedah,0,0,0,Kyrgyzstan
70574,6/1/2023,KGZ,Kelantan,0,0,0,Kyrgyzstan
70575,6/1/2023,KGZ,Perak,0,0,0,Kyrgyzstan
70576,6/1/2023,KGZ,Perlis,0,0,0,Kyrgyzstan
70577,6/1/2023,KGZ,Pulau Pinang,1,0,1,Kyrgyzstan
70578,6/1/2023,KGZ,Sabah,1,0,1,Kyrgyzstan
70579,6/1/2023,KGZ,Sarawak,1,0,1,Kyrgyzstan
70580,6/1/2023,KGZ,Selangor,181,88,93,Kyrgyzstan
70581,6/1/2023,KHM,Johor,1950,851,1099,Cambodia
70582,6/1/2023,KHM,Kedah,104,66,38,Cambodia
70583,6/1/2023,KHM,Kelantan,429,236,193,Cambodia
70584,6/1/2023,KHM,Melaka,0,0,0,Cambodia
70585,6/1/2023,KHM,Negeri Sembilan,0,0,0,Cambodia
70586,6/1/2023,KHM,Pahang,0,0,0,Cambodia
70587,6/1/2023,KHM,Perak,8,0,8,Cambodia
70588,6/1/2023,KHM,Perlis,556,352,204,Cambodia
70589,6/1/2023,KHM,Pulau Pinang,28,11,17,Cambodia
70590,6/1/2023,KHM,Sabah,3,2,1,Cambodia
70591,6/1/2023,KHM,Sarawak,3,1,2,Cambodia
70592,6/1/2023,KHM,Selangor,1880,890,990,Cambodia
70593,6/1/2023,KHM,W.P. Labuan,0,0,0,Cambodia
70594,6/1/2023,KIR,Johor,0,0,0,Kiribati
70595,6/1/2023,KIR,Sabah,0,0,0,Kiribati
70596,6/1/2023,KIR,Selangor,0,0,0,Kiribati
70597,6/1/2023,KNA,Johor,20,13,7,Saint Kitts and Nevis
70598,6/1/2023,KNA,Kedah,0,0,0,Saint Kitts and Nevis
70599,6/1/2023,KNA,Perlis,0,0,0,Saint Kitts and Nevis
70600,6/1/2023,KNA,Pulau Pinang,1,1,0,Saint Kitts and Nevis
70601,6/1/2023,KNA,Sabah,2,2,0,Saint Kitts and Nevis
70602,6/1/2023,KNA,Selangor,62,41,21,Saint Kitts and Nevis
70603,6/1/2023,KNA,W.P. Labuan,1,1,0,Saint Kitts and Nevis
70604,6/1/2023,KOR,Johor,8116,4651,3465,"Korea, Republic of (South Korea)"
70605,6/1/2023,KOR,Kedah,105,70,35,"Korea, Republic of (South Korea)"
70606,6/1/2023,KOR,Kelantan,3,0,3,"Korea, Republic of (South Korea)"
70607,6/1/2023,KOR,Melaka,5,4,1,"Korea, Republic of (South Korea)"
70608,6/1/2023,KOR,Negeri Sembilan,0,0,0,"Korea, Republic of (South Korea)"
70609,6/1/2023,KOR,Pahang,1,0,1,"Korea, Republic of (South Korea)"
70610,6/1/2023,KOR,Perak,18,12,6,"Korea, Republic of (South Korea)"
70611,6/1/2023,KOR,Perlis,57,48,9,"Korea, Republic of (South Korea)"
70612,6/1/2023,KOR,Pulau Pinang,461,256,205,"Korea, Republic of (South Korea)"
70613,6/1/2023,KOR,Sabah,6271,2702,3569,"Korea, Republic of (South Korea)"
70614,6/1/2023,KOR,Sarawak,174,104,70,"Korea, Republic of (South Korea)"
70615,6/1/2023,KOR,Selangor,7908,4574,3334,"Korea, Republic of (South Korea)"
70616,6/1/2023,KOR,Terengganu,0,0,0,"Korea, Republic of (South Korea)"
70617,6/1/2023,KOR,W.P. Labuan,3,2,1,"Korea, Republic of (South Korea)"
70618,6/1/2023,KWT,Johor,88,41,47,Kuwait
70619,6/1/2023,KWT,Kedah,24,13,11,Kuwait
70620,6/1/2023,KWT,Kelantan,0,0,0,Kuwait
70621,6/1/2023,KWT,Perak,0,0,0,Kuwait
70622,6/1/2023,KWT,Perlis,0,0,0,Kuwait
70623,6/1/2023,KWT,Pulau Pinang,22,12,10,Kuwait
70624,6/1/2023,KWT,Sabah,0,0,0,Kuwait
70625,6/1/2023,KWT,Sarawak,2,2,0,Kuwait
70626,6/1/2023,KWT,Selangor,1312,652,660,Kuwait
70627,6/1/2023,KWT,W.P. Labuan,0,0,0,Kuwait
70628,6/1/2023,LAO,Johor,130,36,94,Lao People's Democratic Republic
70629,6/1/2023,LAO,Kedah,605,42,563,Lao People's Democratic Republic
70630,6/1/2023,LAO,Kelantan,250,57,193,Lao People's Democratic Republic
70631,6/1/2023,LAO,Melaka,0,0,0,Lao People's Democratic Republic
70632,6/1/2023,LAO,Perak,28,3,25,Lao People's Democratic Republic
70633,6/1/2023,LAO,Perlis,439,130,309,Lao People's Democratic Republic
70634,6/1/2023,LAO,Pulau Pinang,8,2,6,Lao People's Democratic Republic
70635,6/1/2023,LAO,Sabah,0,0,0,Lao People's Democratic Republic
70636,6/1/2023,LAO,Sarawak,12,6,6,Lao People's Democratic Republic
70637,6/1/2023,LAO,Selangor,138,47,91,Lao People's Democratic Republic
70638,6/1/2023,LAO,W.P. Labuan,0,0,0,Lao People's Democratic Republic
70639,6/1/2023,LBN,Johor,13,9,4,Lebanon
70640,6/1/2023,LBN,Kedah,0,0,0,Lebanon
70641,6/1/2023,LBN,Kelantan,0,0,0,Lebanon
70642,6/1/2023,LBN,Pahang,0,0,0,Lebanon
70643,6/1/2023,LBN,Perak,0,0,0,Lebanon
70644,6/1/2023,LBN,Perlis,0,0,0,Lebanon
70645,6/1/2023,LBN,Pulau Pinang,2,2,0,Lebanon
70646,6/1/2023,LBN,Sabah,0,0,0,Lebanon
70647,6/1/2023,LBN,Sarawak,3,3,0,Lebanon
70648,6/1/2023,LBN,Selangor,233,149,84,Lebanon
70649,6/1/2023,LBN,W.P. Labuan,0,0,0,Lebanon
70650,6/1/2023,LBR,Johor,1,1,0,Liberia
70651,6/1/2023,LBR,Kedah,0,0,0,Liberia
70652,6/1/2023,LBR,Sabah,0,0,0,Liberia
70653,6/1/2023,LBR,Sarawak,0,0,0,Liberia
70654,6/1/2023,LBR,Selangor,7,5,2,Liberia
70655,6/1/2023,LBY,Johor,11,10,1,Libyan Arab Jamahiriya
70656,6/1/2023,LBY,Kedah,0,0,0,Libyan Arab Jamahiriya
70657,6/1/2023,LBY,Perlis,0,0,0,Libyan Arab Jamahiriya
70658,6/1/2023,LBY,Pulau Pinang,0,0,0,Libyan Arab Jamahiriya
70659,6/1/2023,LBY,Sabah,2,2,0,Libyan Arab Jamahiriya
70660,6/1/2023,LBY,Sarawak,0,0,0,Libyan Arab Jamahiriya
70661,6/1/2023,LBY,Selangor,253,167,86,Libyan Arab Jamahiriya
70662,6/1/2023,LCA,Johor,7,7,0,Saint Lucia
70663,6/1/2023,LCA,Kedah,0,0,0,Saint Lucia
70664,6/1/2023,LCA,Pulau Pinang,2,1,1,Saint Lucia
70665,6/1/2023,LCA,Sarawak,0,0,0,Saint Lucia
70666,6/1/2023,LCA,Selangor,4,3,1,Saint Lucia
70667,6/1/2023,LIE,Johor,1,1,0,Liechtenstein
70668,6/1/2023,LIE,Kedah,0,0,0,Liechtenstein
70669,6/1/2023,LIE,Perlis,1,1,0,Liechtenstein
70670,6/1/2023,LIE,Pulau Pinang,0,0,0,Liechtenstein
70671,6/1/2023,LIE,Sabah,0,0,0,Liechtenstein
70672,6/1/2023,LIE,Sarawak,0,0,0,Liechtenstein
70673,6/1/2023,LIE,Selangor,4,1,3,Liechtenstein
70674,6/1/2023,LKA,Johor,1365,883,482,Sri Lanka
70675,6/1/2023,LKA,Kedah,42,23,19,Sri Lanka
70676,6/1/2023,LKA,Kelantan,0,0,0,Sri Lanka
70677,6/1/2023,LKA,Melaka,0,0,0,Sri Lanka
70678,6/1/2023,LKA,Pahang,0,0,0,Sri Lanka
70679,6/1/2023,LKA,Perak,4,1,3,Sri Lanka
70680,6/1/2023,LKA,Perlis,1,1,0,Sri Lanka
70681,6/1/2023,LKA,Pulau Pinang,58,44,14,Sri Lanka
70682,6/1/2023,LKA,Sabah,10,9,1,Sri Lanka
70683,6/1/2023,LKA,Sarawak,12,9,3,Sri Lanka
70684,6/1/2023,LKA,Selangor,3254,2182,1072,Sri Lanka
70685,6/1/2023,LKA,W.P. Labuan,1,1,0,Sri Lanka
70686,6/1/2023,LSO,Johor,0,0,0,Lesotho
70687,6/1/2023,LSO,Kedah,0,0,0,Lesotho
70688,6/1/2023,LSO,Pulau Pinang,0,0,0,Lesotho
70689,6/1/2023,LSO,Sarawak,0,0,0,Lesotho
70690,6/1/2023,LSO,Selangor,0,0,0,Lesotho
70691,6/1/2023,LTU,Johor,34,16,18,Lithuania
70692,6/1/2023,LTU,Kedah,5,3,2,Lithuania
70693,6/1/2023,LTU,Kelantan,1,1,0,Lithuania
70694,6/1/2023,LTU,Pahang,1,1,0,Lithuania
70695,6/1/2023,LTU,Perak,0,0,0,Lithuania
70696,6/1/2023,LTU,Perlis,5,5,0,Lithuania
70697,6/1/2023,LTU,Pulau Pinang,6,5,1,Lithuania
70698,6/1/2023,LTU,Sabah,2,0,2,Lithuania
70699,6/1/2023,LTU,Sarawak,3,2,1,Lithuania
70700,6/1/2023,LTU,Selangor,109,65,44,Lithuania
70701,6/1/2023,LTU,W.P. Labuan,0,0,0,Lithuania
70702,6/1/2023,LUX,Johor,10,6,4,Luxembourg
70703,6/1/2023,LUX,Kedah,4,3,1,Luxembourg
70704,6/1/2023,LUX,Kelantan,0,0,0,Luxembourg
70705,6/1/2023,LUX,Perak,0,0,0,Luxembourg
70706,6/1/2023,LUX,Perlis,0,0,0,Luxembourg
70707,6/1/2023,LUX,Pulau Pinang,4,3,1,Luxembourg
70708,6/1/2023,LUX,Sabah,0,0,0,Luxembourg
70709,6/1/2023,LUX,Sarawak,0,0,0,Luxembourg
70710,6/1/2023,LUX,Selangor,24,16,8,Luxembourg
70711,6/1/2023,LVA,Johor,7,7,0,Latvia
70712,6/1/2023,LVA,Kedah,2,1,1,Latvia
70713,6/1/2023,LVA,Kelantan,1,0,1,Latvia
70714,6/1/2023,LVA,Pahang,0,0,0,Latvia
70715,6/1/2023,LVA,Perak,0,0,0,Latvia
70716,6/1/2023,LVA,Perlis,3,3,0,Latvia
70717,6/1/2023,LVA,Pulau Pinang,2,0,2,Latvia
70718,6/1/2023,LVA,Sabah,0,0,0,Latvia
70719,6/1/2023,LVA,Sarawak,2,1,1,Latvia
70720,6/1/2023,LVA,Selangor,56,32,24,Latvia
70721,6/1/2023,LVA,W.P. Labuan,0,0,0,Latvia
70722,6/1/2023,MAC,Johor,0,0,0,Macao
70723,6/1/2023,MAC,Pahang,0,0,0,Macao
70724,6/1/2023,MAC,Perak,2,1,1,Macao
70725,6/1/2023,MAC,Selangor,2,1,1,Macao
70726,6/1/2023,MAC,W.P. Labuan,0,0,0,Macao
70727,6/1/2023,MAR,Johor,65,43,22,Morocco
70728,6/1/2023,MAR,Kedah,4,4,0,Morocco
70729,6/1/2023,MAR,Kelantan,0,0,0,Morocco
70730,6/1/2023,MAR,Melaka,0,0,0,Morocco
70731,6/1/2023,MAR,Pahang,4,2,2,Morocco
70732,6/1/2023,MAR,Perak,1,1,0,Morocco
70733,6/1/2023,MAR,Perlis,3,3,0,Morocco
70734,6/1/2023,MAR,Pulau Pinang,4,4,0,Morocco
70735,6/1/2023,MAR,Sabah,1,1,0,Morocco
70736,6/1/2023,MAR,Sarawak,4,3,1,Morocco
70737,6/1/2023,MAR,Selangor,566,269,297,Morocco
70738,6/1/2023,MAR,W.P. Labuan,0,0,0,Morocco
70739,6/1/2023,MCO,Johor,0,0,0,Monaco
70740,6/1/2023,MCO,Kedah,0,0,0,Monaco
70741,6/1/2023,MCO,Sabah,0,0,0,Monaco
70742,6/1/2023,MCO,Selangor,1,0,1,Monaco
70743,6/1/2023,MDA,Johor,6,3,3,"Moldova, Republic of"
70744,6/1/2023,MDA,Kedah,5,3,2,"Moldova, Republic of"
70745,6/1/2023,MDA,Kelantan,0,0,0,"Moldova, Republic of"
70746,6/1/2023,MDA,Negeri Sembilan,0,0,0,"Moldova, Republic of"
70747,6/1/2023,MDA,Perlis,0,0,0,"Moldova, Republic of"
70748,6/1/2023,MDA,Pulau Pinang,0,0,0,"Moldova, Republic of"
70749,6/1/2023,MDA,Sabah,0,0,0,"Moldova, Republic of"
70750,6/1/2023,MDA,Sarawak,0,0,0,"Moldova, Republic of"
70751,6/1/2023,MDA,Selangor,22,11,11,"Moldova, Republic of"
70752,6/1/2023,MDG,Johor,9,4,5,Madagascar
70753,6/1/2023,MDG,Kedah,3,2,1,Madagascar
70754,6/1/2023,MDG,Perak,0,0,0,Madagascar
70755,6/1/2023,MDG,Perlis,0,0,0,Madagascar
70756,6/1/2023,MDG,Pulau Pinang,0,0,0,Madagascar
70757,6/1/2023,MDG,Sabah,1,0,1,Madagascar
70758,6/1/2023,MDG,Sarawak,0,0,0,Madagascar
70759,6/1/2023,MDG,Selangor,57,33,24,Madagascar
70760,6/1/2023,MDV,Johor,172,77,95,Maldives
70761,6/1/2023,MDV,Kedah,7,4,3,Maldives
70762,6/1/2023,MDV,Kelantan,2,1,1,Maldives
70763,6/1/2023,MDV,Perak,0,0,0,Maldives
70764,6/1/2023,MDV,Perlis,0,0,0,Maldives
70765,6/1/2023,MDV,Pulau Pinang,14,9,5,Maldives
70766,6/1/2023,MDV,Sabah,0,0,0,Maldives
70767,6/1/2023,MDV,Sarawak,5,2,3,Maldives
70768,6/1/2023,MDV,Selangor,2334,1194,1140,Maldives
70769,6/1/2023,MEX,Johor,150,62,88,Mexico
70770,6/1/2023,MEX,Kedah,14,5,9,Mexico
70771,6/1/2023,MEX,Kelantan,0,0,0,Mexico
70772,6/1/2023,MEX,Pahang,0,0,0,Mexico
70773,6/1/2023,MEX,Perak,4,2,2,Mexico
70774,6/1/2023,MEX,Perlis,6,3,3,Mexico
70775,6/1/2023,MEX,Pulau Pinang,18,14,4,Mexico
70776,6/1/2023,MEX,Sabah,9,4,5,Mexico
70777,6/1/2023,MEX,Sarawak,6,3,3,Mexico
70778,6/1/2023,MEX,Selangor,298,173,125,Mexico
70779,6/1/2023,MEX,W.P. Labuan,0,0,0,Mexico
70780,6/1/2023,MHL,Johor,0,0,0,Marshall Islands
70781,6/1/2023,MHL,Kedah,0,0,0,Marshall Islands
70782,6/1/2023,MHL,Perak,0,0,0,Marshall Islands
70783,6/1/2023,MHL,Pulau Pinang,0,0,0,Marshall Islands
70784,6/1/2023,MHL,Sabah,0,0,0,Marshall Islands
70785,6/1/2023,MHL,Selangor,0,0,0,Marshall Islands
70786,6/1/2023,MKD,Johor,3,2,1,"Macedonia, the former Yugoslav Republic of"
70787,6/1/2023,MKD,Kedah,0,0,0,"Macedonia, the former Yugoslav Republic of"
70788,6/1/2023,MKD,Perak,0,0,0,"Macedonia, the former Yugoslav Republic of"
70789,6/1/2023,MKD,Pulau Pinang,0,0,0,"Macedonia, the former Yugoslav Republic of"
70790,6/1/2023,MKD,Sabah,0,0,0,"Macedonia, the former Yugoslav Republic of"
70791,6/1/2023,MKD,Sarawak,0,0,0,"Macedonia, the former Yugoslav Republic of"
70792,6/1/2023,MKD,Selangor,25,16,9,"Macedonia, the former Yugoslav Republic of"
70793,6/1/2023,MLI,Johor,4,4,0,Mali
70794,6/1/2023,MLI,Sabah,0,0,0,Mali
70795,6/1/2023,MLI,Selangor,9,5,4,Mali
70796,6/1/2023,MLT,Johor,7,5,2,Malta
70797,6/1/2023,MLT,Kedah,0,0,0,Malta
70798,6/1/2023,MLT,Kelantan,0,0,0,Malta
70799,6/1/2023,MLT,Perak,0,0,0,Malta
70800,6/1/2023,MLT,Perlis,0,0,0,Malta
70801,6/1/2023,MLT,Pulau Pinang,1,1,0,Malta
70802,6/1/2023,MLT,Sabah,0,0,0,Malta
70803,6/1/2023,MLT,Sarawak,0,0,0,Malta
70804,6/1/2023,MLT,Selangor,29,20,9,Malta
70805,6/1/2023,MLT,W.P. Labuan,0,0,0,Malta
70806,6/1/2023,MMR,Johor,6439,1876,4563,Myanmar
70807,6/1/2023,MMR,Kedah,85,19,66,Myanmar
70808,6/1/2023,MMR,Kelantan,5,4,1,Myanmar
70809,6/1/2023,MMR,Negeri Sembilan,0,0,0,Myanmar
70810,6/1/2023,MMR,Pahang,7,3,4,Myanmar
70811,6/1/2023,MMR,Perak,35,7,28,Myanmar
70812,6/1/2023,MMR,Perlis,5,0,5,Myanmar
70813,6/1/2023,MMR,Pulau Pinang,287,109,178,Myanmar
70814,6/1/2023,MMR,Sabah,22,10,12,Myanmar
70815,6/1/2023,MMR,Sarawak,77,37,40,Myanmar
70816,6/1/2023,MMR,Selangor,5749,4225,1524,Myanmar
70817,6/1/2023,MMR,Terengganu,1,1,0,Myanmar
70818,6/1/2023,MMR,W.P. Labuan,0,0,0,Myanmar
70819,6/1/2023,MNE,Johor,7,7,0,Montenegro
70820,6/1/2023,MNE,Kedah,0,0,0,Montenegro
70821,6/1/2023,MNE,Pulau Pinang,0,0,0,Montenegro
70822,6/1/2023,MNE,Sabah,0,0,0,Montenegro
70823,6/1/2023,MNE,Sarawak,0,0,0,Montenegro
70824,6/1/2023,MNE,Selangor,7,5,2,Montenegro
70825,6/1/2023,MNG,Johor,161,63,98,Mongolia
70826,6/1/2023,MNG,Kedah,0,0,0,Mongolia
70827,6/1/2023,MNG,Kelantan,5,1,4,Mongolia
70828,6/1/2023,MNG,Perak,1,1,0,Mongolia
70829,6/1/2023,MNG,Perlis,1,0,1,Mongolia
70830,6/1/2023,MNG,Pulau Pinang,21,11,10,Mongolia
70831,6/1/2023,MNG,Sabah,3,0,3,Mongolia
70832,6/1/2023,MNG,Sarawak,0,0,0,Mongolia
70833,6/1/2023,MNG,Selangor,170,74,96,Mongolia
70834,6/1/2023,MNP,Selangor,0,0,0,Northern Mariana Islands
70835,6/1/2023,MOZ,Johor,0,0,0,Mozambique
70836,6/1/2023,MOZ,Kedah,0,0,0,Mozambique
70837,6/1/2023,MOZ,Perak,0,0,0,Mozambique
70838,6/1/2023,MOZ,Pulau Pinang,0,0,0,Mozambique
70839,6/1/2023,MOZ,Sabah,0,0,0,Mozambique
70840,6/1/2023,MOZ,Sarawak,0,0,0,Mozambique
70841,6/1/2023,MOZ,Selangor,17,8,9,Mozambique
70842,6/1/2023,MRT,Johor,5,5,0,Mauritania
70843,6/1/2023,MRT,Kedah,0,0,0,Mauritania
70844,6/1/2023,MRT,Pulau Pinang,0,0,0,Mauritania
70845,6/1/2023,MRT,Sabah,0,0,0,Mauritania
70846,6/1/2023,MRT,Sarawak,2,2,0,Mauritania
70847,6/1/2023,MRT,Selangor,4,4,0,Mauritania
70848,6/1/2023,MUS,Johor,184,94,90,Mauritius
70849,6/1/2023,MUS,Kedah,4,2,2,Mauritius
70850,6/1/2023,MUS,Kelantan,0,0,0,Mauritius
70851,6/1/2023,MUS,Pahang,0,0,0,Mauritius
70852,6/1/2023,MUS,Perak,0,0,0,Mauritius
70853,6/1/2023,MUS,Perlis,0,0,0,Mauritius
70854,6/1/2023,MUS,Pulau Pinang,4,2,2,Mauritius
70855,6/1/2023,MUS,Sabah,2,0,2,Mauritius
70856,6/1/2023,MUS,Sarawak,0,0,0,Mauritius
70857,6/1/2023,MUS,Selangor,891,458,433,Mauritius
70858,6/1/2023,MWI,Johor,0,0,0,Malawi
70859,6/1/2023,MWI,Pulau Pinang,0,0,0,Malawi
70860,6/1/2023,MWI,Sabah,0,0,0,Malawi
70861,6/1/2023,MWI,Sarawak,0,0,0,Malawi
70862,6/1/2023,MWI,Selangor,12,7,5,Malawi
70863,6/1/2023,MYT,Selangor,0,0,0,Mayotte
70864,6/1/2023,NAM,Johor,0,0,0,Namibia
70865,6/1/2023,NAM,Kedah,1,0,1,Namibia
70866,6/1/2023,NAM,Perak,0,0,0,Namibia
70867,6/1/2023,NAM,Perlis,0,0,0,Namibia
70868,6/1/2023,NAM,Pulau Pinang,0,0,0,Namibia
70869,6/1/2023,NAM,Sabah,0,0,0,Namibia
70870,6/1/2023,NAM,Sarawak,0,0,0,Namibia
70871,6/1/2023,NAM,Selangor,37,22,15,Namibia
70872,6/1/2023,NCL,Selangor,0,0,0,New Caledonia
70873,6/1/2023,NER,Johor,0,0,0,Niger
70874,6/1/2023,NER,Sabah,0,0,0,Niger
70875,6/1/2023,NER,Selangor,3,2,1,Niger
70876,6/1/2023,NGA,Johor,47,44,3,Nigeria
70877,6/1/2023,NGA,Kedah,1,0,1,Nigeria
70878,6/1/2023,NGA,Perlis,0,0,0,Nigeria
70879,6/1/2023,NGA,Pulau Pinang,0,0,0,Nigeria
70880,6/1/2023,NGA,Sabah,0,0,0,Nigeria
70881,6/1/2023,NGA,Sarawak,2,2,0,Nigeria
70882,6/1/2023,NGA,Selangor,334,257,77,Nigeria
70883,6/1/2023,NIC,Johor,1,1,0,Nicaragua
70884,6/1/2023,NIC,Kedah,3,1,2,Nicaragua
70885,6/1/2023,NIC,Pulau Pinang,0,0,0,Nicaragua
70886,6/1/2023,NIC,Sabah,0,0,0,Nicaragua
70887,6/1/2023,NIC,Selangor,3,3,0,Nicaragua
70888,6/1/2023,NLD,Johor,854,561,293,Netherlands
70889,6/1/2023,NLD,Kedah,158,86,72,Netherlands
70890,6/1/2023,NLD,Kelantan,1,1,0,Netherlands
70891,6/1/2023,NLD,Melaka,1,1,0,Netherlands
70892,6/1/2023,NLD,Negeri Sembilan,0,0,0,Netherlands
70893,6/1/2023,NLD,Pahang,5,2,3,Netherlands
70894,6/1/2023,NLD,Perak,16,9,7,Netherlands
70895,6/1/2023,NLD,Perlis,48,29,19,Netherlands
70896,6/1/2023,NLD,Pulau Pinang,203,123,80,Netherlands
70897,6/1/2023,NLD,Sabah,71,38,33,Netherlands
70898,6/1/2023,NLD,Sarawak,116,76,40,Netherlands
70899,6/1/2023,NLD,Selangor,2705,1661,1044,Netherlands
70900,6/1/2023,NLD,Terengganu,0,0,0,Netherlands
70901,6/1/2023,NLD,W.P. Labuan,4,2,2,Netherlands
70902,6/1/2023,NOR,Johor,180,111,69,Norway
70903,6/1/2023,NOR,Kedah,13,9,4,Norway
70904,6/1/2023,NOR,Kelantan,1,1,0,Norway
70905,6/1/2023,NOR,Melaka,0,0,0,Norway
70906,6/1/2023,NOR,Pahang,0,0,0,Norway
70907,6/1/2023,NOR,Perak,0,0,0,Norway
70908,6/1/2023,NOR,Perlis,11,6,5,Norway
70909,6/1/2023,NOR,Pulau Pinang,24,13,11,Norway
70910,6/1/2023,NOR,Sabah,8,6,2,Norway
70911,6/1/2023,NOR,Sarawak,23,13,10,Norway
70912,6/1/2023,NOR,Selangor,517,313,204,Norway
70913,6/1/2023,NOR,W.P. Labuan,1,1,0,Norway
70914,6/1/2023,NPL,Johor,702,508,194,Nepal
70915,6/1/2023,NPL,Kedah,28,25,3,Nepal
70916,6/1/2023,NPL,Pahang,0,0,0,Nepal
70917,6/1/2023,NPL,Perak,0,0,0,Nepal
70918,6/1/2023,NPL,Perlis,0,0,0,Nepal
70919,6/1/2023,NPL,Pulau Pinang,17,13,4,Nepal
70920,6/1/2023,NPL,Sabah,3,3,0,Nepal
70921,6/1/2023,NPL,Sarawak,195,142,53,Nepal
70922,6/1/2023,NPL,Selangor,12311,11693,618,Nepal
70923,6/1/2023,NPL,W.P. Labuan,103,101,2,Nepal
70924,6/1/2023,NRU,Johor,0,0,0,Nauru
70925,6/1/2023,NRU,Pulau Pinang,0,0,0,Nauru
70926,6/1/2023,NRU,Selangor,0,0,0,Nauru
70927,6/1/2023,NZL,Johor,818,492,326,New Zealand
70928,6/1/2023,NZL,Kedah,81,40,41,New Zealand
70929,6/1/2023,NZL,Kelantan,2,2,0,New Zealand
70930,6/1/2023,NZL,Melaka,0,0,0,New Zealand
70931,6/1/2023,NZL,Negeri Sembilan,0,0,0,New Zealand
70932,6/1/2023,NZL,Pahang,6,2,4,New Zealand
70933,6/1/2023,NZL,Perak,28,12,16,New Zealand
70934,6/1/2023,NZL,Perlis,31,18,13,New Zealand
70935,6/1/2023,NZL,Pulau Pinang,219,132,87,New Zealand
70936,6/1/2023,NZL,Sabah,39,23,16,New Zealand
70937,6/1/2023,NZL,Sarawak,113,66,47,New Zealand
70938,6/1/2023,NZL,Selangor,2198,1285,913,New Zealand
70939,6/1/2023,NZL,Terengganu,0,0,0,New Zealand
70940,6/1/2023,NZL,W.P. Labuan,6,3,3,New Zealand
70941,6/1/2023,OMN,Johor,80,39,41,Oman
70942,6/1/2023,OMN,Kedah,9,3,6,Oman
70943,6/1/2023,OMN,Kelantan,0,0,0,Oman
70944,6/1/2023,OMN,Melaka,0,0,0,Oman
70945,6/1/2023,OMN,Perak,0,0,0,Oman
70946,6/1/2023,OMN,Perlis,0,0,0,Oman
70947,6/1/2023,OMN,Pulau Pinang,9,6,3,Oman
70948,6/1/2023,OMN,Sabah,0,0,0,Oman
70949,6/1/2023,OMN,Sarawak,5,2,3,Oman
70950,6/1/2023,OMN,Selangor,1296,700,596,Oman
70951,6/1/2023,PAK,Johor,1163,805,358,Pakistan
70952,6/1/2023,PAK,Kedah,144,108,36,Pakistan
70953,6/1/2023,PAK,Kelantan,7,7,0,Pakistan
70954,6/1/2023,PAK,Melaka,0,0,0,Pakistan
70955,6/1/2023,PAK,Negeri Sembilan,0,0,0,Pakistan
70956,6/1/2023,PAK,Pahang,0,0,0,Pakistan
70957,6/1/2023,PAK,Perak,15,11,4,Pakistan
70958,6/1/2023,PAK,Perlis,23,23,0,Pakistan
70959,6/1/2023,PAK,Pulau Pinang,90,77,13,Pakistan
70960,6/1/2023,PAK,Sabah,13,13,0,Pakistan
70961,6/1/2023,PAK,Sarawak,156,135,21,Pakistan
70962,6/1/2023,PAK,Selangor,10745,9160,1585,Pakistan
70963,6/1/2023,PAK,W.P. Labuan,1,1,0,Pakistan
70964,6/1/2023,PAN,Johor,0,0,0,Panama
70965,6/1/2023,PAN,Kedah,0,0,0,Panama
70966,6/1/2023,PAN,Perak,0,0,0,Panama
70967,6/1/2023,PAN,Perlis,0,0,0,Panama
70968,6/1/2023,PAN,Pulau Pinang,1,0,1,Panama
70969,6/1/2023,PAN,Sabah,0,0,0,Panama
70970,6/1/2023,PAN,Sarawak,0,0,0,Panama
70971,6/1/2023,PAN,Selangor,6,4,2,Panama
70972,6/1/2023,PER,Johor,19,12,7,Peru
70973,6/1/2023,PER,Kedah,4,3,1,Peru
70974,6/1/2023,PER,Kelantan,0,0,0,Peru
70975,6/1/2023,PER,Pahang,1,1,0,Peru
70976,6/1/2023,PER,Perak,0,0,0,Peru
70977,6/1/2023,PER,Perlis,2,0,2,Peru
70978,6/1/2023,PER,Pulau Pinang,5,3,2,Peru
70979,6/1/2023,PER,Sabah,2,0,2,Peru
70980,6/1/2023,PER,Sarawak,1,1,0,Peru
70981,6/1/2023,PER,Selangor,90,43,47,Peru
70982,6/1/2023,PER,W.P. Labuan,0,0,0,Peru
70983,6/1/2023,PHL,Johor,24673,7915,16758,Philippines
70984,6/1/2023,PHL,Kedah,510,158,352,Philippines
70985,6/1/2023,PHL,Kelantan,45,25,20,Philippines
70986,6/1/2023,PHL,Melaka,1,0,1,Philippines
70987,6/1/2023,PHL,Negeri Sembilan,0,0,0,Philippines
70988,6/1/2023,PHL,Pahang,24,20,4,Philippines
70989,6/1/2023,PHL,Perak,93,38,55,Philippines
70990,6/1/2023,PHL,Perlis,78,18,60,Philippines
70991,6/1/2023,PHL,Pulau Pinang,625,208,417,Philippines
70992,6/1/2023,PHL,Sabah,748,331,417,Philippines
70993,6/1/2023,PHL,Sarawak,1987,725,1262,Philippines
70994,6/1/2023,PHL,Selangor,7912,3472,4440,Philippines
70995,6/1/2023,PHL,Terengganu,0,0,0,Philippines
70996,6/1/2023,PHL,W.P. Labuan,117,23,94,Philippines
70997,6/1/2023,PLW,Johor,3,3,0,Palau
70998,6/1/2023,PLW,Pulau Pinang,1,1,0,Palau
70999,6/1/2023,PLW,Selangor,2,1,1,Palau
71000,6/1/2023,PNG,Johor,28,17,11,Papua New Guinea
71001,6/1/2023,PNG,Kedah,0,0,0,Papua New Guinea
71002,6/1/2023,PNG,Kelantan,0,0,0,Papua New Guinea
71003,6/1/2023,PNG,Perak,0,0,0,Papua New Guinea
71004,6/1/2023,PNG,Pulau Pinang,0,0,0,Papua New Guinea
71005,6/1/2023,PNG,Sabah,1,1,0,Papua New Guinea
71006,6/1/2023,PNG,Sarawak,11,8,3,Papua New Guinea
71007,6/1/2023,PNG,Selangor,95,68,27,Papua New Guinea
71008,6/1/2023,POL,Johor,252,141,111,Poland
71009,6/1/2023,POL,Kedah,39,19,20,Poland
71010,6/1/2023,POL,Kelantan,2,2,0,Poland
71011,6/1/2023,POL,Melaka,0,0,0,Poland
71012,6/1/2023,POL,Negeri Sembilan,0,0,0,Poland
71013,6/1/2023,POL,Pahang,7,4,3,Poland
71014,6/1/2023,POL,Perak,4,3,1,Poland
71015,6/1/2023,POL,Perlis,13,7,6,Poland
71016,6/1/2023,POL,Pulau Pinang,34,20,14,Poland
71017,6/1/2023,POL,Sabah,14,6,8,Poland
71018,6/1/2023,POL,Sarawak,80,40,40,Poland
71019,6/1/2023,POL,Selangor,661,359,302,Poland
71020,6/1/2023,POL,Terengganu,0,0,0,Poland
71021,6/1/2023,POL,W.P. Labuan,0,0,0,Poland
71022,6/1/2023,PRK,Selangor,0,0,0,"Korea, Democratic People's Republic of"
71023,6/1/2023,PRT,Johor,138,76,62,Portugal
71024,6/1/2023,PRT,Kedah,20,7,13,Portugal
71025,6/1/2023,PRT,Kelantan,1,1,0,Portugal
71026,6/1/2023,PRT,Melaka,0,0,0,Portugal
71027,6/1/2023,PRT,Pahang,0,0,0,Portugal
71028,6/1/2023,PRT,Perak,1,1,0,Portugal
71029,6/1/2023,PRT,Perlis,14,9,5,Portugal
71030,6/1/2023,PRT,Pulau Pinang,44,26,18,Portugal
71031,6/1/2023,PRT,Sabah,14,8,6,Portugal
71032,6/1/2023,PRT,Sarawak,7,5,2,Portugal
71033,6/1/2023,PRT,Selangor,400,250,150,Portugal
71034,6/1/2023,PRT,W.P. Labuan,0,0,0,Portugal
71035,6/1/2023,PRY,Johor,2,0,2,Paraguay
71036,6/1/2023,PRY,Kedah,0,0,0,Paraguay
71037,6/1/2023,PRY,Perak,0,0,0,Paraguay
71038,6/1/2023,PRY,Perlis,0,0,0,Paraguay
71039,6/1/2023,PRY,Pulau Pinang,0,0,0,Paraguay
71040,6/1/2023,PRY,Sabah,0,0,0,Paraguay
71041,6/1/2023,PRY,Sarawak,0,0,0,Paraguay
71042,6/1/2023,PRY,Selangor,9,5,4,Paraguay
71043,6/1/2023,PSE,Johor,24,20,4,"Palestinian Territory, Occupied"
71044,6/1/2023,PSE,Kedah,0,0,0,"Palestinian Territory, Occupied"
71045,6/1/2023,PSE,Kelantan,3,3,0,"Palestinian Territory, Occupied"
71046,6/1/2023,PSE,Melaka,1,1,0,"Palestinian Territory, Occupied"
71047,6/1/2023,PSE,Perak,0,0,0,"Palestinian Territory, Occupied"
71048,6/1/2023,PSE,Perlis,0,0,0,"Palestinian Territory, Occupied"
71049,6/1/2023,PSE,Pulau Pinang,0,0,0,"Palestinian Territory, Occupied"
71050,6/1/2023,PSE,Sabah,0,0,0,"Palestinian Territory, Occupied"
71051,6/1/2023,PSE,Sarawak,5,5,0,"Palestinian Territory, Occupied"
71052,6/1/2023,PSE,Selangor,409,261,148,"Palestinian Territory, Occupied"
71053,6/1/2023,QAT,Johor,29,17,12,Qatar
71054,6/1/2023,QAT,Kedah,0,0,0,Qatar
71055,6/1/2023,QAT,Perlis,0,0,0,Qatar
71056,6/1/2023,QAT,Pulau Pinang,9,7,2,Qatar
71057,6/1/2023,QAT,Sabah,0,0,0,Qatar
71058,6/1/2023,QAT,Sarawak,0,0,0,Qatar
71059,6/1/2023,QAT,Selangor,304,171,133,Qatar
71060,6/1/2023,REU,Johor,0,0,0,Reunion
71061,6/1/2023,REU,Sarawak,1,1,0,Reunion
71062,6/1/2023,ROU,Johor,93,58,35,Romania
71063,6/1/2023,ROU,Kedah,10,2,8,Romania
71064,6/1/2023,ROU,Kelantan,0,0,0,Romania
71065,6/1/2023,ROU,Negeri Sembilan,0,0,0,Romania
71066,6/1/2023,ROU,Pahang,0,0,0,Romania
71067,6/1/2023,ROU,Perak,1,0,1,Romania
71068,6/1/2023,ROU,Perlis,4,3,1,Romania
71069,6/1/2023,ROU,Pulau Pinang,14,5,9,Romania
71070,6/1/2023,ROU,Sabah,4,1,3,Romania
71071,6/1/2023,ROU,Sarawak,5,4,1,Romania
71072,6/1/2023,ROU,Selangor,336,188,148,Romania
71073,6/1/2023,ROU,W.P. Labuan,0,0,0,Romania
71074,6/1/2023,RUS,Johor,445,219,226,Russia
71075,6/1/2023,RUS,Kedah,313,158,155,Russia
71076,6/1/2023,RUS,Kelantan,50,31,19,Russia
71077,6/1/2023,RUS,Melaka,0,0,0,Russia
71078,6/1/2023,RUS,Negeri Sembilan,0,0,0,Russia
71079,6/1/2023,RUS,Pahang,0,0,0,Russia
71080,6/1/2023,RUS,Perak,3,3,0,Russia
71081,6/1/2023,RUS,Perlis,334,204,130,Russia
71082,6/1/2023,RUS,Pulau Pinang,132,75,57,Russia
71083,6/1/2023,RUS,Sabah,20,9,11,Russia
71084,6/1/2023,RUS,Sarawak,39,20,19,Russia
71085,6/1/2023,RUS,Selangor,4266,2221,2045,Russia
71086,6/1/2023,RUS,W.P. Labuan,2,1,1,Russia
71087,6/1/2023,RWA,Johor,0,0,0,Rwanda
71088,6/1/2023,RWA,Kedah,0,0,0,Rwanda
71089,6/1/2023,RWA,Pulau Pinang,0,0,0,Rwanda
71090,6/1/2023,RWA,Selangor,30,23,7,Rwanda
71091,6/1/2023,SAU,Johor,281,175,106,Saudi Arabia
71092,6/1/2023,SAU,Kedah,43,21,22,Saudi Arabia
71093,6/1/2023,SAU,Kelantan,2,1,1,Saudi Arabia
71094,6/1/2023,SAU,Melaka,0,0,0,Saudi Arabia
71095,6/1/2023,SAU,Perak,0,0,0,Saudi Arabia
71096,6/1/2023,SAU,Perlis,5,3,2,Saudi Arabia
71097,6/1/2023,SAU,Pulau Pinang,78,41,37,Saudi Arabia
71098,6/1/2023,SAU,Sabah,2,1,1,Saudi Arabia
71099,6/1/2023,SAU,Sarawak,8,8,0,Saudi Arabia
71100,6/1/2023,SAU,Selangor,5466,2954,2512,Saudi Arabia
71101,6/1/2023,SAU,W.P. Labuan,0,0,0,Saudi Arabia
71102,6/1/2023,SDN,Johor,6,6,0,Sudan
71103,6/1/2023,SDN,Kedah,0,0,0,Sudan
71104,6/1/2023,SDN,Kelantan,0,0,0,Sudan
71105,6/1/2023,SDN,Perlis,0,0,0,Sudan
71106,6/1/2023,SDN,Pulau Pinang,0,0,0,Sudan
71107,6/1/2023,SDN,Sabah,0,0,0,Sudan
71108,6/1/2023,SDN,Sarawak,10,4,6,Sudan
71109,6/1/2023,SDN,Selangor,851,476,375,Sudan
71110,6/1/2023,SDN,W.P. Labuan,0,0,0,Sudan
71111,6/1/2023,SEN,Johor,3,3,0,Senegal
71112,6/1/2023,SEN,Kedah,1,1,0,Senegal
71113,6/1/2023,SEN,Kelantan,0,0,0,Senegal
71114,6/1/2023,SEN,Perak,0,0,0,Senegal
71115,6/1/2023,SEN,Perlis,0,0,0,Senegal
71116,6/1/2023,SEN,Pulau Pinang,0,0,0,Senegal
71117,6/1/2023,SEN,Sabah,0,0,0,Senegal
71118,6/1/2023,SEN,Sarawak,0,0,0,Senegal
71119,6/1/2023,SEN,Selangor,43,34,9,Senegal
71120,6/1/2023,SGP,Johor,1224502,684070,540432,Singapore
71121,6/1/2023,SGP,Kedah,9489,4711,4778,Singapore
71122,6/1/2023,SGP,Kelantan,175,114,61,Singapore
71123,6/1/2023,SGP,Melaka,24,18,6,Singapore
71124,6/1/2023,SGP,Negeri Sembilan,1,1,0,Singapore
71125,6/1/2023,SGP,Pahang,721,355,366,Singapore
71126,6/1/2023,SGP,Perak,7970,3718,4252,Singapore
71127,6/1/2023,SGP,Perlis,519,265,254,Singapore
71128,6/1/2023,SGP,Pulau Pinang,29639,14323,15316,Singapore
71129,6/1/2023,SGP,Sabah,4139,2095,2044,Singapore
71130,6/1/2023,SGP,Sarawak,5720,3085,2635,Singapore
71131,6/1/2023,SGP,Selangor,35275,17545,17730,Singapore
71132,6/1/2023,SGP,Terengganu,0,0,0,Singapore
71133,6/1/2023,SGP,W.P. Labuan,9,4,5,Singapore
71134,6/1/2023,SGS,Johor,0,0,0,South Georgia and the South Sandwich Islands
71135,6/1/2023,SGS,Sabah,0,0,0,South Georgia and the South Sandwich Islands
71136,6/1/2023,SGS,Selangor,0,0,0,South Georgia and the South Sandwich Islands
71137,6/1/2023,SHN,Sarawak,0,0,0,"Saint Helena, Ascension and Tristan da Cunha"
71138,6/1/2023,SLB,Johor,29,29,0,Solomon Islands
71139,6/1/2023,SLB,Perlis,0,0,0,Solomon Islands
71140,6/1/2023,SLB,Pulau Pinang,0,0,0,Solomon Islands
71141,6/1/2023,SLB,Sabah,0,0,0,Solomon Islands
71142,6/1/2023,SLB,Sarawak,2,1,1,Solomon Islands
71143,6/1/2023,SLB,Selangor,1,1,0,Solomon Islands
71144,6/1/2023,SLB,W.P. Labuan,0,0,0,Solomon Islands
71145,6/1/2023,SLE,Johor,0,0,0,Sierra Leone
71146,6/1/2023,SLE,Kedah,0,0,0,Sierra Leone
71147,6/1/2023,SLE,Perak,0,0,0,Sierra Leone
71148,6/1/2023,SLE,Pulau Pinang,0,0,0,Sierra Leone
71149,6/1/2023,SLE,Sabah,0,0,0,Sierra Leone
71150,6/1/2023,SLE,Selangor,9,4,5,Sierra Leone
71151,6/1/2023,SLV,Johor,4,3,1,El Salvador
71152,6/1/2023,SLV,Kedah,0,0,0,El Salvador
71153,6/1/2023,SLV,Perak,0,0,0,El Salvador
71154,6/1/2023,SLV,Perlis,0,0,0,El Salvador
71155,6/1/2023,SLV,Pulau Pinang,0,0,0,El Salvador
71156,6/1/2023,SLV,Sabah,1,1,0,El Salvador
71157,6/1/2023,SLV,Selangor,15,10,5,El Salvador
71158,6/1/2023,SLV,W.P. Labuan,0,0,0,El Salvador
71159,6/1/2023,SMR,Johor,0,0,0,San Marino
71160,6/1/2023,SMR,Selangor,1,1,0,San Marino
71161,6/1/2023,SOM,Johor,0,0,0,Somalia
71162,6/1/2023,SOM,Kedah,0,0,0,Somalia
71163,6/1/2023,SOM,Kelantan,0,0,0,Somalia
71164,6/1/2023,SOM,Perlis,1,0,1,Somalia
71165,6/1/2023,SOM,Sabah,0,0,0,Somalia
71166,6/1/2023,SOM,Sarawak,0,0,0,Somalia
71167,6/1/2023,SOM,Selangor,170,100,70,Somalia
71168,6/1/2023,SRB,Johor,12,5,7,Serbia
71169,6/1/2023,SRB,Kedah,3,3,0,Serbia
71170,6/1/2023,SRB,Kelantan,0,0,0,Serbia
71171,6/1/2023,SRB,Pahang,0,0,0,Serbia
71172,6/1/2023,SRB,Perak,0,0,0,Serbia
71173,6/1/2023,SRB,Perlis,0,0,0,Serbia
71174,6/1/2023,SRB,Pulau Pinang,6,3,3,Serbia
71175,6/1/2023,SRB,Sabah,0,0,0,Serbia
71176,6/1/2023,SRB,Sarawak,0,0,0,Serbia
71177,6/1/2023,SRB,Selangor,31,17,14,Serbia
71178,6/1/2023,STP,Selangor,0,0,0,Sao Tome and Principe
71179,6/1/2023,SUR,Johor,4,2,2,Suriname
71180,6/1/2023,SUR,Kedah,0,0,0,Suriname
71181,6/1/2023,SUR,Kelantan,0,0,0,Suriname
71182,6/1/2023,SUR,Perak,0,0,0,Suriname
71183,6/1/2023,SUR,Perlis,0,0,0,Suriname
71184,6/1/2023,SUR,Pulau Pinang,3,3,0,Suriname
71185,6/1/2023,SUR,Sabah,0,0,0,Suriname
71186,6/1/2023,SUR,Sarawak,0,0,0,Suriname
71187,6/1/2023,SUR,Selangor,17,11,6,Suriname
71188,6/1/2023,SVK,Johor,30,17,13,Slovakia
71189,6/1/2023,SVK,Kedah,18,11,7,Slovakia
71190,6/1/2023,SVK,Kelantan,0,0,0,Slovakia
71191,6/1/2023,SVK,Negeri Sembilan,0,0,0,Slovakia
71192,6/1/2023,SVK,Pahang,0,0,0,Slovakia
71193,6/1/2023,SVK,Perak,2,0,2,Slovakia
71194,6/1/2023,SVK,Perlis,0,0,0,Slovakia
71195,6/1/2023,SVK,Pulau Pinang,8,6,2,Slovakia
71196,6/1/2023,SVK,Sabah,1,1,0,Slovakia
71197,6/1/2023,SVK,Sarawak,5,3,2,Slovakia
71198,6/1/2023,SVK,Selangor,119,67,52,Slovakia
71199,6/1/2023,SVK,W.P. Labuan,0,0,0,Slovakia
71200,6/1/2023,SVN,Johor,12,4,8,Slovenia
71201,6/1/2023,SVN,Kedah,4,2,2,Slovenia
71202,6/1/2023,SVN,Kelantan,0,0,0,Slovenia
71203,6/1/2023,SVN,Perak,0,0,0,Slovenia
71204,6/1/2023,SVN,Perlis,4,2,2,Slovenia
71205,6/1/2023,SVN,Pulau Pinang,4,2,2,Slovenia
71206,6/1/2023,SVN,Sabah,1,0,1,Slovenia
71207,6/1/2023,SVN,Sarawak,1,0,1,Slovenia
71208,6/1/2023,SVN,Selangor,70,47,23,Slovenia
71209,6/1/2023,SVN,W.P. Labuan,0,0,0,Slovenia
71210,6/1/2023,SWE,Johor,250,152,98,Sweden
71211,6/1/2023,SWE,Kedah,25,11,14,Sweden
71212,6/1/2023,SWE,Kelantan,4,3,1,Sweden
71213,6/1/2023,SWE,Melaka,0,0,0,Sweden
71214,6/1/2023,SWE,Negeri Sembilan,0,0,0,Sweden
71215,6/1/2023,SWE,Pahang,1,1,0,Sweden
71216,6/1/2023,SWE,Perak,4,2,2,Sweden
71217,6/1/2023,SWE,Perlis,13,10,3,Sweden
71218,6/1/2023,SWE,Pulau Pinang,63,44,19,Sweden
71219,6/1/2023,SWE,Sabah,11,6,5,Sweden
71220,6/1/2023,SWE,Sarawak,15,12,3,Sweden
71221,6/1/2023,SWE,Selangor,728,457,271,Sweden
71222,6/1/2023,SWE,W.P. Labuan,0,0,0,Sweden
71223,6/1/2023,SWZ,Johor,0,0,0,Swaziland
71224,6/1/2023,SWZ,Kedah,0,0,0,Swaziland
71225,6/1/2023,SWZ,Pulau Pinang,0,0,0,Swaziland
71226,6/1/2023,SWZ,Sabah,0,0,0,Swaziland
71227,6/1/2023,SWZ,Selangor,17,7,10,Swaziland
71228,6/1/2023,SYC,Johor,3,1,2,Seychelles
71229,6/1/2023,SYC,Kedah,0,0,0,Seychelles
71230,6/1/2023,SYC,Pulau Pinang,0,0,0,Seychelles
71231,6/1/2023,SYC,Sabah,0,0,0,Seychelles
71232,6/1/2023,SYC,Sarawak,1,1,0,Seychelles
71233,6/1/2023,SYC,Selangor,48,16,32,Seychelles
71234,6/1/2023,SYR,Johor,12,7,5,Syrian Arab Republic
71235,6/1/2023,SYR,Kedah,0,0,0,Syrian Arab Republic
71236,6/1/2023,SYR,Kelantan,0,0,0,Syrian Arab Republic
71237,6/1/2023,SYR,Pahang,0,0,0,Syrian Arab Republic
71238,6/1/2023,SYR,Perlis,0,0,0,Syrian Arab Republic
71239,6/1/2023,SYR,Pulau Pinang,1,1,0,Syrian Arab Republic
71240,6/1/2023,SYR,Sabah,0,0,0,Syrian Arab Republic
71241,6/1/2023,SYR,Sarawak,1,1,0,Syrian Arab Republic
71242,6/1/2023,SYR,Selangor,670,383,287,Syrian Arab Republic
71243,6/1/2023,SYR,W.P. Labuan,1,1,0,Syrian Arab Republic
71244,6/1/2023,TCA,Perlis,0,0,0,Turks and Caicos
71245,6/1/2023,TCD,Johor,0,0,0,Chad
71246,6/1/2023,TCD,Kedah,0,0,0,Chad
71247,6/1/2023,TCD,Perlis,0,0,0,Chad
71248,6/1/2023,TCD,Selangor,26,18,8,Chad
71249,6/1/2023,TGO,Johor,0,0,0,Togo
71250,6/1/2023,TGO,Perak,1,1,0,Togo
71251,6/1/2023,TGO,Pulau Pinang,1,1,0,Togo
71252,6/1/2023,TGO,Selangor,2,2,0,Togo
71253,6/1/2023,THA,Johor,5129,1309,3820,Thailand
71254,6/1/2023,THA,Kedah,53478,30729,22749,Thailand
71255,6/1/2023,THA,Kelantan,35495,18643,16852,Thailand
71256,6/1/2023,THA,Melaka,57,24,33,Thailand
71257,6/1/2023,THA,Negeri Sembilan,1,0,1,Thailand
71258,6/1/2023,THA,Pahang,25,20,5,Thailand
71259,6/1/2023,THA,Perak,8447,3837,4610,Thailand
71260,6/1/2023,THA,Perlis,42362,24786,17576,Thailand
71261,6/1/2023,THA,Pulau Pinang,2023,841,1182,Thailand
71262,6/1/2023,THA,Sabah,16,7,9,Thailand
71263,6/1/2023,THA,Sarawak,326,103,223,Thailand
71264,6/1/2023,THA,Selangor,6857,2750,4107,Thailand
71265,6/1/2023,THA,Terengganu,0,0,0,Thailand
71266,6/1/2023,THA,W.P. Labuan,3,1,2,Thailand
71267,6/1/2023,TJK,Johor,4,3,1,Tajikistan
71268,6/1/2023,TJK,Kedah,0,0,0,Tajikistan
71269,6/1/2023,TJK,Perlis,0,0,0,Tajikistan
71270,6/1/2023,TJK,Pulau Pinang,1,0,1,Tajikistan
71271,6/1/2023,TJK,Sabah,1,0,1,Tajikistan
71272,6/1/2023,TJK,Selangor,83,60,23,Tajikistan
71273,6/1/2023,TKL,Selangor,0,0,0,Tokelau
71274,6/1/2023,TKM,Johor,4,2,2,Turkmenistan
71275,6/1/2023,TKM,Kedah,1,1,0,Turkmenistan
71276,6/1/2023,TKM,Kelantan,0,0,0,Turkmenistan
71277,6/1/2023,TKM,Perlis,0,0,0,Turkmenistan
71278,6/1/2023,TKM,Pulau Pinang,1,1,0,Turkmenistan
71279,6/1/2023,TKM,Sabah,0,0,0,Turkmenistan
71280,6/1/2023,TKM,Sarawak,0,0,0,Turkmenistan
71281,6/1/2023,TKM,Selangor,92,60,32,Turkmenistan
71282,6/1/2023,TLS,Johor,2,0,2,Timor-Leste
71283,6/1/2023,TLS,Kedah,0,0,0,Timor-Leste
71284,6/1/2023,TLS,Perlis,0,0,0,Timor-Leste
71285,6/1/2023,TLS,Pulau Pinang,6,2,4,Timor-Leste
71286,6/1/2023,TLS,Sabah,2,0,2,Timor-Leste
71287,6/1/2023,TLS,Sarawak,4,1,3,Timor-Leste
71288,6/1/2023,TLS,Selangor,138,90,48,Timor-Leste
71289,6/1/2023,TON,Johor,0,0,0,Tonga
71290,6/1/2023,TON,Pulau Pinang,3,1,2,Tonga
71291,6/1/2023,TON,Sarawak,0,0,0,Tonga
71292,6/1/2023,TON,Selangor,3,1,2,Tonga
71293,6/1/2023,TTO,Johor,3,2,1,Trinidad and Tobago
71294,6/1/2023,TTO,Kedah,0,0,0,Trinidad and Tobago
71295,6/1/2023,TTO,Pahang,0,0,0,Trinidad and Tobago
71296,6/1/2023,TTO,Pulau Pinang,1,1,0,Trinidad and Tobago
71297,6/1/2023,TTO,Sabah,0,0,0,Trinidad and Tobago
71298,6/1/2023,TTO,Sarawak,0,0,0,Trinidad and Tobago
71299,6/1/2023,TTO,Selangor,29,18,11,Trinidad and Tobago
71300,6/1/2023,TUN,Johor,13,7,6,Tunisia
71301,6/1/2023,TUN,Kedah,1,0,1,Tunisia
71302,6/1/2023,TUN,Kelantan,0,0,0,Tunisia
71303,6/1/2023,TUN,Melaka,0,0,0,Tunisia
71304,6/1/2023,TUN,Perak,0,0,0,Tunisia
71305,6/1/2023,TUN,Perlis,0,0,0,Tunisia
71306,6/1/2023,TUN,Pulau Pinang,2,1,1,Tunisia
71307,6/1/2023,TUN,Sabah,1,0,1,Tunisia
71308,6/1/2023,TUN,Sarawak,1,0,1,Tunisia
71309,6/1/2023,TUN,Selangor,344,170,174,Tunisia
71310,6/1/2023,TUN,W.P. Labuan,0,0,0,Tunisia
71311,6/1/2023,TUR,Johor,323,230,93,Turkey
71312,6/1/2023,TUR,Kedah,32,24,8,Turkey
71313,6/1/2023,TUR,Kelantan,1,1,0,Turkey
71314,6/1/2023,TUR,Melaka,0,0,0,Turkey
71315,6/1/2023,TUR,Negeri Sembilan,0,0,0,Turkey
71316,6/1/2023,TUR,Pahang,2,2,0,Turkey
71317,6/1/2023,TUR,Perak,2,1,1,Turkey
71318,6/1/2023,TUR,Perlis,20,15,5,Turkey
71319,6/1/2023,TUR,Pulau Pinang,27,21,6,Turkey
71320,6/1/2023,TUR,Sabah,6,3,3,Turkey
71321,6/1/2023,TUR,Sarawak,22,14,8,Turkey
71322,6/1/2023,TUR,Selangor,1164,797,367,Turkey
71323,6/1/2023,TUR,W.P. Labuan,0,0,0,Turkey
71324,6/1/2023,TUV,Selangor,0,0,0,Tuvalu
71325,6/1/2023,TWN,Johor,6594,2943,3651,Taiwan
71326,6/1/2023,TWN,Kedah,190,108,82,Taiwan
71327,6/1/2023,TWN,Kelantan,0,0,0,Taiwan
71328,6/1/2023,TWN,Melaka,6,2,4,Taiwan
71329,6/1/2023,TWN,Negeri Sembilan,0,0,0,Taiwan
71330,6/1/2023,TWN,Pahang,8,2,6,Taiwan
71331,6/1/2023,TWN,Perak,65,39,26,Taiwan
71332,6/1/2023,TWN,Perlis,24,10,14,Taiwan
71333,6/1/2023,TWN,Pulau Pinang,5861,2718,3143,Taiwan
71334,6/1/2023,TWN,Sabah,967,477,490,Taiwan
71335,6/1/2023,TWN,Sarawak,265,142,123,Taiwan
71336,6/1/2023,TWN,Selangor,13914,6292,7622,Taiwan
71337,6/1/2023,TWN,W.P. Labuan,6,3,3,Taiwan
71338,6/1/2023,TZA,Johor,19,11,8,"Tanzania, United Republic of"
71339,6/1/2023,TZA,Kedah,1,1,0,"Tanzania, United Republic of"
71340,6/1/2023,TZA,Perak,0,0,0,"Tanzania, United Republic of"
71341,6/1/2023,TZA,Perlis,0,0,0,"Tanzania, United Republic of"
71342,6/1/2023,TZA,Pulau Pinang,0,0,0,"Tanzania, United Republic of"
71343,6/1/2023,TZA,Sabah,0,0,0,"Tanzania, United Republic of"
71344,6/1/2023,TZA,Sarawak,6,5,1,"Tanzania, United Republic of"
71345,6/1/2023,TZA,Selangor,135,68,67,"Tanzania, United Republic of"
71346,6/1/2023,UGA,Johor,15,5,10,Uganda
71347,6/1/2023,UGA,Kedah,2,1,1,Uganda
71348,6/1/2023,UGA,Perak,0,0,0,Uganda
71349,6/1/2023,UGA,Perlis,0,0,0,Uganda
71350,6/1/2023,UGA,Pulau Pinang,3,3,0,Uganda
71351,6/1/2023,UGA,Sabah,0,0,0,Uganda
71352,6/1/2023,UGA,Sarawak,0,0,0,Uganda
71353,6/1/2023,UGA,Selangor,107,53,54,Uganda
71354,6/1/2023,UKR,Johor,132,84,48,Ukraine
71355,6/1/2023,UKR,Kedah,15,4,11,Ukraine
71356,6/1/2023,UKR,Kelantan,4,3,1,Ukraine
71357,6/1/2023,UKR,Melaka,4,4,0,Ukraine
71358,6/1/2023,UKR,Negeri Sembilan,0,0,0,Ukraine
71359,6/1/2023,UKR,Pahang,3,3,0,Ukraine
71360,6/1/2023,UKR,Perak,0,0,0,Ukraine
71361,6/1/2023,UKR,Perlis,6,4,2,Ukraine
71362,6/1/2023,UKR,Pulau Pinang,17,10,7,Ukraine
71363,6/1/2023,UKR,Sabah,3,1,2,Ukraine
71364,6/1/2023,UKR,Sarawak,4,3,1,Ukraine
71365,6/1/2023,UKR,Selangor,525,276,249,Ukraine
71366,6/1/2023,UKR,W.P. Labuan,0,0,0,Ukraine
71367,6/1/2023,URY,Johor,7,3,4,Uruguay
71368,6/1/2023,URY,Kedah,1,1,0,Uruguay
71369,6/1/2023,URY,Kelantan,0,0,0,Uruguay
71370,6/1/2023,URY,Perak,0,0,0,Uruguay
71371,6/1/2023,URY,Perlis,0,0,0,Uruguay
71372,6/1/2023,URY,Pulau Pinang,0,0,0,Uruguay
71373,6/1/2023,URY,Sabah,0,0,0,Uruguay
71374,6/1/2023,URY,Sarawak,1,0,1,Uruguay
71375,6/1/2023,URY,Selangor,37,19,18,Uruguay
71376,6/1/2023,URY,W.P. Labuan,0,0,0,Uruguay
71377,6/1/2023,USA,Johor,4955,2834,2121,United States Of America
71378,6/1/2023,USA,Kedah,457,258,199,United States Of America
71379,6/1/2023,USA,Kelantan,18,12,6,United States Of America
71380,6/1/2023,USA,Melaka,2,2,0,United States Of America
71381,6/1/2023,USA,Negeri Sembilan,0,0,0,United States Of America
71382,6/1/2023,USA,Pahang,21,14,7,United States Of America
71383,6/1/2023,USA,Perak,192,105,87,United States Of America
71384,6/1/2023,USA,Perlis,139,90,49,United States Of America
71385,6/1/2023,USA,Pulau Pinang,2245,1318,927,United States Of America
71386,6/1/2023,USA,Sabah,252,149,103,United States Of America
71387,6/1/2023,USA,Sarawak,302,181,121,United States Of America
71388,6/1/2023,USA,Selangor,11853,6854,4999,United States Of America
71389,6/1/2023,USA,Terengganu,0,0,0,United States Of America
71390,6/1/2023,USA,W.P. Labuan,4,3,1,United States Of America
71391,6/1/2023,UZB,Johor,107,81,26,Uzbekistan
71392,6/1/2023,UZB,Kedah,5,4,1,Uzbekistan
71393,6/1/2023,UZB,Kelantan,0,0,0,Uzbekistan
71394,6/1/2023,UZB,Perak,0,0,0,Uzbekistan
71395,6/1/2023,UZB,Perlis,2,2,0,Uzbekistan
71396,6/1/2023,UZB,Pulau Pinang,18,7,11,Uzbekistan
71397,6/1/2023,UZB,Sabah,3,2,1,Uzbekistan
71398,6/1/2023,UZB,Sarawak,0,0,0,Uzbekistan
71399,6/1/2023,UZB,Selangor,823,478,345,Uzbekistan
71400,6/1/2023,VAT,Johor,0,0,0,Holy See (Vatican City State)
71401,6/1/2023,VAT,Sarawak,0,0,0,Holy See (Vatican City State)
71402,6/1/2023,VAT,Selangor,0,0,0,Holy See (Vatican City State)
71403,6/1/2023,VCT,Johor,3,1,2,Saint Vincent and the Grenadines
71404,6/1/2023,VCT,Kedah,1,1,0,Saint Vincent and the Grenadines
71405,6/1/2023,VCT,Pulau Pinang,1,0,1,Saint Vincent and the Grenadines
71406,6/1/2023,VCT,Sarawak,0,0,0,Saint Vincent and the Grenadines
71407,6/1/2023,VCT,Selangor,9,2,7,Saint Vincent and the Grenadines
71408,6/1/2023,VEN,Johor,12,10,2,Venezuela
71409,6/1/2023,VEN,Kedah,0,0,0,Venezuela
71410,6/1/2023,VEN,Kelantan,0,0,0,Venezuela
71411,6/1/2023,VEN,Melaka,0,0,0,Venezuela
71412,6/1/2023,VEN,Perak,0,0,0,Venezuela
71413,6/1/2023,VEN,Perlis,0,0,0,Venezuela
71414,6/1/2023,VEN,Pulau Pinang,5,3,2,Venezuela
71415,6/1/2023,VEN,Sabah,5,2,3,Venezuela
71416,6/1/2023,VEN,Sarawak,1,1,0,Venezuela
71417,6/1/2023,VEN,Selangor,62,35,27,Venezuela
71418,6/1/2023,VEN,W.P. Labuan,0,0,0,Venezuela
71419,6/1/2023,VNM,Johor,19318,6651,12667,Vietnam
71420,6/1/2023,VNM,Kedah,316,63,253,Vietnam
71421,6/1/2023,VNM,Kelantan,22,10,12,Vietnam
71422,6/1/2023,VNM,Melaka,0,0,0,Vietnam
71423,6/1/2023,VNM,Negeri Sembilan,0,0,0,Vietnam
71424,6/1/2023,VNM,Pahang,2,1,1,Vietnam
71425,6/1/2023,VNM,Perak,152,16,136,Vietnam
71426,6/1/2023,VNM,Perlis,278,38,240,Vietnam
71427,6/1/2023,VNM,Pulau Pinang,1904,541,1363,Vietnam
71428,6/1/2023,VNM,Sabah,31,10,21,Vietnam
71429,6/1/2023,VNM,Sarawak,207,47,160,Vietnam
71430,6/1/2023,VNM,Selangor,12279,4633,7646,Vietnam
71431,6/1/2023,VNM,Terengganu,2,2,0,Vietnam
71432,6/1/2023,VNM,W.P. Labuan,4,1,3,Vietnam
71433,6/1/2023,VUT,Johor,46,31,15,Vanuatu
71434,6/1/2023,VUT,Kedah,0,0,0,Vanuatu
71435,6/1/2023,VUT,Pulau Pinang,1,1,0,Vanuatu
71436,6/1/2023,VUT,Sabah,0,0,0,Vanuatu
71437,6/1/2023,VUT,Sarawak,0,0,0,Vanuatu
71438,6/1/2023,VUT,Selangor,40,37,3,Vanuatu
71439,6/1/2023,WSM,Johor,0,0,0,Samoa
71440,6/1/2023,WSM,Sarawak,0,0,0,Samoa
71441,6/1/2023,WSM,Selangor,4,3,1,Samoa
71442,6/1/2023,YEM,Johor,43,32,11,Yemen
71443,6/1/2023,YEM,Kedah,2,2,0,Yemen
71444,6/1/2023,YEM,Kelantan,0,0,0,Yemen
71445,6/1/2023,YEM,Melaka,4,2,2,Yemen
71446,6/1/2023,YEM,Pahang,1,1,0,Yemen
71447,6/1/2023,YEM,Perak,1,1,0,Yemen
71448,6/1/2023,YEM,Perlis,0,0,0,Yemen
71449,6/1/2023,YEM,Pulau Pinang,4,4,0,Yemen
71450,6/1/2023,YEM,Sabah,0,0,0,Yemen
71451,6/1/2023,YEM,Sarawak,3,1,2,Yemen
71452,6/1/2023,YEM,Selangor,1533,924,609,Yemen
71453,6/1/2023,YEM,W.P. Labuan,0,0,0,Yemen
71454,6/1/2023,ZAF,Johor,270,167,103,South Africa
71455,6/1/2023,ZAF,Kedah,26,14,12,South Africa
71456,6/1/2023,ZAF,Kelantan,7,5,2,South Africa
71457,6/1/2023,ZAF,Melaka,0,0,0,South Africa
71458,6/1/2023,ZAF,Pahang,2,1,1,South Africa
71459,6/1/2023,ZAF,Perak,3,2,1,South Africa
71460,6/1/2023,ZAF,Perlis,28,19,9,South Africa
71461,6/1/2023,ZAF,Pulau Pinang,54,34,20,South Africa
71462,6/1/2023,ZAF,Sabah,27,12,15,South Africa
71463,6/1/2023,ZAF,Sarawak,69,29,40,South Africa
71464,6/1/2023,ZAF,Selangor,765,428,337,South Africa
71465,6/1/2023,ZAF,Terengganu,0,0,0,South Africa
71466,6/1/2023,ZAF,W.P. Labuan,14,7,7,South Africa
71467,6/1/2023,ZMB,Johor,9,1,8,Zambia
71468,6/1/2023,ZMB,Kedah,0,0,0,Zambia
71469,6/1/2023,ZMB,Perak,0,0,0,Zambia
71470,6/1/2023,ZMB,Perlis,0,0,0,Zambia
71471,6/1/2023,ZMB,Pulau Pinang,0,0,0,Zambia
71472,6/1/2023,ZMB,Sabah,0,0,0,Zambia
71473,6/1/2023,ZMB,Sarawak,0,0,0,Zambia
71474,6/1/2023,ZMB,Selangor,78,42,36,Zambia
71475,6/1/2023,ZWE,Johor,2,1,1,Zimbabwe
71476,6/1/2023,ZWE,Kedah,1,1,0,Zimbabwe
71477,6/1/2023,ZWE,Kelantan,0,0,0,Zimbabwe
71478,6/1/2023,ZWE,Perak,0,0,0,Zimbabwe
71479,6/1/2023,ZWE,Perlis,0,0,0,Zimbabwe
71480,6/1/2023,ZWE,Pulau Pinang,2,1,1,Zimbabwe
71481,6/1/2023,ZWE,Sabah,0,0,0,Zimbabwe
71482,6/1/2023,ZWE,Sarawak,0,0,0,Zimbabwe
71483,6/1/2023,ZWE,Selangor,151,71,80,Zimbabwe
71484,7/1/2023,ABW,Kedah,0,0,0,Aruba
71485,7/1/2023,ABW,Pulau Pinang,0,0,0,Aruba
71486,7/1/2023,AFG,Johor,0,0,0,Afghanistan
71487,7/1/2023,AFG,Kedah,0,0,0,Afghanistan
71488,7/1/2023,AFG,Perlis,3,3,0,Afghanistan
71489,7/1/2023,AFG,Pulau Pinang,0,0,0,Afghanistan
71490,7/1/2023,AFG,Sarawak,0,0,0,Afghanistan
71491,7/1/2023,AFG,Selangor,68,39,29,Afghanistan
71492,7/1/2023,AGO,Johor,0,0,0,Angola
71493,7/1/2023,AGO,Kedah,0,0,0,Angola
71494,7/1/2023,AGO,Sabah,0,0,0,Angola
71495,7/1/2023,AGO,Selangor,8,8,0,Angola
71496,7/1/2023,AIA,Selangor,0,0,0,Anguilla
71497,7/1/2023,ALB,Johor,20,16,4,Albania
71498,7/1/2023,ALB,Kedah,0,0,0,Albania
71499,7/1/2023,ALB,Perak,0,0,0,Albania
71500,7/1/2023,ALB,Perlis,0,0,0,Albania
71501,7/1/2023,ALB,Pulau Pinang,1,1,0,Albania
71502,7/1/2023,ALB,Sabah,0,0,0,Albania
71503,7/1/2023,ALB,Sarawak,1,1,0,Albania
71504,7/1/2023,ALB,Selangor,25,12,13,Albania
71505,7/1/2023,AND,Johor,0,0,0,Andorra
71506,7/1/2023,AND,Kedah,0,0,0,Andorra
71507,7/1/2023,AND,Perlis,0,0,0,Andorra
71508,7/1/2023,AND,Pulau Pinang,0,0,0,Andorra
71509,7/1/2023,AND,Selangor,7,3,4,Andorra
71510,7/1/2023,ANT,Selangor,0,0,0,Netherlands Antilles
71511,7/1/2023,ARE,Johor,106,58,48,United Arab Emirates
71512,7/1/2023,ARE,Kedah,27,13,14,United Arab Emirates
71513,7/1/2023,ARE,Kelantan,0,0,0,United Arab Emirates
71514,7/1/2023,ARE,Perak,0,0,0,United Arab Emirates
71515,7/1/2023,ARE,Perlis,3,1,2,United Arab Emirates
71516,7/1/2023,ARE,Pulau Pinang,9,3,6,United Arab Emirates
71517,7/1/2023,ARE,Sabah,0,0,0,United Arab Emirates
71518,7/1/2023,ARE,Sarawak,0,0,0,United Arab Emirates
71519,7/1/2023,ARE,Selangor,2070,1023,1047,United Arab Emirates
71520,7/1/2023,ARG,Johor,105,64,41,Argentina
71521,7/1/2023,ARG,Kedah,11,5,6,Argentina
71522,7/1/2023,ARG,Kelantan,0,0,0,Argentina
71523,7/1/2023,ARG,Melaka,0,0,0,Argentina
71524,7/1/2023,ARG,Perak,0,0,0,Argentina
71525,7/1/2023,ARG,Perlis,4,2,2,Argentina
71526,7/1/2023,ARG,Pulau Pinang,13,9,4,Argentina
71527,7/1/2023,ARG,Sabah,1,0,1,Argentina
71528,7/1/2023,ARG,Sarawak,1,1,0,Argentina
71529,7/1/2023,ARG,Selangor,368,185,183,Argentina
71530,7/1/2023,ARG,W.P. Labuan,0,0,0,Argentina
71531,7/1/2023,ARM,Johor,4,1,3,Armenia
71532,7/1/2023,ARM,Kedah,0,0,0,Armenia
71533,7/1/2023,ARM,Kelantan,0,0,0,Armenia
71534,7/1/2023,ARM,Perak,0,0,0,Armenia
71535,7/1/2023,ARM,Perlis,0,0,0,Armenia
71536,7/1/2023,ARM,Pulau Pinang,0,0,0,Armenia
71537,7/1/2023,ARM,Sabah,0,0,0,Armenia
71538,7/1/2023,ARM,Sarawak,1,1,0,Armenia
71539,7/1/2023,ARM,Selangor,130,50,80,Armenia
71540,7/1/2023,ATA,Selangor,0,0,0,Antarctica
71541,7/1/2023,ATG,Johor,8,8,0,Antigua and Barbuda
71542,7/1/2023,ATG,Kedah,0,0,0,Antigua and Barbuda
71543,7/1/2023,ATG,Pulau Pinang,2,0,2,Antigua and Barbuda
71544,7/1/2023,ATG,Sarawak,0,0,0,Antigua and Barbuda
71545,7/1/2023,ATG,Selangor,23,19,4,Antigua and Barbuda
71546,7/1/2023,AUS,Johor,5848,3444,2404,Australia
71547,7/1/2023,AUS,Kedah,629,340,289,Australia
71548,7/1/2023,AUS,Kelantan,9,5,4,Australia
71549,7/1/2023,AUS,Melaka,5,3,2,Australia
71550,7/1/2023,AUS,Negeri Sembilan,1,1,0,Australia
71551,7/1/2023,AUS,Pahang,18,7,11,Australia
71552,7/1/2023,AUS,Perak,263,135,128,Australia
71553,7/1/2023,AUS,Perlis,113,67,46,Australia
71554,7/1/2023,AUS,Pulau Pinang,2182,1120,1062,Australia
71555,7/1/2023,AUS,Sabah,305,174,131,Australia
71556,7/1/2023,AUS,Sarawak,563,321,242,Australia
71557,7/1/2023,AUS,Selangor,29346,16481,12865,Australia
71558,7/1/2023,AUS,Terengganu,0,0,0,Australia
71559,7/1/2023,AUS,W.P. Labuan,9,6,3,Australia
71560,7/1/2023,AUT,Johor,228,158,70,Austria
71561,7/1/2023,AUT,Kedah,47,24,23,Austria
71562,7/1/2023,AUT,Kelantan,3,2,1,Austria
71563,7/1/2023,AUT,Melaka,0,0,0,Austria
71564,7/1/2023,AUT,Negeri Sembilan,0,0,0,Austria
71565,7/1/2023,AUT,Pahang,0,0,0,Austria
71566,7/1/2023,AUT,Perak,1,1,0,Austria
71567,7/1/2023,AUT,Perlis,14,9,5,Austria
71568,7/1/2023,AUT,Pulau Pinang,84,52,32,Austria
71569,7/1/2023,AUT,Sabah,10,6,4,Austria
71570,7/1/2023,AUT,Sarawak,17,9,8,Austria
71571,7/1/2023,AUT,Selangor,987,532,455,Austria
71572,7/1/2023,AUT,Terengganu,0,0,0,Austria
71573,7/1/2023,AUT,W.P. Labuan,0,0,0,Austria
71574,7/1/2023,AZE,Johor,3,2,1,Azerbaijan
71575,7/1/2023,AZE,Kedah,2,1,1,Azerbaijan
71576,7/1/2023,AZE,Kelantan,0,0,0,Azerbaijan
71577,7/1/2023,AZE,Melaka,0,0,0,Azerbaijan
71578,7/1/2023,AZE,Perlis,0,0,0,Azerbaijan
71579,7/1/2023,AZE,Pulau Pinang,1,0,1,Azerbaijan
71580,7/1/2023,AZE,Sabah,0,0,0,Azerbaijan
71581,7/1/2023,AZE,Sarawak,1,1,0,Azerbaijan
71582,7/1/2023,AZE,Selangor,159,88,71,Azerbaijan
71583,7/1/2023,AZE,W.P. Labuan,0,0,0,Azerbaijan
71584,7/1/2023,BDI,Pulau Pinang,0,0,0,Burundi
71585,7/1/2023,BDI,Sarawak,0,0,0,Burundi
71586,7/1/2023,BDI,Selangor,3,2,1,Burundi
71587,7/1/2023,BEL,Johor,465,263,202,Belgium
71588,7/1/2023,BEL,Kedah,105,53,52,Belgium
71589,7/1/2023,BEL,Kelantan,1,1,0,Belgium
71590,7/1/2023,BEL,Melaka,0,0,0,Belgium
71591,7/1/2023,BEL,Negeri Sembilan,0,0,0,Belgium
71592,7/1/2023,BEL,Pahang,1,1,0,Belgium
71593,7/1/2023,BEL,Perak,2,1,1,Belgium
71594,7/1/2023,BEL,Perlis,10,10,0,Belgium
71595,7/1/2023,BEL,Pulau Pinang,81,49,32,Belgium
71596,7/1/2023,BEL,Sabah,29,16,13,Belgium
71597,7/1/2023,BEL,Sarawak,49,29,20,Belgium
71598,7/1/2023,BEL,Selangor,2618,1401,1217,Belgium
71599,7/1/2023,BEL,W.P. Labuan,4,1,3,Belgium
71600,7/1/2023,BEN,Johor,0,0,0,Benin
71601,7/1/2023,BEN,Kedah,5,1,4,Benin
71602,7/1/2023,BEN,Perak,0,0,0,Benin
71603,7/1/2023,BEN,Pulau Pinang,0,0,0,Benin
71604,7/1/2023,BEN,Sabah,0,0,0,Benin
71605,7/1/2023,BEN,Sarawak,0,0,0,Benin
71606,7/1/2023,BEN,Selangor,18,15,3,Benin
71607,7/1/2023,BFA,Perak,0,0,0,Burkina Faso
71608,7/1/2023,BFA,Pulau Pinang,0,0,0,Burkina Faso
71609,7/1/2023,BFA,Selangor,7,7,0,Burkina Faso
71610,7/1/2023,BGD,Johor,3183,2587,596,Bangladesh
71611,7/1/2023,BGD,Kedah,214,123,91,Bangladesh
71612,7/1/2023,BGD,Kelantan,3,3,0,Bangladesh
71613,7/1/2023,BGD,Melaka,0,0,0,Bangladesh
71614,7/1/2023,BGD,Negeri Sembilan,0,0,0,Bangladesh
71615,7/1/2023,BGD,Pahang,2,2,0,Bangladesh
71616,7/1/2023,BGD,Perak,6,4,2,Bangladesh
71617,7/1/2023,BGD,Perlis,2,2,0,Bangladesh
71618,7/1/2023,BGD,Pulau Pinang,603,541,62,Bangladesh
71619,7/1/2023,BGD,Sabah,3,3,0,Bangladesh
71620,7/1/2023,BGD,Sarawak,23,21,2,Bangladesh
71621,7/1/2023,BGD,Selangor,57489,54806,2683,Bangladesh
71622,7/1/2023,BGD,W.P. Labuan,9,8,1,Bangladesh
71623,7/1/2023,BGR,Johor,22,5,17,Bulgaria
71624,7/1/2023,BGR,Kedah,0,0,0,Bulgaria
71625,7/1/2023,BGR,Kelantan,1,0,1,Bulgaria
71626,7/1/2023,BGR,Pahang,0,0,0,Bulgaria
71627,7/1/2023,BGR,Perak,0,0,0,Bulgaria
71628,7/1/2023,BGR,Perlis,0,0,0,Bulgaria
71629,7/1/2023,BGR,Pulau Pinang,11,7,4,Bulgaria
71630,7/1/2023,BGR,Sabah,3,2,1,Bulgaria
71631,7/1/2023,BGR,Sarawak,2,2,0,Bulgaria
71632,7/1/2023,BGR,Selangor,138,79,59,Bulgaria
71633,7/1/2023,BGR,W.P. Labuan,0,0,0,Bulgaria
71634,7/1/2023,BHR,Johor,57,22,35,Bahrain
71635,7/1/2023,BHR,Kedah,1,1,0,Bahrain
71636,7/1/2023,BHR,Kelantan,0,0,0,Bahrain
71637,7/1/2023,BHR,Perlis,2,2,0,Bahrain
71638,7/1/2023,BHR,Pulau Pinang,2,1,1,Bahrain
71639,7/1/2023,BHR,Sabah,0,0,0,Bahrain
71640,7/1/2023,BHR,Sarawak,0,0,0,Bahrain
71641,7/1/2023,BHR,Selangor,514,254,260,Bahrain
71642,7/1/2023,BHS,Johor,0,0,0,Bahamas
71643,7/1/2023,BHS,Kedah,0,0,0,Bahamas
71644,7/1/2023,BHS,Perak,0,0,0,Bahamas
71645,7/1/2023,BHS,Sabah,0,0,0,Bahamas
71646,7/1/2023,BHS,Sarawak,0,0,0,Bahamas
71647,7/1/2023,BHS,Selangor,7,5,2,Bahamas
71648,7/1/2023,BIH,Johor,16,6,10,Bosnia and Herzegovina
71649,7/1/2023,BIH,Kedah,0,0,0,Bosnia and Herzegovina
71650,7/1/2023,BIH,Perlis,2,2,0,Bosnia and Herzegovina
71651,7/1/2023,BIH,Pulau Pinang,0,0,0,Bosnia and Herzegovina
71652,7/1/2023,BIH,Sabah,0,0,0,Bosnia and Herzegovina
71653,7/1/2023,BIH,Sarawak,0,0,0,Bosnia and Herzegovina
71654,7/1/2023,BIH,Selangor,42,22,20,Bosnia and Herzegovina
71655,7/1/2023,BLR,Johor,6,2,4,Belarus
71656,7/1/2023,BLR,Kedah,16,5,11,Belarus
71657,7/1/2023,BLR,Kelantan,2,1,1,Belarus
71658,7/1/2023,BLR,Pahang,0,0,0,Belarus
71659,7/1/2023,BLR,Perak,1,0,1,Belarus
71660,7/1/2023,BLR,Perlis,1,1,0,Belarus
71661,7/1/2023,BLR,Pulau Pinang,5,3,2,Belarus
71662,7/1/2023,BLR,Sabah,1,0,1,Belarus
71663,7/1/2023,BLR,Sarawak,1,1,0,Belarus
71664,7/1/2023,BLR,Selangor,308,150,158,Belarus
71665,7/1/2023,BLR,W.P. Labuan,0,0,0,Belarus
71666,7/1/2023,BLZ,Johor,4,2,2,Belize
71667,7/1/2023,BLZ,Pulau Pinang,0,0,0,Belize
71668,7/1/2023,BLZ,Sarawak,0,0,0,Belize
71669,7/1/2023,BLZ,Selangor,14,9,5,Belize
71670,7/1/2023,BMU,Selangor,0,0,0,Bermuda
71671,7/1/2023,BOL,Johor,10,8,2,Bolivia
71672,7/1/2023,BOL,Kedah,0,0,0,Bolivia
71673,7/1/2023,BOL,Melaka,0,0,0,Bolivia
71674,7/1/2023,BOL,Perak,0,0,0,Bolivia
71675,7/1/2023,BOL,Perlis,0,0,0,Bolivia
71676,7/1/2023,BOL,Pulau Pinang,0,0,0,Bolivia
71677,7/1/2023,BOL,Sabah,1,0,1,Bolivia
71678,7/1/2023,BOL,Sarawak,0,0,0,Bolivia
71679,7/1/2023,BOL,Selangor,40,22,18,Bolivia
71680,7/1/2023,BRA,Johor,207,113,94,Brazil
71681,7/1/2023,BRA,Kedah,19,7,12,Brazil
71682,7/1/2023,BRA,Kelantan,1,1,0,Brazil
71683,7/1/2023,BRA,Melaka,1,0,1,Brazil
71684,7/1/2023,BRA,Pahang,0,0,0,Brazil
71685,7/1/2023,BRA,Perak,6,3,3,Brazil
71686,7/1/2023,BRA,Perlis,9,5,4,Brazil
71687,7/1/2023,BRA,Pulau Pinang,28,18,10,Brazil
71688,7/1/2023,BRA,Sabah,3,2,1,Brazil
71689,7/1/2023,BRA,Sarawak,13,7,6,Brazil
71690,7/1/2023,BRA,Selangor,980,541,439,Brazil
71691,7/1/2023,BRA,W.P. Labuan,1,1,0,Brazil
71692,7/1/2023,BRB,Johor,2,2,0,Barbados
71693,7/1/2023,BRB,Kedah,0,0,0,Barbados
71694,7/1/2023,BRB,Perlis,0,0,0,Barbados
71695,7/1/2023,BRB,Pulau Pinang,2,0,2,Barbados
71696,7/1/2023,BRB,Selangor,3,1,2,Barbados
71697,7/1/2023,BRN,Johor,436,234,202,Brunei Darussalam
71698,7/1/2023,BRN,Kedah,34,18,16,Brunei Darussalam
71699,7/1/2023,BRN,Kelantan,23,11,12,Brunei Darussalam
71700,7/1/2023,BRN,Melaka,0,0,0,Brunei Darussalam
71701,7/1/2023,BRN,Pahang,0,0,0,Brunei Darussalam
71702,7/1/2023,BRN,Perak,3,2,1,Brunei Darussalam
71703,7/1/2023,BRN,Perlis,18,3,15,Brunei Darussalam
71704,7/1/2023,BRN,Pulau Pinang,22,11,11,Brunei Darussalam
71705,7/1/2023,BRN,Sabah,435,177,258,Brunei Darussalam
71706,7/1/2023,BRN,Sarawak,78969,43184,35785,Brunei Darussalam
71707,7/1/2023,BRN,Selangor,4956,2422,2534,Brunei Darussalam
71708,7/1/2023,BRN,W.P. Labuan,817,622,195,Brunei Darussalam
71709,7/1/2023,BTN,Johor,7,7,0,Bhutan
71710,7/1/2023,BTN,Kedah,0,0,0,Bhutan
71711,7/1/2023,BTN,Perak,0,0,0,Bhutan
71712,7/1/2023,BTN,Perlis,0,0,0,Bhutan
71713,7/1/2023,BTN,Pulau Pinang,4,3,1,Bhutan
71714,7/1/2023,BTN,Sabah,0,0,0,Bhutan
71715,7/1/2023,BTN,Sarawak,0,0,0,Bhutan
71716,7/1/2023,BTN,Selangor,63,48,15,Bhutan
71717,7/1/2023,BWA,Johor,2,2,0,Botswana
71718,7/1/2023,BWA,Kedah,0,0,0,Botswana
71719,7/1/2023,BWA,Perlis,0,0,0,Botswana
71720,7/1/2023,BWA,Pulau Pinang,0,0,0,Botswana
71721,7/1/2023,BWA,Sabah,0,0,0,Botswana
71722,7/1/2023,BWA,Sarawak,0,0,0,Botswana
71723,7/1/2023,BWA,Selangor,6,1,5,Botswana
71724,7/1/2023,CAF,Kedah,0,0,0,Central African Republic
71725,7/1/2023,CAF,Selangor,0,0,0,Central African Republic
71726,7/1/2023,CAN,Johor,1496,842,654,Canada
71727,7/1/2023,CAN,Kedah,136,75,61,Canada
71728,7/1/2023,CAN,Kelantan,6,3,3,Canada
71729,7/1/2023,CAN,Melaka,1,1,0,Canada
71730,7/1/2023,CAN,Negeri Sembilan,0,0,0,Canada
71731,7/1/2023,CAN,Pahang,1,1,0,Canada
71732,7/1/2023,CAN,Perak,39,21,18,Canada
71733,7/1/2023,CAN,Perlis,34,20,14,Canada
71734,7/1/2023,CAN,Pulau Pinang,515,283,232,Canada
71735,7/1/2023,CAN,Sabah,83,41,42,Canada
71736,7/1/2023,CAN,Sarawak,243,124,119,Canada
71737,7/1/2023,CAN,Selangor,4568,2583,1985,Canada
71738,7/1/2023,CAN,Terengganu,0,0,0,Canada
71739,7/1/2023,CAN,W.P. Labuan,16,12,4,Canada
71740,7/1/2023,CCK,Selangor,0,0,0,Cocos (Keeling) Islands
71741,7/1/2023,CHE,Johor,717,397,320,Switzerland
71742,7/1/2023,CHE,Kedah,86,46,40,Switzerland
71743,7/1/2023,CHE,Kelantan,6,3,3,Switzerland
71744,7/1/2023,CHE,Melaka,0,0,0,Switzerland
71745,7/1/2023,CHE,Negeri Sembilan,0,0,0,Switzerland
71746,7/1/2023,CHE,Pahang,1,0,1,Switzerland
71747,7/1/2023,CHE,Perak,13,10,3,Switzerland
71748,7/1/2023,CHE,Perlis,45,26,19,Switzerland
71749,7/1/2023,CHE,Pulau Pinang,157,93,64,Switzerland
71750,7/1/2023,CHE,Sabah,44,21,23,Switzerland
71751,7/1/2023,CHE,Sarawak,52,27,25,Switzerland
71752,7/1/2023,CHE,Selangor,2693,1445,1248,Switzerland
71753,7/1/2023,CHE,W.P. Labuan,2,1,1,Switzerland
71754,7/1/2023,CHL,Johor,33,24,9,Chile
71755,7/1/2023,CHL,Kedah,14,9,5,Chile
71756,7/1/2023,CHL,Kelantan,1,1,0,Chile
71757,7/1/2023,CHL,Melaka,0,0,0,Chile
71758,7/1/2023,CHL,Pahang,0,0,0,Chile
71759,7/1/2023,CHL,Perak,1,1,0,Chile
71760,7/1/2023,CHL,Perlis,7,6,1,Chile
71761,7/1/2023,CHL,Pulau Pinang,8,5,3,Chile
71762,7/1/2023,CHL,Sabah,0,0,0,Chile
71763,7/1/2023,CHL,Sarawak,1,1,0,Chile
71764,7/1/2023,CHL,Selangor,203,97,106,Chile
71765,7/1/2023,CHN,Johor,51990,22144,29846,China
71766,7/1/2023,CHN,Kedah,1955,792,1163,China
71767,7/1/2023,CHN,Kelantan,5,2,3,China
71768,7/1/2023,CHN,Melaka,3,2,1,China
71769,7/1/2023,CHN,Pahang,41,18,23,China
71770,7/1/2023,CHN,Perak,275,122,153,China
71771,7/1/2023,CHN,Perlis,146,73,73,China
71772,7/1/2023,CHN,Pulau Pinang,10737,5492,5245,China
71773,7/1/2023,CHN,Sabah,11535,5247,6288,China
71774,7/1/2023,CHN,Sarawak,871,413,458,China
71775,7/1/2023,CHN,Selangor,134932,63626,71306,China
71776,7/1/2023,CHN,Terengganu,0,0,0,China
71777,7/1/2023,CHN,W.P. Labuan,56,48,8,China
71778,7/1/2023,CIV,Johor,0,0,0,C��te d'Iv
71779,7/1/2023,CIV,Kedah,0,0,0,C��te d'Iv
71780,7/1/2023,CIV,Pulau Pinang,0,0,0,C��te d'Iv
71781,7/1/2023,CIV,Sabah,0,0,0,C��te d'Iv
71782,7/1/2023,CIV,Sarawak,0,0,0,C��te d'Iv
71783,7/1/2023,CIV,Selangor,15,11,4,C��te d'Iv
71784,7/1/2023,CMR,Johor,3,3,0,Cameroon
71785,7/1/2023,CMR,Kedah,0,0,0,Cameroon
71786,7/1/2023,CMR,Pulau Pinang,1,0,1,Cameroon
71787,7/1/2023,CMR,Sabah,1,1,0,Cameroon
71788,7/1/2023,CMR,Sarawak,0,0,0,Cameroon
71789,7/1/2023,CMR,Selangor,21,12,9,Cameroon
71790,7/1/2023,COD,Johor,3,3,0,"Congo, the Democratic Republic of the"
71791,7/1/2023,COD,Pulau Pinang,0,0,0,"Congo, the Democratic Republic of the"
71792,7/1/2023,COD,Sarawak,0,0,0,"Congo, the Democratic Republic of the"
71793,7/1/2023,COD,Selangor,12,8,4,"Congo, the Democratic Republic of the"
71794,7/1/2023,COG,Johor,0,0,0,Congo
71795,7/1/2023,COG,Kedah,0,0,0,Congo
71796,7/1/2023,COG,Selangor,8,6,2,Congo
71797,7/1/2023,COK,Selangor,1,1,0,Cook Islands
71798,7/1/2023,COL,Johor,34,20,14,Colombia
71799,7/1/2023,COL,Kedah,2,2,0,Colombia
71800,7/1/2023,COL,Perak,0,0,0,Colombia
71801,7/1/2023,COL,Pulau Pinang,0,0,0,Colombia
71802,7/1/2023,COL,Sabah,1,0,1,Colombia
71803,7/1/2023,COL,Sarawak,0,0,0,Colombia
71804,7/1/2023,COL,Selangor,214,105,109,Colombia
71805,7/1/2023,COL,W.P. Labuan,0,0,0,Colombia
71806,7/1/2023,COM,Johor,3,0,3,Comoros
71807,7/1/2023,COM,Kedah,0,0,0,Comoros
71808,7/1/2023,COM,Selangor,36,17,19,Comoros
71809,7/1/2023,CPV,Johor,0,0,0,Cape Verde
71810,7/1/2023,CPV,Kedah,0,0,0,Cape Verde
71811,7/1/2023,CPV,Pulau Pinang,0,0,0,Cape Verde
71812,7/1/2023,CPV,Sabah,0,0,0,Cape Verde
71813,7/1/2023,CPV,Selangor,3,2,1,Cape Verde
71814,7/1/2023,CRI,Johor,32,15,17,Costa Rica
71815,7/1/2023,CRI,Kedah,1,1,0,Costa Rica
71816,7/1/2023,CRI,Perak,0,0,0,Costa Rica
71817,7/1/2023,CRI,Perlis,0,0,0,Costa Rica
71818,7/1/2023,CRI,Pulau Pinang,5,4,1,Costa Rica
71819,7/1/2023,CRI,Sabah,0,0,0,Costa Rica
71820,7/1/2023,CRI,Sarawak,0,0,0,Costa Rica
71821,7/1/2023,CRI,Selangor,56,34,22,Costa Rica
71822,7/1/2023,CUB,Johor,4,4,0,Cuba
71823,7/1/2023,CUB,Kedah,1,0,1,Cuba
71824,7/1/2023,CUB,Perlis,0,0,0,Cuba
71825,7/1/2023,CUB,Pulau Pinang,1,1,0,Cuba
71826,7/1/2023,CUB,Sabah,0,0,0,Cuba
71827,7/1/2023,CUB,Sarawak,0,0,0,Cuba
71828,7/1/2023,CUB,Selangor,33,21,12,Cuba
71829,7/1/2023,CYP,Johor,12,7,5,Cyprus
71830,7/1/2023,CYP,Kedah,0,0,0,Cyprus
71831,7/1/2023,CYP,Perak,0,0,0,Cyprus
71832,7/1/2023,CYP,Perlis,0,0,0,Cyprus
71833,7/1/2023,CYP,Pulau Pinang,2,2,0,Cyprus
71834,7/1/2023,CYP,Sabah,1,0,1,Cyprus
71835,7/1/2023,CYP,Sarawak,0,0,0,Cyprus
71836,7/1/2023,CYP,Selangor,124,73,51,Cyprus
71837,7/1/2023,CZE,Johor,150,81,69,Czech Republic
71838,7/1/2023,CZE,Kedah,67,30,37,Czech Republic
71839,7/1/2023,CZE,Kelantan,2,0,2,Czech Republic
71840,7/1/2023,CZE,Melaka,0,0,0,Czech Republic
71841,7/1/2023,CZE,Negeri Sembilan,0,0,0,Czech Republic
71842,7/1/2023,CZE,Perak,1,1,0,Czech Republic
71843,7/1/2023,CZE,Perlis,6,4,2,Czech Republic
71844,7/1/2023,CZE,Pulau Pinang,16,6,10,Czech Republic
71845,7/1/2023,CZE,Sabah,8,3,5,Czech Republic
71846,7/1/2023,CZE,Sarawak,19,5,14,Czech Republic
71847,7/1/2023,CZE,Selangor,654,372,282,Czech Republic
71848,7/1/2023,CZE,W.P. Labuan,4,2,2,Czech Republic
71849,7/1/2023,DEU,Johor,2379,1419,960,Germany
71850,7/1/2023,DEU,Kedah,357,195,162,Germany
71851,7/1/2023,DEU,Kelantan,15,10,5,Germany
71852,7/1/2023,DEU,Melaka,2,2,0,Germany
71853,7/1/2023,DEU,Negeri Sembilan,1,0,1,Germany
71854,7/1/2023,DEU,Pahang,4,3,1,Germany
71855,7/1/2023,DEU,Perak,42,31,11,Germany
71856,7/1/2023,DEU,Perlis,137,81,56,Germany
71857,7/1/2023,DEU,Pulau Pinang,763,515,248,Germany
71858,7/1/2023,DEU,Sabah,102,64,38,Germany
71859,7/1/2023,DEU,Sarawak,202,117,85,Germany
71860,7/1/2023,DEU,Selangor,7898,4700,3198,Germany
71861,7/1/2023,DEU,Terengganu,0,0,0,Germany
71862,7/1/2023,DEU,W.P. Labuan,9,8,1,Germany
71863,7/1/2023,DJI,Johor,0,0,0,Djibouti
71864,7/1/2023,DJI,Selangor,2,2,0,Djibouti
71865,7/1/2023,DMA,Johor,5,5,0,Dominica
71866,7/1/2023,DMA,Kedah,0,0,0,Dominica
71867,7/1/2023,DMA,Pulau Pinang,0,0,0,Dominica
71868,7/1/2023,DMA,Sabah,0,0,0,Dominica
71869,7/1/2023,DMA,Sarawak,0,0,0,Dominica
71870,7/1/2023,DMA,Selangor,61,42,19,Dominica
71871,7/1/2023,DMA,W.P. Labuan,0,0,0,Dominica
71872,7/1/2023,DNK,Johor,312,207,105,Denmark
71873,7/1/2023,DNK,Kedah,54,32,22,Denmark
71874,7/1/2023,DNK,Kelantan,0,0,0,Denmark
71875,7/1/2023,DNK,Melaka,0,0,0,Denmark
71876,7/1/2023,DNK,Negeri Sembilan,0,0,0,Denmark
71877,7/1/2023,DNK,Pahang,0,0,0,Denmark
71878,7/1/2023,DNK,Perak,4,2,2,Denmark
71879,7/1/2023,DNK,Perlis,14,11,3,Denmark
71880,7/1/2023,DNK,Pulau Pinang,64,36,28,Denmark
71881,7/1/2023,DNK,Sabah,26,12,14,Denmark
71882,7/1/2023,DNK,Sarawak,44,22,22,Denmark
71883,7/1/2023,DNK,Selangor,1844,1007,837,Denmark
71884,7/1/2023,DNK,W.P. Labuan,0,0,0,Denmark
71885,7/1/2023,DOM,Johor,1,0,1,Dominican Republic
71886,7/1/2023,DOM,Kedah,0,0,0,Dominican Republic
71887,7/1/2023,DOM,Perak,0,0,0,Dominican Republic
71888,7/1/2023,DOM,Perlis,0,0,0,Dominican Republic
71889,7/1/2023,DOM,Pulau Pinang,1,1,0,Dominican Republic
71890,7/1/2023,DOM,Sabah,0,0,0,Dominican Republic
71891,7/1/2023,DOM,Sarawak,0,0,0,Dominican Republic
71892,7/1/2023,DOM,Selangor,16,8,8,Dominican Republic
71893,7/1/2023,DZA,Johor,26,21,5,Algeria
71894,7/1/2023,DZA,Kedah,3,3,0,Algeria
71895,7/1/2023,DZA,Kelantan,0,0,0,Algeria
71896,7/1/2023,DZA,Melaka,0,0,0,Algeria
71897,7/1/2023,DZA,Perak,0,0,0,Algeria
71898,7/1/2023,DZA,Perlis,4,1,3,Algeria
71899,7/1/2023,DZA,Pulau Pinang,5,3,2,Algeria
71900,7/1/2023,DZA,Sabah,0,0,0,Algeria
71901,7/1/2023,DZA,Sarawak,0,0,0,Algeria
71902,7/1/2023,DZA,Selangor,1134,613,521,Algeria
71903,7/1/2023,DZA,W.P. Labuan,0,0,0,Algeria
71904,7/1/2023,ECU,Johor,11,10,1,Ecuador
71905,7/1/2023,ECU,Kedah,3,1,2,Ecuador
71906,7/1/2023,ECU,Perak,0,0,0,Ecuador
71907,7/1/2023,ECU,Perlis,0,0,0,Ecuador
71908,7/1/2023,ECU,Pulau Pinang,1,0,1,Ecuador
71909,7/1/2023,ECU,Sabah,1,1,0,Ecuador
71910,7/1/2023,ECU,Sarawak,0,0,0,Ecuador
71911,7/1/2023,ECU,Selangor,72,35,37,Ecuador
71912,7/1/2023,EGY,Johor,247,190,57,Egypt
71913,7/1/2023,EGY,Kedah,5,4,1,Egypt
71914,7/1/2023,EGY,Kelantan,1,1,0,Egypt
71915,7/1/2023,EGY,Melaka,2,2,0,Egypt
71916,7/1/2023,EGY,Pahang,0,0,0,Egypt
71917,7/1/2023,EGY,Perak,0,0,0,Egypt
71918,7/1/2023,EGY,Perlis,0,0,0,Egypt
71919,7/1/2023,EGY,Pulau Pinang,7,7,0,Egypt
71920,7/1/2023,EGY,Sabah,2,2,0,Egypt
71921,7/1/2023,EGY,Sarawak,92,64,28,Egypt
71922,7/1/2023,EGY,Selangor,1964,1188,776,Egypt
71923,7/1/2023,EGY,Terengganu,0,0,0,Egypt
71924,7/1/2023,EGY,W.P. Labuan,0,0,0,Egypt
71925,7/1/2023,ERI,Johor,1,0,1,Eritrea
71926,7/1/2023,ERI,Pulau Pinang,0,0,0,Eritrea
71927,7/1/2023,ERI,Sabah,0,0,0,Eritrea
71928,7/1/2023,ERI,Selangor,12,11,1,Eritrea
71929,7/1/2023,ESP,Johor,627,360,267,Spain
71930,7/1/2023,ESP,Kedah,116,58,58,Spain
71931,7/1/2023,ESP,Kelantan,14,6,8,Spain
71932,7/1/2023,ESP,Melaka,0,0,0,Spain
71933,7/1/2023,ESP,Negeri Sembilan,0,0,0,Spain
71934,7/1/2023,ESP,Pahang,0,0,0,Spain
71935,7/1/2023,ESP,Perak,17,7,10,Spain
71936,7/1/2023,ESP,Perlis,18,11,7,Spain
71937,7/1/2023,ESP,Pulau Pinang,200,103,97,Spain
71938,7/1/2023,ESP,Sabah,47,32,15,Spain
71939,7/1/2023,ESP,Sarawak,92,54,38,Spain
71940,7/1/2023,ESP,Selangor,5115,2558,2557,Spain
71941,7/1/2023,ESP,W.P. Labuan,6,4,2,Spain
71942,7/1/2023,EST,Johor,19,8,11,Estonia
71943,7/1/2023,EST,Kedah,9,5,4,Estonia
71944,7/1/2023,EST,Kelantan,0,0,0,Estonia
71945,7/1/2023,EST,Pahang,0,0,0,Estonia
71946,7/1/2023,EST,Perak,0,0,0,Estonia
71947,7/1/2023,EST,Perlis,0,0,0,Estonia
71948,7/1/2023,EST,Pulau Pinang,7,4,3,Estonia
71949,7/1/2023,EST,Sabah,1,0,1,Estonia
71950,7/1/2023,EST,Sarawak,0,0,0,Estonia
71951,7/1/2023,EST,Selangor,90,48,42,Estonia
71952,7/1/2023,EST,W.P. Labuan,0,0,0,Estonia
71953,7/1/2023,ETH,Johor,0,0,0,Ethiopia
71954,7/1/2023,ETH,Kedah,0,0,0,Ethiopia
71955,7/1/2023,ETH,Pulau Pinang,0,0,0,Ethiopia
71956,7/1/2023,ETH,Sarawak,1,1,0,Ethiopia
71957,7/1/2023,ETH,Selangor,53,24,29,Ethiopia
71958,7/1/2023,FIN,Johor,112,66,46,Finland
71959,7/1/2023,FIN,Kedah,20,10,10,Finland
71960,7/1/2023,FIN,Kelantan,2,1,1,Finland
71961,7/1/2023,FIN,Melaka,0,0,0,Finland
71962,7/1/2023,FIN,Negeri Sembilan,0,0,0,Finland
71963,7/1/2023,FIN,Pahang,0,0,0,Finland
71964,7/1/2023,FIN,Perak,0,0,0,Finland
71965,7/1/2023,FIN,Perlis,21,13,8,Finland
71966,7/1/2023,FIN,Pulau Pinang,33,19,14,Finland
71967,7/1/2023,FIN,Sabah,9,3,6,Finland
71968,7/1/2023,FIN,Sarawak,4,1,3,Finland
71969,7/1/2023,FIN,Selangor,399,226,173,Finland
71970,7/1/2023,FIN,W.P. Labuan,2,1,1,Finland
71971,7/1/2023,FJI,Johor,64,33,31,Fiji
71972,7/1/2023,FJI,Kedah,1,1,0,Fiji
71973,7/1/2023,FJI,Kelantan,0,0,0,Fiji
71974,7/1/2023,FJI,Perak,0,0,0,Fiji
71975,7/1/2023,FJI,Perlis,0,0,0,Fiji
71976,7/1/2023,FJI,Pulau Pinang,4,0,4,Fiji
71977,7/1/2023,FJI,Sabah,1,1,0,Fiji
71978,7/1/2023,FJI,Sarawak,4,4,0,Fiji
71979,7/1/2023,FJI,Selangor,141,78,63,Fiji
71980,7/1/2023,FRA,Johor,3199,1804,1395,France
71981,7/1/2023,FRA,Kedah,382,217,165,France
71982,7/1/2023,FRA,Kelantan,32,17,15,France
71983,7/1/2023,FRA,Melaka,7,6,1,France
71984,7/1/2023,FRA,Negeri Sembilan,1,1,0,France
71985,7/1/2023,FRA,Pahang,10,6,4,France
71986,7/1/2023,FRA,Perak,46,32,14,France
71987,7/1/2023,FRA,Perlis,79,45,34,France
71988,7/1/2023,FRA,Pulau Pinang,482,284,198,France
71989,7/1/2023,FRA,Sabah,107,72,35,France
71990,7/1/2023,FRA,Sarawak,170,105,65,France
71991,7/1/2023,FRA,Selangor,14425,7767,6658,France
71992,7/1/2023,FRA,Terengganu,0,0,0,France
71993,7/1/2023,FRA,W.P. Labuan,5,3,2,France
71994,7/1/2023,FSM,Johor,0,0,0,"Micronesia, Federated States of"
71995,7/1/2023,FSM,Pulau Pinang,0,0,0,"Micronesia, Federated States of"
71996,7/1/2023,FSM,Selangor,0,0,0,"Micronesia, Federated States of"
71997,7/1/2023,GAB,Johor,2,2,0,Gabon
71998,7/1/2023,GAB,Pulau Pinang,0,0,0,Gabon
71999,7/1/2023,GAB,Sarawak,1,0,1,Gabon
72000,7/1/2023,GAB,Selangor,5,4,1,Gabon
72001,7/1/2023,GBR,Johor,5000,3130,1870,United Kingdom
72002,7/1/2023,GBR,Kedah,948,540,408,United Kingdom
72003,7/1/2023,GBR,Kelantan,15,14,1,United Kingdom
72004,7/1/2023,GBR,Melaka,4,2,2,United Kingdom
72005,7/1/2023,GBR,Negeri Sembilan,1,1,0,United Kingdom
72006,7/1/2023,GBR,Pahang,10,8,2,United Kingdom
72007,7/1/2023,GBR,Perak,137,72,65,United Kingdom
72008,7/1/2023,GBR,Perlis,193,116,77,United Kingdom
72009,7/1/2023,GBR,Pulau Pinang,1796,998,798,United Kingdom
72010,7/1/2023,GBR,Sabah,464,248,216,United Kingdom
72011,7/1/2023,GBR,Sarawak,1048,621,427,United Kingdom
72012,7/1/2023,GBR,Selangor,23629,13369,10260,United Kingdom
72013,7/1/2023,GBR,Terengganu,0,0,0,United Kingdom
72014,7/1/2023,GBR,W.P. Labuan,25,17,8,United Kingdom
72015,7/1/2023,GEO,Johor,11,11,0,Georgia
72016,7/1/2023,GEO,Kedah,0,0,0,Georgia
72017,7/1/2023,GEO,Melaka,0,0,0,Georgia
72018,7/1/2023,GEO,Perak,0,0,0,Georgia
72019,7/1/2023,GEO,Perlis,1,0,1,Georgia
72020,7/1/2023,GEO,Pulau Pinang,1,0,1,Georgia
72021,7/1/2023,GEO,Sabah,0,0,0,Georgia
72022,7/1/2023,GEO,Sarawak,0,0,0,Georgia
72023,7/1/2023,GEO,Selangor,43,28,15,Georgia
72024,7/1/2023,GHA,Johor,10,9,1,Ghana
72025,7/1/2023,GHA,Kedah,1,1,0,Ghana
72026,7/1/2023,GHA,Kelantan,0,0,0,Ghana
72027,7/1/2023,GHA,Pulau Pinang,0,0,0,Ghana
72028,7/1/2023,GHA,Sabah,0,0,0,Ghana
72029,7/1/2023,GHA,Sarawak,0,0,0,Ghana
72030,7/1/2023,GHA,Selangor,58,44,14,Ghana
72031,7/1/2023,GIB,Johor,0,0,0,Gibraltar
72032,7/1/2023,GIB,Sarawak,0,0,0,Gibraltar
72033,7/1/2023,GIN,Johor,7,7,0,Guinea
72034,7/1/2023,GIN,Kedah,1,1,0,Guinea
72035,7/1/2023,GIN,Kelantan,0,0,0,Guinea
72036,7/1/2023,GIN,Perlis,0,0,0,Guinea
72037,7/1/2023,GIN,Pulau Pinang,0,0,0,Guinea
72038,7/1/2023,GIN,Sabah,0,0,0,Guinea
72039,7/1/2023,GIN,Sarawak,0,0,0,Guinea
72040,7/1/2023,GIN,Selangor,53,36,17,Guinea
72041,7/1/2023,GLP,Selangor,0,0,0,Guadeloupe
72042,7/1/2023,GMB,Johor,10,9,1,Gambia
72043,7/1/2023,GMB,Kedah,0,0,0,Gambia
72044,7/1/2023,GMB,Kelantan,0,0,0,Gambia
72045,7/1/2023,GMB,Pulau Pinang,0,0,0,Gambia
72046,7/1/2023,GMB,Sabah,0,0,0,Gambia
72047,7/1/2023,GMB,Sarawak,0,0,0,Gambia
72048,7/1/2023,GMB,Selangor,28,26,2,Gambia
72049,7/1/2023,GNB,Johor,0,0,0,Guinea-Bissau
72050,7/1/2023,GNB,Selangor,0,0,0,Guinea-Bissau
72051,7/1/2023,GNQ,Johor,0,0,0,Equatorial Guinea
72052,7/1/2023,GNQ,Selangor,3,0,3,Equatorial Guinea
72053,7/1/2023,GRC,Johor,42,31,11,Greece
72054,7/1/2023,GRC,Kedah,3,2,1,Greece
72055,7/1/2023,GRC,Kelantan,0,0,0,Greece
72056,7/1/2023,GRC,Melaka,0,0,0,Greece
72057,7/1/2023,GRC,Negeri Sembilan,0,0,0,Greece
72058,7/1/2023,GRC,Pahang,0,0,0,Greece
72059,7/1/2023,GRC,Perak,1,1,0,Greece
72060,7/1/2023,GRC,Perlis,3,1,2,Greece
72061,7/1/2023,GRC,Pulau Pinang,8,3,5,Greece
72062,7/1/2023,GRC,Sabah,1,1,0,Greece
72063,7/1/2023,GRC,Sarawak,6,4,2,Greece
72064,7/1/2023,GRC,Selangor,190,135,55,Greece
72065,7/1/2023,GRD,Johor,12,5,7,Grenada
72066,7/1/2023,GRD,Kedah,1,1,0,Grenada
72067,7/1/2023,GRD,Pulau Pinang,1,0,1,Grenada
72068,7/1/2023,GRD,Sabah,0,0,0,Grenada
72069,7/1/2023,GRD,Sarawak,0,0,0,Grenada
72070,7/1/2023,GRD,Selangor,12,9,3,Grenada
72071,7/1/2023,GRL,Johor,1,1,0,Greenland
72072,7/1/2023,GRL,Selangor,0,0,0,Greenland
72073,7/1/2023,GTM,Johor,5,5,0,Guatemala
72074,7/1/2023,GTM,Kedah,0,0,0,Guatemala
72075,7/1/2023,GTM,Pahang,0,0,0,Guatemala
72076,7/1/2023,GTM,Perak,0,0,0,Guatemala
72077,7/1/2023,GTM,Pulau Pinang,0,0,0,Guatemala
72078,7/1/2023,GTM,Sabah,0,0,0,Guatemala
72079,7/1/2023,GTM,Sarawak,0,0,0,Guatemala
72080,7/1/2023,GTM,Selangor,19,15,4,Guatemala
72081,7/1/2023,GTM,W.P. Labuan,0,0,0,Guatemala
72082,7/1/2023,GUY,Johor,0,0,0,Guyana
72083,7/1/2023,GUY,Kedah,0,0,0,Guyana
72084,7/1/2023,GUY,Pulau Pinang,0,0,0,Guyana
72085,7/1/2023,GUY,Sarawak,1,0,1,Guyana
72086,7/1/2023,GUY,Selangor,4,1,3,Guyana
72087,7/1/2023,HKG,Johor,4,4,0,Hong Kong
72088,7/1/2023,HKG,Kedah,0,0,0,Hong Kong
72089,7/1/2023,HKG,Kelantan,1,1,0,Hong Kong
72090,7/1/2023,HKG,Pahang,3,2,1,Hong Kong
72091,7/1/2023,HKG,Perak,91,49,42,Hong Kong
72092,7/1/2023,HKG,Perlis,1,0,1,Hong Kong
72093,7/1/2023,HKG,Pulau Pinang,0,0,0,Hong Kong
72094,7/1/2023,HKG,Sabah,0,0,0,Hong Kong
72095,7/1/2023,HKG,Sarawak,0,0,0,Hong Kong
72096,7/1/2023,HKG,Selangor,7,6,1,Hong Kong
72097,7/1/2023,HKG,Terengganu,0,0,0,Hong Kong
72098,7/1/2023,HMD,Johor,0,0,0,Heard Island and McDonald Islands
72099,7/1/2023,HND,Johor,9,7,2,Honduras
72100,7/1/2023,HND,Kedah,0,0,0,Honduras
72101,7/1/2023,HND,Perak,0,0,0,Honduras
72102,7/1/2023,HND,Pulau Pinang,0,0,0,Honduras
72103,7/1/2023,HND,Sabah,0,0,0,Honduras
72104,7/1/2023,HND,Sarawak,0,0,0,Honduras
72105,7/1/2023,HND,Selangor,15,14,1,Honduras
72106,7/1/2023,HRV,Johor,25,16,9,Croatia
72107,7/1/2023,HRV,Kedah,1,1,0,Croatia
72108,7/1/2023,HRV,Kelantan,0,0,0,Croatia
72109,7/1/2023,HRV,Melaka,0,0,0,Croatia
72110,7/1/2023,HRV,Pahang,0,0,0,Croatia
72111,7/1/2023,HRV,Perak,0,0,0,Croatia
72112,7/1/2023,HRV,Perlis,0,0,0,Croatia
72113,7/1/2023,HRV,Pulau Pinang,1,0,1,Croatia
72114,7/1/2023,HRV,Sabah,1,1,0,Croatia
72115,7/1/2023,HRV,Sarawak,2,2,0,Croatia
72116,7/1/2023,HRV,Selangor,150,105,45,Croatia
72117,7/1/2023,HTI,Johor,0,0,0,Haiti
72118,7/1/2023,HTI,Kedah,0,0,0,Haiti
72119,7/1/2023,HTI,Kelantan,0,0,0,Haiti
72120,7/1/2023,HTI,Perak,0,0,0,Haiti
72121,7/1/2023,HTI,Pulau Pinang,0,0,0,Haiti
72122,7/1/2023,HTI,Sabah,0,0,0,Haiti
72123,7/1/2023,HTI,Selangor,9,4,5,Haiti
72124,7/1/2023,HUN,Johor,104,59,45,Hungary
72125,7/1/2023,HUN,Kedah,14,6,8,Hungary
72126,7/1/2023,HUN,Kelantan,0,0,0,Hungary
72127,7/1/2023,HUN,Pahang,0,0,0,Hungary
72128,7/1/2023,HUN,Perak,0,0,0,Hungary
72129,7/1/2023,HUN,Perlis,7,4,3,Hungary
72130,7/1/2023,HUN,Pulau Pinang,10,6,4,Hungary
72131,7/1/2023,HUN,Sabah,3,2,1,Hungary
72132,7/1/2023,HUN,Sarawak,18,5,13,Hungary
72133,7/1/2023,HUN,Selangor,465,253,212,Hungary
72134,7/1/2023,HUN,W.P. Labuan,0,0,0,Hungary
72135,7/1/2023,IDN,Johor,110963,52035,58928,Indonesia
72136,7/1/2023,IDN,Kedah,7844,2720,5124,Indonesia
72137,7/1/2023,IDN,Kelantan,206,100,106,Indonesia
72138,7/1/2023,IDN,Melaka,5206,2314,2892,Indonesia
72139,7/1/2023,IDN,Negeri Sembilan,6484,4492,1992,Indonesia
72140,7/1/2023,IDN,Pahang,18,13,5,Indonesia
72141,7/1/2023,IDN,Perak,323,170,153,Indonesia
72142,7/1/2023,IDN,Perlis,681,266,415,Indonesia
72143,7/1/2023,IDN,Pulau Pinang,40973,16180,24793,Indonesia
72144,7/1/2023,IDN,Sabah,4863,2329,2534,Indonesia
72145,7/1/2023,IDN,Sarawak,36328,18358,17970,Indonesia
72146,7/1/2023,IDN,Selangor,130764,61675,69089,Indonesia
72147,7/1/2023,IDN,Terengganu,1,1,0,Indonesia
72148,7/1/2023,IDN,W.P. Labuan,106,42,64,Indonesia
72149,7/1/2023,IND,Johor,22725,15889,6836,India
72150,7/1/2023,IND,Kedah,1141,637,504,India
72151,7/1/2023,IND,Kelantan,6,6,0,India
72152,7/1/2023,IND,Melaka,3,2,1,India
72153,7/1/2023,IND,Negeri Sembilan,0,0,0,India
72154,7/1/2023,IND,Pahang,9,8,1,India
72155,7/1/2023,IND,Perak,269,181,88,India
72156,7/1/2023,IND,Perlis,35,30,5,India
72157,7/1/2023,IND,Pulau Pinang,1108,776,332,India
72158,7/1/2023,IND,Sabah,151,108,43,India
72159,7/1/2023,IND,Sarawak,1048,846,202,India
72160,7/1/2023,IND,Selangor,52105,37815,14290,India
72161,7/1/2023,IND,Terengganu,0,0,0,India
72162,7/1/2023,IND,W.P. Labuan,81,62,19,India
72163,7/1/2023,IOT,Pulau Pinang,0,0,0,British Indian Ocean Territory
72164,7/1/2023,IOT,Selangor,0,0,0,British Indian Ocean Territory
72165,7/1/2023,IRL,Johor,315,180,135,Ireland
72166,7/1/2023,IRL,Kedah,80,50,30,Ireland
72167,7/1/2023,IRL,Kelantan,0,0,0,Ireland
72168,7/1/2023,IRL,Negeri Sembilan,1,0,1,Ireland
72169,7/1/2023,IRL,Pahang,0,0,0,Ireland
72170,7/1/2023,IRL,Perak,19,13,6,Ireland
72171,7/1/2023,IRL,Perlis,17,11,6,Ireland
72172,7/1/2023,IRL,Pulau Pinang,137,79,58,Ireland
72173,7/1/2023,IRL,Sabah,16,8,8,Ireland
72174,7/1/2023,IRL,Sarawak,26,11,15,Ireland
72175,7/1/2023,IRL,Selangor,1791,975,816,Ireland
72176,7/1/2023,IRL,Terengganu,0,0,0,Ireland
72177,7/1/2023,IRL,W.P. Labuan,1,1,0,Ireland
72178,7/1/2023,IRN,Johor,177,100,77,Iran
72179,7/1/2023,IRN,Kedah,12,7,5,Iran
72180,7/1/2023,IRN,Kelantan,0,0,0,Iran
72181,7/1/2023,IRN,Perak,0,0,0,Iran
72182,7/1/2023,IRN,Perlis,9,6,3,Iran
72183,7/1/2023,IRN,Pulau Pinang,8,4,4,Iran
72184,7/1/2023,IRN,Sabah,2,1,1,Iran
72185,7/1/2023,IRN,Sarawak,3,2,1,Iran
72186,7/1/2023,IRN,Selangor,1488,823,665,Iran
72187,7/1/2023,IRN,W.P. Labuan,0,0,0,Iran
72188,7/1/2023,IRQ,Johor,47,30,17,Iraq
72189,7/1/2023,IRQ,Kedah,2,2,0,Iraq
72190,7/1/2023,IRQ,Kelantan,1,1,0,Iraq
72191,7/1/2023,IRQ,Melaka,0,0,0,Iraq
72192,7/1/2023,IRQ,Pahang,0,0,0,Iraq
72193,7/1/2023,IRQ,Perak,0,0,0,Iraq
72194,7/1/2023,IRQ,Perlis,0,0,0,Iraq
72195,7/1/2023,IRQ,Pulau Pinang,3,2,1,Iraq
72196,7/1/2023,IRQ,Sabah,0,0,0,Iraq
72197,7/1/2023,IRQ,Sarawak,0,0,0,Iraq
72198,7/1/2023,IRQ,Selangor,1191,711,480,Iraq
72199,7/1/2023,ISL,Johor,12,4,8,Iceland
72200,7/1/2023,ISL,Kedah,2,1,1,Iceland
72201,7/1/2023,ISL,Kelantan,0,0,0,Iceland
72202,7/1/2023,ISL,Perak,4,2,2,Iceland
72203,7/1/2023,ISL,Perlis,0,0,0,Iceland
72204,7/1/2023,ISL,Pulau Pinang,0,0,0,Iceland
72205,7/1/2023,ISL,Sabah,0,0,0,Iceland
72206,7/1/2023,ISL,Sarawak,0,0,0,Iceland
72207,7/1/2023,ISL,Selangor,41,24,17,Iceland
72208,7/1/2023,ISL,W.P. Labuan,0,0,0,Iceland
72209,7/1/2023,ISR,Pulau Pinang,0,0,0,Israel
72210,7/1/2023,ITA,Johor,763,468,295,Italy
72211,7/1/2023,ITA,Kedah,57,38,19,Italy
72212,7/1/2023,ITA,Kelantan,3,2,1,Italy
72213,7/1/2023,ITA,Melaka,1,1,0,Italy
72214,7/1/2023,ITA,Negeri Sembilan,0,0,0,Italy
72215,7/1/2023,ITA,Pahang,1,1,0,Italy
72216,7/1/2023,ITA,Perak,8,3,5,Italy
72217,7/1/2023,ITA,Perlis,25,14,11,Italy
72218,7/1/2023,ITA,Pulau Pinang,165,120,45,Italy
72219,7/1/2023,ITA,Sabah,41,24,17,Italy
72220,7/1/2023,ITA,Sarawak,111,62,49,Italy
72221,7/1/2023,ITA,Selangor,4711,2671,2040,Italy
72222,7/1/2023,ITA,W.P. Labuan,1,1,0,Italy
72223,7/1/2023,JAM,Johor,4,1,3,Jamaica
72224,7/1/2023,JAM,Kedah,0,0,0,Jamaica
72225,7/1/2023,JAM,Perak,0,0,0,Jamaica
72226,7/1/2023,JAM,Pulau Pinang,2,1,1,Jamaica
72227,7/1/2023,JAM,Sabah,0,0,0,Jamaica
72228,7/1/2023,JAM,Sarawak,0,0,0,Jamaica
72229,7/1/2023,JAM,Selangor,27,9,18,Jamaica
72230,7/1/2023,JAM,W.P. Labuan,0,0,0,Jamaica
72231,7/1/2023,JOR,Johor,40,26,14,Jordan
72232,7/1/2023,JOR,Kedah,6,3,3,Jordan
72233,7/1/2023,JOR,Kelantan,0,0,0,Jordan
72234,7/1/2023,JOR,Melaka,0,0,0,Jordan
72235,7/1/2023,JOR,Perlis,0,0,0,Jordan
72236,7/1/2023,JOR,Pulau Pinang,18,11,7,Jordan
72237,7/1/2023,JOR,Sabah,1,1,0,Jordan
72238,7/1/2023,JOR,Sarawak,0,0,0,Jordan
72239,7/1/2023,JOR,Selangor,1371,749,622,Jordan
72240,7/1/2023,JOR,W.P. Labuan,0,0,0,Jordan
72241,7/1/2023,JPN,Johor,6456,4146,2310,Japan
72242,7/1/2023,JPN,Kedah,209,100,109,Japan
72243,7/1/2023,JPN,Kelantan,16,10,6,Japan
72244,7/1/2023,JPN,Melaka,1,1,0,Japan
72245,7/1/2023,JPN,Negeri Sembilan,0,0,0,Japan
72246,7/1/2023,JPN,Pahang,1,0,1,Japan
72247,7/1/2023,JPN,Perak,79,57,22,Japan
72248,7/1/2023,JPN,Perlis,70,54,16,Japan
72249,7/1/2023,JPN,Pulau Pinang,1541,1051,490,Japan
72250,7/1/2023,JPN,Sabah,121,76,45,Japan
72251,7/1/2023,JPN,Sarawak,191,137,54,Japan
72252,7/1/2023,JPN,Selangor,21617,12766,8851,Japan
72253,7/1/2023,JPN,W.P. Labuan,10,6,4,Japan
72254,7/1/2023,KAZ,Johor,87,45,42,Kazakhstan
72255,7/1/2023,KAZ,Kedah,18,5,13,Kazakhstan
72256,7/1/2023,KAZ,Kelantan,1,1,0,Kazakhstan
72257,7/1/2023,KAZ,Melaka,0,0,0,Kazakhstan
72258,7/1/2023,KAZ,Perak,1,1,0,Kazakhstan
72259,7/1/2023,KAZ,Perlis,3,0,3,Kazakhstan
72260,7/1/2023,KAZ,Pulau Pinang,7,5,2,Kazakhstan
72261,7/1/2023,KAZ,Sabah,5,2,3,Kazakhstan
72262,7/1/2023,KAZ,Sarawak,7,0,7,Kazakhstan
72263,7/1/2023,KAZ,Selangor,966,417,549,Kazakhstan
72264,7/1/2023,KAZ,W.P. Labuan,0,0,0,Kazakhstan
72265,7/1/2023,KEN,Johor,79,41,38,Kenya
72266,7/1/2023,KEN,Kedah,8,3,5,Kenya
72267,7/1/2023,KEN,Kelantan,0,0,0,Kenya
72268,7/1/2023,KEN,Perak,0,0,0,Kenya
72269,7/1/2023,KEN,Perlis,1,0,1,Kenya
72270,7/1/2023,KEN,Pulau Pinang,2,1,1,Kenya
72271,7/1/2023,KEN,Sabah,0,0,0,Kenya
72272,7/1/2023,KEN,Sarawak,0,0,0,Kenya
72273,7/1/2023,KEN,Selangor,395,203,192,Kenya
72274,7/1/2023,KGZ,Johor,30,18,12,Kyrgyzstan
72275,7/1/2023,KGZ,Kedah,3,2,1,Kyrgyzstan
72276,7/1/2023,KGZ,Kelantan,0,0,0,Kyrgyzstan
72277,7/1/2023,KGZ,Perak,0,0,0,Kyrgyzstan
72278,7/1/2023,KGZ,Perlis,1,0,1,Kyrgyzstan
72279,7/1/2023,KGZ,Pulau Pinang,11,6,5,Kyrgyzstan
72280,7/1/2023,KGZ,Sabah,0,0,0,Kyrgyzstan
72281,7/1/2023,KGZ,Sarawak,0,0,0,Kyrgyzstan
72282,7/1/2023,KGZ,Selangor,222,98,124,Kyrgyzstan
72283,7/1/2023,KHM,Johor,2372,1067,1305,Cambodia
72284,7/1/2023,KHM,Kedah,106,63,43,Cambodia
72285,7/1/2023,KHM,Kelantan,565,314,251,Cambodia
72286,7/1/2023,KHM,Melaka,0,0,0,Cambodia
72287,7/1/2023,KHM,Negeri Sembilan,0,0,0,Cambodia
72288,7/1/2023,KHM,Pahang,0,0,0,Cambodia
72289,7/1/2023,KHM,Perak,11,2,9,Cambodia
72290,7/1/2023,KHM,Perlis,858,529,329,Cambodia
72291,7/1/2023,KHM,Pulau Pinang,51,23,28,Cambodia
72292,7/1/2023,KHM,Sabah,0,0,0,Cambodia
72293,7/1/2023,KHM,Sarawak,11,4,7,Cambodia
72294,7/1/2023,KHM,Selangor,4326,2043,2283,Cambodia
72295,7/1/2023,KHM,W.P. Labuan,0,0,0,Cambodia
72296,7/1/2023,KIR,Johor,0,0,0,Kiribati
72297,7/1/2023,KIR,Sabah,0,0,0,Kiribati
72298,7/1/2023,KIR,Selangor,2,1,1,Kiribati
72299,7/1/2023,KNA,Johor,24,14,10,Saint Kitts and Nevis
72300,7/1/2023,KNA,Kedah,0,0,0,Saint Kitts and Nevis
72301,7/1/2023,KNA,Perlis,0,0,0,Saint Kitts and Nevis
72302,7/1/2023,KNA,Pulau Pinang,0,0,0,Saint Kitts and Nevis
72303,7/1/2023,KNA,Sabah,2,0,2,Saint Kitts and Nevis
72304,7/1/2023,KNA,Selangor,98,68,30,Saint Kitts and Nevis
72305,7/1/2023,KNA,W.P. Labuan,0,0,0,Saint Kitts and Nevis
72306,7/1/2023,KOR,Johor,15171,7790,7381,"Korea, Republic of (South Korea)"
72307,7/1/2023,KOR,Kedah,183,101,82,"Korea, Republic of (South Korea)"
72308,7/1/2023,KOR,Kelantan,1,0,1,"Korea, Republic of (South Korea)"
72309,7/1/2023,KOR,Melaka,3,2,1,"Korea, Republic of (South Korea)"
72310,7/1/2023,KOR,Negeri Sembilan,0,0,0,"Korea, Republic of (South Korea)"
72311,7/1/2023,KOR,Pahang,2,0,2,"Korea, Republic of (South Korea)"
72312,7/1/2023,KOR,Perak,16,10,6,"Korea, Republic of (South Korea)"
72313,7/1/2023,KOR,Perlis,60,41,19,"Korea, Republic of (South Korea)"
72314,7/1/2023,KOR,Pulau Pinang,741,393,348,"Korea, Republic of (South Korea)"
72315,7/1/2023,KOR,Sabah,7839,3327,4512,"Korea, Republic of (South Korea)"
72316,7/1/2023,KOR,Sarawak,229,125,104,"Korea, Republic of (South Korea)"
72317,7/1/2023,KOR,Selangor,21820,10908,10912,"Korea, Republic of (South Korea)"
72318,7/1/2023,KOR,Terengganu,0,0,0,"Korea, Republic of (South Korea)"
72319,7/1/2023,KOR,W.P. Labuan,3,2,1,"Korea, Republic of (South Korea)"
72320,7/1/2023,KWT,Johor,104,64,40,Kuwait
72321,7/1/2023,KWT,Kedah,30,9,21,Kuwait
72322,7/1/2023,KWT,Kelantan,0,0,0,Kuwait
72323,7/1/2023,KWT,Perak,1,0,1,Kuwait
72324,7/1/2023,KWT,Perlis,2,1,1,Kuwait
72325,7/1/2023,KWT,Pulau Pinang,10,3,7,Kuwait
72326,7/1/2023,KWT,Sabah,2,1,1,Kuwait
72327,7/1/2023,KWT,Sarawak,0,0,0,Kuwait
72328,7/1/2023,KWT,Selangor,2585,1351,1234,Kuwait
72329,7/1/2023,KWT,W.P. Labuan,1,1,0,Kuwait
72330,7/1/2023,LAO,Johor,206,66,140,Lao People's Democratic Republic
72331,7/1/2023,LAO,Kedah,292,24,268,Lao People's Democratic Republic
72332,7/1/2023,LAO,Kelantan,144,59,85,Lao People's Democratic Republic
72333,7/1/2023,LAO,Melaka,0,0,0,Lao People's Democratic Republic
72334,7/1/2023,LAO,Perak,35,2,33,Lao People's Democratic Republic
72335,7/1/2023,LAO,Perlis,535,115,420,Lao People's Democratic Republic
72336,7/1/2023,LAO,Pulau Pinang,22,5,17,Lao People's Democratic Republic
72337,7/1/2023,LAO,Sabah,2,0,2,Lao People's Democratic Republic
72338,7/1/2023,LAO,Sarawak,8,5,3,Lao People's Democratic Republic
72339,7/1/2023,LAO,Selangor,309,106,203,Lao People's Democratic Republic
72340,7/1/2023,LAO,W.P. Labuan,0,0,0,Lao People's Democratic Republic
72341,7/1/2023,LBN,Johor,12,6,6,Lebanon
72342,7/1/2023,LBN,Kedah,1,0,1,Lebanon
72343,7/1/2023,LBN,Kelantan,0,0,0,Lebanon
72344,7/1/2023,LBN,Pahang,0,0,0,Lebanon
72345,7/1/2023,LBN,Perak,0,0,0,Lebanon
72346,7/1/2023,LBN,Perlis,0,0,0,Lebanon
72347,7/1/2023,LBN,Pulau Pinang,3,2,1,Lebanon
72348,7/1/2023,LBN,Sabah,0,0,0,Lebanon
72349,7/1/2023,LBN,Sarawak,1,1,0,Lebanon
72350,7/1/2023,LBN,Selangor,299,177,122,Lebanon
72351,7/1/2023,LBN,W.P. Labuan,0,0,0,Lebanon
72352,7/1/2023,LBR,Johor,0,0,0,Liberia
72353,7/1/2023,LBR,Kedah,0,0,0,Liberia
72354,7/1/2023,LBR,Sabah,0,0,0,Liberia
72355,7/1/2023,LBR,Sarawak,0,0,0,Liberia
72356,7/1/2023,LBR,Selangor,4,2,2,Liberia
72357,7/1/2023,LBY,Johor,1,1,0,Libyan Arab Jamahiriya
72358,7/1/2023,LBY,Kedah,0,0,0,Libyan Arab Jamahiriya
72359,7/1/2023,LBY,Perlis,0,0,0,Libyan Arab Jamahiriya
72360,7/1/2023,LBY,Pulau Pinang,0,0,0,Libyan Arab Jamahiriya
72361,7/1/2023,LBY,Sabah,1,1,0,Libyan Arab Jamahiriya
72362,7/1/2023,LBY,Sarawak,3,2,1,Libyan Arab Jamahiriya
72363,7/1/2023,LBY,Selangor,333,242,91,Libyan Arab Jamahiriya
72364,7/1/2023,LCA,Johor,6,4,2,Saint Lucia
72365,7/1/2023,LCA,Kedah,0,0,0,Saint Lucia
72366,7/1/2023,LCA,Pulau Pinang,0,0,0,Saint Lucia
72367,7/1/2023,LCA,Sarawak,1,1,0,Saint Lucia
72368,7/1/2023,LCA,Selangor,11,8,3,Saint Lucia
72369,7/1/2023,LIE,Johor,1,1,0,Liechtenstein
72370,7/1/2023,LIE,Kedah,0,0,0,Liechtenstein
72371,7/1/2023,LIE,Perlis,1,1,0,Liechtenstein
72372,7/1/2023,LIE,Pulau Pinang,0,0,0,Liechtenstein
72373,7/1/2023,LIE,Sabah,0,0,0,Liechtenstein
72374,7/1/2023,LIE,Sarawak,1,1,0,Liechtenstein
72375,7/1/2023,LIE,Selangor,17,8,9,Liechtenstein
72376,7/1/2023,LKA,Johor,1119,743,376,Sri Lanka
72377,7/1/2023,LKA,Kedah,43,20,23,Sri Lanka
72378,7/1/2023,LKA,Kelantan,0,0,0,Sri Lanka
72379,7/1/2023,LKA,Melaka,0,0,0,Sri Lanka
72380,7/1/2023,LKA,Pahang,0,0,0,Sri Lanka
72381,7/1/2023,LKA,Perak,0,0,0,Sri Lanka
72382,7/1/2023,LKA,Perlis,0,0,0,Sri Lanka
72383,7/1/2023,LKA,Pulau Pinang,37,21,16,Sri Lanka
72384,7/1/2023,LKA,Sabah,3,1,2,Sri Lanka
72385,7/1/2023,LKA,Sarawak,27,19,8,Sri Lanka
72386,7/1/2023,LKA,Selangor,4693,3011,1682,Sri Lanka
72387,7/1/2023,LKA,W.P. Labuan,0,0,0,Sri Lanka
72388,7/1/2023,LSO,Johor,1,1,0,Lesotho
72389,7/1/2023,LSO,Kedah,0,0,0,Lesotho
72390,7/1/2023,LSO,Pulau Pinang,0,0,0,Lesotho
72391,7/1/2023,LSO,Sarawak,0,0,0,Lesotho
72392,7/1/2023,LSO,Selangor,8,3,5,Lesotho
72393,7/1/2023,LTU,Johor,35,14,21,Lithuania
72394,7/1/2023,LTU,Kedah,8,2,6,Lithuania
72395,7/1/2023,LTU,Kelantan,1,0,1,Lithuania
72396,7/1/2023,LTU,Pahang,0,0,0,Lithuania
72397,7/1/2023,LTU,Perak,0,0,0,Lithuania
72398,7/1/2023,LTU,Perlis,3,3,0,Lithuania
72399,7/1/2023,LTU,Pulau Pinang,3,2,1,Lithuania
72400,7/1/2023,LTU,Sabah,7,4,3,Lithuania
72401,7/1/2023,LTU,Sarawak,1,1,0,Lithuania
72402,7/1/2023,LTU,Selangor,238,113,125,Lithuania
72403,7/1/2023,LTU,W.P. Labuan,0,0,0,Lithuania
72404,7/1/2023,LUX,Johor,10,4,6,Luxembourg
72405,7/1/2023,LUX,Kedah,3,1,2,Luxembourg
72406,7/1/2023,LUX,Kelantan,0,0,0,Luxembourg
72407,7/1/2023,LUX,Perak,0,0,0,Luxembourg
72408,7/1/2023,LUX,Perlis,0,0,0,Luxembourg
72409,7/1/2023,LUX,Pulau Pinang,3,1,2,Luxembourg
72410,7/1/2023,LUX,Sabah,4,2,2,Luxembourg
72411,7/1/2023,LUX,Sarawak,2,2,0,Luxembourg
72412,7/1/2023,LUX,Selangor,60,36,24,Luxembourg
72413,7/1/2023,LVA,Johor,12,7,5,Latvia
72414,7/1/2023,LVA,Kedah,3,1,2,Latvia
72415,7/1/2023,LVA,Kelantan,0,0,0,Latvia
72416,7/1/2023,LVA,Pahang,0,0,0,Latvia
72417,7/1/2023,LVA,Perak,1,1,0,Latvia
72418,7/1/2023,LVA,Perlis,0,0,0,Latvia
72419,7/1/2023,LVA,Pulau Pinang,0,0,0,Latvia
72420,7/1/2023,LVA,Sabah,1,0,1,Latvia
72421,7/1/2023,LVA,Sarawak,1,0,1,Latvia
72422,7/1/2023,LVA,Selangor,108,67,41,Latvia
72423,7/1/2023,LVA,W.P. Labuan,0,0,0,Latvia
72424,7/1/2023,MAC,Johor,0,0,0,Macao
72425,7/1/2023,MAC,Pahang,0,0,0,Macao
72426,7/1/2023,MAC,Perak,4,3,1,Macao
72427,7/1/2023,MAC,Selangor,0,0,0,Macao
72428,7/1/2023,MAC,W.P. Labuan,0,0,0,Macao
72429,7/1/2023,MAR,Johor,75,43,32,Morocco
72430,7/1/2023,MAR,Kedah,8,4,4,Morocco
72431,7/1/2023,MAR,Kelantan,2,1,1,Morocco
72432,7/1/2023,MAR,Melaka,0,0,0,Morocco
72433,7/1/2023,MAR,Pahang,0,0,0,Morocco
72434,7/1/2023,MAR,Perak,1,1,0,Morocco
72435,7/1/2023,MAR,Perlis,3,2,1,Morocco
72436,7/1/2023,MAR,Pulau Pinang,18,9,9,Morocco
72437,7/1/2023,MAR,Sabah,2,2,0,Morocco
72438,7/1/2023,MAR,Sarawak,8,6,2,Morocco
72439,7/1/2023,MAR,Selangor,1180,590,590,Morocco
72440,7/1/2023,MAR,W.P. Labuan,0,0,0,Morocco
72441,7/1/2023,MCO,Johor,0,0,0,Monaco
72442,7/1/2023,MCO,Kedah,0,0,0,Monaco
72443,7/1/2023,MCO,Sabah,0,0,0,Monaco
72444,7/1/2023,MCO,Selangor,3,0,3,Monaco
72445,7/1/2023,MDA,Johor,3,2,1,"Moldova, Republic of"
72446,7/1/2023,MDA,Kedah,0,0,0,"Moldova, Republic of"
72447,7/1/2023,MDA,Kelantan,0,0,0,"Moldova, Republic of"
72448,7/1/2023,MDA,Negeri Sembilan,0,0,0,"Moldova, Republic of"
72449,7/1/2023,MDA,Perlis,1,1,0,"Moldova, Republic of"
72450,7/1/2023,MDA,Pulau Pinang,1,1,0,"Moldova, Republic of"
72451,7/1/2023,MDA,Sabah,0,0,0,"Moldova, Republic of"
72452,7/1/2023,MDA,Sarawak,1,0,1,"Moldova, Republic of"
72453,7/1/2023,MDA,Selangor,27,17,10,"Moldova, Republic of"
72454,7/1/2023,MDG,Johor,14,6,8,Madagascar
72455,7/1/2023,MDG,Kedah,0,0,0,Madagascar
72456,7/1/2023,MDG,Perak,0,0,0,Madagascar
72457,7/1/2023,MDG,Perlis,0,0,0,Madagascar
72458,7/1/2023,MDG,Pulau Pinang,1,0,1,Madagascar
72459,7/1/2023,MDG,Sabah,2,0,2,Madagascar
72460,7/1/2023,MDG,Sarawak,0,0,0,Madagascar
72461,7/1/2023,MDG,Selangor,105,47,58,Madagascar
72462,7/1/2023,MDV,Johor,714,355,359,Maldives
72463,7/1/2023,MDV,Kedah,6,4,2,Maldives
72464,7/1/2023,MDV,Kelantan,2,2,0,Maldives
72465,7/1/2023,MDV,Perak,1,1,0,Maldives
72466,7/1/2023,MDV,Perlis,2,2,0,Maldives
72467,7/1/2023,MDV,Pulau Pinang,4,2,2,Maldives
72468,7/1/2023,MDV,Sabah,6,3,3,Maldives
72469,7/1/2023,MDV,Sarawak,4,2,2,Maldives
72470,7/1/2023,MDV,Selangor,5552,2707,2845,Maldives
72471,7/1/2023,MEX,Johor,222,101,121,Mexico
72472,7/1/2023,MEX,Kedah,5,3,2,Mexico
72473,7/1/2023,MEX,Kelantan,0,0,0,Mexico
72474,7/1/2023,MEX,Pahang,3,2,1,Mexico
72475,7/1/2023,MEX,Perak,1,0,1,Mexico
72476,7/1/2023,MEX,Perlis,0,0,0,Mexico
72477,7/1/2023,MEX,Pulau Pinang,49,20,29,Mexico
72478,7/1/2023,MEX,Sabah,1,1,0,Mexico
72479,7/1/2023,MEX,Sarawak,8,4,4,Mexico
72480,7/1/2023,MEX,Selangor,862,451,411,Mexico
72481,7/1/2023,MEX,W.P. Labuan,0,0,0,Mexico
72482,7/1/2023,MHL,Johor,1,1,0,Marshall Islands
72483,7/1/2023,MHL,Kedah,0,0,0,Marshall Islands
72484,7/1/2023,MHL,Perak,0,0,0,Marshall Islands
72485,7/1/2023,MHL,Pulau Pinang,0,0,0,Marshall Islands
72486,7/1/2023,MHL,Sabah,0,0,0,Marshall Islands
72487,7/1/2023,MHL,Selangor,3,3,0,Marshall Islands
72488,7/1/2023,MKD,Johor,5,3,2,"Macedonia, the former Yugoslav Republic of"
72489,7/1/2023,MKD,Kedah,2,1,1,"Macedonia, the former Yugoslav Republic of"
72490,7/1/2023,MKD,Perak,0,0,0,"Macedonia, the former Yugoslav Republic of"
72491,7/1/2023,MKD,Pulau Pinang,0,0,0,"Macedonia, the former Yugoslav Republic of"
72492,7/1/2023,MKD,Sabah,0,0,0,"Macedonia, the former Yugoslav Republic of"
72493,7/1/2023,MKD,Sarawak,1,0,1,"Macedonia, the former Yugoslav Republic of"
72494,7/1/2023,MKD,Selangor,27,11,16,"Macedonia, the former Yugoslav Republic of"
72495,7/1/2023,MLI,Johor,5,5,0,Mali
72496,7/1/2023,MLI,Sabah,0,0,0,Mali
72497,7/1/2023,MLI,Selangor,15,11,4,Mali
72498,7/1/2023,MLT,Johor,7,4,3,Malta
72499,7/1/2023,MLT,Kedah,0,0,0,Malta
72500,7/1/2023,MLT,Kelantan,0,0,0,Malta
72501,7/1/2023,MLT,Perak,0,0,0,Malta
72502,7/1/2023,MLT,Perlis,0,0,0,Malta
72503,7/1/2023,MLT,Pulau Pinang,3,2,1,Malta
72504,7/1/2023,MLT,Sabah,0,0,0,Malta
72505,7/1/2023,MLT,Sarawak,0,0,0,Malta
72506,7/1/2023,MLT,Selangor,66,36,30,Malta
72507,7/1/2023,MLT,W.P. Labuan,0,0,0,Malta
72508,7/1/2023,MMR,Johor,5534,1782,3752,Myanmar
72509,7/1/2023,MMR,Kedah,60,10,50,Myanmar
72510,7/1/2023,MMR,Kelantan,2,0,2,Myanmar
72511,7/1/2023,MMR,Negeri Sembilan,0,0,0,Myanmar
72512,7/1/2023,MMR,Pahang,2,0,2,Myanmar
72513,7/1/2023,MMR,Perak,22,4,18,Myanmar
72514,7/1/2023,MMR,Perlis,4,0,4,Myanmar
72515,7/1/2023,MMR,Pulau Pinang,350,177,173,Myanmar
72516,7/1/2023,MMR,Sabah,8,2,6,Myanmar
72517,7/1/2023,MMR,Sarawak,93,44,49,Myanmar
72518,7/1/2023,MMR,Selangor,7517,5327,2190,Myanmar
72519,7/1/2023,MMR,Terengganu,0,0,0,Myanmar
72520,7/1/2023,MMR,W.P. Labuan,1,0,1,Myanmar
72521,7/1/2023,MNE,Johor,2,1,1,Montenegro
72522,7/1/2023,MNE,Kedah,0,0,0,Montenegro
72523,7/1/2023,MNE,Pulau Pinang,0,0,0,Montenegro
72524,7/1/2023,MNE,Sabah,0,0,0,Montenegro
72525,7/1/2023,MNE,Sarawak,0,0,0,Montenegro
72526,7/1/2023,MNE,Selangor,12,12,0,Montenegro
72527,7/1/2023,MNG,Johor,143,49,94,Mongolia
72528,7/1/2023,MNG,Kedah,1,0,1,Mongolia
72529,7/1/2023,MNG,Kelantan,2,1,1,Mongolia
72530,7/1/2023,MNG,Perak,2,0,2,Mongolia
72531,7/1/2023,MNG,Perlis,0,0,0,Mongolia
72532,7/1/2023,MNG,Pulau Pinang,11,4,7,Mongolia
72533,7/1/2023,MNG,Sabah,10,5,5,Mongolia
72534,7/1/2023,MNG,Sarawak,0,0,0,Mongolia
72535,7/1/2023,MNG,Selangor,361,150,211,Mongolia
72536,7/1/2023,MNP,Selangor,0,0,0,Northern Mariana Islands
72537,7/1/2023,MOZ,Johor,0,0,0,Mozambique
72538,7/1/2023,MOZ,Kedah,0,0,0,Mozambique
72539,7/1/2023,MOZ,Perak,0,0,0,Mozambique
72540,7/1/2023,MOZ,Pulau Pinang,0,0,0,Mozambique
72541,7/1/2023,MOZ,Sabah,0,0,0,Mozambique
72542,7/1/2023,MOZ,Sarawak,0,0,0,Mozambique
72543,7/1/2023,MOZ,Selangor,25,12,13,Mozambique
72544,7/1/2023,MRT,Johor,4,4,0,Mauritania
72545,7/1/2023,MRT,Kedah,0,0,0,Mauritania
72546,7/1/2023,MRT,Pulau Pinang,0,0,0,Mauritania
72547,7/1/2023,MRT,Sabah,0,0,0,Mauritania
72548,7/1/2023,MRT,Sarawak,0,0,0,Mauritania
72549,7/1/2023,MRT,Selangor,18,13,5,Mauritania
72550,7/1/2023,MUS,Johor,152,85,67,Mauritius
72551,7/1/2023,MUS,Kedah,6,2,4,Mauritius
72552,7/1/2023,MUS,Kelantan,0,0,0,Mauritius
72553,7/1/2023,MUS,Pahang,0,0,0,Mauritius
72554,7/1/2023,MUS,Perak,1,0,1,Mauritius
72555,7/1/2023,MUS,Perlis,4,2,2,Mauritius
72556,7/1/2023,MUS,Pulau Pinang,6,5,1,Mauritius
72557,7/1/2023,MUS,Sabah,0,0,0,Mauritius
72558,7/1/2023,MUS,Sarawak,0,0,0,Mauritius
72559,7/1/2023,MUS,Selangor,1358,696,662,Mauritius
72560,7/1/2023,MWI,Johor,3,3,0,Malawi
72561,7/1/2023,MWI,Pulau Pinang,0,0,0,Malawi
72562,7/1/2023,MWI,Sabah,0,0,0,Malawi
72563,7/1/2023,MWI,Sarawak,1,0,1,Malawi
72564,7/1/2023,MWI,Selangor,11,4,7,Malawi
72565,7/1/2023,MYT,Selangor,0,0,0,Mayotte
72566,7/1/2023,NAM,Johor,20,14,6,Namibia
72567,7/1/2023,NAM,Kedah,0,0,0,Namibia
72568,7/1/2023,NAM,Perak,0,0,0,Namibia
72569,7/1/2023,NAM,Perlis,0,0,0,Namibia
72570,7/1/2023,NAM,Pulau Pinang,1,1,0,Namibia
72571,7/1/2023,NAM,Sabah,0,0,0,Namibia
72572,7/1/2023,NAM,Sarawak,0,0,0,Namibia
72573,7/1/2023,NAM,Selangor,19,9,10,Namibia
72574,7/1/2023,NCL,Selangor,0,0,0,New Caledonia
72575,7/1/2023,NER,Johor,0,0,0,Niger
72576,7/1/2023,NER,Sabah,0,0,0,Niger
72577,7/1/2023,NER,Selangor,4,2,2,Niger
72578,7/1/2023,NGA,Johor,34,32,2,Nigeria
72579,7/1/2023,NGA,Kedah,1,1,0,Nigeria
72580,7/1/2023,NGA,Perlis,0,0,0,Nigeria
72581,7/1/2023,NGA,Pulau Pinang,3,2,1,Nigeria
72582,7/1/2023,NGA,Sabah,1,1,0,Nigeria
72583,7/1/2023,NGA,Sarawak,11,8,3,Nigeria
72584,7/1/2023,NGA,Selangor,313,238,75,Nigeria
72585,7/1/2023,NIC,Johor,2,0,2,Nicaragua
72586,7/1/2023,NIC,Kedah,0,0,0,Nicaragua
72587,7/1/2023,NIC,Pulau Pinang,1,0,1,Nicaragua
72588,7/1/2023,NIC,Sabah,1,1,0,Nicaragua
72589,7/1/2023,NIC,Selangor,6,3,3,Nicaragua
72590,7/1/2023,NLD,Johor,1759,1022,737,Netherlands
72591,7/1/2023,NLD,Kedah,339,174,165,Netherlands
72592,7/1/2023,NLD,Kelantan,10,5,5,Netherlands
72593,7/1/2023,NLD,Melaka,0,0,0,Netherlands
72594,7/1/2023,NLD,Negeri Sembilan,1,0,1,Netherlands
72595,7/1/2023,NLD,Pahang,1,1,0,Netherlands
72596,7/1/2023,NLD,Perak,15,8,7,Netherlands
72597,7/1/2023,NLD,Perlis,58,35,23,Netherlands
72598,7/1/2023,NLD,Pulau Pinang,325,174,151,Netherlands
72599,7/1/2023,NLD,Sabah,66,30,36,Netherlands
72600,7/1/2023,NLD,Sarawak,182,104,78,Netherlands
72601,7/1/2023,NLD,Selangor,9860,5216,4644,Netherlands
72602,7/1/2023,NLD,Terengganu,0,0,0,Netherlands
72603,7/1/2023,NLD,W.P. Labuan,3,2,1,Netherlands
72604,7/1/2023,NOR,Johor,302,157,145,Norway
72605,7/1/2023,NOR,Kedah,81,38,43,Norway
72606,7/1/2023,NOR,Kelantan,0,0,0,Norway
72607,7/1/2023,NOR,Melaka,0,0,0,Norway
72608,7/1/2023,NOR,Pahang,0,0,0,Norway
72609,7/1/2023,NOR,Perak,3,2,1,Norway
72610,7/1/2023,NOR,Perlis,16,9,7,Norway
72611,7/1/2023,NOR,Pulau Pinang,59,35,24,Norway
72612,7/1/2023,NOR,Sabah,7,5,2,Norway
72613,7/1/2023,NOR,Sarawak,26,19,7,Norway
72614,7/1/2023,NOR,Selangor,1162,619,543,Norway
72615,7/1/2023,NOR,W.P. Labuan,0,0,0,Norway
72616,7/1/2023,NPL,Johor,529,374,155,Nepal
72617,7/1/2023,NPL,Kedah,23,8,15,Nepal
72618,7/1/2023,NPL,Pahang,0,0,0,Nepal
72619,7/1/2023,NPL,Perak,1,1,0,Nepal
72620,7/1/2023,NPL,Perlis,4,3,1,Nepal
72621,7/1/2023,NPL,Pulau Pinang,17,13,4,Nepal
72622,7/1/2023,NPL,Sabah,5,4,1,Nepal
72623,7/1/2023,NPL,Sarawak,232,159,73,Nepal
72624,7/1/2023,NPL,Selangor,12190,11633,557,Nepal
72625,7/1/2023,NPL,W.P. Labuan,24,23,1,Nepal
72626,7/1/2023,NRU,Johor,2,0,2,Nauru
72627,7/1/2023,NRU,Pulau Pinang,0,0,0,Nauru
72628,7/1/2023,NRU,Selangor,0,0,0,Nauru
72629,7/1/2023,NZL,Johor,941,551,390,New Zealand
72630,7/1/2023,NZL,Kedah,116,63,53,New Zealand
72631,7/1/2023,NZL,Kelantan,8,5,3,New Zealand
72632,7/1/2023,NZL,Melaka,0,0,0,New Zealand
72633,7/1/2023,NZL,Negeri Sembilan,2,1,1,New Zealand
72634,7/1/2023,NZL,Pahang,5,2,3,New Zealand
72635,7/1/2023,NZL,Perak,39,20,19,New Zealand
72636,7/1/2023,NZL,Perlis,16,8,8,New Zealand
72637,7/1/2023,NZL,Pulau Pinang,340,180,160,New Zealand
72638,7/1/2023,NZL,Sabah,68,36,32,New Zealand
72639,7/1/2023,NZL,Sarawak,163,98,65,New Zealand
72640,7/1/2023,NZL,Selangor,3921,2208,1713,New Zealand
72641,7/1/2023,NZL,Terengganu,0,0,0,New Zealand
72642,7/1/2023,NZL,W.P. Labuan,2,1,1,New Zealand
72643,7/1/2023,OMN,Johor,245,101,144,Oman
72644,7/1/2023,OMN,Kedah,24,15,9,Oman
72645,7/1/2023,OMN,Kelantan,5,5,0,Oman
72646,7/1/2023,OMN,Melaka,1,1,0,Oman
72647,7/1/2023,OMN,Perak,3,2,1,Oman
72648,7/1/2023,OMN,Perlis,5,5,0,Oman
72649,7/1/2023,OMN,Pulau Pinang,107,57,50,Oman
72650,7/1/2023,OMN,Sabah,0,0,0,Oman
72651,7/1/2023,OMN,Sarawak,6,3,3,Oman
72652,7/1/2023,OMN,Selangor,4665,2428,2237,Oman
72653,7/1/2023,PAK,Johor,1236,847,389,Pakistan
72654,7/1/2023,PAK,Kedah,230,114,116,Pakistan
72655,7/1/2023,PAK,Kelantan,11,11,0,Pakistan
72656,7/1/2023,PAK,Melaka,1,1,0,Pakistan
72657,7/1/2023,PAK,Negeri Sembilan,0,0,0,Pakistan
72658,7/1/2023,PAK,Pahang,1,1,0,Pakistan
72659,7/1/2023,PAK,Perak,21,20,1,Pakistan
72660,7/1/2023,PAK,Perlis,19,18,1,Pakistan
72661,7/1/2023,PAK,Pulau Pinang,78,67,11,Pakistan
72662,7/1/2023,PAK,Sabah,9,7,2,Pakistan
72663,7/1/2023,PAK,Sarawak,127,102,25,Pakistan
72664,7/1/2023,PAK,Selangor,10693,8441,2252,Pakistan
72665,7/1/2023,PAK,W.P. Labuan,1,1,0,Pakistan
72666,7/1/2023,PAN,Johor,4,1,3,Panama
72667,7/1/2023,PAN,Kedah,0,0,0,Panama
72668,7/1/2023,PAN,Perak,0,0,0,Panama
72669,7/1/2023,PAN,Perlis,0,0,0,Panama
72670,7/1/2023,PAN,Pulau Pinang,3,3,0,Panama
72671,7/1/2023,PAN,Sabah,2,0,2,Panama
72672,7/1/2023,PAN,Sarawak,0,0,0,Panama
72673,7/1/2023,PAN,Selangor,46,23,23,Panama
72674,7/1/2023,PER,Johor,34,16,18,Peru
72675,7/1/2023,PER,Kedah,9,4,5,Peru
72676,7/1/2023,PER,Kelantan,0,0,0,Peru
72677,7/1/2023,PER,Pahang,0,0,0,Peru
72678,7/1/2023,PER,Perak,0,0,0,Peru
72679,7/1/2023,PER,Perlis,4,3,1,Peru
72680,7/1/2023,PER,Pulau Pinang,5,4,1,Peru
72681,7/1/2023,PER,Sabah,0,0,0,Peru
72682,7/1/2023,PER,Sarawak,0,0,0,Peru
72683,7/1/2023,PER,Selangor,144,79,65,Peru
72684,7/1/2023,PER,W.P. Labuan,0,0,0,Peru
72685,7/1/2023,PHL,Johor,26964,9160,17804,Philippines
72686,7/1/2023,PHL,Kedah,492,157,335,Philippines
72687,7/1/2023,PHL,Kelantan,21,13,8,Philippines
72688,7/1/2023,PHL,Melaka,4,2,2,Philippines
72689,7/1/2023,PHL,Negeri Sembilan,3,3,0,Philippines
72690,7/1/2023,PHL,Pahang,23,19,4,Philippines
72691,7/1/2023,PHL,Perak,69,17,52,Philippines
72692,7/1/2023,PHL,Perlis,192,50,142,Philippines
72693,7/1/2023,PHL,Pulau Pinang,716,285,431,Philippines
72694,7/1/2023,PHL,Sabah,1015,471,544,Philippines
72695,7/1/2023,PHL,Sarawak,2283,847,1436,Philippines
72696,7/1/2023,PHL,Selangor,21286,8208,13078,Philippines
72697,7/1/2023,PHL,Terengganu,0,0,0,Philippines
72698,7/1/2023,PHL,W.P. Labuan,104,30,74,Philippines
72699,7/1/2023,PLW,Johor,0,0,0,Palau
72700,7/1/2023,PLW,Pulau Pinang,0,0,0,Palau
72701,7/1/2023,PLW,Selangor,3,1,2,Palau
72702,7/1/2023,PNG,Johor,26,18,8,Papua New Guinea
72703,7/1/2023,PNG,Kedah,1,0,1,Papua New Guinea
72704,7/1/2023,PNG,Kelantan,0,0,0,Papua New Guinea
72705,7/1/2023,PNG,Perak,1,1,0,Papua New Guinea
72706,7/1/2023,PNG,Pulau Pinang,1,0,1,Papua New Guinea
72707,7/1/2023,PNG,Sabah,0,0,0,Papua New Guinea
72708,7/1/2023,PNG,Sarawak,4,2,2,Papua New Guinea
72709,7/1/2023,PNG,Selangor,68,44,24,Papua New Guinea
72710,7/1/2023,POL,Johor,478,251,227,Poland
72711,7/1/2023,POL,Kedah,46,19,27,Poland
72712,7/1/2023,POL,Kelantan,1,1,0,Poland
72713,7/1/2023,POL,Melaka,0,0,0,Poland
72714,7/1/2023,POL,Negeri Sembilan,0,0,0,Poland
72715,7/1/2023,POL,Pahang,4,4,0,Poland
72716,7/1/2023,POL,Perak,6,3,3,Poland
72717,7/1/2023,POL,Perlis,13,7,6,Poland
72718,7/1/2023,POL,Pulau Pinang,60,30,30,Poland
72719,7/1/2023,POL,Sabah,35,16,19,Poland
72720,7/1/2023,POL,Sarawak,70,38,32,Poland
72721,7/1/2023,POL,Selangor,1349,700,649,Poland
72722,7/1/2023,POL,Terengganu,0,0,0,Poland
72723,7/1/2023,POL,W.P. Labuan,0,0,0,Poland
72724,7/1/2023,PRK,Selangor,0,0,0,"Korea, Democratic People's Republic of"
72725,7/1/2023,PRT,Johor,222,131,91,Portugal
72726,7/1/2023,PRT,Kedah,19,7,12,Portugal
72727,7/1/2023,PRT,Kelantan,0,0,0,Portugal
72728,7/1/2023,PRT,Melaka,0,0,0,Portugal
72729,7/1/2023,PRT,Pahang,1,0,1,Portugal
72730,7/1/2023,PRT,Perak,2,1,1,Portugal
72731,7/1/2023,PRT,Perlis,6,3,3,Portugal
72732,7/1/2023,PRT,Pulau Pinang,34,21,13,Portugal
72733,7/1/2023,PRT,Sabah,15,11,4,Portugal
72734,7/1/2023,PRT,Sarawak,9,5,4,Portugal
72735,7/1/2023,PRT,Selangor,724,420,304,Portugal
72736,7/1/2023,PRT,W.P. Labuan,0,0,0,Portugal
72737,7/1/2023,PRY,Johor,4,3,1,Paraguay
72738,7/1/2023,PRY,Kedah,0,0,0,Paraguay
72739,7/1/2023,PRY,Perak,0,0,0,Paraguay
72740,7/1/2023,PRY,Perlis,0,0,0,Paraguay
72741,7/1/2023,PRY,Pulau Pinang,1,0,1,Paraguay
72742,7/1/2023,PRY,Sabah,0,0,0,Paraguay
72743,7/1/2023,PRY,Sarawak,0,0,0,Paraguay
72744,7/1/2023,PRY,Selangor,12,5,7,Paraguay
72745,7/1/2023,PSE,Johor,28,25,3,"Palestinian Territory, Occupied"
72746,7/1/2023,PSE,Kedah,1,1,0,"Palestinian Territory, Occupied"
72747,7/1/2023,PSE,Kelantan,0,0,0,"Palestinian Territory, Occupied"
72748,7/1/2023,PSE,Melaka,0,0,0,"Palestinian Territory, Occupied"
72749,7/1/2023,PSE,Perak,0,0,0,"Palestinian Territory, Occupied"
72750,7/1/2023,PSE,Perlis,0,0,0,"Palestinian Territory, Occupied"
72751,7/1/2023,PSE,Pulau Pinang,1,1,0,"Palestinian Territory, Occupied"
72752,7/1/2023,PSE,Sabah,0,0,0,"Palestinian Territory, Occupied"
72753,7/1/2023,PSE,Sarawak,0,0,0,"Palestinian Territory, Occupied"
72754,7/1/2023,PSE,Selangor,478,290,188,"Palestinian Territory, Occupied"
72755,7/1/2023,QAT,Johor,74,42,32,Qatar
72756,7/1/2023,QAT,Kedah,8,5,3,Qatar
72757,7/1/2023,QAT,Perlis,0,0,0,Qatar
72758,7/1/2023,QAT,Pulau Pinang,13,2,11,Qatar
72759,7/1/2023,QAT,Sabah,0,0,0,Qatar
72760,7/1/2023,QAT,Sarawak,0,0,0,Qatar
72761,7/1/2023,QAT,Selangor,747,386,361,Qatar
72762,7/1/2023,REU,Johor,0,0,0,Reunion
72763,7/1/2023,REU,Sarawak,0,0,0,Reunion
72764,7/1/2023,ROU,Johor,132,71,61,Romania
72765,7/1/2023,ROU,Kedah,8,4,4,Romania
72766,7/1/2023,ROU,Kelantan,1,0,1,Romania
72767,7/1/2023,ROU,Negeri Sembilan,0,0,0,Romania
72768,7/1/2023,ROU,Pahang,0,0,0,Romania
72769,7/1/2023,ROU,Perak,0,0,0,Romania
72770,7/1/2023,ROU,Perlis,0,0,0,Romania
72771,7/1/2023,ROU,Pulau Pinang,20,9,11,Romania
72772,7/1/2023,ROU,Sabah,2,1,1,Romania
72773,7/1/2023,ROU,Sarawak,6,5,1,Romania
72774,7/1/2023,ROU,Selangor,570,268,302,Romania
72775,7/1/2023,ROU,W.P. Labuan,0,0,0,Romania
72776,7/1/2023,RUS,Johor,511,251,260,Russia
72777,7/1/2023,RUS,Kedah,352,189,163,Russia
72778,7/1/2023,RUS,Kelantan,31,21,10,Russia
72779,7/1/2023,RUS,Melaka,0,0,0,Russia
72780,7/1/2023,RUS,Negeri Sembilan,0,0,0,Russia
72781,7/1/2023,RUS,Pahang,5,2,3,Russia
72782,7/1/2023,RUS,Perak,8,3,5,Russia
72783,7/1/2023,RUS,Perlis,330,203,127,Russia
72784,7/1/2023,RUS,Pulau Pinang,124,67,57,Russia
72785,7/1/2023,RUS,Sabah,27,14,13,Russia
72786,7/1/2023,RUS,Sarawak,46,20,26,Russia
72787,7/1/2023,RUS,Selangor,7902,3979,3923,Russia
72788,7/1/2023,RUS,W.P. Labuan,9,4,5,Russia
72789,7/1/2023,RWA,Johor,3,1,2,Rwanda
72790,7/1/2023,RWA,Kedah,0,0,0,Rwanda
72791,7/1/2023,RWA,Pulau Pinang,2,2,0,Rwanda
72792,7/1/2023,RWA,Selangor,11,6,5,Rwanda
72793,7/1/2023,SAU,Johor,706,373,333,Saudi Arabia
72794,7/1/2023,SAU,Kedah,241,126,115,Saudi Arabia
72795,7/1/2023,SAU,Kelantan,28,14,14,Saudi Arabia
72796,7/1/2023,SAU,Melaka,0,0,0,Saudi Arabia
72797,7/1/2023,SAU,Perak,6,5,1,Saudi Arabia
72798,7/1/2023,SAU,Perlis,24,12,12,Saudi Arabia
72799,7/1/2023,SAU,Pulau Pinang,209,109,100,Saudi Arabia
72800,7/1/2023,SAU,Sabah,2,1,1,Saudi Arabia
72801,7/1/2023,SAU,Sarawak,19,13,6,Saudi Arabia
72802,7/1/2023,SAU,Selangor,10164,5390,4774,Saudi Arabia
72803,7/1/2023,SAU,W.P. Labuan,0,0,0,Saudi Arabia
72804,7/1/2023,SDN,Johor,11,6,5,Sudan
72805,7/1/2023,SDN,Kedah,0,0,0,Sudan
72806,7/1/2023,SDN,Kelantan,0,0,0,Sudan
72807,7/1/2023,SDN,Perlis,0,0,0,Sudan
72808,7/1/2023,SDN,Pulau Pinang,0,0,0,Sudan
72809,7/1/2023,SDN,Sabah,0,0,0,Sudan
72810,7/1/2023,SDN,Sarawak,1,1,0,Sudan
72811,7/1/2023,SDN,Selangor,1226,651,575,Sudan
72812,7/1/2023,SDN,W.P. Labuan,0,0,0,Sudan
72813,7/1/2023,SEN,Johor,7,5,2,Senegal
72814,7/1/2023,SEN,Kedah,1,0,1,Senegal
72815,7/1/2023,SEN,Kelantan,0,0,0,Senegal
72816,7/1/2023,SEN,Perak,0,0,0,Senegal
72817,7/1/2023,SEN,Perlis,0,0,0,Senegal
72818,7/1/2023,SEN,Pulau Pinang,0,0,0,Senegal
72819,7/1/2023,SEN,Sabah,1,1,0,Senegal
72820,7/1/2023,SEN,Sarawak,0,0,0,Senegal
72821,7/1/2023,SEN,Selangor,56,37,19,Senegal
72822,7/1/2023,SGP,Johor,1217340,694189,523151,Singapore
72823,7/1/2023,SGP,Kedah,4811,2470,2341,Singapore
72824,7/1/2023,SGP,Kelantan,117,72,45,Singapore
72825,7/1/2023,SGP,Melaka,6,5,1,Singapore
72826,7/1/2023,SGP,Negeri Sembilan,2,0,2,Singapore
72827,7/1/2023,SGP,Pahang,508,264,244,Singapore
72828,7/1/2023,SGP,Perak,6463,2854,3609,Singapore
72829,7/1/2023,SGP,Perlis,196,102,94,Singapore
72830,7/1/2023,SGP,Pulau Pinang,19079,9039,10040,Singapore
72831,7/1/2023,SGP,Sabah,1773,922,851,Singapore
72832,7/1/2023,SGP,Sarawak,3348,1882,1466,Singapore
72833,7/1/2023,SGP,Selangor,41414,21825,19589,Singapore
72834,7/1/2023,SGP,Terengganu,0,0,0,Singapore
72835,7/1/2023,SGP,W.P. Labuan,10,9,1,Singapore
72836,7/1/2023,SGS,Johor,0,0,0,South Georgia and the South Sandwich Islands
72837,7/1/2023,SGS,Sabah,0,0,0,South Georgia and the South Sandwich Islands
72838,7/1/2023,SGS,Selangor,0,0,0,South Georgia and the South Sandwich Islands
72839,7/1/2023,SHN,Sarawak,0,0,0,"Saint Helena, Ascension and Tristan da Cunha"
72840,7/1/2023,SLB,Johor,0,0,0,Solomon Islands
72841,7/1/2023,SLB,Perlis,0,0,0,Solomon Islands
72842,7/1/2023,SLB,Pulau Pinang,0,0,0,Solomon Islands
72843,7/1/2023,SLB,Sabah,0,0,0,Solomon Islands
72844,7/1/2023,SLB,Sarawak,0,0,0,Solomon Islands
72845,7/1/2023,SLB,Selangor,6,3,3,Solomon Islands
72846,7/1/2023,SLB,W.P. Labuan,1,0,1,Solomon Islands
72847,7/1/2023,SLE,Johor,2,2,0,Sierra Leone
72848,7/1/2023,SLE,Kedah,0,0,0,Sierra Leone
72849,7/1/2023,SLE,Perak,0,0,0,Sierra Leone
72850,7/1/2023,SLE,Pulau Pinang,0,0,0,Sierra Leone
72851,7/1/2023,SLE,Sabah,0,0,0,Sierra Leone
72852,7/1/2023,SLE,Selangor,31,13,18,Sierra Leone
72853,7/1/2023,SLV,Johor,1,0,1,El Salvador
72854,7/1/2023,SLV,Kedah,0,0,0,El Salvador
72855,7/1/2023,SLV,Perak,0,0,0,El Salvador
72856,7/1/2023,SLV,Perlis,0,0,0,El Salvador
72857,7/1/2023,SLV,Pulau Pinang,5,3,2,El Salvador
72858,7/1/2023,SLV,Sabah,0,0,0,El Salvador
72859,7/1/2023,SLV,Selangor,16,8,8,El Salvador
72860,7/1/2023,SLV,W.P. Labuan,0,0,0,El Salvador
72861,7/1/2023,SMR,Johor,2,1,1,San Marino
72862,7/1/2023,SMR,Selangor,2,2,0,San Marino
72863,7/1/2023,SOM,Johor,0,0,0,Somalia
72864,7/1/2023,SOM,Kedah,0,0,0,Somalia
72865,7/1/2023,SOM,Kelantan,0,0,0,Somalia
72866,7/1/2023,SOM,Perlis,0,0,0,Somalia
72867,7/1/2023,SOM,Sabah,0,0,0,Somalia
72868,7/1/2023,SOM,Sarawak,0,0,0,Somalia
72869,7/1/2023,SOM,Selangor,181,108,73,Somalia
72870,7/1/2023,SRB,Johor,9,3,6,Serbia
72871,7/1/2023,SRB,Kedah,0,0,0,Serbia
72872,7/1/2023,SRB,Kelantan,0,0,0,Serbia
72873,7/1/2023,SRB,Pahang,0,0,0,Serbia
72874,7/1/2023,SRB,Perak,0,0,0,Serbia
72875,7/1/2023,SRB,Perlis,0,0,0,Serbia
72876,7/1/2023,SRB,Pulau Pinang,1,1,0,Serbia
72877,7/1/2023,SRB,Sabah,0,0,0,Serbia
72878,7/1/2023,SRB,Sarawak,0,0,0,Serbia
72879,7/1/2023,SRB,Selangor,75,43,32,Serbia
72880,7/1/2023,STP,Selangor,1,1,0,Sao Tome and Principe
72881,7/1/2023,SUR,Johor,4,2,2,Suriname
72882,7/1/2023,SUR,Kedah,0,0,0,Suriname
72883,7/1/2023,SUR,Kelantan,0,0,0,Suriname
72884,7/1/2023,SUR,Perak,1,1,0,Suriname
72885,7/1/2023,SUR,Perlis,0,0,0,Suriname
72886,7/1/2023,SUR,Pulau Pinang,1,1,0,Suriname
72887,7/1/2023,SUR,Sabah,1,0,1,Suriname
72888,7/1/2023,SUR,Sarawak,0,0,0,Suriname
72889,7/1/2023,SUR,Selangor,21,16,5,Suriname
72890,7/1/2023,SVK,Johor,50,25,25,Slovakia
72891,7/1/2023,SVK,Kedah,55,29,26,Slovakia
72892,7/1/2023,SVK,Kelantan,2,2,0,Slovakia
72893,7/1/2023,SVK,Negeri Sembilan,1,1,0,Slovakia
72894,7/1/2023,SVK,Pahang,0,0,0,Slovakia
72895,7/1/2023,SVK,Perak,0,0,0,Slovakia
72896,7/1/2023,SVK,Perlis,1,1,0,Slovakia
72897,7/1/2023,SVK,Pulau Pinang,13,10,3,Slovakia
72898,7/1/2023,SVK,Sabah,0,0,0,Slovakia
72899,7/1/2023,SVK,Sarawak,3,1,2,Slovakia
72900,7/1/2023,SVK,Selangor,323,168,155,Slovakia
72901,7/1/2023,SVK,W.P. Labuan,9,4,5,Slovakia
72902,7/1/2023,SVN,Johor,25,13,12,Slovenia
72903,7/1/2023,SVN,Kedah,10,4,6,Slovenia
72904,7/1/2023,SVN,Kelantan,0,0,0,Slovenia
72905,7/1/2023,SVN,Perak,1,1,0,Slovenia
72906,7/1/2023,SVN,Perlis,0,0,0,Slovenia
72907,7/1/2023,SVN,Pulau Pinang,1,0,1,Slovenia
72908,7/1/2023,SVN,Sabah,12,7,5,Slovenia
72909,7/1/2023,SVN,Sarawak,1,1,0,Slovenia
72910,7/1/2023,SVN,Selangor,193,95,98,Slovenia
72911,7/1/2023,SVN,W.P. Labuan,0,0,0,Slovenia
72912,7/1/2023,SWE,Johor,270,154,116,Sweden
72913,7/1/2023,SWE,Kedah,42,26,16,Sweden
72914,7/1/2023,SWE,Kelantan,29,22,7,Sweden
72915,7/1/2023,SWE,Melaka,0,0,0,Sweden
72916,7/1/2023,SWE,Negeri Sembilan,0,0,0,Sweden
72917,7/1/2023,SWE,Pahang,0,0,0,Sweden
72918,7/1/2023,SWE,Perak,11,7,4,Sweden
72919,7/1/2023,SWE,Perlis,7,1,6,Sweden
72920,7/1/2023,SWE,Pulau Pinang,57,36,21,Sweden
72921,7/1/2023,SWE,Sabah,8,4,4,Sweden
72922,7/1/2023,SWE,Sarawak,19,11,8,Sweden
72923,7/1/2023,SWE,Selangor,1048,639,409,Sweden
72924,7/1/2023,SWE,W.P. Labuan,1,1,0,Sweden
72925,7/1/2023,SWZ,Johor,6,0,6,Swaziland
72926,7/1/2023,SWZ,Kedah,0,0,0,Swaziland
72927,7/1/2023,SWZ,Pulau Pinang,0,0,0,Swaziland
72928,7/1/2023,SWZ,Sabah,0,0,0,Swaziland
72929,7/1/2023,SWZ,Selangor,26,14,12,Swaziland
72930,7/1/2023,SYC,Johor,10,4,6,Seychelles
72931,7/1/2023,SYC,Kedah,0,0,0,Seychelles
72932,7/1/2023,SYC,Pulau Pinang,1,1,0,Seychelles
72933,7/1/2023,SYC,Sabah,0,0,0,Seychelles
72934,7/1/2023,SYC,Sarawak,0,0,0,Seychelles
72935,7/1/2023,SYC,Selangor,43,15,28,Seychelles
72936,7/1/2023,SYR,Johor,7,5,2,Syrian Arab Republic
72937,7/1/2023,SYR,Kedah,2,2,0,Syrian Arab Republic
72938,7/1/2023,SYR,Kelantan,0,0,0,Syrian Arab Republic
72939,7/1/2023,SYR,Pahang,0,0,0,Syrian Arab Republic
72940,7/1/2023,SYR,Perlis,1,1,0,Syrian Arab Republic
72941,7/1/2023,SYR,Pulau Pinang,2,2,0,Syrian Arab Republic
72942,7/1/2023,SYR,Sabah,0,0,0,Syrian Arab Republic
72943,7/1/2023,SYR,Sarawak,1,1,0,Syrian Arab Republic
72944,7/1/2023,SYR,Selangor,821,482,339,Syrian Arab Republic
72945,7/1/2023,SYR,W.P. Labuan,0,0,0,Syrian Arab Republic
72946,7/1/2023,TCA,Perlis,0,0,0,Turks and Caicos
72947,7/1/2023,TCD,Johor,14,12,2,Chad
72948,7/1/2023,TCD,Kedah,0,0,0,Chad
72949,7/1/2023,TCD,Perlis,0,0,0,Chad
72950,7/1/2023,TCD,Selangor,20,13,7,Chad
72951,7/1/2023,TGO,Johor,0,0,0,Togo
72952,7/1/2023,TGO,Perak,0,0,0,Togo
72953,7/1/2023,TGO,Pulau Pinang,0,0,0,Togo
72954,7/1/2023,TGO,Selangor,12,8,4,Togo
72955,7/1/2023,THA,Johor,6728,1755,4973,Thailand
72956,7/1/2023,THA,Kedah,62029,36453,25576,Thailand
72957,7/1/2023,THA,Kelantan,48622,26002,22620,Thailand
72958,7/1/2023,THA,Melaka,1,1,0,Thailand
72959,7/1/2023,THA,Negeri Sembilan,1,1,0,Thailand
72960,7/1/2023,THA,Pahang,16,13,3,Thailand
72961,7/1/2023,THA,Perak,12551,5742,6809,Thailand
72962,7/1/2023,THA,Perlis,60902,36177,24725,Thailand
72963,7/1/2023,THA,Pulau Pinang,2341,933,1408,Thailand
72964,7/1/2023,THA,Sabah,35,22,13,Thailand
72965,7/1/2023,THA,Sarawak,358,145,213,Thailand
72966,7/1/2023,THA,Selangor,17209,6989,10220,Thailand
72967,7/1/2023,THA,Terengganu,0,0,0,Thailand
72968,7/1/2023,THA,W.P. Labuan,3,0,3,Thailand
72969,7/1/2023,TJK,Johor,7,5,2,Tajikistan
72970,7/1/2023,TJK,Kedah,1,0,1,Tajikistan
72971,7/1/2023,TJK,Perlis,2,2,0,Tajikistan
72972,7/1/2023,TJK,Pulau Pinang,0,0,0,Tajikistan
72973,7/1/2023,TJK,Sabah,1,1,0,Tajikistan
72974,7/1/2023,TJK,Selangor,128,86,42,Tajikistan
72975,7/1/2023,TKL,Selangor,0,0,0,Tokelau
72976,7/1/2023,TKM,Johor,1,1,0,Turkmenistan
72977,7/1/2023,TKM,Kedah,2,2,0,Turkmenistan
72978,7/1/2023,TKM,Kelantan,0,0,0,Turkmenistan
72979,7/1/2023,TKM,Perlis,0,0,0,Turkmenistan
72980,7/1/2023,TKM,Pulau Pinang,0,0,0,Turkmenistan
72981,7/1/2023,TKM,Sabah,2,0,2,Turkmenistan
72982,7/1/2023,TKM,Sarawak,2,2,0,Turkmenistan
72983,7/1/2023,TKM,Selangor,142,83,59,Turkmenistan
72984,7/1/2023,TLS,Johor,9,3,6,Timor-Leste
72985,7/1/2023,TLS,Kedah,3,1,2,Timor-Leste
72986,7/1/2023,TLS,Perlis,1,1,0,Timor-Leste
72987,7/1/2023,TLS,Pulau Pinang,7,1,6,Timor-Leste
72988,7/1/2023,TLS,Sabah,0,0,0,Timor-Leste
72989,7/1/2023,TLS,Sarawak,3,1,2,Timor-Leste
72990,7/1/2023,TLS,Selangor,255,154,101,Timor-Leste
72991,7/1/2023,TON,Johor,0,0,0,Tonga
72992,7/1/2023,TON,Pulau Pinang,1,0,1,Tonga
72993,7/1/2023,TON,Sarawak,0,0,0,Tonga
72994,7/1/2023,TON,Selangor,9,7,2,Tonga
72995,7/1/2023,TTO,Johor,9,5,4,Trinidad and Tobago
72996,7/1/2023,TTO,Kedah,0,0,0,Trinidad and Tobago
72997,7/1/2023,TTO,Pahang,2,1,1,Trinidad and Tobago
72998,7/1/2023,TTO,Pulau Pinang,3,1,2,Trinidad and Tobago
72999,7/1/2023,TTO,Sabah,1,0,1,Trinidad and Tobago
73000,7/1/2023,TTO,Sarawak,5,3,2,Trinidad and Tobago
73001,7/1/2023,TTO,Selangor,56,28,28,Trinidad and Tobago
73002,7/1/2023,TUN,Johor,12,9,3,Tunisia
73003,7/1/2023,TUN,Kedah,5,4,1,Tunisia
73004,7/1/2023,TUN,Kelantan,0,0,0,Tunisia
73005,7/1/2023,TUN,Melaka,0,0,0,Tunisia
73006,7/1/2023,TUN,Perak,0,0,0,Tunisia
73007,7/1/2023,TUN,Perlis,0,0,0,Tunisia
73008,7/1/2023,TUN,Pulau Pinang,7,3,4,Tunisia
73009,7/1/2023,TUN,Sabah,0,0,0,Tunisia
73010,7/1/2023,TUN,Sarawak,0,0,0,Tunisia
73011,7/1/2023,TUN,Selangor,1070,511,559,Tunisia
73012,7/1/2023,TUN,W.P. Labuan,0,0,0,Tunisia
73013,7/1/2023,TUR,Johor,312,210,102,Turkey
73014,7/1/2023,TUR,Kedah,51,31,20,Turkey
73015,7/1/2023,TUR,Kelantan,6,5,1,Turkey
73016,7/1/2023,TUR,Melaka,1,1,0,Turkey
73017,7/1/2023,TUR,Negeri Sembilan,0,0,0,Turkey
73018,7/1/2023,TUR,Pahang,1,1,0,Turkey
73019,7/1/2023,TUR,Perak,2,2,0,Turkey
73020,7/1/2023,TUR,Perlis,19,16,3,Turkey
73021,7/1/2023,TUR,Pulau Pinang,47,33,14,Turkey
73022,7/1/2023,TUR,Sabah,4,3,1,Turkey
73023,7/1/2023,TUR,Sarawak,21,19,2,Turkey
73024,7/1/2023,TUR,Selangor,1401,914,487,Turkey
73025,7/1/2023,TUR,W.P. Labuan,0,0,0,Turkey
73026,7/1/2023,TUV,Selangor,0,0,0,Tuvalu
73027,7/1/2023,TWN,Johor,9966,4342,5624,Taiwan
73028,7/1/2023,TWN,Kedah,253,124,129,Taiwan
73029,7/1/2023,TWN,Kelantan,0,0,0,Taiwan
73030,7/1/2023,TWN,Melaka,4,2,2,Taiwan
73031,7/1/2023,TWN,Negeri Sembilan,0,0,0,Taiwan
73032,7/1/2023,TWN,Pahang,5,4,1,Taiwan
73033,7/1/2023,TWN,Perak,98,52,46,Taiwan
73034,7/1/2023,TWN,Perlis,19,7,12,Taiwan
73035,7/1/2023,TWN,Pulau Pinang,4955,2365,2590,Taiwan
73036,7/1/2023,TWN,Sabah,1614,781,833,Taiwan
73037,7/1/2023,TWN,Sarawak,343,147,196,Taiwan
73038,7/1/2023,TWN,Selangor,21828,10362,11466,Taiwan
73039,7/1/2023,TWN,W.P. Labuan,8,4,4,Taiwan
73040,7/1/2023,TZA,Johor,40,24,16,"Tanzania, United Republic of"
73041,7/1/2023,TZA,Kedah,2,1,1,"Tanzania, United Republic of"
73042,7/1/2023,TZA,Perak,0,0,0,"Tanzania, United Republic of"
73043,7/1/2023,TZA,Perlis,0,0,0,"Tanzania, United Republic of"
73044,7/1/2023,TZA,Pulau Pinang,0,0,0,"Tanzania, United Republic of"
73045,7/1/2023,TZA,Sabah,0,0,0,"Tanzania, United Republic of"
73046,7/1/2023,TZA,Sarawak,4,4,0,"Tanzania, United Republic of"
73047,7/1/2023,TZA,Selangor,209,103,106,"Tanzania, United Republic of"
73048,7/1/2023,UGA,Johor,12,5,7,Uganda
73049,7/1/2023,UGA,Kedah,3,1,2,Uganda
73050,7/1/2023,UGA,Perak,0,0,0,Uganda
73051,7/1/2023,UGA,Perlis,0,0,0,Uganda
73052,7/1/2023,UGA,Pulau Pinang,2,1,1,Uganda
73053,7/1/2023,UGA,Sabah,0,0,0,Uganda
73054,7/1/2023,UGA,Sarawak,0,0,0,Uganda
73055,7/1/2023,UGA,Selangor,134,70,64,Uganda
73056,7/1/2023,UKR,Johor,121,73,48,Ukraine
73057,7/1/2023,UKR,Kedah,15,7,8,Ukraine
73058,7/1/2023,UKR,Kelantan,2,1,1,Ukraine
73059,7/1/2023,UKR,Melaka,0,0,0,Ukraine
73060,7/1/2023,UKR,Negeri Sembilan,0,0,0,Ukraine
73061,7/1/2023,UKR,Pahang,2,2,0,Ukraine
73062,7/1/2023,UKR,Perak,0,0,0,Ukraine
73063,7/1/2023,UKR,Perlis,1,0,1,Ukraine
73064,7/1/2023,UKR,Pulau Pinang,29,16,13,Ukraine
73065,7/1/2023,UKR,Sabah,4,2,2,Ukraine
73066,7/1/2023,UKR,Sarawak,1,0,1,Ukraine
73067,7/1/2023,UKR,Selangor,841,438,403,Ukraine
73068,7/1/2023,UKR,W.P. Labuan,0,0,0,Ukraine
73069,7/1/2023,URY,Johor,4,0,4,Uruguay
73070,7/1/2023,URY,Kedah,1,1,0,Uruguay
73071,7/1/2023,URY,Kelantan,0,0,0,Uruguay
73072,7/1/2023,URY,Perak,0,0,0,Uruguay
73073,7/1/2023,URY,Perlis,0,0,0,Uruguay
73074,7/1/2023,URY,Pulau Pinang,2,0,2,Uruguay
73075,7/1/2023,URY,Sabah,0,0,0,Uruguay
73076,7/1/2023,URY,Sarawak,4,1,3,Uruguay
73077,7/1/2023,URY,Selangor,34,20,14,Uruguay
73078,7/1/2023,URY,W.P. Labuan,4,2,2,Uruguay
73079,7/1/2023,USA,Johor,5734,3183,2551,United States Of America
73080,7/1/2023,USA,Kedah,511,269,242,United States Of America
73081,7/1/2023,USA,Kelantan,12,7,5,United States Of America
73082,7/1/2023,USA,Melaka,1,1,0,United States Of America
73083,7/1/2023,USA,Negeri Sembilan,0,0,0,United States Of America
73084,7/1/2023,USA,Pahang,11,8,3,United States Of America
73085,7/1/2023,USA,Perak,195,90,105,United States Of America
73086,7/1/2023,USA,Perlis,145,91,54,United States Of America
73087,7/1/2023,USA,Pulau Pinang,2791,1564,1227,United States Of America
73088,7/1/2023,USA,Sabah,243,132,111,United States Of America
73089,7/1/2023,USA,Sarawak,304,176,128,United States Of America
73090,7/1/2023,USA,Selangor,18311,10343,7968,United States Of America
73091,7/1/2023,USA,Terengganu,0,0,0,United States Of America
73092,7/1/2023,USA,W.P. Labuan,5,1,4,United States Of America
73093,7/1/2023,UZB,Johor,101,79,22,Uzbekistan
73094,7/1/2023,UZB,Kedah,9,5,4,Uzbekistan
73095,7/1/2023,UZB,Kelantan,1,1,0,Uzbekistan
73096,7/1/2023,UZB,Perak,0,0,0,Uzbekistan
73097,7/1/2023,UZB,Perlis,1,1,0,Uzbekistan
73098,7/1/2023,UZB,Pulau Pinang,8,2,6,Uzbekistan
73099,7/1/2023,UZB,Sabah,5,5,0,Uzbekistan
73100,7/1/2023,UZB,Sarawak,4,2,2,Uzbekistan
73101,7/1/2023,UZB,Selangor,1554,915,639,Uzbekistan
73102,7/1/2023,VAT,Johor,0,0,0,Holy See (Vatican City State)
73103,7/1/2023,VAT,Sarawak,0,0,0,Holy See (Vatican City State)
73104,7/1/2023,VAT,Selangor,0,0,0,Holy See (Vatican City State)
73105,7/1/2023,VCT,Johor,1,0,1,Saint Vincent and the Grenadines
73106,7/1/2023,VCT,Kedah,0,0,0,Saint Vincent and the Grenadines
73107,7/1/2023,VCT,Pulau Pinang,0,0,0,Saint Vincent and the Grenadines
73108,7/1/2023,VCT,Sarawak,0,0,0,Saint Vincent and the Grenadines
73109,7/1/2023,VCT,Selangor,4,0,4,Saint Vincent and the Grenadines
73110,7/1/2023,VEN,Johor,20,9,11,Venezuela
73111,7/1/2023,VEN,Kedah,3,1,2,Venezuela
73112,7/1/2023,VEN,Kelantan,0,0,0,Venezuela
73113,7/1/2023,VEN,Melaka,0,0,0,Venezuela
73114,7/1/2023,VEN,Perak,0,0,0,Venezuela
73115,7/1/2023,VEN,Perlis,0,0,0,Venezuela
73116,7/1/2023,VEN,Pulau Pinang,1,1,0,Venezuela
73117,7/1/2023,VEN,Sabah,2,1,1,Venezuela
73118,7/1/2023,VEN,Sarawak,1,1,0,Venezuela
73119,7/1/2023,VEN,Selangor,108,58,50,Venezuela
73120,7/1/2023,VEN,W.P. Labuan,0,0,0,Venezuela
73121,7/1/2023,VNM,Johor,25253,9424,15829,Vietnam
73122,7/1/2023,VNM,Kedah,318,67,251,Vietnam
73123,7/1/2023,VNM,Kelantan,13,5,8,Vietnam
73124,7/1/2023,VNM,Melaka,3,0,3,Vietnam
73125,7/1/2023,VNM,Negeri Sembilan,0,0,0,Vietnam
73126,7/1/2023,VNM,Pahang,1,0,1,Vietnam
73127,7/1/2023,VNM,Perak,199,13,186,Vietnam
73128,7/1/2023,VNM,Perlis,233,23,210,Vietnam
73129,7/1/2023,VNM,Pulau Pinang,1975,632,1343,Vietnam
73130,7/1/2023,VNM,Sabah,15,6,9,Vietnam
73131,7/1/2023,VNM,Sarawak,197,45,152,Vietnam
73132,7/1/2023,VNM,Selangor,21579,8159,13420,Vietnam
73133,7/1/2023,VNM,Terengganu,0,0,0,Vietnam
73134,7/1/2023,VNM,W.P. Labuan,6,2,4,Vietnam
73135,7/1/2023,VUT,Johor,38,30,8,Vanuatu
73136,7/1/2023,VUT,Kedah,0,0,0,Vanuatu
73137,7/1/2023,VUT,Pulau Pinang,4,3,1,Vanuatu
73138,7/1/2023,VUT,Sabah,0,0,0,Vanuatu
73139,7/1/2023,VUT,Sarawak,1,0,1,Vanuatu
73140,7/1/2023,VUT,Selangor,59,46,13,Vanuatu
73141,7/1/2023,WSM,Johor,3,3,0,Samoa
73142,7/1/2023,WSM,Sarawak,0,0,0,Samoa
73143,7/1/2023,WSM,Selangor,6,0,6,Samoa
73144,7/1/2023,YEM,Johor,37,22,15,Yemen
73145,7/1/2023,YEM,Kedah,2,1,1,Yemen
73146,7/1/2023,YEM,Kelantan,1,1,0,Yemen
73147,7/1/2023,YEM,Melaka,0,0,0,Yemen
73148,7/1/2023,YEM,Pahang,0,0,0,Yemen
73149,7/1/2023,YEM,Perak,0,0,0,Yemen
73150,7/1/2023,YEM,Perlis,2,2,0,Yemen
73151,7/1/2023,YEM,Pulau Pinang,1,1,0,Yemen
73152,7/1/2023,YEM,Sabah,0,0,0,Yemen
73153,7/1/2023,YEM,Sarawak,2,0,2,Yemen
73154,7/1/2023,YEM,Selangor,1570,991,579,Yemen
73155,7/1/2023,YEM,W.P. Labuan,0,0,0,Yemen
73156,7/1/2023,ZAF,Johor,317,172,145,South Africa
73157,7/1/2023,ZAF,Kedah,36,19,17,South Africa
73158,7/1/2023,ZAF,Kelantan,0,0,0,South Africa
73159,7/1/2023,ZAF,Melaka,0,0,0,South Africa
73160,7/1/2023,ZAF,Pahang,3,2,1,South Africa
73161,7/1/2023,ZAF,Perak,2,2,0,South Africa
73162,7/1/2023,ZAF,Perlis,17,14,3,South Africa
73163,7/1/2023,ZAF,Pulau Pinang,67,32,35,South Africa
73164,7/1/2023,ZAF,Sabah,15,8,7,South Africa
73165,7/1/2023,ZAF,Sarawak,80,42,38,South Africa
73166,7/1/2023,ZAF,Selangor,1235,706,529,South Africa
73167,7/1/2023,ZAF,Terengganu,0,0,0,South Africa
73168,7/1/2023,ZAF,W.P. Labuan,1,1,0,South Africa
73169,7/1/2023,ZMB,Johor,3,2,1,Zambia
73170,7/1/2023,ZMB,Kedah,5,3,2,Zambia
73171,7/1/2023,ZMB,Perak,0,0,0,Zambia
73172,7/1/2023,ZMB,Perlis,0,0,0,Zambia
73173,7/1/2023,ZMB,Pulau Pinang,0,0,0,Zambia
73174,7/1/2023,ZMB,Sabah,0,0,0,Zambia
73175,7/1/2023,ZMB,Sarawak,0,0,0,Zambia
73176,7/1/2023,ZMB,Selangor,51,28,23,Zambia
73177,7/1/2023,ZWE,Johor,17,7,10,Zimbabwe
73178,7/1/2023,ZWE,Kedah,3,2,1,Zimbabwe
73179,7/1/2023,ZWE,Kelantan,0,0,0,Zimbabwe
73180,7/1/2023,ZWE,Perak,0,0,0,Zimbabwe
73181,7/1/2023,ZWE,Perlis,0,0,0,Zimbabwe
73182,7/1/2023,ZWE,Pulau Pinang,0,0,0,Zimbabwe
73183,7/1/2023,ZWE,Sabah,1,1,0,Zimbabwe
73184,7/1/2023,ZWE,Sarawak,1,1,0,Zimbabwe
73185,7/1/2023,ZWE,Selangor,209,88,121,Zimbabwe
73186,8/1/2023,ABW,Kedah,0,0,0,Aruba
73187,8/1/2023,ABW,Pulau Pinang,0,0,0,Aruba
73188,8/1/2023,AFG,Johor,0,0,0,Afghanistan
73189,8/1/2023,AFG,Kedah,0,0,0,Afghanistan
73190,8/1/2023,AFG,Perlis,0,0,0,Afghanistan
73191,8/1/2023,AFG,Pulau Pinang,0,0,0,Afghanistan
73192,8/1/2023,AFG,Sarawak,1,1,0,Afghanistan
73193,8/1/2023,AFG,Selangor,93,62,31,Afghanistan
73194,8/1/2023,AGO,Johor,0,0,0,Angola
73195,8/1/2023,AGO,Kedah,0,0,0,Angola
73196,8/1/2023,AGO,Sabah,0,0,0,Angola
73197,8/1/2023,AGO,Selangor,4,3,1,Angola
73198,8/1/2023,AIA,Selangor,0,0,0,Anguilla
73199,8/1/2023,ALB,Johor,18,14,4,Albania
73200,8/1/2023,ALB,Kedah,0,0,0,Albania
73201,8/1/2023,ALB,Perak,1,1,0,Albania
73202,8/1/2023,ALB,Perlis,0,0,0,Albania
73203,8/1/2023,ALB,Pulau Pinang,0,0,0,Albania
73204,8/1/2023,ALB,Sabah,0,0,0,Albania
73205,8/1/2023,ALB,Sarawak,0,0,0,Albania
73206,8/1/2023,ALB,Selangor,49,27,22,Albania
73207,8/1/2023,AND,Johor,1,0,1,Andorra
73208,8/1/2023,AND,Kedah,1,0,1,Andorra
73209,8/1/2023,AND,Perlis,0,0,0,Andorra
73210,8/1/2023,AND,Pulau Pinang,1,1,0,Andorra
73211,8/1/2023,AND,Selangor,14,7,7,Andorra
73212,8/1/2023,ANT,Selangor,0,0,0,Netherlands Antilles
73213,8/1/2023,ARE,Johor,73,34,39,United Arab Emirates
73214,8/1/2023,ARE,Kedah,21,10,11,United Arab Emirates
73215,8/1/2023,ARE,Kelantan,0,0,0,United Arab Emirates
73216,8/1/2023,ARE,Perak,0,0,0,United Arab Emirates
73217,8/1/2023,ARE,Perlis,0,0,0,United Arab Emirates
73218,8/1/2023,ARE,Pulau Pinang,16,6,10,United Arab Emirates
73219,8/1/2023,ARE,Sabah,0,0,0,United Arab Emirates
73220,8/1/2023,ARE,Sarawak,0,0,0,United Arab Emirates
73221,8/1/2023,ARE,Selangor,1408,741,667,United Arab Emirates
73222,8/1/2023,ARG,Johor,98,59,39,Argentina
73223,8/1/2023,ARG,Kedah,14,8,6,Argentina
73224,8/1/2023,ARG,Kelantan,0,0,0,Argentina
73225,8/1/2023,ARG,Melaka,0,0,0,Argentina
73226,8/1/2023,ARG,Perak,2,1,1,Argentina
73227,8/1/2023,ARG,Perlis,3,0,3,Argentina
73228,8/1/2023,ARG,Pulau Pinang,12,9,3,Argentina
73229,8/1/2023,ARG,Sabah,0,0,0,Argentina
73230,8/1/2023,ARG,Sarawak,2,2,0,Argentina
73231,8/1/2023,ARG,Selangor,353,177,176,Argentina
73232,8/1/2023,ARG,W.P. Labuan,0,0,0,Argentina
73233,8/1/2023,ARM,Johor,1,0,1,Armenia
73234,8/1/2023,ARM,Kedah,1,1,0,Armenia
73235,8/1/2023,ARM,Kelantan,0,0,0,Armenia
73236,8/1/2023,ARM,Perak,0,0,0,Armenia
73237,8/1/2023,ARM,Perlis,0,0,0,Armenia
73238,8/1/2023,ARM,Pulau Pinang,3,1,2,Armenia
73239,8/1/2023,ARM,Sabah,0,0,0,Armenia
73240,8/1/2023,ARM,Sarawak,0,0,0,Armenia
73241,8/1/2023,ARM,Selangor,49,25,24,Armenia
73242,8/1/2023,ATA,Selangor,0,0,0,Antarctica
73243,8/1/2023,ATG,Johor,12,7,5,Antigua and Barbuda
73244,8/1/2023,ATG,Kedah,0,0,0,Antigua and Barbuda
73245,8/1/2023,ATG,Pulau Pinang,0,0,0,Antigua and Barbuda
73246,8/1/2023,ATG,Sarawak,0,0,0,Antigua and Barbuda
73247,8/1/2023,ATG,Selangor,26,14,12,Antigua and Barbuda
73248,8/1/2023,AUS,Johor,4669,2730,1939,Australia
73249,8/1/2023,AUS,Kedah,454,247,207,Australia
73250,8/1/2023,AUS,Kelantan,6,3,3,Australia
73251,8/1/2023,AUS,Melaka,1,1,0,Australia
73252,8/1/2023,AUS,Negeri Sembilan,1,1,0,Australia
73253,8/1/2023,AUS,Pahang,19,13,6,Australia
73254,8/1/2023,AUS,Perak,205,105,100,Australia
73255,8/1/2023,AUS,Perlis,183,143,40,Australia
73256,8/1/2023,AUS,Pulau Pinang,1896,1014,882,Australia
73257,8/1/2023,AUS,Sabah,50,30,20,Australia
73258,8/1/2023,AUS,Sarawak,452,278,174,Australia
73259,8/1/2023,AUS,Selangor,20995,12471,8524,Australia
73260,8/1/2023,AUS,Terengganu,0,0,0,Australia
73261,8/1/2023,AUS,W.P. Labuan,9,6,3,Australia
73262,8/1/2023,AUT,Johor,288,185,103,Austria
73263,8/1/2023,AUT,Kedah,56,32,24,Austria
73264,8/1/2023,AUT,Kelantan,2,2,0,Austria
73265,8/1/2023,AUT,Melaka,0,0,0,Austria
73266,8/1/2023,AUT,Negeri Sembilan,0,0,0,Austria
73267,8/1/2023,AUT,Pahang,1,1,0,Austria
73268,8/1/2023,AUT,Perak,4,3,1,Austria
73269,8/1/2023,AUT,Perlis,23,9,14,Austria
73270,8/1/2023,AUT,Pulau Pinang,80,53,27,Austria
73271,8/1/2023,AUT,Sabah,5,3,2,Austria
73272,8/1/2023,AUT,Sarawak,20,10,10,Austria
73273,8/1/2023,AUT,Selangor,1087,649,438,Austria
73274,8/1/2023,AUT,Terengganu,0,0,0,Austria
73275,8/1/2023,AUT,W.P. Labuan,1,1,0,Austria
73276,8/1/2023,AZE,Johor,3,0,3,Azerbaijan
73277,8/1/2023,AZE,Kedah,3,2,1,Azerbaijan
73278,8/1/2023,AZE,Kelantan,1,1,0,Azerbaijan
73279,8/1/2023,AZE,Melaka,0,0,0,Azerbaijan
73280,8/1/2023,AZE,Perlis,0,0,0,Azerbaijan
73281,8/1/2023,AZE,Pulau Pinang,0,0,0,Azerbaijan
73282,8/1/2023,AZE,Sabah,0,0,0,Azerbaijan
73283,8/1/2023,AZE,Sarawak,2,1,1,Azerbaijan
73284,8/1/2023,AZE,Selangor,130,70,60,Azerbaijan
73285,8/1/2023,AZE,W.P. Labuan,0,0,0,Azerbaijan
73286,8/1/2023,BDI,Pulau Pinang,0,0,0,Burundi
73287,8/1/2023,BDI,Sarawak,0,0,0,Burundi
73288,8/1/2023,BDI,Selangor,3,1,2,Burundi
73289,8/1/2023,BEL,Johor,350,193,157,Belgium
73290,8/1/2023,BEL,Kedah,44,19,25,Belgium
73291,8/1/2023,BEL,Kelantan,2,1,1,Belgium
73292,8/1/2023,BEL,Melaka,0,0,0,Belgium
73293,8/1/2023,BEL,Negeri Sembilan,0,0,0,Belgium
73294,8/1/2023,BEL,Pahang,1,1,0,Belgium
73295,8/1/2023,BEL,Perak,10,1,9,Belgium
73296,8/1/2023,BEL,Perlis,19,13,6,Belgium
73297,8/1/2023,BEL,Pulau Pinang,79,55,24,Belgium
73298,8/1/2023,BEL,Sabah,10,5,5,Belgium
73299,8/1/2023,BEL,Sarawak,35,19,16,Belgium
73300,8/1/2023,BEL,Selangor,1787,961,826,Belgium
73301,8/1/2023,BEL,W.P. Labuan,0,0,0,Belgium
73302,8/1/2023,BEN,Johor,0,0,0,Benin
73303,8/1/2023,BEN,Kedah,0,0,0,Benin
73304,8/1/2023,BEN,Perak,0,0,0,Benin
73305,8/1/2023,BEN,Pulau Pinang,1,1,0,Benin
73306,8/1/2023,BEN,Sabah,0,0,0,Benin
73307,8/1/2023,BEN,Sarawak,0,0,0,Benin
73308,8/1/2023,BEN,Selangor,7,6,1,Benin
73309,8/1/2023,BFA,Perak,0,0,0,Burkina Faso
73310,8/1/2023,BFA,Pulau Pinang,0,0,0,Burkina Faso
73311,8/1/2023,BFA,Selangor,8,7,1,Burkina Faso
73312,8/1/2023,BGD,Johor,3822,3262,560,Bangladesh
73313,8/1/2023,BGD,Kedah,108,70,38,Bangladesh
73314,8/1/2023,BGD,Kelantan,8,8,0,Bangladesh
73315,8/1/2023,BGD,Melaka,0,0,0,Bangladesh
73316,8/1/2023,BGD,Negeri Sembilan,0,0,0,Bangladesh
73317,8/1/2023,BGD,Pahang,0,0,0,Bangladesh
73318,8/1/2023,BGD,Perak,4,3,1,Bangladesh
73319,8/1/2023,BGD,Perlis,3,3,0,Bangladesh
73320,8/1/2023,BGD,Pulau Pinang,688,646,42,Bangladesh
73321,8/1/2023,BGD,Sabah,0,0,0,Bangladesh
73322,8/1/2023,BGD,Sarawak,61,51,10,Bangladesh
73323,8/1/2023,BGD,Selangor,70816,68473,2343,Bangladesh
73324,8/1/2023,BGD,W.P. Labuan,4,4,0,Bangladesh
73325,8/1/2023,BGR,Johor,42,24,18,Bulgaria
73326,8/1/2023,BGR,Kedah,8,4,4,Bulgaria
73327,8/1/2023,BGR,Kelantan,0,0,0,Bulgaria
73328,8/1/2023,BGR,Pahang,0,0,0,Bulgaria
73329,8/1/2023,BGR,Perak,0,0,0,Bulgaria
73330,8/1/2023,BGR,Perlis,0,0,0,Bulgaria
73331,8/1/2023,BGR,Pulau Pinang,6,3,3,Bulgaria
73332,8/1/2023,BGR,Sabah,0,0,0,Bulgaria
73333,8/1/2023,BGR,Sarawak,0,0,0,Bulgaria
73334,8/1/2023,BGR,Selangor,193,105,88,Bulgaria
73335,8/1/2023,BGR,W.P. Labuan,0,0,0,Bulgaria
73336,8/1/2023,BHR,Johor,52,17,35,Bahrain
73337,8/1/2023,BHR,Kedah,3,2,1,Bahrain
73338,8/1/2023,BHR,Kelantan,0,0,0,Bahrain
73339,8/1/2023,BHR,Perlis,1,1,0,Bahrain
73340,8/1/2023,BHR,Pulau Pinang,9,5,4,Bahrain
73341,8/1/2023,BHR,Sabah,0,0,0,Bahrain
73342,8/1/2023,BHR,Sarawak,1,1,0,Bahrain
73343,8/1/2023,BHR,Selangor,542,273,269,Bahrain
73344,8/1/2023,BHS,Johor,1,1,0,Bahamas
73345,8/1/2023,BHS,Kedah,0,0,0,Bahamas
73346,8/1/2023,BHS,Perak,0,0,0,Bahamas
73347,8/1/2023,BHS,Sabah,0,0,0,Bahamas
73348,8/1/2023,BHS,Sarawak,0,0,0,Bahamas
73349,8/1/2023,BHS,Selangor,2,0,2,Bahamas
73350,8/1/2023,BIH,Johor,4,2,2,Bosnia and Herzegovina
73351,8/1/2023,BIH,Kedah,1,0,1,Bosnia and Herzegovina
73352,8/1/2023,BIH,Perlis,0,0,0,Bosnia and Herzegovina
73353,8/1/2023,BIH,Pulau Pinang,0,0,0,Bosnia and Herzegovina
73354,8/1/2023,BIH,Sabah,0,0,0,Bosnia and Herzegovina
73355,8/1/2023,BIH,Sarawak,1,1,0,Bosnia and Herzegovina
73356,8/1/2023,BIH,Selangor,46,30,16,Bosnia and Herzegovina
73357,8/1/2023,BLR,Johor,22,10,12,Belarus
73358,8/1/2023,BLR,Kedah,8,5,3,Belarus
73359,8/1/2023,BLR,Kelantan,1,0,1,Belarus
73360,8/1/2023,BLR,Pahang,0,0,0,Belarus
73361,8/1/2023,BLR,Perak,0,0,0,Belarus
73362,8/1/2023,BLR,Perlis,0,0,0,Belarus
73363,8/1/2023,BLR,Pulau Pinang,5,2,3,Belarus
73364,8/1/2023,BLR,Sabah,0,0,0,Belarus
73365,8/1/2023,BLR,Sarawak,3,1,2,Belarus
73366,8/1/2023,BLR,Selangor,243,109,134,Belarus
73367,8/1/2023,BLR,W.P. Labuan,0,0,0,Belarus
73368,8/1/2023,BLZ,Johor,1,0,1,Belize
73369,8/1/2023,BLZ,Pulau Pinang,0,0,0,Belize
73370,8/1/2023,BLZ,Sarawak,0,0,0,Belize
73371,8/1/2023,BLZ,Selangor,14,8,6,Belize
73372,8/1/2023,BMU,Selangor,1,0,1,Bermuda
73373,8/1/2023,BOL,Johor,13,6,7,Bolivia
73374,8/1/2023,BOL,Kedah,2,0,2,Bolivia
73375,8/1/2023,BOL,Melaka,0,0,0,Bolivia
73376,8/1/2023,BOL,Perak,0,0,0,Bolivia
73377,8/1/2023,BOL,Perlis,0,0,0,Bolivia
73378,8/1/2023,BOL,Pulau Pinang,0,0,0,Bolivia
73379,8/1/2023,BOL,Sabah,0,0,0,Bolivia
73380,8/1/2023,BOL,Sarawak,1,1,0,Bolivia
73381,8/1/2023,BOL,Selangor,24,12,12,Bolivia
73382,8/1/2023,BRA,Johor,308,177,131,Brazil
73383,8/1/2023,BRA,Kedah,35,18,17,Brazil
73384,8/1/2023,BRA,Kelantan,0,0,0,Brazil
73385,8/1/2023,BRA,Melaka,2,2,0,Brazil
73386,8/1/2023,BRA,Pahang,0,0,0,Brazil
73387,8/1/2023,BRA,Perak,2,1,1,Brazil
73388,8/1/2023,BRA,Perlis,5,1,4,Brazil
73389,8/1/2023,BRA,Pulau Pinang,24,15,9,Brazil
73390,8/1/2023,BRA,Sabah,4,3,1,Brazil
73391,8/1/2023,BRA,Sarawak,10,5,5,Brazil
73392,8/1/2023,BRA,Selangor,914,519,395,Brazil
73393,8/1/2023,BRA,W.P. Labuan,0,0,0,Brazil
73394,8/1/2023,BRB,Johor,0,0,0,Barbados
73395,8/1/2023,BRB,Kedah,0,0,0,Barbados
73396,8/1/2023,BRB,Perlis,0,0,0,Barbados
73397,8/1/2023,BRB,Pulau Pinang,0,0,0,Barbados
73398,8/1/2023,BRB,Selangor,5,3,2,Barbados
73399,8/1/2023,BRN,Johor,790,379,411,Brunei Darussalam
73400,8/1/2023,BRN,Kedah,58,24,34,Brunei Darussalam
73401,8/1/2023,BRN,Kelantan,15,12,3,Brunei Darussalam
73402,8/1/2023,BRN,Melaka,0,0,0,Brunei Darussalam
73403,8/1/2023,BRN,Pahang,1,1,0,Brunei Darussalam
73404,8/1/2023,BRN,Perak,1,1,0,Brunei Darussalam
73405,8/1/2023,BRN,Perlis,38,23,15,Brunei Darussalam
73406,8/1/2023,BRN,Pulau Pinang,9,3,6,Brunei Darussalam
73407,8/1/2023,BRN,Sabah,180,82,98,Brunei Darussalam
73408,8/1/2023,BRN,Sarawak,67279,36829,30450,Brunei Darussalam
73409,8/1/2023,BRN,Selangor,6508,3205,3303,Brunei Darussalam
73410,8/1/2023,BRN,W.P. Labuan,1791,1120,671,Brunei Darussalam
73411,8/1/2023,BTN,Johor,14,9,5,Bhutan
73412,8/1/2023,BTN,Kedah,0,0,0,Bhutan
73413,8/1/2023,BTN,Perak,1,1,0,Bhutan
73414,8/1/2023,BTN,Perlis,2,1,1,Bhutan
73415,8/1/2023,BTN,Pulau Pinang,0,0,0,Bhutan
73416,8/1/2023,BTN,Sabah,0,0,0,Bhutan
73417,8/1/2023,BTN,Sarawak,1,1,0,Bhutan
73418,8/1/2023,BTN,Selangor,73,36,37,Bhutan
73419,8/1/2023,BWA,Johor,0,0,0,Botswana
73420,8/1/2023,BWA,Kedah,4,2,2,Botswana
73421,8/1/2023,BWA,Perlis,0,0,0,Botswana
73422,8/1/2023,BWA,Pulau Pinang,0,0,0,Botswana
73423,8/1/2023,BWA,Sabah,0,0,0,Botswana
73424,8/1/2023,BWA,Sarawak,0,0,0,Botswana
73425,8/1/2023,BWA,Selangor,11,4,7,Botswana
73426,8/1/2023,CAF,Kedah,0,0,0,Central African Republic
73427,8/1/2023,CAF,Selangor,4,3,1,Central African Republic
73428,8/1/2023,CAN,Johor,1600,892,708,Canada
73429,8/1/2023,CAN,Kedah,129,77,52,Canada
73430,8/1/2023,CAN,Kelantan,4,3,1,Canada
73431,8/1/2023,CAN,Melaka,0,0,0,Canada
73432,8/1/2023,CAN,Negeri Sembilan,0,0,0,Canada
73433,8/1/2023,CAN,Pahang,2,1,1,Canada
73434,8/1/2023,CAN,Perak,59,33,26,Canada
73435,8/1/2023,CAN,Perlis,29,18,11,Canada
73436,8/1/2023,CAN,Pulau Pinang,484,271,213,Canada
73437,8/1/2023,CAN,Sabah,29,20,9,Canada
73438,8/1/2023,CAN,Sarawak,204,119,85,Canada
73439,8/1/2023,CAN,Selangor,4144,2374,1770,Canada
73440,8/1/2023,CAN,Terengganu,0,0,0,Canada
73441,8/1/2023,CAN,W.P. Labuan,2,2,0,Canada
73442,8/1/2023,CCK,Selangor,0,0,0,Cocos (Keeling) Islands
73443,8/1/2023,CHE,Johor,514,288,226,Switzerland
73444,8/1/2023,CHE,Kedah,76,40,36,Switzerland
73445,8/1/2023,CHE,Kelantan,8,4,4,Switzerland
73446,8/1/2023,CHE,Melaka,0,0,0,Switzerland
73447,8/1/2023,CHE,Negeri Sembilan,1,1,0,Switzerland
73448,8/1/2023,CHE,Pahang,1,1,0,Switzerland
73449,8/1/2023,CHE,Perak,3,3,0,Switzerland
73450,8/1/2023,CHE,Perlis,39,26,13,Switzerland
73451,8/1/2023,CHE,Pulau Pinang,103,63,40,Switzerland
73452,8/1/2023,CHE,Sabah,18,13,5,Switzerland
73453,8/1/2023,CHE,Sarawak,26,13,13,Switzerland
73454,8/1/2023,CHE,Selangor,1612,935,677,Switzerland
73455,8/1/2023,CHE,W.P. Labuan,2,1,1,Switzerland
73456,8/1/2023,CHL,Johor,50,29,21,Chile
73457,8/1/2023,CHL,Kedah,15,9,6,Chile
73458,8/1/2023,CHL,Kelantan,2,1,1,Chile
73459,8/1/2023,CHL,Melaka,0,0,0,Chile
73460,8/1/2023,CHL,Pahang,0,0,0,Chile
73461,8/1/2023,CHL,Perak,0,0,0,Chile
73462,8/1/2023,CHL,Perlis,4,4,0,Chile
73463,8/1/2023,CHL,Pulau Pinang,6,3,3,Chile
73464,8/1/2023,CHL,Sabah,0,0,0,Chile
73465,8/1/2023,CHL,Sarawak,2,1,1,Chile
73466,8/1/2023,CHL,Selangor,294,147,147,Chile
73467,8/1/2023,CHN,Johor,58998,25424,33574,China
73468,8/1/2023,CHN,Kedah,1902,827,1075,China
73469,8/1/2023,CHN,Kelantan,3,1,2,China
73470,8/1/2023,CHN,Melaka,4,4,0,China
73471,8/1/2023,CHN,Pahang,36,25,11,China
73472,8/1/2023,CHN,Perak,282,123,159,China
73473,8/1/2023,CHN,Perlis,140,56,84,China
73474,8/1/2023,CHN,Pulau Pinang,10924,5864,5060,China
73475,8/1/2023,CHN,Sabah,2288,1075,1213,China
73476,8/1/2023,CHN,Sarawak,1048,497,551,China
73477,8/1/2023,CHN,Selangor,130284,63643,66641,China
73478,8/1/2023,CHN,Terengganu,0,0,0,China
73479,8/1/2023,CHN,W.P. Labuan,33,26,7,China
73480,8/1/2023,CIV,Johor,6,6,0,C��te d'Iv
73481,8/1/2023,CIV,Kedah,0,0,0,C��te d'Iv
73482,8/1/2023,CIV,Pulau Pinang,0,0,0,C��te d'Iv
73483,8/1/2023,CIV,Sabah,0,0,0,C��te d'Iv
73484,8/1/2023,CIV,Sarawak,0,0,0,C��te d'Iv
73485,8/1/2023,CIV,Selangor,38,27,11,C��te d'Iv
73486,8/1/2023,CMR,Johor,0,0,0,Cameroon
73487,8/1/2023,CMR,Kedah,6,3,3,Cameroon
73488,8/1/2023,CMR,Pulau Pinang,2,1,1,Cameroon
73489,8/1/2023,CMR,Sabah,0,0,0,Cameroon
73490,8/1/2023,CMR,Sarawak,0,0,0,Cameroon
73491,8/1/2023,CMR,Selangor,28,16,12,Cameroon
73492,8/1/2023,COD,Johor,1,1,0,"Congo, the Democratic Republic of the"
73493,8/1/2023,COD,Pulau Pinang,0,0,0,"Congo, the Democratic Republic of the"
73494,8/1/2023,COD,Sarawak,0,0,0,"Congo, the Democratic Republic of the"
73495,8/1/2023,COD,Selangor,15,9,6,"Congo, the Democratic Republic of the"
73496,8/1/2023,COG,Johor,0,0,0,Congo
73497,8/1/2023,COG,Kedah,0,0,0,Congo
73498,8/1/2023,COG,Selangor,4,2,2,Congo
73499,8/1/2023,COK,Selangor,0,0,0,Cook Islands
73500,8/1/2023,COL,Johor,43,20,23,Colombia
73501,8/1/2023,COL,Kedah,0,0,0,Colombia
73502,8/1/2023,COL,Perak,1,0,1,Colombia
73503,8/1/2023,COL,Pulau Pinang,6,2,4,Colombia
73504,8/1/2023,COL,Sabah,2,1,1,Colombia
73505,8/1/2023,COL,Sarawak,5,4,1,Colombia
73506,8/1/2023,COL,Selangor,184,102,82,Colombia
73507,8/1/2023,COL,W.P. Labuan,0,0,0,Colombia
73508,8/1/2023,COM,Johor,2,2,0,Comoros
73509,8/1/2023,COM,Kedah,0,0,0,Comoros
73510,8/1/2023,COM,Selangor,20,10,10,Comoros
73511,8/1/2023,CPV,Johor,0,0,0,Cape Verde
73512,8/1/2023,CPV,Kedah,0,0,0,Cape Verde
73513,8/1/2023,CPV,Pulau Pinang,0,0,0,Cape Verde
73514,8/1/2023,CPV,Sabah,0,0,0,Cape Verde
73515,8/1/2023,CPV,Selangor,7,4,3,Cape Verde
73516,8/1/2023,CRI,Johor,15,9,6,Costa Rica
73517,8/1/2023,CRI,Kedah,0,0,0,Costa Rica
73518,8/1/2023,CRI,Perak,0,0,0,Costa Rica
73519,8/1/2023,CRI,Perlis,0,0,0,Costa Rica
73520,8/1/2023,CRI,Pulau Pinang,8,6,2,Costa Rica
73521,8/1/2023,CRI,Sabah,0,0,0,Costa Rica
73522,8/1/2023,CRI,Sarawak,1,1,0,Costa Rica
73523,8/1/2023,CRI,Selangor,58,34,24,Costa Rica
73524,8/1/2023,CUB,Johor,9,8,1,Cuba
73525,8/1/2023,CUB,Kedah,0,0,0,Cuba
73526,8/1/2023,CUB,Perlis,0,0,0,Cuba
73527,8/1/2023,CUB,Pulau Pinang,0,0,0,Cuba
73528,8/1/2023,CUB,Sabah,0,0,0,Cuba
73529,8/1/2023,CUB,Sarawak,0,0,0,Cuba
73530,8/1/2023,CUB,Selangor,24,14,10,Cuba
73531,8/1/2023,CYP,Johor,11,7,4,Cyprus
73532,8/1/2023,CYP,Kedah,6,4,2,Cyprus
73533,8/1/2023,CYP,Perak,0,0,0,Cyprus
73534,8/1/2023,CYP,Perlis,0,0,0,Cyprus
73535,8/1/2023,CYP,Pulau Pinang,1,0,1,Cyprus
73536,8/1/2023,CYP,Sabah,0,0,0,Cyprus
73537,8/1/2023,CYP,Sarawak,0,0,0,Cyprus
73538,8/1/2023,CYP,Selangor,125,78,47,Cyprus
73539,8/1/2023,CZE,Johor,119,62,57,Czech Republic
73540,8/1/2023,CZE,Kedah,24,11,13,Czech Republic
73541,8/1/2023,CZE,Kelantan,2,2,0,Czech Republic
73542,8/1/2023,CZE,Melaka,0,0,0,Czech Republic
73543,8/1/2023,CZE,Negeri Sembilan,0,0,0,Czech Republic
73544,8/1/2023,CZE,Perak,6,3,3,Czech Republic
73545,8/1/2023,CZE,Perlis,5,2,3,Czech Republic
73546,8/1/2023,CZE,Pulau Pinang,13,8,5,Czech Republic
73547,8/1/2023,CZE,Sabah,3,2,1,Czech Republic
73548,8/1/2023,CZE,Sarawak,20,10,10,Czech Republic
73549,8/1/2023,CZE,Selangor,479,250,229,Czech Republic
73550,8/1/2023,CZE,W.P. Labuan,0,0,0,Czech Republic
73551,8/1/2023,DEU,Johor,2781,1665,1116,Germany
73552,8/1/2023,DEU,Kedah,378,200,178,Germany
73553,8/1/2023,DEU,Kelantan,10,8,2,Germany
73554,8/1/2023,DEU,Melaka,6,1,5,Germany
73555,8/1/2023,DEU,Negeri Sembilan,1,0,1,Germany
73556,8/1/2023,DEU,Pahang,16,11,5,Germany
73557,8/1/2023,DEU,Perak,41,23,18,Germany
73558,8/1/2023,DEU,Perlis,115,59,56,Germany
73559,8/1/2023,DEU,Pulau Pinang,833,537,296,Germany
73560,8/1/2023,DEU,Sabah,31,17,14,Germany
73561,8/1/2023,DEU,Sarawak,294,165,129,Germany
73562,8/1/2023,DEU,Selangor,8639,4935,3704,Germany
73563,8/1/2023,DEU,Terengganu,0,0,0,Germany
73564,8/1/2023,DEU,W.P. Labuan,7,4,3,Germany
73565,8/1/2023,DJI,Johor,0,0,0,Djibouti
73566,8/1/2023,DJI,Selangor,10,5,5,Djibouti
73567,8/1/2023,DMA,Johor,10,7,3,Dominica
73568,8/1/2023,DMA,Kedah,0,0,0,Dominica
73569,8/1/2023,DMA,Pulau Pinang,1,1,0,Dominica
73570,8/1/2023,DMA,Sabah,0,0,0,Dominica
73571,8/1/2023,DMA,Sarawak,0,0,0,Dominica
73572,8/1/2023,DMA,Selangor,46,32,14,Dominica
73573,8/1/2023,DMA,W.P. Labuan,0,0,0,Dominica
73574,8/1/2023,DNK,Johor,265,190,75,Denmark
73575,8/1/2023,DNK,Kedah,32,18,14,Denmark
73576,8/1/2023,DNK,Kelantan,2,1,1,Denmark
73577,8/1/2023,DNK,Melaka,0,0,0,Denmark
73578,8/1/2023,DNK,Negeri Sembilan,0,0,0,Denmark
73579,8/1/2023,DNK,Pahang,0,0,0,Denmark
73580,8/1/2023,DNK,Perak,1,1,0,Denmark
73581,8/1/2023,DNK,Perlis,2,2,0,Denmark
73582,8/1/2023,DNK,Pulau Pinang,41,29,12,Denmark
73583,8/1/2023,DNK,Sabah,4,3,1,Denmark
73584,8/1/2023,DNK,Sarawak,23,13,10,Denmark
73585,8/1/2023,DNK,Selangor,824,482,342,Denmark
73586,8/1/2023,DNK,W.P. Labuan,0,0,0,Denmark
73587,8/1/2023,DOM,Johor,2,1,1,Dominican Republic
73588,8/1/2023,DOM,Kedah,1,0,1,Dominican Republic
73589,8/1/2023,DOM,Perak,0,0,0,Dominican Republic
73590,8/1/2023,DOM,Perlis,0,0,0,Dominican Republic
73591,8/1/2023,DOM,Pulau Pinang,0,0,0,Dominican Republic
73592,8/1/2023,DOM,Sabah,0,0,0,Dominican Republic
73593,8/1/2023,DOM,Sarawak,0,0,0,Dominican Republic
73594,8/1/2023,DOM,Selangor,16,10,6,Dominican Republic
73595,8/1/2023,DZA,Johor,124,56,68,Algeria
73596,8/1/2023,DZA,Kedah,5,3,2,Algeria
73597,8/1/2023,DZA,Kelantan,0,0,0,Algeria
73598,8/1/2023,DZA,Melaka,0,0,0,Algeria
73599,8/1/2023,DZA,Perak,0,0,0,Algeria
73600,8/1/2023,DZA,Perlis,1,1,0,Algeria
73601,8/1/2023,DZA,Pulau Pinang,3,2,1,Algeria
73602,8/1/2023,DZA,Sabah,1,0,1,Algeria
73603,8/1/2023,DZA,Sarawak,3,3,0,Algeria
73604,8/1/2023,DZA,Selangor,3055,1543,1512,Algeria
73605,8/1/2023,DZA,W.P. Labuan,0,0,0,Algeria
73606,8/1/2023,ECU,Johor,15,8,7,Ecuador
73607,8/1/2023,ECU,Kedah,3,1,2,Ecuador
73608,8/1/2023,ECU,Perak,0,0,0,Ecuador
73609,8/1/2023,ECU,Perlis,0,0,0,Ecuador
73610,8/1/2023,ECU,Pulau Pinang,1,0,1,Ecuador
73611,8/1/2023,ECU,Sabah,0,0,0,Ecuador
73612,8/1/2023,ECU,Sarawak,0,0,0,Ecuador
73613,8/1/2023,ECU,Selangor,83,31,52,Ecuador
73614,8/1/2023,EGY,Johor,171,142,29,Egypt
73615,8/1/2023,EGY,Kedah,12,4,8,Egypt
73616,8/1/2023,EGY,Kelantan,1,1,0,Egypt
73617,8/1/2023,EGY,Melaka,0,0,0,Egypt
73618,8/1/2023,EGY,Pahang,0,0,0,Egypt
73619,8/1/2023,EGY,Perak,0,0,0,Egypt
73620,8/1/2023,EGY,Perlis,1,1,0,Egypt
73621,8/1/2023,EGY,Pulau Pinang,17,11,6,Egypt
73622,8/1/2023,EGY,Sabah,2,2,0,Egypt
73623,8/1/2023,EGY,Sarawak,76,60,16,Egypt
73624,8/1/2023,EGY,Selangor,2548,1601,947,Egypt
73625,8/1/2023,EGY,Terengganu,0,0,0,Egypt
73626,8/1/2023,EGY,W.P. Labuan,0,0,0,Egypt
73627,8/1/2023,ERI,Johor,0,0,0,Eritrea
73628,8/1/2023,ERI,Pulau Pinang,2,1,1,Eritrea
73629,8/1/2023,ERI,Sabah,0,0,0,Eritrea
73630,8/1/2023,ERI,Selangor,33,17,16,Eritrea
73631,8/1/2023,ESP,Johor,1307,695,612,Spain
73632,8/1/2023,ESP,Kedah,131,60,71,Spain
73633,8/1/2023,ESP,Kelantan,8,5,3,Spain
73634,8/1/2023,ESP,Melaka,1,1,0,Spain
73635,8/1/2023,ESP,Negeri Sembilan,0,0,0,Spain
73636,8/1/2023,ESP,Pahang,0,0,0,Spain
73637,8/1/2023,ESP,Perak,12,4,8,Spain
73638,8/1/2023,ESP,Perlis,25,15,10,Spain
73639,8/1/2023,ESP,Pulau Pinang,322,155,167,Spain
73640,8/1/2023,ESP,Sabah,23,11,12,Spain
73641,8/1/2023,ESP,Sarawak,145,86,59,Spain
73642,8/1/2023,ESP,Selangor,8140,4112,4028,Spain
73643,8/1/2023,ESP,W.P. Labuan,10,7,3,Spain
73644,8/1/2023,EST,Johor,31,17,14,Estonia
73645,8/1/2023,EST,Kedah,5,3,2,Estonia
73646,8/1/2023,EST,Kelantan,0,0,0,Estonia
73647,8/1/2023,EST,Pahang,1,1,0,Estonia
73648,8/1/2023,EST,Perak,0,0,0,Estonia
73649,8/1/2023,EST,Perlis,1,0,1,Estonia
73650,8/1/2023,EST,Pulau Pinang,5,3,2,Estonia
73651,8/1/2023,EST,Sabah,0,0,0,Estonia
73652,8/1/2023,EST,Sarawak,0,0,0,Estonia
73653,8/1/2023,EST,Selangor,74,32,42,Estonia
73654,8/1/2023,EST,W.P. Labuan,0,0,0,Estonia
73655,8/1/2023,ETH,Johor,0,0,0,Ethiopia
73656,8/1/2023,ETH,Kedah,0,0,0,Ethiopia
73657,8/1/2023,ETH,Pulau Pinang,0,0,0,Ethiopia
73658,8/1/2023,ETH,Sarawak,0,0,0,Ethiopia
73659,8/1/2023,ETH,Selangor,50,25,25,Ethiopia
73660,8/1/2023,FIN,Johor,86,58,28,Finland
73661,8/1/2023,FIN,Kedah,6,3,3,Finland
73662,8/1/2023,FIN,Kelantan,1,1,0,Finland
73663,8/1/2023,FIN,Melaka,0,0,0,Finland
73664,8/1/2023,FIN,Negeri Sembilan,0,0,0,Finland
73665,8/1/2023,FIN,Pahang,0,0,0,Finland
73666,8/1/2023,FIN,Perak,0,0,0,Finland
73667,8/1/2023,FIN,Perlis,3,0,3,Finland
73668,8/1/2023,FIN,Pulau Pinang,23,13,10,Finland
73669,8/1/2023,FIN,Sabah,1,1,0,Finland
73670,8/1/2023,FIN,Sarawak,9,6,3,Finland
73671,8/1/2023,FIN,Selangor,377,227,150,Finland
73672,8/1/2023,FIN,W.P. Labuan,0,0,0,Finland
73673,8/1/2023,FJI,Johor,85,46,39,Fiji
73674,8/1/2023,FJI,Kedah,0,0,0,Fiji
73675,8/1/2023,FJI,Kelantan,0,0,0,Fiji
73676,8/1/2023,FJI,Perak,0,0,0,Fiji
73677,8/1/2023,FJI,Perlis,0,0,0,Fiji
73678,8/1/2023,FJI,Pulau Pinang,1,1,0,Fiji
73679,8/1/2023,FJI,Sabah,0,0,0,Fiji
73680,8/1/2023,FJI,Sarawak,0,0,0,Fiji
73681,8/1/2023,FJI,Selangor,170,98,72,Fiji
73682,8/1/2023,FRA,Johor,3410,1930,1480,France
73683,8/1/2023,FRA,Kedah,302,167,135,France
73684,8/1/2023,FRA,Kelantan,27,15,12,France
73685,8/1/2023,FRA,Melaka,3,2,1,France
73686,8/1/2023,FRA,Negeri Sembilan,2,1,1,France
73687,8/1/2023,FRA,Pahang,18,9,9,France
73688,8/1/2023,FRA,Perak,24,16,8,France
73689,8/1/2023,FRA,Perlis,75,50,25,France
73690,8/1/2023,FRA,Pulau Pinang,542,312,230,France
73691,8/1/2023,FRA,Sabah,31,19,12,France
73692,8/1/2023,FRA,Sarawak,212,120,92,France
73693,8/1/2023,FRA,Selangor,15193,8035,7158,France
73694,8/1/2023,FRA,Terengganu,0,0,0,France
73695,8/1/2023,FRA,W.P. Labuan,1,1,0,France
73696,8/1/2023,FSM,Johor,0,0,0,"Micronesia, Federated States of"
73697,8/1/2023,FSM,Pulau Pinang,0,0,0,"Micronesia, Federated States of"
73698,8/1/2023,FSM,Selangor,0,0,0,"Micronesia, Federated States of"
73699,8/1/2023,GAB,Johor,2,0,2,Gabon
73700,8/1/2023,GAB,Pulau Pinang,0,0,0,Gabon
73701,8/1/2023,GAB,Sarawak,0,0,0,Gabon
73702,8/1/2023,GAB,Selangor,7,3,4,Gabon
73703,8/1/2023,GBR,Johor,5811,3632,2179,United Kingdom
73704,8/1/2023,GBR,Kedah,950,504,446,United Kingdom
73705,8/1/2023,GBR,Kelantan,25,17,8,United Kingdom
73706,8/1/2023,GBR,Melaka,1,0,1,United Kingdom
73707,8/1/2023,GBR,Negeri Sembilan,0,0,0,United Kingdom
73708,8/1/2023,GBR,Pahang,37,20,17,United Kingdom
73709,8/1/2023,GBR,Perak,177,98,79,United Kingdom
73710,8/1/2023,GBR,Perlis,177,102,75,United Kingdom
73711,8/1/2023,GBR,Pulau Pinang,1823,1016,807,United Kingdom
73712,8/1/2023,GBR,Sabah,135,82,53,United Kingdom
73713,8/1/2023,GBR,Sarawak,884,538,346,United Kingdom
73714,8/1/2023,GBR,Selangor,23299,13135,10164,United Kingdom
73715,8/1/2023,GBR,Terengganu,0,0,0,United Kingdom
73716,8/1/2023,GBR,W.P. Labuan,26,20,6,United Kingdom
73717,8/1/2023,GEO,Johor,5,3,2,Georgia
73718,8/1/2023,GEO,Kedah,2,1,1,Georgia
73719,8/1/2023,GEO,Melaka,0,0,0,Georgia
73720,8/1/2023,GEO,Perak,0,0,0,Georgia
73721,8/1/2023,GEO,Perlis,0,0,0,Georgia
73722,8/1/2023,GEO,Pulau Pinang,1,0,1,Georgia
73723,8/1/2023,GEO,Sabah,2,2,0,Georgia
73724,8/1/2023,GEO,Sarawak,0,0,0,Georgia
73725,8/1/2023,GEO,Selangor,49,28,21,Georgia
73726,8/1/2023,GHA,Johor,12,9,3,Ghana
73727,8/1/2023,GHA,Kedah,1,0,1,Ghana
73728,8/1/2023,GHA,Kelantan,0,0,0,Ghana
73729,8/1/2023,GHA,Pulau Pinang,0,0,0,Ghana
73730,8/1/2023,GHA,Sabah,0,0,0,Ghana
73731,8/1/2023,GHA,Sarawak,0,0,0,Ghana
73732,8/1/2023,GHA,Selangor,126,78,48,Ghana
73733,8/1/2023,GIB,Johor,0,0,0,Gibraltar
73734,8/1/2023,GIB,Sarawak,0,0,0,Gibraltar
73735,8/1/2023,GIN,Johor,14,9,5,Guinea
73736,8/1/2023,GIN,Kedah,1,1,0,Guinea
73737,8/1/2023,GIN,Kelantan,0,0,0,Guinea
73738,8/1/2023,GIN,Perlis,0,0,0,Guinea
73739,8/1/2023,GIN,Pulau Pinang,0,0,0,Guinea
73740,8/1/2023,GIN,Sabah,0,0,0,Guinea
73741,8/1/2023,GIN,Sarawak,0,0,0,Guinea
73742,8/1/2023,GIN,Selangor,51,38,13,Guinea
73743,8/1/2023,GLP,Selangor,0,0,0,Guadeloupe
73744,8/1/2023,GMB,Johor,6,6,0,Gambia
73745,8/1/2023,GMB,Kedah,0,0,0,Gambia
73746,8/1/2023,GMB,Kelantan,0,0,0,Gambia
73747,8/1/2023,GMB,Pulau Pinang,0,0,0,Gambia
73748,8/1/2023,GMB,Sabah,0,0,0,Gambia
73749,8/1/2023,GMB,Sarawak,1,1,0,Gambia
73750,8/1/2023,GMB,Selangor,35,23,12,Gambia
73751,8/1/2023,GNB,Johor,0,0,0,Guinea-Bissau
73752,8/1/2023,GNB,Selangor,1,1,0,Guinea-Bissau
73753,8/1/2023,GNQ,Johor,0,0,0,Equatorial Guinea
73754,8/1/2023,GNQ,Selangor,2,1,1,Equatorial Guinea
73755,8/1/2023,GRC,Johor,52,34,18,Greece
73756,8/1/2023,GRC,Kedah,10,4,6,Greece
73757,8/1/2023,GRC,Kelantan,3,1,2,Greece
73758,8/1/2023,GRC,Melaka,0,0,0,Greece
73759,8/1/2023,GRC,Negeri Sembilan,1,1,0,Greece
73760,8/1/2023,GRC,Pahang,0,0,0,Greece
73761,8/1/2023,GRC,Perak,0,0,0,Greece
73762,8/1/2023,GRC,Perlis,2,2,0,Greece
73763,8/1/2023,GRC,Pulau Pinang,8,5,3,Greece
73764,8/1/2023,GRC,Sabah,1,1,0,Greece
73765,8/1/2023,GRC,Sarawak,21,7,14,Greece
73766,8/1/2023,GRC,Selangor,409,267,142,Greece
73767,8/1/2023,GRD,Johor,9,6,3,Grenada
73768,8/1/2023,GRD,Kedah,0,0,0,Grenada
73769,8/1/2023,GRD,Pulau Pinang,0,0,0,Grenada
73770,8/1/2023,GRD,Sabah,0,0,0,Grenada
73771,8/1/2023,GRD,Sarawak,0,0,0,Grenada
73772,8/1/2023,GRD,Selangor,22,16,6,Grenada
73773,8/1/2023,GRL,Johor,0,0,0,Greenland
73774,8/1/2023,GRL,Selangor,0,0,0,Greenland
73775,8/1/2023,GTM,Johor,3,1,2,Guatemala
73776,8/1/2023,GTM,Kedah,0,0,0,Guatemala
73777,8/1/2023,GTM,Pahang,0,0,0,Guatemala
73778,8/1/2023,GTM,Perak,0,0,0,Guatemala
73779,8/1/2023,GTM,Pulau Pinang,1,1,0,Guatemala
73780,8/1/2023,GTM,Sabah,0,0,0,Guatemala
73781,8/1/2023,GTM,Sarawak,0,0,0,Guatemala
73782,8/1/2023,GTM,Selangor,19,11,8,Guatemala
73783,8/1/2023,GTM,W.P. Labuan,0,0,0,Guatemala
73784,8/1/2023,GUY,Johor,1,1,0,Guyana
73785,8/1/2023,GUY,Kedah,0,0,0,Guyana
73786,8/1/2023,GUY,Pulau Pinang,0,0,0,Guyana
73787,8/1/2023,GUY,Sarawak,0,0,0,Guyana
73788,8/1/2023,GUY,Selangor,8,4,4,Guyana
73789,8/1/2023,HKG,Johor,9,6,3,Hong Kong
73790,8/1/2023,HKG,Kedah,1,1,0,Hong Kong
73791,8/1/2023,HKG,Kelantan,0,0,0,Hong Kong
73792,8/1/2023,HKG,Pahang,1,1,0,Hong Kong
73793,8/1/2023,HKG,Perak,30,12,18,Hong Kong
73794,8/1/2023,HKG,Perlis,1,1,0,Hong Kong
73795,8/1/2023,HKG,Pulau Pinang,0,0,0,Hong Kong
73796,8/1/2023,HKG,Sabah,0,0,0,Hong Kong
73797,8/1/2023,HKG,Sarawak,2,1,1,Hong Kong
73798,8/1/2023,HKG,Selangor,13,7,6,Hong Kong
73799,8/1/2023,HKG,Terengganu,0,0,0,Hong Kong
73800,8/1/2023,HMD,Johor,1,0,1,Heard Island and McDonald Islands
73801,8/1/2023,HND,Johor,7,4,3,Honduras
73802,8/1/2023,HND,Kedah,0,0,0,Honduras
73803,8/1/2023,HND,Perak,0,0,0,Honduras
73804,8/1/2023,HND,Pulau Pinang,0,0,0,Honduras
73805,8/1/2023,HND,Sabah,0,0,0,Honduras
73806,8/1/2023,HND,Sarawak,0,0,0,Honduras
73807,8/1/2023,HND,Selangor,12,6,6,Honduras
73808,8/1/2023,HRV,Johor,50,41,9,Croatia
73809,8/1/2023,HRV,Kedah,0,0,0,Croatia
73810,8/1/2023,HRV,Kelantan,0,0,0,Croatia
73811,8/1/2023,HRV,Melaka,0,0,0,Croatia
73812,8/1/2023,HRV,Pahang,0,0,0,Croatia
73813,8/1/2023,HRV,Perak,0,0,0,Croatia
73814,8/1/2023,HRV,Perlis,0,0,0,Croatia
73815,8/1/2023,HRV,Pulau Pinang,1,1,0,Croatia
73816,8/1/2023,HRV,Sabah,0,0,0,Croatia
73817,8/1/2023,HRV,Sarawak,0,0,0,Croatia
73818,8/1/2023,HRV,Selangor,238,125,113,Croatia
73819,8/1/2023,HTI,Johor,1,1,0,Haiti
73820,8/1/2023,HTI,Kedah,0,0,0,Haiti
73821,8/1/2023,HTI,Kelantan,0,0,0,Haiti
73822,8/1/2023,HTI,Perak,0,0,0,Haiti
73823,8/1/2023,HTI,Pulau Pinang,0,0,0,Haiti
73824,8/1/2023,HTI,Sabah,0,0,0,Haiti
73825,8/1/2023,HTI,Selangor,3,2,1,Haiti
73826,8/1/2023,HUN,Johor,96,61,35,Hungary
73827,8/1/2023,HUN,Kedah,13,5,8,Hungary
73828,8/1/2023,HUN,Kelantan,0,0,0,Hungary
73829,8/1/2023,HUN,Pahang,0,0,0,Hungary
73830,8/1/2023,HUN,Perak,0,0,0,Hungary
73831,8/1/2023,HUN,Perlis,0,0,0,Hungary
73832,8/1/2023,HUN,Pulau Pinang,20,11,9,Hungary
73833,8/1/2023,HUN,Sabah,1,1,0,Hungary
73834,8/1/2023,HUN,Sarawak,7,4,3,Hungary
73835,8/1/2023,HUN,Selangor,518,267,251,Hungary
73836,8/1/2023,HUN,W.P. Labuan,0,0,0,Hungary
73837,8/1/2023,IDN,Johor,89381,42360,47021,Indonesia
73838,8/1/2023,IDN,Kedah,4629,1647,2982,Indonesia
73839,8/1/2023,IDN,Kelantan,149,94,55,Indonesia
73840,8/1/2023,IDN,Melaka,3374,1618,1756,Indonesia
73841,8/1/2023,IDN,Negeri Sembilan,7265,4703,2562,Indonesia
73842,8/1/2023,IDN,Pahang,23,17,6,Indonesia
73843,8/1/2023,IDN,Perak,297,126,171,Indonesia
73844,8/1/2023,IDN,Perlis,514,255,259,Indonesia
73845,8/1/2023,IDN,Pulau Pinang,37925,15355,22570,Indonesia
73846,8/1/2023,IDN,Sabah,4260,2007,2253,Indonesia
73847,8/1/2023,IDN,Sarawak,31604,16820,14784,Indonesia
73848,8/1/2023,IDN,Selangor,115655,55363,60292,Indonesia
73849,8/1/2023,IDN,Terengganu,0,0,0,Indonesia
73850,8/1/2023,IDN,W.P. Labuan,56,28,28,Indonesia
73851,8/1/2023,IND,Johor,25130,17609,7521,India
73852,8/1/2023,IND,Kedah,1154,624,530,India
73853,8/1/2023,IND,Kelantan,1,1,0,India
73854,8/1/2023,IND,Melaka,1,1,0,India
73855,8/1/2023,IND,Negeri Sembilan,0,0,0,India
73856,8/1/2023,IND,Pahang,26,20,6,India
73857,8/1/2023,IND,Perak,213,146,67,India
73858,8/1/2023,IND,Perlis,31,22,9,India
73859,8/1/2023,IND,Pulau Pinang,1011,667,344,India
73860,8/1/2023,IND,Sabah,77,61,16,India
73861,8/1/2023,IND,Sarawak,979,814,165,India
73862,8/1/2023,IND,Selangor,53686,37829,15857,India
73863,8/1/2023,IND,Terengganu,0,0,0,India
73864,8/1/2023,IND,W.P. Labuan,76,61,15,India
73865,8/1/2023,IOT,Pulau Pinang,0,0,0,British Indian Ocean Territory
73866,8/1/2023,IOT,Selangor,0,0,0,British Indian Ocean Territory
73867,8/1/2023,IRL,Johor,297,178,119,Ireland
73868,8/1/2023,IRL,Kedah,42,24,18,Ireland
73869,8/1/2023,IRL,Kelantan,0,0,0,Ireland
73870,8/1/2023,IRL,Negeri Sembilan,0,0,0,Ireland
73871,8/1/2023,IRL,Pahang,0,0,0,Ireland
73872,8/1/2023,IRL,Perak,9,7,2,Ireland
73873,8/1/2023,IRL,Perlis,13,5,8,Ireland
73874,8/1/2023,IRL,Pulau Pinang,128,77,51,Ireland
73875,8/1/2023,IRL,Sabah,2,0,2,Ireland
73876,8/1/2023,IRL,Sarawak,23,16,7,Ireland
73877,8/1/2023,IRL,Selangor,1651,944,707,Ireland
73878,8/1/2023,IRL,Terengganu,0,0,0,Ireland
73879,8/1/2023,IRL,W.P. Labuan,0,0,0,Ireland
73880,8/1/2023,IRN,Johor,204,116,88,Iran
73881,8/1/2023,IRN,Kedah,11,6,5,Iran
73882,8/1/2023,IRN,Kelantan,0,0,0,Iran
73883,8/1/2023,IRN,Perak,0,0,0,Iran
73884,8/1/2023,IRN,Perlis,0,0,0,Iran
73885,8/1/2023,IRN,Pulau Pinang,4,0,4,Iran
73886,8/1/2023,IRN,Sabah,1,1,0,Iran
73887,8/1/2023,IRN,Sarawak,1,0,1,Iran
73888,8/1/2023,IRN,Selangor,2006,1017,989,Iran
73889,8/1/2023,IRN,W.P. Labuan,0,0,0,Iran
73890,8/1/2023,IRQ,Johor,68,35,33,Iraq
73891,8/1/2023,IRQ,Kedah,0,0,0,Iraq
73892,8/1/2023,IRQ,Kelantan,0,0,0,Iraq
73893,8/1/2023,IRQ,Melaka,0,0,0,Iraq
73894,8/1/2023,IRQ,Pahang,0,0,0,Iraq
73895,8/1/2023,IRQ,Perak,0,0,0,Iraq
73896,8/1/2023,IRQ,Perlis,0,0,0,Iraq
73897,8/1/2023,IRQ,Pulau Pinang,7,5,2,Iraq
73898,8/1/2023,IRQ,Sabah,0,0,0,Iraq
73899,8/1/2023,IRQ,Sarawak,2,1,1,Iraq
73900,8/1/2023,IRQ,Selangor,1324,775,549,Iraq
73901,8/1/2023,ISL,Johor,23,10,13,Iceland
73902,8/1/2023,ISL,Kedah,4,1,3,Iceland
73903,8/1/2023,ISL,Kelantan,0,0,0,Iceland
73904,8/1/2023,ISL,Perak,1,1,0,Iceland
73905,8/1/2023,ISL,Perlis,0,0,0,Iceland
73906,8/1/2023,ISL,Pulau Pinang,0,0,0,Iceland
73907,8/1/2023,ISL,Sabah,0,0,0,Iceland
73908,8/1/2023,ISL,Sarawak,4,1,3,Iceland
73909,8/1/2023,ISL,Selangor,20,12,8,Iceland
73910,8/1/2023,ISL,W.P. Labuan,0,0,0,Iceland
73911,8/1/2023,ISR,Pulau Pinang,0,0,0,Israel
73912,8/1/2023,ITA,Johor,2138,1138,1000,Italy
73913,8/1/2023,ITA,Kedah,139,77,62,Italy
73914,8/1/2023,ITA,Kelantan,8,7,1,Italy
73915,8/1/2023,ITA,Melaka,3,1,2,Italy
73916,8/1/2023,ITA,Negeri Sembilan,0,0,0,Italy
73917,8/1/2023,ITA,Pahang,7,5,2,Italy
73918,8/1/2023,ITA,Perak,20,11,9,Italy
73919,8/1/2023,ITA,Perlis,39,21,18,Italy
73920,8/1/2023,ITA,Pulau Pinang,264,164,100,Italy
73921,8/1/2023,ITA,Sabah,67,37,30,Italy
73922,8/1/2023,ITA,Sarawak,425,231,194,Italy
73923,8/1/2023,ITA,Selangor,12253,6534,5719,Italy
73924,8/1/2023,ITA,W.P. Labuan,7,5,2,Italy
73925,8/1/2023,JAM,Johor,6,3,3,Jamaica
73926,8/1/2023,JAM,Kedah,0,0,0,Jamaica
73927,8/1/2023,JAM,Perak,0,0,0,Jamaica
73928,8/1/2023,JAM,Pulau Pinang,1,1,0,Jamaica
73929,8/1/2023,JAM,Sabah,0,0,0,Jamaica
73930,8/1/2023,JAM,Sarawak,0,0,0,Jamaica
73931,8/1/2023,JAM,Selangor,29,6,23,Jamaica
73932,8/1/2023,JAM,W.P. Labuan,1,0,1,Jamaica
73933,8/1/2023,JOR,Johor,9,6,3,Jordan
73934,8/1/2023,JOR,Kedah,7,4,3,Jordan
73935,8/1/2023,JOR,Kelantan,0,0,0,Jordan
73936,8/1/2023,JOR,Melaka,0,0,0,Jordan
73937,8/1/2023,JOR,Perlis,0,0,0,Jordan
73938,8/1/2023,JOR,Pulau Pinang,13,11,2,Jordan
73939,8/1/2023,JOR,Sabah,1,1,0,Jordan
73940,8/1/2023,JOR,Sarawak,4,2,2,Jordan
73941,8/1/2023,JOR,Selangor,1148,631,517,Jordan
73942,8/1/2023,JOR,W.P. Labuan,0,0,0,Jordan
73943,8/1/2023,JPN,Johor,7505,4742,2763,Japan
73944,8/1/2023,JPN,Kedah,289,147,142,Japan
73945,8/1/2023,JPN,Kelantan,20,11,9,Japan
73946,8/1/2023,JPN,Melaka,1,1,0,Japan
73947,8/1/2023,JPN,Negeri Sembilan,0,0,0,Japan
73948,8/1/2023,JPN,Pahang,10,6,4,Japan
73949,8/1/2023,JPN,Perak,94,62,32,Japan
73950,8/1/2023,JPN,Perlis,110,86,24,Japan
73951,8/1/2023,JPN,Pulau Pinang,1973,1225,748,Japan
73952,8/1/2023,JPN,Sabah,104,58,46,Japan
73953,8/1/2023,JPN,Sarawak,222,128,94,Japan
73954,8/1/2023,JPN,Selangor,31511,17150,14361,Japan
73955,8/1/2023,JPN,W.P. Labuan,15,9,6,Japan
73956,8/1/2023,KAZ,Johor,81,29,52,Kazakhstan
73957,8/1/2023,KAZ,Kedah,7,4,3,Kazakhstan
73958,8/1/2023,KAZ,Kelantan,0,0,0,Kazakhstan
73959,8/1/2023,KAZ,Melaka,0,0,0,Kazakhstan
73960,8/1/2023,KAZ,Perak,0,0,0,Kazakhstan
73961,8/1/2023,KAZ,Perlis,8,3,5,Kazakhstan
73962,8/1/2023,KAZ,Pulau Pinang,1,1,0,Kazakhstan
73963,8/1/2023,KAZ,Sabah,1,0,1,Kazakhstan
73964,8/1/2023,KAZ,Sarawak,2,1,1,Kazakhstan
73965,8/1/2023,KAZ,Selangor,940,407,533,Kazakhstan
73966,8/1/2023,KAZ,W.P. Labuan,1,0,1,Kazakhstan
73967,8/1/2023,KEN,Johor,159,65,94,Kenya
73968,8/1/2023,KEN,Kedah,4,2,2,Kenya
73969,8/1/2023,KEN,Kelantan,0,0,0,Kenya
73970,8/1/2023,KEN,Perak,0,0,0,Kenya
73971,8/1/2023,KEN,Perlis,1,1,0,Kenya
73972,8/1/2023,KEN,Pulau Pinang,7,1,6,Kenya
73973,8/1/2023,KEN,Sabah,4,3,1,Kenya
73974,8/1/2023,KEN,Sarawak,5,2,3,Kenya
73975,8/1/2023,KEN,Selangor,478,208,270,Kenya
73976,8/1/2023,KGZ,Johor,24,13,11,Kyrgyzstan
73977,8/1/2023,KGZ,Kedah,2,1,1,Kyrgyzstan
73978,8/1/2023,KGZ,Kelantan,0,0,0,Kyrgyzstan
73979,8/1/2023,KGZ,Perak,0,0,0,Kyrgyzstan
73980,8/1/2023,KGZ,Perlis,0,0,0,Kyrgyzstan
73981,8/1/2023,KGZ,Pulau Pinang,1,1,0,Kyrgyzstan
73982,8/1/2023,KGZ,Sabah,0,0,0,Kyrgyzstan
73983,8/1/2023,KGZ,Sarawak,0,0,0,Kyrgyzstan
73984,8/1/2023,KGZ,Selangor,264,136,128,Kyrgyzstan
73985,8/1/2023,KHM,Johor,2600,1118,1482,Cambodia
73986,8/1/2023,KHM,Kedah,71,29,42,Cambodia
73987,8/1/2023,KHM,Kelantan,525,292,233,Cambodia
73988,8/1/2023,KHM,Melaka,0,0,0,Cambodia
73989,8/1/2023,KHM,Negeri Sembilan,0,0,0,Cambodia
73990,8/1/2023,KHM,Pahang,0,0,0,Cambodia
73991,8/1/2023,KHM,Perak,6,2,4,Cambodia
73992,8/1/2023,KHM,Perlis,688,423,265,Cambodia
73993,8/1/2023,KHM,Pulau Pinang,39,7,32,Cambodia
73994,8/1/2023,KHM,Sabah,4,3,1,Cambodia
73995,8/1/2023,KHM,Sarawak,9,3,6,Cambodia
73996,8/1/2023,KHM,Selangor,5480,2927,2553,Cambodia
73997,8/1/2023,KHM,W.P. Labuan,0,0,0,Cambodia
73998,8/1/2023,KIR,Johor,0,0,0,Kiribati
73999,8/1/2023,KIR,Sabah,0,0,0,Kiribati
74000,8/1/2023,KIR,Selangor,0,0,0,Kiribati
74001,8/1/2023,KNA,Johor,47,34,13,Saint Kitts and Nevis
74002,8/1/2023,KNA,Kedah,0,0,0,Saint Kitts and Nevis
74003,8/1/2023,KNA,Perlis,0,0,0,Saint Kitts and Nevis
74004,8/1/2023,KNA,Pulau Pinang,4,4,0,Saint Kitts and Nevis
74005,8/1/2023,KNA,Sabah,1,1,0,Saint Kitts and Nevis
74006,8/1/2023,KNA,Selangor,73,57,16,Saint Kitts and Nevis
74007,8/1/2023,KNA,W.P. Labuan,0,0,0,Saint Kitts and Nevis
74008,8/1/2023,KOR,Johor,14489,7505,6984,"Korea, Republic of (South Korea)"
74009,8/1/2023,KOR,Kedah,154,75,79,"Korea, Republic of (South Korea)"
74010,8/1/2023,KOR,Kelantan,2,1,1,"Korea, Republic of (South Korea)"
74011,8/1/2023,KOR,Melaka,24,15,9,"Korea, Republic of (South Korea)"
74012,8/1/2023,KOR,Negeri Sembilan,0,0,0,"Korea, Republic of (South Korea)"
74013,8/1/2023,KOR,Pahang,2,1,1,"Korea, Republic of (South Korea)"
74014,8/1/2023,KOR,Perak,12,9,3,"Korea, Republic of (South Korea)"
74015,8/1/2023,KOR,Perlis,72,47,25,"Korea, Republic of (South Korea)"
74016,8/1/2023,KOR,Pulau Pinang,740,389,351,"Korea, Republic of (South Korea)"
74017,8/1/2023,KOR,Sabah,753,360,393,"Korea, Republic of (South Korea)"
74018,8/1/2023,KOR,Sarawak,226,154,72,"Korea, Republic of (South Korea)"
74019,8/1/2023,KOR,Selangor,19550,10173,9377,"Korea, Republic of (South Korea)"
74020,8/1/2023,KOR,Terengganu,0,0,0,"Korea, Republic of (South Korea)"
74021,8/1/2023,KOR,W.P. Labuan,11,6,5,"Korea, Republic of (South Korea)"
74022,8/1/2023,KWT,Johor,320,165,155,Kuwait
74023,8/1/2023,KWT,Kedah,23,10,13,Kuwait
74024,8/1/2023,KWT,Kelantan,1,0,1,Kuwait
74025,8/1/2023,KWT,Perak,0,0,0,Kuwait
74026,8/1/2023,KWT,Perlis,0,0,0,Kuwait
74027,8/1/2023,KWT,Pulau Pinang,47,22,25,Kuwait
74028,8/1/2023,KWT,Sabah,0,0,0,Kuwait
74029,8/1/2023,KWT,Sarawak,0,0,0,Kuwait
74030,8/1/2023,KWT,Selangor,3652,1771,1881,Kuwait
74031,8/1/2023,KWT,W.P. Labuan,0,0,0,Kuwait
74032,8/1/2023,LAO,Johor,384,125,259,Lao People's Democratic Republic
74033,8/1/2023,LAO,Kedah,363,37,326,Lao People's Democratic Republic
74034,8/1/2023,LAO,Kelantan,149,43,106,Lao People's Democratic Republic
74035,8/1/2023,LAO,Melaka,0,0,0,Lao People's Democratic Republic
74036,8/1/2023,LAO,Perak,36,3,33,Lao People's Democratic Republic
74037,8/1/2023,LAO,Perlis,377,117,260,Lao People's Democratic Republic
74038,8/1/2023,LAO,Pulau Pinang,25,13,12,Lao People's Democratic Republic
74039,8/1/2023,LAO,Sabah,0,0,0,Lao People's Democratic Republic
74040,8/1/2023,LAO,Sarawak,4,1,3,Lao People's Democratic Republic
74041,8/1/2023,LAO,Selangor,575,217,358,Lao People's Democratic Republic
74042,8/1/2023,LAO,W.P. Labuan,0,0,0,Lao People's Democratic Republic
74043,8/1/2023,LBN,Johor,10,6,4,Lebanon
74044,8/1/2023,LBN,Kedah,2,0,2,Lebanon
74045,8/1/2023,LBN,Kelantan,0,0,0,Lebanon
74046,8/1/2023,LBN,Pahang,0,0,0,Lebanon
74047,8/1/2023,LBN,Perak,0,0,0,Lebanon
74048,8/1/2023,LBN,Perlis,0,0,0,Lebanon
74049,8/1/2023,LBN,Pulau Pinang,0,0,0,Lebanon
74050,8/1/2023,LBN,Sabah,0,0,0,Lebanon
74051,8/1/2023,LBN,Sarawak,5,5,0,Lebanon
74052,8/1/2023,LBN,Selangor,279,160,119,Lebanon
74053,8/1/2023,LBN,W.P. Labuan,0,0,0,Lebanon
74054,8/1/2023,LBR,Johor,2,2,0,Liberia
74055,8/1/2023,LBR,Kedah,0,0,0,Liberia
74056,8/1/2023,LBR,Sabah,0,0,0,Liberia
74057,8/1/2023,LBR,Sarawak,1,1,0,Liberia
74058,8/1/2023,LBR,Selangor,8,5,3,Liberia
74059,8/1/2023,LBY,Johor,3,3,0,Libyan Arab Jamahiriya
74060,8/1/2023,LBY,Kedah,2,2,0,Libyan Arab Jamahiriya
74061,8/1/2023,LBY,Perlis,1,1,0,Libyan Arab Jamahiriya
74062,8/1/2023,LBY,Pulau Pinang,6,2,4,Libyan Arab Jamahiriya
74063,8/1/2023,LBY,Sabah,0,0,0,Libyan Arab Jamahiriya
74064,8/1/2023,LBY,Sarawak,0,0,0,Libyan Arab Jamahiriya
74065,8/1/2023,LBY,Selangor,564,395,169,Libyan Arab Jamahiriya
74066,8/1/2023,LCA,Johor,8,7,1,Saint Lucia
74067,8/1/2023,LCA,Kedah,1,0,1,Saint Lucia
74068,8/1/2023,LCA,Pulau Pinang,1,1,0,Saint Lucia
74069,8/1/2023,LCA,Sarawak,3,2,1,Saint Lucia
74070,8/1/2023,LCA,Selangor,10,9,1,Saint Lucia
74071,8/1/2023,LIE,Johor,0,0,0,Liechtenstein
74072,8/1/2023,LIE,Kedah,1,0,1,Liechtenstein
74073,8/1/2023,LIE,Perlis,0,0,0,Liechtenstein
74074,8/1/2023,LIE,Pulau Pinang,0,0,0,Liechtenstein
74075,8/1/2023,LIE,Sabah,0,0,0,Liechtenstein
74076,8/1/2023,LIE,Sarawak,0,0,0,Liechtenstein
74077,8/1/2023,LIE,Selangor,4,3,1,Liechtenstein
74078,8/1/2023,LKA,Johor,1545,990,555,Sri Lanka
74079,8/1/2023,LKA,Kedah,60,30,30,Sri Lanka
74080,8/1/2023,LKA,Kelantan,0,0,0,Sri Lanka
74081,8/1/2023,LKA,Melaka,0,0,0,Sri Lanka
74082,8/1/2023,LKA,Pahang,1,1,0,Sri Lanka
74083,8/1/2023,LKA,Perak,6,4,2,Sri Lanka
74084,8/1/2023,LKA,Perlis,2,1,1,Sri Lanka
74085,8/1/2023,LKA,Pulau Pinang,45,17,28,Sri Lanka
74086,8/1/2023,LKA,Sabah,5,4,1,Sri Lanka
74087,8/1/2023,LKA,Sarawak,25,17,8,Sri Lanka
74088,8/1/2023,LKA,Selangor,5524,3532,1992,Sri Lanka
74089,8/1/2023,LKA,W.P. Labuan,1,1,0,Sri Lanka
74090,8/1/2023,LSO,Johor,1,1,0,Lesotho
74091,8/1/2023,LSO,Kedah,0,0,0,Lesotho
74092,8/1/2023,LSO,Pulau Pinang,0,0,0,Lesotho
74093,8/1/2023,LSO,Sarawak,1,1,0,Lesotho
74094,8/1/2023,LSO,Selangor,4,1,3,Lesotho
74095,8/1/2023,LTU,Johor,38,16,22,Lithuania
74096,8/1/2023,LTU,Kedah,6,3,3,Lithuania
74097,8/1/2023,LTU,Kelantan,1,1,0,Lithuania
74098,8/1/2023,LTU,Pahang,0,0,0,Lithuania
74099,8/1/2023,LTU,Perak,0,0,0,Lithuania
74100,8/1/2023,LTU,Perlis,7,5,2,Lithuania
74101,8/1/2023,LTU,Pulau Pinang,4,1,3,Lithuania
74102,8/1/2023,LTU,Sabah,1,0,1,Lithuania
74103,8/1/2023,LTU,Sarawak,6,2,4,Lithuania
74104,8/1/2023,LTU,Selangor,209,109,100,Lithuania
74105,8/1/2023,LTU,W.P. Labuan,0,0,0,Lithuania
74106,8/1/2023,LUX,Johor,28,17,11,Luxembourg
74107,8/1/2023,LUX,Kedah,3,2,1,Luxembourg
74108,8/1/2023,LUX,Kelantan,0,0,0,Luxembourg
74109,8/1/2023,LUX,Perak,0,0,0,Luxembourg
74110,8/1/2023,LUX,Perlis,4,2,2,Luxembourg
74111,8/1/2023,LUX,Pulau Pinang,3,2,1,Luxembourg
74112,8/1/2023,LUX,Sabah,0,0,0,Luxembourg
74113,8/1/2023,LUX,Sarawak,0,0,0,Luxembourg
74114,8/1/2023,LUX,Selangor,127,73,54,Luxembourg
74115,8/1/2023,LVA,Johor,9,5,4,Latvia
74116,8/1/2023,LVA,Kedah,0,0,0,Latvia
74117,8/1/2023,LVA,Kelantan,0,0,0,Latvia
74118,8/1/2023,LVA,Pahang,0,0,0,Latvia
74119,8/1/2023,LVA,Perak,0,0,0,Latvia
74120,8/1/2023,LVA,Perlis,1,1,0,Latvia
74121,8/1/2023,LVA,Pulau Pinang,1,1,0,Latvia
74122,8/1/2023,LVA,Sabah,1,1,0,Latvia
74123,8/1/2023,LVA,Sarawak,2,1,1,Latvia
74124,8/1/2023,LVA,Selangor,125,69,56,Latvia
74125,8/1/2023,LVA,W.P. Labuan,0,0,0,Latvia
74126,8/1/2023,MAC,Johor,4,3,1,Macao
74127,8/1/2023,MAC,Pahang,1,1,0,Macao
74128,8/1/2023,MAC,Perak,0,0,0,Macao
74129,8/1/2023,MAC,Selangor,7,3,4,Macao
74130,8/1/2023,MAC,W.P. Labuan,0,0,0,Macao
74131,8/1/2023,MAR,Johor,102,58,44,Morocco
74132,8/1/2023,MAR,Kedah,15,9,6,Morocco
74133,8/1/2023,MAR,Kelantan,1,0,1,Morocco
74134,8/1/2023,MAR,Melaka,0,0,0,Morocco
74135,8/1/2023,MAR,Pahang,0,0,0,Morocco
74136,8/1/2023,MAR,Perak,0,0,0,Morocco
74137,8/1/2023,MAR,Perlis,4,4,0,Morocco
74138,8/1/2023,MAR,Pulau Pinang,15,11,4,Morocco
74139,8/1/2023,MAR,Sabah,0,0,0,Morocco
74140,8/1/2023,MAR,Sarawak,6,6,0,Morocco
74141,8/1/2023,MAR,Selangor,2751,1190,1561,Morocco
74142,8/1/2023,MAR,W.P. Labuan,1,1,0,Morocco
74143,8/1/2023,MCO,Johor,0,0,0,Monaco
74144,8/1/2023,MCO,Kedah,0,0,0,Monaco
74145,8/1/2023,MCO,Sabah,0,0,0,Monaco
74146,8/1/2023,MCO,Selangor,4,2,2,Monaco
74147,8/1/2023,MDA,Johor,5,2,3,"Moldova, Republic of"
74148,8/1/2023,MDA,Kedah,0,0,0,"Moldova, Republic of"
74149,8/1/2023,MDA,Kelantan,0,0,0,"Moldova, Republic of"
74150,8/1/2023,MDA,Negeri Sembilan,0,0,0,"Moldova, Republic of"
74151,8/1/2023,MDA,Perlis,0,0,0,"Moldova, Republic of"
74152,8/1/2023,MDA,Pulau Pinang,1,0,1,"Moldova, Republic of"
74153,8/1/2023,MDA,Sabah,0,0,0,"Moldova, Republic of"
74154,8/1/2023,MDA,Sarawak,0,0,0,"Moldova, Republic of"
74155,8/1/2023,MDA,Selangor,38,24,14,"Moldova, Republic of"
74156,8/1/2023,MDG,Johor,19,8,11,Madagascar
74157,8/1/2023,MDG,Kedah,2,0,2,Madagascar
74158,8/1/2023,MDG,Perak,0,0,0,Madagascar
74159,8/1/2023,MDG,Perlis,1,0,1,Madagascar
74160,8/1/2023,MDG,Pulau Pinang,0,0,0,Madagascar
74161,8/1/2023,MDG,Sabah,0,0,0,Madagascar
74162,8/1/2023,MDG,Sarawak,1,0,1,Madagascar
74163,8/1/2023,MDG,Selangor,318,120,198,Madagascar
74164,8/1/2023,MDV,Johor,121,73,48,Maldives
74165,8/1/2023,MDV,Kedah,11,6,5,Maldives
74166,8/1/2023,MDV,Kelantan,0,0,0,Maldives
74167,8/1/2023,MDV,Perak,0,0,0,Maldives
74168,8/1/2023,MDV,Perlis,0,0,0,Maldives
74169,8/1/2023,MDV,Pulau Pinang,12,7,5,Maldives
74170,8/1/2023,MDV,Sabah,1,1,0,Maldives
74171,8/1/2023,MDV,Sarawak,1,0,1,Maldives
74172,8/1/2023,MDV,Selangor,2222,1164,1058,Maldives
74173,8/1/2023,MEX,Johor,155,70,85,Mexico
74174,8/1/2023,MEX,Kedah,5,3,2,Mexico
74175,8/1/2023,MEX,Kelantan,0,0,0,Mexico
74176,8/1/2023,MEX,Pahang,0,0,0,Mexico
74177,8/1/2023,MEX,Perak,1,1,0,Mexico
74178,8/1/2023,MEX,Perlis,1,0,1,Mexico
74179,8/1/2023,MEX,Pulau Pinang,27,18,9,Mexico
74180,8/1/2023,MEX,Sabah,2,0,2,Mexico
74181,8/1/2023,MEX,Sarawak,6,4,2,Mexico
74182,8/1/2023,MEX,Selangor,499,266,233,Mexico
74183,8/1/2023,MEX,W.P. Labuan,0,0,0,Mexico
74184,8/1/2023,MHL,Johor,1,1,0,Marshall Islands
74185,8/1/2023,MHL,Kedah,0,0,0,Marshall Islands
74186,8/1/2023,MHL,Perak,0,0,0,Marshall Islands
74187,8/1/2023,MHL,Pulau Pinang,0,0,0,Marshall Islands
74188,8/1/2023,MHL,Sabah,0,0,0,Marshall Islands
74189,8/1/2023,MHL,Selangor,6,5,1,Marshall Islands
74190,8/1/2023,MKD,Johor,1,1,0,"Macedonia, the former Yugoslav Republic of"
74191,8/1/2023,MKD,Kedah,1,1,0,"Macedonia, the former Yugoslav Republic of"
74192,8/1/2023,MKD,Perak,0,0,0,"Macedonia, the former Yugoslav Republic of"
74193,8/1/2023,MKD,Pulau Pinang,0,0,0,"Macedonia, the former Yugoslav Republic of"
74194,8/1/2023,MKD,Sabah,0,0,0,"Macedonia, the former Yugoslav Republic of"
74195,8/1/2023,MKD,Sarawak,0,0,0,"Macedonia, the former Yugoslav Republic of"
74196,8/1/2023,MKD,Selangor,55,27,28,"Macedonia, the former Yugoslav Republic of"
74197,8/1/2023,MLI,Johor,3,3,0,Mali
74198,8/1/2023,MLI,Sabah,0,0,0,Mali
74199,8/1/2023,MLI,Selangor,12,9,3,Mali
74200,8/1/2023,MLT,Johor,15,9,6,Malta
74201,8/1/2023,MLT,Kedah,0,0,0,Malta
74202,8/1/2023,MLT,Kelantan,0,0,0,Malta
74203,8/1/2023,MLT,Perak,0,0,0,Malta
74204,8/1/2023,MLT,Perlis,2,1,1,Malta
74205,8/1/2023,MLT,Pulau Pinang,3,3,0,Malta
74206,8/1/2023,MLT,Sabah,2,1,1,Malta
74207,8/1/2023,MLT,Sarawak,0,0,0,Malta
74208,8/1/2023,MLT,Selangor,90,51,39,Malta
74209,8/1/2023,MLT,W.P. Labuan,0,0,0,Malta
74210,8/1/2023,MMR,Johor,5709,1831,3878,Myanmar
74211,8/1/2023,MMR,Kedah,96,26,70,Myanmar
74212,8/1/2023,MMR,Kelantan,1,0,1,Myanmar
74213,8/1/2023,MMR,Negeri Sembilan,1,1,0,Myanmar
74214,8/1/2023,MMR,Pahang,2,0,2,Myanmar
74215,8/1/2023,MMR,Perak,29,9,20,Myanmar
74216,8/1/2023,MMR,Perlis,6,2,4,Myanmar
74217,8/1/2023,MMR,Pulau Pinang,459,246,213,Myanmar
74218,8/1/2023,MMR,Sabah,7,5,2,Myanmar
74219,8/1/2023,MMR,Sarawak,75,29,46,Myanmar
74220,8/1/2023,MMR,Selangor,7597,5249,2348,Myanmar
74221,8/1/2023,MMR,Terengganu,0,0,0,Myanmar
74222,8/1/2023,MMR,W.P. Labuan,0,0,0,Myanmar
74223,8/1/2023,MNE,Johor,4,4,0,Montenegro
74224,8/1/2023,MNE,Kedah,0,0,0,Montenegro
74225,8/1/2023,MNE,Pulau Pinang,0,0,0,Montenegro
74226,8/1/2023,MNE,Sabah,0,0,0,Montenegro
74227,8/1/2023,MNE,Sarawak,0,0,0,Montenegro
74228,8/1/2023,MNE,Selangor,17,10,7,Montenegro
74229,8/1/2023,MNG,Johor,117,43,74,Mongolia
74230,8/1/2023,MNG,Kedah,7,1,6,Mongolia
74231,8/1/2023,MNG,Kelantan,0,0,0,Mongolia
74232,8/1/2023,MNG,Perak,0,0,0,Mongolia
74233,8/1/2023,MNG,Perlis,5,3,2,Mongolia
74234,8/1/2023,MNG,Pulau Pinang,6,4,2,Mongolia
74235,8/1/2023,MNG,Sabah,1,0,1,Mongolia
74236,8/1/2023,MNG,Sarawak,0,0,0,Mongolia
74237,8/1/2023,MNG,Selangor,320,144,176,Mongolia
74238,8/1/2023,MNP,Selangor,0,0,0,Northern Mariana Islands
74239,8/1/2023,MOZ,Johor,0,0,0,Mozambique
74240,8/1/2023,MOZ,Kedah,0,0,0,Mozambique
74241,8/1/2023,MOZ,Perak,0,0,0,Mozambique
74242,8/1/2023,MOZ,Pulau Pinang,1,0,1,Mozambique
74243,8/1/2023,MOZ,Sabah,0,0,0,Mozambique
74244,8/1/2023,MOZ,Sarawak,0,0,0,Mozambique
74245,8/1/2023,MOZ,Selangor,31,13,18,Mozambique
74246,8/1/2023,MRT,Johor,4,4,0,Mauritania
74247,8/1/2023,MRT,Kedah,0,0,0,Mauritania
74248,8/1/2023,MRT,Pulau Pinang,0,0,0,Mauritania
74249,8/1/2023,MRT,Sabah,0,0,0,Mauritania
74250,8/1/2023,MRT,Sarawak,0,0,0,Mauritania
74251,8/1/2023,MRT,Selangor,26,20,6,Mauritania
74252,8/1/2023,MUS,Johor,152,67,85,Mauritius
74253,8/1/2023,MUS,Kedah,25,7,18,Mauritius
74254,8/1/2023,MUS,Kelantan,0,0,0,Mauritius
74255,8/1/2023,MUS,Pahang,0,0,0,Mauritius
74256,8/1/2023,MUS,Perak,0,0,0,Mauritius
74257,8/1/2023,MUS,Perlis,6,6,0,Mauritius
74258,8/1/2023,MUS,Pulau Pinang,17,11,6,Mauritius
74259,8/1/2023,MUS,Sabah,0,0,0,Mauritius
74260,8/1/2023,MUS,Sarawak,1,0,1,Mauritius
74261,8/1/2023,MUS,Selangor,1535,791,744,Mauritius
74262,8/1/2023,MWI,Johor,1,1,0,Malawi
74263,8/1/2023,MWI,Pulau Pinang,0,0,0,Malawi
74264,8/1/2023,MWI,Sabah,0,0,0,Malawi
74265,8/1/2023,MWI,Sarawak,0,0,0,Malawi
74266,8/1/2023,MWI,Selangor,24,7,17,Malawi
74267,8/1/2023,MYT,Selangor,0,0,0,Mayotte
74268,8/1/2023,NAM,Johor,1,0,1,Namibia
74269,8/1/2023,NAM,Kedah,0,0,0,Namibia
74270,8/1/2023,NAM,Perak,0,0,0,Namibia
74271,8/1/2023,NAM,Perlis,0,0,0,Namibia
74272,8/1/2023,NAM,Pulau Pinang,0,0,0,Namibia
74273,8/1/2023,NAM,Sabah,0,0,0,Namibia
74274,8/1/2023,NAM,Sarawak,0,0,0,Namibia
74275,8/1/2023,NAM,Selangor,22,16,6,Namibia
74276,8/1/2023,NCL,Selangor,0,0,0,New Caledonia
74277,8/1/2023,NER,Johor,0,0,0,Niger
74278,8/1/2023,NER,Sabah,0,0,0,Niger
74279,8/1/2023,NER,Selangor,5,2,3,Niger
74280,8/1/2023,NGA,Johor,39,34,5,Nigeria
74281,8/1/2023,NGA,Kedah,2,0,2,Nigeria
74282,8/1/2023,NGA,Perlis,0,0,0,Nigeria
74283,8/1/2023,NGA,Pulau Pinang,4,4,0,Nigeria
74284,8/1/2023,NGA,Sabah,0,0,0,Nigeria
74285,8/1/2023,NGA,Sarawak,10,4,6,Nigeria
74286,8/1/2023,NGA,Selangor,488,365,123,Nigeria
74287,8/1/2023,NIC,Johor,3,0,3,Nicaragua
74288,8/1/2023,NIC,Kedah,2,0,2,Nicaragua
74289,8/1/2023,NIC,Pulau Pinang,0,0,0,Nicaragua
74290,8/1/2023,NIC,Sabah,0,0,0,Nicaragua
74291,8/1/2023,NIC,Selangor,5,2,3,Nicaragua
74292,8/1/2023,NLD,Johor,1630,1012,618,Netherlands
74293,8/1/2023,NLD,Kedah,273,148,125,Netherlands
74294,8/1/2023,NLD,Kelantan,4,3,1,Netherlands
74295,8/1/2023,NLD,Melaka,3,3,0,Netherlands
74296,8/1/2023,NLD,Negeri Sembilan,0,0,0,Netherlands
74297,8/1/2023,NLD,Pahang,0,0,0,Netherlands
74298,8/1/2023,NLD,Perak,20,14,6,Netherlands
74299,8/1/2023,NLD,Perlis,73,41,32,Netherlands
74300,8/1/2023,NLD,Pulau Pinang,316,194,122,Netherlands
74301,8/1/2023,NLD,Sabah,44,26,18,Netherlands
74302,8/1/2023,NLD,Sarawak,175,112,63,Netherlands
74303,8/1/2023,NLD,Selangor,7406,4046,3360,Netherlands
74304,8/1/2023,NLD,Terengganu,0,0,0,Netherlands
74305,8/1/2023,NLD,W.P. Labuan,5,3,2,Netherlands
74306,8/1/2023,NOR,Johor,126,92,34,Norway
74307,8/1/2023,NOR,Kedah,12,6,6,Norway
74308,8/1/2023,NOR,Kelantan,1,1,0,Norway
74309,8/1/2023,NOR,Melaka,0,0,0,Norway
74310,8/1/2023,NOR,Pahang,0,0,0,Norway
74311,8/1/2023,NOR,Perak,1,1,0,Norway
74312,8/1/2023,NOR,Perlis,4,2,2,Norway
74313,8/1/2023,NOR,Pulau Pinang,15,6,9,Norway
74314,8/1/2023,NOR,Sabah,1,1,0,Norway
74315,8/1/2023,NOR,Sarawak,9,6,3,Norway
74316,8/1/2023,NOR,Selangor,521,303,218,Norway
74317,8/1/2023,NOR,W.P. Labuan,1,0,1,Norway
74318,8/1/2023,NPL,Johor,874,629,245,Nepal
74319,8/1/2023,NPL,Kedah,7,6,1,Nepal
74320,8/1/2023,NPL,Pahang,0,0,0,Nepal
74321,8/1/2023,NPL,Perak,0,0,0,Nepal
74322,8/1/2023,NPL,Perlis,1,1,0,Nepal
74323,8/1/2023,NPL,Pulau Pinang,11,8,3,Nepal
74324,8/1/2023,NPL,Sabah,1,0,1,Nepal
74325,8/1/2023,NPL,Sarawak,269,188,81,Nepal
74326,8/1/2023,NPL,Selangor,10412,9927,485,Nepal
74327,8/1/2023,NPL,W.P. Labuan,30,29,1,Nepal
74328,8/1/2023,NRU,Johor,41,25,16,Nauru
74329,8/1/2023,NRU,Pulau Pinang,0,0,0,Nauru
74330,8/1/2023,NRU,Selangor,8,6,2,Nauru
74331,8/1/2023,NZL,Johor,726,445,281,New Zealand
74332,8/1/2023,NZL,Kedah,55,34,21,New Zealand
74333,8/1/2023,NZL,Kelantan,5,3,2,New Zealand
74334,8/1/2023,NZL,Melaka,0,0,0,New Zealand
74335,8/1/2023,NZL,Negeri Sembilan,0,0,0,New Zealand
74336,8/1/2023,NZL,Pahang,6,4,2,New Zealand
74337,8/1/2023,NZL,Perak,30,22,8,New Zealand
74338,8/1/2023,NZL,Perlis,22,17,5,New Zealand
74339,8/1/2023,NZL,Pulau Pinang,224,124,100,New Zealand
74340,8/1/2023,NZL,Sabah,20,10,10,New Zealand
74341,8/1/2023,NZL,Sarawak,149,91,58,New Zealand
74342,8/1/2023,NZL,Selangor,2726,1646,1080,New Zealand
74343,8/1/2023,NZL,Terengganu,0,0,0,New Zealand
74344,8/1/2023,NZL,W.P. Labuan,2,2,0,New Zealand
74345,8/1/2023,OMN,Johor,180,81,99,Oman
74346,8/1/2023,OMN,Kedah,13,7,6,Oman
74347,8/1/2023,OMN,Kelantan,0,0,0,Oman
74348,8/1/2023,OMN,Melaka,0,0,0,Oman
74349,8/1/2023,OMN,Perak,6,3,3,Oman
74350,8/1/2023,OMN,Perlis,5,2,3,Oman
74351,8/1/2023,OMN,Pulau Pinang,12,6,6,Oman
74352,8/1/2023,OMN,Sabah,0,0,0,Oman
74353,8/1/2023,OMN,Sarawak,16,10,6,Oman
74354,8/1/2023,OMN,Selangor,3188,1603,1585,Oman
74355,8/1/2023,PAK,Johor,1162,820,342,Pakistan
74356,8/1/2023,PAK,Kedah,156,104,52,Pakistan
74357,8/1/2023,PAK,Kelantan,13,11,2,Pakistan
74358,8/1/2023,PAK,Melaka,0,0,0,Pakistan
74359,8/1/2023,PAK,Negeri Sembilan,0,0,0,Pakistan
74360,8/1/2023,PAK,Pahang,0,0,0,Pakistan
74361,8/1/2023,PAK,Perak,10,10,0,Pakistan
74362,8/1/2023,PAK,Perlis,15,15,0,Pakistan
74363,8/1/2023,PAK,Pulau Pinang,82,66,16,Pakistan
74364,8/1/2023,PAK,Sabah,20,20,0,Pakistan
74365,8/1/2023,PAK,Sarawak,167,128,39,Pakistan
74366,8/1/2023,PAK,Selangor,12841,10878,1963,Pakistan
74367,8/1/2023,PAK,W.P. Labuan,3,2,1,Pakistan
74368,8/1/2023,PAN,Johor,8,5,3,Panama
74369,8/1/2023,PAN,Kedah,0,0,0,Panama
74370,8/1/2023,PAN,Perak,0,0,0,Panama
74371,8/1/2023,PAN,Perlis,0,0,0,Panama
74372,8/1/2023,PAN,Pulau Pinang,0,0,0,Panama
74373,8/1/2023,PAN,Sabah,0,0,0,Panama
74374,8/1/2023,PAN,Sarawak,0,0,0,Panama
74375,8/1/2023,PAN,Selangor,30,18,12,Panama
74376,8/1/2023,PER,Johor,40,20,20,Peru
74377,8/1/2023,PER,Kedah,1,1,0,Peru
74378,8/1/2023,PER,Kelantan,0,0,0,Peru
74379,8/1/2023,PER,Pahang,1,1,0,Peru
74380,8/1/2023,PER,Perak,0,0,0,Peru
74381,8/1/2023,PER,Perlis,0,0,0,Peru
74382,8/1/2023,PER,Pulau Pinang,3,0,3,Peru
74383,8/1/2023,PER,Sabah,0,0,0,Peru
74384,8/1/2023,PER,Sarawak,2,2,0,Peru
74385,8/1/2023,PER,Selangor,134,72,62,Peru
74386,8/1/2023,PER,W.P. Labuan,0,0,0,Peru
74387,8/1/2023,PHL,Johor,24915,8236,16679,Philippines
74388,8/1/2023,PHL,Kedah,392,134,258,Philippines
74389,8/1/2023,PHL,Kelantan,23,15,8,Philippines
74390,8/1/2023,PHL,Melaka,0,0,0,Philippines
74391,8/1/2023,PHL,Negeri Sembilan,0,0,0,Philippines
74392,8/1/2023,PHL,Pahang,29,25,4,Philippines
74393,8/1/2023,PHL,Perak,59,24,35,Philippines
74394,8/1/2023,PHL,Perlis,168,48,120,Philippines
74395,8/1/2023,PHL,Pulau Pinang,655,257,398,Philippines
74396,8/1/2023,PHL,Sabah,616,356,260,Philippines
74397,8/1/2023,PHL,Sarawak,1941,751,1190,Philippines
74398,8/1/2023,PHL,Selangor,19043,7691,11352,Philippines
74399,8/1/2023,PHL,Terengganu,0,0,0,Philippines
74400,8/1/2023,PHL,W.P. Labuan,125,44,81,Philippines
74401,8/1/2023,PLW,Johor,1,1,0,Palau
74402,8/1/2023,PLW,Pulau Pinang,0,0,0,Palau
74403,8/1/2023,PLW,Selangor,0,0,0,Palau
74404,8/1/2023,PNG,Johor,8,1,7,Papua New Guinea
74405,8/1/2023,PNG,Kedah,0,0,0,Papua New Guinea
74406,8/1/2023,PNG,Kelantan,0,0,0,Papua New Guinea
74407,8/1/2023,PNG,Perak,0,0,0,Papua New Guinea
74408,8/1/2023,PNG,Pulau Pinang,1,0,1,Papua New Guinea
74409,8/1/2023,PNG,Sabah,0,0,0,Papua New Guinea
74410,8/1/2023,PNG,Sarawak,6,4,2,Papua New Guinea
74411,8/1/2023,PNG,Selangor,29,16,13,Papua New Guinea
74412,8/1/2023,POL,Johor,292,169,123,Poland
74413,8/1/2023,POL,Kedah,43,14,29,Poland
74414,8/1/2023,POL,Kelantan,0,0,0,Poland
74415,8/1/2023,POL,Melaka,0,0,0,Poland
74416,8/1/2023,POL,Negeri Sembilan,0,0,0,Poland
74417,8/1/2023,POL,Pahang,0,0,0,Poland
74418,8/1/2023,POL,Perak,0,0,0,Poland
74419,8/1/2023,POL,Perlis,4,1,3,Poland
74420,8/1/2023,POL,Pulau Pinang,62,38,24,Poland
74421,8/1/2023,POL,Sabah,16,9,7,Poland
74422,8/1/2023,POL,Sarawak,80,39,41,Poland
74423,8/1/2023,POL,Selangor,1397,662,735,Poland
74424,8/1/2023,POL,Terengganu,0,0,0,Poland
74425,8/1/2023,POL,W.P. Labuan,0,0,0,Poland
74426,8/1/2023,PRK,Selangor,0,0,0,"Korea, Democratic People's Republic of"
74427,8/1/2023,PRT,Johor,238,127,111,Portugal
74428,8/1/2023,PRT,Kedah,44,24,20,Portugal
74429,8/1/2023,PRT,Kelantan,1,1,0,Portugal
74430,8/1/2023,PRT,Melaka,0,0,0,Portugal
74431,8/1/2023,PRT,Pahang,0,0,0,Portugal
74432,8/1/2023,PRT,Perak,1,1,0,Portugal
74433,8/1/2023,PRT,Perlis,7,6,1,Portugal
74434,8/1/2023,PRT,Pulau Pinang,64,30,34,Portugal
74435,8/1/2023,PRT,Sabah,10,7,3,Portugal
74436,8/1/2023,PRT,Sarawak,14,8,6,Portugal
74437,8/1/2023,PRT,Selangor,1146,607,539,Portugal
74438,8/1/2023,PRT,W.P. Labuan,1,1,0,Portugal
74439,8/1/2023,PRY,Johor,2,2,0,Paraguay
74440,8/1/2023,PRY,Kedah,0,0,0,Paraguay
74441,8/1/2023,PRY,Perak,0,0,0,Paraguay
74442,8/1/2023,PRY,Perlis,0,0,0,Paraguay
74443,8/1/2023,PRY,Pulau Pinang,2,1,1,Paraguay
74444,8/1/2023,PRY,Sabah,0,0,0,Paraguay
74445,8/1/2023,PRY,Sarawak,1,1,0,Paraguay
74446,8/1/2023,PRY,Selangor,14,11,3,Paraguay
74447,8/1/2023,PSE,Johor,30,27,3,"Palestinian Territory, Occupied"
74448,8/1/2023,PSE,Kedah,0,0,0,"Palestinian Territory, Occupied"
74449,8/1/2023,PSE,Kelantan,0,0,0,"Palestinian Territory, Occupied"
74450,8/1/2023,PSE,Melaka,0,0,0,"Palestinian Territory, Occupied"
74451,8/1/2023,PSE,Perak,0,0,0,"Palestinian Territory, Occupied"
74452,8/1/2023,PSE,Perlis,0,0,0,"Palestinian Territory, Occupied"
74453,8/1/2023,PSE,Pulau Pinang,1,1,0,"Palestinian Territory, Occupied"
74454,8/1/2023,PSE,Sabah,0,0,0,"Palestinian Territory, Occupied"
74455,8/1/2023,PSE,Sarawak,1,1,0,"Palestinian Territory, Occupied"
74456,8/1/2023,PSE,Selangor,537,326,211,"Palestinian Territory, Occupied"
74457,8/1/2023,QAT,Johor,77,34,43,Qatar
74458,8/1/2023,QAT,Kedah,5,3,2,Qatar
74459,8/1/2023,QAT,Perlis,0,0,0,Qatar
74460,8/1/2023,QAT,Pulau Pinang,0,0,0,Qatar
74461,8/1/2023,QAT,Sabah,0,0,0,Qatar
74462,8/1/2023,QAT,Sarawak,1,0,1,Qatar
74463,8/1/2023,QAT,Selangor,338,190,148,Qatar
74464,8/1/2023,REU,Johor,0,0,0,Reunion
74465,8/1/2023,REU,Sarawak,0,0,0,Reunion
74466,8/1/2023,ROU,Johor,137,82,55,Romania
74467,8/1/2023,ROU,Kedah,5,4,1,Romania
74468,8/1/2023,ROU,Kelantan,1,1,0,Romania
74469,8/1/2023,ROU,Negeri Sembilan,0,0,0,Romania
74470,8/1/2023,ROU,Pahang,0,0,0,Romania
74471,8/1/2023,ROU,Perak,3,1,2,Romania
74472,8/1/2023,ROU,Perlis,4,1,3,Romania
74473,8/1/2023,ROU,Pulau Pinang,15,12,3,Romania
74474,8/1/2023,ROU,Sabah,1,0,1,Romania
74475,8/1/2023,ROU,Sarawak,10,6,4,Romania
74476,8/1/2023,ROU,Selangor,667,313,354,Romania
74477,8/1/2023,ROU,W.P. Labuan,0,0,0,Romania
74478,8/1/2023,RUS,Johor,483,235,248,Russia
74479,8/1/2023,RUS,Kedah,264,138,126,Russia
74480,8/1/2023,RUS,Kelantan,41,26,15,Russia
74481,8/1/2023,RUS,Melaka,0,0,0,Russia
74482,8/1/2023,RUS,Negeri Sembilan,1,1,0,Russia
74483,8/1/2023,RUS,Pahang,2,1,1,Russia
74484,8/1/2023,RUS,Perak,1,0,1,Russia
74485,8/1/2023,RUS,Perlis,215,123,92,Russia
74486,8/1/2023,RUS,Pulau Pinang,141,65,76,Russia
74487,8/1/2023,RUS,Sabah,17,8,9,Russia
74488,8/1/2023,RUS,Sarawak,27,15,12,Russia
74489,8/1/2023,RUS,Selangor,7069,3601,3468,Russia
74490,8/1/2023,RUS,W.P. Labuan,7,5,2,Russia
74491,8/1/2023,RWA,Johor,4,2,2,Rwanda
74492,8/1/2023,RWA,Kedah,0,0,0,Rwanda
74493,8/1/2023,RWA,Pulau Pinang,1,1,0,Rwanda
74494,8/1/2023,RWA,Selangor,15,9,6,Rwanda
74495,8/1/2023,SAU,Johor,482,224,258,Saudi Arabia
74496,8/1/2023,SAU,Kedah,84,43,41,Saudi Arabia
74497,8/1/2023,SAU,Kelantan,23,13,10,Saudi Arabia
74498,8/1/2023,SAU,Melaka,0,0,0,Saudi Arabia
74499,8/1/2023,SAU,Perak,10,5,5,Saudi Arabia
74500,8/1/2023,SAU,Perlis,3,3,0,Saudi Arabia
74501,8/1/2023,SAU,Pulau Pinang,85,45,40,Saudi Arabia
74502,8/1/2023,SAU,Sabah,4,2,2,Saudi Arabia
74503,8/1/2023,SAU,Sarawak,3,3,0,Saudi Arabia
74504,8/1/2023,SAU,Selangor,7361,3893,3468,Saudi Arabia
74505,8/1/2023,SAU,W.P. Labuan,0,0,0,Saudi Arabia
74506,8/1/2023,SDN,Johor,12,8,4,Sudan
74507,8/1/2023,SDN,Kedah,1,1,0,Sudan
74508,8/1/2023,SDN,Kelantan,0,0,0,Sudan
74509,8/1/2023,SDN,Perlis,0,0,0,Sudan
74510,8/1/2023,SDN,Pulau Pinang,2,1,1,Sudan
74511,8/1/2023,SDN,Sabah,0,0,0,Sudan
74512,8/1/2023,SDN,Sarawak,0,0,0,Sudan
74513,8/1/2023,SDN,Selangor,1464,783,681,Sudan
74514,8/1/2023,SDN,W.P. Labuan,1,1,0,Sudan
74515,8/1/2023,SEN,Johor,7,5,2,Senegal
74516,8/1/2023,SEN,Kedah,1,1,0,Senegal
74517,8/1/2023,SEN,Kelantan,0,0,0,Senegal
74518,8/1/2023,SEN,Perak,0,0,0,Senegal
74519,8/1/2023,SEN,Perlis,0,0,0,Senegal
74520,8/1/2023,SEN,Pulau Pinang,0,0,0,Senegal
74521,8/1/2023,SEN,Sabah,0,0,0,Senegal
74522,8/1/2023,SEN,Sarawak,0,0,0,Senegal
74523,8/1/2023,SEN,Selangor,137,74,63,Senegal
74524,8/1/2023,SGP,Johor,1198428,694040,504388,Singapore
74525,8/1/2023,SGP,Kedah,4225,2203,2022,Singapore
74526,8/1/2023,SGP,Kelantan,67,52,15,Singapore
74527,8/1/2023,SGP,Melaka,36,24,12,Singapore
74528,8/1/2023,SGP,Negeri Sembilan,0,0,0,Singapore
74529,8/1/2023,SGP,Pahang,468,239,229,Singapore
74530,8/1/2023,SGP,Perak,5898,2601,3297,Singapore
74531,8/1/2023,SGP,Perlis,192,123,69,Singapore
74532,8/1/2023,SGP,Pulau Pinang,18427,8890,9537,Singapore
74533,8/1/2023,SGP,Sabah,610,330,280,Singapore
74534,8/1/2023,SGP,Sarawak,3789,2226,1563,Singapore
74535,8/1/2023,SGP,Selangor,43929,22787,21142,Singapore
74536,8/1/2023,SGP,Terengganu,0,0,0,Singapore
74537,8/1/2023,SGP,W.P. Labuan,11,11,0,Singapore
74538,8/1/2023,SGS,Johor,0,0,0,South Georgia and the South Sandwich Islands
74539,8/1/2023,SGS,Sabah,0,0,0,South Georgia and the South Sandwich Islands
74540,8/1/2023,SGS,Selangor,0,0,0,South Georgia and the South Sandwich Islands
74541,8/1/2023,SHN,Sarawak,0,0,0,"Saint Helena, Ascension and Tristan da Cunha"
74542,8/1/2023,SLB,Johor,1,1,0,Solomon Islands
74543,8/1/2023,SLB,Perlis,0,0,0,Solomon Islands
74544,8/1/2023,SLB,Pulau Pinang,1,1,0,Solomon Islands
74545,8/1/2023,SLB,Sabah,0,0,0,Solomon Islands
74546,8/1/2023,SLB,Sarawak,1,1,0,Solomon Islands
74547,8/1/2023,SLB,Selangor,4,3,1,Solomon Islands
74548,8/1/2023,SLB,W.P. Labuan,0,0,0,Solomon Islands
74549,8/1/2023,SLE,Johor,4,3,1,Sierra Leone
74550,8/1/2023,SLE,Kedah,0,0,0,Sierra Leone
74551,8/1/2023,SLE,Perak,0,0,0,Sierra Leone
74552,8/1/2023,SLE,Pulau Pinang,0,0,0,Sierra Leone
74553,8/1/2023,SLE,Sabah,0,0,0,Sierra Leone
74554,8/1/2023,SLE,Selangor,15,12,3,Sierra Leone
74555,8/1/2023,SLV,Johor,3,0,3,El Salvador
74556,8/1/2023,SLV,Kedah,0,0,0,El Salvador
74557,8/1/2023,SLV,Perak,1,0,1,El Salvador
74558,8/1/2023,SLV,Perlis,0,0,0,El Salvador
74559,8/1/2023,SLV,Pulau Pinang,0,0,0,El Salvador
74560,8/1/2023,SLV,Sabah,1,1,0,El Salvador
74561,8/1/2023,SLV,Selangor,18,6,12,El Salvador
74562,8/1/2023,SLV,W.P. Labuan,0,0,0,El Salvador
74563,8/1/2023,SMR,Johor,0,0,0,San Marino
74564,8/1/2023,SMR,Selangor,4,2,2,San Marino
74565,8/1/2023,SOM,Johor,0,0,0,Somalia
74566,8/1/2023,SOM,Kedah,0,0,0,Somalia
74567,8/1/2023,SOM,Kelantan,0,0,0,Somalia
74568,8/1/2023,SOM,Perlis,0,0,0,Somalia
74569,8/1/2023,SOM,Sabah,0,0,0,Somalia
74570,8/1/2023,SOM,Sarawak,0,0,0,Somalia
74571,8/1/2023,SOM,Selangor,248,139,109,Somalia
74572,8/1/2023,SRB,Johor,17,13,4,Serbia
74573,8/1/2023,SRB,Kedah,0,0,0,Serbia
74574,8/1/2023,SRB,Kelantan,1,1,0,Serbia
74575,8/1/2023,SRB,Pahang,0,0,0,Serbia
74576,8/1/2023,SRB,Perak,0,0,0,Serbia
74577,8/1/2023,SRB,Perlis,0,0,0,Serbia
74578,8/1/2023,SRB,Pulau Pinang,1,1,0,Serbia
74579,8/1/2023,SRB,Sabah,0,0,0,Serbia
74580,8/1/2023,SRB,Sarawak,0,0,0,Serbia
74581,8/1/2023,SRB,Selangor,81,38,43,Serbia
74582,8/1/2023,STP,Selangor,2,2,0,Sao Tome and Principe
74583,8/1/2023,SUR,Johor,4,2,2,Suriname
74584,8/1/2023,SUR,Kedah,0,0,0,Suriname
74585,8/1/2023,SUR,Kelantan,0,0,0,Suriname
74586,8/1/2023,SUR,Perak,0,0,0,Suriname
74587,8/1/2023,SUR,Perlis,0,0,0,Suriname
74588,8/1/2023,SUR,Pulau Pinang,0,0,0,Suriname
74589,8/1/2023,SUR,Sabah,0,0,0,Suriname
74590,8/1/2023,SUR,Sarawak,0,0,0,Suriname
74591,8/1/2023,SUR,Selangor,38,23,15,Suriname
74592,8/1/2023,SVK,Johor,49,23,26,Slovakia
74593,8/1/2023,SVK,Kedah,25,10,15,Slovakia
74594,8/1/2023,SVK,Kelantan,2,2,0,Slovakia
74595,8/1/2023,SVK,Negeri Sembilan,0,0,0,Slovakia
74596,8/1/2023,SVK,Pahang,0,0,0,Slovakia
74597,8/1/2023,SVK,Perak,0,0,0,Slovakia
74598,8/1/2023,SVK,Perlis,2,1,1,Slovakia
74599,8/1/2023,SVK,Pulau Pinang,20,13,7,Slovakia
74600,8/1/2023,SVK,Sabah,1,1,0,Slovakia
74601,8/1/2023,SVK,Sarawak,7,4,3,Slovakia
74602,8/1/2023,SVK,Selangor,231,119,112,Slovakia
74603,8/1/2023,SVK,W.P. Labuan,0,0,0,Slovakia
74604,8/1/2023,SVN,Johor,24,8,16,Slovenia
74605,8/1/2023,SVN,Kedah,4,3,1,Slovenia
74606,8/1/2023,SVN,Kelantan,0,0,0,Slovenia
74607,8/1/2023,SVN,Perak,0,0,0,Slovenia
74608,8/1/2023,SVN,Perlis,1,1,0,Slovenia
74609,8/1/2023,SVN,Pulau Pinang,2,1,1,Slovenia
74610,8/1/2023,SVN,Sabah,1,0,1,Slovenia
74611,8/1/2023,SVN,Sarawak,6,4,2,Slovenia
74612,8/1/2023,SVN,Selangor,151,80,71,Slovenia
74613,8/1/2023,SVN,W.P. Labuan,0,0,0,Slovenia
74614,8/1/2023,SWE,Johor,219,142,77,Sweden
74615,8/1/2023,SWE,Kedah,35,26,9,Sweden
74616,8/1/2023,SWE,Kelantan,14,8,6,Sweden
74617,8/1/2023,SWE,Melaka,0,0,0,Sweden
74618,8/1/2023,SWE,Negeri Sembilan,0,0,0,Sweden
74619,8/1/2023,SWE,Pahang,0,0,0,Sweden
74620,8/1/2023,SWE,Perak,3,3,0,Sweden
74621,8/1/2023,SWE,Perlis,8,7,1,Sweden
74622,8/1/2023,SWE,Pulau Pinang,50,31,19,Sweden
74623,8/1/2023,SWE,Sabah,3,0,3,Sweden
74624,8/1/2023,SWE,Sarawak,49,32,17,Sweden
74625,8/1/2023,SWE,Selangor,818,525,293,Sweden
74626,8/1/2023,SWE,W.P. Labuan,0,0,0,Sweden
74627,8/1/2023,SWZ,Johor,0,0,0,Swaziland
74628,8/1/2023,SWZ,Kedah,1,0,1,Swaziland
74629,8/1/2023,SWZ,Pulau Pinang,0,0,0,Swaziland
74630,8/1/2023,SWZ,Sabah,0,0,0,Swaziland
74631,8/1/2023,SWZ,Selangor,25,12,13,Swaziland
74632,8/1/2023,SYC,Johor,7,4,3,Seychelles
74633,8/1/2023,SYC,Kedah,0,0,0,Seychelles
74634,8/1/2023,SYC,Pulau Pinang,0,0,0,Seychelles
74635,8/1/2023,SYC,Sabah,1,1,0,Seychelles
74636,8/1/2023,SYC,Sarawak,0,0,0,Seychelles
74637,8/1/2023,SYC,Selangor,106,45,61,Seychelles
74638,8/1/2023,SYR,Johor,16,12,4,Syrian Arab Republic
74639,8/1/2023,SYR,Kedah,1,1,0,Syrian Arab Republic
74640,8/1/2023,SYR,Kelantan,0,0,0,Syrian Arab Republic
74641,8/1/2023,SYR,Pahang,0,0,0,Syrian Arab Republic
74642,8/1/2023,SYR,Perlis,0,0,0,Syrian Arab Republic
74643,8/1/2023,SYR,Pulau Pinang,8,5,3,Syrian Arab Republic
74644,8/1/2023,SYR,Sabah,0,0,0,Syrian Arab Republic
74645,8/1/2023,SYR,Sarawak,2,2,0,Syrian Arab Republic
74646,8/1/2023,SYR,Selangor,895,486,409,Syrian Arab Republic
74647,8/1/2023,SYR,W.P. Labuan,0,0,0,Syrian Arab Republic
74648,8/1/2023,TCA,Perlis,0,0,0,Turks and Caicos
74649,8/1/2023,TCD,Johor,4,2,2,Chad
74650,8/1/2023,TCD,Kedah,0,0,0,Chad
74651,8/1/2023,TCD,Perlis,0,0,0,Chad
74652,8/1/2023,TCD,Selangor,18,14,4,Chad
74653,8/1/2023,TGO,Johor,3,2,1,Togo
74654,8/1/2023,TGO,Perak,0,0,0,Togo
74655,8/1/2023,TGO,Pulau Pinang,0,0,0,Togo
74656,8/1/2023,TGO,Selangor,14,11,3,Togo
74657,8/1/2023,THA,Johor,6278,1612,4666,Thailand
74658,8/1/2023,THA,Kedah,58229,34008,24221,Thailand
74659,8/1/2023,THA,Kelantan,34580,18957,15623,Thailand
74660,8/1/2023,THA,Melaka,1,1,0,Thailand
74661,8/1/2023,THA,Negeri Sembilan,0,0,0,Thailand
74662,8/1/2023,THA,Pahang,16,8,8,Thailand
74663,8/1/2023,THA,Perak,11287,5454,5833,Thailand
74664,8/1/2023,THA,Perlis,44145,25712,18433,Thailand
74665,8/1/2023,THA,Pulau Pinang,2014,821,1193,Thailand
74666,8/1/2023,THA,Sabah,8,5,3,Thailand
74667,8/1/2023,THA,Sarawak,322,108,214,Thailand
74668,8/1/2023,THA,Selangor,14524,5963,8561,Thailand
74669,8/1/2023,THA,Terengganu,0,0,0,Thailand
74670,8/1/2023,THA,W.P. Labuan,13,4,9,Thailand
74671,8/1/2023,TJK,Johor,2,1,1,Tajikistan
74672,8/1/2023,TJK,Kedah,1,0,1,Tajikistan
74673,8/1/2023,TJK,Perlis,0,0,0,Tajikistan
74674,8/1/2023,TJK,Pulau Pinang,5,2,3,Tajikistan
74675,8/1/2023,TJK,Sabah,1,1,0,Tajikistan
74676,8/1/2023,TJK,Selangor,118,93,25,Tajikistan
74677,8/1/2023,TKL,Selangor,0,0,0,Tokelau
74678,8/1/2023,TKM,Johor,4,2,2,Turkmenistan
74679,8/1/2023,TKM,Kedah,0,0,0,Turkmenistan
74680,8/1/2023,TKM,Kelantan,0,0,0,Turkmenistan
74681,8/1/2023,TKM,Perlis,0,0,0,Turkmenistan
74682,8/1/2023,TKM,Pulau Pinang,1,1,0,Turkmenistan
74683,8/1/2023,TKM,Sabah,1,1,0,Turkmenistan
74684,8/1/2023,TKM,Sarawak,0,0,0,Turkmenistan
74685,8/1/2023,TKM,Selangor,205,112,93,Turkmenistan
74686,8/1/2023,TLS,Johor,4,0,4,Timor-Leste
74687,8/1/2023,TLS,Kedah,0,0,0,Timor-Leste
74688,8/1/2023,TLS,Perlis,0,0,0,Timor-Leste
74689,8/1/2023,TLS,Pulau Pinang,12,7,5,Timor-Leste
74690,8/1/2023,TLS,Sabah,0,0,0,Timor-Leste
74691,8/1/2023,TLS,Sarawak,5,4,1,Timor-Leste
74692,8/1/2023,TLS,Selangor,270,151,119,Timor-Leste
74693,8/1/2023,TON,Johor,0,0,0,Tonga
74694,8/1/2023,TON,Pulau Pinang,2,0,2,Tonga
74695,8/1/2023,TON,Sarawak,0,0,0,Tonga
74696,8/1/2023,TON,Selangor,10,3,7,Tonga
74697,8/1/2023,TTO,Johor,5,2,3,Trinidad and Tobago
74698,8/1/2023,TTO,Kedah,0,0,0,Trinidad and Tobago
74699,8/1/2023,TTO,Pahang,0,0,0,Trinidad and Tobago
74700,8/1/2023,TTO,Pulau Pinang,4,2,2,Trinidad and Tobago
74701,8/1/2023,TTO,Sabah,0,0,0,Trinidad and Tobago
74702,8/1/2023,TTO,Sarawak,1,0,1,Trinidad and Tobago
74703,8/1/2023,TTO,Selangor,50,27,23,Trinidad and Tobago
74704,8/1/2023,TUN,Johor,10,9,1,Tunisia
74705,8/1/2023,TUN,Kedah,4,3,1,Tunisia
74706,8/1/2023,TUN,Kelantan,2,2,0,Tunisia
74707,8/1/2023,TUN,Melaka,0,0,0,Tunisia
74708,8/1/2023,TUN,Perak,0,0,0,Tunisia
74709,8/1/2023,TUN,Perlis,0,0,0,Tunisia
74710,8/1/2023,TUN,Pulau Pinang,1,1,0,Tunisia
74711,8/1/2023,TUN,Sabah,1,0,1,Tunisia
74712,8/1/2023,TUN,Sarawak,3,3,0,Tunisia
74713,8/1/2023,TUN,Selangor,2252,1014,1238,Tunisia
74714,8/1/2023,TUN,W.P. Labuan,0,0,0,Tunisia
74715,8/1/2023,TUR,Johor,376,271,105,Turkey
74716,8/1/2023,TUR,Kedah,56,33,23,Turkey
74717,8/1/2023,TUR,Kelantan,2,2,0,Turkey
74718,8/1/2023,TUR,Melaka,0,0,0,Turkey
74719,8/1/2023,TUR,Negeri Sembilan,2,1,1,Turkey
74720,8/1/2023,TUR,Pahang,0,0,0,Turkey
74721,8/1/2023,TUR,Perak,1,1,0,Turkey
74722,8/1/2023,TUR,Perlis,30,27,3,Turkey
74723,8/1/2023,TUR,Pulau Pinang,27,22,5,Turkey
74724,8/1/2023,TUR,Sabah,4,2,2,Turkey
74725,8/1/2023,TUR,Sarawak,23,18,5,Turkey
74726,8/1/2023,TUR,Selangor,1498,1014,484,Turkey
74727,8/1/2023,TUR,W.P. Labuan,1,1,0,Turkey
74728,8/1/2023,TUV,Selangor,0,0,0,Tuvalu
74729,8/1/2023,TWN,Johor,9321,4190,5131,Taiwan
74730,8/1/2023,TWN,Kedah,159,75,84,Taiwan
74731,8/1/2023,TWN,Kelantan,0,0,0,Taiwan
74732,8/1/2023,TWN,Melaka,4,3,1,Taiwan
74733,8/1/2023,TWN,Negeri Sembilan,0,0,0,Taiwan
74734,8/1/2023,TWN,Pahang,8,3,5,Taiwan
74735,8/1/2023,TWN,Perak,59,35,24,Taiwan
74736,8/1/2023,TWN,Perlis,33,17,16,Taiwan
74737,8/1/2023,TWN,Pulau Pinang,4854,2338,2516,Taiwan
74738,8/1/2023,TWN,Sabah,241,144,97,Taiwan
74739,8/1/2023,TWN,Sarawak,338,156,182,Taiwan
74740,8/1/2023,TWN,Selangor,20807,10105,10702,Taiwan
74741,8/1/2023,TWN,W.P. Labuan,3,2,1,Taiwan
74742,8/1/2023,TZA,Johor,43,24,19,"Tanzania, United Republic of"
74743,8/1/2023,TZA,Kedah,0,0,0,"Tanzania, United Republic of"
74744,8/1/2023,TZA,Perak,0,0,0,"Tanzania, United Republic of"
74745,8/1/2023,TZA,Perlis,0,0,0,"Tanzania, United Republic of"
74746,8/1/2023,TZA,Pulau Pinang,0,0,0,"Tanzania, United Republic of"
74747,8/1/2023,TZA,Sabah,0,0,0,"Tanzania, United Republic of"
74748,8/1/2023,TZA,Sarawak,4,4,0,"Tanzania, United Republic of"
74749,8/1/2023,TZA,Selangor,201,107,94,"Tanzania, United Republic of"
74750,8/1/2023,UGA,Johor,22,8,14,Uganda
74751,8/1/2023,UGA,Kedah,2,0,2,Uganda
74752,8/1/2023,UGA,Perak,0,0,0,Uganda
74753,8/1/2023,UGA,Perlis,0,0,0,Uganda
74754,8/1/2023,UGA,Pulau Pinang,2,1,1,Uganda
74755,8/1/2023,UGA,Sabah,0,0,0,Uganda
74756,8/1/2023,UGA,Sarawak,0,0,0,Uganda
74757,8/1/2023,UGA,Selangor,112,45,67,Uganda
74758,8/1/2023,UKR,Johor,122,69,53,Ukraine
74759,8/1/2023,UKR,Kedah,17,8,9,Ukraine
74760,8/1/2023,UKR,Kelantan,1,1,0,Ukraine
74761,8/1/2023,UKR,Melaka,0,0,0,Ukraine
74762,8/1/2023,UKR,Negeri Sembilan,0,0,0,Ukraine
74763,8/1/2023,UKR,Pahang,3,3,0,Ukraine
74764,8/1/2023,UKR,Perak,0,0,0,Ukraine
74765,8/1/2023,UKR,Perlis,7,3,4,Ukraine
74766,8/1/2023,UKR,Pulau Pinang,17,6,11,Ukraine
74767,8/1/2023,UKR,Sabah,1,1,0,Ukraine
74768,8/1/2023,UKR,Sarawak,10,3,7,Ukraine
74769,8/1/2023,UKR,Selangor,950,471,479,Ukraine
74770,8/1/2023,UKR,W.P. Labuan,0,0,0,Ukraine
74771,8/1/2023,URY,Johor,4,2,2,Uruguay
74772,8/1/2023,URY,Kedah,1,1,0,Uruguay
74773,8/1/2023,URY,Kelantan,0,0,0,Uruguay
74774,8/1/2023,URY,Perak,0,0,0,Uruguay
74775,8/1/2023,URY,Perlis,0,0,0,Uruguay
74776,8/1/2023,URY,Pulau Pinang,0,0,0,Uruguay
74777,8/1/2023,URY,Sabah,0,0,0,Uruguay
74778,8/1/2023,URY,Sarawak,1,1,0,Uruguay
74779,8/1/2023,URY,Selangor,78,49,29,Uruguay
74780,8/1/2023,URY,W.P. Labuan,0,0,0,Uruguay
74781,8/1/2023,USA,Johor,4514,2677,1837,United States Of America
74782,8/1/2023,USA,Kedah,389,217,172,United States Of America
74783,8/1/2023,USA,Kelantan,7,5,2,United States Of America
74784,8/1/2023,USA,Melaka,1,0,1,United States Of America
74785,8/1/2023,USA,Negeri Sembilan,0,0,0,United States Of America
74786,8/1/2023,USA,Pahang,13,8,5,United States Of America
74787,8/1/2023,USA,Perak,229,115,114,United States Of America
74788,8/1/2023,USA,Perlis,95,60,35,United States Of America
74789,8/1/2023,USA,Pulau Pinang,2069,1247,822,United States Of America
74790,8/1/2023,USA,Sabah,57,34,23,United States Of America
74791,8/1/2023,USA,Sarawak,282,162,120,United States Of America
74792,8/1/2023,USA,Selangor,14499,8628,5871,United States Of America
74793,8/1/2023,USA,Terengganu,0,0,0,United States Of America
74794,8/1/2023,USA,W.P. Labuan,13,9,4,United States Of America
74795,8/1/2023,UZB,Johor,82,59,23,Uzbekistan
74796,8/1/2023,UZB,Kedah,5,0,5,Uzbekistan
74797,8/1/2023,UZB,Kelantan,0,0,0,Uzbekistan
74798,8/1/2023,UZB,Perak,0,0,0,Uzbekistan
74799,8/1/2023,UZB,Perlis,1,1,0,Uzbekistan
74800,8/1/2023,UZB,Pulau Pinang,27,9,18,Uzbekistan
74801,8/1/2023,UZB,Sabah,3,2,1,Uzbekistan
74802,8/1/2023,UZB,Sarawak,3,0,3,Uzbekistan
74803,8/1/2023,UZB,Selangor,1280,773,507,Uzbekistan
74804,8/1/2023,VAT,Johor,0,0,0,Holy See (Vatican City State)
74805,8/1/2023,VAT,Sarawak,0,0,0,Holy See (Vatican City State)
74806,8/1/2023,VAT,Selangor,0,0,0,Holy See (Vatican City State)
74807,8/1/2023,VCT,Johor,0,0,0,Saint Vincent and the Grenadines
74808,8/1/2023,VCT,Kedah,0,0,0,Saint Vincent and the Grenadines
74809,8/1/2023,VCT,Pulau Pinang,0,0,0,Saint Vincent and the Grenadines
74810,8/1/2023,VCT,Sarawak,0,0,0,Saint Vincent and the Grenadines
74811,8/1/2023,VCT,Selangor,1,1,0,Saint Vincent and the Grenadines
74812,8/1/2023,VEN,Johor,17,9,8,Venezuela
74813,8/1/2023,VEN,Kedah,4,3,1,Venezuela
74814,8/1/2023,VEN,Kelantan,0,0,0,Venezuela
74815,8/1/2023,VEN,Melaka,0,0,0,Venezuela
74816,8/1/2023,VEN,Perak,0,0,0,Venezuela
74817,8/1/2023,VEN,Perlis,0,0,0,Venezuela
74818,8/1/2023,VEN,Pulau Pinang,0,0,0,Venezuela
74819,8/1/2023,VEN,Sabah,0,0,0,Venezuela
74820,8/1/2023,VEN,Sarawak,0,0,0,Venezuela
74821,8/1/2023,VEN,Selangor,91,53,38,Venezuela
74822,8/1/2023,VEN,W.P. Labuan,0,0,0,Venezuela
74823,8/1/2023,VNM,Johor,21679,7775,13904,Vietnam
74824,8/1/2023,VNM,Kedah,241,39,202,Vietnam
74825,8/1/2023,VNM,Kelantan,18,14,4,Vietnam
74826,8/1/2023,VNM,Melaka,0,0,0,Vietnam
74827,8/1/2023,VNM,Negeri Sembilan,0,0,0,Vietnam
74828,8/1/2023,VNM,Pahang,0,0,0,Vietnam
74829,8/1/2023,VNM,Perak,85,9,76,Vietnam
74830,8/1/2023,VNM,Perlis,283,25,258,Vietnam
74831,8/1/2023,VNM,Pulau Pinang,1724,554,1170,Vietnam
74832,8/1/2023,VNM,Sabah,8,5,3,Vietnam
74833,8/1/2023,VNM,Sarawak,135,35,100,Vietnam
74834,8/1/2023,VNM,Selangor,19361,7455,11906,Vietnam
74835,8/1/2023,VNM,Terengganu,0,0,0,Vietnam
74836,8/1/2023,VNM,W.P. Labuan,3,2,1,Vietnam
74837,8/1/2023,VUT,Johor,73,58,15,Vanuatu
74838,8/1/2023,VUT,Kedah,0,0,0,Vanuatu
74839,8/1/2023,VUT,Pulau Pinang,6,3,3,Vanuatu
74840,8/1/2023,VUT,Sabah,2,2,0,Vanuatu
74841,8/1/2023,VUT,Sarawak,1,1,0,Vanuatu
74842,8/1/2023,VUT,Selangor,83,64,19,Vanuatu
74843,8/1/2023,WSM,Johor,2,0,2,Samoa
74844,8/1/2023,WSM,Sarawak,0,0,0,Samoa
74845,8/1/2023,WSM,Selangor,1,0,1,Samoa
74846,8/1/2023,YEM,Johor,51,34,17,Yemen
74847,8/1/2023,YEM,Kedah,1,1,0,Yemen
74848,8/1/2023,YEM,Kelantan,1,1,0,Yemen
74849,8/1/2023,YEM,Melaka,0,0,0,Yemen
74850,8/1/2023,YEM,Pahang,0,0,0,Yemen
74851,8/1/2023,YEM,Perak,0,0,0,Yemen
74852,8/1/2023,YEM,Perlis,1,1,0,Yemen
74853,8/1/2023,YEM,Pulau Pinang,8,6,2,Yemen
74854,8/1/2023,YEM,Sabah,0,0,0,Yemen
74855,8/1/2023,YEM,Sarawak,1,0,1,Yemen
74856,8/1/2023,YEM,Selangor,1707,1107,600,Yemen
74857,8/1/2023,YEM,W.P. Labuan,0,0,0,Yemen
74858,8/1/2023,ZAF,Johor,243,143,100,South Africa
74859,8/1/2023,ZAF,Kedah,23,14,9,South Africa
74860,8/1/2023,ZAF,Kelantan,2,2,0,South Africa
74861,8/1/2023,ZAF,Melaka,0,0,0,South Africa
74862,8/1/2023,ZAF,Pahang,0,0,0,South Africa
74863,8/1/2023,ZAF,Perak,3,2,1,South Africa
74864,8/1/2023,ZAF,Perlis,18,9,9,South Africa
74865,8/1/2023,ZAF,Pulau Pinang,67,37,30,South Africa
74866,8/1/2023,ZAF,Sabah,8,5,3,South Africa
74867,8/1/2023,ZAF,Sarawak,112,52,60,South Africa
74868,8/1/2023,ZAF,Selangor,914,512,402,South Africa
74869,8/1/2023,ZAF,Terengganu,0,0,0,South Africa
74870,8/1/2023,ZAF,W.P. Labuan,13,5,8,South Africa
74871,8/1/2023,ZMB,Johor,2,1,1,Zambia
74872,8/1/2023,ZMB,Kedah,0,0,0,Zambia
74873,8/1/2023,ZMB,Perak,0,0,0,Zambia
74874,8/1/2023,ZMB,Perlis,0,0,0,Zambia
74875,8/1/2023,ZMB,Pulau Pinang,0,0,0,Zambia
74876,8/1/2023,ZMB,Sabah,0,0,0,Zambia
74877,8/1/2023,ZMB,Sarawak,1,0,1,Zambia
74878,8/1/2023,ZMB,Selangor,77,45,32,Zambia
74879,8/1/2023,ZWE,Johor,3,0,3,Zimbabwe
74880,8/1/2023,ZWE,Kedah,1,0,1,Zimbabwe
74881,8/1/2023,ZWE,Kelantan,0,0,0,Zimbabwe
74882,8/1/2023,ZWE,Perak,0,0,0,Zimbabwe
74883,8/1/2023,ZWE,Perlis,0,0,0,Zimbabwe
74884,8/1/2023,ZWE,Pulau Pinang,13,7,6,Zimbabwe
74885,8/1/2023,ZWE,Sabah,1,1,0,Zimbabwe
74886,8/1/2023,ZWE,Sarawak,1,1,0,Zimbabwe
74887,8/1/2023,ZWE,Selangor,179,82,97,Zimbabwe
74888,9/1/2023,ABW,Kedah,0,0,0,Aruba
74889,9/1/2023,ABW,Pulau Pinang,0,0,0,Aruba
74890,9/1/2023,AFG,Johor,2,2,0,Afghanistan
74891,9/1/2023,AFG,Kedah,2,2,0,Afghanistan
74892,9/1/2023,AFG,Perlis,0,0,0,Afghanistan
74893,9/1/2023,AFG,Pulau Pinang,0,0,0,Afghanistan
74894,9/1/2023,AFG,Sarawak,0,0,0,Afghanistan
74895,9/1/2023,AFG,Selangor,62,50,12,Afghanistan
74896,9/1/2023,AGO,Johor,0,0,0,Angola
74897,9/1/2023,AGO,Kedah,0,0,0,Angola
74898,9/1/2023,AGO,Sabah,0,0,0,Angola
74899,9/1/2023,AGO,Selangor,7,3,4,Angola
74900,9/1/2023,AIA,Selangor,0,0,0,Anguilla
74901,9/1/2023,ALB,Johor,25,19,6,Albania
74902,9/1/2023,ALB,Kedah,1,1,0,Albania
74903,9/1/2023,ALB,Perak,0,0,0,Albania
74904,9/1/2023,ALB,Perlis,0,0,0,Albania
74905,9/1/2023,ALB,Pulau Pinang,0,0,0,Albania
74906,9/1/2023,ALB,Sabah,0,0,0,Albania
74907,9/1/2023,ALB,Sarawak,0,0,0,Albania
74908,9/1/2023,ALB,Selangor,34,17,17,Albania
74909,9/1/2023,AND,Johor,1,1,0,Andorra
74910,9/1/2023,AND,Kedah,0,0,0,Andorra
74911,9/1/2023,AND,Perlis,0,0,0,Andorra
74912,9/1/2023,AND,Pulau Pinang,0,0,0,Andorra
74913,9/1/2023,AND,Selangor,7,3,4,Andorra
74914,9/1/2023,ANT,Selangor,0,0,0,Netherlands Antilles
74915,9/1/2023,ARE,Johor,8,5,3,United Arab Emirates
74916,9/1/2023,ARE,Kedah,4,1,3,United Arab Emirates
74917,9/1/2023,ARE,Kelantan,0,0,0,United Arab Emirates
74918,9/1/2023,ARE,Perak,0,0,0,United Arab Emirates
74919,9/1/2023,ARE,Perlis,0,0,0,United Arab Emirates
74920,9/1/2023,ARE,Pulau Pinang,6,4,2,United Arab Emirates
74921,9/1/2023,ARE,Sabah,0,0,0,United Arab Emirates
74922,9/1/2023,ARE,Sarawak,0,0,0,United Arab Emirates
74923,9/1/2023,ARE,Selangor,361,243,118,United Arab Emirates
74924,9/1/2023,ARG,Johor,51,27,24,Argentina
74925,9/1/2023,ARG,Kedah,11,5,6,Argentina
74926,9/1/2023,ARG,Kelantan,4,2,2,Argentina
74927,9/1/2023,ARG,Melaka,0,0,0,Argentina
74928,9/1/2023,ARG,Perak,0,0,0,Argentina
74929,9/1/2023,ARG,Perlis,3,2,1,Argentina
74930,9/1/2023,ARG,Pulau Pinang,1,0,1,Argentina
74931,9/1/2023,ARG,Sabah,1,1,0,Argentina
74932,9/1/2023,ARG,Sarawak,1,1,0,Argentina
74933,9/1/2023,ARG,Selangor,409,231,178,Argentina
74934,9/1/2023,ARG,W.P. Labuan,3,1,2,Argentina
74935,9/1/2023,ARM,Johor,0,0,0,Armenia
74936,9/1/2023,ARM,Kedah,0,0,0,Armenia
74937,9/1/2023,ARM,Kelantan,0,0,0,Armenia
74938,9/1/2023,ARM,Perak,0,0,0,Armenia
74939,9/1/2023,ARM,Perlis,0,0,0,Armenia
74940,9/1/2023,ARM,Pulau Pinang,2,0,2,Armenia
74941,9/1/2023,ARM,Sabah,0,0,0,Armenia
74942,9/1/2023,ARM,Sarawak,0,0,0,Armenia
74943,9/1/2023,ARM,Selangor,58,35,23,Armenia
74944,9/1/2023,ATA,Selangor,0,0,0,Antarctica
74945,9/1/2023,ATG,Johor,6,3,3,Antigua and Barbuda
74946,9/1/2023,ATG,Kedah,0,0,0,Antigua and Barbuda
74947,9/1/2023,ATG,Pulau Pinang,0,0,0,Antigua and Barbuda
74948,9/1/2023,ATG,Sarawak,0,0,0,Antigua and Barbuda
74949,9/1/2023,ATG,Selangor,19,12,7,Antigua and Barbuda
74950,9/1/2023,AUS,Johor,5978,3502,2476,Australia
74951,9/1/2023,AUS,Kedah,537,273,264,Australia
74952,9/1/2023,AUS,Kelantan,3,3,0,Australia
74953,9/1/2023,AUS,Melaka,1,1,0,Australia
74954,9/1/2023,AUS,Negeri Sembilan,2,2,0,Australia
74955,9/1/2023,AUS,Pahang,21,11,10,Australia
74956,9/1/2023,AUS,Perak,221,117,104,Australia
74957,9/1/2023,AUS,Perlis,67,47,20,Australia
74958,9/1/2023,AUS,Pulau Pinang,2032,1123,909,Australia
74959,9/1/2023,AUS,Sabah,116,65,51,Australia
74960,9/1/2023,AUS,Sarawak,580,305,275,Australia
74961,9/1/2023,AUS,Selangor,29390,16640,12750,Australia
74962,9/1/2023,AUS,Terengganu,1,1,0,Australia
74963,9/1/2023,AUS,W.P. Labuan,3,2,1,Australia
74964,9/1/2023,AUT,Johor,203,144,59,Austria
74965,9/1/2023,AUT,Kedah,29,12,17,Austria
74966,9/1/2023,AUT,Kelantan,3,2,1,Austria
74967,9/1/2023,AUT,Melaka,0,0,0,Austria
74968,9/1/2023,AUT,Negeri Sembilan,0,0,0,Austria
74969,9/1/2023,AUT,Pahang,0,0,0,Austria
74970,9/1/2023,AUT,Perak,2,2,0,Austria
74971,9/1/2023,AUT,Perlis,1,0,1,Austria
74972,9/1/2023,AUT,Pulau Pinang,66,41,25,Austria
74973,9/1/2023,AUT,Sabah,0,0,0,Austria
74974,9/1/2023,AUT,Sarawak,16,7,9,Austria
74975,9/1/2023,AUT,Selangor,810,481,329,Austria
74976,9/1/2023,AUT,Terengganu,0,0,0,Austria
74977,9/1/2023,AUT,W.P. Labuan,0,0,0,Austria
74978,9/1/2023,AZE,Johor,4,3,1,Azerbaijan
74979,9/1/2023,AZE,Kedah,0,0,0,Azerbaijan
74980,9/1/2023,AZE,Kelantan,0,0,0,Azerbaijan
74981,9/1/2023,AZE,Melaka,0,0,0,Azerbaijan
74982,9/1/2023,AZE,Perlis,0,0,0,Azerbaijan
74983,9/1/2023,AZE,Pulau Pinang,4,2,2,Azerbaijan
74984,9/1/2023,AZE,Sabah,0,0,0,Azerbaijan
74985,9/1/2023,AZE,Sarawak,6,1,5,Azerbaijan
74986,9/1/2023,AZE,Selangor,138,84,54,Azerbaijan
74987,9/1/2023,AZE,W.P. Labuan,5,5,0,Azerbaijan
74988,9/1/2023,BDI,Pulau Pinang,1,0,1,Burundi
74989,9/1/2023,BDI,Sarawak,0,0,0,Burundi
74990,9/1/2023,BDI,Selangor,31,9,22,Burundi
74991,9/1/2023,BEL,Johor,387,217,170,Belgium
74992,9/1/2023,BEL,Kedah,41,25,16,Belgium
74993,9/1/2023,BEL,Kelantan,1,1,0,Belgium
74994,9/1/2023,BEL,Melaka,0,0,0,Belgium
74995,9/1/2023,BEL,Negeri Sembilan,0,0,0,Belgium
74996,9/1/2023,BEL,Pahang,6,3,3,Belgium
74997,9/1/2023,BEL,Perak,2,1,1,Belgium
74998,9/1/2023,BEL,Perlis,11,6,5,Belgium
74999,9/1/2023,BEL,Pulau Pinang,69,47,22,Belgium
75000,9/1/2023,BEL,Sabah,11,6,5,Belgium
75001,9/1/2023,BEL,Sarawak,25,12,13,Belgium
75002,9/1/2023,BEL,Selangor,1655,909,746,Belgium
75003,9/1/2023,BEL,W.P. Labuan,0,0,0,Belgium
75004,9/1/2023,BEN,Johor,2,2,0,Benin
75005,9/1/2023,BEN,Kedah,0,0,0,Benin
75006,9/1/2023,BEN,Perak,0,0,0,Benin
75007,9/1/2023,BEN,Pulau Pinang,0,0,0,Benin
75008,9/1/2023,BEN,Sabah,0,0,0,Benin
75009,9/1/2023,BEN,Sarawak,0,0,0,Benin
75010,9/1/2023,BEN,Selangor,23,17,6,Benin
75011,9/1/2023,BFA,Perak,0,0,0,Burkina Faso
75012,9/1/2023,BFA,Pulau Pinang,1,1,0,Burkina Faso
75013,9/1/2023,BFA,Selangor,26,22,4,Burkina Faso
75014,9/1/2023,BGD,Johor,3848,3272,576,Bangladesh
75015,9/1/2023,BGD,Kedah,117,67,50,Bangladesh
75016,9/1/2023,BGD,Kelantan,1,1,0,Bangladesh
75017,9/1/2023,BGD,Melaka,0,0,0,Bangladesh
75018,9/1/2023,BGD,Negeri Sembilan,0,0,0,Bangladesh
75019,9/1/2023,BGD,Pahang,2,0,2,Bangladesh
75020,9/1/2023,BGD,Perak,3,2,1,Bangladesh
75021,9/1/2023,BGD,Perlis,9,6,3,Bangladesh
75022,9/1/2023,BGD,Pulau Pinang,413,394,19,Bangladesh
75023,9/1/2023,BGD,Sabah,1,0,1,Bangladesh
75024,9/1/2023,BGD,Sarawak,49,37,12,Bangladesh
75025,9/1/2023,BGD,Selangor,51900,50055,1845,Bangladesh
75026,9/1/2023,BGD,W.P. Labuan,3,3,0,Bangladesh
75027,9/1/2023,BGR,Johor,44,24,20,Bulgaria
75028,9/1/2023,BGR,Kedah,4,4,0,Bulgaria
75029,9/1/2023,BGR,Kelantan,0,0,0,Bulgaria
75030,9/1/2023,BGR,Pahang,0,0,0,Bulgaria
75031,9/1/2023,BGR,Perak,0,0,0,Bulgaria
75032,9/1/2023,BGR,Perlis,0,0,0,Bulgaria
75033,9/1/2023,BGR,Pulau Pinang,3,1,2,Bulgaria
75034,9/1/2023,BGR,Sabah,2,1,1,Bulgaria
75035,9/1/2023,BGR,Sarawak,1,1,0,Bulgaria
75036,9/1/2023,BGR,Selangor,223,132,91,Bulgaria
75037,9/1/2023,BGR,W.P. Labuan,0,0,0,Bulgaria
75038,9/1/2023,BHR,Johor,13,7,6,Bahrain
75039,9/1/2023,BHR,Kedah,1,1,0,Bahrain
75040,9/1/2023,BHR,Kelantan,0,0,0,Bahrain
75041,9/1/2023,BHR,Perlis,0,0,0,Bahrain
75042,9/1/2023,BHR,Pulau Pinang,9,5,4,Bahrain
75043,9/1/2023,BHR,Sabah,0,0,0,Bahrain
75044,9/1/2023,BHR,Sarawak,1,1,0,Bahrain
75045,9/1/2023,BHR,Selangor,167,92,75,Bahrain
75046,9/1/2023,BHS,Johor,0,0,0,Bahamas
75047,9/1/2023,BHS,Kedah,0,0,0,Bahamas
75048,9/1/2023,BHS,Perak,0,0,0,Bahamas
75049,9/1/2023,BHS,Sabah,0,0,0,Bahamas
75050,9/1/2023,BHS,Sarawak,0,0,0,Bahamas
75051,9/1/2023,BHS,Selangor,6,3,3,Bahamas
75052,9/1/2023,BIH,Johor,11,7,4,Bosnia and Herzegovina
75053,9/1/2023,BIH,Kedah,1,0,1,Bosnia and Herzegovina
75054,9/1/2023,BIH,Perlis,0,0,0,Bosnia and Herzegovina
75055,9/1/2023,BIH,Pulau Pinang,2,2,0,Bosnia and Herzegovina
75056,9/1/2023,BIH,Sabah,0,0,0,Bosnia and Herzegovina
75057,9/1/2023,BIH,Sarawak,1,1,0,Bosnia and Herzegovina
75058,9/1/2023,BIH,Selangor,90,65,25,Bosnia and Herzegovina
75059,9/1/2023,BLR,Johor,12,7,5,Belarus
75060,9/1/2023,BLR,Kedah,2,2,0,Belarus
75061,9/1/2023,BLR,Kelantan,1,1,0,Belarus
75062,9/1/2023,BLR,Pahang,0,0,0,Belarus
75063,9/1/2023,BLR,Perak,0,0,0,Belarus
75064,9/1/2023,BLR,Perlis,1,0,1,Belarus
75065,9/1/2023,BLR,Pulau Pinang,11,7,4,Belarus
75066,9/1/2023,BLR,Sabah,1,0,1,Belarus
75067,9/1/2023,BLR,Sarawak,5,3,2,Belarus
75068,9/1/2023,BLR,Selangor,311,156,155,Belarus
75069,9/1/2023,BLR,W.P. Labuan,0,0,0,Belarus
75070,9/1/2023,BLZ,Johor,0,0,0,Belize
75071,9/1/2023,BLZ,Pulau Pinang,1,1,0,Belize
75072,9/1/2023,BLZ,Sarawak,0,0,0,Belize
75073,9/1/2023,BLZ,Selangor,8,2,6,Belize
75074,9/1/2023,BMU,Selangor,0,0,0,Bermuda
75075,9/1/2023,BOL,Johor,4,3,1,Bolivia
75076,9/1/2023,BOL,Kedah,0,0,0,Bolivia
75077,9/1/2023,BOL,Melaka,0,0,0,Bolivia
75078,9/1/2023,BOL,Perak,0,0,0,Bolivia
75079,9/1/2023,BOL,Perlis,0,0,0,Bolivia
75080,9/1/2023,BOL,Pulau Pinang,0,0,0,Bolivia
75081,9/1/2023,BOL,Sabah,0,0,0,Bolivia
75082,9/1/2023,BOL,Sarawak,1,1,0,Bolivia
75083,9/1/2023,BOL,Selangor,16,7,9,Bolivia
75084,9/1/2023,BRA,Johor,278,177,101,Brazil
75085,9/1/2023,BRA,Kedah,35,18,17,Brazil
75086,9/1/2023,BRA,Kelantan,0,0,0,Brazil
75087,9/1/2023,BRA,Melaka,0,0,0,Brazil
75088,9/1/2023,BRA,Pahang,1,0,1,Brazil
75089,9/1/2023,BRA,Perak,1,1,0,Brazil
75090,9/1/2023,BRA,Perlis,3,2,1,Brazil
75091,9/1/2023,BRA,Pulau Pinang,23,14,9,Brazil
75092,9/1/2023,BRA,Sabah,2,2,0,Brazil
75093,9/1/2023,BRA,Sarawak,10,3,7,Brazil
75094,9/1/2023,BRA,Selangor,986,590,396,Brazil
75095,9/1/2023,BRA,W.P. Labuan,0,0,0,Brazil
75096,9/1/2023,BRB,Johor,2,0,2,Barbados
75097,9/1/2023,BRB,Kedah,0,0,0,Barbados
75098,9/1/2023,BRB,Perlis,0,0,0,Barbados
75099,9/1/2023,BRB,Pulau Pinang,0,0,0,Barbados
75100,9/1/2023,BRB,Selangor,7,3,4,Barbados
75101,9/1/2023,BRN,Johor,423,220,203,Brunei Darussalam
75102,9/1/2023,BRN,Kedah,36,16,20,Brunei Darussalam
75103,9/1/2023,BRN,Kelantan,5,3,2,Brunei Darussalam
75104,9/1/2023,BRN,Melaka,0,0,0,Brunei Darussalam
75105,9/1/2023,BRN,Pahang,0,0,0,Brunei Darussalam
75106,9/1/2023,BRN,Perak,9,5,4,Brunei Darussalam
75107,9/1/2023,BRN,Perlis,23,13,10,Brunei Darussalam
75108,9/1/2023,BRN,Pulau Pinang,10,3,7,Brunei Darussalam
75109,9/1/2023,BRN,Sabah,148,62,86,Brunei Darussalam
75110,9/1/2023,BRN,Sarawak,63606,35362,28244,Brunei Darussalam
75111,9/1/2023,BRN,Selangor,5412,2668,2744,Brunei Darussalam
75112,9/1/2023,BRN,W.P. Labuan,1036,719,317,Brunei Darussalam
75113,9/1/2023,BTN,Johor,3,3,0,Bhutan
75114,9/1/2023,BTN,Kedah,0,0,0,Bhutan
75115,9/1/2023,BTN,Perak,0,0,0,Bhutan
75116,9/1/2023,BTN,Perlis,1,0,1,Bhutan
75117,9/1/2023,BTN,Pulau Pinang,4,4,0,Bhutan
75118,9/1/2023,BTN,Sabah,0,0,0,Bhutan
75119,9/1/2023,BTN,Sarawak,0,0,0,Bhutan
75120,9/1/2023,BTN,Selangor,87,49,38,Bhutan
75121,9/1/2023,BWA,Johor,6,4,2,Botswana
75122,9/1/2023,BWA,Kedah,1,1,0,Botswana
75123,9/1/2023,BWA,Perlis,0,0,0,Botswana
75124,9/1/2023,BWA,Pulau Pinang,0,0,0,Botswana
75125,9/1/2023,BWA,Sabah,0,0,0,Botswana
75126,9/1/2023,BWA,Sarawak,0,0,0,Botswana
75127,9/1/2023,BWA,Selangor,67,17,50,Botswana
75128,9/1/2023,CAF,Kedah,1,0,1,Central African Republic
75129,9/1/2023,CAF,Selangor,1,0,1,Central African Republic
75130,9/1/2023,CAN,Johor,1277,754,523,Canada
75131,9/1/2023,CAN,Kedah,93,53,40,Canada
75132,9/1/2023,CAN,Kelantan,0,0,0,Canada
75133,9/1/2023,CAN,Melaka,3,1,2,Canada
75134,9/1/2023,CAN,Negeri Sembilan,1,1,0,Canada
75135,9/1/2023,CAN,Pahang,4,4,0,Canada
75136,9/1/2023,CAN,Perak,17,8,9,Canada
75137,9/1/2023,CAN,Perlis,27,18,9,Canada
75138,9/1/2023,CAN,Pulau Pinang,389,223,166,Canada
75139,9/1/2023,CAN,Sabah,18,7,11,Canada
75140,9/1/2023,CAN,Sarawak,206,116,90,Canada
75141,9/1/2023,CAN,Selangor,3998,2372,1626,Canada
75142,9/1/2023,CAN,Terengganu,0,0,0,Canada
75143,9/1/2023,CAN,W.P. Labuan,2,1,1,Canada
75144,9/1/2023,CCK,Selangor,0,0,0,Cocos (Keeling) Islands
75145,9/1/2023,CHE,Johor,383,219,164,Switzerland
75146,9/1/2023,CHE,Kedah,63,33,30,Switzerland
75147,9/1/2023,CHE,Kelantan,1,1,0,Switzerland
75148,9/1/2023,CHE,Melaka,0,0,0,Switzerland
75149,9/1/2023,CHE,Negeri Sembilan,0,0,0,Switzerland
75150,9/1/2023,CHE,Pahang,0,0,0,Switzerland
75151,9/1/2023,CHE,Perak,1,1,0,Switzerland
75152,9/1/2023,CHE,Perlis,19,12,7,Switzerland
75153,9/1/2023,CHE,Pulau Pinang,102,70,32,Switzerland
75154,9/1/2023,CHE,Sabah,8,4,4,Switzerland
75155,9/1/2023,CHE,Sarawak,34,20,14,Switzerland
75156,9/1/2023,CHE,Selangor,1360,846,514,Switzerland
75157,9/1/2023,CHE,W.P. Labuan,1,1,0,Switzerland
75158,9/1/2023,CHL,Johor,41,19,22,Chile
75159,9/1/2023,CHL,Kedah,8,4,4,Chile
75160,9/1/2023,CHL,Kelantan,1,1,0,Chile
75161,9/1/2023,CHL,Melaka,0,0,0,Chile
75162,9/1/2023,CHL,Pahang,0,0,0,Chile
75163,9/1/2023,CHL,Perak,0,0,0,Chile
75164,9/1/2023,CHL,Perlis,6,5,1,Chile
75165,9/1/2023,CHL,Pulau Pinang,4,4,0,Chile
75166,9/1/2023,CHL,Sabah,1,1,0,Chile
75167,9/1/2023,CHL,Sarawak,2,2,0,Chile
75168,9/1/2023,CHL,Selangor,249,124,125,Chile
75169,9/1/2023,CHN,Johor,49921,21544,28377,China
75170,9/1/2023,CHN,Kedah,975,398,577,China
75171,9/1/2023,CHN,Kelantan,3,1,2,China
75172,9/1/2023,CHN,Melaka,2,1,1,China
75173,9/1/2023,CHN,Pahang,75,42,33,China
75174,9/1/2023,CHN,Perak,203,88,115,China
75175,9/1/2023,CHN,Perlis,73,40,33,China
75176,9/1/2023,CHN,Pulau Pinang,8074,4341,3733,China
75177,9/1/2023,CHN,Sabah,2008,929,1079,China
75178,9/1/2023,CHN,Sarawak,1023,582,441,China
75179,9/1/2023,CHN,Selangor,109565,54338,55227,China
75180,9/1/2023,CHN,Terengganu,0,0,0,China
75181,9/1/2023,CHN,W.P. Labuan,49,40,9,China
75182,9/1/2023,CIV,Johor,1,0,1,C��te d'Iv
75183,9/1/2023,CIV,Kedah,0,0,0,C��te d'Iv
75184,9/1/2023,CIV,Pulau Pinang,0,0,0,C��te d'Iv
75185,9/1/2023,CIV,Sabah,0,0,0,C��te d'Iv
75186,9/1/2023,CIV,Sarawak,0,0,0,C��te d'Iv
75187,9/1/2023,CIV,Selangor,66,53,13,C��te d'Iv
75188,9/1/2023,CMR,Johor,1,1,0,Cameroon
75189,9/1/2023,CMR,Kedah,0,0,0,Cameroon
75190,9/1/2023,CMR,Pulau Pinang,1,1,0,Cameroon
75191,9/1/2023,CMR,Sabah,0,0,0,Cameroon
75192,9/1/2023,CMR,Sarawak,1,1,0,Cameroon
75193,9/1/2023,CMR,Selangor,77,61,16,Cameroon
75194,9/1/2023,COD,Johor,1,1,0,"Congo, the Democratic Republic of the"
75195,9/1/2023,COD,Pulau Pinang,0,0,0,"Congo, the Democratic Republic of the"
75196,9/1/2023,COD,Sarawak,0,0,0,"Congo, the Democratic Republic of the"
75197,9/1/2023,COD,Selangor,18,12,6,"Congo, the Democratic Republic of the"
75198,9/1/2023,COG,Johor,0,0,0,Congo
75199,9/1/2023,COG,Kedah,0,0,0,Congo
75200,9/1/2023,COG,Selangor,18,11,7,Congo
75201,9/1/2023,COK,Selangor,0,0,0,Cook Islands
75202,9/1/2023,COL,Johor,26,13,13,Colombia
75203,9/1/2023,COL,Kedah,0,0,0,Colombia
75204,9/1/2023,COL,Perak,0,0,0,Colombia
75205,9/1/2023,COL,Pulau Pinang,8,4,4,Colombia
75206,9/1/2023,COL,Sabah,0,0,0,Colombia
75207,9/1/2023,COL,Sarawak,1,1,0,Colombia
75208,9/1/2023,COL,Selangor,394,225,169,Colombia
75209,9/1/2023,COL,W.P. Labuan,0,0,0,Colombia
75210,9/1/2023,COM,Johor,0,0,0,Comoros
75211,9/1/2023,COM,Kedah,0,0,0,Comoros
75212,9/1/2023,COM,Selangor,37,26,11,Comoros
75213,9/1/2023,CPV,Johor,0,0,0,Cape Verde
75214,9/1/2023,CPV,Kedah,0,0,0,Cape Verde
75215,9/1/2023,CPV,Pulau Pinang,0,0,0,Cape Verde
75216,9/1/2023,CPV,Sabah,0,0,0,Cape Verde
75217,9/1/2023,CPV,Selangor,1,0,1,Cape Verde
75218,9/1/2023,CRI,Johor,11,6,5,Costa Rica
75219,9/1/2023,CRI,Kedah,0,0,0,Costa Rica
75220,9/1/2023,CRI,Perak,0,0,0,Costa Rica
75221,9/1/2023,CRI,Perlis,0,0,0,Costa Rica
75222,9/1/2023,CRI,Pulau Pinang,3,2,1,Costa Rica
75223,9/1/2023,CRI,Sabah,2,2,0,Costa Rica
75224,9/1/2023,CRI,Sarawak,1,1,0,Costa Rica
75225,9/1/2023,CRI,Selangor,77,41,36,Costa Rica
75226,9/1/2023,CUB,Johor,1,0,1,Cuba
75227,9/1/2023,CUB,Kedah,1,1,0,Cuba
75228,9/1/2023,CUB,Perlis,0,0,0,Cuba
75229,9/1/2023,CUB,Pulau Pinang,0,0,0,Cuba
75230,9/1/2023,CUB,Sabah,1,1,0,Cuba
75231,9/1/2023,CUB,Sarawak,0,0,0,Cuba
75232,9/1/2023,CUB,Selangor,22,10,12,Cuba
75233,9/1/2023,CYP,Johor,11,6,5,Cyprus
75234,9/1/2023,CYP,Kedah,1,1,0,Cyprus
75235,9/1/2023,CYP,Perak,0,0,0,Cyprus
75236,9/1/2023,CYP,Perlis,0,0,0,Cyprus
75237,9/1/2023,CYP,Pulau Pinang,1,1,0,Cyprus
75238,9/1/2023,CYP,Sabah,0,0,0,Cyprus
75239,9/1/2023,CYP,Sarawak,0,0,0,Cyprus
75240,9/1/2023,CYP,Selangor,69,51,18,Cyprus
75241,9/1/2023,CZE,Johor,106,56,50,Czech Republic
75242,9/1/2023,CZE,Kedah,10,6,4,Czech Republic
75243,9/1/2023,CZE,Kelantan,0,0,0,Czech Republic
75244,9/1/2023,CZE,Melaka,0,0,0,Czech Republic
75245,9/1/2023,CZE,Negeri Sembilan,0,0,0,Czech Republic
75246,9/1/2023,CZE,Perak,0,0,0,Czech Republic
75247,9/1/2023,CZE,Perlis,5,5,0,Czech Republic
75248,9/1/2023,CZE,Pulau Pinang,13,8,5,Czech Republic
75249,9/1/2023,CZE,Sabah,1,0,1,Czech Republic
75250,9/1/2023,CZE,Sarawak,24,12,12,Czech Republic
75251,9/1/2023,CZE,Selangor,423,258,165,Czech Republic
75252,9/1/2023,CZE,W.P. Labuan,0,0,0,Czech Republic
75253,9/1/2023,DEU,Johor,2433,1493,940,Germany
75254,9/1/2023,DEU,Kedah,322,179,143,Germany
75255,9/1/2023,DEU,Kelantan,12,9,3,Germany
75256,9/1/2023,DEU,Melaka,3,1,2,Germany
75257,9/1/2023,DEU,Negeri Sembilan,3,2,1,Germany
75258,9/1/2023,DEU,Pahang,3,2,1,Germany
75259,9/1/2023,DEU,Perak,21,17,4,Germany
75260,9/1/2023,DEU,Perlis,71,46,25,Germany
75261,9/1/2023,DEU,Pulau Pinang,615,442,173,Germany
75262,9/1/2023,DEU,Sabah,35,20,15,Germany
75263,9/1/2023,DEU,Sarawak,240,141,99,Germany
75264,9/1/2023,DEU,Selangor,7620,4619,3001,Germany
75265,9/1/2023,DEU,Terengganu,0,0,0,Germany
75266,9/1/2023,DEU,W.P. Labuan,3,2,1,Germany
75267,9/1/2023,DJI,Johor,1,1,0,Djibouti
75268,9/1/2023,DJI,Selangor,12,8,4,Djibouti
75269,9/1/2023,DMA,Johor,6,5,1,Dominica
75270,9/1/2023,DMA,Kedah,0,0,0,Dominica
75271,9/1/2023,DMA,Pulau Pinang,2,1,1,Dominica
75272,9/1/2023,DMA,Sabah,0,0,0,Dominica
75273,9/1/2023,DMA,Sarawak,0,0,0,Dominica
75274,9/1/2023,DMA,Selangor,62,49,13,Dominica
75275,9/1/2023,DMA,W.P. Labuan,0,0,0,Dominica
75276,9/1/2023,DNK,Johor,343,243,100,Denmark
75277,9/1/2023,DNK,Kedah,16,9,7,Denmark
75278,9/1/2023,DNK,Kelantan,0,0,0,Denmark
75279,9/1/2023,DNK,Melaka,1,1,0,Denmark
75280,9/1/2023,DNK,Negeri Sembilan,0,0,0,Denmark
75281,9/1/2023,DNK,Pahang,0,0,0,Denmark
75282,9/1/2023,DNK,Perak,1,1,0,Denmark
75283,9/1/2023,DNK,Perlis,5,2,3,Denmark
75284,9/1/2023,DNK,Pulau Pinang,45,33,12,Denmark
75285,9/1/2023,DNK,Sabah,7,3,4,Denmark
75286,9/1/2023,DNK,Sarawak,11,7,4,Denmark
75287,9/1/2023,DNK,Selangor,847,529,318,Denmark
75288,9/1/2023,DNK,W.P. Labuan,6,1,5,Denmark
75289,9/1/2023,DOM,Johor,7,3,4,Dominican Republic
75290,9/1/2023,DOM,Kedah,1,0,1,Dominican Republic
75291,9/1/2023,DOM,Perak,0,0,0,Dominican Republic
75292,9/1/2023,DOM,Perlis,0,0,0,Dominican Republic
75293,9/1/2023,DOM,Pulau Pinang,1,1,0,Dominican Republic
75294,9/1/2023,DOM,Sabah,0,0,0,Dominican Republic
75295,9/1/2023,DOM,Sarawak,0,0,0,Dominican Republic
75296,9/1/2023,DOM,Selangor,27,10,17,Dominican Republic
75297,9/1/2023,DZA,Johor,80,49,31,Algeria
75298,9/1/2023,DZA,Kedah,5,4,1,Algeria
75299,9/1/2023,DZA,Kelantan,0,0,0,Algeria
75300,9/1/2023,DZA,Melaka,0,0,0,Algeria
75301,9/1/2023,DZA,Perak,1,0,1,Algeria
75302,9/1/2023,DZA,Perlis,2,2,0,Algeria
75303,9/1/2023,DZA,Pulau Pinang,0,0,0,Algeria
75304,9/1/2023,DZA,Sabah,3,0,3,Algeria
75305,9/1/2023,DZA,Sarawak,3,3,0,Algeria
75306,9/1/2023,DZA,Selangor,1622,1014,608,Algeria
75307,9/1/2023,DZA,W.P. Labuan,0,0,0,Algeria
75308,9/1/2023,ECU,Johor,16,6,10,Ecuador
75309,9/1/2023,ECU,Kedah,0,0,0,Ecuador
75310,9/1/2023,ECU,Perak,0,0,0,Ecuador
75311,9/1/2023,ECU,Perlis,0,0,0,Ecuador
75312,9/1/2023,ECU,Pulau Pinang,4,3,1,Ecuador
75313,9/1/2023,ECU,Sabah,0,0,0,Ecuador
75314,9/1/2023,ECU,Sarawak,0,0,0,Ecuador
75315,9/1/2023,ECU,Selangor,128,58,70,Ecuador
75316,9/1/2023,EGY,Johor,221,175,46,Egypt
75317,9/1/2023,EGY,Kedah,9,7,2,Egypt
75318,9/1/2023,EGY,Kelantan,2,1,1,Egypt
75319,9/1/2023,EGY,Melaka,0,0,0,Egypt
75320,9/1/2023,EGY,Pahang,0,0,0,Egypt
75321,9/1/2023,EGY,Perak,0,0,0,Egypt
75322,9/1/2023,EGY,Perlis,0,0,0,Egypt
75323,9/1/2023,EGY,Pulau Pinang,15,12,3,Egypt
75324,9/1/2023,EGY,Sabah,0,0,0,Egypt
75325,9/1/2023,EGY,Sarawak,91,56,35,Egypt
75326,9/1/2023,EGY,Selangor,2310,1543,767,Egypt
75327,9/1/2023,EGY,Terengganu,0,0,0,Egypt
75328,9/1/2023,EGY,W.P. Labuan,0,0,0,Egypt
75329,9/1/2023,ERI,Johor,0,0,0,Eritrea
75330,9/1/2023,ERI,Pulau Pinang,0,0,0,Eritrea
75331,9/1/2023,ERI,Sabah,0,0,0,Eritrea
75332,9/1/2023,ERI,Selangor,21,10,11,Eritrea
75333,9/1/2023,ESP,Johor,683,410,273,Spain
75334,9/1/2023,ESP,Kedah,56,33,23,Spain
75335,9/1/2023,ESP,Kelantan,3,2,1,Spain
75336,9/1/2023,ESP,Melaka,0,0,0,Spain
75337,9/1/2023,ESP,Negeri Sembilan,0,0,0,Spain
75338,9/1/2023,ESP,Pahang,0,0,0,Spain
75339,9/1/2023,ESP,Perak,6,3,3,Spain
75340,9/1/2023,ESP,Perlis,16,11,5,Spain
75341,9/1/2023,ESP,Pulau Pinang,151,82,69,Spain
75342,9/1/2023,ESP,Sabah,18,9,9,Spain
75343,9/1/2023,ESP,Sarawak,66,43,23,Spain
75344,9/1/2023,ESP,Selangor,4142,2211,1931,Spain
75345,9/1/2023,ESP,W.P. Labuan,1,0,1,Spain
75346,9/1/2023,EST,Johor,21,12,9,Estonia
75347,9/1/2023,EST,Kedah,4,0,4,Estonia
75348,9/1/2023,EST,Kelantan,1,0,1,Estonia
75349,9/1/2023,EST,Pahang,0,0,0,Estonia
75350,9/1/2023,EST,Perak,0,0,0,Estonia
75351,9/1/2023,EST,Perlis,1,1,0,Estonia
75352,9/1/2023,EST,Pulau Pinang,0,0,0,Estonia
75353,9/1/2023,EST,Sabah,0,0,0,Estonia
75354,9/1/2023,EST,Sarawak,1,0,1,Estonia
75355,9/1/2023,EST,Selangor,120,81,39,Estonia
75356,9/1/2023,EST,W.P. Labuan,0,0,0,Estonia
75357,9/1/2023,ETH,Johor,2,2,0,Ethiopia
75358,9/1/2023,ETH,Kedah,0,0,0,Ethiopia
75359,9/1/2023,ETH,Pulau Pinang,1,1,0,Ethiopia
75360,9/1/2023,ETH,Sarawak,0,0,0,Ethiopia
75361,9/1/2023,ETH,Selangor,48,27,21,Ethiopia
75362,9/1/2023,FIN,Johor,164,94,70,Finland
75363,9/1/2023,FIN,Kedah,13,4,9,Finland
75364,9/1/2023,FIN,Kelantan,0,0,0,Finland
75365,9/1/2023,FIN,Melaka,0,0,0,Finland
75366,9/1/2023,FIN,Negeri Sembilan,0,0,0,Finland
75367,9/1/2023,FIN,Pahang,0,0,0,Finland
75368,9/1/2023,FIN,Perak,5,3,2,Finland
75369,9/1/2023,FIN,Perlis,4,3,1,Finland
75370,9/1/2023,FIN,Pulau Pinang,35,26,9,Finland
75371,9/1/2023,FIN,Sabah,1,1,0,Finland
75372,9/1/2023,FIN,Sarawak,3,3,0,Finland
75373,9/1/2023,FIN,Selangor,358,237,121,Finland
75374,9/1/2023,FIN,W.P. Labuan,0,0,0,Finland
75375,9/1/2023,FJI,Johor,133,67,66,Fiji
75376,9/1/2023,FJI,Kedah,4,1,3,Fiji
75377,9/1/2023,FJI,Kelantan,1,1,0,Fiji
75378,9/1/2023,FJI,Perak,1,1,0,Fiji
75379,9/1/2023,FJI,Perlis,0,0,0,Fiji
75380,9/1/2023,FJI,Pulau Pinang,0,0,0,Fiji
75381,9/1/2023,FJI,Sabah,0,0,0,Fiji
75382,9/1/2023,FJI,Sarawak,0,0,0,Fiji
75383,9/1/2023,FJI,Selangor,186,104,82,Fiji
75384,9/1/2023,FRA,Johor,1795,1076,719,France
75385,9/1/2023,FRA,Kedah,171,99,72,France
75386,9/1/2023,FRA,Kelantan,8,6,2,France
75387,9/1/2023,FRA,Melaka,10,4,6,France
75388,9/1/2023,FRA,Negeri Sembilan,4,2,2,France
75389,9/1/2023,FRA,Pahang,11,7,4,France
75390,9/1/2023,FRA,Perak,18,10,8,France
75391,9/1/2023,FRA,Perlis,69,47,22,France
75392,9/1/2023,FRA,Pulau Pinang,267,191,76,France
75393,9/1/2023,FRA,Sabah,23,15,8,France
75394,9/1/2023,FRA,Sarawak,88,55,33,France
75395,9/1/2023,FRA,Selangor,7963,4633,3330,France
75396,9/1/2023,FRA,Terengganu,1,1,0,France
75397,9/1/2023,FRA,W.P. Labuan,2,0,2,France
75398,9/1/2023,FSM,Johor,0,0,0,"Micronesia, Federated States of"
75399,9/1/2023,FSM,Pulau Pinang,0,0,0,"Micronesia, Federated States of"
75400,9/1/2023,FSM,Selangor,1,1,0,"Micronesia, Federated States of"
75401,9/1/2023,GAB,Johor,1,0,1,Gabon
75402,9/1/2023,GAB,Pulau Pinang,1,1,0,Gabon
75403,9/1/2023,GAB,Sarawak,0,0,0,Gabon
75404,9/1/2023,GAB,Selangor,41,37,4,Gabon
75405,9/1/2023,GBR,Johor,4488,2942,1546,United Kingdom
75406,9/1/2023,GBR,Kedah,480,284,196,United Kingdom
75407,9/1/2023,GBR,Kelantan,14,10,4,United Kingdom
75408,9/1/2023,GBR,Melaka,2,2,0,United Kingdom
75409,9/1/2023,GBR,Negeri Sembilan,1,1,0,United Kingdom
75410,9/1/2023,GBR,Pahang,20,16,4,United Kingdom
75411,9/1/2023,GBR,Perak,99,55,44,United Kingdom
75412,9/1/2023,GBR,Perlis,113,72,41,United Kingdom
75413,9/1/2023,GBR,Pulau Pinang,1275,821,454,United Kingdom
75414,9/1/2023,GBR,Sabah,146,65,81,United Kingdom
75415,9/1/2023,GBR,Sarawak,831,546,285,United Kingdom
75416,9/1/2023,GBR,Selangor,16130,10041,6089,United Kingdom
75417,9/1/2023,GBR,Terengganu,0,0,0,United Kingdom
75418,9/1/2023,GBR,W.P. Labuan,29,24,5,United Kingdom
75419,9/1/2023,GEO,Johor,1,1,0,Georgia
75420,9/1/2023,GEO,Kedah,1,0,1,Georgia
75421,9/1/2023,GEO,Melaka,0,0,0,Georgia
75422,9/1/2023,GEO,Perak,0,0,0,Georgia
75423,9/1/2023,GEO,Perlis,0,0,0,Georgia
75424,9/1/2023,GEO,Pulau Pinang,4,2,2,Georgia
75425,9/1/2023,GEO,Sabah,0,0,0,Georgia
75426,9/1/2023,GEO,Sarawak,1,0,1,Georgia
75427,9/1/2023,GEO,Selangor,72,46,26,Georgia
75428,9/1/2023,GHA,Johor,12,11,1,Ghana
75429,9/1/2023,GHA,Kedah,0,0,0,Ghana
75430,9/1/2023,GHA,Kelantan,0,0,0,Ghana
75431,9/1/2023,GHA,Pulau Pinang,8,3,5,Ghana
75432,9/1/2023,GHA,Sabah,0,0,0,Ghana
75433,9/1/2023,GHA,Sarawak,0,0,0,Ghana
75434,9/1/2023,GHA,Selangor,106,83,23,Ghana
75435,9/1/2023,GIB,Johor,0,0,0,Gibraltar
75436,9/1/2023,GIB,Sarawak,0,0,0,Gibraltar
75437,9/1/2023,GIN,Johor,2,1,1,Guinea
75438,9/1/2023,GIN,Kedah,2,2,0,Guinea
75439,9/1/2023,GIN,Kelantan,0,0,0,Guinea
75440,9/1/2023,GIN,Perlis,0,0,0,Guinea
75441,9/1/2023,GIN,Pulau Pinang,0,0,0,Guinea
75442,9/1/2023,GIN,Sabah,0,0,0,Guinea
75443,9/1/2023,GIN,Sarawak,1,1,0,Guinea
75444,9/1/2023,GIN,Selangor,78,55,23,Guinea
75445,9/1/2023,GLP,Selangor,0,0,0,Guadeloupe
75446,9/1/2023,GMB,Johor,4,4,0,Gambia
75447,9/1/2023,GMB,Kedah,0,0,0,Gambia
75448,9/1/2023,GMB,Kelantan,0,0,0,Gambia
75449,9/1/2023,GMB,Pulau Pinang,0,0,0,Gambia
75450,9/1/2023,GMB,Sabah,1,1,0,Gambia
75451,9/1/2023,GMB,Sarawak,0,0,0,Gambia
75452,9/1/2023,GMB,Selangor,23,14,9,Gambia
75453,9/1/2023,GNB,Johor,0,0,0,Guinea-Bissau
75454,9/1/2023,GNB,Selangor,1,1,0,Guinea-Bissau
75455,9/1/2023,GNQ,Johor,0,0,0,Equatorial Guinea
75456,9/1/2023,GNQ,Selangor,0,0,0,Equatorial Guinea
75457,9/1/2023,GRC,Johor,50,38,12,Greece
75458,9/1/2023,GRC,Kedah,5,2,3,Greece
75459,9/1/2023,GRC,Kelantan,0,0,0,Greece
75460,9/1/2023,GRC,Melaka,0,0,0,Greece
75461,9/1/2023,GRC,Negeri Sembilan,0,0,0,Greece
75462,9/1/2023,GRC,Pahang,0,0,0,Greece
75463,9/1/2023,GRC,Perak,1,1,0,Greece
75464,9/1/2023,GRC,Perlis,1,0,1,Greece
75465,9/1/2023,GRC,Pulau Pinang,10,9,1,Greece
75466,9/1/2023,GRC,Sabah,0,0,0,Greece
75467,9/1/2023,GRC,Sarawak,5,4,1,Greece
75468,9/1/2023,GRC,Selangor,226,180,46,Greece
75469,9/1/2023,GRD,Johor,8,4,4,Grenada
75470,9/1/2023,GRD,Kedah,0,0,0,Grenada
75471,9/1/2023,GRD,Pulau Pinang,1,1,0,Grenada
75472,9/1/2023,GRD,Sabah,0,0,0,Grenada
75473,9/1/2023,GRD,Sarawak,0,0,0,Grenada
75474,9/1/2023,GRD,Selangor,5,5,0,Grenada
75475,9/1/2023,GRL,Johor,0,0,0,Greenland
75476,9/1/2023,GRL,Selangor,1,0,1,Greenland
75477,9/1/2023,GTM,Johor,3,3,0,Guatemala
75478,9/1/2023,GTM,Kedah,0,0,0,Guatemala
75479,9/1/2023,GTM,Pahang,0,0,0,Guatemala
75480,9/1/2023,GTM,Perak,0,0,0,Guatemala
75481,9/1/2023,GTM,Pulau Pinang,0,0,0,Guatemala
75482,9/1/2023,GTM,Sabah,0,0,0,Guatemala
75483,9/1/2023,GTM,Sarawak,0,0,0,Guatemala
75484,9/1/2023,GTM,Selangor,60,25,35,Guatemala
75485,9/1/2023,GTM,W.P. Labuan,0,0,0,Guatemala
75486,9/1/2023,GUY,Johor,0,0,0,Guyana
75487,9/1/2023,GUY,Kedah,0,0,0,Guyana
75488,9/1/2023,GUY,Pulau Pinang,0,0,0,Guyana
75489,9/1/2023,GUY,Sarawak,0,0,0,Guyana
75490,9/1/2023,GUY,Selangor,7,5,2,Guyana
75491,9/1/2023,HKG,Johor,9,3,6,Hong Kong
75492,9/1/2023,HKG,Kedah,0,0,0,Hong Kong
75493,9/1/2023,HKG,Kelantan,0,0,0,Hong Kong
75494,9/1/2023,HKG,Pahang,4,1,3,Hong Kong
75495,9/1/2023,HKG,Perak,35,21,14,Hong Kong
75496,9/1/2023,HKG,Perlis,0,0,0,Hong Kong
75497,9/1/2023,HKG,Pulau Pinang,0,0,0,Hong Kong
75498,9/1/2023,HKG,Sabah,0,0,0,Hong Kong
75499,9/1/2023,HKG,Sarawak,0,0,0,Hong Kong
75500,9/1/2023,HKG,Selangor,66,24,42,Hong Kong
75501,9/1/2023,HKG,Terengganu,0,0,0,Hong Kong
75502,9/1/2023,HMD,Johor,0,0,0,Heard Island and McDonald Islands
75503,9/1/2023,HND,Johor,8,6,2,Honduras
75504,9/1/2023,HND,Kedah,1,1,0,Honduras
75505,9/1/2023,HND,Perak,0,0,0,Honduras
75506,9/1/2023,HND,Pulau Pinang,0,0,0,Honduras
75507,9/1/2023,HND,Sabah,0,0,0,Honduras
75508,9/1/2023,HND,Sarawak,2,0,2,Honduras
75509,9/1/2023,HND,Selangor,19,14,5,Honduras
75510,9/1/2023,HRV,Johor,57,43,14,Croatia
75511,9/1/2023,HRV,Kedah,0,0,0,Croatia
75512,9/1/2023,HRV,Kelantan,0,0,0,Croatia
75513,9/1/2023,HRV,Melaka,0,0,0,Croatia
75514,9/1/2023,HRV,Pahang,1,1,0,Croatia
75515,9/1/2023,HRV,Perak,0,0,0,Croatia
75516,9/1/2023,HRV,Perlis,0,0,0,Croatia
75517,9/1/2023,HRV,Pulau Pinang,6,5,1,Croatia
75518,9/1/2023,HRV,Sabah,2,0,2,Croatia
75519,9/1/2023,HRV,Sarawak,0,0,0,Croatia
75520,9/1/2023,HRV,Selangor,124,87,37,Croatia
75521,9/1/2023,HTI,Johor,0,0,0,Haiti
75522,9/1/2023,HTI,Kedah,0,0,0,Haiti
75523,9/1/2023,HTI,Kelantan,0,0,0,Haiti
75524,9/1/2023,HTI,Perak,0,0,0,Haiti
75525,9/1/2023,HTI,Pulau Pinang,0,0,0,Haiti
75526,9/1/2023,HTI,Sabah,0,0,0,Haiti
75527,9/1/2023,HTI,Selangor,16,10,6,Haiti
75528,9/1/2023,HUN,Johor,77,48,29,Hungary
75529,9/1/2023,HUN,Kedah,12,7,5,Hungary
75530,9/1/2023,HUN,Kelantan,0,0,0,Hungary
75531,9/1/2023,HUN,Pahang,0,0,0,Hungary
75532,9/1/2023,HUN,Perak,0,0,0,Hungary
75533,9/1/2023,HUN,Perlis,1,1,0,Hungary
75534,9/1/2023,HUN,Pulau Pinang,16,10,6,Hungary
75535,9/1/2023,HUN,Sabah,4,2,2,Hungary
75536,9/1/2023,HUN,Sarawak,3,2,1,Hungary
75537,9/1/2023,HUN,Selangor,370,208,162,Hungary
75538,9/1/2023,HUN,W.P. Labuan,0,0,0,Hungary
75539,9/1/2023,IDN,Johor,95529,44431,51098,Indonesia
75540,9/1/2023,IDN,Kedah,5260,1990,3270,Indonesia
75541,9/1/2023,IDN,Kelantan,171,119,52,Indonesia
75542,9/1/2023,IDN,Melaka,4156,1828,2328,Indonesia
75543,9/1/2023,IDN,Negeri Sembilan,6028,3861,2167,Indonesia
75544,9/1/2023,IDN,Pahang,26,15,11,Indonesia
75545,9/1/2023,IDN,Perak,236,86,150,Indonesia
75546,9/1/2023,IDN,Perlis,604,232,372,Indonesia
75547,9/1/2023,IDN,Pulau Pinang,37833,15124,22709,Indonesia
75548,9/1/2023,IDN,Sabah,4175,2070,2105,Indonesia
75549,9/1/2023,IDN,Sarawak,35887,18905,16982,Indonesia
75550,9/1/2023,IDN,Selangor,118926,56501,62425,Indonesia
75551,9/1/2023,IDN,Terengganu,0,0,0,Indonesia
75552,9/1/2023,IDN,W.P. Labuan,53,34,19,Indonesia
75553,9/1/2023,IND,Johor,28112,18909,9203,India
75554,9/1/2023,IND,Kedah,1275,695,580,India
75555,9/1/2023,IND,Kelantan,4,3,1,India
75556,9/1/2023,IND,Melaka,3,3,0,India
75557,9/1/2023,IND,Negeri Sembilan,1,1,0,India
75558,9/1/2023,IND,Pahang,12,9,3,India
75559,9/1/2023,IND,Perak,207,131,76,India
75560,9/1/2023,IND,Perlis,25,16,9,India
75561,9/1/2023,IND,Pulau Pinang,4007,3060,947,India
75562,9/1/2023,IND,Sabah,85,67,18,India
75563,9/1/2023,IND,Sarawak,1094,922,172,India
75564,9/1/2023,IND,Selangor,63166,45168,17998,India
75565,9/1/2023,IND,Terengganu,0,0,0,India
75566,9/1/2023,IND,W.P. Labuan,42,39,3,India
75567,9/1/2023,IOT,Pulau Pinang,0,0,0,British Indian Ocean Territory
75568,9/1/2023,IOT,Selangor,0,0,0,British Indian Ocean Territory
75569,9/1/2023,IRL,Johor,233,152,81,Ireland
75570,9/1/2023,IRL,Kedah,46,23,23,Ireland
75571,9/1/2023,IRL,Kelantan,0,0,0,Ireland
75572,9/1/2023,IRL,Negeri Sembilan,0,0,0,Ireland
75573,9/1/2023,IRL,Pahang,5,2,3,Ireland
75574,9/1/2023,IRL,Perak,7,5,2,Ireland
75575,9/1/2023,IRL,Perlis,9,7,2,Ireland
75576,9/1/2023,IRL,Pulau Pinang,98,61,37,Ireland
75577,9/1/2023,IRL,Sabah,4,2,2,Ireland
75578,9/1/2023,IRL,Sarawak,41,24,17,Ireland
75579,9/1/2023,IRL,Selangor,1618,1003,615,Ireland
75580,9/1/2023,IRL,Terengganu,0,0,0,Ireland
75581,9/1/2023,IRL,W.P. Labuan,0,0,0,Ireland
75582,9/1/2023,IRN,Johor,532,259,273,Iran
75583,9/1/2023,IRN,Kedah,30,15,15,Iran
75584,9/1/2023,IRN,Kelantan,0,0,0,Iran
75585,9/1/2023,IRN,Perak,0,0,0,Iran
75586,9/1/2023,IRN,Perlis,3,1,2,Iran
75587,9/1/2023,IRN,Pulau Pinang,7,7,0,Iran
75588,9/1/2023,IRN,Sabah,0,0,0,Iran
75589,9/1/2023,IRN,Sarawak,3,2,1,Iran
75590,9/1/2023,IRN,Selangor,2890,1498,1392,Iran
75591,9/1/2023,IRN,W.P. Labuan,0,0,0,Iran
75592,9/1/2023,IRQ,Johor,68,43,25,Iraq
75593,9/1/2023,IRQ,Kedah,5,5,0,Iraq
75594,9/1/2023,IRQ,Kelantan,0,0,0,Iraq
75595,9/1/2023,IRQ,Melaka,0,0,0,Iraq
75596,9/1/2023,IRQ,Pahang,1,1,0,Iraq
75597,9/1/2023,IRQ,Perak,0,0,0,Iraq
75598,9/1/2023,IRQ,Perlis,0,0,0,Iraq
75599,9/1/2023,IRQ,Pulau Pinang,0,0,0,Iraq
75600,9/1/2023,IRQ,Sabah,1,0,1,Iraq
75601,9/1/2023,IRQ,Sarawak,3,1,2,Iraq
75602,9/1/2023,IRQ,Selangor,1510,1030,480,Iraq
75603,9/1/2023,ISL,Johor,4,2,2,Iceland
75604,9/1/2023,ISL,Kedah,0,0,0,Iceland
75605,9/1/2023,ISL,Kelantan,0,0,0,Iceland
75606,9/1/2023,ISL,Perak,0,0,0,Iceland
75607,9/1/2023,ISL,Perlis,0,0,0,Iceland
75608,9/1/2023,ISL,Pulau Pinang,1,0,1,Iceland
75609,9/1/2023,ISL,Sabah,0,0,0,Iceland
75610,9/1/2023,ISL,Sarawak,0,0,0,Iceland
75611,9/1/2023,ISL,Selangor,20,12,8,Iceland
75612,9/1/2023,ISL,W.P. Labuan,0,0,0,Iceland
75613,9/1/2023,ISR,Pulau Pinang,0,0,0,Israel
75614,9/1/2023,ITA,Johor,596,414,182,Italy
75615,9/1/2023,ITA,Kedah,41,24,17,Italy
75616,9/1/2023,ITA,Kelantan,3,2,1,Italy
75617,9/1/2023,ITA,Melaka,0,0,0,Italy
75618,9/1/2023,ITA,Negeri Sembilan,0,0,0,Italy
75619,9/1/2023,ITA,Pahang,0,0,0,Italy
75620,9/1/2023,ITA,Perak,5,4,1,Italy
75621,9/1/2023,ITA,Perlis,11,8,3,Italy
75622,9/1/2023,ITA,Pulau Pinang,97,74,23,Italy
75623,9/1/2023,ITA,Sabah,7,3,4,Italy
75624,9/1/2023,ITA,Sarawak,56,38,18,Italy
75625,9/1/2023,ITA,Selangor,3501,2237,1264,Italy
75626,9/1/2023,ITA,W.P. Labuan,2,2,0,Italy
75627,9/1/2023,JAM,Johor,2,1,1,Jamaica
75628,9/1/2023,JAM,Kedah,0,0,0,Jamaica
75629,9/1/2023,JAM,Perak,0,0,0,Jamaica
75630,9/1/2023,JAM,Pulau Pinang,3,1,2,Jamaica
75631,9/1/2023,JAM,Sabah,0,0,0,Jamaica
75632,9/1/2023,JAM,Sarawak,3,2,1,Jamaica
75633,9/1/2023,JAM,Selangor,13,8,5,Jamaica
75634,9/1/2023,JAM,W.P. Labuan,0,0,0,Jamaica
75635,9/1/2023,JOR,Johor,23,15,8,Jordan
75636,9/1/2023,JOR,Kedah,10,2,8,Jordan
75637,9/1/2023,JOR,Kelantan,0,0,0,Jordan
75638,9/1/2023,JOR,Melaka,0,0,0,Jordan
75639,9/1/2023,JOR,Perlis,0,0,0,Jordan
75640,9/1/2023,JOR,Pulau Pinang,11,6,5,Jordan
75641,9/1/2023,JOR,Sabah,1,1,0,Jordan
75642,9/1/2023,JOR,Sarawak,0,0,0,Jordan
75643,9/1/2023,JOR,Selangor,1129,695,434,Jordan
75644,9/1/2023,JOR,W.P. Labuan,0,0,0,Jordan
75645,9/1/2023,JPN,Johor,6653,4460,2193,Japan
75646,9/1/2023,JPN,Kedah,160,98,62,Japan
75647,9/1/2023,JPN,Kelantan,8,5,3,Japan
75648,9/1/2023,JPN,Melaka,3,3,0,Japan
75649,9/1/2023,JPN,Negeri Sembilan,0,0,0,Japan
75650,9/1/2023,JPN,Pahang,5,5,0,Japan
75651,9/1/2023,JPN,Perak,44,30,14,Japan
75652,9/1/2023,JPN,Perlis,98,78,20,Japan
75653,9/1/2023,JPN,Pulau Pinang,1378,972,406,Japan
75654,9/1/2023,JPN,Sabah,94,46,48,Japan
75655,9/1/2023,JPN,Sarawak,204,145,59,Japan
75656,9/1/2023,JPN,Selangor,23590,14379,9211,Japan
75657,9/1/2023,JPN,W.P. Labuan,14,11,3,Japan
75658,9/1/2023,KAZ,Johor,52,19,33,Kazakhstan
75659,9/1/2023,KAZ,Kedah,6,1,5,Kazakhstan
75660,9/1/2023,KAZ,Kelantan,1,1,0,Kazakhstan
75661,9/1/2023,KAZ,Melaka,0,0,0,Kazakhstan
75662,9/1/2023,KAZ,Perak,0,0,0,Kazakhstan
75663,9/1/2023,KAZ,Perlis,1,0,1,Kazakhstan
75664,9/1/2023,KAZ,Pulau Pinang,10,5,5,Kazakhstan
75665,9/1/2023,KAZ,Sabah,0,0,0,Kazakhstan
75666,9/1/2023,KAZ,Sarawak,7,1,6,Kazakhstan
75667,9/1/2023,KAZ,Selangor,831,365,466,Kazakhstan
75668,9/1/2023,KAZ,W.P. Labuan,0,0,0,Kazakhstan
75669,9/1/2023,KEN,Johor,52,31,21,Kenya
75670,9/1/2023,KEN,Kedah,8,3,5,Kenya
75671,9/1/2023,KEN,Kelantan,0,0,0,Kenya
75672,9/1/2023,KEN,Perak,0,0,0,Kenya
75673,9/1/2023,KEN,Perlis,1,0,1,Kenya
75674,9/1/2023,KEN,Pulau Pinang,1,0,1,Kenya
75675,9/1/2023,KEN,Sabah,0,0,0,Kenya
75676,9/1/2023,KEN,Sarawak,3,2,1,Kenya
75677,9/1/2023,KEN,Selangor,560,285,275,Kenya
75678,9/1/2023,KGZ,Johor,38,31,7,Kyrgyzstan
75679,9/1/2023,KGZ,Kedah,3,2,1,Kyrgyzstan
75680,9/1/2023,KGZ,Kelantan,0,0,0,Kyrgyzstan
75681,9/1/2023,KGZ,Perak,0,0,0,Kyrgyzstan
75682,9/1/2023,KGZ,Perlis,0,0,0,Kyrgyzstan
75683,9/1/2023,KGZ,Pulau Pinang,4,2,2,Kyrgyzstan
75684,9/1/2023,KGZ,Sabah,0,0,0,Kyrgyzstan
75685,9/1/2023,KGZ,Sarawak,0,0,0,Kyrgyzstan
75686,9/1/2023,KGZ,Selangor,236,123,113,Kyrgyzstan
75687,9/1/2023,KHM,Johor,1706,696,1010,Cambodia
75688,9/1/2023,KHM,Kedah,104,46,58,Cambodia
75689,9/1/2023,KHM,Kelantan,430,246,184,Cambodia
75690,9/1/2023,KHM,Melaka,0,0,0,Cambodia
75691,9/1/2023,KHM,Negeri Sembilan,0,0,0,Cambodia
75692,9/1/2023,KHM,Pahang,0,0,0,Cambodia
75693,9/1/2023,KHM,Perak,15,2,13,Cambodia
75694,9/1/2023,KHM,Perlis,718,409,309,Cambodia
75695,9/1/2023,KHM,Pulau Pinang,54,31,23,Cambodia
75696,9/1/2023,KHM,Sabah,1,0,1,Cambodia
75697,9/1/2023,KHM,Sarawak,12,4,8,Cambodia
75698,9/1/2023,KHM,Selangor,3519,1681,1838,Cambodia
75699,9/1/2023,KHM,W.P. Labuan,0,0,0,Cambodia
75700,9/1/2023,KIR,Johor,0,0,0,Kiribati
75701,9/1/2023,KIR,Sabah,0,0,0,Kiribati
75702,9/1/2023,KIR,Selangor,1,1,0,Kiribati
75703,9/1/2023,KNA,Johor,17,11,6,Saint Kitts and Nevis
75704,9/1/2023,KNA,Kedah,6,5,1,Saint Kitts and Nevis
75705,9/1/2023,KNA,Perlis,0,0,0,Saint Kitts and Nevis
75706,9/1/2023,KNA,Pulau Pinang,6,4,2,Saint Kitts and Nevis
75707,9/1/2023,KNA,Sabah,0,0,0,Saint Kitts and Nevis
75708,9/1/2023,KNA,Selangor,62,44,18,Saint Kitts and Nevis
75709,9/1/2023,KNA,W.P. Labuan,0,0,0,Saint Kitts and Nevis
75710,9/1/2023,KOR,Johor,9916,5561,4355,"Korea, Republic of (South Korea)"
75711,9/1/2023,KOR,Kedah,160,83,77,"Korea, Republic of (South Korea)"
75712,9/1/2023,KOR,Kelantan,8,6,2,"Korea, Republic of (South Korea)"
75713,9/1/2023,KOR,Melaka,2,2,0,"Korea, Republic of (South Korea)"
75714,9/1/2023,KOR,Negeri Sembilan,0,0,0,"Korea, Republic of (South Korea)"
75715,9/1/2023,KOR,Pahang,7,3,4,"Korea, Republic of (South Korea)"
75716,9/1/2023,KOR,Perak,16,10,6,"Korea, Republic of (South Korea)"
75717,9/1/2023,KOR,Perlis,61,47,14,"Korea, Republic of (South Korea)"
75718,9/1/2023,KOR,Pulau Pinang,464,279,185,"Korea, Republic of (South Korea)"
75719,9/1/2023,KOR,Sabah,450,196,254,"Korea, Republic of (South Korea)"
75720,9/1/2023,KOR,Sarawak,219,134,85,"Korea, Republic of (South Korea)"
75721,9/1/2023,KOR,Selangor,14842,8207,6635,"Korea, Republic of (South Korea)"
75722,9/1/2023,KOR,Terengganu,0,0,0,"Korea, Republic of (South Korea)"
75723,9/1/2023,KOR,W.P. Labuan,6,5,1,"Korea, Republic of (South Korea)"
75724,9/1/2023,KWT,Johor,34,19,15,Kuwait
75725,9/1/2023,KWT,Kedah,6,2,4,Kuwait
75726,9/1/2023,KWT,Kelantan,0,0,0,Kuwait
75727,9/1/2023,KWT,Perak,0,0,0,Kuwait
75728,9/1/2023,KWT,Perlis,0,0,0,Kuwait
75729,9/1/2023,KWT,Pulau Pinang,8,3,5,Kuwait
75730,9/1/2023,KWT,Sabah,0,0,0,Kuwait
75731,9/1/2023,KWT,Sarawak,1,1,0,Kuwait
75732,9/1/2023,KWT,Selangor,782,417,365,Kuwait
75733,9/1/2023,KWT,W.P. Labuan,0,0,0,Kuwait
75734,9/1/2023,LAO,Johor,198,60,138,Lao People's Democratic Republic
75735,9/1/2023,LAO,Kedah,773,47,726,Lao People's Democratic Republic
75736,9/1/2023,LAO,Kelantan,188,21,167,Lao People's Democratic Republic
75737,9/1/2023,LAO,Melaka,0,0,0,Lao People's Democratic Republic
75738,9/1/2023,LAO,Perak,36,2,34,Lao People's Democratic Republic
75739,9/1/2023,LAO,Perlis,420,69,351,Lao People's Democratic Republic
75740,9/1/2023,LAO,Pulau Pinang,13,7,6,Lao People's Democratic Republic
75741,9/1/2023,LAO,Sabah,0,0,0,Lao People's Democratic Republic
75742,9/1/2023,LAO,Sarawak,13,10,3,Lao People's Democratic Republic
75743,9/1/2023,LAO,Selangor,324,127,197,Lao People's Democratic Republic
75744,9/1/2023,LAO,W.P. Labuan,0,0,0,Lao People's Democratic Republic
75745,9/1/2023,LBN,Johor,16,12,4,Lebanon
75746,9/1/2023,LBN,Kedah,0,0,0,Lebanon
75747,9/1/2023,LBN,Kelantan,0,0,0,Lebanon
75748,9/1/2023,LBN,Pahang,0,0,0,Lebanon
75749,9/1/2023,LBN,Perak,0,0,0,Lebanon
75750,9/1/2023,LBN,Perlis,0,0,0,Lebanon
75751,9/1/2023,LBN,Pulau Pinang,1,1,0,Lebanon
75752,9/1/2023,LBN,Sabah,0,0,0,Lebanon
75753,9/1/2023,LBN,Sarawak,4,4,0,Lebanon
75754,9/1/2023,LBN,Selangor,317,196,121,Lebanon
75755,9/1/2023,LBN,W.P. Labuan,0,0,0,Lebanon
75756,9/1/2023,LBR,Johor,1,1,0,Liberia
75757,9/1/2023,LBR,Kedah,1,1,0,Liberia
75758,9/1/2023,LBR,Sabah,0,0,0,Liberia
75759,9/1/2023,LBR,Sarawak,0,0,0,Liberia
75760,9/1/2023,LBR,Selangor,8,8,0,Liberia
75761,9/1/2023,LBY,Johor,7,4,3,Libyan Arab Jamahiriya
75762,9/1/2023,LBY,Kedah,1,1,0,Libyan Arab Jamahiriya
75763,9/1/2023,LBY,Perlis,1,1,0,Libyan Arab Jamahiriya
75764,9/1/2023,LBY,Pulau Pinang,0,0,0,Libyan Arab Jamahiriya
75765,9/1/2023,LBY,Sabah,0,0,0,Libyan Arab Jamahiriya
75766,9/1/2023,LBY,Sarawak,0,0,0,Libyan Arab Jamahiriya
75767,9/1/2023,LBY,Selangor,669,464,205,Libyan Arab Jamahiriya
75768,9/1/2023,LCA,Johor,10,8,2,Saint Lucia
75769,9/1/2023,LCA,Kedah,0,0,0,Saint Lucia
75770,9/1/2023,LCA,Pulau Pinang,0,0,0,Saint Lucia
75771,9/1/2023,LCA,Sarawak,0,0,0,Saint Lucia
75772,9/1/2023,LCA,Selangor,16,11,5,Saint Lucia
75773,9/1/2023,LIE,Johor,1,1,0,Liechtenstein
75774,9/1/2023,LIE,Kedah,0,0,0,Liechtenstein
75775,9/1/2023,LIE,Perlis,0,0,0,Liechtenstein
75776,9/1/2023,LIE,Pulau Pinang,0,0,0,Liechtenstein
75777,9/1/2023,LIE,Sabah,0,0,0,Liechtenstein
75778,9/1/2023,LIE,Sarawak,0,0,0,Liechtenstein
75779,9/1/2023,LIE,Selangor,6,6,0,Liechtenstein
75780,9/1/2023,LKA,Johor,1605,1027,578,Sri Lanka
75781,9/1/2023,LKA,Kedah,58,27,31,Sri Lanka
75782,9/1/2023,LKA,Kelantan,0,0,0,Sri Lanka
75783,9/1/2023,LKA,Melaka,1,1,0,Sri Lanka
75784,9/1/2023,LKA,Pahang,0,0,0,Sri Lanka
75785,9/1/2023,LKA,Perak,2,2,0,Sri Lanka
75786,9/1/2023,LKA,Perlis,0,0,0,Sri Lanka
75787,9/1/2023,LKA,Pulau Pinang,44,36,8,Sri Lanka
75788,9/1/2023,LKA,Sabah,3,2,1,Sri Lanka
75789,9/1/2023,LKA,Sarawak,36,24,12,Sri Lanka
75790,9/1/2023,LKA,Selangor,5603,3546,2057,Sri Lanka
75791,9/1/2023,LKA,W.P. Labuan,0,0,0,Sri Lanka
75792,9/1/2023,LSO,Johor,0,0,0,Lesotho
75793,9/1/2023,LSO,Kedah,0,0,0,Lesotho
75794,9/1/2023,LSO,Pulau Pinang,0,0,0,Lesotho
75795,9/1/2023,LSO,Sarawak,0,0,0,Lesotho
75796,9/1/2023,LSO,Selangor,6,4,2,Lesotho
75797,9/1/2023,LTU,Johor,52,24,28,Lithuania
75798,9/1/2023,LTU,Kedah,19,4,15,Lithuania
75799,9/1/2023,LTU,Kelantan,1,1,0,Lithuania
75800,9/1/2023,LTU,Pahang,0,0,0,Lithuania
75801,9/1/2023,LTU,Perak,0,0,0,Lithuania
75802,9/1/2023,LTU,Perlis,4,2,2,Lithuania
75803,9/1/2023,LTU,Pulau Pinang,9,5,4,Lithuania
75804,9/1/2023,LTU,Sabah,0,0,0,Lithuania
75805,9/1/2023,LTU,Sarawak,1,1,0,Lithuania
75806,9/1/2023,LTU,Selangor,254,122,132,Lithuania
75807,9/1/2023,LTU,W.P. Labuan,0,0,0,Lithuania
75808,9/1/2023,LUX,Johor,3,2,1,Luxembourg
75809,9/1/2023,LUX,Kedah,0,0,0,Luxembourg
75810,9/1/2023,LUX,Kelantan,0,0,0,Luxembourg
75811,9/1/2023,LUX,Perak,0,0,0,Luxembourg
75812,9/1/2023,LUX,Perlis,0,0,0,Luxembourg
75813,9/1/2023,LUX,Pulau Pinang,2,2,0,Luxembourg
75814,9/1/2023,LUX,Sabah,0,0,0,Luxembourg
75815,9/1/2023,LUX,Sarawak,0,0,0,Luxembourg
75816,9/1/2023,LUX,Selangor,36,28,8,Luxembourg
75817,9/1/2023,LVA,Johor,29,14,15,Latvia
75818,9/1/2023,LVA,Kedah,2,1,1,Latvia
75819,9/1/2023,LVA,Kelantan,1,1,0,Latvia
75820,9/1/2023,LVA,Pahang,0,0,0,Latvia
75821,9/1/2023,LVA,Perak,0,0,0,Latvia
75822,9/1/2023,LVA,Perlis,0,0,0,Latvia
75823,9/1/2023,LVA,Pulau Pinang,7,3,4,Latvia
75824,9/1/2023,LVA,Sabah,0,0,0,Latvia
75825,9/1/2023,LVA,Sarawak,6,3,3,Latvia
75826,9/1/2023,LVA,Selangor,153,95,58,Latvia
75827,9/1/2023,LVA,W.P. Labuan,0,0,0,Latvia
75828,9/1/2023,MAC,Johor,0,0,0,Macao
75829,9/1/2023,MAC,Pahang,0,0,0,Macao
75830,9/1/2023,MAC,Perak,0,0,0,Macao
75831,9/1/2023,MAC,Selangor,13,8,5,Macao
75832,9/1/2023,MAC,W.P. Labuan,0,0,0,Macao
75833,9/1/2023,MAR,Johor,146,71,75,Morocco
75834,9/1/2023,MAR,Kedah,7,4,3,Morocco
75835,9/1/2023,MAR,Kelantan,1,1,0,Morocco
75836,9/1/2023,MAR,Melaka,0,0,0,Morocco
75837,9/1/2023,MAR,Pahang,0,0,0,Morocco
75838,9/1/2023,MAR,Perak,0,0,0,Morocco
75839,9/1/2023,MAR,Perlis,2,2,0,Morocco
75840,9/1/2023,MAR,Pulau Pinang,9,7,2,Morocco
75841,9/1/2023,MAR,Sabah,1,1,0,Morocco
75842,9/1/2023,MAR,Sarawak,5,4,1,Morocco
75843,9/1/2023,MAR,Selangor,1668,766,902,Morocco
75844,9/1/2023,MAR,W.P. Labuan,0,0,0,Morocco
75845,9/1/2023,MCO,Johor,0,0,0,Monaco
75846,9/1/2023,MCO,Kedah,0,0,0,Monaco
75847,9/1/2023,MCO,Sabah,0,0,0,Monaco
75848,9/1/2023,MCO,Selangor,2,1,1,Monaco
75849,9/1/2023,MDA,Johor,1,1,0,"Moldova, Republic of"
75850,9/1/2023,MDA,Kedah,1,0,1,"Moldova, Republic of"
75851,9/1/2023,MDA,Kelantan,1,0,1,"Moldova, Republic of"
75852,9/1/2023,MDA,Negeri Sembilan,0,0,0,"Moldova, Republic of"
75853,9/1/2023,MDA,Perlis,0,0,0,"Moldova, Republic of"
75854,9/1/2023,MDA,Pulau Pinang,1,1,0,"Moldova, Republic of"
75855,9/1/2023,MDA,Sabah,0,0,0,"Moldova, Republic of"
75856,9/1/2023,MDA,Sarawak,0,0,0,"Moldova, Republic of"
75857,9/1/2023,MDA,Selangor,33,19,14,"Moldova, Republic of"
75858,9/1/2023,MDG,Johor,15,6,9,Madagascar
75859,9/1/2023,MDG,Kedah,0,0,0,Madagascar
75860,9/1/2023,MDG,Perak,0,0,0,Madagascar
75861,9/1/2023,MDG,Perlis,0,0,0,Madagascar
75862,9/1/2023,MDG,Pulau Pinang,0,0,0,Madagascar
75863,9/1/2023,MDG,Sabah,0,0,0,Madagascar
75864,9/1/2023,MDG,Sarawak,0,0,0,Madagascar
75865,9/1/2023,MDG,Selangor,98,45,53,Madagascar
75866,9/1/2023,MDV,Johor,97,51,46,Maldives
75867,9/1/2023,MDV,Kedah,2,2,0,Maldives
75868,9/1/2023,MDV,Kelantan,0,0,0,Maldives
75869,9/1/2023,MDV,Perak,0,0,0,Maldives
75870,9/1/2023,MDV,Perlis,1,1,0,Maldives
75871,9/1/2023,MDV,Pulau Pinang,2,0,2,Maldives
75872,9/1/2023,MDV,Sabah,0,0,0,Maldives
75873,9/1/2023,MDV,Sarawak,1,0,1,Maldives
75874,9/1/2023,MDV,Selangor,2728,1477,1251,Maldives
75875,9/1/2023,MEX,Johor,205,96,109,Mexico
75876,9/1/2023,MEX,Kedah,1,0,1,Mexico
75877,9/1/2023,MEX,Kelantan,0,0,0,Mexico
75878,9/1/2023,MEX,Pahang,0,0,0,Mexico
75879,9/1/2023,MEX,Perak,1,0,1,Mexico
75880,9/1/2023,MEX,Perlis,0,0,0,Mexico
75881,9/1/2023,MEX,Pulau Pinang,38,23,15,Mexico
75882,9/1/2023,MEX,Sabah,2,2,0,Mexico
75883,9/1/2023,MEX,Sarawak,4,1,3,Mexico
75884,9/1/2023,MEX,Selangor,905,420,485,Mexico
75885,9/1/2023,MEX,W.P. Labuan,0,0,0,Mexico
75886,9/1/2023,MHL,Johor,0,0,0,Marshall Islands
75887,9/1/2023,MHL,Kedah,0,0,0,Marshall Islands
75888,9/1/2023,MHL,Perak,0,0,0,Marshall Islands
75889,9/1/2023,MHL,Pulau Pinang,0,0,0,Marshall Islands
75890,9/1/2023,MHL,Sabah,0,0,0,Marshall Islands
75891,9/1/2023,MHL,Selangor,4,1,3,Marshall Islands
75892,9/1/2023,MKD,Johor,4,4,0,"Macedonia, the former Yugoslav Republic of"
75893,9/1/2023,MKD,Kedah,1,0,1,"Macedonia, the former Yugoslav Republic of"
75894,9/1/2023,MKD,Perak,0,0,0,"Macedonia, the former Yugoslav Republic of"
75895,9/1/2023,MKD,Pulau Pinang,0,0,0,"Macedonia, the former Yugoslav Republic of"
75896,9/1/2023,MKD,Sabah,0,0,0,"Macedonia, the former Yugoslav Republic of"
75897,9/1/2023,MKD,Sarawak,1,1,0,"Macedonia, the former Yugoslav Republic of"
75898,9/1/2023,MKD,Selangor,43,24,19,"Macedonia, the former Yugoslav Republic of"
75899,9/1/2023,MLI,Johor,2,2,0,Mali
75900,9/1/2023,MLI,Sabah,0,0,0,Mali
75901,9/1/2023,MLI,Selangor,19,14,5,Mali
75902,9/1/2023,MLT,Johor,21,11,10,Malta
75903,9/1/2023,MLT,Kedah,5,4,1,Malta
75904,9/1/2023,MLT,Kelantan,0,0,0,Malta
75905,9/1/2023,MLT,Perak,0,0,0,Malta
75906,9/1/2023,MLT,Perlis,0,0,0,Malta
75907,9/1/2023,MLT,Pulau Pinang,1,1,0,Malta
75908,9/1/2023,MLT,Sabah,1,1,0,Malta
75909,9/1/2023,MLT,Sarawak,1,1,0,Malta
75910,9/1/2023,MLT,Selangor,51,33,18,Malta
75911,9/1/2023,MLT,W.P. Labuan,0,0,0,Malta
75912,9/1/2023,MMR,Johor,7130,2139,4991,Myanmar
75913,9/1/2023,MMR,Kedah,82,21,61,Myanmar
75914,9/1/2023,MMR,Kelantan,1,0,1,Myanmar
75915,9/1/2023,MMR,Negeri Sembilan,0,0,0,Myanmar
75916,9/1/2023,MMR,Pahang,5,1,4,Myanmar
75917,9/1/2023,MMR,Perak,26,6,20,Myanmar
75918,9/1/2023,MMR,Perlis,4,1,3,Myanmar
75919,9/1/2023,MMR,Pulau Pinang,242,120,122,Myanmar
75920,9/1/2023,MMR,Sabah,3,2,1,Myanmar
75921,9/1/2023,MMR,Sarawak,72,26,46,Myanmar
75922,9/1/2023,MMR,Selangor,7141,4810,2331,Myanmar
75923,9/1/2023,MMR,Terengganu,0,0,0,Myanmar
75924,9/1/2023,MMR,W.P. Labuan,1,1,0,Myanmar
75925,9/1/2023,MNE,Johor,1,1,0,Montenegro
75926,9/1/2023,MNE,Kedah,0,0,0,Montenegro
75927,9/1/2023,MNE,Pulau Pinang,0,0,0,Montenegro
75928,9/1/2023,MNE,Sabah,0,0,0,Montenegro
75929,9/1/2023,MNE,Sarawak,0,0,0,Montenegro
75930,9/1/2023,MNE,Selangor,10,6,4,Montenegro
75931,9/1/2023,MNG,Johor,98,43,55,Mongolia
75932,9/1/2023,MNG,Kedah,2,0,2,Mongolia
75933,9/1/2023,MNG,Kelantan,0,0,0,Mongolia
75934,9/1/2023,MNG,Perak,0,0,0,Mongolia
75935,9/1/2023,MNG,Perlis,5,5,0,Mongolia
75936,9/1/2023,MNG,Pulau Pinang,6,2,4,Mongolia
75937,9/1/2023,MNG,Sabah,0,0,0,Mongolia
75938,9/1/2023,MNG,Sarawak,1,0,1,Mongolia
75939,9/1/2023,MNG,Selangor,294,115,179,Mongolia
75940,9/1/2023,MNP,Selangor,0,0,0,Northern Mariana Islands
75941,9/1/2023,MOZ,Johor,0,0,0,Mozambique
75942,9/1/2023,MOZ,Kedah,0,0,0,Mozambique
75943,9/1/2023,MOZ,Perak,0,0,0,Mozambique
75944,9/1/2023,MOZ,Pulau Pinang,1,1,0,Mozambique
75945,9/1/2023,MOZ,Sabah,0,0,0,Mozambique
75946,9/1/2023,MOZ,Sarawak,1,0,1,Mozambique
75947,9/1/2023,MOZ,Selangor,25,13,12,Mozambique
75948,9/1/2023,MRT,Johor,3,2,1,Mauritania
75949,9/1/2023,MRT,Kedah,0,0,0,Mauritania
75950,9/1/2023,MRT,Pulau Pinang,0,0,0,Mauritania
75951,9/1/2023,MRT,Sabah,0,0,0,Mauritania
75952,9/1/2023,MRT,Sarawak,0,0,0,Mauritania
75953,9/1/2023,MRT,Selangor,32,29,3,Mauritania
75954,9/1/2023,MUS,Johor,138,73,65,Mauritius
75955,9/1/2023,MUS,Kedah,8,4,4,Mauritius
75956,9/1/2023,MUS,Kelantan,0,0,0,Mauritius
75957,9/1/2023,MUS,Pahang,0,0,0,Mauritius
75958,9/1/2023,MUS,Perak,1,1,0,Mauritius
75959,9/1/2023,MUS,Perlis,1,1,0,Mauritius
75960,9/1/2023,MUS,Pulau Pinang,8,4,4,Mauritius
75961,9/1/2023,MUS,Sabah,0,0,0,Mauritius
75962,9/1/2023,MUS,Sarawak,0,0,0,Mauritius
75963,9/1/2023,MUS,Selangor,1790,953,837,Mauritius
75964,9/1/2023,MWI,Johor,1,1,0,Malawi
75965,9/1/2023,MWI,Pulau Pinang,1,1,0,Malawi
75966,9/1/2023,MWI,Sabah,0,0,0,Malawi
75967,9/1/2023,MWI,Sarawak,0,0,0,Malawi
75968,9/1/2023,MWI,Selangor,20,11,9,Malawi
75969,9/1/2023,MYT,Selangor,0,0,0,Mayotte
75970,9/1/2023,NAM,Johor,3,0,3,Namibia
75971,9/1/2023,NAM,Kedah,0,0,0,Namibia
75972,9/1/2023,NAM,Perak,0,0,0,Namibia
75973,9/1/2023,NAM,Perlis,0,0,0,Namibia
75974,9/1/2023,NAM,Pulau Pinang,0,0,0,Namibia
75975,9/1/2023,NAM,Sabah,0,0,0,Namibia
75976,9/1/2023,NAM,Sarawak,2,2,0,Namibia
75977,9/1/2023,NAM,Selangor,23,9,14,Namibia
75978,9/1/2023,NCL,Selangor,0,0,0,New Caledonia
75979,9/1/2023,NER,Johor,0,0,0,Niger
75980,9/1/2023,NER,Sabah,1,1,0,Niger
75981,9/1/2023,NER,Selangor,4,4,0,Niger
75982,9/1/2023,NGA,Johor,41,38,3,Nigeria
75983,9/1/2023,NGA,Kedah,0,0,0,Nigeria
75984,9/1/2023,NGA,Perlis,0,0,0,Nigeria
75985,9/1/2023,NGA,Pulau Pinang,2,1,1,Nigeria
75986,9/1/2023,NGA,Sabah,1,1,0,Nigeria
75987,9/1/2023,NGA,Sarawak,13,11,2,Nigeria
75988,9/1/2023,NGA,Selangor,460,342,118,Nigeria
75989,9/1/2023,NIC,Johor,0,0,0,Nicaragua
75990,9/1/2023,NIC,Kedah,0,0,0,Nicaragua
75991,9/1/2023,NIC,Pulau Pinang,0,0,0,Nicaragua
75992,9/1/2023,NIC,Sabah,0,0,0,Nicaragua
75993,9/1/2023,NIC,Selangor,10,8,2,Nicaragua
75994,9/1/2023,NLD,Johor,1166,735,431,Netherlands
75995,9/1/2023,NLD,Kedah,134,73,61,Netherlands
75996,9/1/2023,NLD,Kelantan,3,3,0,Netherlands
75997,9/1/2023,NLD,Melaka,0,0,0,Netherlands
75998,9/1/2023,NLD,Negeri Sembilan,0,0,0,Netherlands
75999,9/1/2023,NLD,Pahang,7,6,1,Netherlands
76000,9/1/2023,NLD,Perak,13,6,7,Netherlands
76001,9/1/2023,NLD,Perlis,22,12,10,Netherlands
76002,9/1/2023,NLD,Pulau Pinang,191,126,65,Netherlands
76003,9/1/2023,NLD,Sabah,16,7,9,Netherlands
76004,9/1/2023,NLD,Sarawak,136,85,51,Netherlands
76005,9/1/2023,NLD,Selangor,4865,2786,2079,Netherlands
76006,9/1/2023,NLD,Terengganu,0,0,0,Netherlands
76007,9/1/2023,NLD,W.P. Labuan,3,3,0,Netherlands
76008,9/1/2023,NOR,Johor,145,95,50,Norway
76009,9/1/2023,NOR,Kedah,14,9,5,Norway
76010,9/1/2023,NOR,Kelantan,0,0,0,Norway
76011,9/1/2023,NOR,Melaka,0,0,0,Norway
76012,9/1/2023,NOR,Pahang,0,0,0,Norway
76013,9/1/2023,NOR,Perak,1,0,1,Norway
76014,9/1/2023,NOR,Perlis,2,2,0,Norway
76015,9/1/2023,NOR,Pulau Pinang,17,8,9,Norway
76016,9/1/2023,NOR,Sabah,2,1,1,Norway
76017,9/1/2023,NOR,Sarawak,33,23,10,Norway
76018,9/1/2023,NOR,Selangor,577,373,204,Norway
76019,9/1/2023,NOR,W.P. Labuan,2,2,0,Norway
76020,9/1/2023,NPL,Johor,1118,776,342,Nepal
76021,9/1/2023,NPL,Kedah,23,8,15,Nepal
76022,9/1/2023,NPL,Pahang,0,0,0,Nepal
76023,9/1/2023,NPL,Perak,0,0,0,Nepal
76024,9/1/2023,NPL,Perlis,0,0,0,Nepal
76025,9/1/2023,NPL,Pulau Pinang,17,15,2,Nepal
76026,9/1/2023,NPL,Sabah,1,1,0,Nepal
76027,9/1/2023,NPL,Sarawak,134,100,34,Nepal
76028,9/1/2023,NPL,Selangor,9283,8827,456,Nepal
76029,9/1/2023,NPL,W.P. Labuan,46,44,2,Nepal
76030,9/1/2023,NRU,Johor,1,0,1,Nauru
76031,9/1/2023,NRU,Pulau Pinang,0,0,0,Nauru
76032,9/1/2023,NRU,Selangor,9,4,5,Nauru
76033,9/1/2023,NZL,Johor,930,581,349,New Zealand
76034,9/1/2023,NZL,Kedah,94,55,39,New Zealand
76035,9/1/2023,NZL,Kelantan,1,0,1,New Zealand
76036,9/1/2023,NZL,Melaka,1,0,1,New Zealand
76037,9/1/2023,NZL,Negeri Sembilan,0,0,0,New Zealand
76038,9/1/2023,NZL,Pahang,2,1,1,New Zealand
76039,9/1/2023,NZL,Perak,22,14,8,New Zealand
76040,9/1/2023,NZL,Perlis,19,12,7,New Zealand
76041,9/1/2023,NZL,Pulau Pinang,266,158,108,New Zealand
76042,9/1/2023,NZL,Sabah,8,4,4,New Zealand
76043,9/1/2023,NZL,Sarawak,121,69,52,New Zealand
76044,9/1/2023,NZL,Selangor,3702,2121,1581,New Zealand
76045,9/1/2023,NZL,Terengganu,0,0,0,New Zealand
76046,9/1/2023,NZL,W.P. Labuan,1,1,0,New Zealand
76047,9/1/2023,OMN,Johor,25,12,13,Oman
76048,9/1/2023,OMN,Kedah,3,2,1,Oman
76049,9/1/2023,OMN,Kelantan,0,0,0,Oman
76050,9/1/2023,OMN,Melaka,0,0,0,Oman
76051,9/1/2023,OMN,Perak,0,0,0,Oman
76052,9/1/2023,OMN,Perlis,1,1,0,Oman
76053,9/1/2023,OMN,Pulau Pinang,3,3,0,Oman
76054,9/1/2023,OMN,Sabah,1,1,0,Oman
76055,9/1/2023,OMN,Sarawak,15,8,7,Oman
76056,9/1/2023,OMN,Selangor,1466,910,556,Oman
76057,9/1/2023,PAK,Johor,1039,749,290,Pakistan
76058,9/1/2023,PAK,Kedah,128,98,30,Pakistan
76059,9/1/2023,PAK,Kelantan,10,10,0,Pakistan
76060,9/1/2023,PAK,Melaka,0,0,0,Pakistan
76061,9/1/2023,PAK,Negeri Sembilan,0,0,0,Pakistan
76062,9/1/2023,PAK,Pahang,0,0,0,Pakistan
76063,9/1/2023,PAK,Perak,9,8,1,Pakistan
76064,9/1/2023,PAK,Perlis,15,13,2,Pakistan
76065,9/1/2023,PAK,Pulau Pinang,58,52,6,Pakistan
76066,9/1/2023,PAK,Sabah,9,9,0,Pakistan
76067,9/1/2023,PAK,Sarawak,136,112,24,Pakistan
76068,9/1/2023,PAK,Selangor,11875,10367,1508,Pakistan
76069,9/1/2023,PAK,W.P. Labuan,1,0,1,Pakistan
76070,9/1/2023,PAN,Johor,9,4,5,Panama
76071,9/1/2023,PAN,Kedah,0,0,0,Panama
76072,9/1/2023,PAN,Perak,0,0,0,Panama
76073,9/1/2023,PAN,Perlis,0,0,0,Panama
76074,9/1/2023,PAN,Pulau Pinang,0,0,0,Panama
76075,9/1/2023,PAN,Sabah,0,0,0,Panama
76076,9/1/2023,PAN,Sarawak,0,0,0,Panama
76077,9/1/2023,PAN,Selangor,30,14,16,Panama
76078,9/1/2023,PER,Johor,37,22,15,Peru
76079,9/1/2023,PER,Kedah,3,1,2,Peru
76080,9/1/2023,PER,Kelantan,0,0,0,Peru
76081,9/1/2023,PER,Pahang,0,0,0,Peru
76082,9/1/2023,PER,Perak,0,0,0,Peru
76083,9/1/2023,PER,Perlis,0,0,0,Peru
76084,9/1/2023,PER,Pulau Pinang,4,2,2,Peru
76085,9/1/2023,PER,Sabah,0,0,0,Peru
76086,9/1/2023,PER,Sarawak,0,0,0,Peru
76087,9/1/2023,PER,Selangor,147,72,75,Peru
76088,9/1/2023,PER,W.P. Labuan,0,0,0,Peru
76089,9/1/2023,PHL,Johor,23504,7221,16283,Philippines
76090,9/1/2023,PHL,Kedah,337,111,226,Philippines
76091,9/1/2023,PHL,Kelantan,27,21,6,Philippines
76092,9/1/2023,PHL,Melaka,2,1,1,Philippines
76093,9/1/2023,PHL,Negeri Sembilan,0,0,0,Philippines
76094,9/1/2023,PHL,Pahang,13,12,1,Philippines
76095,9/1/2023,PHL,Perak,55,13,42,Philippines
76096,9/1/2023,PHL,Perlis,210,63,147,Philippines
76097,9/1/2023,PHL,Pulau Pinang,732,271,461,Philippines
76098,9/1/2023,PHL,Sabah,631,358,273,Philippines
76099,9/1/2023,PHL,Sarawak,1857,774,1083,Philippines
76100,9/1/2023,PHL,Selangor,17431,6932,10499,Philippines
76101,9/1/2023,PHL,Terengganu,0,0,0,Philippines
76102,9/1/2023,PHL,W.P. Labuan,94,26,68,Philippines
76103,9/1/2023,PLW,Johor,0,0,0,Palau
76104,9/1/2023,PLW,Pulau Pinang,0,0,0,Palau
76105,9/1/2023,PLW,Selangor,2,1,1,Palau
76106,9/1/2023,PNG,Johor,16,10,6,Papua New Guinea
76107,9/1/2023,PNG,Kedah,0,0,0,Papua New Guinea
76108,9/1/2023,PNG,Kelantan,0,0,0,Papua New Guinea
76109,9/1/2023,PNG,Perak,1,1,0,Papua New Guinea
76110,9/1/2023,PNG,Pulau Pinang,3,3,0,Papua New Guinea
76111,9/1/2023,PNG,Sabah,1,0,1,Papua New Guinea
76112,9/1/2023,PNG,Sarawak,4,3,1,Papua New Guinea
76113,9/1/2023,PNG,Selangor,72,51,21,Papua New Guinea
76114,9/1/2023,POL,Johor,391,224,167,Poland
76115,9/1/2023,POL,Kedah,38,16,22,Poland
76116,9/1/2023,POL,Kelantan,0,0,0,Poland
76117,9/1/2023,POL,Melaka,0,0,0,Poland
76118,9/1/2023,POL,Negeri Sembilan,0,0,0,Poland
76119,9/1/2023,POL,Pahang,0,0,0,Poland
76120,9/1/2023,POL,Perak,2,1,1,Poland
76121,9/1/2023,POL,Perlis,16,12,4,Poland
76122,9/1/2023,POL,Pulau Pinang,38,24,14,Poland
76123,9/1/2023,POL,Sabah,9,5,4,Poland
76124,9/1/2023,POL,Sarawak,39,20,19,Poland
76125,9/1/2023,POL,Selangor,1339,684,655,Poland
76126,9/1/2023,POL,Terengganu,0,0,0,Poland
76127,9/1/2023,POL,W.P. Labuan,0,0,0,Poland
76128,9/1/2023,PRK,Selangor,0,0,0,"Korea, Democratic People's Republic of"
76129,9/1/2023,PRT,Johor,153,88,65,Portugal
76130,9/1/2023,PRT,Kedah,14,6,8,Portugal
76131,9/1/2023,PRT,Kelantan,0,0,0,Portugal
76132,9/1/2023,PRT,Melaka,0,0,0,Portugal
76133,9/1/2023,PRT,Pahang,0,0,0,Portugal
76134,9/1/2023,PRT,Perak,3,3,0,Portugal
76135,9/1/2023,PRT,Perlis,1,0,1,Portugal
76136,9/1/2023,PRT,Pulau Pinang,51,22,29,Portugal
76137,9/1/2023,PRT,Sabah,6,3,3,Portugal
76138,9/1/2023,PRT,Sarawak,5,2,3,Portugal
76139,9/1/2023,PRT,Selangor,855,495,360,Portugal
76140,9/1/2023,PRT,W.P. Labuan,0,0,0,Portugal
76141,9/1/2023,PRY,Johor,4,3,1,Paraguay
76142,9/1/2023,PRY,Kedah,1,0,1,Paraguay
76143,9/1/2023,PRY,Perak,0,0,0,Paraguay
76144,9/1/2023,PRY,Perlis,0,0,0,Paraguay
76145,9/1/2023,PRY,Pulau Pinang,3,1,2,Paraguay
76146,9/1/2023,PRY,Sabah,0,0,0,Paraguay
76147,9/1/2023,PRY,Sarawak,0,0,0,Paraguay
76148,9/1/2023,PRY,Selangor,24,13,11,Paraguay
76149,9/1/2023,PSE,Johor,32,28,4,"Palestinian Territory, Occupied"
76150,9/1/2023,PSE,Kedah,1,1,0,"Palestinian Territory, Occupied"
76151,9/1/2023,PSE,Kelantan,0,0,0,"Palestinian Territory, Occupied"
76152,9/1/2023,PSE,Melaka,0,0,0,"Palestinian Territory, Occupied"
76153,9/1/2023,PSE,Perak,0,0,0,"Palestinian Territory, Occupied"
76154,9/1/2023,PSE,Perlis,0,0,0,"Palestinian Territory, Occupied"
76155,9/1/2023,PSE,Pulau Pinang,2,2,0,"Palestinian Territory, Occupied"
76156,9/1/2023,PSE,Sabah,0,0,0,"Palestinian Territory, Occupied"
76157,9/1/2023,PSE,Sarawak,1,1,0,"Palestinian Territory, Occupied"
76158,9/1/2023,PSE,Selangor,492,338,154,"Palestinian Territory, Occupied"
76159,9/1/2023,QAT,Johor,2,1,1,Qatar
76160,9/1/2023,QAT,Kedah,0,0,0,Qatar
76161,9/1/2023,QAT,Perlis,2,2,0,Qatar
76162,9/1/2023,QAT,Pulau Pinang,1,1,0,Qatar
76163,9/1/2023,QAT,Sabah,1,1,0,Qatar
76164,9/1/2023,QAT,Sarawak,0,0,0,Qatar
76165,9/1/2023,QAT,Selangor,118,89,29,Qatar
76166,9/1/2023,REU,Johor,1,0,1,Reunion
76167,9/1/2023,REU,Sarawak,0,0,0,Reunion
76168,9/1/2023,ROU,Johor,139,86,53,Romania
76169,9/1/2023,ROU,Kedah,9,8,1,Romania
76170,9/1/2023,ROU,Kelantan,0,0,0,Romania
76171,9/1/2023,ROU,Negeri Sembilan,0,0,0,Romania
76172,9/1/2023,ROU,Pahang,1,1,0,Romania
76173,9/1/2023,ROU,Perak,0,0,0,Romania
76174,9/1/2023,ROU,Perlis,0,0,0,Romania
76175,9/1/2023,ROU,Pulau Pinang,13,5,8,Romania
76176,9/1/2023,ROU,Sabah,3,1,2,Romania
76177,9/1/2023,ROU,Sarawak,9,6,3,Romania
76178,9/1/2023,ROU,Selangor,557,304,253,Romania
76179,9/1/2023,ROU,W.P. Labuan,0,0,0,Romania
76180,9/1/2023,RUS,Johor,399,208,191,Russia
76181,9/1/2023,RUS,Kedah,213,110,103,Russia
76182,9/1/2023,RUS,Kelantan,54,36,18,Russia
76183,9/1/2023,RUS,Melaka,2,2,0,Russia
76184,9/1/2023,RUS,Negeri Sembilan,3,3,0,Russia
76185,9/1/2023,RUS,Pahang,1,1,0,Russia
76186,9/1/2023,RUS,Perak,2,1,1,Russia
76187,9/1/2023,RUS,Perlis,170,106,64,Russia
76188,9/1/2023,RUS,Pulau Pinang,154,82,72,Russia
76189,9/1/2023,RUS,Sabah,3,1,2,Russia
76190,9/1/2023,RUS,Sarawak,48,31,17,Russia
76191,9/1/2023,RUS,Selangor,6843,3476,3367,Russia
76192,9/1/2023,RUS,W.P. Labuan,6,4,2,Russia
76193,9/1/2023,RWA,Johor,0,0,0,Rwanda
76194,9/1/2023,RWA,Kedah,0,0,0,Rwanda
76195,9/1/2023,RWA,Pulau Pinang,1,1,0,Rwanda
76196,9/1/2023,RWA,Selangor,10,6,4,Rwanda
76197,9/1/2023,SAU,Johor,138,73,65,Saudi Arabia
76198,9/1/2023,SAU,Kedah,19,11,8,Saudi Arabia
76199,9/1/2023,SAU,Kelantan,6,3,3,Saudi Arabia
76200,9/1/2023,SAU,Melaka,0,0,0,Saudi Arabia
76201,9/1/2023,SAU,Perak,2,0,2,Saudi Arabia
76202,9/1/2023,SAU,Perlis,2,1,1,Saudi Arabia
76203,9/1/2023,SAU,Pulau Pinang,19,11,8,Saudi Arabia
76204,9/1/2023,SAU,Sabah,2,2,0,Saudi Arabia
76205,9/1/2023,SAU,Sarawak,11,7,4,Saudi Arabia
76206,9/1/2023,SAU,Selangor,3386,2126,1260,Saudi Arabia
76207,9/1/2023,SAU,W.P. Labuan,0,0,0,Saudi Arabia
76208,9/1/2023,SDN,Johor,12,8,4,Sudan
76209,9/1/2023,SDN,Kedah,2,1,1,Sudan
76210,9/1/2023,SDN,Kelantan,0,0,0,Sudan
76211,9/1/2023,SDN,Perlis,0,0,0,Sudan
76212,9/1/2023,SDN,Pulau Pinang,2,1,1,Sudan
76213,9/1/2023,SDN,Sabah,0,0,0,Sudan
76214,9/1/2023,SDN,Sarawak,2,1,1,Sudan
76215,9/1/2023,SDN,Selangor,1047,583,464,Sudan
76216,9/1/2023,SDN,W.P. Labuan,1,0,1,Sudan
76217,9/1/2023,SEN,Johor,11,8,3,Senegal
76218,9/1/2023,SEN,Kedah,0,0,0,Senegal
76219,9/1/2023,SEN,Kelantan,0,0,0,Senegal
76220,9/1/2023,SEN,Perak,0,0,0,Senegal
76221,9/1/2023,SEN,Perlis,0,0,0,Senegal
76222,9/1/2023,SEN,Pulau Pinang,0,0,0,Senegal
76223,9/1/2023,SEN,Sabah,0,0,0,Senegal
76224,9/1/2023,SEN,Sarawak,0,0,0,Senegal
76225,9/1/2023,SEN,Selangor,145,116,29,Senegal
76226,9/1/2023,SGP,Johor,1310305,742628,567677,Singapore
76227,9/1/2023,SGP,Kedah,5433,2819,2614,Singapore
76228,9/1/2023,SGP,Kelantan,77,52,25,Singapore
76229,9/1/2023,SGP,Melaka,13,12,1,Singapore
76230,9/1/2023,SGP,Negeri Sembilan,0,0,0,Singapore
76231,9/1/2023,SGP,Pahang,791,402,389,Singapore
76232,9/1/2023,SGP,Perak,6499,2981,3518,Singapore
76233,9/1/2023,SGP,Perlis,220,115,105,Singapore
76234,9/1/2023,SGP,Pulau Pinang,18568,9203,9365,Singapore
76235,9/1/2023,SGP,Sabah,537,267,270,Singapore
76236,9/1/2023,SGP,Sarawak,4662,2661,2001,Singapore
76237,9/1/2023,SGP,Selangor,52584,27079,25505,Singapore
76238,9/1/2023,SGP,Terengganu,0,0,0,Singapore
76239,9/1/2023,SGP,W.P. Labuan,9,6,3,Singapore
76240,9/1/2023,SGS,Johor,0,0,0,South Georgia and the South Sandwich Islands
76241,9/1/2023,SGS,Sabah,0,0,0,South Georgia and the South Sandwich Islands
76242,9/1/2023,SGS,Selangor,0,0,0,South Georgia and the South Sandwich Islands
76243,9/1/2023,SHN,Sarawak,0,0,0,"Saint Helena, Ascension and Tristan da Cunha"
76244,9/1/2023,SLB,Johor,0,0,0,Solomon Islands
76245,9/1/2023,SLB,Perlis,0,0,0,Solomon Islands
76246,9/1/2023,SLB,Pulau Pinang,0,0,0,Solomon Islands
76247,9/1/2023,SLB,Sabah,0,0,0,Solomon Islands
76248,9/1/2023,SLB,Sarawak,2,2,0,Solomon Islands
76249,9/1/2023,SLB,Selangor,5,4,1,Solomon Islands
76250,9/1/2023,SLB,W.P. Labuan,0,0,0,Solomon Islands
76251,9/1/2023,SLE,Johor,1,1,0,Sierra Leone
76252,9/1/2023,SLE,Kedah,0,0,0,Sierra Leone
76253,9/1/2023,SLE,Perak,0,0,0,Sierra Leone
76254,9/1/2023,SLE,Pulau Pinang,1,1,0,Sierra Leone
76255,9/1/2023,SLE,Sabah,0,0,0,Sierra Leone
76256,9/1/2023,SLE,Selangor,31,23,8,Sierra Leone
76257,9/1/2023,SLV,Johor,4,1,3,El Salvador
76258,9/1/2023,SLV,Kedah,0,0,0,El Salvador
76259,9/1/2023,SLV,Perak,0,0,0,El Salvador
76260,9/1/2023,SLV,Perlis,0,0,0,El Salvador
76261,9/1/2023,SLV,Pulau Pinang,2,2,0,El Salvador
76262,9/1/2023,SLV,Sabah,1,0,1,El Salvador
76263,9/1/2023,SLV,Selangor,26,17,9,El Salvador
76264,9/1/2023,SLV,W.P. Labuan,0,0,0,El Salvador
76265,9/1/2023,SMR,Johor,0,0,0,San Marino
76266,9/1/2023,SMR,Selangor,0,0,0,San Marino
76267,9/1/2023,SOM,Johor,0,0,0,Somalia
76268,9/1/2023,SOM,Kedah,0,0,0,Somalia
76269,9/1/2023,SOM,Kelantan,0,0,0,Somalia
76270,9/1/2023,SOM,Perlis,0,0,0,Somalia
76271,9/1/2023,SOM,Sabah,0,0,0,Somalia
76272,9/1/2023,SOM,Sarawak,0,0,0,Somalia
76273,9/1/2023,SOM,Selangor,251,162,89,Somalia
76274,9/1/2023,SRB,Johor,7,6,1,Serbia
76275,9/1/2023,SRB,Kedah,3,2,1,Serbia
76276,9/1/2023,SRB,Kelantan,0,0,0,Serbia
76277,9/1/2023,SRB,Pahang,0,0,0,Serbia
76278,9/1/2023,SRB,Perak,0,0,0,Serbia
76279,9/1/2023,SRB,Perlis,0,0,0,Serbia
76280,9/1/2023,SRB,Pulau Pinang,1,1,0,Serbia
76281,9/1/2023,SRB,Sabah,0,0,0,Serbia
76282,9/1/2023,SRB,Sarawak,1,0,1,Serbia
76283,9/1/2023,SRB,Selangor,96,47,49,Serbia
76284,9/1/2023,STP,Selangor,2,2,0,Sao Tome and Principe
76285,9/1/2023,SUR,Johor,12,5,7,Suriname
76286,9/1/2023,SUR,Kedah,0,0,0,Suriname
76287,9/1/2023,SUR,Kelantan,0,0,0,Suriname
76288,9/1/2023,SUR,Perak,0,0,0,Suriname
76289,9/1/2023,SUR,Perlis,0,0,0,Suriname
76290,9/1/2023,SUR,Pulau Pinang,3,1,2,Suriname
76291,9/1/2023,SUR,Sabah,0,0,0,Suriname
76292,9/1/2023,SUR,Sarawak,0,0,0,Suriname
76293,9/1/2023,SUR,Selangor,68,35,33,Suriname
76294,9/1/2023,SVK,Johor,26,19,7,Slovakia
76295,9/1/2023,SVK,Kedah,24,11,13,Slovakia
76296,9/1/2023,SVK,Kelantan,0,0,0,Slovakia
76297,9/1/2023,SVK,Negeri Sembilan,0,0,0,Slovakia
76298,9/1/2023,SVK,Pahang,0,0,0,Slovakia
76299,9/1/2023,SVK,Perak,0,0,0,Slovakia
76300,9/1/2023,SVK,Perlis,0,0,0,Slovakia
76301,9/1/2023,SVK,Pulau Pinang,7,5,2,Slovakia
76302,9/1/2023,SVK,Sabah,2,2,0,Slovakia
76303,9/1/2023,SVK,Sarawak,1,0,1,Slovakia
76304,9/1/2023,SVK,Selangor,272,156,116,Slovakia
76305,9/1/2023,SVK,W.P. Labuan,0,0,0,Slovakia
76306,9/1/2023,SVN,Johor,14,6,8,Slovenia
76307,9/1/2023,SVN,Kedah,6,2,4,Slovenia
76308,9/1/2023,SVN,Kelantan,0,0,0,Slovenia
76309,9/1/2023,SVN,Perak,0,0,0,Slovenia
76310,9/1/2023,SVN,Perlis,0,0,0,Slovenia
76311,9/1/2023,SVN,Pulau Pinang,3,1,2,Slovenia
76312,9/1/2023,SVN,Sabah,0,0,0,Slovenia
76313,9/1/2023,SVN,Sarawak,4,3,1,Slovenia
76314,9/1/2023,SVN,Selangor,138,77,61,Slovenia
76315,9/1/2023,SVN,W.P. Labuan,0,0,0,Slovenia
76316,9/1/2023,SWE,Johor,287,187,100,Sweden
76317,9/1/2023,SWE,Kedah,41,21,20,Sweden
76318,9/1/2023,SWE,Kelantan,2,2,0,Sweden
76319,9/1/2023,SWE,Melaka,0,0,0,Sweden
76320,9/1/2023,SWE,Negeri Sembilan,1,1,0,Sweden
76321,9/1/2023,SWE,Pahang,0,0,0,Sweden
76322,9/1/2023,SWE,Perak,7,7,0,Sweden
76323,9/1/2023,SWE,Perlis,16,12,4,Sweden
76324,9/1/2023,SWE,Pulau Pinang,57,43,14,Sweden
76325,9/1/2023,SWE,Sabah,3,2,1,Sweden
76326,9/1/2023,SWE,Sarawak,37,25,12,Sweden
76327,9/1/2023,SWE,Selangor,771,527,244,Sweden
76328,9/1/2023,SWE,W.P. Labuan,0,0,0,Sweden
76329,9/1/2023,SWZ,Johor,0,0,0,Swaziland
76330,9/1/2023,SWZ,Kedah,0,0,0,Swaziland
76331,9/1/2023,SWZ,Pulau Pinang,0,0,0,Swaziland
76332,9/1/2023,SWZ,Sabah,0,0,0,Swaziland
76333,9/1/2023,SWZ,Selangor,22,8,14,Swaziland
76334,9/1/2023,SYC,Johor,2,0,2,Seychelles
76335,9/1/2023,SYC,Kedah,0,0,0,Seychelles
76336,9/1/2023,SYC,Pulau Pinang,2,1,1,Seychelles
76337,9/1/2023,SYC,Sabah,0,0,0,Seychelles
76338,9/1/2023,SYC,Sarawak,1,1,0,Seychelles
76339,9/1/2023,SYC,Selangor,117,49,68,Seychelles
76340,9/1/2023,SYR,Johor,22,13,9,Syrian Arab Republic
76341,9/1/2023,SYR,Kedah,1,1,0,Syrian Arab Republic
76342,9/1/2023,SYR,Kelantan,0,0,0,Syrian Arab Republic
76343,9/1/2023,SYR,Pahang,0,0,0,Syrian Arab Republic
76344,9/1/2023,SYR,Perlis,0,0,0,Syrian Arab Republic
76345,9/1/2023,SYR,Pulau Pinang,2,1,1,Syrian Arab Republic
76346,9/1/2023,SYR,Sabah,1,1,0,Syrian Arab Republic
76347,9/1/2023,SYR,Sarawak,6,6,0,Syrian Arab Republic
76348,9/1/2023,SYR,Selangor,755,466,289,Syrian Arab Republic
76349,9/1/2023,SYR,W.P. Labuan,0,0,0,Syrian Arab Republic
76350,9/1/2023,TCA,Perlis,0,0,0,Turks and Caicos
76351,9/1/2023,TCD,Johor,2,2,0,Chad
76352,9/1/2023,TCD,Kedah,0,0,0,Chad
76353,9/1/2023,TCD,Perlis,1,1,0,Chad
76354,9/1/2023,TCD,Selangor,31,25,6,Chad
76355,9/1/2023,TGO,Johor,3,1,2,Togo
76356,9/1/2023,TGO,Perak,0,0,0,Togo
76357,9/1/2023,TGO,Pulau Pinang,0,0,0,Togo
76358,9/1/2023,TGO,Selangor,8,6,2,Togo
76359,9/1/2023,THA,Johor,6671,1797,4874,Thailand
76360,9/1/2023,THA,Kedah,67381,41054,26327,Thailand
76361,9/1/2023,THA,Kelantan,34118,18894,15224,Thailand
76362,9/1/2023,THA,Melaka,10,7,3,Thailand
76363,9/1/2023,THA,Negeri Sembilan,0,0,0,Thailand
76364,9/1/2023,THA,Pahang,27,20,7,Thailand
76365,9/1/2023,THA,Perak,9355,4370,4985,Thailand
76366,9/1/2023,THA,Perlis,50060,29338,20722,Thailand
76367,9/1/2023,THA,Pulau Pinang,1810,766,1044,Thailand
76368,9/1/2023,THA,Sabah,8,1,7,Thailand
76369,9/1/2023,THA,Sarawak,319,120,199,Thailand
76370,9/1/2023,THA,Selangor,14375,5911,8464,Thailand
76371,9/1/2023,THA,Terengganu,1,0,1,Thailand
76372,9/1/2023,THA,W.P. Labuan,15,5,10,Thailand
76373,9/1/2023,TJK,Johor,2,1,1,Tajikistan
76374,9/1/2023,TJK,Kedah,0,0,0,Tajikistan
76375,9/1/2023,TJK,Perlis,0,0,0,Tajikistan
76376,9/1/2023,TJK,Pulau Pinang,1,1,0,Tajikistan
76377,9/1/2023,TJK,Sabah,0,0,0,Tajikistan
76378,9/1/2023,TJK,Selangor,108,67,41,Tajikistan
76379,9/1/2023,TKL,Selangor,0,0,0,Tokelau
76380,9/1/2023,TKM,Johor,2,0,2,Turkmenistan
76381,9/1/2023,TKM,Kedah,0,0,0,Turkmenistan
76382,9/1/2023,TKM,Kelantan,0,0,0,Turkmenistan
76383,9/1/2023,TKM,Perlis,0,0,0,Turkmenistan
76384,9/1/2023,TKM,Pulau Pinang,0,0,0,Turkmenistan
76385,9/1/2023,TKM,Sabah,0,0,0,Turkmenistan
76386,9/1/2023,TKM,Sarawak,1,1,0,Turkmenistan
76387,9/1/2023,TKM,Selangor,127,76,51,Turkmenistan
76388,9/1/2023,TLS,Johor,3,3,0,Timor-Leste
76389,9/1/2023,TLS,Kedah,0,0,0,Timor-Leste
76390,9/1/2023,TLS,Perlis,0,0,0,Timor-Leste
76391,9/1/2023,TLS,Pulau Pinang,9,6,3,Timor-Leste
76392,9/1/2023,TLS,Sabah,0,0,0,Timor-Leste
76393,9/1/2023,TLS,Sarawak,1,1,0,Timor-Leste
76394,9/1/2023,TLS,Selangor,247,138,109,Timor-Leste
76395,9/1/2023,TON,Johor,2,1,1,Tonga
76396,9/1/2023,TON,Pulau Pinang,2,1,1,Tonga
76397,9/1/2023,TON,Sarawak,0,0,0,Tonga
76398,9/1/2023,TON,Selangor,15,5,10,Tonga
76399,9/1/2023,TTO,Johor,8,3,5,Trinidad and Tobago
76400,9/1/2023,TTO,Kedah,2,1,1,Trinidad and Tobago
76401,9/1/2023,TTO,Pahang,0,0,0,Trinidad and Tobago
76402,9/1/2023,TTO,Pulau Pinang,1,1,0,Trinidad and Tobago
76403,9/1/2023,TTO,Sabah,2,1,1,Trinidad and Tobago
76404,9/1/2023,TTO,Sarawak,2,2,0,Trinidad and Tobago
76405,9/1/2023,TTO,Selangor,39,23,16,Trinidad and Tobago
76406,9/1/2023,TUN,Johor,11,4,7,Tunisia
76407,9/1/2023,TUN,Kedah,1,1,0,Tunisia
76408,9/1/2023,TUN,Kelantan,0,0,0,Tunisia
76409,9/1/2023,TUN,Melaka,0,0,0,Tunisia
76410,9/1/2023,TUN,Perak,2,1,1,Tunisia
76411,9/1/2023,TUN,Perlis,0,0,0,Tunisia
76412,9/1/2023,TUN,Pulau Pinang,4,3,1,Tunisia
76413,9/1/2023,TUN,Sabah,0,0,0,Tunisia
76414,9/1/2023,TUN,Sarawak,1,1,0,Tunisia
76415,9/1/2023,TUN,Selangor,1746,847,899,Tunisia
76416,9/1/2023,TUN,W.P. Labuan,0,0,0,Tunisia
76417,9/1/2023,TUR,Johor,332,221,111,Turkey
76418,9/1/2023,TUR,Kedah,28,15,13,Turkey
76419,9/1/2023,TUR,Kelantan,0,0,0,Turkey
76420,9/1/2023,TUR,Melaka,1,1,0,Turkey
76421,9/1/2023,TUR,Negeri Sembilan,0,0,0,Turkey
76422,9/1/2023,TUR,Pahang,2,2,0,Turkey
76423,9/1/2023,TUR,Perak,2,2,0,Turkey
76424,9/1/2023,TUR,Perlis,11,9,2,Turkey
76425,9/1/2023,TUR,Pulau Pinang,24,16,8,Turkey
76426,9/1/2023,TUR,Sabah,1,1,0,Turkey
76427,9/1/2023,TUR,Sarawak,18,12,6,Turkey
76428,9/1/2023,TUR,Selangor,2170,1302,868,Turkey
76429,9/1/2023,TUR,W.P. Labuan,0,0,0,Turkey
76430,9/1/2023,TUV,Selangor,2,1,1,Tuvalu
76431,9/1/2023,TWN,Johor,5692,2405,3287,Taiwan
76432,9/1/2023,TWN,Kedah,113,55,58,Taiwan
76433,9/1/2023,TWN,Kelantan,1,1,0,Taiwan
76434,9/1/2023,TWN,Melaka,4,3,1,Taiwan
76435,9/1/2023,TWN,Negeri Sembilan,0,0,0,Taiwan
76436,9/1/2023,TWN,Pahang,15,8,7,Taiwan
76437,9/1/2023,TWN,Perak,48,26,22,Taiwan
76438,9/1/2023,TWN,Perlis,26,15,11,Taiwan
76439,9/1/2023,TWN,Pulau Pinang,3634,1749,1885,Taiwan
76440,9/1/2023,TWN,Sabah,281,135,146,Taiwan
76441,9/1/2023,TWN,Sarawak,323,147,176,Taiwan
76442,9/1/2023,TWN,Selangor,18179,8828,9351,Taiwan
76443,9/1/2023,TWN,W.P. Labuan,20,9,11,Taiwan
76444,9/1/2023,TZA,Johor,20,13,7,"Tanzania, United Republic of"
76445,9/1/2023,TZA,Kedah,0,0,0,"Tanzania, United Republic of"
76446,9/1/2023,TZA,Perak,0,0,0,"Tanzania, United Republic of"
76447,9/1/2023,TZA,Perlis,0,0,0,"Tanzania, United Republic of"
76448,9/1/2023,TZA,Pulau Pinang,1,1,0,"Tanzania, United Republic of"
76449,9/1/2023,TZA,Sabah,0,0,0,"Tanzania, United Republic of"
76450,9/1/2023,TZA,Sarawak,2,2,0,"Tanzania, United Republic of"
76451,9/1/2023,TZA,Selangor,294,173,121,"Tanzania, United Republic of"
76452,9/1/2023,UGA,Johor,15,7,8,Uganda
76453,9/1/2023,UGA,Kedah,0,0,0,Uganda
76454,9/1/2023,UGA,Perak,0,0,0,Uganda
76455,9/1/2023,UGA,Perlis,0,0,0,Uganda
76456,9/1/2023,UGA,Pulau Pinang,3,2,1,Uganda
76457,9/1/2023,UGA,Sabah,0,0,0,Uganda
76458,9/1/2023,UGA,Sarawak,0,0,0,Uganda
76459,9/1/2023,UGA,Selangor,157,64,93,Uganda
76460,9/1/2023,UKR,Johor,98,52,46,Ukraine
76461,9/1/2023,UKR,Kedah,25,10,15,Ukraine
76462,9/1/2023,UKR,Kelantan,1,1,0,Ukraine
76463,9/1/2023,UKR,Melaka,0,0,0,Ukraine
76464,9/1/2023,UKR,Negeri Sembilan,0,0,0,Ukraine
76465,9/1/2023,UKR,Pahang,4,4,0,Ukraine
76466,9/1/2023,UKR,Perak,1,1,0,Ukraine
76467,9/1/2023,UKR,Perlis,6,5,1,Ukraine
76468,9/1/2023,UKR,Pulau Pinang,15,11,4,Ukraine
76469,9/1/2023,UKR,Sabah,2,2,0,Ukraine
76470,9/1/2023,UKR,Sarawak,4,3,1,Ukraine
76471,9/1/2023,UKR,Selangor,870,448,422,Ukraine
76472,9/1/2023,UKR,W.P. Labuan,1,0,1,Ukraine
76473,9/1/2023,URY,Johor,7,4,3,Uruguay
76474,9/1/2023,URY,Kedah,0,0,0,Uruguay
76475,9/1/2023,URY,Kelantan,0,0,0,Uruguay
76476,9/1/2023,URY,Perak,0,0,0,Uruguay
76477,9/1/2023,URY,Perlis,0,0,0,Uruguay
76478,9/1/2023,URY,Pulau Pinang,0,0,0,Uruguay
76479,9/1/2023,URY,Sabah,0,0,0,Uruguay
76480,9/1/2023,URY,Sarawak,1,0,1,Uruguay
76481,9/1/2023,URY,Selangor,33,18,15,Uruguay
76482,9/1/2023,URY,W.P. Labuan,0,0,0,Uruguay
76483,9/1/2023,USA,Johor,4192,2446,1746,United States Of America
76484,9/1/2023,USA,Kedah,293,166,127,United States Of America
76485,9/1/2023,USA,Kelantan,11,6,5,United States Of America
76486,9/1/2023,USA,Melaka,3,3,0,United States Of America
76487,9/1/2023,USA,Negeri Sembilan,1,1,0,United States Of America
76488,9/1/2023,USA,Pahang,30,19,11,United States Of America
76489,9/1/2023,USA,Perak,148,77,71,United States Of America
76490,9/1/2023,USA,Perlis,105,67,38,United States Of America
76491,9/1/2023,USA,Pulau Pinang,1816,1189,627,United States Of America
76492,9/1/2023,USA,Sabah,137,70,67,United States Of America
76493,9/1/2023,USA,Sarawak,268,153,115,United States Of America
76494,9/1/2023,USA,Selangor,14022,8338,5684,United States Of America
76495,9/1/2023,USA,Terengganu,0,0,0,United States Of America
76496,9/1/2023,USA,W.P. Labuan,5,4,1,United States Of America
76497,9/1/2023,UZB,Johor,89,58,31,Uzbekistan
76498,9/1/2023,UZB,Kedah,4,3,1,Uzbekistan
76499,9/1/2023,UZB,Kelantan,0,0,0,Uzbekistan
76500,9/1/2023,UZB,Perak,1,0,1,Uzbekistan
76501,9/1/2023,UZB,Perlis,0,0,0,Uzbekistan
76502,9/1/2023,UZB,Pulau Pinang,22,14,8,Uzbekistan
76503,9/1/2023,UZB,Sabah,0,0,0,Uzbekistan
76504,9/1/2023,UZB,Sarawak,1,0,1,Uzbekistan
76505,9/1/2023,UZB,Selangor,968,560,408,Uzbekistan
76506,9/1/2023,VAT,Johor,0,0,0,Holy See (Vatican City State)
76507,9/1/2023,VAT,Sarawak,0,0,0,Holy See (Vatican City State)
76508,9/1/2023,VAT,Selangor,1,1,0,Holy See (Vatican City State)
76509,9/1/2023,VCT,Johor,0,0,0,Saint Vincent and the Grenadines
76510,9/1/2023,VCT,Kedah,0,0,0,Saint Vincent and the Grenadines
76511,9/1/2023,VCT,Pulau Pinang,0,0,0,Saint Vincent and the Grenadines
76512,9/1/2023,VCT,Sarawak,0,0,0,Saint Vincent and the Grenadines
76513,9/1/2023,VCT,Selangor,2,1,1,Saint Vincent and the Grenadines
76514,9/1/2023,VEN,Johor,7,2,5,Venezuela
76515,9/1/2023,VEN,Kedah,0,0,0,Venezuela
76516,9/1/2023,VEN,Kelantan,0,0,0,Venezuela
76517,9/1/2023,VEN,Melaka,0,0,0,Venezuela
76518,9/1/2023,VEN,Perak,0,0,0,Venezuela
76519,9/1/2023,VEN,Perlis,1,0,1,Venezuela
76520,9/1/2023,VEN,Pulau Pinang,0,0,0,Venezuela
76521,9/1/2023,VEN,Sabah,0,0,0,Venezuela
76522,9/1/2023,VEN,Sarawak,7,5,2,Venezuela
76523,9/1/2023,VEN,Selangor,92,43,49,Venezuela
76524,9/1/2023,VEN,W.P. Labuan,0,0,0,Venezuela
76525,9/1/2023,VNM,Johor,14872,4843,10029,Vietnam
76526,9/1/2023,VNM,Kedah,246,31,215,Vietnam
76527,9/1/2023,VNM,Kelantan,31,10,21,Vietnam
76528,9/1/2023,VNM,Melaka,0,0,0,Vietnam
76529,9/1/2023,VNM,Negeri Sembilan,0,0,0,Vietnam
76530,9/1/2023,VNM,Pahang,1,1,0,Vietnam
76531,9/1/2023,VNM,Perak,130,11,119,Vietnam
76532,9/1/2023,VNM,Perlis,211,27,184,Vietnam
76533,9/1/2023,VNM,Pulau Pinang,1586,614,972,Vietnam
76534,9/1/2023,VNM,Sabah,7,4,3,Vietnam
76535,9/1/2023,VNM,Sarawak,210,45,165,Vietnam
76536,9/1/2023,VNM,Selangor,16439,6033,10406,Vietnam
76537,9/1/2023,VNM,Terengganu,0,0,0,Vietnam
76538,9/1/2023,VNM,W.P. Labuan,3,3,0,Vietnam
76539,9/1/2023,VUT,Johor,44,36,8,Vanuatu
76540,9/1/2023,VUT,Kedah,0,0,0,Vanuatu
76541,9/1/2023,VUT,Pulau Pinang,8,7,1,Vanuatu
76542,9/1/2023,VUT,Sabah,1,1,0,Vanuatu
76543,9/1/2023,VUT,Sarawak,0,0,0,Vanuatu
76544,9/1/2023,VUT,Selangor,121,110,11,Vanuatu
76545,9/1/2023,WSM,Johor,0,0,0,Samoa
76546,9/1/2023,WSM,Sarawak,0,0,0,Samoa
76547,9/1/2023,WSM,Selangor,7,4,3,Samoa
76548,9/1/2023,YEM,Johor,20,18,2,Yemen
76549,9/1/2023,YEM,Kedah,4,3,1,Yemen
76550,9/1/2023,YEM,Kelantan,0,0,0,Yemen
76551,9/1/2023,YEM,Melaka,4,2,2,Yemen
76552,9/1/2023,YEM,Pahang,0,0,0,Yemen
76553,9/1/2023,YEM,Perak,0,0,0,Yemen
76554,9/1/2023,YEM,Perlis,1,1,0,Yemen
76555,9/1/2023,YEM,Pulau Pinang,5,3,2,Yemen
76556,9/1/2023,YEM,Sabah,1,1,0,Yemen
76557,9/1/2023,YEM,Sarawak,3,3,0,Yemen
76558,9/1/2023,YEM,Selangor,1472,1059,413,Yemen
76559,9/1/2023,YEM,W.P. Labuan,0,0,0,Yemen
76560,9/1/2023,ZAF,Johor,301,182,119,South Africa
76561,9/1/2023,ZAF,Kedah,28,16,12,South Africa
76562,9/1/2023,ZAF,Kelantan,0,0,0,South Africa
76563,9/1/2023,ZAF,Melaka,0,0,0,South Africa
76564,9/1/2023,ZAF,Pahang,0,0,0,South Africa
76565,9/1/2023,ZAF,Perak,3,1,2,South Africa
76566,9/1/2023,ZAF,Perlis,8,4,4,South Africa
76567,9/1/2023,ZAF,Pulau Pinang,32,21,11,South Africa
76568,9/1/2023,ZAF,Sabah,6,2,4,South Africa
76569,9/1/2023,ZAF,Sarawak,80,39,41,South Africa
76570,9/1/2023,ZAF,Selangor,1133,679,454,South Africa
76571,9/1/2023,ZAF,Terengganu,0,0,0,South Africa
76572,9/1/2023,ZAF,W.P. Labuan,1,0,1,South Africa
76573,9/1/2023,ZMB,Johor,3,1,2,Zambia
76574,9/1/2023,ZMB,Kedah,0,0,0,Zambia
76575,9/1/2023,ZMB,Perak,0,0,0,Zambia
76576,9/1/2023,ZMB,Perlis,0,0,0,Zambia
76577,9/1/2023,ZMB,Pulau Pinang,0,0,0,Zambia
76578,9/1/2023,ZMB,Sabah,0,0,0,Zambia
76579,9/1/2023,ZMB,Sarawak,0,0,0,Zambia
76580,9/1/2023,ZMB,Selangor,118,49,69,Zambia
76581,9/1/2023,ZWE,Johor,14,6,8,Zimbabwe
76582,9/1/2023,ZWE,Kedah,0,0,0,Zimbabwe
76583,9/1/2023,ZWE,Kelantan,0,0,0,Zimbabwe
76584,9/1/2023,ZWE,Perak,1,0,1,Zimbabwe
76585,9/1/2023,ZWE,Perlis,0,0,0,Zimbabwe
76586,9/1/2023,ZWE,Pulau Pinang,0,0,0,Zimbabwe
76587,9/1/2023,ZWE,Sabah,1,1,0,Zimbabwe
76588,9/1/2023,ZWE,Sarawak,2,2,0,Zimbabwe
76589,9/1/2023,ZWE,Selangor,181,95,86,Zimbabwe
76590,10/1/2023,ABW,Kedah,0,0,0,Aruba
76591,10/1/2023,ABW,Pulau Pinang,0,0,0,Aruba
76592,10/1/2023,AFG,Johor,0,0,0,Afghanistan
76593,10/1/2023,AFG,Kedah,0,0,0,Afghanistan
76594,10/1/2023,AFG,Perlis,0,0,0,Afghanistan
76595,10/1/2023,AFG,Pulau Pinang,1,0,1,Afghanistan
76596,10/1/2023,AFG,Sarawak,0,0,0,Afghanistan
76597,10/1/2023,AFG,Selangor,72,57,15,Afghanistan
76598,10/1/2023,AGO,Johor,1,1,0,Angola
76599,10/1/2023,AGO,Kedah,0,0,0,Angola
76600,10/1/2023,AGO,Sabah,0,0,0,Angola
76601,10/1/2023,AGO,Selangor,4,3,1,Angola
76602,10/1/2023,AIA,Selangor,0,0,0,Anguilla
76603,10/1/2023,ALB,Johor,27,20,7,Albania
76604,10/1/2023,ALB,Kedah,1,0,1,Albania
76605,10/1/2023,ALB,Perak,0,0,0,Albania
76606,10/1/2023,ALB,Perlis,0,0,0,Albania
76607,10/1/2023,ALB,Pulau Pinang,1,0,1,Albania
76608,10/1/2023,ALB,Sabah,0,0,0,Albania
76609,10/1/2023,ALB,Sarawak,1,1,0,Albania
76610,10/1/2023,ALB,Selangor,32,17,15,Albania
76611,10/1/2023,AND,Johor,3,1,2,Andorra
76612,10/1/2023,AND,Kedah,0,0,0,Andorra
76613,10/1/2023,AND,Perlis,0,0,0,Andorra
76614,10/1/2023,AND,Pulau Pinang,1,1,0,Andorra
76615,10/1/2023,AND,Selangor,11,9,2,Andorra
76616,10/1/2023,ANT,Selangor,0,0,0,Netherlands Antilles
76617,10/1/2023,ARE,Johor,17,9,8,United Arab Emirates
76618,10/1/2023,ARE,Kedah,2,1,1,United Arab Emirates
76619,10/1/2023,ARE,Kelantan,0,0,0,United Arab Emirates
76620,10/1/2023,ARE,Perak,0,0,0,United Arab Emirates
76621,10/1/2023,ARE,Perlis,1,1,0,United Arab Emirates
76622,10/1/2023,ARE,Pulau Pinang,1,1,0,United Arab Emirates
76623,10/1/2023,ARE,Sabah,0,0,0,United Arab Emirates
76624,10/1/2023,ARE,Sarawak,0,0,0,United Arab Emirates
76625,10/1/2023,ARE,Selangor,406,250,156,United Arab Emirates
76626,10/1/2023,ARG,Johor,83,49,34,Argentina
76627,10/1/2023,ARG,Kedah,30,18,12,Argentina
76628,10/1/2023,ARG,Kelantan,0,0,0,Argentina
76629,10/1/2023,ARG,Melaka,0,0,0,Argentina
76630,10/1/2023,ARG,Perak,1,1,0,Argentina
76631,10/1/2023,ARG,Perlis,4,2,2,Argentina
76632,10/1/2023,ARG,Pulau Pinang,7,3,4,Argentina
76633,10/1/2023,ARG,Sabah,0,0,0,Argentina
76634,10/1/2023,ARG,Sarawak,4,3,1,Argentina
76635,10/1/2023,ARG,Selangor,383,219,164,Argentina
76636,10/1/2023,ARG,W.P. Labuan,0,0,0,Argentina
76637,10/1/2023,ARM,Johor,23,5,18,Armenia
76638,10/1/2023,ARM,Kedah,21,8,13,Armenia
76639,10/1/2023,ARM,Kelantan,0,0,0,Armenia
76640,10/1/2023,ARM,Perak,0,0,0,Armenia
76641,10/1/2023,ARM,Perlis,1,1,0,Armenia
76642,10/1/2023,ARM,Pulau Pinang,0,0,0,Armenia
76643,10/1/2023,ARM,Sabah,0,0,0,Armenia
76644,10/1/2023,ARM,Sarawak,1,1,0,Armenia
76645,10/1/2023,ARM,Selangor,236,72,164,Armenia
76646,10/1/2023,ATA,Selangor,0,0,0,Antarctica
76647,10/1/2023,ATG,Johor,6,5,1,Antigua and Barbuda
76648,10/1/2023,ATG,Kedah,0,0,0,Antigua and Barbuda
76649,10/1/2023,ATG,Pulau Pinang,0,0,0,Antigua and Barbuda
76650,10/1/2023,ATG,Sarawak,0,0,0,Antigua and Barbuda
76651,10/1/2023,ATG,Selangor,8,7,1,Antigua and Barbuda
76652,10/1/2023,AUS,Johor,5758,3403,2355,Australia
76653,10/1/2023,AUS,Kedah,528,318,210,Australia
76654,10/1/2023,AUS,Kelantan,2,1,1,Australia
76655,10/1/2023,AUS,Melaka,1,1,0,Australia
76656,10/1/2023,AUS,Negeri Sembilan,2,2,0,Australia
76657,10/1/2023,AUS,Pahang,26,13,13,Australia
76658,10/1/2023,AUS,Perak,214,117,97,Australia
76659,10/1/2023,AUS,Perlis,78,42,36,Australia
76660,10/1/2023,AUS,Pulau Pinang,1817,959,858,Australia
76661,10/1/2023,AUS,Sabah,85,42,43,Australia
76662,10/1/2023,AUS,Sarawak,501,272,229,Australia
76663,10/1/2023,AUS,Selangor,24006,13843,10163,Australia
76664,10/1/2023,AUS,Terengganu,0,0,0,Australia
76665,10/1/2023,AUS,W.P. Labuan,5,3,2,Australia
76666,10/1/2023,AUT,Johor,182,121,61,Austria
76667,10/1/2023,AUT,Kedah,28,19,9,Austria
76668,10/1/2023,AUT,Kelantan,6,6,0,Austria
76669,10/1/2023,AUT,Melaka,0,0,0,Austria
76670,10/1/2023,AUT,Negeri Sembilan,0,0,0,Austria
76671,10/1/2023,AUT,Pahang,0,0,0,Austria
76672,10/1/2023,AUT,Perak,1,1,0,Austria
76673,10/1/2023,AUT,Perlis,5,3,2,Austria
76674,10/1/2023,AUT,Pulau Pinang,78,55,23,Austria
76675,10/1/2023,AUT,Sabah,1,0,1,Austria
76676,10/1/2023,AUT,Sarawak,16,8,8,Austria
76677,10/1/2023,AUT,Selangor,750,462,288,Austria
76678,10/1/2023,AUT,Terengganu,0,0,0,Austria
76679,10/1/2023,AUT,W.P. Labuan,0,0,0,Austria
76680,10/1/2023,AZE,Johor,1,0,1,Azerbaijan
76681,10/1/2023,AZE,Kedah,1,1,0,Azerbaijan
76682,10/1/2023,AZE,Kelantan,0,0,0,Azerbaijan
76683,10/1/2023,AZE,Melaka,0,0,0,Azerbaijan
76684,10/1/2023,AZE,Perlis,1,1,0,Azerbaijan
76685,10/1/2023,AZE,Pulau Pinang,0,0,0,Azerbaijan
76686,10/1/2023,AZE,Sabah,0,0,0,Azerbaijan
76687,10/1/2023,AZE,Sarawak,0,0,0,Azerbaijan
76688,10/1/2023,AZE,Selangor,133,70,63,Azerbaijan
76689,10/1/2023,AZE,W.P. Labuan,0,0,0,Azerbaijan
76690,10/1/2023,BDI,Pulau Pinang,0,0,0,Burundi
76691,10/1/2023,BDI,Sarawak,0,0,0,Burundi
76692,10/1/2023,BDI,Selangor,1,0,1,Burundi
76693,10/1/2023,BEL,Johor,277,189,88,Belgium
76694,10/1/2023,BEL,Kedah,58,27,31,Belgium
76695,10/1/2023,BEL,Kelantan,3,2,1,Belgium
76696,10/1/2023,BEL,Melaka,0,0,0,Belgium
76697,10/1/2023,BEL,Negeri Sembilan,0,0,0,Belgium
76698,10/1/2023,BEL,Pahang,0,0,0,Belgium
76699,10/1/2023,BEL,Perak,1,1,0,Belgium
76700,10/1/2023,BEL,Perlis,15,9,6,Belgium
76701,10/1/2023,BEL,Pulau Pinang,72,45,27,Belgium
76702,10/1/2023,BEL,Sabah,2,2,0,Belgium
76703,10/1/2023,BEL,Sarawak,20,9,11,Belgium
76704,10/1/2023,BEL,Selangor,1245,762,483,Belgium
76705,10/1/2023,BEL,W.P. Labuan,0,0,0,Belgium
76706,10/1/2023,BEN,Johor,3,3,0,Benin
76707,10/1/2023,BEN,Kedah,0,0,0,Benin
76708,10/1/2023,BEN,Perak,0,0,0,Benin
76709,10/1/2023,BEN,Pulau Pinang,0,0,0,Benin
76710,10/1/2023,BEN,Sabah,0,0,0,Benin
76711,10/1/2023,BEN,Sarawak,0,0,0,Benin
76712,10/1/2023,BEN,Selangor,8,6,2,Benin
76713,10/1/2023,BFA,Perak,0,0,0,Burkina Faso
76714,10/1/2023,BFA,Pulau Pinang,0,0,0,Burkina Faso
76715,10/1/2023,BFA,Selangor,7,6,1,Burkina Faso
76716,10/1/2023,BGD,Johor,3629,3020,609,Bangladesh
76717,10/1/2023,BGD,Kedah,129,83,46,Bangladesh
76718,10/1/2023,BGD,Kelantan,2,2,0,Bangladesh
76719,10/1/2023,BGD,Melaka,0,0,0,Bangladesh
76720,10/1/2023,BGD,Negeri Sembilan,0,0,0,Bangladesh
76721,10/1/2023,BGD,Pahang,0,0,0,Bangladesh
76722,10/1/2023,BGD,Perak,11,9,2,Bangladesh
76723,10/1/2023,BGD,Perlis,6,6,0,Bangladesh
76724,10/1/2023,BGD,Pulau Pinang,218,208,10,Bangladesh
76725,10/1/2023,BGD,Sabah,9,6,3,Bangladesh
76726,10/1/2023,BGD,Sarawak,38,31,7,Bangladesh
76727,10/1/2023,BGD,Selangor,39230,37522,1708,Bangladesh
76728,10/1/2023,BGD,W.P. Labuan,18,18,0,Bangladesh
76729,10/1/2023,BGR,Johor,32,18,14,Bulgaria
76730,10/1/2023,BGR,Kedah,6,3,3,Bulgaria
76731,10/1/2023,BGR,Kelantan,0,0,0,Bulgaria
76732,10/1/2023,BGR,Pahang,0,0,0,Bulgaria
76733,10/1/2023,BGR,Perak,0,0,0,Bulgaria
76734,10/1/2023,BGR,Perlis,1,1,0,Bulgaria
76735,10/1/2023,BGR,Pulau Pinang,9,6,3,Bulgaria
76736,10/1/2023,BGR,Sabah,0,0,0,Bulgaria
76737,10/1/2023,BGR,Sarawak,1,1,0,Bulgaria
76738,10/1/2023,BGR,Selangor,173,93,80,Bulgaria
76739,10/1/2023,BGR,W.P. Labuan,0,0,0,Bulgaria
76740,10/1/2023,BHR,Johor,18,13,5,Bahrain
76741,10/1/2023,BHR,Kedah,2,1,1,Bahrain
76742,10/1/2023,BHR,Kelantan,0,0,0,Bahrain
76743,10/1/2023,BHR,Perlis,3,3,0,Bahrain
76744,10/1/2023,BHR,Pulau Pinang,0,0,0,Bahrain
76745,10/1/2023,BHR,Sabah,0,0,0,Bahrain
76746,10/1/2023,BHR,Sarawak,0,0,0,Bahrain
76747,10/1/2023,BHR,Selangor,175,122,53,Bahrain
76748,10/1/2023,BHS,Johor,1,0,1,Bahamas
76749,10/1/2023,BHS,Kedah,1,0,1,Bahamas
76750,10/1/2023,BHS,Perak,0,0,0,Bahamas
76751,10/1/2023,BHS,Sabah,0,0,0,Bahamas
76752,10/1/2023,BHS,Sarawak,0,0,0,Bahamas
76753,10/1/2023,BHS,Selangor,7,4,3,Bahamas
76754,10/1/2023,BIH,Johor,9,6,3,Bosnia and Herzegovina
76755,10/1/2023,BIH,Kedah,0,0,0,Bosnia and Herzegovina
76756,10/1/2023,BIH,Perlis,1,1,0,Bosnia and Herzegovina
76757,10/1/2023,BIH,Pulau Pinang,0,0,0,Bosnia and Herzegovina
76758,10/1/2023,BIH,Sabah,0,0,0,Bosnia and Herzegovina
76759,10/1/2023,BIH,Sarawak,0,0,0,Bosnia and Herzegovina
76760,10/1/2023,BIH,Selangor,41,23,18,Bosnia and Herzegovina
76761,10/1/2023,BLR,Johor,24,11,13,Belarus
76762,10/1/2023,BLR,Kedah,12,6,6,Belarus
76763,10/1/2023,BLR,Kelantan,1,1,0,Belarus
76764,10/1/2023,BLR,Pahang,0,0,0,Belarus
76765,10/1/2023,BLR,Perak,0,0,0,Belarus
76766,10/1/2023,BLR,Perlis,1,0,1,Belarus
76767,10/1/2023,BLR,Pulau Pinang,6,3,3,Belarus
76768,10/1/2023,BLR,Sabah,0,0,0,Belarus
76769,10/1/2023,BLR,Sarawak,1,0,1,Belarus
76770,10/1/2023,BLR,Selangor,333,152,181,Belarus
76771,10/1/2023,BLR,W.P. Labuan,0,0,0,Belarus
76772,10/1/2023,BLZ,Johor,0,0,0,Belize
76773,10/1/2023,BLZ,Pulau Pinang,0,0,0,Belize
76774,10/1/2023,BLZ,Sarawak,0,0,0,Belize
76775,10/1/2023,BLZ,Selangor,1,1,0,Belize
76776,10/1/2023,BMU,Selangor,0,0,0,Bermuda
76777,10/1/2023,BOL,Johor,2,1,1,Bolivia
76778,10/1/2023,BOL,Kedah,0,0,0,Bolivia
76779,10/1/2023,BOL,Melaka,0,0,0,Bolivia
76780,10/1/2023,BOL,Perak,0,0,0,Bolivia
76781,10/1/2023,BOL,Perlis,0,0,0,Bolivia
76782,10/1/2023,BOL,Pulau Pinang,0,0,0,Bolivia
76783,10/1/2023,BOL,Sabah,0,0,0,Bolivia
76784,10/1/2023,BOL,Sarawak,0,0,0,Bolivia
76785,10/1/2023,BOL,Selangor,277,139,138,Bolivia
76786,10/1/2023,BRA,Johor,252,146,106,Brazil
76787,10/1/2023,BRA,Kedah,42,18,24,Brazil
76788,10/1/2023,BRA,Kelantan,2,1,1,Brazil
76789,10/1/2023,BRA,Melaka,0,0,0,Brazil
76790,10/1/2023,BRA,Pahang,0,0,0,Brazil
76791,10/1/2023,BRA,Perak,2,1,1,Brazil
76792,10/1/2023,BRA,Perlis,6,5,1,Brazil
76793,10/1/2023,BRA,Pulau Pinang,26,17,9,Brazil
76794,10/1/2023,BRA,Sabah,5,4,1,Brazil
76795,10/1/2023,BRA,Sarawak,9,7,2,Brazil
76796,10/1/2023,BRA,Selangor,1032,628,404,Brazil
76797,10/1/2023,BRA,W.P. Labuan,2,2,0,Brazil
76798,10/1/2023,BRB,Johor,2,2,0,Barbados
76799,10/1/2023,BRB,Kedah,0,0,0,Barbados
76800,10/1/2023,BRB,Perlis,0,0,0,Barbados
76801,10/1/2023,BRB,Pulau Pinang,0,0,0,Barbados
76802,10/1/2023,BRB,Selangor,5,3,2,Barbados
76803,10/1/2023,BRN,Johor,327,156,171,Brunei Darussalam
76804,10/1/2023,BRN,Kedah,17,8,9,Brunei Darussalam
76805,10/1/2023,BRN,Kelantan,9,8,1,Brunei Darussalam
76806,10/1/2023,BRN,Melaka,0,0,0,Brunei Darussalam
76807,10/1/2023,BRN,Pahang,0,0,0,Brunei Darussalam
76808,10/1/2023,BRN,Perak,1,1,0,Brunei Darussalam
76809,10/1/2023,BRN,Perlis,27,10,17,Brunei Darussalam
76810,10/1/2023,BRN,Pulau Pinang,22,10,12,Brunei Darussalam
76811,10/1/2023,BRN,Sabah,134,61,73,Brunei Darussalam
76812,10/1/2023,BRN,Sarawak,58974,33361,25613,Brunei Darussalam
76813,10/1/2023,BRN,Selangor,4375,2176,2199,Brunei Darussalam
76814,10/1/2023,BRN,W.P. Labuan,871,646,225,Brunei Darussalam
76815,10/1/2023,BTN,Johor,10,7,3,Bhutan
76816,10/1/2023,BTN,Kedah,0,0,0,Bhutan
76817,10/1/2023,BTN,Perak,0,0,0,Bhutan
76818,10/1/2023,BTN,Perlis,0,0,0,Bhutan
76819,10/1/2023,BTN,Pulau Pinang,0,0,0,Bhutan
76820,10/1/2023,BTN,Sabah,0,0,0,Bhutan
76821,10/1/2023,BTN,Sarawak,0,0,0,Bhutan
76822,10/1/2023,BTN,Selangor,48,32,16,Bhutan
76823,10/1/2023,BWA,Johor,2,2,0,Botswana
76824,10/1/2023,BWA,Kedah,0,0,0,Botswana
76825,10/1/2023,BWA,Perlis,0,0,0,Botswana
76826,10/1/2023,BWA,Pulau Pinang,0,0,0,Botswana
76827,10/1/2023,BWA,Sabah,0,0,0,Botswana
76828,10/1/2023,BWA,Sarawak,0,0,0,Botswana
76829,10/1/2023,BWA,Selangor,14,4,10,Botswana
76830,10/1/2023,CAF,Kedah,0,0,0,Central African Republic
76831,10/1/2023,CAF,Selangor,1,0,1,Central African Republic
76832,10/1/2023,CAN,Johor,1558,889,669,Canada
76833,10/1/2023,CAN,Kedah,168,84,84,Canada
76834,10/1/2023,CAN,Kelantan,0,0,0,Canada
76835,10/1/2023,CAN,Melaka,0,0,0,Canada
76836,10/1/2023,CAN,Negeri Sembilan,0,0,0,Canada
76837,10/1/2023,CAN,Pahang,6,4,2,Canada
76838,10/1/2023,CAN,Perak,34,20,14,Canada
76839,10/1/2023,CAN,Perlis,41,28,13,Canada
76840,10/1/2023,CAN,Pulau Pinang,479,266,213,Canada
76841,10/1/2023,CAN,Sabah,46,28,18,Canada
76842,10/1/2023,CAN,Sarawak,242,146,96,Canada
76843,10/1/2023,CAN,Selangor,4518,2586,1932,Canada
76844,10/1/2023,CAN,Terengganu,0,0,0,Canada
76845,10/1/2023,CAN,W.P. Labuan,4,3,1,Canada
76846,10/1/2023,CCK,Selangor,0,0,0,Cocos (Keeling) Islands
76847,10/1/2023,CHE,Johor,403,246,157,Switzerland
76848,10/1/2023,CHE,Kedah,106,58,48,Switzerland
76849,10/1/2023,CHE,Kelantan,1,0,1,Switzerland
76850,10/1/2023,CHE,Melaka,0,0,0,Switzerland
76851,10/1/2023,CHE,Negeri Sembilan,0,0,0,Switzerland
76852,10/1/2023,CHE,Pahang,1,1,0,Switzerland
76853,10/1/2023,CHE,Perak,5,2,3,Switzerland
76854,10/1/2023,CHE,Perlis,20,8,12,Switzerland
76855,10/1/2023,CHE,Pulau Pinang,157,93,64,Switzerland
76856,10/1/2023,CHE,Sabah,9,6,3,Switzerland
76857,10/1/2023,CHE,Sarawak,47,22,25,Switzerland
76858,10/1/2023,CHE,Selangor,1372,845,527,Switzerland
76859,10/1/2023,CHE,W.P. Labuan,5,3,2,Switzerland
76860,10/1/2023,CHL,Johor,40,17,23,Chile
76861,10/1/2023,CHL,Kedah,9,3,6,Chile
76862,10/1/2023,CHL,Kelantan,1,0,1,Chile
76863,10/1/2023,CHL,Melaka,0,0,0,Chile
76864,10/1/2023,CHL,Pahang,0,0,0,Chile
76865,10/1/2023,CHL,Perak,0,0,0,Chile
76866,10/1/2023,CHL,Perlis,2,1,1,Chile
76867,10/1/2023,CHL,Pulau Pinang,10,5,5,Chile
76868,10/1/2023,CHL,Sabah,0,0,0,Chile
76869,10/1/2023,CHL,Sarawak,1,1,0,Chile
76870,10/1/2023,CHL,Selangor,247,130,117,Chile
76871,10/1/2023,CHN,Johor,48690,21231,27459,China
76872,10/1/2023,CHN,Kedah,1156,521,635,China
76873,10/1/2023,CHN,Kelantan,12,7,5,China
76874,10/1/2023,CHN,Melaka,3,3,0,China
76875,10/1/2023,CHN,Pahang,28,14,14,China
76876,10/1/2023,CHN,Perak,237,97,140,China
76877,10/1/2023,CHN,Perlis,94,53,41,China
76878,10/1/2023,CHN,Pulau Pinang,9209,4790,4419,China
76879,10/1/2023,CHN,Sabah,1575,765,810,China
76880,10/1/2023,CHN,Sarawak,957,490,467,China
76881,10/1/2023,CHN,Selangor,96676,49199,47477,China
76882,10/1/2023,CHN,Terengganu,1,1,0,China
76883,10/1/2023,CHN,W.P. Labuan,44,39,5,China
76884,10/1/2023,CIV,Johor,2,2,0,C��te d'Iv
76885,10/1/2023,CIV,Kedah,0,0,0,C��te d'Iv
76886,10/1/2023,CIV,Pulau Pinang,0,0,0,C��te d'Iv
76887,10/1/2023,CIV,Sabah,0,0,0,C��te d'Iv
76888,10/1/2023,CIV,Sarawak,0,0,0,C��te d'Iv
76889,10/1/2023,CIV,Selangor,16,11,5,C��te d'Iv
76890,10/1/2023,CMR,Johor,2,2,0,Cameroon
76891,10/1/2023,CMR,Kedah,1,1,0,Cameroon
76892,10/1/2023,CMR,Pulau Pinang,0,0,0,Cameroon
76893,10/1/2023,CMR,Sabah,1,1,0,Cameroon
76894,10/1/2023,CMR,Sarawak,0,0,0,Cameroon
76895,10/1/2023,CMR,Selangor,25,20,5,Cameroon
76896,10/1/2023,COD,Johor,3,3,0,"Congo, the Democratic Republic of the"
76897,10/1/2023,COD,Pulau Pinang,0,0,0,"Congo, the Democratic Republic of the"
76898,10/1/2023,COD,Sarawak,0,0,0,"Congo, the Democratic Republic of the"
76899,10/1/2023,COD,Selangor,13,10,3,"Congo, the Democratic Republic of the"
76900,10/1/2023,COG,Johor,0,0,0,Congo
76901,10/1/2023,COG,Kedah,0,0,0,Congo
76902,10/1/2023,COG,Selangor,17,14,3,Congo
76903,10/1/2023,COK,Selangor,0,0,0,Cook Islands
76904,10/1/2023,COL,Johor,47,33,14,Colombia
76905,10/1/2023,COL,Kedah,8,3,5,Colombia
76906,10/1/2023,COL,Perak,0,0,0,Colombia
76907,10/1/2023,COL,Pulau Pinang,6,3,3,Colombia
76908,10/1/2023,COL,Sabah,2,1,1,Colombia
76909,10/1/2023,COL,Sarawak,1,1,0,Colombia
76910,10/1/2023,COL,Selangor,241,127,114,Colombia
76911,10/1/2023,COL,W.P. Labuan,1,1,0,Colombia
76912,10/1/2023,COM,Johor,0,0,0,Comoros
76913,10/1/2023,COM,Kedah,0,0,0,Comoros
76914,10/1/2023,COM,Selangor,21,13,8,Comoros
76915,10/1/2023,CPV,Johor,0,0,0,Cape Verde
76916,10/1/2023,CPV,Kedah,0,0,0,Cape Verde
76917,10/1/2023,CPV,Pulau Pinang,0,0,0,Cape Verde
76918,10/1/2023,CPV,Sabah,0,0,0,Cape Verde
76919,10/1/2023,CPV,Selangor,5,2,3,Cape Verde
76920,10/1/2023,CRI,Johor,22,15,7,Costa Rica
76921,10/1/2023,CRI,Kedah,3,1,2,Costa Rica
76922,10/1/2023,CRI,Perak,0,0,0,Costa Rica
76923,10/1/2023,CRI,Perlis,0,0,0,Costa Rica
76924,10/1/2023,CRI,Pulau Pinang,13,7,6,Costa Rica
76925,10/1/2023,CRI,Sabah,0,0,0,Costa Rica
76926,10/1/2023,CRI,Sarawak,3,3,0,Costa Rica
76927,10/1/2023,CRI,Selangor,58,33,25,Costa Rica
76928,10/1/2023,CUB,Johor,5,3,2,Cuba
76929,10/1/2023,CUB,Kedah,0,0,0,Cuba
76930,10/1/2023,CUB,Perlis,0,0,0,Cuba
76931,10/1/2023,CUB,Pulau Pinang,0,0,0,Cuba
76932,10/1/2023,CUB,Sabah,0,0,0,Cuba
76933,10/1/2023,CUB,Sarawak,0,0,0,Cuba
76934,10/1/2023,CUB,Selangor,13,6,7,Cuba
76935,10/1/2023,CYP,Johor,20,14,6,Cyprus
76936,10/1/2023,CYP,Kedah,0,0,0,Cyprus
76937,10/1/2023,CYP,Perak,0,0,0,Cyprus
76938,10/1/2023,CYP,Perlis,0,0,0,Cyprus
76939,10/1/2023,CYP,Pulau Pinang,2,1,1,Cyprus
76940,10/1/2023,CYP,Sabah,0,0,0,Cyprus
76941,10/1/2023,CYP,Sarawak,1,0,1,Cyprus
76942,10/1/2023,CYP,Selangor,73,42,31,Cyprus
76943,10/1/2023,CZE,Johor,81,41,40,Czech Republic
76944,10/1/2023,CZE,Kedah,39,18,21,Czech Republic
76945,10/1/2023,CZE,Kelantan,0,0,0,Czech Republic
76946,10/1/2023,CZE,Melaka,0,0,0,Czech Republic
76947,10/1/2023,CZE,Negeri Sembilan,0,0,0,Czech Republic
76948,10/1/2023,CZE,Perak,0,0,0,Czech Republic
76949,10/1/2023,CZE,Perlis,2,1,1,Czech Republic
76950,10/1/2023,CZE,Pulau Pinang,11,5,6,Czech Republic
76951,10/1/2023,CZE,Sabah,2,1,1,Czech Republic
76952,10/1/2023,CZE,Sarawak,5,5,0,Czech Republic
76953,10/1/2023,CZE,Selangor,503,302,201,Czech Republic
76954,10/1/2023,CZE,W.P. Labuan,0,0,0,Czech Republic
76955,10/1/2023,DEU,Johor,2566,1575,991,Germany
76956,10/1/2023,DEU,Kedah,368,197,171,Germany
76957,10/1/2023,DEU,Kelantan,16,10,6,Germany
76958,10/1/2023,DEU,Melaka,3,1,2,Germany
76959,10/1/2023,DEU,Negeri Sembilan,1,1,0,Germany
76960,10/1/2023,DEU,Pahang,12,10,2,Germany
76961,10/1/2023,DEU,Perak,39,21,18,Germany
76962,10/1/2023,DEU,Perlis,68,41,27,Germany
76963,10/1/2023,DEU,Pulau Pinang,786,540,246,Germany
76964,10/1/2023,DEU,Sabah,31,16,15,Germany
76965,10/1/2023,DEU,Sarawak,230,153,77,Germany
76966,10/1/2023,DEU,Selangor,6844,4246,2598,Germany
76967,10/1/2023,DEU,Terengganu,0,0,0,Germany
76968,10/1/2023,DEU,W.P. Labuan,5,2,3,Germany
76969,10/1/2023,DJI,Johor,1,1,0,Djibouti
76970,10/1/2023,DJI,Selangor,12,8,4,Djibouti
76971,10/1/2023,DMA,Johor,4,3,1,Dominica
76972,10/1/2023,DMA,Kedah,0,0,0,Dominica
76973,10/1/2023,DMA,Pulau Pinang,0,0,0,Dominica
76974,10/1/2023,DMA,Sabah,0,0,0,Dominica
76975,10/1/2023,DMA,Sarawak,0,0,0,Dominica
76976,10/1/2023,DMA,Selangor,44,38,6,Dominica
76977,10/1/2023,DMA,W.P. Labuan,0,0,0,Dominica
76978,10/1/2023,DNK,Johor,358,243,115,Denmark
76979,10/1/2023,DNK,Kedah,46,28,18,Denmark
76980,10/1/2023,DNK,Kelantan,0,0,0,Denmark
76981,10/1/2023,DNK,Melaka,0,0,0,Denmark
76982,10/1/2023,DNK,Negeri Sembilan,0,0,0,Denmark
76983,10/1/2023,DNK,Pahang,0,0,0,Denmark
76984,10/1/2023,DNK,Perak,0,0,0,Denmark
76985,10/1/2023,DNK,Perlis,6,4,2,Denmark
76986,10/1/2023,DNK,Pulau Pinang,62,39,23,Denmark
76987,10/1/2023,DNK,Sabah,16,8,8,Denmark
76988,10/1/2023,DNK,Sarawak,17,9,8,Denmark
76989,10/1/2023,DNK,Selangor,1113,654,459,Denmark
76990,10/1/2023,DNK,W.P. Labuan,0,0,0,Denmark
76991,10/1/2023,DOM,Johor,0,0,0,Dominican Republic
76992,10/1/2023,DOM,Kedah,0,0,0,Dominican Republic
76993,10/1/2023,DOM,Perak,0,0,0,Dominican Republic
76994,10/1/2023,DOM,Perlis,0,0,0,Dominican Republic
76995,10/1/2023,DOM,Pulau Pinang,2,1,1,Dominican Republic
76996,10/1/2023,DOM,Sabah,0,0,0,Dominican Republic
76997,10/1/2023,DOM,Sarawak,0,0,0,Dominican Republic
76998,10/1/2023,DOM,Selangor,20,9,11,Dominican Republic
76999,10/1/2023,DZA,Johor,34,21,13,Algeria
77000,10/1/2023,DZA,Kedah,2,2,0,Algeria
77001,10/1/2023,DZA,Kelantan,1,1,0,Algeria
77002,10/1/2023,DZA,Melaka,0,0,0,Algeria
77003,10/1/2023,DZA,Perak,0,0,0,Algeria
77004,10/1/2023,DZA,Perlis,0,0,0,Algeria
77005,10/1/2023,DZA,Pulau Pinang,2,1,1,Algeria
77006,10/1/2023,DZA,Sabah,0,0,0,Algeria
77007,10/1/2023,DZA,Sarawak,2,2,0,Algeria
77008,10/1/2023,DZA,Selangor,1145,741,404,Algeria
77009,10/1/2023,DZA,W.P. Labuan,0,0,0,Algeria
77010,10/1/2023,ECU,Johor,9,5,4,Ecuador
77011,10/1/2023,ECU,Kedah,1,1,0,Ecuador
77012,10/1/2023,ECU,Perak,0,0,0,Ecuador
77013,10/1/2023,ECU,Perlis,0,0,0,Ecuador
77014,10/1/2023,ECU,Pulau Pinang,0,0,0,Ecuador
77015,10/1/2023,ECU,Sabah,0,0,0,Ecuador
77016,10/1/2023,ECU,Sarawak,0,0,0,Ecuador
77017,10/1/2023,ECU,Selangor,72,42,30,Ecuador
77018,10/1/2023,EGY,Johor,239,211,28,Egypt
77019,10/1/2023,EGY,Kedah,5,4,1,Egypt
77020,10/1/2023,EGY,Kelantan,2,2,0,Egypt
77021,10/1/2023,EGY,Melaka,0,0,0,Egypt
77022,10/1/2023,EGY,Pahang,0,0,0,Egypt
77023,10/1/2023,EGY,Perak,1,0,1,Egypt
77024,10/1/2023,EGY,Perlis,1,1,0,Egypt
77025,10/1/2023,EGY,Pulau Pinang,9,9,0,Egypt
77026,10/1/2023,EGY,Sabah,1,1,0,Egypt
77027,10/1/2023,EGY,Sarawak,73,41,32,Egypt
77028,10/1/2023,EGY,Selangor,2259,1559,700,Egypt
77029,10/1/2023,EGY,Terengganu,0,0,0,Egypt
77030,10/1/2023,EGY,W.P. Labuan,0,0,0,Egypt
77031,10/1/2023,ERI,Johor,0,0,0,Eritrea
77032,10/1/2023,ERI,Pulau Pinang,0,0,0,Eritrea
77033,10/1/2023,ERI,Sabah,0,0,0,Eritrea
77034,10/1/2023,ERI,Selangor,13,10,3,Eritrea
77035,10/1/2023,ESP,Johor,586,340,246,Spain
77036,10/1/2023,ESP,Kedah,109,57,52,Spain
77037,10/1/2023,ESP,Kelantan,8,4,4,Spain
77038,10/1/2023,ESP,Melaka,0,0,0,Spain
77039,10/1/2023,ESP,Negeri Sembilan,0,0,0,Spain
77040,10/1/2023,ESP,Pahang,3,2,1,Spain
77041,10/1/2023,ESP,Perak,8,5,3,Spain
77042,10/1/2023,ESP,Perlis,15,9,6,Spain
77043,10/1/2023,ESP,Pulau Pinang,112,73,39,Spain
77044,10/1/2023,ESP,Sabah,13,5,8,Spain
77045,10/1/2023,ESP,Sarawak,60,35,25,Spain
77046,10/1/2023,ESP,Selangor,3213,1795,1418,Spain
77047,10/1/2023,ESP,W.P. Labuan,2,1,1,Spain
77048,10/1/2023,EST,Johor,23,11,12,Estonia
77049,10/1/2023,EST,Kedah,27,14,13,Estonia
77050,10/1/2023,EST,Kelantan,0,0,0,Estonia
77051,10/1/2023,EST,Pahang,0,0,0,Estonia
77052,10/1/2023,EST,Perak,0,0,0,Estonia
77053,10/1/2023,EST,Perlis,0,0,0,Estonia
77054,10/1/2023,EST,Pulau Pinang,9,3,6,Estonia
77055,10/1/2023,EST,Sabah,3,2,1,Estonia
77056,10/1/2023,EST,Sarawak,3,2,1,Estonia
77057,10/1/2023,EST,Selangor,198,101,97,Estonia
77058,10/1/2023,EST,W.P. Labuan,1,0,1,Estonia
77059,10/1/2023,ETH,Johor,0,0,0,Ethiopia
77060,10/1/2023,ETH,Kedah,0,0,0,Ethiopia
77061,10/1/2023,ETH,Pulau Pinang,0,0,0,Ethiopia
77062,10/1/2023,ETH,Sarawak,0,0,0,Ethiopia
77063,10/1/2023,ETH,Selangor,61,42,19,Ethiopia
77064,10/1/2023,FIN,Johor,203,113,90,Finland
77065,10/1/2023,FIN,Kedah,37,20,17,Finland
77066,10/1/2023,FIN,Kelantan,0,0,0,Finland
77067,10/1/2023,FIN,Melaka,0,0,0,Finland
77068,10/1/2023,FIN,Negeri Sembilan,0,0,0,Finland
77069,10/1/2023,FIN,Pahang,0,0,0,Finland
77070,10/1/2023,FIN,Perak,5,3,2,Finland
77071,10/1/2023,FIN,Perlis,2,2,0,Finland
77072,10/1/2023,FIN,Pulau Pinang,62,31,31,Finland
77073,10/1/2023,FIN,Sabah,1,1,0,Finland
77074,10/1/2023,FIN,Sarawak,10,6,4,Finland
77075,10/1/2023,FIN,Selangor,470,255,215,Finland
77076,10/1/2023,FIN,W.P. Labuan,0,0,0,Finland
77077,10/1/2023,FJI,Johor,63,34,29,Fiji
77078,10/1/2023,FJI,Kedah,3,3,0,Fiji
77079,10/1/2023,FJI,Kelantan,0,0,0,Fiji
77080,10/1/2023,FJI,Perak,0,0,0,Fiji
77081,10/1/2023,FJI,Perlis,0,0,0,Fiji
77082,10/1/2023,FJI,Pulau Pinang,6,4,2,Fiji
77083,10/1/2023,FJI,Sabah,0,0,0,Fiji
77084,10/1/2023,FJI,Sarawak,1,1,0,Fiji
77085,10/1/2023,FJI,Selangor,166,76,90,Fiji
77086,10/1/2023,FRA,Johor,2135,1285,850,France
77087,10/1/2023,FRA,Kedah,322,169,153,France
77088,10/1/2023,FRA,Kelantan,24,16,8,France
77089,10/1/2023,FRA,Melaka,7,4,3,France
77090,10/1/2023,FRA,Negeri Sembilan,3,0,3,France
77091,10/1/2023,FRA,Pahang,24,14,10,France
77092,10/1/2023,FRA,Perak,27,22,5,France
77093,10/1/2023,FRA,Perlis,45,29,16,France
77094,10/1/2023,FRA,Pulau Pinang,329,207,122,France
77095,10/1/2023,FRA,Sabah,34,25,9,France
77096,10/1/2023,FRA,Sarawak,80,50,30,France
77097,10/1/2023,FRA,Selangor,7994,4822,3172,France
77098,10/1/2023,FRA,Terengganu,0,0,0,France
77099,10/1/2023,FRA,W.P. Labuan,6,3,3,France
77100,10/1/2023,FSM,Johor,0,0,0,"Micronesia, Federated States of"
77101,10/1/2023,FSM,Pulau Pinang,0,0,0,"Micronesia, Federated States of"
77102,10/1/2023,FSM,Selangor,1,0,1,"Micronesia, Federated States of"
77103,10/1/2023,GAB,Johor,1,0,1,Gabon
77104,10/1/2023,GAB,Pulau Pinang,0,0,0,Gabon
77105,10/1/2023,GAB,Sarawak,0,0,0,Gabon
77106,10/1/2023,GAB,Selangor,10,4,6,Gabon
77107,10/1/2023,GBR,Johor,5482,3422,2060,United Kingdom
77108,10/1/2023,GBR,Kedah,747,413,334,United Kingdom
77109,10/1/2023,GBR,Kelantan,23,14,9,United Kingdom
77110,10/1/2023,GBR,Melaka,1,1,0,United Kingdom
77111,10/1/2023,GBR,Negeri Sembilan,2,2,0,United Kingdom
77112,10/1/2023,GBR,Pahang,35,25,10,United Kingdom
77113,10/1/2023,GBR,Perak,86,58,28,United Kingdom
77114,10/1/2023,GBR,Perlis,122,76,46,United Kingdom
77115,10/1/2023,GBR,Pulau Pinang,1587,957,630,United Kingdom
77116,10/1/2023,GBR,Sabah,106,58,48,United Kingdom
77117,10/1/2023,GBR,Sarawak,991,585,406,United Kingdom
77118,10/1/2023,GBR,Selangor,17730,10854,6876,United Kingdom
77119,10/1/2023,GBR,Terengganu,0,0,0,United Kingdom
77120,10/1/2023,GBR,W.P. Labuan,45,35,10,United Kingdom
77121,10/1/2023,GEO,Johor,3,2,1,Georgia
77122,10/1/2023,GEO,Kedah,2,1,1,Georgia
77123,10/1/2023,GEO,Melaka,0,0,0,Georgia
77124,10/1/2023,GEO,Perak,0,0,0,Georgia
77125,10/1/2023,GEO,Perlis,0,0,0,Georgia
77126,10/1/2023,GEO,Pulau Pinang,4,2,2,Georgia
77127,10/1/2023,GEO,Sabah,2,1,1,Georgia
77128,10/1/2023,GEO,Sarawak,0,0,0,Georgia
77129,10/1/2023,GEO,Selangor,42,24,18,Georgia
77130,10/1/2023,GHA,Johor,8,7,1,Ghana
77131,10/1/2023,GHA,Kedah,0,0,0,Ghana
77132,10/1/2023,GHA,Kelantan,0,0,0,Ghana
77133,10/1/2023,GHA,Pulau Pinang,0,0,0,Ghana
77134,10/1/2023,GHA,Sabah,0,0,0,Ghana
77135,10/1/2023,GHA,Sarawak,0,0,0,Ghana
77136,10/1/2023,GHA,Selangor,94,59,35,Ghana
77137,10/1/2023,GIB,Johor,1,0,1,Gibraltar
77138,10/1/2023,GIB,Sarawak,0,0,0,Gibraltar
77139,10/1/2023,GIN,Johor,4,2,2,Guinea
77140,10/1/2023,GIN,Kedah,1,1,0,Guinea
77141,10/1/2023,GIN,Kelantan,1,1,0,Guinea
77142,10/1/2023,GIN,Perlis,0,0,0,Guinea
77143,10/1/2023,GIN,Pulau Pinang,0,0,0,Guinea
77144,10/1/2023,GIN,Sabah,0,0,0,Guinea
77145,10/1/2023,GIN,Sarawak,0,0,0,Guinea
77146,10/1/2023,GIN,Selangor,57,37,20,Guinea
77147,10/1/2023,GLP,Selangor,0,0,0,Guadeloupe
77148,10/1/2023,GMB,Johor,4,4,0,Gambia
77149,10/1/2023,GMB,Kedah,0,0,0,Gambia
77150,10/1/2023,GMB,Kelantan,0,0,0,Gambia
77151,10/1/2023,GMB,Pulau Pinang,0,0,0,Gambia
77152,10/1/2023,GMB,Sabah,2,2,0,Gambia
77153,10/1/2023,GMB,Sarawak,0,0,0,Gambia
77154,10/1/2023,GMB,Selangor,34,25,9,Gambia
77155,10/1/2023,GNB,Johor,0,0,0,Guinea-Bissau
77156,10/1/2023,GNB,Selangor,0,0,0,Guinea-Bissau
77157,10/1/2023,GNQ,Johor,1,1,0,Equatorial Guinea
77158,10/1/2023,GNQ,Selangor,2,1,1,Equatorial Guinea
77159,10/1/2023,GRC,Johor,80,62,18,Greece
77160,10/1/2023,GRC,Kedah,1,0,1,Greece
77161,10/1/2023,GRC,Kelantan,0,0,0,Greece
77162,10/1/2023,GRC,Melaka,0,0,0,Greece
77163,10/1/2023,GRC,Negeri Sembilan,1,1,0,Greece
77164,10/1/2023,GRC,Pahang,0,0,0,Greece
77165,10/1/2023,GRC,Perak,0,0,0,Greece
77166,10/1/2023,GRC,Perlis,1,1,0,Greece
77167,10/1/2023,GRC,Pulau Pinang,13,11,2,Greece
77168,10/1/2023,GRC,Sabah,3,2,1,Greece
77169,10/1/2023,GRC,Sarawak,19,13,6,Greece
77170,10/1/2023,GRC,Selangor,251,174,77,Greece
77171,10/1/2023,GRD,Johor,11,4,7,Grenada
77172,10/1/2023,GRD,Kedah,0,0,0,Grenada
77173,10/1/2023,GRD,Pulau Pinang,1,1,0,Grenada
77174,10/1/2023,GRD,Sabah,0,0,0,Grenada
77175,10/1/2023,GRD,Sarawak,0,0,0,Grenada
77176,10/1/2023,GRD,Selangor,20,17,3,Grenada
77177,10/1/2023,GRL,Johor,0,0,0,Greenland
77178,10/1/2023,GRL,Selangor,0,0,0,Greenland
77179,10/1/2023,GTM,Johor,2,2,0,Guatemala
77180,10/1/2023,GTM,Kedah,0,0,0,Guatemala
77181,10/1/2023,GTM,Pahang,0,0,0,Guatemala
77182,10/1/2023,GTM,Perak,0,0,0,Guatemala
77183,10/1/2023,GTM,Pulau Pinang,1,1,0,Guatemala
77184,10/1/2023,GTM,Sabah,0,0,0,Guatemala
77185,10/1/2023,GTM,Sarawak,0,0,0,Guatemala
77186,10/1/2023,GTM,Selangor,45,24,21,Guatemala
77187,10/1/2023,GTM,W.P. Labuan,0,0,0,Guatemala
77188,10/1/2023,GUY,Johor,0,0,0,Guyana
77189,10/1/2023,GUY,Kedah,0,0,0,Guyana
77190,10/1/2023,GUY,Pulau Pinang,0,0,0,Guyana
77191,10/1/2023,GUY,Sarawak,0,0,0,Guyana
77192,10/1/2023,GUY,Selangor,3,0,3,Guyana
77193,10/1/2023,HKG,Johor,6,5,1,Hong Kong
77194,10/1/2023,HKG,Kedah,0,0,0,Hong Kong
77195,10/1/2023,HKG,Kelantan,0,0,0,Hong Kong
77196,10/1/2023,HKG,Pahang,2,2,0,Hong Kong
77197,10/1/2023,HKG,Perak,21,10,11,Hong Kong
77198,10/1/2023,HKG,Perlis,0,0,0,Hong Kong
77199,10/1/2023,HKG,Pulau Pinang,0,0,0,Hong Kong
77200,10/1/2023,HKG,Sabah,0,0,0,Hong Kong
77201,10/1/2023,HKG,Sarawak,0,0,0,Hong Kong
77202,10/1/2023,HKG,Selangor,2,1,1,Hong Kong
77203,10/1/2023,HKG,Terengganu,1,1,0,Hong Kong
77204,10/1/2023,HMD,Johor,0,0,0,Heard Island and McDonald Islands
77205,10/1/2023,HND,Johor,3,3,0,Honduras
77206,10/1/2023,HND,Kedah,1,1,0,Honduras
77207,10/1/2023,HND,Perak,0,0,0,Honduras
77208,10/1/2023,HND,Pulau Pinang,0,0,0,Honduras
77209,10/1/2023,HND,Sabah,0,0,0,Honduras
77210,10/1/2023,HND,Sarawak,0,0,0,Honduras
77211,10/1/2023,HND,Selangor,21,13,8,Honduras
77212,10/1/2023,HRV,Johor,49,37,12,Croatia
77213,10/1/2023,HRV,Kedah,1,1,0,Croatia
77214,10/1/2023,HRV,Kelantan,0,0,0,Croatia
77215,10/1/2023,HRV,Melaka,0,0,0,Croatia
77216,10/1/2023,HRV,Pahang,2,2,0,Croatia
77217,10/1/2023,HRV,Perak,0,0,0,Croatia
77218,10/1/2023,HRV,Perlis,0,0,0,Croatia
77219,10/1/2023,HRV,Pulau Pinang,7,3,4,Croatia
77220,10/1/2023,HRV,Sabah,0,0,0,Croatia
77221,10/1/2023,HRV,Sarawak,0,0,0,Croatia
77222,10/1/2023,HRV,Selangor,201,135,66,Croatia
77223,10/1/2023,HTI,Johor,1,1,0,Haiti
77224,10/1/2023,HTI,Kedah,0,0,0,Haiti
77225,10/1/2023,HTI,Kelantan,0,0,0,Haiti
77226,10/1/2023,HTI,Perak,0,0,0,Haiti
77227,10/1/2023,HTI,Pulau Pinang,0,0,0,Haiti
77228,10/1/2023,HTI,Sabah,0,0,0,Haiti
77229,10/1/2023,HTI,Selangor,4,4,0,Haiti
77230,10/1/2023,HUN,Johor,106,66,40,Hungary
77231,10/1/2023,HUN,Kedah,21,10,11,Hungary
77232,10/1/2023,HUN,Kelantan,0,0,0,Hungary
77233,10/1/2023,HUN,Pahang,0,0,0,Hungary
77234,10/1/2023,HUN,Perak,3,3,0,Hungary
77235,10/1/2023,HUN,Perlis,2,1,1,Hungary
77236,10/1/2023,HUN,Pulau Pinang,24,15,9,Hungary
77237,10/1/2023,HUN,Sabah,2,1,1,Hungary
77238,10/1/2023,HUN,Sarawak,7,4,3,Hungary
77239,10/1/2023,HUN,Selangor,492,268,224,Hungary
77240,10/1/2023,HUN,W.P. Labuan,0,0,0,Hungary
77241,10/1/2023,IDN,Johor,93484,43240,50244,Indonesia
77242,10/1/2023,IDN,Kedah,6462,2392,4070,Indonesia
77243,10/1/2023,IDN,Kelantan,278,133,145,Indonesia
77244,10/1/2023,IDN,Melaka,3476,1526,1950,Indonesia
77245,10/1/2023,IDN,Negeri Sembilan,5078,3032,2046,Indonesia
77246,10/1/2023,IDN,Pahang,16,11,5,Indonesia
77247,10/1/2023,IDN,Perak,262,122,140,Indonesia
77248,10/1/2023,IDN,Perlis,616,315,301,Indonesia
77249,10/1/2023,IDN,Pulau Pinang,38534,15377,23157,Indonesia
77250,10/1/2023,IDN,Sabah,3845,1995,1850,Indonesia
77251,10/1/2023,IDN,Sarawak,34683,18599,16084,Indonesia
77252,10/1/2023,IDN,Selangor,126287,59676,66611,Indonesia
77253,10/1/2023,IDN,Terengganu,0,0,0,Indonesia
77254,10/1/2023,IDN,W.P. Labuan,55,37,18,Indonesia
77255,10/1/2023,IND,Johor,26747,18215,8532,India
77256,10/1/2023,IND,Kedah,1245,660,585,India
77257,10/1/2023,IND,Kelantan,3,3,0,India
77258,10/1/2023,IND,Melaka,2,2,0,India
77259,10/1/2023,IND,Negeri Sembilan,2,2,0,India
77260,10/1/2023,IND,Pahang,10,9,1,India
77261,10/1/2023,IND,Perak,151,115,36,India
77262,10/1/2023,IND,Perlis,30,26,4,India
77263,10/1/2023,IND,Pulau Pinang,920,675,245,India
77264,10/1/2023,IND,Sabah,96,76,20,India
77265,10/1/2023,IND,Sarawak,1091,938,153,India
77266,10/1/2023,IND,Selangor,52719,35647,17072,India
77267,10/1/2023,IND,Terengganu,0,0,0,India
77268,10/1/2023,IND,W.P. Labuan,28,27,1,India
77269,10/1/2023,IOT,Pulau Pinang,0,0,0,British Indian Ocean Territory
77270,10/1/2023,IOT,Selangor,0,0,0,British Indian Ocean Territory
77271,10/1/2023,IRL,Johor,297,187,110,Ireland
77272,10/1/2023,IRL,Kedah,58,29,29,Ireland
77273,10/1/2023,IRL,Kelantan,2,1,1,Ireland
77274,10/1/2023,IRL,Negeri Sembilan,0,0,0,Ireland
77275,10/1/2023,IRL,Pahang,0,0,0,Ireland
77276,10/1/2023,IRL,Perak,7,5,2,Ireland
77277,10/1/2023,IRL,Perlis,13,9,4,Ireland
77278,10/1/2023,IRL,Pulau Pinang,91,57,34,Ireland
77279,10/1/2023,IRL,Sabah,6,3,3,Ireland
77280,10/1/2023,IRL,Sarawak,43,22,21,Ireland
77281,10/1/2023,IRL,Selangor,1375,818,557,Ireland
77282,10/1/2023,IRL,Terengganu,0,0,0,Ireland
77283,10/1/2023,IRL,W.P. Labuan,1,0,1,Ireland
77284,10/1/2023,IRN,Johor,314,163,151,Iran
77285,10/1/2023,IRN,Kedah,12,8,4,Iran
77286,10/1/2023,IRN,Kelantan,0,0,0,Iran
77287,10/1/2023,IRN,Perak,0,0,0,Iran
77288,10/1/2023,IRN,Perlis,3,2,1,Iran
77289,10/1/2023,IRN,Pulau Pinang,6,2,4,Iran
77290,10/1/2023,IRN,Sabah,0,0,0,Iran
77291,10/1/2023,IRN,Sarawak,2,2,0,Iran
77292,10/1/2023,IRN,Selangor,1857,1000,857,Iran
77293,10/1/2023,IRN,W.P. Labuan,0,0,0,Iran
77294,10/1/2023,IRQ,Johor,22,14,8,Iraq
77295,10/1/2023,IRQ,Kedah,4,1,3,Iraq
77296,10/1/2023,IRQ,Kelantan,0,0,0,Iraq
77297,10/1/2023,IRQ,Melaka,0,0,0,Iraq
77298,10/1/2023,IRQ,Pahang,0,0,0,Iraq
77299,10/1/2023,IRQ,Perak,0,0,0,Iraq
77300,10/1/2023,IRQ,Perlis,0,0,0,Iraq
77301,10/1/2023,IRQ,Pulau Pinang,6,5,1,Iraq
77302,10/1/2023,IRQ,Sabah,1,1,0,Iraq
77303,10/1/2023,IRQ,Sarawak,4,2,2,Iraq
77304,10/1/2023,IRQ,Selangor,1482,1030,452,Iraq
77305,10/1/2023,ISL,Johor,3,2,1,Iceland
77306,10/1/2023,ISL,Kedah,0,0,0,Iceland
77307,10/1/2023,ISL,Kelantan,0,0,0,Iceland
77308,10/1/2023,ISL,Perak,2,1,1,Iceland
77309,10/1/2023,ISL,Perlis,2,0,2,Iceland
77310,10/1/2023,ISL,Pulau Pinang,1,1,0,Iceland
77311,10/1/2023,ISL,Sabah,1,0,1,Iceland
77312,10/1/2023,ISL,Sarawak,2,2,0,Iceland
77313,10/1/2023,ISL,Selangor,19,10,9,Iceland
77314,10/1/2023,ISL,W.P. Labuan,0,0,0,Iceland
77315,10/1/2023,ISR,Pulau Pinang,0,0,0,Israel
77316,10/1/2023,ITA,Johor,600,427,173,Italy
77317,10/1/2023,ITA,Kedah,87,54,33,Italy
77318,10/1/2023,ITA,Kelantan,4,3,1,Italy
77319,10/1/2023,ITA,Melaka,2,1,1,Italy
77320,10/1/2023,ITA,Negeri Sembilan,0,0,0,Italy
77321,10/1/2023,ITA,Pahang,5,3,2,Italy
77322,10/1/2023,ITA,Perak,6,4,2,Italy
77323,10/1/2023,ITA,Perlis,13,10,3,Italy
77324,10/1/2023,ITA,Pulau Pinang,129,97,32,Italy
77325,10/1/2023,ITA,Sabah,10,5,5,Italy
77326,10/1/2023,ITA,Sarawak,34,20,14,Italy
77327,10/1/2023,ITA,Selangor,2554,1749,805,Italy
77328,10/1/2023,ITA,W.P. Labuan,2,2,0,Italy
77329,10/1/2023,JAM,Johor,8,1,7,Jamaica
77330,10/1/2023,JAM,Kedah,0,0,0,Jamaica
77331,10/1/2023,JAM,Perak,0,0,0,Jamaica
77332,10/1/2023,JAM,Pulau Pinang,0,0,0,Jamaica
77333,10/1/2023,JAM,Sabah,0,0,0,Jamaica
77334,10/1/2023,JAM,Sarawak,0,0,0,Jamaica
77335,10/1/2023,JAM,Selangor,18,5,13,Jamaica
77336,10/1/2023,JAM,W.P. Labuan,0,0,0,Jamaica
77337,10/1/2023,JOR,Johor,31,19,12,Jordan
77338,10/1/2023,JOR,Kedah,5,2,3,Jordan
77339,10/1/2023,JOR,Kelantan,0,0,0,Jordan
77340,10/1/2023,JOR,Melaka,0,0,0,Jordan
77341,10/1/2023,JOR,Perlis,4,2,2,Jordan
77342,10/1/2023,JOR,Pulau Pinang,1,0,1,Jordan
77343,10/1/2023,JOR,Sabah,0,0,0,Jordan
77344,10/1/2023,JOR,Sarawak,1,1,0,Jordan
77345,10/1/2023,JOR,Selangor,896,548,348,Jordan
77346,10/1/2023,JOR,W.P. Labuan,0,0,0,Jordan
77347,10/1/2023,JPN,Johor,7275,4752,2523,Japan
77348,10/1/2023,JPN,Kedah,204,116,88,Japan
77349,10/1/2023,JPN,Kelantan,6,4,2,Japan
77350,10/1/2023,JPN,Melaka,3,2,1,Japan
77351,10/1/2023,JPN,Negeri Sembilan,0,0,0,Japan
77352,10/1/2023,JPN,Pahang,10,7,3,Japan
77353,10/1/2023,JPN,Perak,36,25,11,Japan
77354,10/1/2023,JPN,Perlis,52,42,10,Japan
77355,10/1/2023,JPN,Pulau Pinang,1246,911,335,Japan
77356,10/1/2023,JPN,Sabah,66,36,30,Japan
77357,10/1/2023,JPN,Sarawak,204,129,75,Japan
77358,10/1/2023,JPN,Selangor,19869,12610,7259,Japan
77359,10/1/2023,JPN,W.P. Labuan,13,9,4,Japan
77360,10/1/2023,KAZ,Johor,71,29,42,Kazakhstan
77361,10/1/2023,KAZ,Kedah,10,2,8,Kazakhstan
77362,10/1/2023,KAZ,Kelantan,5,0,5,Kazakhstan
77363,10/1/2023,KAZ,Melaka,0,0,0,Kazakhstan
77364,10/1/2023,KAZ,Perak,0,0,0,Kazakhstan
77365,10/1/2023,KAZ,Perlis,6,2,4,Kazakhstan
77366,10/1/2023,KAZ,Pulau Pinang,3,1,2,Kazakhstan
77367,10/1/2023,KAZ,Sabah,3,2,1,Kazakhstan
77368,10/1/2023,KAZ,Sarawak,5,3,2,Kazakhstan
77369,10/1/2023,KAZ,Selangor,780,321,459,Kazakhstan
77370,10/1/2023,KAZ,W.P. Labuan,0,0,0,Kazakhstan
77371,10/1/2023,KEN,Johor,52,22,30,Kenya
77372,10/1/2023,KEN,Kedah,3,1,2,Kenya
77373,10/1/2023,KEN,Kelantan,0,0,0,Kenya
77374,10/1/2023,KEN,Perak,0,0,0,Kenya
77375,10/1/2023,KEN,Perlis,1,0,1,Kenya
77376,10/1/2023,KEN,Pulau Pinang,1,0,1,Kenya
77377,10/1/2023,KEN,Sabah,2,2,0,Kenya
77378,10/1/2023,KEN,Sarawak,1,0,1,Kenya
77379,10/1/2023,KEN,Selangor,530,271,259,Kenya
77380,10/1/2023,KGZ,Johor,46,31,15,Kyrgyzstan
77381,10/1/2023,KGZ,Kedah,2,1,1,Kyrgyzstan
77382,10/1/2023,KGZ,Kelantan,0,0,0,Kyrgyzstan
77383,10/1/2023,KGZ,Perak,0,0,0,Kyrgyzstan
77384,10/1/2023,KGZ,Perlis,0,0,0,Kyrgyzstan
77385,10/1/2023,KGZ,Pulau Pinang,2,1,1,Kyrgyzstan
77386,10/1/2023,KGZ,Sabah,0,0,0,Kyrgyzstan
77387,10/1/2023,KGZ,Sarawak,0,0,0,Kyrgyzstan
77388,10/1/2023,KGZ,Selangor,237,116,121,Kyrgyzstan
77389,10/1/2023,KHM,Johor,2180,960,1220,Cambodia
77390,10/1/2023,KHM,Kedah,123,53,70,Cambodia
77391,10/1/2023,KHM,Kelantan,434,228,206,Cambodia
77392,10/1/2023,KHM,Melaka,0,0,0,Cambodia
77393,10/1/2023,KHM,Negeri Sembilan,0,0,0,Cambodia
77394,10/1/2023,KHM,Pahang,0,0,0,Cambodia
77395,10/1/2023,KHM,Perak,3,2,1,Cambodia
77396,10/1/2023,KHM,Perlis,672,386,286,Cambodia
77397,10/1/2023,KHM,Pulau Pinang,44,20,24,Cambodia
77398,10/1/2023,KHM,Sabah,2,0,2,Cambodia
77399,10/1/2023,KHM,Sarawak,18,11,7,Cambodia
77400,10/1/2023,KHM,Selangor,4039,1962,2077,Cambodia
77401,10/1/2023,KHM,W.P. Labuan,0,0,0,Cambodia
77402,10/1/2023,KIR,Johor,0,0,0,Kiribati
77403,10/1/2023,KIR,Sabah,0,0,0,Kiribati
77404,10/1/2023,KIR,Selangor,0,0,0,Kiribati
77405,10/1/2023,KNA,Johor,21,14,7,Saint Kitts and Nevis
77406,10/1/2023,KNA,Kedah,2,1,1,Saint Kitts and Nevis
77407,10/1/2023,KNA,Perlis,0,0,0,Saint Kitts and Nevis
77408,10/1/2023,KNA,Pulau Pinang,2,2,0,Saint Kitts and Nevis
77409,10/1/2023,KNA,Sabah,0,0,0,Saint Kitts and Nevis
77410,10/1/2023,KNA,Selangor,70,52,18,Saint Kitts and Nevis
77411,10/1/2023,KNA,W.P. Labuan,0,0,0,Saint Kitts and Nevis
77412,10/1/2023,KOR,Johor,10225,5654,4571,"Korea, Republic of (South Korea)"
77413,10/1/2023,KOR,Kedah,198,99,99,"Korea, Republic of (South Korea)"
77414,10/1/2023,KOR,Kelantan,2,0,2,"Korea, Republic of (South Korea)"
77415,10/1/2023,KOR,Melaka,4,2,2,"Korea, Republic of (South Korea)"
77416,10/1/2023,KOR,Negeri Sembilan,0,0,0,"Korea, Republic of (South Korea)"
77417,10/1/2023,KOR,Pahang,3,0,3,"Korea, Republic of (South Korea)"
77418,10/1/2023,KOR,Perak,20,14,6,"Korea, Republic of (South Korea)"
77419,10/1/2023,KOR,Perlis,61,36,25,"Korea, Republic of (South Korea)"
77420,10/1/2023,KOR,Pulau Pinang,572,323,249,"Korea, Republic of (South Korea)"
77421,10/1/2023,KOR,Sabah,372,190,182,"Korea, Republic of (South Korea)"
77422,10/1/2023,KOR,Sarawak,258,159,99,"Korea, Republic of (South Korea)"
77423,10/1/2023,KOR,Selangor,13234,7452,5782,"Korea, Republic of (South Korea)"
77424,10/1/2023,KOR,Terengganu,0,0,0,"Korea, Republic of (South Korea)"
77425,10/1/2023,KOR,W.P. Labuan,3,3,0,"Korea, Republic of (South Korea)"
77426,10/1/2023,KWT,Johor,11,5,6,Kuwait
77427,10/1/2023,KWT,Kedah,2,2,0,Kuwait
77428,10/1/2023,KWT,Kelantan,0,0,0,Kuwait
77429,10/1/2023,KWT,Perak,0,0,0,Kuwait
77430,10/1/2023,KWT,Perlis,0,0,0,Kuwait
77431,10/1/2023,KWT,Pulau Pinang,2,1,1,Kuwait
77432,10/1/2023,KWT,Sabah,0,0,0,Kuwait
77433,10/1/2023,KWT,Sarawak,0,0,0,Kuwait
77434,10/1/2023,KWT,Selangor,410,267,143,Kuwait
77435,10/1/2023,KWT,W.P. Labuan,0,0,0,Kuwait
77436,10/1/2023,LAO,Johor,232,64,168,Lao People's Democratic Republic
77437,10/1/2023,LAO,Kedah,906,61,845,Lao People's Democratic Republic
77438,10/1/2023,LAO,Kelantan,160,12,148,Lao People's Democratic Republic
77439,10/1/2023,LAO,Melaka,0,0,0,Lao People's Democratic Republic
77440,10/1/2023,LAO,Perak,33,3,30,Lao People's Democratic Republic
77441,10/1/2023,LAO,Perlis,414,69,345,Lao People's Democratic Republic
77442,10/1/2023,LAO,Pulau Pinang,22,11,11,Lao People's Democratic Republic
77443,10/1/2023,LAO,Sabah,2,0,2,Lao People's Democratic Republic
77444,10/1/2023,LAO,Sarawak,14,9,5,Lao People's Democratic Republic
77445,10/1/2023,LAO,Selangor,358,159,199,Lao People's Democratic Republic
77446,10/1/2023,LAO,W.P. Labuan,0,0,0,Lao People's Democratic Republic
77447,10/1/2023,LBN,Johor,26,12,14,Lebanon
77448,10/1/2023,LBN,Kedah,0,0,0,Lebanon
77449,10/1/2023,LBN,Kelantan,0,0,0,Lebanon
77450,10/1/2023,LBN,Pahang,0,0,0,Lebanon
77451,10/1/2023,LBN,Perak,1,1,0,Lebanon
77452,10/1/2023,LBN,Perlis,0,0,0,Lebanon
77453,10/1/2023,LBN,Pulau Pinang,0,0,0,Lebanon
77454,10/1/2023,LBN,Sabah,0,0,0,Lebanon
77455,10/1/2023,LBN,Sarawak,2,2,0,Lebanon
77456,10/1/2023,LBN,Selangor,284,195,89,Lebanon
77457,10/1/2023,LBN,W.P. Labuan,0,0,0,Lebanon
77458,10/1/2023,LBR,Johor,3,2,1,Liberia
77459,10/1/2023,LBR,Kedah,0,0,0,Liberia
77460,10/1/2023,LBR,Sabah,0,0,0,Liberia
77461,10/1/2023,LBR,Sarawak,0,0,0,Liberia
77462,10/1/2023,LBR,Selangor,9,7,2,Liberia
77463,10/1/2023,LBY,Johor,7,5,2,Libyan Arab Jamahiriya
77464,10/1/2023,LBY,Kedah,0,0,0,Libyan Arab Jamahiriya
77465,10/1/2023,LBY,Perlis,0,0,0,Libyan Arab Jamahiriya
77466,10/1/2023,LBY,Pulau Pinang,0,0,0,Libyan Arab Jamahiriya
77467,10/1/2023,LBY,Sabah,0,0,0,Libyan Arab Jamahiriya
77468,10/1/2023,LBY,Sarawak,3,3,0,Libyan Arab Jamahiriya
77469,10/1/2023,LBY,Selangor,437,313,124,Libyan Arab Jamahiriya
77470,10/1/2023,LCA,Johor,6,6,0,Saint Lucia
77471,10/1/2023,LCA,Kedah,0,0,0,Saint Lucia
77472,10/1/2023,LCA,Pulau Pinang,1,1,0,Saint Lucia
77473,10/1/2023,LCA,Sarawak,2,1,1,Saint Lucia
77474,10/1/2023,LCA,Selangor,7,6,1,Saint Lucia
77475,10/1/2023,LIE,Johor,5,2,3,Liechtenstein
77476,10/1/2023,LIE,Kedah,1,0,1,Liechtenstein
77477,10/1/2023,LIE,Perlis,0,0,0,Liechtenstein
77478,10/1/2023,LIE,Pulau Pinang,2,2,0,Liechtenstein
77479,10/1/2023,LIE,Sabah,0,0,0,Liechtenstein
77480,10/1/2023,LIE,Sarawak,0,0,0,Liechtenstein
77481,10/1/2023,LIE,Selangor,9,1,8,Liechtenstein
77482,10/1/2023,LKA,Johor,1196,770,426,Sri Lanka
77483,10/1/2023,LKA,Kedah,55,35,20,Sri Lanka
77484,10/1/2023,LKA,Kelantan,0,0,0,Sri Lanka
77485,10/1/2023,LKA,Melaka,1,1,0,Sri Lanka
77486,10/1/2023,LKA,Pahang,0,0,0,Sri Lanka
77487,10/1/2023,LKA,Perak,8,6,2,Sri Lanka
77488,10/1/2023,LKA,Perlis,1,1,0,Sri Lanka
77489,10/1/2023,LKA,Pulau Pinang,42,27,15,Sri Lanka
77490,10/1/2023,LKA,Sabah,3,2,1,Sri Lanka
77491,10/1/2023,LKA,Sarawak,49,31,18,Sri Lanka
77492,10/1/2023,LKA,Selangor,4199,2712,1487,Sri Lanka
77493,10/1/2023,LKA,W.P. Labuan,0,0,0,Sri Lanka
77494,10/1/2023,LSO,Johor,1,0,1,Lesotho
77495,10/1/2023,LSO,Kedah,1,0,1,Lesotho
77496,10/1/2023,LSO,Pulau Pinang,0,0,0,Lesotho
77497,10/1/2023,LSO,Sarawak,0,0,0,Lesotho
77498,10/1/2023,LSO,Selangor,9,4,5,Lesotho
77499,10/1/2023,LTU,Johor,89,42,47,Lithuania
77500,10/1/2023,LTU,Kedah,25,14,11,Lithuania
77501,10/1/2023,LTU,Kelantan,0,0,0,Lithuania
77502,10/1/2023,LTU,Pahang,0,0,0,Lithuania
77503,10/1/2023,LTU,Perak,0,0,0,Lithuania
77504,10/1/2023,LTU,Perlis,1,1,0,Lithuania
77505,10/1/2023,LTU,Pulau Pinang,4,0,4,Lithuania
77506,10/1/2023,LTU,Sabah,6,1,5,Lithuania
77507,10/1/2023,LTU,Sarawak,4,3,1,Lithuania
77508,10/1/2023,LTU,Selangor,332,180,152,Lithuania
77509,10/1/2023,LTU,W.P. Labuan,14,5,9,Lithuania
77510,10/1/2023,LUX,Johor,9,7,2,Luxembourg
77511,10/1/2023,LUX,Kedah,7,4,3,Luxembourg
77512,10/1/2023,LUX,Kelantan,0,0,0,Luxembourg
77513,10/1/2023,LUX,Perak,0,0,0,Luxembourg
77514,10/1/2023,LUX,Perlis,0,0,0,Luxembourg
77515,10/1/2023,LUX,Pulau Pinang,3,3,0,Luxembourg
77516,10/1/2023,LUX,Sabah,0,0,0,Luxembourg
77517,10/1/2023,LUX,Sarawak,0,0,0,Luxembourg
77518,10/1/2023,LUX,Selangor,57,36,21,Luxembourg
77519,10/1/2023,LVA,Johor,32,13,19,Latvia
77520,10/1/2023,LVA,Kedah,7,2,5,Latvia
77521,10/1/2023,LVA,Kelantan,0,0,0,Latvia
77522,10/1/2023,LVA,Pahang,0,0,0,Latvia
77523,10/1/2023,LVA,Perak,0,0,0,Latvia
77524,10/1/2023,LVA,Perlis,0,0,0,Latvia
77525,10/1/2023,LVA,Pulau Pinang,1,0,1,Latvia
77526,10/1/2023,LVA,Sabah,2,0,2,Latvia
77527,10/1/2023,LVA,Sarawak,1,0,1,Latvia
77528,10/1/2023,LVA,Selangor,169,88,81,Latvia
77529,10/1/2023,LVA,W.P. Labuan,6,2,4,Latvia
77530,10/1/2023,MAC,Johor,0,0,0,Macao
77531,10/1/2023,MAC,Pahang,0,0,0,Macao
77532,10/1/2023,MAC,Perak,1,1,0,Macao
77533,10/1/2023,MAC,Selangor,0,0,0,Macao
77534,10/1/2023,MAC,W.P. Labuan,0,0,0,Macao
77535,10/1/2023,MAR,Johor,78,45,33,Morocco
77536,10/1/2023,MAR,Kedah,8,5,3,Morocco
77537,10/1/2023,MAR,Kelantan,2,2,0,Morocco
77538,10/1/2023,MAR,Melaka,0,0,0,Morocco
77539,10/1/2023,MAR,Pahang,0,0,0,Morocco
77540,10/1/2023,MAR,Perak,0,0,0,Morocco
77541,10/1/2023,MAR,Perlis,5,4,1,Morocco
77542,10/1/2023,MAR,Pulau Pinang,13,9,4,Morocco
77543,10/1/2023,MAR,Sabah,0,0,0,Morocco
77544,10/1/2023,MAR,Sarawak,2,2,0,Morocco
77545,10/1/2023,MAR,Selangor,1357,693,664,Morocco
77546,10/1/2023,MAR,W.P. Labuan,0,0,0,Morocco
77547,10/1/2023,MCO,Johor,0,0,0,Monaco
77548,10/1/2023,MCO,Kedah,0,0,0,Monaco
77549,10/1/2023,MCO,Sabah,0,0,0,Monaco
77550,10/1/2023,MCO,Selangor,1,1,0,Monaco
77551,10/1/2023,MDA,Johor,1,1,0,"Moldova, Republic of"
77552,10/1/2023,MDA,Kedah,1,0,1,"Moldova, Republic of"
77553,10/1/2023,MDA,Kelantan,0,0,0,"Moldova, Republic of"
77554,10/1/2023,MDA,Negeri Sembilan,1,1,0,"Moldova, Republic of"
77555,10/1/2023,MDA,Perlis,0,0,0,"Moldova, Republic of"
77556,10/1/2023,MDA,Pulau Pinang,0,0,0,"Moldova, Republic of"
77557,10/1/2023,MDA,Sabah,0,0,0,"Moldova, Republic of"
77558,10/1/2023,MDA,Sarawak,0,0,0,"Moldova, Republic of"
77559,10/1/2023,MDA,Selangor,42,23,19,"Moldova, Republic of"
77560,10/1/2023,MDG,Johor,7,4,3,Madagascar
77561,10/1/2023,MDG,Kedah,1,0,1,Madagascar
77562,10/1/2023,MDG,Perak,0,0,0,Madagascar
77563,10/1/2023,MDG,Perlis,0,0,0,Madagascar
77564,10/1/2023,MDG,Pulau Pinang,2,2,0,Madagascar
77565,10/1/2023,MDG,Sabah,0,0,0,Madagascar
77566,10/1/2023,MDG,Sarawak,0,0,0,Madagascar
77567,10/1/2023,MDG,Selangor,87,42,45,Madagascar
77568,10/1/2023,MDV,Johor,158,65,93,Maldives
77569,10/1/2023,MDV,Kedah,2,1,1,Maldives
77570,10/1/2023,MDV,Kelantan,0,0,0,Maldives
77571,10/1/2023,MDV,Perak,0,0,0,Maldives
77572,10/1/2023,MDV,Perlis,0,0,0,Maldives
77573,10/1/2023,MDV,Pulau Pinang,1,1,0,Maldives
77574,10/1/2023,MDV,Sabah,0,0,0,Maldives
77575,10/1/2023,MDV,Sarawak,0,0,0,Maldives
77576,10/1/2023,MDV,Selangor,2499,1371,1128,Maldives
77577,10/1/2023,MEX,Johor,227,104,123,Mexico
77578,10/1/2023,MEX,Kedah,9,4,5,Mexico
77579,10/1/2023,MEX,Kelantan,0,0,0,Mexico
77580,10/1/2023,MEX,Pahang,0,0,0,Mexico
77581,10/1/2023,MEX,Perak,0,0,0,Mexico
77582,10/1/2023,MEX,Perlis,2,1,1,Mexico
77583,10/1/2023,MEX,Pulau Pinang,32,28,4,Mexico
77584,10/1/2023,MEX,Sabah,1,1,0,Mexico
77585,10/1/2023,MEX,Sarawak,6,3,3,Mexico
77586,10/1/2023,MEX,Selangor,882,455,427,Mexico
77587,10/1/2023,MEX,W.P. Labuan,0,0,0,Mexico
77588,10/1/2023,MHL,Johor,2,1,1,Marshall Islands
77589,10/1/2023,MHL,Kedah,0,0,0,Marshall Islands
77590,10/1/2023,MHL,Perak,2,1,1,Marshall Islands
77591,10/1/2023,MHL,Pulau Pinang,0,0,0,Marshall Islands
77592,10/1/2023,MHL,Sabah,0,0,0,Marshall Islands
77593,10/1/2023,MHL,Selangor,0,0,0,Marshall Islands
77594,10/1/2023,MKD,Johor,4,2,2,"Macedonia, the former Yugoslav Republic of"
77595,10/1/2023,MKD,Kedah,0,0,0,"Macedonia, the former Yugoslav Republic of"
77596,10/1/2023,MKD,Perak,0,0,0,"Macedonia, the former Yugoslav Republic of"
77597,10/1/2023,MKD,Pulau Pinang,2,1,1,"Macedonia, the former Yugoslav Republic of"
77598,10/1/2023,MKD,Sabah,0,0,0,"Macedonia, the former Yugoslav Republic of"
77599,10/1/2023,MKD,Sarawak,1,0,1,"Macedonia, the former Yugoslav Republic of"
77600,10/1/2023,MKD,Selangor,57,27,30,"Macedonia, the former Yugoslav Republic of"
77601,10/1/2023,MLI,Johor,3,3,0,Mali
77602,10/1/2023,MLI,Sabah,0,0,0,Mali
77603,10/1/2023,MLI,Selangor,11,5,6,Mali
77604,10/1/2023,MLT,Johor,7,6,1,Malta
77605,10/1/2023,MLT,Kedah,0,0,0,Malta
77606,10/1/2023,MLT,Kelantan,0,0,0,Malta
77607,10/1/2023,MLT,Perak,0,0,0,Malta
77608,10/1/2023,MLT,Perlis,0,0,0,Malta
77609,10/1/2023,MLT,Pulau Pinang,3,2,1,Malta
77610,10/1/2023,MLT,Sabah,0,0,0,Malta
77611,10/1/2023,MLT,Sarawak,0,0,0,Malta
77612,10/1/2023,MLT,Selangor,27,20,7,Malta
77613,10/1/2023,MLT,W.P. Labuan,0,0,0,Malta
77614,10/1/2023,MMR,Johor,6179,1980,4199,Myanmar
77615,10/1/2023,MMR,Kedah,77,21,56,Myanmar
77616,10/1/2023,MMR,Kelantan,0,0,0,Myanmar
77617,10/1/2023,MMR,Negeri Sembilan,0,0,0,Myanmar
77618,10/1/2023,MMR,Pahang,3,1,2,Myanmar
77619,10/1/2023,MMR,Perak,21,6,15,Myanmar
77620,10/1/2023,MMR,Perlis,1,0,1,Myanmar
77621,10/1/2023,MMR,Pulau Pinang,293,157,136,Myanmar
77622,10/1/2023,MMR,Sabah,7,1,6,Myanmar
77623,10/1/2023,MMR,Sarawak,92,45,47,Myanmar
77624,10/1/2023,MMR,Selangor,6339,4111,2228,Myanmar
77625,10/1/2023,MMR,Terengganu,0,0,0,Myanmar
77626,10/1/2023,MMR,W.P. Labuan,0,0,0,Myanmar
77627,10/1/2023,MNE,Johor,3,3,0,Montenegro
77628,10/1/2023,MNE,Kedah,0,0,0,Montenegro
77629,10/1/2023,MNE,Pulau Pinang,0,0,0,Montenegro
77630,10/1/2023,MNE,Sabah,0,0,0,Montenegro
77631,10/1/2023,MNE,Sarawak,1,1,0,Montenegro
77632,10/1/2023,MNE,Selangor,11,11,0,Montenegro
77633,10/1/2023,MNG,Johor,106,26,80,Mongolia
77634,10/1/2023,MNG,Kedah,9,3,6,Mongolia
77635,10/1/2023,MNG,Kelantan,2,2,0,Mongolia
77636,10/1/2023,MNG,Perak,0,0,0,Mongolia
77637,10/1/2023,MNG,Perlis,1,0,1,Mongolia
77638,10/1/2023,MNG,Pulau Pinang,20,8,12,Mongolia
77639,10/1/2023,MNG,Sabah,0,0,0,Mongolia
77640,10/1/2023,MNG,Sarawak,0,0,0,Mongolia
77641,10/1/2023,MNG,Selangor,358,130,228,Mongolia
77642,10/1/2023,MNP,Selangor,0,0,0,Northern Mariana Islands
77643,10/1/2023,MOZ,Johor,0,0,0,Mozambique
77644,10/1/2023,MOZ,Kedah,0,0,0,Mozambique
77645,10/1/2023,MOZ,Perak,0,0,0,Mozambique
77646,10/1/2023,MOZ,Pulau Pinang,0,0,0,Mozambique
77647,10/1/2023,MOZ,Sabah,0,0,0,Mozambique
77648,10/1/2023,MOZ,Sarawak,0,0,0,Mozambique
77649,10/1/2023,MOZ,Selangor,14,10,4,Mozambique
77650,10/1/2023,MRT,Johor,3,1,2,Mauritania
77651,10/1/2023,MRT,Kedah,0,0,0,Mauritania
77652,10/1/2023,MRT,Pulau Pinang,1,1,0,Mauritania
77653,10/1/2023,MRT,Sabah,0,0,0,Mauritania
77654,10/1/2023,MRT,Sarawak,0,0,0,Mauritania
77655,10/1/2023,MRT,Selangor,23,21,2,Mauritania
77656,10/1/2023,MUS,Johor,101,58,43,Mauritius
77657,10/1/2023,MUS,Kedah,0,0,0,Mauritius
77658,10/1/2023,MUS,Kelantan,0,0,0,Mauritius
77659,10/1/2023,MUS,Pahang,0,0,0,Mauritius
77660,10/1/2023,MUS,Perak,2,2,0,Mauritius
77661,10/1/2023,MUS,Perlis,2,1,1,Mauritius
77662,10/1/2023,MUS,Pulau Pinang,3,1,2,Mauritius
77663,10/1/2023,MUS,Sabah,1,1,0,Mauritius
77664,10/1/2023,MUS,Sarawak,0,0,0,Mauritius
77665,10/1/2023,MUS,Selangor,1766,928,838,Mauritius
77666,10/1/2023,MWI,Johor,2,0,2,Malawi
77667,10/1/2023,MWI,Pulau Pinang,0,0,0,Malawi
77668,10/1/2023,MWI,Sabah,0,0,0,Malawi
77669,10/1/2023,MWI,Sarawak,0,0,0,Malawi
77670,10/1/2023,MWI,Selangor,20,13,7,Malawi
77671,10/1/2023,MYT,Selangor,0,0,0,Mayotte
77672,10/1/2023,NAM,Johor,1,1,0,Namibia
77673,10/1/2023,NAM,Kedah,0,0,0,Namibia
77674,10/1/2023,NAM,Perak,0,0,0,Namibia
77675,10/1/2023,NAM,Perlis,1,1,0,Namibia
77676,10/1/2023,NAM,Pulau Pinang,0,0,0,Namibia
77677,10/1/2023,NAM,Sabah,0,0,0,Namibia
77678,10/1/2023,NAM,Sarawak,1,1,0,Namibia
77679,10/1/2023,NAM,Selangor,32,20,12,Namibia
77680,10/1/2023,NCL,Selangor,0,0,0,New Caledonia
77681,10/1/2023,NER,Johor,0,0,0,Niger
77682,10/1/2023,NER,Sabah,0,0,0,Niger
77683,10/1/2023,NER,Selangor,3,2,1,Niger
77684,10/1/2023,NGA,Johor,32,27,5,Nigeria
77685,10/1/2023,NGA,Kedah,1,1,0,Nigeria
77686,10/1/2023,NGA,Perlis,1,1,0,Nigeria
77687,10/1/2023,NGA,Pulau Pinang,0,0,0,Nigeria
77688,10/1/2023,NGA,Sabah,0,0,0,Nigeria
77689,10/1/2023,NGA,Sarawak,9,8,1,Nigeria
77690,10/1/2023,NGA,Selangor,457,333,124,Nigeria
77691,10/1/2023,NIC,Johor,0,0,0,Nicaragua
77692,10/1/2023,NIC,Kedah,0,0,0,Nicaragua
77693,10/1/2023,NIC,Pulau Pinang,0,0,0,Nicaragua
77694,10/1/2023,NIC,Sabah,0,0,0,Nicaragua
77695,10/1/2023,NIC,Selangor,2,2,0,Nicaragua
77696,10/1/2023,NLD,Johor,1115,704,411,Netherlands
77697,10/1/2023,NLD,Kedah,156,87,69,Netherlands
77698,10/1/2023,NLD,Kelantan,7,3,4,Netherlands
77699,10/1/2023,NLD,Melaka,1,1,0,Netherlands
77700,10/1/2023,NLD,Negeri Sembilan,0,0,0,Netherlands
77701,10/1/2023,NLD,Pahang,2,1,1,Netherlands
77702,10/1/2023,NLD,Perak,6,4,2,Netherlands
77703,10/1/2023,NLD,Perlis,36,22,14,Netherlands
77704,10/1/2023,NLD,Pulau Pinang,252,173,79,Netherlands
77705,10/1/2023,NLD,Sabah,21,9,12,Netherlands
77706,10/1/2023,NLD,Sarawak,144,71,73,Netherlands
77707,10/1/2023,NLD,Selangor,4256,2507,1749,Netherlands
77708,10/1/2023,NLD,Terengganu,0,0,0,Netherlands
77709,10/1/2023,NLD,W.P. Labuan,1,1,0,Netherlands
77710,10/1/2023,NOR,Johor,193,117,76,Norway
77711,10/1/2023,NOR,Kedah,21,12,9,Norway
77712,10/1/2023,NOR,Kelantan,0,0,0,Norway
77713,10/1/2023,NOR,Melaka,0,0,0,Norway
77714,10/1/2023,NOR,Pahang,0,0,0,Norway
77715,10/1/2023,NOR,Perak,1,1,0,Norway
77716,10/1/2023,NOR,Perlis,3,3,0,Norway
77717,10/1/2023,NOR,Pulau Pinang,43,23,20,Norway
77718,10/1/2023,NOR,Sabah,0,0,0,Norway
77719,10/1/2023,NOR,Sarawak,12,10,2,Norway
77720,10/1/2023,NOR,Selangor,673,440,233,Norway
77721,10/1/2023,NOR,W.P. Labuan,0,0,0,Norway
77722,10/1/2023,NPL,Johor,944,587,357,Nepal
77723,10/1/2023,NPL,Kedah,19,12,7,Nepal
77724,10/1/2023,NPL,Pahang,1,1,0,Nepal
77725,10/1/2023,NPL,Perak,0,0,0,Nepal
77726,10/1/2023,NPL,Perlis,1,1,0,Nepal
77727,10/1/2023,NPL,Pulau Pinang,11,7,4,Nepal
77728,10/1/2023,NPL,Sabah,2,2,0,Nepal
77729,10/1/2023,NPL,Sarawak,130,91,39,Nepal
77730,10/1/2023,NPL,Selangor,7181,6586,595,Nepal
77731,10/1/2023,NPL,W.P. Labuan,18,17,1,Nepal
77732,10/1/2023,NRU,Johor,0,0,0,Nauru
77733,10/1/2023,NRU,Pulau Pinang,0,0,0,Nauru
77734,10/1/2023,NRU,Selangor,0,0,0,Nauru
77735,10/1/2023,NZL,Johor,956,590,366,New Zealand
77736,10/1/2023,NZL,Kedah,97,44,53,New Zealand
77737,10/1/2023,NZL,Kelantan,1,1,0,New Zealand
77738,10/1/2023,NZL,Melaka,0,0,0,New Zealand
77739,10/1/2023,NZL,Negeri Sembilan,2,2,0,New Zealand
77740,10/1/2023,NZL,Pahang,23,13,10,New Zealand
77741,10/1/2023,NZL,Perak,35,18,17,New Zealand
77742,10/1/2023,NZL,Perlis,20,13,7,New Zealand
77743,10/1/2023,NZL,Pulau Pinang,225,128,97,New Zealand
77744,10/1/2023,NZL,Sabah,7,3,4,New Zealand
77745,10/1/2023,NZL,Sarawak,131,80,51,New Zealand
77746,10/1/2023,NZL,Selangor,3365,1970,1395,New Zealand
77747,10/1/2023,NZL,Terengganu,0,0,0,New Zealand
77748,10/1/2023,NZL,W.P. Labuan,5,3,2,New Zealand
77749,10/1/2023,OMN,Johor,29,19,10,Oman
77750,10/1/2023,OMN,Kedah,4,3,1,Oman
77751,10/1/2023,OMN,Kelantan,0,0,0,Oman
77752,10/1/2023,OMN,Melaka,0,0,0,Oman
77753,10/1/2023,OMN,Perak,1,1,0,Oman
77754,10/1/2023,OMN,Perlis,5,5,0,Oman
77755,10/1/2023,OMN,Pulau Pinang,5,5,0,Oman
77756,10/1/2023,OMN,Sabah,0,0,0,Oman
77757,10/1/2023,OMN,Sarawak,2,2,0,Oman
77758,10/1/2023,OMN,Selangor,1135,744,391,Oman
77759,10/1/2023,PAK,Johor,1109,810,299,Pakistan
77760,10/1/2023,PAK,Kedah,78,54,24,Pakistan
77761,10/1/2023,PAK,Kelantan,17,17,0,Pakistan
77762,10/1/2023,PAK,Melaka,0,0,0,Pakistan
77763,10/1/2023,PAK,Negeri Sembilan,0,0,0,Pakistan
77764,10/1/2023,PAK,Pahang,2,2,0,Pakistan
77765,10/1/2023,PAK,Perak,13,13,0,Pakistan
77766,10/1/2023,PAK,Perlis,14,13,1,Pakistan
77767,10/1/2023,PAK,Pulau Pinang,76,67,9,Pakistan
77768,10/1/2023,PAK,Sabah,6,6,0,Pakistan
77769,10/1/2023,PAK,Sarawak,124,105,19,Pakistan
77770,10/1/2023,PAK,Selangor,10590,9067,1523,Pakistan
77771,10/1/2023,PAK,W.P. Labuan,0,0,0,Pakistan
77772,10/1/2023,PAN,Johor,5,2,3,Panama
77773,10/1/2023,PAN,Kedah,1,0,1,Panama
77774,10/1/2023,PAN,Perak,0,0,0,Panama
77775,10/1/2023,PAN,Perlis,0,0,0,Panama
77776,10/1/2023,PAN,Pulau Pinang,0,0,0,Panama
77777,10/1/2023,PAN,Sabah,1,1,0,Panama
77778,10/1/2023,PAN,Sarawak,0,0,0,Panama
77779,10/1/2023,PAN,Selangor,41,23,18,Panama
77780,10/1/2023,PER,Johor,43,23,20,Peru
77781,10/1/2023,PER,Kedah,3,1,2,Peru
77782,10/1/2023,PER,Kelantan,0,0,0,Peru
77783,10/1/2023,PER,Pahang,0,0,0,Peru
77784,10/1/2023,PER,Perak,2,1,1,Peru
77785,10/1/2023,PER,Perlis,0,0,0,Peru
77786,10/1/2023,PER,Pulau Pinang,5,1,4,Peru
77787,10/1/2023,PER,Sabah,1,0,1,Peru
77788,10/1/2023,PER,Sarawak,0,0,0,Peru
77789,10/1/2023,PER,Selangor,396,171,225,Peru
77790,10/1/2023,PER,W.P. Labuan,0,0,0,Peru
77791,10/1/2023,PHL,Johor,22838,6909,15929,Philippines
77792,10/1/2023,PHL,Kedah,458,132,326,Philippines
77793,10/1/2023,PHL,Kelantan,39,19,20,Philippines
77794,10/1/2023,PHL,Melaka,0,0,0,Philippines
77795,10/1/2023,PHL,Negeri Sembilan,0,0,0,Philippines
77796,10/1/2023,PHL,Pahang,28,20,8,Philippines
77797,10/1/2023,PHL,Perak,55,13,42,Philippines
77798,10/1/2023,PHL,Perlis,281,91,190,Philippines
77799,10/1/2023,PHL,Pulau Pinang,721,304,417,Philippines
77800,10/1/2023,PHL,Sabah,576,304,272,Philippines
77801,10/1/2023,PHL,Sarawak,1928,793,1135,Philippines
77802,10/1/2023,PHL,Selangor,16866,7263,9603,Philippines
77803,10/1/2023,PHL,Terengganu,2,2,0,Philippines
77804,10/1/2023,PHL,W.P. Labuan,115,33,82,Philippines
77805,10/1/2023,PLW,Johor,0,0,0,Palau
77806,10/1/2023,PLW,Pulau Pinang,0,0,0,Palau
77807,10/1/2023,PLW,Selangor,1,1,0,Palau
77808,10/1/2023,PNG,Johor,12,5,7,Papua New Guinea
77809,10/1/2023,PNG,Kedah,0,0,0,Papua New Guinea
77810,10/1/2023,PNG,Kelantan,0,0,0,Papua New Guinea
77811,10/1/2023,PNG,Perak,0,0,0,Papua New Guinea
77812,10/1/2023,PNG,Pulau Pinang,3,1,2,Papua New Guinea
77813,10/1/2023,PNG,Sabah,0,0,0,Papua New Guinea
77814,10/1/2023,PNG,Sarawak,1,0,1,Papua New Guinea
77815,10/1/2023,PNG,Selangor,106,72,34,Papua New Guinea
77816,10/1/2023,POL,Johor,394,201,193,Poland
77817,10/1/2023,POL,Kedah,58,25,33,Poland
77818,10/1/2023,POL,Kelantan,1,1,0,Poland
77819,10/1/2023,POL,Melaka,0,0,0,Poland
77820,10/1/2023,POL,Negeri Sembilan,0,0,0,Poland
77821,10/1/2023,POL,Pahang,0,0,0,Poland
77822,10/1/2023,POL,Perak,7,4,3,Poland
77823,10/1/2023,POL,Perlis,4,3,1,Poland
77824,10/1/2023,POL,Pulau Pinang,58,30,28,Poland
77825,10/1/2023,POL,Sabah,4,2,2,Poland
77826,10/1/2023,POL,Sarawak,37,20,17,Poland
77827,10/1/2023,POL,Selangor,1342,695,647,Poland
77828,10/1/2023,POL,Terengganu,0,0,0,Poland
77829,10/1/2023,POL,W.P. Labuan,0,0,0,Poland
77830,10/1/2023,PRK,Selangor,0,0,0,"Korea, Democratic People's Republic of"
77831,10/1/2023,PRT,Johor,153,85,68,Portugal
77832,10/1/2023,PRT,Kedah,19,6,13,Portugal
77833,10/1/2023,PRT,Kelantan,0,0,0,Portugal
77834,10/1/2023,PRT,Melaka,0,0,0,Portugal
77835,10/1/2023,PRT,Pahang,1,1,0,Portugal
77836,10/1/2023,PRT,Perak,0,0,0,Portugal
77837,10/1/2023,PRT,Perlis,1,1,0,Portugal
77838,10/1/2023,PRT,Pulau Pinang,58,32,26,Portugal
77839,10/1/2023,PRT,Sabah,7,5,2,Portugal
77840,10/1/2023,PRT,Sarawak,6,3,3,Portugal
77841,10/1/2023,PRT,Selangor,817,484,333,Portugal
77842,10/1/2023,PRT,W.P. Labuan,0,0,0,Portugal
77843,10/1/2023,PRY,Johor,8,6,2,Paraguay
77844,10/1/2023,PRY,Kedah,0,0,0,Paraguay
77845,10/1/2023,PRY,Perak,0,0,0,Paraguay
77846,10/1/2023,PRY,Perlis,0,0,0,Paraguay
77847,10/1/2023,PRY,Pulau Pinang,0,0,0,Paraguay
77848,10/1/2023,PRY,Sabah,0,0,0,Paraguay
77849,10/1/2023,PRY,Sarawak,0,0,0,Paraguay
77850,10/1/2023,PRY,Selangor,5,1,4,Paraguay
77851,10/1/2023,PSE,Johor,21,17,4,"Palestinian Territory, Occupied"
77852,10/1/2023,PSE,Kedah,1,0,1,"Palestinian Territory, Occupied"
77853,10/1/2023,PSE,Kelantan,0,0,0,"Palestinian Territory, Occupied"
77854,10/1/2023,PSE,Melaka,0,0,0,"Palestinian Territory, Occupied"
77855,10/1/2023,PSE,Perak,1,1,0,"Palestinian Territory, Occupied"
77856,10/1/2023,PSE,Perlis,0,0,0,"Palestinian Territory, Occupied"
77857,10/1/2023,PSE,Pulau Pinang,0,0,0,"Palestinian Territory, Occupied"
77858,10/1/2023,PSE,Sabah,0,0,0,"Palestinian Territory, Occupied"
77859,10/1/2023,PSE,Sarawak,2,2,0,"Palestinian Territory, Occupied"
77860,10/1/2023,PSE,Selangor,374,248,126,"Palestinian Territory, Occupied"
77861,10/1/2023,QAT,Johor,14,8,6,Qatar
77862,10/1/2023,QAT,Kedah,0,0,0,Qatar
77863,10/1/2023,QAT,Perlis,0,0,0,Qatar
77864,10/1/2023,QAT,Pulau Pinang,0,0,0,Qatar
77865,10/1/2023,QAT,Sabah,0,0,0,Qatar
77866,10/1/2023,QAT,Sarawak,1,1,0,Qatar
77867,10/1/2023,QAT,Selangor,131,83,48,Qatar
77868,10/1/2023,REU,Johor,0,0,0,Reunion
77869,10/1/2023,REU,Sarawak,0,0,0,Reunion
77870,10/1/2023,ROU,Johor,122,72,50,Romania
77871,10/1/2023,ROU,Kedah,14,3,11,Romania
77872,10/1/2023,ROU,Kelantan,2,1,1,Romania
77873,10/1/2023,ROU,Negeri Sembilan,0,0,0,Romania
77874,10/1/2023,ROU,Pahang,1,1,0,Romania
77875,10/1/2023,ROU,Perak,0,0,0,Romania
77876,10/1/2023,ROU,Perlis,0,0,0,Romania
77877,10/1/2023,ROU,Pulau Pinang,21,11,10,Romania
77878,10/1/2023,ROU,Sabah,0,0,0,Romania
77879,10/1/2023,ROU,Sarawak,6,2,4,Romania
77880,10/1/2023,ROU,Selangor,676,357,319,Romania
77881,10/1/2023,ROU,W.P. Labuan,0,0,0,Romania
77882,10/1/2023,RUS,Johor,407,195,212,Russia
77883,10/1/2023,RUS,Kedah,266,124,142,Russia
77884,10/1/2023,RUS,Kelantan,54,27,27,Russia
77885,10/1/2023,RUS,Melaka,1,1,0,Russia
77886,10/1/2023,RUS,Negeri Sembilan,0,0,0,Russia
77887,10/1/2023,RUS,Pahang,7,4,3,Russia
77888,10/1/2023,RUS,Perak,1,0,1,Russia
77889,10/1/2023,RUS,Perlis,141,88,53,Russia
77890,10/1/2023,RUS,Pulau Pinang,180,100,80,Russia
77891,10/1/2023,RUS,Sabah,23,7,16,Russia
77892,10/1/2023,RUS,Sarawak,43,25,18,Russia
77893,10/1/2023,RUS,Selangor,7294,3721,3573,Russia
77894,10/1/2023,RUS,W.P. Labuan,10,6,4,Russia
77895,10/1/2023,RWA,Johor,0,0,0,Rwanda
77896,10/1/2023,RWA,Kedah,1,0,1,Rwanda
77897,10/1/2023,RWA,Pulau Pinang,0,0,0,Rwanda
77898,10/1/2023,RWA,Selangor,11,6,5,Rwanda
77899,10/1/2023,SAU,Johor,143,82,61,Saudi Arabia
77900,10/1/2023,SAU,Kedah,28,15,13,Saudi Arabia
77901,10/1/2023,SAU,Kelantan,6,2,4,Saudi Arabia
77902,10/1/2023,SAU,Melaka,0,0,0,Saudi Arabia
77903,10/1/2023,SAU,Perak,1,0,1,Saudi Arabia
77904,10/1/2023,SAU,Perlis,7,6,1,Saudi Arabia
77905,10/1/2023,SAU,Pulau Pinang,20,12,8,Saudi Arabia
77906,10/1/2023,SAU,Sabah,0,0,0,Saudi Arabia
77907,10/1/2023,SAU,Sarawak,11,7,4,Saudi Arabia
77908,10/1/2023,SAU,Selangor,3761,2280,1481,Saudi Arabia
77909,10/1/2023,SAU,W.P. Labuan,0,0,0,Saudi Arabia
77910,10/1/2023,SDN,Johor,6,2,4,Sudan
77911,10/1/2023,SDN,Kedah,0,0,0,Sudan
77912,10/1/2023,SDN,Kelantan,0,0,0,Sudan
77913,10/1/2023,SDN,Perlis,0,0,0,Sudan
77914,10/1/2023,SDN,Pulau Pinang,0,0,0,Sudan
77915,10/1/2023,SDN,Sabah,1,1,0,Sudan
77916,10/1/2023,SDN,Sarawak,1,1,0,Sudan
77917,10/1/2023,SDN,Selangor,1236,748,488,Sudan
77918,10/1/2023,SDN,W.P. Labuan,0,0,0,Sudan
77919,10/1/2023,SEN,Johor,2,1,1,Senegal
77920,10/1/2023,SEN,Kedah,0,0,0,Senegal
77921,10/1/2023,SEN,Kelantan,0,0,0,Senegal
77922,10/1/2023,SEN,Perak,0,0,0,Senegal
77923,10/1/2023,SEN,Perlis,1,1,0,Senegal
77924,10/1/2023,SEN,Pulau Pinang,1,1,0,Senegal
77925,10/1/2023,SEN,Sabah,0,0,0,Senegal
77926,10/1/2023,SEN,Sarawak,0,0,0,Senegal
77927,10/1/2023,SEN,Selangor,51,39,12,Senegal
77928,10/1/2023,SGP,Johor,1284587,740290,544297,Singapore
77929,10/1/2023,SGP,Kedah,4531,2459,2072,Singapore
77930,10/1/2023,SGP,Kelantan,73,43,30,Singapore
77931,10/1/2023,SGP,Melaka,13,10,3,Singapore
77932,10/1/2023,SGP,Negeri Sembilan,5,5,0,Singapore
77933,10/1/2023,SGP,Pahang,681,397,284,Singapore
77934,10/1/2023,SGP,Perak,5582,2557,3025,Singapore
77935,10/1/2023,SGP,Perlis,229,142,87,Singapore
77936,10/1/2023,SGP,Pulau Pinang,16645,8224,8421,Singapore
77937,10/1/2023,SGP,Sabah,527,280,247,Singapore
77938,10/1/2023,SGP,Sarawak,3958,2260,1698,Singapore
77939,10/1/2023,SGP,Selangor,38965,21247,17718,Singapore
77940,10/1/2023,SGP,Terengganu,0,0,0,Singapore
77941,10/1/2023,SGP,W.P. Labuan,25,19,6,Singapore
77942,10/1/2023,SGS,Johor,0,0,0,South Georgia and the South Sandwich Islands
77943,10/1/2023,SGS,Sabah,0,0,0,South Georgia and the South Sandwich Islands
77944,10/1/2023,SGS,Selangor,0,0,0,South Georgia and the South Sandwich Islands
77945,10/1/2023,SHN,Sarawak,0,0,0,"Saint Helena, Ascension and Tristan da Cunha"
77946,10/1/2023,SLB,Johor,2,1,1,Solomon Islands
77947,10/1/2023,SLB,Perlis,0,0,0,Solomon Islands
77948,10/1/2023,SLB,Pulau Pinang,0,0,0,Solomon Islands
77949,10/1/2023,SLB,Sabah,0,0,0,Solomon Islands
77950,10/1/2023,SLB,Sarawak,1,0,1,Solomon Islands
77951,10/1/2023,SLB,Selangor,5,3,2,Solomon Islands
77952,10/1/2023,SLB,W.P. Labuan,0,0,0,Solomon Islands
77953,10/1/2023,SLE,Johor,2,1,1,Sierra Leone
77954,10/1/2023,SLE,Kedah,0,0,0,Sierra Leone
77955,10/1/2023,SLE,Perak,0,0,0,Sierra Leone
77956,10/1/2023,SLE,Pulau Pinang,1,0,1,Sierra Leone
77957,10/1/2023,SLE,Sabah,1,1,0,Sierra Leone
77958,10/1/2023,SLE,Selangor,21,14,7,Sierra Leone
77959,10/1/2023,SLV,Johor,2,0,2,El Salvador
77960,10/1/2023,SLV,Kedah,0,0,0,El Salvador
77961,10/1/2023,SLV,Perak,0,0,0,El Salvador
77962,10/1/2023,SLV,Perlis,0,0,0,El Salvador
77963,10/1/2023,SLV,Pulau Pinang,2,1,1,El Salvador
77964,10/1/2023,SLV,Sabah,0,0,0,El Salvador
77965,10/1/2023,SLV,Selangor,17,9,8,El Salvador
77966,10/1/2023,SLV,W.P. Labuan,0,0,0,El Salvador
77967,10/1/2023,SMR,Johor,0,0,0,San Marino
77968,10/1/2023,SMR,Selangor,1,1,0,San Marino
77969,10/1/2023,SOM,Johor,0,0,0,Somalia
77970,10/1/2023,SOM,Kedah,0,0,0,Somalia
77971,10/1/2023,SOM,Kelantan,0,0,0,Somalia
77972,10/1/2023,SOM,Perlis,0,0,0,Somalia
77973,10/1/2023,SOM,Sabah,0,0,0,Somalia
77974,10/1/2023,SOM,Sarawak,0,0,0,Somalia
77975,10/1/2023,SOM,Selangor,268,168,100,Somalia
77976,10/1/2023,SRB,Johor,7,6,1,Serbia
77977,10/1/2023,SRB,Kedah,4,3,1,Serbia
77978,10/1/2023,SRB,Kelantan,0,0,0,Serbia
77979,10/1/2023,SRB,Pahang,0,0,0,Serbia
77980,10/1/2023,SRB,Perak,0,0,0,Serbia
77981,10/1/2023,SRB,Perlis,0,0,0,Serbia
77982,10/1/2023,SRB,Pulau Pinang,15,4,11,Serbia
77983,10/1/2023,SRB,Sabah,0,0,0,Serbia
77984,10/1/2023,SRB,Sarawak,1,0,1,Serbia
77985,10/1/2023,SRB,Selangor,101,59,42,Serbia
77986,10/1/2023,STP,Selangor,2,2,0,Sao Tome and Principe
77987,10/1/2023,SUR,Johor,5,2,3,Suriname
77988,10/1/2023,SUR,Kedah,0,0,0,Suriname
77989,10/1/2023,SUR,Kelantan,0,0,0,Suriname
77990,10/1/2023,SUR,Perak,0,0,0,Suriname
77991,10/1/2023,SUR,Perlis,0,0,0,Suriname
77992,10/1/2023,SUR,Pulau Pinang,0,0,0,Suriname
77993,10/1/2023,SUR,Sabah,0,0,0,Suriname
77994,10/1/2023,SUR,Sarawak,0,0,0,Suriname
77995,10/1/2023,SUR,Selangor,18,11,7,Suriname
77996,10/1/2023,SVK,Johor,29,20,9,Slovakia
77997,10/1/2023,SVK,Kedah,54,28,26,Slovakia
77998,10/1/2023,SVK,Kelantan,0,0,0,Slovakia
77999,10/1/2023,SVK,Negeri Sembilan,0,0,0,Slovakia
78000,10/1/2023,SVK,Pahang,0,0,0,Slovakia
78001,10/1/2023,SVK,Perak,0,0,0,Slovakia
78002,10/1/2023,SVK,Perlis,1,1,0,Slovakia
78003,10/1/2023,SVK,Pulau Pinang,17,13,4,Slovakia
78004,10/1/2023,SVK,Sabah,1,0,1,Slovakia
78005,10/1/2023,SVK,Sarawak,2,2,0,Slovakia
78006,10/1/2023,SVK,Selangor,358,202,156,Slovakia
78007,10/1/2023,SVK,W.P. Labuan,0,0,0,Slovakia
78008,10/1/2023,SVN,Johor,22,13,9,Slovenia
78009,10/1/2023,SVN,Kedah,3,1,2,Slovenia
78010,10/1/2023,SVN,Kelantan,0,0,0,Slovenia
78011,10/1/2023,SVN,Perak,0,0,0,Slovenia
78012,10/1/2023,SVN,Perlis,0,0,0,Slovenia
78013,10/1/2023,SVN,Pulau Pinang,7,5,2,Slovenia
78014,10/1/2023,SVN,Sabah,1,0,1,Slovenia
78015,10/1/2023,SVN,Sarawak,2,2,0,Slovenia
78016,10/1/2023,SVN,Selangor,136,80,56,Slovenia
78017,10/1/2023,SVN,W.P. Labuan,0,0,0,Slovenia
78018,10/1/2023,SWE,Johor,317,158,159,Sweden
78019,10/1/2023,SWE,Kedah,66,21,45,Sweden
78020,10/1/2023,SWE,Kelantan,4,2,2,Sweden
78021,10/1/2023,SWE,Melaka,1,1,0,Sweden
78022,10/1/2023,SWE,Negeri Sembilan,0,0,0,Sweden
78023,10/1/2023,SWE,Pahang,0,0,0,Sweden
78024,10/1/2023,SWE,Perak,7,5,2,Sweden
78025,10/1/2023,SWE,Perlis,7,6,1,Sweden
78026,10/1/2023,SWE,Pulau Pinang,75,47,28,Sweden
78027,10/1/2023,SWE,Sabah,14,9,5,Sweden
78028,10/1/2023,SWE,Sarawak,50,32,18,Sweden
78029,10/1/2023,SWE,Selangor,1022,616,406,Sweden
78030,10/1/2023,SWE,W.P. Labuan,0,0,0,Sweden
78031,10/1/2023,SWZ,Johor,1,1,0,Swaziland
78032,10/1/2023,SWZ,Kedah,0,0,0,Swaziland
78033,10/1/2023,SWZ,Pulau Pinang,0,0,0,Swaziland
78034,10/1/2023,SWZ,Sabah,1,0,1,Swaziland
78035,10/1/2023,SWZ,Selangor,29,19,10,Swaziland
78036,10/1/2023,SYC,Johor,10,2,8,Seychelles
78037,10/1/2023,SYC,Kedah,0,0,0,Seychelles
78038,10/1/2023,SYC,Pulau Pinang,3,1,2,Seychelles
78039,10/1/2023,SYC,Sabah,0,0,0,Seychelles
78040,10/1/2023,SYC,Sarawak,1,1,0,Seychelles
78041,10/1/2023,SYC,Selangor,57,23,34,Seychelles
78042,10/1/2023,SYR,Johor,14,10,4,Syrian Arab Republic
78043,10/1/2023,SYR,Kedah,0,0,0,Syrian Arab Republic
78044,10/1/2023,SYR,Kelantan,0,0,0,Syrian Arab Republic
78045,10/1/2023,SYR,Pahang,0,0,0,Syrian Arab Republic
78046,10/1/2023,SYR,Perlis,1,1,0,Syrian Arab Republic
78047,10/1/2023,SYR,Pulau Pinang,2,2,0,Syrian Arab Republic
78048,10/1/2023,SYR,Sabah,0,0,0,Syrian Arab Republic
78049,10/1/2023,SYR,Sarawak,2,2,0,Syrian Arab Republic
78050,10/1/2023,SYR,Selangor,687,467,220,Syrian Arab Republic
78051,10/1/2023,SYR,W.P. Labuan,0,0,0,Syrian Arab Republic
78052,10/1/2023,TCA,Perlis,0,0,0,Turks and Caicos
78053,10/1/2023,TCD,Johor,1,1,0,Chad
78054,10/1/2023,TCD,Kedah,1,1,0,Chad
78055,10/1/2023,TCD,Perlis,1,1,0,Chad
78056,10/1/2023,TCD,Selangor,45,32,13,Chad
78057,10/1/2023,TGO,Johor,8,8,0,Togo
78058,10/1/2023,TGO,Perak,0,0,0,Togo
78059,10/1/2023,TGO,Pulau Pinang,0,0,0,Togo
78060,10/1/2023,TGO,Selangor,12,9,3,Togo
78061,10/1/2023,THA,Johor,11757,3601,8156,Thailand
78062,10/1/2023,THA,Kedah,78352,46416,31936,Thailand
78063,10/1/2023,THA,Kelantan,46426,24852,21574,Thailand
78064,10/1/2023,THA,Melaka,2,2,0,Thailand
78065,10/1/2023,THA,Negeri Sembilan,1,0,1,Thailand
78066,10/1/2023,THA,Pahang,10,6,4,Thailand
78067,10/1/2023,THA,Perak,11505,5283,6222,Thailand
78068,10/1/2023,THA,Perlis,56604,31372,25232,Thailand
78069,10/1/2023,THA,Pulau Pinang,2810,1048,1762,Thailand
78070,10/1/2023,THA,Sabah,20,13,7,Thailand
78071,10/1/2023,THA,Sarawak,320,115,205,Thailand
78072,10/1/2023,THA,Selangor,19691,7707,11984,Thailand
78073,10/1/2023,THA,Terengganu,0,0,0,Thailand
78074,10/1/2023,THA,W.P. Labuan,11,3,8,Thailand
78075,10/1/2023,TJK,Johor,7,6,1,Tajikistan
78076,10/1/2023,TJK,Kedah,0,0,0,Tajikistan
78077,10/1/2023,TJK,Perlis,0,0,0,Tajikistan
78078,10/1/2023,TJK,Pulau Pinang,0,0,0,Tajikistan
78079,10/1/2023,TJK,Sabah,0,0,0,Tajikistan
78080,10/1/2023,TJK,Selangor,157,120,37,Tajikistan
78081,10/1/2023,TKL,Selangor,0,0,0,Tokelau
78082,10/1/2023,TKM,Johor,0,0,0,Turkmenistan
78083,10/1/2023,TKM,Kedah,0,0,0,Turkmenistan
78084,10/1/2023,TKM,Kelantan,0,0,0,Turkmenistan
78085,10/1/2023,TKM,Perlis,0,0,0,Turkmenistan
78086,10/1/2023,TKM,Pulau Pinang,0,0,0,Turkmenistan
78087,10/1/2023,TKM,Sabah,0,0,0,Turkmenistan
78088,10/1/2023,TKM,Sarawak,2,2,0,Turkmenistan
78089,10/1/2023,TKM,Selangor,121,83,38,Turkmenistan
78090,10/1/2023,TLS,Johor,5,1,4,Timor-Leste
78091,10/1/2023,TLS,Kedah,2,0,2,Timor-Leste
78092,10/1/2023,TLS,Perlis,0,0,0,Timor-Leste
78093,10/1/2023,TLS,Pulau Pinang,12,8,4,Timor-Leste
78094,10/1/2023,TLS,Sabah,0,0,0,Timor-Leste
78095,10/1/2023,TLS,Sarawak,4,4,0,Timor-Leste
78096,10/1/2023,TLS,Selangor,183,112,71,Timor-Leste
78097,10/1/2023,TON,Johor,1,1,0,Tonga
78098,10/1/2023,TON,Pulau Pinang,3,1,2,Tonga
78099,10/1/2023,TON,Sarawak,0,0,0,Tonga
78100,10/1/2023,TON,Selangor,33,7,26,Tonga
78101,10/1/2023,TTO,Johor,14,6,8,Trinidad and Tobago
78102,10/1/2023,TTO,Kedah,0,0,0,Trinidad and Tobago
78103,10/1/2023,TTO,Pahang,0,0,0,Trinidad and Tobago
78104,10/1/2023,TTO,Pulau Pinang,1,0,1,Trinidad and Tobago
78105,10/1/2023,TTO,Sabah,0,0,0,Trinidad and Tobago
78106,10/1/2023,TTO,Sarawak,3,1,2,Trinidad and Tobago
78107,10/1/2023,TTO,Selangor,32,19,13,Trinidad and Tobago
78108,10/1/2023,TUN,Johor,9,7,2,Tunisia
78109,10/1/2023,TUN,Kedah,1,1,0,Tunisia
78110,10/1/2023,TUN,Kelantan,0,0,0,Tunisia
78111,10/1/2023,TUN,Melaka,0,0,0,Tunisia
78112,10/1/2023,TUN,Perak,0,0,0,Tunisia
78113,10/1/2023,TUN,Perlis,0,0,0,Tunisia
78114,10/1/2023,TUN,Pulau Pinang,6,5,1,Tunisia
78115,10/1/2023,TUN,Sabah,0,0,0,Tunisia
78116,10/1/2023,TUN,Sarawak,0,0,0,Tunisia
78117,10/1/2023,TUN,Selangor,937,475,462,Tunisia
78118,10/1/2023,TUN,W.P. Labuan,0,0,0,Tunisia
78119,10/1/2023,TUR,Johor,346,259,87,Turkey
78120,10/1/2023,TUR,Kedah,34,23,11,Turkey
78121,10/1/2023,TUR,Kelantan,1,1,0,Turkey
78122,10/1/2023,TUR,Melaka,0,0,0,Turkey
78123,10/1/2023,TUR,Negeri Sembilan,0,0,0,Turkey
78124,10/1/2023,TUR,Pahang,2,0,2,Turkey
78125,10/1/2023,TUR,Perak,1,1,0,Turkey
78126,10/1/2023,TUR,Perlis,10,9,1,Turkey
78127,10/1/2023,TUR,Pulau Pinang,39,29,10,Turkey
78128,10/1/2023,TUR,Sabah,1,0,1,Turkey
78129,10/1/2023,TUR,Sarawak,25,16,9,Turkey
78130,10/1/2023,TUR,Selangor,1607,1183,424,Turkey
78131,10/1/2023,TUR,W.P. Labuan,0,0,0,Turkey
78132,10/1/2023,TUV,Selangor,0,0,0,Tuvalu
78133,10/1/2023,TWN,Johor,6859,2862,3997,Taiwan
78134,10/1/2023,TWN,Kedah,118,64,54,Taiwan
78135,10/1/2023,TWN,Kelantan,3,3,0,Taiwan
78136,10/1/2023,TWN,Melaka,1,1,0,Taiwan
78137,10/1/2023,TWN,Negeri Sembilan,0,0,0,Taiwan
78138,10/1/2023,TWN,Pahang,5,3,2,Taiwan
78139,10/1/2023,TWN,Perak,53,25,28,Taiwan
78140,10/1/2023,TWN,Perlis,6,2,4,Taiwan
78141,10/1/2023,TWN,Pulau Pinang,4338,2089,2249,Taiwan
78142,10/1/2023,TWN,Sabah,106,46,60,Taiwan
78143,10/1/2023,TWN,Sarawak,263,119,144,Taiwan
78144,10/1/2023,TWN,Selangor,17862,8281,9581,Taiwan
78145,10/1/2023,TWN,W.P. Labuan,6,5,1,Taiwan
78146,10/1/2023,TZA,Johor,17,11,6,"Tanzania, United Republic of"
78147,10/1/2023,TZA,Kedah,1,0,1,"Tanzania, United Republic of"
78148,10/1/2023,TZA,Perak,0,0,0,"Tanzania, United Republic of"
78149,10/1/2023,TZA,Perlis,0,0,0,"Tanzania, United Republic of"
78150,10/1/2023,TZA,Pulau Pinang,1,1,0,"Tanzania, United Republic of"
78151,10/1/2023,TZA,Sabah,0,0,0,"Tanzania, United Republic of"
78152,10/1/2023,TZA,Sarawak,4,4,0,"Tanzania, United Republic of"
78153,10/1/2023,TZA,Selangor,263,117,146,"Tanzania, United Republic of"
78154,10/1/2023,UGA,Johor,26,8,18,Uganda
78155,10/1/2023,UGA,Kedah,0,0,0,Uganda
78156,10/1/2023,UGA,Perak,0,0,0,Uganda
78157,10/1/2023,UGA,Perlis,0,0,0,Uganda
78158,10/1/2023,UGA,Pulau Pinang,0,0,0,Uganda
78159,10/1/2023,UGA,Sabah,0,0,0,Uganda
78160,10/1/2023,UGA,Sarawak,0,0,0,Uganda
78161,10/1/2023,UGA,Selangor,158,82,76,Uganda
78162,10/1/2023,UKR,Johor,96,42,54,Ukraine
78163,10/1/2023,UKR,Kedah,22,10,12,Ukraine
78164,10/1/2023,UKR,Kelantan,0,0,0,Ukraine
78165,10/1/2023,UKR,Melaka,5,5,0,Ukraine
78166,10/1/2023,UKR,Negeri Sembilan,0,0,0,Ukraine
78167,10/1/2023,UKR,Pahang,0,0,0,Ukraine
78168,10/1/2023,UKR,Perak,1,0,1,Ukraine
78169,10/1/2023,UKR,Perlis,7,4,3,Ukraine
78170,10/1/2023,UKR,Pulau Pinang,20,9,11,Ukraine
78171,10/1/2023,UKR,Sabah,5,2,3,Ukraine
78172,10/1/2023,UKR,Sarawak,0,0,0,Ukraine
78173,10/1/2023,UKR,Selangor,906,442,464,Ukraine
78174,10/1/2023,UKR,W.P. Labuan,1,1,0,Ukraine
78175,10/1/2023,URY,Johor,3,2,1,Uruguay
78176,10/1/2023,URY,Kedah,1,1,0,Uruguay
78177,10/1/2023,URY,Kelantan,0,0,0,Uruguay
78178,10/1/2023,URY,Perak,0,0,0,Uruguay
78179,10/1/2023,URY,Perlis,0,0,0,Uruguay
78180,10/1/2023,URY,Pulau Pinang,1,1,0,Uruguay
78181,10/1/2023,URY,Sabah,0,0,0,Uruguay
78182,10/1/2023,URY,Sarawak,1,1,0,Uruguay
78183,10/1/2023,URY,Selangor,64,36,28,Uruguay
78184,10/1/2023,URY,W.P. Labuan,0,0,0,Uruguay
78185,10/1/2023,USA,Johor,4641,2658,1983,United States Of America
78186,10/1/2023,USA,Kedah,369,203,166,United States Of America
78187,10/1/2023,USA,Kelantan,14,10,4,United States Of America
78188,10/1/2023,USA,Melaka,12,6,6,United States Of America
78189,10/1/2023,USA,Negeri Sembilan,0,0,0,United States Of America
78190,10/1/2023,USA,Pahang,21,18,3,United States Of America
78191,10/1/2023,USA,Perak,104,59,45,United States Of America
78192,10/1/2023,USA,Perlis,49,30,19,United States Of America
78193,10/1/2023,USA,Pulau Pinang,2064,1233,831,United States Of America
78194,10/1/2023,USA,Sabah,71,39,32,United States Of America
78195,10/1/2023,USA,Sarawak,288,156,132,United States Of America
78196,10/1/2023,USA,Selangor,14060,8310,5750,United States Of America
78197,10/1/2023,USA,Terengganu,0,0,0,United States Of America
78198,10/1/2023,USA,W.P. Labuan,3,3,0,United States Of America
78199,10/1/2023,UZB,Johor,66,49,17,Uzbekistan
78200,10/1/2023,UZB,Kedah,8,5,3,Uzbekistan
78201,10/1/2023,UZB,Kelantan,0,0,0,Uzbekistan
78202,10/1/2023,UZB,Perak,0,0,0,Uzbekistan
78203,10/1/2023,UZB,Perlis,2,2,0,Uzbekistan
78204,10/1/2023,UZB,Pulau Pinang,12,5,7,Uzbekistan
78205,10/1/2023,UZB,Sabah,2,2,0,Uzbekistan
78206,10/1/2023,UZB,Sarawak,0,0,0,Uzbekistan
78207,10/1/2023,UZB,Selangor,900,545,355,Uzbekistan
78208,10/1/2023,VAT,Johor,0,0,0,Holy See (Vatican City State)
78209,10/1/2023,VAT,Sarawak,0,0,0,Holy See (Vatican City State)
78210,10/1/2023,VAT,Selangor,0,0,0,Holy See (Vatican City State)
78211,10/1/2023,VCT,Johor,0,0,0,Saint Vincent and the Grenadines
78212,10/1/2023,VCT,Kedah,0,0,0,Saint Vincent and the Grenadines
78213,10/1/2023,VCT,Pulau Pinang,0,0,0,Saint Vincent and the Grenadines
78214,10/1/2023,VCT,Sarawak,0,0,0,Saint Vincent and the Grenadines
78215,10/1/2023,VCT,Selangor,1,0,1,Saint Vincent and the Grenadines
78216,10/1/2023,VEN,Johor,13,8,5,Venezuela
78217,10/1/2023,VEN,Kedah,0,0,0,Venezuela
78218,10/1/2023,VEN,Kelantan,0,0,0,Venezuela
78219,10/1/2023,VEN,Melaka,0,0,0,Venezuela
78220,10/1/2023,VEN,Perak,0,0,0,Venezuela
78221,10/1/2023,VEN,Perlis,0,0,0,Venezuela
78222,10/1/2023,VEN,Pulau Pinang,6,4,2,Venezuela
78223,10/1/2023,VEN,Sabah,0,0,0,Venezuela
78224,10/1/2023,VEN,Sarawak,5,3,2,Venezuela
78225,10/1/2023,VEN,Selangor,87,48,39,Venezuela
78226,10/1/2023,VEN,W.P. Labuan,0,0,0,Venezuela
78227,10/1/2023,VNM,Johor,14353,4405,9948,Vietnam
78228,10/1/2023,VNM,Kedah,367,75,292,Vietnam
78229,10/1/2023,VNM,Kelantan,15,5,10,Vietnam
78230,10/1/2023,VNM,Melaka,0,0,0,Vietnam
78231,10/1/2023,VNM,Negeri Sembilan,0,0,0,Vietnam
78232,10/1/2023,VNM,Pahang,1,0,1,Vietnam
78233,10/1/2023,VNM,Perak,186,10,176,Vietnam
78234,10/1/2023,VNM,Perlis,131,28,103,Vietnam
78235,10/1/2023,VNM,Pulau Pinang,1245,367,878,Vietnam
78236,10/1/2023,VNM,Sabah,14,7,7,Vietnam
78237,10/1/2023,VNM,Sarawak,219,69,150,Vietnam
78238,10/1/2023,VNM,Selangor,15135,5369,9766,Vietnam
78239,10/1/2023,VNM,Terengganu,0,0,0,Vietnam
78240,10/1/2023,VNM,W.P. Labuan,1,1,0,Vietnam
78241,10/1/2023,VUT,Johor,56,41,15,Vanuatu
78242,10/1/2023,VUT,Kedah,0,0,0,Vanuatu
78243,10/1/2023,VUT,Pulau Pinang,5,3,2,Vanuatu
78244,10/1/2023,VUT,Sabah,0,0,0,Vanuatu
78245,10/1/2023,VUT,Sarawak,0,0,0,Vanuatu
78246,10/1/2023,VUT,Selangor,85,67,18,Vanuatu
78247,10/1/2023,WSM,Johor,1,1,0,Samoa
78248,10/1/2023,WSM,Sarawak,0,0,0,Samoa
78249,10/1/2023,WSM,Selangor,4,3,1,Samoa
78250,10/1/2023,YEM,Johor,31,18,13,Yemen
78251,10/1/2023,YEM,Kedah,2,2,0,Yemen
78252,10/1/2023,YEM,Kelantan,2,0,2,Yemen
78253,10/1/2023,YEM,Melaka,0,0,0,Yemen
78254,10/1/2023,YEM,Pahang,0,0,0,Yemen
78255,10/1/2023,YEM,Perak,1,1,0,Yemen
78256,10/1/2023,YEM,Perlis,2,2,0,Yemen
78257,10/1/2023,YEM,Pulau Pinang,2,2,0,Yemen
78258,10/1/2023,YEM,Sabah,0,0,0,Yemen
78259,10/1/2023,YEM,Sarawak,2,1,1,Yemen
78260,10/1/2023,YEM,Selangor,1710,1303,407,Yemen
78261,10/1/2023,YEM,W.P. Labuan,0,0,0,Yemen
78262,10/1/2023,ZAF,Johor,289,182,107,South Africa
78263,10/1/2023,ZAF,Kedah,37,20,17,South Africa
78264,10/1/2023,ZAF,Kelantan,2,1,1,South Africa
78265,10/1/2023,ZAF,Melaka,0,0,0,South Africa
78266,10/1/2023,ZAF,Pahang,0,0,0,South Africa
78267,10/1/2023,ZAF,Perak,2,2,0,South Africa
78268,10/1/2023,ZAF,Perlis,21,12,9,South Africa
78269,10/1/2023,ZAF,Pulau Pinang,55,26,29,South Africa
78270,10/1/2023,ZAF,Sabah,7,5,2,South Africa
78271,10/1/2023,ZAF,Sarawak,59,33,26,South Africa
78272,10/1/2023,ZAF,Selangor,1058,619,439,South Africa
78273,10/1/2023,ZAF,Terengganu,0,0,0,South Africa
78274,10/1/2023,ZAF,W.P. Labuan,0,0,0,South Africa
78275,10/1/2023,ZMB,Johor,6,4,2,Zambia
78276,10/1/2023,ZMB,Kedah,1,0,1,Zambia
78277,10/1/2023,ZMB,Perak,0,0,0,Zambia
78278,10/1/2023,ZMB,Perlis,1,1,0,Zambia
78279,10/1/2023,ZMB,Pulau Pinang,1,0,1,Zambia
78280,10/1/2023,ZMB,Sabah,0,0,0,Zambia
78281,10/1/2023,ZMB,Sarawak,0,0,0,Zambia
78282,10/1/2023,ZMB,Selangor,47,26,21,Zambia
78283,10/1/2023,ZWE,Johor,7,3,4,Zimbabwe
78284,10/1/2023,ZWE,Kedah,0,0,0,Zimbabwe
78285,10/1/2023,ZWE,Kelantan,0,0,0,Zimbabwe
78286,10/1/2023,ZWE,Perak,0,0,0,Zimbabwe
78287,10/1/2023,ZWE,Perlis,1,0,1,Zimbabwe
78288,10/1/2023,ZWE,Pulau Pinang,3,2,1,Zimbabwe
78289,10/1/2023,ZWE,Sabah,0,0,0,Zimbabwe
78290,10/1/2023,ZWE,Sarawak,0,0,0,Zimbabwe
78291,10/1/2023,ZWE,Selangor,189,86,103,Zimbabwe
78292,11/1/2023,ABW,Kedah,0,0,0,Aruba
78293,11/1/2023,ABW,Pulau Pinang,0,0,0,Aruba
78294,11/1/2023,AFG,Johor,1,1,0,Afghanistan
78295,11/1/2023,AFG,Kedah,0,0,0,Afghanistan
78296,11/1/2023,AFG,Perlis,0,0,0,Afghanistan
78297,11/1/2023,AFG,Pulau Pinang,1,1,0,Afghanistan
78298,11/1/2023,AFG,Sarawak,0,0,0,Afghanistan
78299,11/1/2023,AFG,Selangor,42,32,10,Afghanistan
78300,11/1/2023,AGO,Johor,0,0,0,Angola
78301,11/1/2023,AGO,Kedah,0,0,0,Angola
78302,11/1/2023,AGO,Sabah,0,0,0,Angola
78303,11/1/2023,AGO,Selangor,3,3,0,Angola
78304,11/1/2023,AIA,Selangor,1,1,0,Anguilla
78305,11/1/2023,ALB,Johor,15,13,2,Albania
78306,11/1/2023,ALB,Kedah,1,1,0,Albania
78307,11/1/2023,ALB,Perak,0,0,0,Albania
78308,11/1/2023,ALB,Perlis,0,0,0,Albania
78309,11/1/2023,ALB,Pulau Pinang,1,1,0,Albania
78310,11/1/2023,ALB,Sabah,0,0,0,Albania
78311,11/1/2023,ALB,Sarawak,0,0,0,Albania
78312,11/1/2023,ALB,Selangor,38,23,15,Albania
78313,11/1/2023,AND,Johor,3,1,2,Andorra
78314,11/1/2023,AND,Kedah,0,0,0,Andorra
78315,11/1/2023,AND,Perlis,0,0,0,Andorra
78316,11/1/2023,AND,Pulau Pinang,0,0,0,Andorra
78317,11/1/2023,AND,Selangor,6,3,3,Andorra
78318,11/1/2023,ANT,Selangor,0,0,0,Netherlands Antilles
78319,11/1/2023,ARE,Johor,15,9,6,United Arab Emirates
78320,11/1/2023,ARE,Kedah,0,0,0,United Arab Emirates
78321,11/1/2023,ARE,Kelantan,0,0,0,United Arab Emirates
78322,11/1/2023,ARE,Perak,0,0,0,United Arab Emirates
78323,11/1/2023,ARE,Perlis,1,1,0,United Arab Emirates
78324,11/1/2023,ARE,Pulau Pinang,0,0,0,United Arab Emirates
78325,11/1/2023,ARE,Sabah,0,0,0,United Arab Emirates
78326,11/1/2023,ARE,Sarawak,0,0,0,United Arab Emirates
78327,11/1/2023,ARE,Selangor,369,235,134,United Arab Emirates
78328,11/1/2023,ARG,Johor,80,54,26,Argentina
78329,11/1/2023,ARG,Kedah,41,15,26,Argentina
78330,11/1/2023,ARG,Kelantan,0,0,0,Argentina
78331,11/1/2023,ARG,Melaka,1,1,0,Argentina
78332,11/1/2023,ARG,Perak,0,0,0,Argentina
78333,11/1/2023,ARG,Perlis,1,1,0,Argentina
78334,11/1/2023,ARG,Pulau Pinang,15,5,10,Argentina
78335,11/1/2023,ARG,Sabah,4,3,1,Argentina
78336,11/1/2023,ARG,Sarawak,3,3,0,Argentina
78337,11/1/2023,ARG,Selangor,411,230,181,Argentina
78338,11/1/2023,ARG,W.P. Labuan,0,0,0,Argentina
78339,11/1/2023,ARM,Johor,2,2,0,Armenia
78340,11/1/2023,ARM,Kedah,0,0,0,Armenia
78341,11/1/2023,ARM,Kelantan,1,1,0,Armenia
78342,11/1/2023,ARM,Perak,0,0,0,Armenia
78343,11/1/2023,ARM,Perlis,0,0,0,Armenia
78344,11/1/2023,ARM,Pulau Pinang,3,2,1,Armenia
78345,11/1/2023,ARM,Sabah,1,1,0,Armenia
78346,11/1/2023,ARM,Sarawak,0,0,0,Armenia
78347,11/1/2023,ARM,Selangor,32,17,15,Armenia
78348,11/1/2023,ATA,Selangor,0,0,0,Antarctica
78349,11/1/2023,ATG,Johor,3,3,0,Antigua and Barbuda
78350,11/1/2023,ATG,Kedah,0,0,0,Antigua and Barbuda
78351,11/1/2023,ATG,Pulau Pinang,0,0,0,Antigua and Barbuda
78352,11/1/2023,ATG,Sarawak,0,0,0,Antigua and Barbuda
78353,11/1/2023,ATG,Selangor,15,10,5,Antigua and Barbuda
78354,11/1/2023,AUS,Johor,5161,3050,2111,Australia
78355,11/1/2023,AUS,Kedah,684,346,338,Australia
78356,11/1/2023,AUS,Kelantan,4,3,1,Australia
78357,11/1/2023,AUS,Melaka,4,2,2,Australia
78358,11/1/2023,AUS,Negeri Sembilan,3,3,0,Australia
78359,11/1/2023,AUS,Pahang,10,8,2,Australia
78360,11/1/2023,AUS,Perak,228,122,106,Australia
78361,11/1/2023,AUS,Perlis,94,57,37,Australia
78362,11/1/2023,AUS,Pulau Pinang,2127,1142,985,Australia
78363,11/1/2023,AUS,Sabah,265,124,141,Australia
78364,11/1/2023,AUS,Sarawak,481,272,209,Australia
78365,11/1/2023,AUS,Selangor,26398,15601,10797,Australia
78366,11/1/2023,AUS,Terengganu,4,3,1,Australia
78367,11/1/2023,AUS,W.P. Labuan,8,6,2,Australia
78368,11/1/2023,AUT,Johor,183,130,53,Austria
78369,11/1/2023,AUT,Kedah,66,38,28,Austria
78370,11/1/2023,AUT,Kelantan,5,5,0,Austria
78371,11/1/2023,AUT,Melaka,0,0,0,Austria
78372,11/1/2023,AUT,Negeri Sembilan,2,1,1,Austria
78373,11/1/2023,AUT,Pahang,0,0,0,Austria
78374,11/1/2023,AUT,Perak,4,4,0,Austria
78375,11/1/2023,AUT,Perlis,16,9,7,Austria
78376,11/1/2023,AUT,Pulau Pinang,103,81,22,Austria
78377,11/1/2023,AUT,Sabah,10,6,4,Austria
78378,11/1/2023,AUT,Sarawak,9,5,4,Austria
78379,11/1/2023,AUT,Selangor,941,635,306,Austria
78380,11/1/2023,AUT,Terengganu,0,0,0,Austria
78381,11/1/2023,AUT,W.P. Labuan,0,0,0,Austria
78382,11/1/2023,AZE,Johor,9,7,2,Azerbaijan
78383,11/1/2023,AZE,Kedah,2,0,2,Azerbaijan
78384,11/1/2023,AZE,Kelantan,0,0,0,Azerbaijan
78385,11/1/2023,AZE,Melaka,0,0,0,Azerbaijan
78386,11/1/2023,AZE,Perlis,0,0,0,Azerbaijan
78387,11/1/2023,AZE,Pulau Pinang,1,1,0,Azerbaijan
78388,11/1/2023,AZE,Sabah,0,0,0,Azerbaijan
78389,11/1/2023,AZE,Sarawak,2,1,1,Azerbaijan
78390,11/1/2023,AZE,Selangor,151,82,69,Azerbaijan
78391,11/1/2023,AZE,W.P. Labuan,0,0,0,Azerbaijan
78392,11/1/2023,BDI,Pulau Pinang,1,0,1,Burundi
78393,11/1/2023,BDI,Sarawak,0,0,0,Burundi
78394,11/1/2023,BDI,Selangor,2,1,1,Burundi
78395,11/1/2023,BEL,Johor,259,170,89,Belgium
78396,11/1/2023,BEL,Kedah,68,41,27,Belgium
78397,11/1/2023,BEL,Kelantan,3,2,1,Belgium
78398,11/1/2023,BEL,Melaka,5,2,3,Belgium
78399,11/1/2023,BEL,Negeri Sembilan,0,0,0,Belgium
78400,11/1/2023,BEL,Pahang,0,0,0,Belgium
78401,11/1/2023,BEL,Perak,0,0,0,Belgium
78402,11/1/2023,BEL,Perlis,7,4,3,Belgium
78403,11/1/2023,BEL,Pulau Pinang,76,51,25,Belgium
78404,11/1/2023,BEL,Sabah,18,10,8,Belgium
78405,11/1/2023,BEL,Sarawak,12,9,3,Belgium
78406,11/1/2023,BEL,Selangor,1217,817,400,Belgium
78407,11/1/2023,BEL,W.P. Labuan,2,2,0,Belgium
78408,11/1/2023,BEN,Johor,1,1,0,Benin
78409,11/1/2023,BEN,Kedah,0,0,0,Benin
78410,11/1/2023,BEN,Perak,0,0,0,Benin
78411,11/1/2023,BEN,Pulau Pinang,0,0,0,Benin
78412,11/1/2023,BEN,Sabah,2,2,0,Benin
78413,11/1/2023,BEN,Sarawak,1,1,0,Benin
78414,11/1/2023,BEN,Selangor,11,8,3,Benin
78415,11/1/2023,BFA,Perak,0,0,0,Burkina Faso
78416,11/1/2023,BFA,Pulau Pinang,0,0,0,Burkina Faso
78417,11/1/2023,BFA,Selangor,5,3,2,Burkina Faso
78418,11/1/2023,BGD,Johor,2690,2231,459,Bangladesh
78419,11/1/2023,BGD,Kedah,62,41,21,Bangladesh
78420,11/1/2023,BGD,Kelantan,2,2,0,Bangladesh
78421,11/1/2023,BGD,Melaka,0,0,0,Bangladesh
78422,11/1/2023,BGD,Negeri Sembilan,0,0,0,Bangladesh
78423,11/1/2023,BGD,Pahang,1,1,0,Bangladesh
78424,11/1/2023,BGD,Perak,2,1,1,Bangladesh
78425,11/1/2023,BGD,Perlis,4,3,1,Bangladesh
78426,11/1/2023,BGD,Pulau Pinang,190,172,18,Bangladesh
78427,11/1/2023,BGD,Sabah,7,7,0,Bangladesh
78428,11/1/2023,BGD,Sarawak,42,32,10,Bangladesh
78429,11/1/2023,BGD,Selangor,35940,34250,1690,Bangladesh
78430,11/1/2023,BGD,W.P. Labuan,11,11,0,Bangladesh
78431,11/1/2023,BGR,Johor,57,32,25,Bulgaria
78432,11/1/2023,BGR,Kedah,20,10,10,Bulgaria
78433,11/1/2023,BGR,Kelantan,1,1,0,Bulgaria
78434,11/1/2023,BGR,Pahang,0,0,0,Bulgaria
78435,11/1/2023,BGR,Perak,0,0,0,Bulgaria
78436,11/1/2023,BGR,Perlis,0,0,0,Bulgaria
78437,11/1/2023,BGR,Pulau Pinang,19,13,6,Bulgaria
78438,11/1/2023,BGR,Sabah,1,1,0,Bulgaria
78439,11/1/2023,BGR,Sarawak,0,0,0,Bulgaria
78440,11/1/2023,BGR,Selangor,375,175,200,Bulgaria
78441,11/1/2023,BGR,W.P. Labuan,0,0,0,Bulgaria
78442,11/1/2023,BHR,Johor,6,5,1,Bahrain
78443,11/1/2023,BHR,Kedah,1,1,0,Bahrain
78444,11/1/2023,BHR,Kelantan,0,0,0,Bahrain
78445,11/1/2023,BHR,Perlis,0,0,0,Bahrain
78446,11/1/2023,BHR,Pulau Pinang,2,1,1,Bahrain
78447,11/1/2023,BHR,Sabah,0,0,0,Bahrain
78448,11/1/2023,BHR,Sarawak,1,1,0,Bahrain
78449,11/1/2023,BHR,Selangor,139,83,56,Bahrain
78450,11/1/2023,BHS,Johor,2,1,1,Bahamas
78451,11/1/2023,BHS,Kedah,0,0,0,Bahamas
78452,11/1/2023,BHS,Perak,0,0,0,Bahamas
78453,11/1/2023,BHS,Sabah,0,0,0,Bahamas
78454,11/1/2023,BHS,Sarawak,0,0,0,Bahamas
78455,11/1/2023,BHS,Selangor,0,0,0,Bahamas
78456,11/1/2023,BIH,Johor,2,2,0,Bosnia and Herzegovina
78457,11/1/2023,BIH,Kedah,0,0,0,Bosnia and Herzegovina
78458,11/1/2023,BIH,Perlis,0,0,0,Bosnia and Herzegovina
78459,11/1/2023,BIH,Pulau Pinang,4,2,2,Bosnia and Herzegovina
78460,11/1/2023,BIH,Sabah,0,0,0,Bosnia and Herzegovina
78461,11/1/2023,BIH,Sarawak,4,4,0,Bosnia and Herzegovina
78462,11/1/2023,BIH,Selangor,65,35,30,Bosnia and Herzegovina
78463,11/1/2023,BLR,Johor,13,4,9,Belarus
78464,11/1/2023,BLR,Kedah,22,9,13,Belarus
78465,11/1/2023,BLR,Kelantan,2,1,1,Belarus
78466,11/1/2023,BLR,Pahang,0,0,0,Belarus
78467,11/1/2023,BLR,Perak,0,0,0,Belarus
78468,11/1/2023,BLR,Perlis,0,0,0,Belarus
78469,11/1/2023,BLR,Pulau Pinang,15,4,11,Belarus
78470,11/1/2023,BLR,Sabah,4,1,3,Belarus
78471,11/1/2023,BLR,Sarawak,3,0,3,Belarus
78472,11/1/2023,BLR,Selangor,409,181,228,Belarus
78473,11/1/2023,BLR,W.P. Labuan,0,0,0,Belarus
78474,11/1/2023,BLZ,Johor,6,2,4,Belize
78475,11/1/2023,BLZ,Pulau Pinang,0,0,0,Belize
78476,11/1/2023,BLZ,Sarawak,0,0,0,Belize
78477,11/1/2023,BLZ,Selangor,5,3,2,Belize
78478,11/1/2023,BMU,Selangor,0,0,0,Bermuda
78479,11/1/2023,BOL,Johor,4,3,1,Bolivia
78480,11/1/2023,BOL,Kedah,0,0,0,Bolivia
78481,11/1/2023,BOL,Melaka,0,0,0,Bolivia
78482,11/1/2023,BOL,Perak,0,0,0,Bolivia
78483,11/1/2023,BOL,Perlis,0,0,0,Bolivia
78484,11/1/2023,BOL,Pulau Pinang,0,0,0,Bolivia
78485,11/1/2023,BOL,Sabah,0,0,0,Bolivia
78486,11/1/2023,BOL,Sarawak,0,0,0,Bolivia
78487,11/1/2023,BOL,Selangor,40,29,11,Bolivia
78488,11/1/2023,BRA,Johor,360,216,144,Brazil
78489,11/1/2023,BRA,Kedah,60,27,33,Brazil
78490,11/1/2023,BRA,Kelantan,0,0,0,Brazil
78491,11/1/2023,BRA,Melaka,4,3,1,Brazil
78492,11/1/2023,BRA,Pahang,4,3,1,Brazil
78493,11/1/2023,BRA,Perak,6,3,3,Brazil
78494,11/1/2023,BRA,Perlis,8,2,6,Brazil
78495,11/1/2023,BRA,Pulau Pinang,19,12,7,Brazil
78496,11/1/2023,BRA,Sabah,8,6,2,Brazil
78497,11/1/2023,BRA,Sarawak,16,12,4,Brazil
78498,11/1/2023,BRA,Selangor,996,579,417,Brazil
78499,11/1/2023,BRA,W.P. Labuan,0,0,0,Brazil
78500,11/1/2023,BRB,Johor,1,0,1,Barbados
78501,11/1/2023,BRB,Kedah,0,0,0,Barbados
78502,11/1/2023,BRB,Perlis,0,0,0,Barbados
78503,11/1/2023,BRB,Pulau Pinang,0,0,0,Barbados
78504,11/1/2023,BRB,Selangor,5,5,0,Barbados
78505,11/1/2023,BRN,Johor,502,264,238,Brunei Darussalam
78506,11/1/2023,BRN,Kedah,31,14,17,Brunei Darussalam
78507,11/1/2023,BRN,Kelantan,23,12,11,Brunei Darussalam
78508,11/1/2023,BRN,Melaka,0,0,0,Brunei Darussalam
78509,11/1/2023,BRN,Pahang,0,0,0,Brunei Darussalam
78510,11/1/2023,BRN,Perak,3,1,2,Brunei Darussalam
78511,11/1/2023,BRN,Perlis,37,22,15,Brunei Darussalam
78512,11/1/2023,BRN,Pulau Pinang,29,15,14,Brunei Darussalam
78513,11/1/2023,BRN,Sabah,1075,451,624,Brunei Darussalam
78514,11/1/2023,BRN,Sarawak,64400,36057,28343,Brunei Darussalam
78515,11/1/2023,BRN,Selangor,6185,3123,3062,Brunei Darussalam
78516,11/1/2023,BRN,W.P. Labuan,1189,825,364,Brunei Darussalam
78517,11/1/2023,BTN,Johor,18,11,7,Bhutan
78518,11/1/2023,BTN,Kedah,2,2,0,Bhutan
78519,11/1/2023,BTN,Perak,0,0,0,Bhutan
78520,11/1/2023,BTN,Perlis,0,0,0,Bhutan
78521,11/1/2023,BTN,Pulau Pinang,2,1,1,Bhutan
78522,11/1/2023,BTN,Sabah,1,1,0,Bhutan
78523,11/1/2023,BTN,Sarawak,0,0,0,Bhutan
78524,11/1/2023,BTN,Selangor,44,34,10,Bhutan
78525,11/1/2023,BWA,Johor,1,0,1,Botswana
78526,11/1/2023,BWA,Kedah,1,1,0,Botswana
78527,11/1/2023,BWA,Perlis,1,1,0,Botswana
78528,11/1/2023,BWA,Pulau Pinang,1,1,0,Botswana
78529,11/1/2023,BWA,Sabah,0,0,0,Botswana
78530,11/1/2023,BWA,Sarawak,0,0,0,Botswana
78531,11/1/2023,BWA,Selangor,10,5,5,Botswana
78532,11/1/2023,CAF,Kedah,0,0,0,Central African Republic
78533,11/1/2023,CAF,Selangor,0,0,0,Central African Republic
78534,11/1/2023,CAN,Johor,1605,891,714,Canada
78535,11/1/2023,CAN,Kedah,209,114,95,Canada
78536,11/1/2023,CAN,Kelantan,7,4,3,Canada
78537,11/1/2023,CAN,Melaka,0,0,0,Canada
78538,11/1/2023,CAN,Negeri Sembilan,0,0,0,Canada
78539,11/1/2023,CAN,Pahang,5,4,1,Canada
78540,11/1/2023,CAN,Perak,52,26,26,Canada
78541,11/1/2023,CAN,Perlis,44,28,16,Canada
78542,11/1/2023,CAN,Pulau Pinang,638,346,292,Canada
78543,11/1/2023,CAN,Sabah,112,61,51,Canada
78544,11/1/2023,CAN,Sarawak,235,133,102,Canada
78545,11/1/2023,CAN,Selangor,4874,2820,2054,Canada
78546,11/1/2023,CAN,Terengganu,0,0,0,Canada
78547,11/1/2023,CAN,W.P. Labuan,7,3,4,Canada
78548,11/1/2023,CCK,Selangor,0,0,0,Cocos (Keeling) Islands
78549,11/1/2023,CHE,Johor,439,258,181,Switzerland
78550,11/1/2023,CHE,Kedah,151,76,75,Switzerland
78551,11/1/2023,CHE,Kelantan,4,3,1,Switzerland
78552,11/1/2023,CHE,Melaka,0,0,0,Switzerland
78553,11/1/2023,CHE,Negeri Sembilan,4,1,3,Switzerland
78554,11/1/2023,CHE,Pahang,6,4,2,Switzerland
78555,11/1/2023,CHE,Perak,7,5,2,Switzerland
78556,11/1/2023,CHE,Perlis,19,10,9,Switzerland
78557,11/1/2023,CHE,Pulau Pinang,147,100,47,Switzerland
78558,11/1/2023,CHE,Sabah,22,14,8,Switzerland
78559,11/1/2023,CHE,Sarawak,30,15,15,Switzerland
78560,11/1/2023,CHE,Selangor,1347,822,525,Switzerland
78561,11/1/2023,CHE,W.P. Labuan,1,1,0,Switzerland
78562,11/1/2023,CHL,Johor,33,20,13,Chile
78563,11/1/2023,CHL,Kedah,12,5,7,Chile
78564,11/1/2023,CHL,Kelantan,0,0,0,Chile
78565,11/1/2023,CHL,Melaka,0,0,0,Chile
78566,11/1/2023,CHL,Pahang,0,0,0,Chile
78567,11/1/2023,CHL,Perak,0,0,0,Chile
78568,11/1/2023,CHL,Perlis,2,0,2,Chile
78569,11/1/2023,CHL,Pulau Pinang,5,3,2,Chile
78570,11/1/2023,CHL,Sabah,6,1,5,Chile
78571,11/1/2023,CHL,Sarawak,3,2,1,Chile
78572,11/1/2023,CHL,Selangor,314,166,148,Chile
78573,11/1/2023,CHN,Johor,40105,17947,22158,China
78574,11/1/2023,CHN,Kedah,1155,525,630,China
78575,11/1/2023,CHN,Kelantan,14,12,2,China
78576,11/1/2023,CHN,Melaka,2,2,0,China
78577,11/1/2023,CHN,Pahang,41,23,18,China
78578,11/1/2023,CHN,Perak,259,112,147,China
78579,11/1/2023,CHN,Perlis,139,73,66,China
78580,11/1/2023,CHN,Pulau Pinang,7833,4314,3519,China
78581,11/1/2023,CHN,Sabah,8287,3955,4332,China
78582,11/1/2023,CHN,Sarawak,991,499,492,China
78583,11/1/2023,CHN,Selangor,81817,44534,37283,China
78584,11/1/2023,CHN,Terengganu,0,0,0,China
78585,11/1/2023,CHN,W.P. Labuan,51,42,9,China
78586,11/1/2023,CIV,Johor,1,1,0,C��te d'Iv
78587,11/1/2023,CIV,Kedah,0,0,0,C��te d'Iv
78588,11/1/2023,CIV,Pulau Pinang,0,0,0,C��te d'Iv
78589,11/1/2023,CIV,Sabah,0,0,0,C��te d'Iv
78590,11/1/2023,CIV,Sarawak,0,0,0,C��te d'Iv
78591,11/1/2023,CIV,Selangor,39,23,16,C��te d'Iv
78592,11/1/2023,CMR,Johor,0,0,0,Cameroon
78593,11/1/2023,CMR,Kedah,0,0,0,Cameroon
78594,11/1/2023,CMR,Pulau Pinang,0,0,0,Cameroon
78595,11/1/2023,CMR,Sabah,0,0,0,Cameroon
78596,11/1/2023,CMR,Sarawak,0,0,0,Cameroon
78597,11/1/2023,CMR,Selangor,28,14,14,Cameroon
78598,11/1/2023,COD,Johor,2,2,0,"Congo, the Democratic Republic of the"
78599,11/1/2023,COD,Pulau Pinang,0,0,0,"Congo, the Democratic Republic of the"
78600,11/1/2023,COD,Sarawak,0,0,0,"Congo, the Democratic Republic of the"
78601,11/1/2023,COD,Selangor,11,7,4,"Congo, the Democratic Republic of the"
78602,11/1/2023,COG,Johor,0,0,0,Congo
78603,11/1/2023,COG,Kedah,0,0,0,Congo
78604,11/1/2023,COG,Selangor,1,0,1,Congo
78605,11/1/2023,COK,Selangor,0,0,0,Cook Islands
78606,11/1/2023,COL,Johor,11,8,3,Colombia
78607,11/1/2023,COL,Kedah,6,4,2,Colombia
78608,11/1/2023,COL,Perak,0,0,0,Colombia
78609,11/1/2023,COL,Pulau Pinang,4,2,2,Colombia
78610,11/1/2023,COL,Sabah,0,0,0,Colombia
78611,11/1/2023,COL,Sarawak,1,1,0,Colombia
78612,11/1/2023,COL,Selangor,198,110,88,Colombia
78613,11/1/2023,COL,W.P. Labuan,0,0,0,Colombia
78614,11/1/2023,COM,Johor,1,1,0,Comoros
78615,11/1/2023,COM,Kedah,0,0,0,Comoros
78616,11/1/2023,COM,Selangor,16,10,6,Comoros
78617,11/1/2023,CPV,Johor,1,0,1,Cape Verde
78618,11/1/2023,CPV,Kedah,0,0,0,Cape Verde
78619,11/1/2023,CPV,Pulau Pinang,0,0,0,Cape Verde
78620,11/1/2023,CPV,Sabah,0,0,0,Cape Verde
78621,11/1/2023,CPV,Selangor,1,0,1,Cape Verde
78622,11/1/2023,CRI,Johor,19,13,6,Costa Rica
78623,11/1/2023,CRI,Kedah,0,0,0,Costa Rica
78624,11/1/2023,CRI,Perak,0,0,0,Costa Rica
78625,11/1/2023,CRI,Perlis,0,0,0,Costa Rica
78626,11/1/2023,CRI,Pulau Pinang,3,3,0,Costa Rica
78627,11/1/2023,CRI,Sabah,1,1,0,Costa Rica
78628,11/1/2023,CRI,Sarawak,0,0,0,Costa Rica
78629,11/1/2023,CRI,Selangor,57,37,20,Costa Rica
78630,11/1/2023,CUB,Johor,5,4,1,Cuba
78631,11/1/2023,CUB,Kedah,0,0,0,Cuba
78632,11/1/2023,CUB,Perlis,0,0,0,Cuba
78633,11/1/2023,CUB,Pulau Pinang,1,0,1,Cuba
78634,11/1/2023,CUB,Sabah,0,0,0,Cuba
78635,11/1/2023,CUB,Sarawak,0,0,0,Cuba
78636,11/1/2023,CUB,Selangor,33,17,16,Cuba
78637,11/1/2023,CYP,Johor,12,4,8,Cyprus
78638,11/1/2023,CYP,Kedah,0,0,0,Cyprus
78639,11/1/2023,CYP,Perak,0,0,0,Cyprus
78640,11/1/2023,CYP,Perlis,0,0,0,Cyprus
78641,11/1/2023,CYP,Pulau Pinang,0,0,0,Cyprus
78642,11/1/2023,CYP,Sabah,1,1,0,Cyprus
78643,11/1/2023,CYP,Sarawak,1,1,0,Cyprus
78644,11/1/2023,CYP,Selangor,111,74,37,Cyprus
78645,11/1/2023,CZE,Johor,170,91,79,Czech Republic
78646,11/1/2023,CZE,Kedah,117,49,68,Czech Republic
78647,11/1/2023,CZE,Kelantan,1,0,1,Czech Republic
78648,11/1/2023,CZE,Melaka,0,0,0,Czech Republic
78649,11/1/2023,CZE,Negeri Sembilan,0,0,0,Czech Republic
78650,11/1/2023,CZE,Perak,0,0,0,Czech Republic
78651,11/1/2023,CZE,Perlis,0,0,0,Czech Republic
78652,11/1/2023,CZE,Pulau Pinang,19,11,8,Czech Republic
78653,11/1/2023,CZE,Sabah,14,9,5,Czech Republic
78654,11/1/2023,CZE,Sarawak,12,7,5,Czech Republic
78655,11/1/2023,CZE,Selangor,669,388,281,Czech Republic
78656,11/1/2023,CZE,W.P. Labuan,12,4,8,Czech Republic
78657,11/1/2023,DEU,Johor,2467,1562,905,Germany
78658,11/1/2023,DEU,Kedah,784,393,391,Germany
78659,11/1/2023,DEU,Kelantan,7,6,1,Germany
78660,11/1/2023,DEU,Melaka,0,0,0,Germany
78661,11/1/2023,DEU,Negeri Sembilan,1,1,0,Germany
78662,11/1/2023,DEU,Pahang,6,5,1,Germany
78663,11/1/2023,DEU,Perak,21,16,5,Germany
78664,11/1/2023,DEU,Perlis,87,52,35,Germany
78665,11/1/2023,DEU,Pulau Pinang,845,648,197,Germany
78666,11/1/2023,DEU,Sabah,110,74,36,Germany
78667,11/1/2023,DEU,Sarawak,158,106,52,Germany
78668,11/1/2023,DEU,Selangor,7252,4649,2603,Germany
78669,11/1/2023,DEU,Terengganu,1,1,0,Germany
78670,11/1/2023,DEU,W.P. Labuan,7,4,3,Germany
78671,11/1/2023,DJI,Johor,0,0,0,Djibouti
78672,11/1/2023,DJI,Selangor,14,9,5,Djibouti
78673,11/1/2023,DMA,Johor,2,2,0,Dominica
78674,11/1/2023,DMA,Kedah,0,0,0,Dominica
78675,11/1/2023,DMA,Pulau Pinang,0,0,0,Dominica
78676,11/1/2023,DMA,Sabah,0,0,0,Dominica
78677,11/1/2023,DMA,Sarawak,0,0,0,Dominica
78678,11/1/2023,DMA,Selangor,37,32,5,Dominica
78679,11/1/2023,DMA,W.P. Labuan,0,0,0,Dominica
78680,11/1/2023,DNK,Johor,276,216,60,Denmark
78681,11/1/2023,DNK,Kedah,141,67,74,Denmark
78682,11/1/2023,DNK,Kelantan,1,1,0,Denmark
78683,11/1/2023,DNK,Melaka,0,0,0,Denmark
78684,11/1/2023,DNK,Negeri Sembilan,4,2,2,Denmark
78685,11/1/2023,DNK,Pahang,0,0,0,Denmark
78686,11/1/2023,DNK,Perak,4,3,1,Denmark
78687,11/1/2023,DNK,Perlis,26,15,11,Denmark
78688,11/1/2023,DNK,Pulau Pinang,85,58,27,Denmark
78689,11/1/2023,DNK,Sabah,22,15,7,Denmark
78690,11/1/2023,DNK,Sarawak,9,6,3,Denmark
78691,11/1/2023,DNK,Selangor,1015,649,366,Denmark
78692,11/1/2023,DNK,W.P. Labuan,0,0,0,Denmark
78693,11/1/2023,DOM,Johor,2,0,2,Dominican Republic
78694,11/1/2023,DOM,Kedah,0,0,0,Dominican Republic
78695,11/1/2023,DOM,Perak,0,0,0,Dominican Republic
78696,11/1/2023,DOM,Perlis,0,0,0,Dominican Republic
78697,11/1/2023,DOM,Pulau Pinang,1,1,0,Dominican Republic
78698,11/1/2023,DOM,Sabah,1,0,1,Dominican Republic
78699,11/1/2023,DOM,Sarawak,0,0,0,Dominican Republic
78700,11/1/2023,DOM,Selangor,92,46,46,Dominican Republic
78701,11/1/2023,DZA,Johor,20,14,6,Algeria
78702,11/1/2023,DZA,Kedah,2,2,0,Algeria
78703,11/1/2023,DZA,Kelantan,0,0,0,Algeria
78704,11/1/2023,DZA,Melaka,0,0,0,Algeria
78705,11/1/2023,DZA,Perak,0,0,0,Algeria
78706,11/1/2023,DZA,Perlis,0,0,0,Algeria
78707,11/1/2023,DZA,Pulau Pinang,1,1,0,Algeria
78708,11/1/2023,DZA,Sabah,2,2,0,Algeria
78709,11/1/2023,DZA,Sarawak,3,3,0,Algeria
78710,11/1/2023,DZA,Selangor,767,514,253,Algeria
78711,11/1/2023,DZA,W.P. Labuan,0,0,0,Algeria
78712,11/1/2023,ECU,Johor,9,6,3,Ecuador
78713,11/1/2023,ECU,Kedah,3,0,3,Ecuador
78714,11/1/2023,ECU,Perak,0,0,0,Ecuador
78715,11/1/2023,ECU,Perlis,0,0,0,Ecuador
78716,11/1/2023,ECU,Pulau Pinang,3,1,2,Ecuador
78717,11/1/2023,ECU,Sabah,3,2,1,Ecuador
78718,11/1/2023,ECU,Sarawak,0,0,0,Ecuador
78719,11/1/2023,ECU,Selangor,105,55,50,Ecuador
78720,11/1/2023,EGY,Johor,193,160,33,Egypt
78721,11/1/2023,EGY,Kedah,7,5,2,Egypt
78722,11/1/2023,EGY,Kelantan,4,1,3,Egypt
78723,11/1/2023,EGY,Melaka,0,0,0,Egypt
78724,11/1/2023,EGY,Pahang,0,0,0,Egypt
78725,11/1/2023,EGY,Perak,0,0,0,Egypt
78726,11/1/2023,EGY,Perlis,0,0,0,Egypt
78727,11/1/2023,EGY,Pulau Pinang,14,10,4,Egypt
78728,11/1/2023,EGY,Sabah,0,0,0,Egypt
78729,11/1/2023,EGY,Sarawak,52,42,10,Egypt
78730,11/1/2023,EGY,Selangor,1948,1329,619,Egypt
78731,11/1/2023,EGY,Terengganu,0,0,0,Egypt
78732,11/1/2023,EGY,W.P. Labuan,0,0,0,Egypt
78733,11/1/2023,ERI,Johor,0,0,0,Eritrea
78734,11/1/2023,ERI,Pulau Pinang,0,0,0,Eritrea
78735,11/1/2023,ERI,Sabah,0,0,0,Eritrea
78736,11/1/2023,ERI,Selangor,26,14,12,Eritrea
78737,11/1/2023,ESP,Johor,526,330,196,Spain
78738,11/1/2023,ESP,Kedah,277,138,139,Spain
78739,11/1/2023,ESP,Kelantan,3,2,1,Spain
78740,11/1/2023,ESP,Melaka,2,1,1,Spain
78741,11/1/2023,ESP,Negeri Sembilan,1,1,0,Spain
78742,11/1/2023,ESP,Pahang,0,0,0,Spain
78743,11/1/2023,ESP,Perak,9,7,2,Spain
78744,11/1/2023,ESP,Perlis,14,10,4,Spain
78745,11/1/2023,ESP,Pulau Pinang,116,69,47,Spain
78746,11/1/2023,ESP,Sabah,31,21,10,Spain
78747,11/1/2023,ESP,Sarawak,49,29,20,Spain
78748,11/1/2023,ESP,Selangor,3435,2110,1325,Spain
78749,11/1/2023,ESP,W.P. Labuan,3,2,1,Spain
78750,11/1/2023,EST,Johor,36,17,19,Estonia
78751,11/1/2023,EST,Kedah,25,13,12,Estonia
78752,11/1/2023,EST,Kelantan,6,2,4,Estonia
78753,11/1/2023,EST,Pahang,0,0,0,Estonia
78754,11/1/2023,EST,Perak,0,0,0,Estonia
78755,11/1/2023,EST,Perlis,3,1,2,Estonia
78756,11/1/2023,EST,Pulau Pinang,3,3,0,Estonia
78757,11/1/2023,EST,Sabah,2,1,1,Estonia
78758,11/1/2023,EST,Sarawak,18,8,10,Estonia
78759,11/1/2023,EST,Selangor,283,148,135,Estonia
78760,11/1/2023,EST,W.P. Labuan,0,0,0,Estonia
78761,11/1/2023,ETH,Johor,1,1,0,Ethiopia
78762,11/1/2023,ETH,Kedah,1,0,1,Ethiopia
78763,11/1/2023,ETH,Pulau Pinang,0,0,0,Ethiopia
78764,11/1/2023,ETH,Sarawak,0,0,0,Ethiopia
78765,11/1/2023,ETH,Selangor,35,26,9,Ethiopia
78766,11/1/2023,FIN,Johor,238,148,90,Finland
78767,11/1/2023,FIN,Kedah,112,46,66,Finland
78768,11/1/2023,FIN,Kelantan,0,0,0,Finland
78769,11/1/2023,FIN,Melaka,0,0,0,Finland
78770,11/1/2023,FIN,Negeri Sembilan,3,3,0,Finland
78771,11/1/2023,FIN,Pahang,0,0,0,Finland
78772,11/1/2023,FIN,Perak,3,3,0,Finland
78773,11/1/2023,FIN,Perlis,2,2,0,Finland
78774,11/1/2023,FIN,Pulau Pinang,67,47,20,Finland
78775,11/1/2023,FIN,Sabah,10,8,2,Finland
78776,11/1/2023,FIN,Sarawak,22,10,12,Finland
78777,11/1/2023,FIN,Selangor,585,325,260,Finland
78778,11/1/2023,FIN,W.P. Labuan,0,0,0,Finland
78779,11/1/2023,FJI,Johor,58,39,19,Fiji
78780,11/1/2023,FJI,Kedah,2,0,2,Fiji
78781,11/1/2023,FJI,Kelantan,0,0,0,Fiji
78782,11/1/2023,FJI,Perak,0,0,0,Fiji
78783,11/1/2023,FJI,Perlis,0,0,0,Fiji
78784,11/1/2023,FJI,Pulau Pinang,1,1,0,Fiji
78785,11/1/2023,FJI,Sabah,0,0,0,Fiji
78786,11/1/2023,FJI,Sarawak,1,1,0,Fiji
78787,11/1/2023,FJI,Selangor,127,59,68,Fiji
78788,11/1/2023,FRA,Johor,1868,1182,686,France
78789,11/1/2023,FRA,Kedah,412,242,170,France
78790,11/1/2023,FRA,Kelantan,16,12,4,France
78791,11/1/2023,FRA,Melaka,3,1,2,France
78792,11/1/2023,FRA,Negeri Sembilan,5,3,2,France
78793,11/1/2023,FRA,Pahang,13,7,6,France
78794,11/1/2023,FRA,Perak,27,22,5,France
78795,11/1/2023,FRA,Perlis,44,33,11,France
78796,11/1/2023,FRA,Pulau Pinang,425,282,143,France
78797,11/1/2023,FRA,Sabah,78,49,29,France
78798,11/1/2023,FRA,Sarawak,82,54,28,France
78799,11/1/2023,FRA,Selangor,7412,4785,2627,France
78800,11/1/2023,FRA,Terengganu,0,0,0,France
78801,11/1/2023,FRA,W.P. Labuan,3,3,0,France
78802,11/1/2023,FSM,Johor,0,0,0,"Micronesia, Federated States of"
78803,11/1/2023,FSM,Pulau Pinang,0,0,0,"Micronesia, Federated States of"
78804,11/1/2023,FSM,Selangor,10,5,5,"Micronesia, Federated States of"
78805,11/1/2023,GAB,Johor,1,0,1,Gabon
78806,11/1/2023,GAB,Pulau Pinang,0,0,0,Gabon
78807,11/1/2023,GAB,Sarawak,0,0,0,Gabon
78808,11/1/2023,GAB,Selangor,11,7,4,Gabon
78809,11/1/2023,GBR,Johor,4695,2980,1715,United Kingdom
78810,11/1/2023,GBR,Kedah,1202,650,552,United Kingdom
78811,11/1/2023,GBR,Kelantan,23,15,8,United Kingdom
78812,11/1/2023,GBR,Melaka,5,4,1,United Kingdom
78813,11/1/2023,GBR,Negeri Sembilan,0,0,0,United Kingdom
78814,11/1/2023,GBR,Pahang,14,10,4,United Kingdom
78815,11/1/2023,GBR,Perak,88,55,33,United Kingdom
78816,11/1/2023,GBR,Perlis,138,89,49,United Kingdom
78817,11/1/2023,GBR,Pulau Pinang,1688,1001,687,United Kingdom
78818,11/1/2023,GBR,Sabah,265,140,125,United Kingdom
78819,11/1/2023,GBR,Sarawak,669,431,238,United Kingdom
78820,11/1/2023,GBR,Selangor,17675,11303,6372,United Kingdom
78821,11/1/2023,GBR,Terengganu,0,0,0,United Kingdom
78822,11/1/2023,GBR,W.P. Labuan,39,31,8,United Kingdom
78823,11/1/2023,GEO,Johor,12,9,3,Georgia
78824,11/1/2023,GEO,Kedah,1,1,0,Georgia
78825,11/1/2023,GEO,Melaka,0,0,0,Georgia
78826,11/1/2023,GEO,Perak,0,0,0,Georgia
78827,11/1/2023,GEO,Perlis,0,0,0,Georgia
78828,11/1/2023,GEO,Pulau Pinang,3,0,3,Georgia
78829,11/1/2023,GEO,Sabah,0,0,0,Georgia
78830,11/1/2023,GEO,Sarawak,0,0,0,Georgia
78831,11/1/2023,GEO,Selangor,48,30,18,Georgia
78832,11/1/2023,GHA,Johor,6,4,2,Ghana
78833,11/1/2023,GHA,Kedah,0,0,0,Ghana
78834,11/1/2023,GHA,Kelantan,0,0,0,Ghana
78835,11/1/2023,GHA,Pulau Pinang,0,0,0,Ghana
78836,11/1/2023,GHA,Sabah,0,0,0,Ghana
78837,11/1/2023,GHA,Sarawak,0,0,0,Ghana
78838,11/1/2023,GHA,Selangor,125,84,41,Ghana
78839,11/1/2023,GIB,Johor,0,0,0,Gibraltar
78840,11/1/2023,GIB,Sarawak,0,0,0,Gibraltar
78841,11/1/2023,GIN,Johor,4,2,2,Guinea
78842,11/1/2023,GIN,Kedah,1,0,1,Guinea
78843,11/1/2023,GIN,Kelantan,0,0,0,Guinea
78844,11/1/2023,GIN,Perlis,0,0,0,Guinea
78845,11/1/2023,GIN,Pulau Pinang,0,0,0,Guinea
78846,11/1/2023,GIN,Sabah,0,0,0,Guinea
78847,11/1/2023,GIN,Sarawak,0,0,0,Guinea
78848,11/1/2023,GIN,Selangor,61,44,17,Guinea
78849,11/1/2023,GLP,Selangor,0,0,0,Guadeloupe
78850,11/1/2023,GMB,Johor,1,0,1,Gambia
78851,11/1/2023,GMB,Kedah,0,0,0,Gambia
78852,11/1/2023,GMB,Kelantan,0,0,0,Gambia
78853,11/1/2023,GMB,Pulau Pinang,0,0,0,Gambia
78854,11/1/2023,GMB,Sabah,0,0,0,Gambia
78855,11/1/2023,GMB,Sarawak,0,0,0,Gambia
78856,11/1/2023,GMB,Selangor,28,21,7,Gambia
78857,11/1/2023,GNB,Johor,0,0,0,Guinea-Bissau
78858,11/1/2023,GNB,Selangor,1,0,1,Guinea-Bissau
78859,11/1/2023,GNQ,Johor,0,0,0,Equatorial Guinea
78860,11/1/2023,GNQ,Selangor,0,0,0,Equatorial Guinea
78861,11/1/2023,GRC,Johor,71,48,23,Greece
78862,11/1/2023,GRC,Kedah,6,2,4,Greece
78863,11/1/2023,GRC,Kelantan,0,0,0,Greece
78864,11/1/2023,GRC,Melaka,0,0,0,Greece
78865,11/1/2023,GRC,Negeri Sembilan,0,0,0,Greece
78866,11/1/2023,GRC,Pahang,0,0,0,Greece
78867,11/1/2023,GRC,Perak,0,0,0,Greece
78868,11/1/2023,GRC,Perlis,3,1,2,Greece
78869,11/1/2023,GRC,Pulau Pinang,21,12,9,Greece
78870,11/1/2023,GRC,Sabah,2,2,0,Greece
78871,11/1/2023,GRC,Sarawak,4,4,0,Greece
78872,11/1/2023,GRC,Selangor,293,212,81,Greece
78873,11/1/2023,GRD,Johor,2,0,2,Grenada
78874,11/1/2023,GRD,Kedah,0,0,0,Grenada
78875,11/1/2023,GRD,Pulau Pinang,1,1,0,Grenada
78876,11/1/2023,GRD,Sabah,0,0,0,Grenada
78877,11/1/2023,GRD,Sarawak,0,0,0,Grenada
78878,11/1/2023,GRD,Selangor,9,8,1,Grenada
78879,11/1/2023,GRL,Johor,0,0,0,Greenland
78880,11/1/2023,GRL,Selangor,0,0,0,Greenland
78881,11/1/2023,GTM,Johor,6,2,4,Guatemala
78882,11/1/2023,GTM,Kedah,1,1,0,Guatemala
78883,11/1/2023,GTM,Pahang,0,0,0,Guatemala
78884,11/1/2023,GTM,Perak,0,0,0,Guatemala
78885,11/1/2023,GTM,Pulau Pinang,7,5,2,Guatemala
78886,11/1/2023,GTM,Sabah,0,0,0,Guatemala
78887,11/1/2023,GTM,Sarawak,0,0,0,Guatemala
78888,11/1/2023,GTM,Selangor,63,39,24,Guatemala
78889,11/1/2023,GTM,W.P. Labuan,0,0,0,Guatemala
78890,11/1/2023,GUY,Johor,1,0,1,Guyana
78891,11/1/2023,GUY,Kedah,0,0,0,Guyana
78892,11/1/2023,GUY,Pulau Pinang,0,0,0,Guyana
78893,11/1/2023,GUY,Sarawak,0,0,0,Guyana
78894,11/1/2023,GUY,Selangor,16,10,6,Guyana
78895,11/1/2023,HKG,Johor,6,1,5,Hong Kong
78896,11/1/2023,HKG,Kedah,0,0,0,Hong Kong
78897,11/1/2023,HKG,Kelantan,0,0,0,Hong Kong
78898,11/1/2023,HKG,Pahang,4,2,2,Hong Kong
78899,11/1/2023,HKG,Perak,51,29,22,Hong Kong
78900,11/1/2023,HKG,Perlis,2,2,0,Hong Kong
78901,11/1/2023,HKG,Pulau Pinang,0,0,0,Hong Kong
78902,11/1/2023,HKG,Sabah,53,28,25,Hong Kong
78903,11/1/2023,HKG,Sarawak,0,0,0,Hong Kong
78904,11/1/2023,HKG,Selangor,42,15,27,Hong Kong
78905,11/1/2023,HKG,Terengganu,0,0,0,Hong Kong
78906,11/1/2023,HMD,Johor,0,0,0,Heard Island and McDonald Islands
78907,11/1/2023,HND,Johor,6,4,2,Honduras
78908,11/1/2023,HND,Kedah,1,1,0,Honduras
78909,11/1/2023,HND,Perak,0,0,0,Honduras
78910,11/1/2023,HND,Pulau Pinang,0,0,0,Honduras
78911,11/1/2023,HND,Sabah,0,0,0,Honduras
78912,11/1/2023,HND,Sarawak,0,0,0,Honduras
78913,11/1/2023,HND,Selangor,26,16,10,Honduras
78914,11/1/2023,HRV,Johor,60,31,29,Croatia
78915,11/1/2023,HRV,Kedah,2,0,2,Croatia
78916,11/1/2023,HRV,Kelantan,0,0,0,Croatia
78917,11/1/2023,HRV,Melaka,1,1,0,Croatia
78918,11/1/2023,HRV,Pahang,0,0,0,Croatia
78919,11/1/2023,HRV,Perak,0,0,0,Croatia
78920,11/1/2023,HRV,Perlis,0,0,0,Croatia
78921,11/1/2023,HRV,Pulau Pinang,3,2,1,Croatia
78922,11/1/2023,HRV,Sabah,8,7,1,Croatia
78923,11/1/2023,HRV,Sarawak,1,1,0,Croatia
78924,11/1/2023,HRV,Selangor,243,139,104,Croatia
78925,11/1/2023,HTI,Johor,1,1,0,Haiti
78926,11/1/2023,HTI,Kedah,0,0,0,Haiti
78927,11/1/2023,HTI,Kelantan,0,0,0,Haiti
78928,11/1/2023,HTI,Perak,0,0,0,Haiti
78929,11/1/2023,HTI,Pulau Pinang,0,0,0,Haiti
78930,11/1/2023,HTI,Sabah,0,0,0,Haiti
78931,11/1/2023,HTI,Selangor,9,6,3,Haiti
78932,11/1/2023,HUN,Johor,108,66,42,Hungary
78933,11/1/2023,HUN,Kedah,30,13,17,Hungary
78934,11/1/2023,HUN,Kelantan,0,0,0,Hungary
78935,11/1/2023,HUN,Pahang,0,0,0,Hungary
78936,11/1/2023,HUN,Perak,1,1,0,Hungary
78937,11/1/2023,HUN,Perlis,2,0,2,Hungary
78938,11/1/2023,HUN,Pulau Pinang,30,15,15,Hungary
78939,11/1/2023,HUN,Sabah,1,0,1,Hungary
78940,11/1/2023,HUN,Sarawak,6,4,2,Hungary
78941,11/1/2023,HUN,Selangor,550,299,251,Hungary
78942,11/1/2023,HUN,W.P. Labuan,0,0,0,Hungary
78943,11/1/2023,IDN,Johor,96612,45154,51458,Indonesia
78944,11/1/2023,IDN,Kedah,5183,1900,3283,Indonesia
78945,11/1/2023,IDN,Kelantan,139,80,59,Indonesia
78946,11/1/2023,IDN,Melaka,3624,1639,1985,Indonesia
78947,11/1/2023,IDN,Negeri Sembilan,5507,3369,2138,Indonesia
78948,11/1/2023,IDN,Pahang,17,7,10,Indonesia
78949,11/1/2023,IDN,Perak,217,84,133,Indonesia
78950,11/1/2023,IDN,Perlis,652,255,397,Indonesia
78951,11/1/2023,IDN,Pulau Pinang,39593,15700,23893,Indonesia
78952,11/1/2023,IDN,Sabah,4552,2211,2341,Indonesia
78953,11/1/2023,IDN,Sarawak,35677,19271,16406,Indonesia
78954,11/1/2023,IDN,Selangor,139070,66141,72929,Indonesia
78955,11/1/2023,IDN,Terengganu,0,0,0,Indonesia
78956,11/1/2023,IDN,W.P. Labuan,43,22,21,Indonesia
78957,11/1/2023,IND,Johor,19940,13134,6806,India
78958,11/1/2023,IND,Kedah,1165,622,543,India
78959,11/1/2023,IND,Kelantan,7,5,2,India
78960,11/1/2023,IND,Melaka,12,12,0,India
78961,11/1/2023,IND,Negeri Sembilan,1,1,0,India
78962,11/1/2023,IND,Pahang,15,12,3,India
78963,11/1/2023,IND,Perak,163,122,41,India
78964,11/1/2023,IND,Perlis,18,14,4,India
78965,11/1/2023,IND,Pulau Pinang,895,674,221,India
78966,11/1/2023,IND,Sabah,189,143,46,India
78967,11/1/2023,IND,Sarawak,1029,824,205,India
78968,11/1/2023,IND,Selangor,48321,33365,14956,India
78969,11/1/2023,IND,Terengganu,0,0,0,India
78970,11/1/2023,IND,W.P. Labuan,31,29,2,India
78971,11/1/2023,IOT,Pulau Pinang,1,0,1,British Indian Ocean Territory
78972,11/1/2023,IOT,Selangor,1,0,1,British Indian Ocean Territory
78973,11/1/2023,IRL,Johor,296,192,104,Ireland
78974,11/1/2023,IRL,Kedah,69,35,34,Ireland
78975,11/1/2023,IRL,Kelantan,1,1,0,Ireland
78976,11/1/2023,IRL,Negeri Sembilan,0,0,0,Ireland
78977,11/1/2023,IRL,Pahang,0,0,0,Ireland
78978,11/1/2023,IRL,Perak,2,0,2,Ireland
78979,11/1/2023,IRL,Perlis,17,12,5,Ireland
78980,11/1/2023,IRL,Pulau Pinang,100,66,34,Ireland
78981,11/1/2023,IRL,Sabah,12,9,3,Ireland
78982,11/1/2023,IRL,Sarawak,36,13,23,Ireland
78983,11/1/2023,IRL,Selangor,1383,861,522,Ireland
78984,11/1/2023,IRL,Terengganu,2,2,0,Ireland
78985,11/1/2023,IRL,W.P. Labuan,2,1,1,Ireland
78986,11/1/2023,IRN,Johor,256,134,122,Iran
78987,11/1/2023,IRN,Kedah,7,4,3,Iran
78988,11/1/2023,IRN,Kelantan,0,0,0,Iran
78989,11/1/2023,IRN,Perak,0,0,0,Iran
78990,11/1/2023,IRN,Perlis,2,2,0,Iran
78991,11/1/2023,IRN,Pulau Pinang,12,7,5,Iran
78992,11/1/2023,IRN,Sabah,2,2,0,Iran
78993,11/1/2023,IRN,Sarawak,5,5,0,Iran
78994,11/1/2023,IRN,Selangor,2308,1253,1055,Iran
78995,11/1/2023,IRN,W.P. Labuan,0,0,0,Iran
78996,11/1/2023,IRQ,Johor,17,14,3,Iraq
78997,11/1/2023,IRQ,Kedah,2,1,1,Iraq
78998,11/1/2023,IRQ,Kelantan,0,0,0,Iraq
78999,11/1/2023,IRQ,Melaka,0,0,0,Iraq
79000,11/1/2023,IRQ,Pahang,0,0,0,Iraq
79001,11/1/2023,IRQ,Perak,0,0,0,Iraq
79002,11/1/2023,IRQ,Perlis,0,0,0,Iraq
79003,11/1/2023,IRQ,Pulau Pinang,3,2,1,Iraq
79004,11/1/2023,IRQ,Sabah,0,0,0,Iraq
79005,11/1/2023,IRQ,Sarawak,3,1,2,Iraq
79006,11/1/2023,IRQ,Selangor,1358,947,411,Iraq
79007,11/1/2023,ISL,Johor,16,9,7,Iceland
79008,11/1/2023,ISL,Kedah,1,1,0,Iceland
79009,11/1/2023,ISL,Kelantan,0,0,0,Iceland
79010,11/1/2023,ISL,Perak,0,0,0,Iceland
79011,11/1/2023,ISL,Perlis,0,0,0,Iceland
79012,11/1/2023,ISL,Pulau Pinang,1,1,0,Iceland
79013,11/1/2023,ISL,Sabah,5,4,1,Iceland
79014,11/1/2023,ISL,Sarawak,0,0,0,Iceland
79015,11/1/2023,ISL,Selangor,34,18,16,Iceland
79016,11/1/2023,ISL,W.P. Labuan,0,0,0,Iceland
79017,11/1/2023,ISR,Pulau Pinang,0,0,0,Israel
79018,11/1/2023,ITA,Johor,586,407,179,Italy
79019,11/1/2023,ITA,Kedah,200,108,92,Italy
79020,11/1/2023,ITA,Kelantan,3,3,0,Italy
79021,11/1/2023,ITA,Melaka,0,0,0,Italy
79022,11/1/2023,ITA,Negeri Sembilan,0,0,0,Italy
79023,11/1/2023,ITA,Pahang,2,2,0,Italy
79024,11/1/2023,ITA,Perak,3,2,1,Italy
79025,11/1/2023,ITA,Perlis,17,10,7,Italy
79026,11/1/2023,ITA,Pulau Pinang,141,107,34,Italy
79027,11/1/2023,ITA,Sabah,19,12,7,Italy
79028,11/1/2023,ITA,Sarawak,33,26,7,Italy
79029,11/1/2023,ITA,Selangor,3126,2253,873,Italy
79030,11/1/2023,ITA,W.P. Labuan,0,0,0,Italy
79031,11/1/2023,JAM,Johor,0,0,0,Jamaica
79032,11/1/2023,JAM,Kedah,0,0,0,Jamaica
79033,11/1/2023,JAM,Perak,0,0,0,Jamaica
79034,11/1/2023,JAM,Pulau Pinang,1,1,0,Jamaica
79035,11/1/2023,JAM,Sabah,0,0,0,Jamaica
79036,11/1/2023,JAM,Sarawak,1,1,0,Jamaica
79037,11/1/2023,JAM,Selangor,36,10,26,Jamaica
79038,11/1/2023,JAM,W.P. Labuan,0,0,0,Jamaica
79039,11/1/2023,JOR,Johor,15,11,4,Jordan
79040,11/1/2023,JOR,Kedah,5,4,1,Jordan
79041,11/1/2023,JOR,Kelantan,0,0,0,Jordan
79042,11/1/2023,JOR,Melaka,0,0,0,Jordan
79043,11/1/2023,JOR,Perlis,1,1,0,Jordan
79044,11/1/2023,JOR,Pulau Pinang,14,11,3,Jordan
79045,11/1/2023,JOR,Sabah,0,0,0,Jordan
79046,11/1/2023,JOR,Sarawak,0,0,0,Jordan
79047,11/1/2023,JOR,Selangor,709,470,239,Jordan
79048,11/1/2023,JOR,W.P. Labuan,0,0,0,Jordan
79049,11/1/2023,JPN,Johor,7015,4526,2489,Japan
79050,11/1/2023,JPN,Kedah,279,136,143,Japan
79051,11/1/2023,JPN,Kelantan,12,9,3,Japan
79052,11/1/2023,JPN,Melaka,2,2,0,Japan
79053,11/1/2023,JPN,Negeri Sembilan,0,0,0,Japan
79054,11/1/2023,JPN,Pahang,18,14,4,Japan
79055,11/1/2023,JPN,Perak,85,59,26,Japan
79056,11/1/2023,JPN,Perlis,53,46,7,Japan
79057,11/1/2023,JPN,Pulau Pinang,1327,982,345,Japan
79058,11/1/2023,JPN,Sabah,225,132,93,Japan
79059,11/1/2023,JPN,Sarawak,227,148,79,Japan
79060,11/1/2023,JPN,Selangor,20707,13397,7310,Japan
79061,11/1/2023,JPN,W.P. Labuan,13,8,5,Japan
79062,11/1/2023,KAZ,Johor,36,17,19,Kazakhstan
79063,11/1/2023,KAZ,Kedah,8,4,4,Kazakhstan
79064,11/1/2023,KAZ,Kelantan,1,0,1,Kazakhstan
79065,11/1/2023,KAZ,Melaka,0,0,0,Kazakhstan
79066,11/1/2023,KAZ,Perak,0,0,0,Kazakhstan
79067,11/1/2023,KAZ,Perlis,6,2,4,Kazakhstan
79068,11/1/2023,KAZ,Pulau Pinang,12,5,7,Kazakhstan
79069,11/1/2023,KAZ,Sabah,4,1,3,Kazakhstan
79070,11/1/2023,KAZ,Sarawak,13,6,7,Kazakhstan
79071,11/1/2023,KAZ,Selangor,892,375,517,Kazakhstan
79072,11/1/2023,KAZ,W.P. Labuan,0,0,0,Kazakhstan
79073,11/1/2023,KEN,Johor,68,26,42,Kenya
79074,11/1/2023,KEN,Kedah,2,1,1,Kenya
79075,11/1/2023,KEN,Kelantan,0,0,0,Kenya
79076,11/1/2023,KEN,Perak,0,0,0,Kenya
79077,11/1/2023,KEN,Perlis,0,0,0,Kenya
79078,11/1/2023,KEN,Pulau Pinang,6,4,2,Kenya
79079,11/1/2023,KEN,Sabah,0,0,0,Kenya
79080,11/1/2023,KEN,Sarawak,3,1,2,Kenya
79081,11/1/2023,KEN,Selangor,582,286,296,Kenya
79082,11/1/2023,KGZ,Johor,26,18,8,Kyrgyzstan
79083,11/1/2023,KGZ,Kedah,3,3,0,Kyrgyzstan
79084,11/1/2023,KGZ,Kelantan,0,0,0,Kyrgyzstan
79085,11/1/2023,KGZ,Perak,0,0,0,Kyrgyzstan
79086,11/1/2023,KGZ,Perlis,1,0,1,Kyrgyzstan
79087,11/1/2023,KGZ,Pulau Pinang,2,2,0,Kyrgyzstan
79088,11/1/2023,KGZ,Sabah,0,0,0,Kyrgyzstan
79089,11/1/2023,KGZ,Sarawak,0,0,0,Kyrgyzstan
79090,11/1/2023,KGZ,Selangor,281,157,124,Kyrgyzstan
79091,11/1/2023,KHM,Johor,2846,1218,1628,Cambodia
79092,11/1/2023,KHM,Kedah,109,57,52,Cambodia
79093,11/1/2023,KHM,Kelantan,354,181,173,Cambodia
79094,11/1/2023,KHM,Melaka,0,0,0,Cambodia
79095,11/1/2023,KHM,Negeri Sembilan,0,0,0,Cambodia
79096,11/1/2023,KHM,Pahang,0,0,0,Cambodia
79097,11/1/2023,KHM,Perak,14,4,10,Cambodia
79098,11/1/2023,KHM,Perlis,618,344,274,Cambodia
79099,11/1/2023,KHM,Pulau Pinang,45,22,23,Cambodia
79100,11/1/2023,KHM,Sabah,3,0,3,Cambodia
79101,11/1/2023,KHM,Sarawak,7,1,6,Cambodia
79102,11/1/2023,KHM,Selangor,4255,1991,2264,Cambodia
79103,11/1/2023,KHM,W.P. Labuan,0,0,0,Cambodia
79104,11/1/2023,KIR,Johor,0,0,0,Kiribati
79105,11/1/2023,KIR,Sabah,0,0,0,Kiribati
79106,11/1/2023,KIR,Selangor,0,0,0,Kiribati
79107,11/1/2023,KNA,Johor,26,16,10,Saint Kitts and Nevis
79108,11/1/2023,KNA,Kedah,2,1,1,Saint Kitts and Nevis
79109,11/1/2023,KNA,Perlis,0,0,0,Saint Kitts and Nevis
79110,11/1/2023,KNA,Pulau Pinang,0,0,0,Saint Kitts and Nevis
79111,11/1/2023,KNA,Sabah,0,0,0,Saint Kitts and Nevis
79112,11/1/2023,KNA,Selangor,56,44,12,Saint Kitts and Nevis
79113,11/1/2023,KNA,W.P. Labuan,0,0,0,Saint Kitts and Nevis
79114,11/1/2023,KOR,Johor,9723,5285,4438,"Korea, Republic of (South Korea)"
79115,11/1/2023,KOR,Kedah,209,106,103,"Korea, Republic of (South Korea)"
79116,11/1/2023,KOR,Kelantan,2,1,1,"Korea, Republic of (South Korea)"
79117,11/1/2023,KOR,Melaka,1,1,0,"Korea, Republic of (South Korea)"
79118,11/1/2023,KOR,Negeri Sembilan,0,0,0,"Korea, Republic of (South Korea)"
79119,11/1/2023,KOR,Pahang,5,3,2,"Korea, Republic of (South Korea)"
79120,11/1/2023,KOR,Perak,31,14,17,"Korea, Republic of (South Korea)"
79121,11/1/2023,KOR,Perlis,52,34,18,"Korea, Republic of (South Korea)"
79122,11/1/2023,KOR,Pulau Pinang,475,289,186,"Korea, Republic of (South Korea)"
79123,11/1/2023,KOR,Sabah,9304,3884,5420,"Korea, Republic of (South Korea)"
79124,11/1/2023,KOR,Sarawak,194,116,78,"Korea, Republic of (South Korea)"
79125,11/1/2023,KOR,Selangor,14482,8292,6190,"Korea, Republic of (South Korea)"
79126,11/1/2023,KOR,Terengganu,0,0,0,"Korea, Republic of (South Korea)"
79127,11/1/2023,KOR,W.P. Labuan,1,0,1,"Korea, Republic of (South Korea)"
79128,11/1/2023,KWT,Johor,18,8,10,Kuwait
79129,11/1/2023,KWT,Kedah,4,2,2,Kuwait
79130,11/1/2023,KWT,Kelantan,0,0,0,Kuwait
79131,11/1/2023,KWT,Perak,0,0,0,Kuwait
79132,11/1/2023,KWT,Perlis,3,3,0,Kuwait
79133,11/1/2023,KWT,Pulau Pinang,2,1,1,Kuwait
79134,11/1/2023,KWT,Sabah,0,0,0,Kuwait
79135,11/1/2023,KWT,Sarawak,0,0,0,Kuwait
79136,11/1/2023,KWT,Selangor,287,184,103,Kuwait
79137,11/1/2023,KWT,W.P. Labuan,0,0,0,Kuwait
79138,11/1/2023,LAO,Johor,186,60,126,Lao People's Democratic Republic
79139,11/1/2023,LAO,Kedah,873,72,801,Lao People's Democratic Republic
79140,11/1/2023,LAO,Kelantan,138,7,131,Lao People's Democratic Republic
79141,11/1/2023,LAO,Melaka,0,0,0,Lao People's Democratic Republic
79142,11/1/2023,LAO,Perak,36,5,31,Lao People's Democratic Republic
79143,11/1/2023,LAO,Perlis,463,76,387,Lao People's Democratic Republic
79144,11/1/2023,LAO,Pulau Pinang,21,7,14,Lao People's Democratic Republic
79145,11/1/2023,LAO,Sabah,0,0,0,Lao People's Democratic Republic
79146,11/1/2023,LAO,Sarawak,8,2,6,Lao People's Democratic Republic
79147,11/1/2023,LAO,Selangor,318,154,164,Lao People's Democratic Republic
79148,11/1/2023,LAO,W.P. Labuan,1,0,1,Lao People's Democratic Republic
79149,11/1/2023,LBN,Johor,13,9,4,Lebanon
79150,11/1/2023,LBN,Kedah,7,3,4,Lebanon
79151,11/1/2023,LBN,Kelantan,0,0,0,Lebanon
79152,11/1/2023,LBN,Pahang,0,0,0,Lebanon
79153,11/1/2023,LBN,Perak,1,1,0,Lebanon
79154,11/1/2023,LBN,Perlis,0,0,0,Lebanon
79155,11/1/2023,LBN,Pulau Pinang,3,2,1,Lebanon
79156,11/1/2023,LBN,Sabah,2,2,0,Lebanon
79157,11/1/2023,LBN,Sarawak,2,2,0,Lebanon
79158,11/1/2023,LBN,Selangor,301,194,107,Lebanon
79159,11/1/2023,LBN,W.P. Labuan,0,0,0,Lebanon
79160,11/1/2023,LBR,Johor,0,0,0,Liberia
79161,11/1/2023,LBR,Kedah,0,0,0,Liberia
79162,11/1/2023,LBR,Sabah,0,0,0,Liberia
79163,11/1/2023,LBR,Sarawak,1,1,0,Liberia
79164,11/1/2023,LBR,Selangor,8,8,0,Liberia
79165,11/1/2023,LBY,Johor,0,0,0,Libyan Arab Jamahiriya
79166,11/1/2023,LBY,Kedah,0,0,0,Libyan Arab Jamahiriya
79167,11/1/2023,LBY,Perlis,0,0,0,Libyan Arab Jamahiriya
79168,11/1/2023,LBY,Pulau Pinang,0,0,0,Libyan Arab Jamahiriya
79169,11/1/2023,LBY,Sabah,0,0,0,Libyan Arab Jamahiriya
79170,11/1/2023,LBY,Sarawak,2,1,1,Libyan Arab Jamahiriya
79171,11/1/2023,LBY,Selangor,405,301,104,Libyan Arab Jamahiriya
79172,11/1/2023,LCA,Johor,4,3,1,Saint Lucia
79173,11/1/2023,LCA,Kedah,0,0,0,Saint Lucia
79174,11/1/2023,LCA,Pulau Pinang,2,2,0,Saint Lucia
79175,11/1/2023,LCA,Sarawak,1,1,0,Saint Lucia
79176,11/1/2023,LCA,Selangor,6,6,0,Saint Lucia
79177,11/1/2023,LIE,Johor,0,0,0,Liechtenstein
79178,11/1/2023,LIE,Kedah,1,1,0,Liechtenstein
79179,11/1/2023,LIE,Perlis,0,0,0,Liechtenstein
79180,11/1/2023,LIE,Pulau Pinang,3,2,1,Liechtenstein
79181,11/1/2023,LIE,Sabah,0,0,0,Liechtenstein
79182,11/1/2023,LIE,Sarawak,0,0,0,Liechtenstein
79183,11/1/2023,LIE,Selangor,7,6,1,Liechtenstein
79184,11/1/2023,LKA,Johor,817,539,278,Sri Lanka
79185,11/1/2023,LKA,Kedah,48,33,15,Sri Lanka
79186,11/1/2023,LKA,Kelantan,0,0,0,Sri Lanka
79187,11/1/2023,LKA,Melaka,0,0,0,Sri Lanka
79188,11/1/2023,LKA,Pahang,0,0,0,Sri Lanka
79189,11/1/2023,LKA,Perak,2,1,1,Sri Lanka
79190,11/1/2023,LKA,Perlis,0,0,0,Sri Lanka
79191,11/1/2023,LKA,Pulau Pinang,39,22,17,Sri Lanka
79192,11/1/2023,LKA,Sabah,15,10,5,Sri Lanka
79193,11/1/2023,LKA,Sarawak,17,14,3,Sri Lanka
79194,11/1/2023,LKA,Selangor,4946,3188,1758,Sri Lanka
79195,11/1/2023,LKA,W.P. Labuan,0,0,0,Sri Lanka
79196,11/1/2023,LSO,Johor,0,0,0,Lesotho
79197,11/1/2023,LSO,Kedah,0,0,0,Lesotho
79198,11/1/2023,LSO,Pulau Pinang,0,0,0,Lesotho
79199,11/1/2023,LSO,Sarawak,0,0,0,Lesotho
79200,11/1/2023,LSO,Selangor,3,0,3,Lesotho
79201,11/1/2023,LTU,Johor,107,44,63,Lithuania
79202,11/1/2023,LTU,Kedah,65,29,36,Lithuania
79203,11/1/2023,LTU,Kelantan,1,1,0,Lithuania
79204,11/1/2023,LTU,Pahang,0,0,0,Lithuania
79205,11/1/2023,LTU,Perak,1,0,1,Lithuania
79206,11/1/2023,LTU,Perlis,1,1,0,Lithuania
79207,11/1/2023,LTU,Pulau Pinang,14,5,9,Lithuania
79208,11/1/2023,LTU,Sabah,2,1,1,Lithuania
79209,11/1/2023,LTU,Sarawak,4,1,3,Lithuania
79210,11/1/2023,LTU,Selangor,486,247,239,Lithuania
79211,11/1/2023,LTU,W.P. Labuan,22,10,12,Lithuania
79212,11/1/2023,LUX,Johor,12,10,2,Luxembourg
79213,11/1/2023,LUX,Kedah,4,3,1,Luxembourg
79214,11/1/2023,LUX,Kelantan,0,0,0,Luxembourg
79215,11/1/2023,LUX,Perak,0,0,0,Luxembourg
79216,11/1/2023,LUX,Perlis,0,0,0,Luxembourg
79217,11/1/2023,LUX,Pulau Pinang,5,3,2,Luxembourg
79218,11/1/2023,LUX,Sabah,0,0,0,Luxembourg
79219,11/1/2023,LUX,Sarawak,0,0,0,Luxembourg
79220,11/1/2023,LUX,Selangor,51,37,14,Luxembourg
79221,11/1/2023,LVA,Johor,69,20,49,Latvia
79222,11/1/2023,LVA,Kedah,6,4,2,Latvia
79223,11/1/2023,LVA,Kelantan,1,0,1,Latvia
79224,11/1/2023,LVA,Pahang,0,0,0,Latvia
79225,11/1/2023,LVA,Perak,1,1,0,Latvia
79226,11/1/2023,LVA,Perlis,2,2,0,Latvia
79227,11/1/2023,LVA,Pulau Pinang,6,2,4,Latvia
79228,11/1/2023,LVA,Sabah,3,1,2,Latvia
79229,11/1/2023,LVA,Sarawak,16,5,11,Latvia
79230,11/1/2023,LVA,Selangor,208,96,112,Latvia
79231,11/1/2023,LVA,W.P. Labuan,0,0,0,Latvia
79232,11/1/2023,MAC,Johor,0,0,0,Macao
79233,11/1/2023,MAC,Pahang,0,0,0,Macao
79234,11/1/2023,MAC,Perak,0,0,0,Macao
79235,11/1/2023,MAC,Selangor,0,0,0,Macao
79236,11/1/2023,MAC,W.P. Labuan,0,0,0,Macao
79237,11/1/2023,MAR,Johor,78,50,28,Morocco
79238,11/1/2023,MAR,Kedah,12,7,5,Morocco
79239,11/1/2023,MAR,Kelantan,1,1,0,Morocco
79240,11/1/2023,MAR,Melaka,0,0,0,Morocco
79241,11/1/2023,MAR,Pahang,0,0,0,Morocco
79242,11/1/2023,MAR,Perak,0,0,0,Morocco
79243,11/1/2023,MAR,Perlis,0,0,0,Morocco
79244,11/1/2023,MAR,Pulau Pinang,8,8,0,Morocco
79245,11/1/2023,MAR,Sabah,0,0,0,Morocco
79246,11/1/2023,MAR,Sarawak,8,5,3,Morocco
79247,11/1/2023,MAR,Selangor,835,456,379,Morocco
79248,11/1/2023,MAR,W.P. Labuan,0,0,0,Morocco
79249,11/1/2023,MCO,Johor,0,0,0,Monaco
79250,11/1/2023,MCO,Kedah,1,1,0,Monaco
79251,11/1/2023,MCO,Sabah,1,1,0,Monaco
79252,11/1/2023,MCO,Selangor,5,5,0,Monaco
79253,11/1/2023,MDA,Johor,1,1,0,"Moldova, Republic of"
79254,11/1/2023,MDA,Kedah,0,0,0,"Moldova, Republic of"
79255,11/1/2023,MDA,Kelantan,0,0,0,"Moldova, Republic of"
79256,11/1/2023,MDA,Negeri Sembilan,0,0,0,"Moldova, Republic of"
79257,11/1/2023,MDA,Perlis,0,0,0,"Moldova, Republic of"
79258,11/1/2023,MDA,Pulau Pinang,0,0,0,"Moldova, Republic of"
79259,11/1/2023,MDA,Sabah,0,0,0,"Moldova, Republic of"
79260,11/1/2023,MDA,Sarawak,0,0,0,"Moldova, Republic of"
79261,11/1/2023,MDA,Selangor,33,20,13,"Moldova, Republic of"
79262,11/1/2023,MDG,Johor,3,1,2,Madagascar
79263,11/1/2023,MDG,Kedah,0,0,0,Madagascar
79264,11/1/2023,MDG,Perak,0,0,0,Madagascar
79265,11/1/2023,MDG,Perlis,0,0,0,Madagascar
79266,11/1/2023,MDG,Pulau Pinang,0,0,0,Madagascar
79267,11/1/2023,MDG,Sabah,0,0,0,Madagascar
79268,11/1/2023,MDG,Sarawak,0,0,0,Madagascar
79269,11/1/2023,MDG,Selangor,42,21,21,Madagascar
79270,11/1/2023,MDV,Johor,128,66,62,Maldives
79271,11/1/2023,MDV,Kedah,1,0,1,Maldives
79272,11/1/2023,MDV,Kelantan,0,0,0,Maldives
79273,11/1/2023,MDV,Perak,0,0,0,Maldives
79274,11/1/2023,MDV,Perlis,0,0,0,Maldives
79275,11/1/2023,MDV,Pulau Pinang,4,2,2,Maldives
79276,11/1/2023,MDV,Sabah,0,0,0,Maldives
79277,11/1/2023,MDV,Sarawak,0,0,0,Maldives
79278,11/1/2023,MDV,Selangor,2354,1339,1015,Maldives
79279,11/1/2023,MEX,Johor,278,127,151,Mexico
79280,11/1/2023,MEX,Kedah,11,3,8,Mexico
79281,11/1/2023,MEX,Kelantan,2,1,1,Mexico
79282,11/1/2023,MEX,Pahang,0,0,0,Mexico
79283,11/1/2023,MEX,Perak,0,0,0,Mexico
79284,11/1/2023,MEX,Perlis,4,1,3,Mexico
79285,11/1/2023,MEX,Pulau Pinang,39,27,12,Mexico
79286,11/1/2023,MEX,Sabah,2,1,1,Mexico
79287,11/1/2023,MEX,Sarawak,4,2,2,Mexico
79288,11/1/2023,MEX,Selangor,866,428,438,Mexico
79289,11/1/2023,MEX,W.P. Labuan,0,0,0,Mexico
79290,11/1/2023,MHL,Johor,1,1,0,Marshall Islands
79291,11/1/2023,MHL,Kedah,0,0,0,Marshall Islands
79292,11/1/2023,MHL,Perak,0,0,0,Marshall Islands
79293,11/1/2023,MHL,Pulau Pinang,0,0,0,Marshall Islands
79294,11/1/2023,MHL,Sabah,0,0,0,Marshall Islands
79295,11/1/2023,MHL,Selangor,3,3,0,Marshall Islands
79296,11/1/2023,MKD,Johor,5,3,2,"Macedonia, the former Yugoslav Republic of"
79297,11/1/2023,MKD,Kedah,2,1,1,"Macedonia, the former Yugoslav Republic of"
79298,11/1/2023,MKD,Perak,0,0,0,"Macedonia, the former Yugoslav Republic of"
79299,11/1/2023,MKD,Pulau Pinang,0,0,0,"Macedonia, the former Yugoslav Republic of"
79300,11/1/2023,MKD,Sabah,0,0,0,"Macedonia, the former Yugoslav Republic of"
79301,11/1/2023,MKD,Sarawak,1,1,0,"Macedonia, the former Yugoslav Republic of"
79302,11/1/2023,MKD,Selangor,32,23,9,"Macedonia, the former Yugoslav Republic of"
79303,11/1/2023,MLI,Johor,1,1,0,Mali
79304,11/1/2023,MLI,Sabah,0,0,0,Mali
79305,11/1/2023,MLI,Selangor,9,7,2,Mali
79306,11/1/2023,MLT,Johor,3,1,2,Malta
79307,11/1/2023,MLT,Kedah,0,0,0,Malta
79308,11/1/2023,MLT,Kelantan,0,0,0,Malta
79309,11/1/2023,MLT,Perak,0,0,0,Malta
79310,11/1/2023,MLT,Perlis,0,0,0,Malta
79311,11/1/2023,MLT,Pulau Pinang,37,20,17,Malta
79312,11/1/2023,MLT,Sabah,0,0,0,Malta
79313,11/1/2023,MLT,Sarawak,0,0,0,Malta
79314,11/1/2023,MLT,Selangor,55,37,18,Malta
79315,11/1/2023,MLT,W.P. Labuan,0,0,0,Malta
79316,11/1/2023,MMR,Johor,6026,1643,4383,Myanmar
79317,11/1/2023,MMR,Kedah,64,9,55,Myanmar
79318,11/1/2023,MMR,Kelantan,2,1,1,Myanmar
79319,11/1/2023,MMR,Negeri Sembilan,0,0,0,Myanmar
79320,11/1/2023,MMR,Pahang,1,0,1,Myanmar
79321,11/1/2023,MMR,Perak,39,10,29,Myanmar
79322,11/1/2023,MMR,Perlis,3,1,2,Myanmar
79323,11/1/2023,MMR,Pulau Pinang,438,209,229,Myanmar
79324,11/1/2023,MMR,Sabah,18,5,13,Myanmar
79325,11/1/2023,MMR,Sarawak,49,20,29,Myanmar
79326,11/1/2023,MMR,Selangor,6648,4479,2169,Myanmar
79327,11/1/2023,MMR,Terengganu,0,0,0,Myanmar
79328,11/1/2023,MMR,W.P. Labuan,0,0,0,Myanmar
79329,11/1/2023,MNE,Johor,5,5,0,Montenegro
79330,11/1/2023,MNE,Kedah,0,0,0,Montenegro
79331,11/1/2023,MNE,Pulau Pinang,0,0,0,Montenegro
79332,11/1/2023,MNE,Sabah,0,0,0,Montenegro
79333,11/1/2023,MNE,Sarawak,0,0,0,Montenegro
79334,11/1/2023,MNE,Selangor,14,12,2,Montenegro
79335,11/1/2023,MNG,Johor,137,51,86,Mongolia
79336,11/1/2023,MNG,Kedah,22,9,13,Mongolia
79337,11/1/2023,MNG,Kelantan,1,0,1,Mongolia
79338,11/1/2023,MNG,Perak,2,1,1,Mongolia
79339,11/1/2023,MNG,Perlis,0,0,0,Mongolia
79340,11/1/2023,MNG,Pulau Pinang,9,2,7,Mongolia
79341,11/1/2023,MNG,Sabah,5,2,3,Mongolia
79342,11/1/2023,MNG,Sarawak,0,0,0,Mongolia
79343,11/1/2023,MNG,Selangor,445,177,268,Mongolia
79344,11/1/2023,MNP,Selangor,0,0,0,Northern Mariana Islands
79345,11/1/2023,MOZ,Johor,0,0,0,Mozambique
79346,11/1/2023,MOZ,Kedah,0,0,0,Mozambique
79347,11/1/2023,MOZ,Perak,0,0,0,Mozambique
79348,11/1/2023,MOZ,Pulau Pinang,0,0,0,Mozambique
79349,11/1/2023,MOZ,Sabah,0,0,0,Mozambique
79350,11/1/2023,MOZ,Sarawak,0,0,0,Mozambique
79351,11/1/2023,MOZ,Selangor,19,8,11,Mozambique
79352,11/1/2023,MRT,Johor,0,0,0,Mauritania
79353,11/1/2023,MRT,Kedah,0,0,0,Mauritania
79354,11/1/2023,MRT,Pulau Pinang,0,0,0,Mauritania
79355,11/1/2023,MRT,Sabah,0,0,0,Mauritania
79356,11/1/2023,MRT,Sarawak,0,0,0,Mauritania
79357,11/1/2023,MRT,Selangor,25,19,6,Mauritania
79358,11/1/2023,MUS,Johor,380,172,208,Mauritius
79359,11/1/2023,MUS,Kedah,12,4,8,Mauritius
79360,11/1/2023,MUS,Kelantan,0,0,0,Mauritius
79361,11/1/2023,MUS,Pahang,0,0,0,Mauritius
79362,11/1/2023,MUS,Perak,0,0,0,Mauritius
79363,11/1/2023,MUS,Perlis,2,2,0,Mauritius
79364,11/1/2023,MUS,Pulau Pinang,10,5,5,Mauritius
79365,11/1/2023,MUS,Sabah,2,1,1,Mauritius
79366,11/1/2023,MUS,Sarawak,2,0,2,Mauritius
79367,11/1/2023,MUS,Selangor,2568,1205,1363,Mauritius
79368,11/1/2023,MWI,Johor,5,2,3,Malawi
79369,11/1/2023,MWI,Pulau Pinang,0,0,0,Malawi
79370,11/1/2023,MWI,Sabah,0,0,0,Malawi
79371,11/1/2023,MWI,Sarawak,0,0,0,Malawi
79372,11/1/2023,MWI,Selangor,27,18,9,Malawi
79373,11/1/2023,MYT,Selangor,1,0,1,Mayotte
79374,11/1/2023,NAM,Johor,2,0,2,Namibia
79375,11/1/2023,NAM,Kedah,0,0,0,Namibia
79376,11/1/2023,NAM,Perak,5,2,3,Namibia
79377,11/1/2023,NAM,Perlis,0,0,0,Namibia
79378,11/1/2023,NAM,Pulau Pinang,1,1,0,Namibia
79379,11/1/2023,NAM,Sabah,1,1,0,Namibia
79380,11/1/2023,NAM,Sarawak,0,0,0,Namibia
79381,11/1/2023,NAM,Selangor,32,12,20,Namibia
79382,11/1/2023,NCL,Selangor,0,0,0,New Caledonia
79383,11/1/2023,NER,Johor,0,0,0,Niger
79384,11/1/2023,NER,Sabah,0,0,0,Niger
79385,11/1/2023,NER,Selangor,1,0,1,Niger
79386,11/1/2023,NGA,Johor,33,28,5,Nigeria
79387,11/1/2023,NGA,Kedah,1,1,0,Nigeria
79388,11/1/2023,NGA,Perlis,0,0,0,Nigeria
79389,11/1/2023,NGA,Pulau Pinang,5,5,0,Nigeria
79390,11/1/2023,NGA,Sabah,0,0,0,Nigeria
79391,11/1/2023,NGA,Sarawak,6,2,4,Nigeria
79392,11/1/2023,NGA,Selangor,484,369,115,Nigeria
79393,11/1/2023,NIC,Johor,0,0,0,Nicaragua
79394,11/1/2023,NIC,Kedah,1,1,0,Nicaragua
79395,11/1/2023,NIC,Pulau Pinang,0,0,0,Nicaragua
79396,11/1/2023,NIC,Sabah,0,0,0,Nicaragua
79397,11/1/2023,NIC,Selangor,6,3,3,Nicaragua
79398,11/1/2023,NLD,Johor,970,624,346,Netherlands
79399,11/1/2023,NLD,Kedah,315,158,157,Netherlands
79400,11/1/2023,NLD,Kelantan,2,1,1,Netherlands
79401,11/1/2023,NLD,Melaka,4,2,2,Netherlands
79402,11/1/2023,NLD,Negeri Sembilan,4,3,1,Netherlands
79403,11/1/2023,NLD,Pahang,0,0,0,Netherlands
79404,11/1/2023,NLD,Perak,12,10,2,Netherlands
79405,11/1/2023,NLD,Perlis,16,12,4,Netherlands
79406,11/1/2023,NLD,Pulau Pinang,252,152,100,Netherlands
79407,11/1/2023,NLD,Sabah,48,26,22,Netherlands
79408,11/1/2023,NLD,Sarawak,103,57,46,Netherlands
79409,11/1/2023,NLD,Selangor,4250,2637,1613,Netherlands
79410,11/1/2023,NLD,Terengganu,2,2,0,Netherlands
79411,11/1/2023,NLD,W.P. Labuan,4,3,1,Netherlands
79412,11/1/2023,NOR,Johor,178,111,67,Norway
79413,11/1/2023,NOR,Kedah,81,38,43,Norway
79414,11/1/2023,NOR,Kelantan,1,1,0,Norway
79415,11/1/2023,NOR,Melaka,1,1,0,Norway
79416,11/1/2023,NOR,Pahang,0,0,0,Norway
79417,11/1/2023,NOR,Perak,2,1,1,Norway
79418,11/1/2023,NOR,Perlis,5,4,1,Norway
79419,11/1/2023,NOR,Pulau Pinang,38,24,14,Norway
79420,11/1/2023,NOR,Sabah,9,7,2,Norway
79421,11/1/2023,NOR,Sarawak,13,11,2,Norway
79422,11/1/2023,NOR,Selangor,749,475,274,Norway
79423,11/1/2023,NOR,W.P. Labuan,1,1,0,Norway
79424,11/1/2023,NPL,Johor,856,534,322,Nepal
79425,11/1/2023,NPL,Kedah,18,11,7,Nepal
79426,11/1/2023,NPL,Pahang,1,1,0,Nepal
79427,11/1/2023,NPL,Perak,0,0,0,Nepal
79428,11/1/2023,NPL,Perlis,0,0,0,Nepal
79429,11/1/2023,NPL,Pulau Pinang,23,15,8,Nepal
79430,11/1/2023,NPL,Sabah,3,2,1,Nepal
79431,11/1/2023,NPL,Sarawak,141,110,31,Nepal
79432,11/1/2023,NPL,Selangor,8471,7874,597,Nepal
79433,11/1/2023,NPL,W.P. Labuan,35,35,0,Nepal
79434,11/1/2023,NRU,Johor,5,3,2,Nauru
79435,11/1/2023,NRU,Pulau Pinang,0,0,0,Nauru
79436,11/1/2023,NRU,Selangor,3,3,0,Nauru
79437,11/1/2023,NZL,Johor,693,414,279,New Zealand
79438,11/1/2023,NZL,Kedah,89,44,45,New Zealand
79439,11/1/2023,NZL,Kelantan,7,5,2,New Zealand
79440,11/1/2023,NZL,Melaka,4,2,2,New Zealand
79441,11/1/2023,NZL,Negeri Sembilan,0,0,0,New Zealand
79442,11/1/2023,NZL,Pahang,0,0,0,New Zealand
79443,11/1/2023,NZL,Perak,19,9,10,New Zealand
79444,11/1/2023,NZL,Perlis,7,5,2,New Zealand
79445,11/1/2023,NZL,Pulau Pinang,245,143,102,New Zealand
79446,11/1/2023,NZL,Sabah,31,21,10,New Zealand
79447,11/1/2023,NZL,Sarawak,110,64,46,New Zealand
79448,11/1/2023,NZL,Selangor,3530,2105,1425,New Zealand
79449,11/1/2023,NZL,Terengganu,0,0,0,New Zealand
79450,11/1/2023,NZL,W.P. Labuan,0,0,0,New Zealand
79451,11/1/2023,OMN,Johor,47,25,22,Oman
79452,11/1/2023,OMN,Kedah,5,5,0,Oman
79453,11/1/2023,OMN,Kelantan,0,0,0,Oman
79454,11/1/2023,OMN,Melaka,0,0,0,Oman
79455,11/1/2023,OMN,Perak,1,1,0,Oman
79456,11/1/2023,OMN,Perlis,0,0,0,Oman
79457,11/1/2023,OMN,Pulau Pinang,0,0,0,Oman
79458,11/1/2023,OMN,Sabah,0,0,0,Oman
79459,11/1/2023,OMN,Sarawak,4,4,0,Oman
79460,11/1/2023,OMN,Selangor,1617,1048,569,Oman
79461,11/1/2023,PAK,Johor,718,523,195,Pakistan
79462,11/1/2023,PAK,Kedah,98,65,33,Pakistan
79463,11/1/2023,PAK,Kelantan,19,19,0,Pakistan
79464,11/1/2023,PAK,Melaka,3,3,0,Pakistan
79465,11/1/2023,PAK,Negeri Sembilan,0,0,0,Pakistan
79466,11/1/2023,PAK,Pahang,0,0,0,Pakistan
79467,11/1/2023,PAK,Perak,11,10,1,Pakistan
79468,11/1/2023,PAK,Perlis,15,15,0,Pakistan
79469,11/1/2023,PAK,Pulau Pinang,78,71,7,Pakistan
79470,11/1/2023,PAK,Sabah,20,19,1,Pakistan
79471,11/1/2023,PAK,Sarawak,126,111,15,Pakistan
79472,11/1/2023,PAK,Selangor,8964,7439,1525,Pakistan
79473,11/1/2023,PAK,W.P. Labuan,4,3,1,Pakistan
79474,11/1/2023,PAN,Johor,2,1,1,Panama
79475,11/1/2023,PAN,Kedah,0,0,0,Panama
79476,11/1/2023,PAN,Perak,0,0,0,Panama
79477,11/1/2023,PAN,Perlis,0,0,0,Panama
79478,11/1/2023,PAN,Pulau Pinang,3,2,1,Panama
79479,11/1/2023,PAN,Sabah,1,0,1,Panama
79480,11/1/2023,PAN,Sarawak,0,0,0,Panama
79481,11/1/2023,PAN,Selangor,43,20,23,Panama
79482,11/1/2023,PER,Johor,24,8,16,Peru
79483,11/1/2023,PER,Kedah,4,3,1,Peru
79484,11/1/2023,PER,Kelantan,0,0,0,Peru
79485,11/1/2023,PER,Pahang,0,0,0,Peru
79486,11/1/2023,PER,Perak,0,0,0,Peru
79487,11/1/2023,PER,Perlis,2,0,2,Peru
79488,11/1/2023,PER,Pulau Pinang,6,1,5,Peru
79489,11/1/2023,PER,Sabah,2,2,0,Peru
79490,11/1/2023,PER,Sarawak,0,0,0,Peru
79491,11/1/2023,PER,Selangor,151,83,68,Peru
79492,11/1/2023,PER,W.P. Labuan,0,0,0,Peru
79493,11/1/2023,PHL,Johor,24853,7657,17196,Philippines
79494,11/1/2023,PHL,Kedah,415,123,292,Philippines
79495,11/1/2023,PHL,Kelantan,24,8,16,Philippines
79496,11/1/2023,PHL,Melaka,0,0,0,Philippines
79497,11/1/2023,PHL,Negeri Sembilan,0,0,0,Philippines
79498,11/1/2023,PHL,Pahang,34,27,7,Philippines
79499,11/1/2023,PHL,Perak,82,21,61,Philippines
79500,11/1/2023,PHL,Perlis,202,62,140,Philippines
79501,11/1/2023,PHL,Pulau Pinang,800,345,455,Philippines
79502,11/1/2023,PHL,Sabah,1444,680,764,Philippines
79503,11/1/2023,PHL,Sarawak,1883,777,1106,Philippines
79504,11/1/2023,PHL,Selangor,16484,6894,9590,Philippines
79505,11/1/2023,PHL,Terengganu,0,0,0,Philippines
79506,11/1/2023,PHL,W.P. Labuan,117,36,81,Philippines
79507,11/1/2023,PLW,Johor,3,0,3,Palau
79508,11/1/2023,PLW,Pulau Pinang,0,0,0,Palau
79509,11/1/2023,PLW,Selangor,3,3,0,Palau
79510,11/1/2023,PNG,Johor,71,32,39,Papua New Guinea
79511,11/1/2023,PNG,Kedah,1,1,0,Papua New Guinea
79512,11/1/2023,PNG,Kelantan,0,0,0,Papua New Guinea
79513,11/1/2023,PNG,Perak,0,0,0,Papua New Guinea
79514,11/1/2023,PNG,Pulau Pinang,2,1,1,Papua New Guinea
79515,11/1/2023,PNG,Sabah,4,2,2,Papua New Guinea
79516,11/1/2023,PNG,Sarawak,8,8,0,Papua New Guinea
79517,11/1/2023,PNG,Selangor,117,83,34,Papua New Guinea
79518,11/1/2023,POL,Johor,551,283,268,Poland
79519,11/1/2023,POL,Kedah,176,79,97,Poland
79520,11/1/2023,POL,Kelantan,2,1,1,Poland
79521,11/1/2023,POL,Melaka,0,0,0,Poland
79522,11/1/2023,POL,Negeri Sembilan,0,0,0,Poland
79523,11/1/2023,POL,Pahang,0,0,0,Poland
79524,11/1/2023,POL,Perak,2,1,1,Poland
79525,11/1/2023,POL,Perlis,22,13,9,Poland
79526,11/1/2023,POL,Pulau Pinang,87,57,30,Poland
79527,11/1/2023,POL,Sabah,28,15,13,Poland
79528,11/1/2023,POL,Sarawak,37,22,15,Poland
79529,11/1/2023,POL,Selangor,1738,938,800,Poland
79530,11/1/2023,POL,Terengganu,1,1,0,Poland
79531,11/1/2023,POL,W.P. Labuan,1,1,0,Poland
79532,11/1/2023,PRK,Selangor,0,0,0,"Korea, Democratic People's Republic of"
79533,11/1/2023,PRT,Johor,179,102,77,Portugal
79534,11/1/2023,PRT,Kedah,69,42,27,Portugal
79535,11/1/2023,PRT,Kelantan,2,2,0,Portugal
79536,11/1/2023,PRT,Melaka,0,0,0,Portugal
79537,11/1/2023,PRT,Pahang,0,0,0,Portugal
79538,11/1/2023,PRT,Perak,3,2,1,Portugal
79539,11/1/2023,PRT,Perlis,1,1,0,Portugal
79540,11/1/2023,PRT,Pulau Pinang,62,39,23,Portugal
79541,11/1/2023,PRT,Sabah,16,10,6,Portugal
79542,11/1/2023,PRT,Sarawak,4,1,3,Portugal
79543,11/1/2023,PRT,Selangor,897,532,365,Portugal
79544,11/1/2023,PRT,W.P. Labuan,0,0,0,Portugal
79545,11/1/2023,PRY,Johor,5,3,2,Paraguay
79546,11/1/2023,PRY,Kedah,0,0,0,Paraguay
79547,11/1/2023,PRY,Perak,0,0,0,Paraguay
79548,11/1/2023,PRY,Perlis,0,0,0,Paraguay
79549,11/1/2023,PRY,Pulau Pinang,0,0,0,Paraguay
79550,11/1/2023,PRY,Sabah,2,1,1,Paraguay
79551,11/1/2023,PRY,Sarawak,0,0,0,Paraguay
79552,11/1/2023,PRY,Selangor,8,5,3,Paraguay
79553,11/1/2023,PSE,Johor,22,21,1,"Palestinian Territory, Occupied"
79554,11/1/2023,PSE,Kedah,0,0,0,"Palestinian Territory, Occupied"
79555,11/1/2023,PSE,Kelantan,0,0,0,"Palestinian Territory, Occupied"
79556,11/1/2023,PSE,Melaka,0,0,0,"Palestinian Territory, Occupied"
79557,11/1/2023,PSE,Perak,0,0,0,"Palestinian Territory, Occupied"
79558,11/1/2023,PSE,Perlis,0,0,0,"Palestinian Territory, Occupied"
79559,11/1/2023,PSE,Pulau Pinang,2,2,0,"Palestinian Territory, Occupied"
79560,11/1/2023,PSE,Sabah,0,0,0,"Palestinian Territory, Occupied"
79561,11/1/2023,PSE,Sarawak,0,0,0,"Palestinian Territory, Occupied"
79562,11/1/2023,PSE,Selangor,262,187,75,"Palestinian Territory, Occupied"
79563,11/1/2023,QAT,Johor,6,0,6,Qatar
79564,11/1/2023,QAT,Kedah,1,0,1,Qatar
79565,11/1/2023,QAT,Perlis,0,0,0,Qatar
79566,11/1/2023,QAT,Pulau Pinang,0,0,0,Qatar
79567,11/1/2023,QAT,Sabah,0,0,0,Qatar
79568,11/1/2023,QAT,Sarawak,2,2,0,Qatar
79569,11/1/2023,QAT,Selangor,93,68,25,Qatar
79570,11/1/2023,REU,Johor,0,0,0,Reunion
79571,11/1/2023,REU,Sarawak,0,0,0,Reunion
79572,11/1/2023,ROU,Johor,177,106,71,Romania
79573,11/1/2023,ROU,Kedah,29,15,14,Romania
79574,11/1/2023,ROU,Kelantan,0,0,0,Romania
79575,11/1/2023,ROU,Negeri Sembilan,0,0,0,Romania
79576,11/1/2023,ROU,Pahang,0,0,0,Romania
79577,11/1/2023,ROU,Perak,0,0,0,Romania
79578,11/1/2023,ROU,Perlis,1,0,1,Romania
79579,11/1/2023,ROU,Pulau Pinang,26,14,12,Romania
79580,11/1/2023,ROU,Sabah,5,4,1,Romania
79581,11/1/2023,ROU,Sarawak,3,3,0,Romania
79582,11/1/2023,ROU,Selangor,719,379,340,Romania
79583,11/1/2023,ROU,W.P. Labuan,0,0,0,Romania
79584,11/1/2023,RUS,Johor,432,205,227,Russia
79585,11/1/2023,RUS,Kedah,388,176,212,Russia
79586,11/1/2023,RUS,Kelantan,38,21,17,Russia
79587,11/1/2023,RUS,Melaka,0,0,0,Russia
79588,11/1/2023,RUS,Negeri Sembilan,0,0,0,Russia
79589,11/1/2023,RUS,Pahang,3,1,2,Russia
79590,11/1/2023,RUS,Perak,6,4,2,Russia
79591,11/1/2023,RUS,Perlis,171,96,75,Russia
79592,11/1/2023,RUS,Pulau Pinang,236,118,118,Russia
79593,11/1/2023,RUS,Sabah,45,23,22,Russia
79594,11/1/2023,RUS,Sarawak,82,42,40,Russia
79595,11/1/2023,RUS,Selangor,9052,4526,4526,Russia
79596,11/1/2023,RUS,W.P. Labuan,7,5,2,Russia
79597,11/1/2023,RWA,Johor,3,1,2,Rwanda
79598,11/1/2023,RWA,Kedah,0,0,0,Rwanda
79599,11/1/2023,RWA,Pulau Pinang,1,1,0,Rwanda
79600,11/1/2023,RWA,Selangor,6,4,2,Rwanda
79601,11/1/2023,SAU,Johor,284,176,108,Saudi Arabia
79602,11/1/2023,SAU,Kedah,66,37,29,Saudi Arabia
79603,11/1/2023,SAU,Kelantan,8,6,2,Saudi Arabia
79604,11/1/2023,SAU,Melaka,0,0,0,Saudi Arabia
79605,11/1/2023,SAU,Perak,2,2,0,Saudi Arabia
79606,11/1/2023,SAU,Perlis,8,5,3,Saudi Arabia
79607,11/1/2023,SAU,Pulau Pinang,46,22,24,Saudi Arabia
79608,11/1/2023,SAU,Sabah,2,1,1,Saudi Arabia
79609,11/1/2023,SAU,Sarawak,8,8,0,Saudi Arabia
79610,11/1/2023,SAU,Selangor,6825,3703,3122,Saudi Arabia
79611,11/1/2023,SAU,W.P. Labuan,0,0,0,Saudi Arabia
79612,11/1/2023,SDN,Johor,18,8,10,Sudan
79613,11/1/2023,SDN,Kedah,2,1,1,Sudan
79614,11/1/2023,SDN,Kelantan,0,0,0,Sudan
79615,11/1/2023,SDN,Perlis,0,0,0,Sudan
79616,11/1/2023,SDN,Pulau Pinang,0,0,0,Sudan
79617,11/1/2023,SDN,Sabah,0,0,0,Sudan
79618,11/1/2023,SDN,Sarawak,5,4,1,Sudan
79619,11/1/2023,SDN,Selangor,1508,835,673,Sudan
79620,11/1/2023,SDN,W.P. Labuan,0,0,0,Sudan
79621,11/1/2023,SEN,Johor,5,4,1,Senegal
79622,11/1/2023,SEN,Kedah,1,0,1,Senegal
79623,11/1/2023,SEN,Kelantan,0,0,0,Senegal
79624,11/1/2023,SEN,Perak,0,0,0,Senegal
79625,11/1/2023,SEN,Perlis,0,0,0,Senegal
79626,11/1/2023,SEN,Pulau Pinang,0,0,0,Senegal
79627,11/1/2023,SEN,Sabah,0,0,0,Senegal
79628,11/1/2023,SEN,Sarawak,0,0,0,Senegal
79629,11/1/2023,SEN,Selangor,90,75,15,Senegal
79630,11/1/2023,SGP,Johor,1289911,729528,560383,Singapore
79631,11/1/2023,SGP,Kedah,6692,3385,3307,Singapore
79632,11/1/2023,SGP,Kelantan,64,34,30,Singapore
79633,11/1/2023,SGP,Melaka,23,19,4,Singapore
79634,11/1/2023,SGP,Negeri Sembilan,0,0,0,Singapore
79635,11/1/2023,SGP,Pahang,533,251,282,Singapore
79636,11/1/2023,SGP,Perak,7407,3400,4007,Singapore
79637,11/1/2023,SGP,Perlis,284,152,132,Singapore
79638,11/1/2023,SGP,Pulau Pinang,24374,11929,12445,Singapore
79639,11/1/2023,SGP,Sabah,2712,1410,1302,Singapore
79640,11/1/2023,SGP,Sarawak,4567,2481,2086,Singapore
79641,11/1/2023,SGP,Selangor,46627,24446,22181,Singapore
79642,11/1/2023,SGP,Terengganu,0,0,0,Singapore
79643,11/1/2023,SGP,W.P. Labuan,5,4,1,Singapore
79644,11/1/2023,SGS,Johor,0,0,0,South Georgia and the South Sandwich Islands
79645,11/1/2023,SGS,Sabah,1,0,1,South Georgia and the South Sandwich Islands
79646,11/1/2023,SGS,Selangor,0,0,0,South Georgia and the South Sandwich Islands
79647,11/1/2023,SHN,Sarawak,0,0,0,"Saint Helena, Ascension and Tristan da Cunha"
79648,11/1/2023,SLB,Johor,46,27,19,Solomon Islands
79649,11/1/2023,SLB,Perlis,0,0,0,Solomon Islands
79650,11/1/2023,SLB,Pulau Pinang,1,1,0,Solomon Islands
79651,11/1/2023,SLB,Sabah,0,0,0,Solomon Islands
79652,11/1/2023,SLB,Sarawak,6,2,4,Solomon Islands
79653,11/1/2023,SLB,Selangor,19,10,9,Solomon Islands
79654,11/1/2023,SLB,W.P. Labuan,0,0,0,Solomon Islands
79655,11/1/2023,SLE,Johor,1,1,0,Sierra Leone
79656,11/1/2023,SLE,Kedah,1,0,1,Sierra Leone
79657,11/1/2023,SLE,Perak,0,0,0,Sierra Leone
79658,11/1/2023,SLE,Pulau Pinang,0,0,0,Sierra Leone
79659,11/1/2023,SLE,Sabah,0,0,0,Sierra Leone
79660,11/1/2023,SLE,Selangor,44,27,17,Sierra Leone
79661,11/1/2023,SLV,Johor,0,0,0,El Salvador
79662,11/1/2023,SLV,Kedah,0,0,0,El Salvador
79663,11/1/2023,SLV,Perak,0,0,0,El Salvador
79664,11/1/2023,SLV,Perlis,1,0,1,El Salvador
79665,11/1/2023,SLV,Pulau Pinang,1,0,1,El Salvador
79666,11/1/2023,SLV,Sabah,0,0,0,El Salvador
79667,11/1/2023,SLV,Selangor,12,7,5,El Salvador
79668,11/1/2023,SLV,W.P. Labuan,0,0,0,El Salvador
79669,11/1/2023,SMR,Johor,0,0,0,San Marino
79670,11/1/2023,SMR,Selangor,4,4,0,San Marino
79671,11/1/2023,SOM,Johor,1,1,0,Somalia
79672,11/1/2023,SOM,Kedah,0,0,0,Somalia
79673,11/1/2023,SOM,Kelantan,0,0,0,Somalia
79674,11/1/2023,SOM,Perlis,0,0,0,Somalia
79675,11/1/2023,SOM,Sabah,0,0,0,Somalia
79676,11/1/2023,SOM,Sarawak,0,0,0,Somalia
79677,11/1/2023,SOM,Selangor,305,186,119,Somalia
79678,11/1/2023,SRB,Johor,3,2,1,Serbia
79679,11/1/2023,SRB,Kedah,1,1,0,Serbia
79680,11/1/2023,SRB,Kelantan,0,0,0,Serbia
79681,11/1/2023,SRB,Pahang,0,0,0,Serbia
79682,11/1/2023,SRB,Perak,1,0,1,Serbia
79683,11/1/2023,SRB,Perlis,0,0,0,Serbia
79684,11/1/2023,SRB,Pulau Pinang,7,6,1,Serbia
79685,11/1/2023,SRB,Sabah,0,0,0,Serbia
79686,11/1/2023,SRB,Sarawak,1,1,0,Serbia
79687,11/1/2023,SRB,Selangor,97,46,51,Serbia
79688,11/1/2023,STP,Selangor,1,1,0,Sao Tome and Principe
79689,11/1/2023,SUR,Johor,3,1,2,Suriname
79690,11/1/2023,SUR,Kedah,0,0,0,Suriname
79691,11/1/2023,SUR,Kelantan,0,0,0,Suriname
79692,11/1/2023,SUR,Perak,0,0,0,Suriname
79693,11/1/2023,SUR,Perlis,0,0,0,Suriname
79694,11/1/2023,SUR,Pulau Pinang,0,0,0,Suriname
79695,11/1/2023,SUR,Sabah,0,0,0,Suriname
79696,11/1/2023,SUR,Sarawak,0,0,0,Suriname
79697,11/1/2023,SUR,Selangor,17,13,4,Suriname
79698,11/1/2023,SVK,Johor,44,22,22,Slovakia
79699,11/1/2023,SVK,Kedah,54,26,28,Slovakia
79700,11/1/2023,SVK,Kelantan,0,0,0,Slovakia
79701,11/1/2023,SVK,Negeri Sembilan,0,0,0,Slovakia
79702,11/1/2023,SVK,Pahang,0,0,0,Slovakia
79703,11/1/2023,SVK,Perak,0,0,0,Slovakia
79704,11/1/2023,SVK,Perlis,2,2,0,Slovakia
79705,11/1/2023,SVK,Pulau Pinang,21,14,7,Slovakia
79706,11/1/2023,SVK,Sabah,6,3,3,Slovakia
79707,11/1/2023,SVK,Sarawak,1,1,0,Slovakia
79708,11/1/2023,SVK,Selangor,394,221,173,Slovakia
79709,11/1/2023,SVK,W.P. Labuan,4,2,2,Slovakia
79710,11/1/2023,SVN,Johor,24,14,10,Slovenia
79711,11/1/2023,SVN,Kedah,12,4,8,Slovenia
79712,11/1/2023,SVN,Kelantan,0,0,0,Slovenia
79713,11/1/2023,SVN,Perak,0,0,0,Slovenia
79714,11/1/2023,SVN,Perlis,1,1,0,Slovenia
79715,11/1/2023,SVN,Pulau Pinang,10,5,5,Slovenia
79716,11/1/2023,SVN,Sabah,1,1,0,Slovenia
79717,11/1/2023,SVN,Sarawak,0,0,0,Slovenia
79718,11/1/2023,SVN,Selangor,181,105,76,Slovenia
79719,11/1/2023,SVN,W.P. Labuan,0,0,0,Slovenia
79720,11/1/2023,SWE,Johor,347,207,140,Sweden
79721,11/1/2023,SWE,Kedah,146,64,82,Sweden
79722,11/1/2023,SWE,Kelantan,2,0,2,Sweden
79723,11/1/2023,SWE,Melaka,0,0,0,Sweden
79724,11/1/2023,SWE,Negeri Sembilan,0,0,0,Sweden
79725,11/1/2023,SWE,Pahang,1,1,0,Sweden
79726,11/1/2023,SWE,Perak,6,5,1,Sweden
79727,11/1/2023,SWE,Perlis,14,12,2,Sweden
79728,11/1/2023,SWE,Pulau Pinang,113,74,39,Sweden
79729,11/1/2023,SWE,Sabah,11,6,5,Sweden
79730,11/1/2023,SWE,Sarawak,40,22,18,Sweden
79731,11/1/2023,SWE,Selangor,1269,753,516,Sweden
79732,11/1/2023,SWE,W.P. Labuan,2,1,1,Sweden
79733,11/1/2023,SWZ,Johor,3,2,1,Swaziland
79734,11/1/2023,SWZ,Kedah,0,0,0,Swaziland
79735,11/1/2023,SWZ,Pulau Pinang,0,0,0,Swaziland
79736,11/1/2023,SWZ,Sabah,0,0,0,Swaziland
79737,11/1/2023,SWZ,Selangor,25,14,11,Swaziland
79738,11/1/2023,SYC,Johor,0,0,0,Seychelles
79739,11/1/2023,SYC,Kedah,1,1,0,Seychelles
79740,11/1/2023,SYC,Pulau Pinang,0,0,0,Seychelles
79741,11/1/2023,SYC,Sabah,0,0,0,Seychelles
79742,11/1/2023,SYC,Sarawak,0,0,0,Seychelles
79743,11/1/2023,SYC,Selangor,70,29,41,Seychelles
79744,11/1/2023,SYR,Johor,12,8,4,Syrian Arab Republic
79745,11/1/2023,SYR,Kedah,0,0,0,Syrian Arab Republic
79746,11/1/2023,SYR,Kelantan,1,0,1,Syrian Arab Republic
79747,11/1/2023,SYR,Pahang,0,0,0,Syrian Arab Republic
79748,11/1/2023,SYR,Perlis,0,0,0,Syrian Arab Republic
79749,11/1/2023,SYR,Pulau Pinang,5,5,0,Syrian Arab Republic
79750,11/1/2023,SYR,Sabah,0,0,0,Syrian Arab Republic
79751,11/1/2023,SYR,Sarawak,1,1,0,Syrian Arab Republic
79752,11/1/2023,SYR,Selangor,813,539,274,Syrian Arab Republic
79753,11/1/2023,SYR,W.P. Labuan,0,0,0,Syrian Arab Republic
79754,11/1/2023,TCA,Perlis,0,0,0,Turks and Caicos
79755,11/1/2023,TCD,Johor,2,2,0,Chad
79756,11/1/2023,TCD,Kedah,0,0,0,Chad
79757,11/1/2023,TCD,Perlis,0,0,0,Chad
79758,11/1/2023,TCD,Selangor,46,40,6,Chad
79759,11/1/2023,TGO,Johor,0,0,0,Togo
79760,11/1/2023,TGO,Perak,0,0,0,Togo
79761,11/1/2023,TGO,Pulau Pinang,0,0,0,Togo
79762,11/1/2023,TGO,Selangor,13,10,3,Togo
79763,11/1/2023,THA,Johor,6138,1699,4439,Thailand
79764,11/1/2023,THA,Kedah,66908,40495,26413,Thailand
79765,11/1/2023,THA,Kelantan,39482,20641,18841,Thailand
79766,11/1/2023,THA,Melaka,3,1,2,Thailand
79767,11/1/2023,THA,Negeri Sembilan,0,0,0,Thailand
79768,11/1/2023,THA,Pahang,6,4,2,Thailand
79769,11/1/2023,THA,Perak,9890,4626,5264,Thailand
79770,11/1/2023,THA,Perlis,52035,30442,21593,Thailand
79771,11/1/2023,THA,Pulau Pinang,2374,959,1415,Thailand
79772,11/1/2023,THA,Sabah,32,11,21,Thailand
79773,11/1/2023,THA,Sarawak,310,106,204,Thailand
79774,11/1/2023,THA,Selangor,13787,5643,8144,Thailand
79775,11/1/2023,THA,Terengganu,2,0,2,Thailand
79776,11/1/2023,THA,W.P. Labuan,13,4,9,Thailand
79777,11/1/2023,TJK,Johor,4,3,1,Tajikistan
79778,11/1/2023,TJK,Kedah,0,0,0,Tajikistan
79779,11/1/2023,TJK,Perlis,0,0,0,Tajikistan
79780,11/1/2023,TJK,Pulau Pinang,0,0,0,Tajikistan
79781,11/1/2023,TJK,Sabah,0,0,0,Tajikistan
79782,11/1/2023,TJK,Selangor,144,105,39,Tajikistan
79783,11/1/2023,TKL,Selangor,0,0,0,Tokelau
79784,11/1/2023,TKM,Johor,0,0,0,Turkmenistan
79785,11/1/2023,TKM,Kedah,3,0,3,Turkmenistan
79786,11/1/2023,TKM,Kelantan,0,0,0,Turkmenistan
79787,11/1/2023,TKM,Perlis,0,0,0,Turkmenistan
79788,11/1/2023,TKM,Pulau Pinang,5,4,1,Turkmenistan
79789,11/1/2023,TKM,Sabah,0,0,0,Turkmenistan
79790,11/1/2023,TKM,Sarawak,0,0,0,Turkmenistan
79791,11/1/2023,TKM,Selangor,93,52,41,Turkmenistan
79792,11/1/2023,TLS,Johor,5,2,3,Timor-Leste
79793,11/1/2023,TLS,Kedah,0,0,0,Timor-Leste
79794,11/1/2023,TLS,Perlis,0,0,0,Timor-Leste
79795,11/1/2023,TLS,Pulau Pinang,10,4,6,Timor-Leste
79796,11/1/2023,TLS,Sabah,3,3,0,Timor-Leste
79797,11/1/2023,TLS,Sarawak,4,3,1,Timor-Leste
79798,11/1/2023,TLS,Selangor,211,134,77,Timor-Leste
79799,11/1/2023,TON,Johor,2,0,2,Tonga
79800,11/1/2023,TON,Pulau Pinang,8,4,4,Tonga
79801,11/1/2023,TON,Sarawak,0,0,0,Tonga
79802,11/1/2023,TON,Selangor,19,12,7,Tonga
79803,11/1/2023,TTO,Johor,3,1,2,Trinidad and Tobago
79804,11/1/2023,TTO,Kedah,0,0,0,Trinidad and Tobago
79805,11/1/2023,TTO,Pahang,0,0,0,Trinidad and Tobago
79806,11/1/2023,TTO,Pulau Pinang,0,0,0,Trinidad and Tobago
79807,11/1/2023,TTO,Sabah,0,0,0,Trinidad and Tobago
79808,11/1/2023,TTO,Sarawak,0,0,0,Trinidad and Tobago
79809,11/1/2023,TTO,Selangor,43,24,19,Trinidad and Tobago
79810,11/1/2023,TUN,Johor,18,7,11,Tunisia
79811,11/1/2023,TUN,Kedah,0,0,0,Tunisia
79812,11/1/2023,TUN,Kelantan,1,1,0,Tunisia
79813,11/1/2023,TUN,Melaka,0,0,0,Tunisia
79814,11/1/2023,TUN,Perak,0,0,0,Tunisia
79815,11/1/2023,TUN,Perlis,1,1,0,Tunisia
79816,11/1/2023,TUN,Pulau Pinang,2,2,0,Tunisia
79817,11/1/2023,TUN,Sabah,0,0,0,Tunisia
79818,11/1/2023,TUN,Sarawak,1,1,0,Tunisia
79819,11/1/2023,TUN,Selangor,665,371,294,Tunisia
79820,11/1/2023,TUN,W.P. Labuan,0,0,0,Tunisia
79821,11/1/2023,TUR,Johor,353,262,91,Turkey
79822,11/1/2023,TUR,Kedah,47,31,16,Turkey
79823,11/1/2023,TUR,Kelantan,1,0,1,Turkey
79824,11/1/2023,TUR,Melaka,0,0,0,Turkey
79825,11/1/2023,TUR,Negeri Sembilan,0,0,0,Turkey
79826,11/1/2023,TUR,Pahang,0,0,0,Turkey
79827,11/1/2023,TUR,Perak,2,2,0,Turkey
79828,11/1/2023,TUR,Perlis,23,16,7,Turkey
79829,11/1/2023,TUR,Pulau Pinang,28,24,4,Turkey
79830,11/1/2023,TUR,Sabah,9,6,3,Turkey
79831,11/1/2023,TUR,Sarawak,20,18,2,Turkey
79832,11/1/2023,TUR,Selangor,1495,1065,430,Turkey
79833,11/1/2023,TUR,W.P. Labuan,0,0,0,Turkey
79834,11/1/2023,TUV,Selangor,1,1,0,Tuvalu
79835,11/1/2023,TWN,Johor,5648,2240,3408,Taiwan
79836,11/1/2023,TWN,Kedah,129,60,69,Taiwan
79837,11/1/2023,TWN,Kelantan,0,0,0,Taiwan
79838,11/1/2023,TWN,Melaka,3,1,2,Taiwan
79839,11/1/2023,TWN,Negeri Sembilan,0,0,0,Taiwan
79840,11/1/2023,TWN,Pahang,3,1,2,Taiwan
79841,11/1/2023,TWN,Perak,47,26,21,Taiwan
79842,11/1/2023,TWN,Perlis,23,18,5,Taiwan
79843,11/1/2023,TWN,Pulau Pinang,4032,2028,2004,Taiwan
79844,11/1/2023,TWN,Sabah,1021,497,524,Taiwan
79845,11/1/2023,TWN,Sarawak,293,121,172,Taiwan
79846,11/1/2023,TWN,Selangor,15768,7249,8519,Taiwan
79847,11/1/2023,TWN,W.P. Labuan,5,4,1,Taiwan
79848,11/1/2023,TZA,Johor,38,29,9,"Tanzania, United Republic of"
79849,11/1/2023,TZA,Kedah,0,0,0,"Tanzania, United Republic of"
79850,11/1/2023,TZA,Perak,0,0,0,"Tanzania, United Republic of"
79851,11/1/2023,TZA,Perlis,0,0,0,"Tanzania, United Republic of"
79852,11/1/2023,TZA,Pulau Pinang,1,0,1,"Tanzania, United Republic of"
79853,11/1/2023,TZA,Sabah,0,0,0,"Tanzania, United Republic of"
79854,11/1/2023,TZA,Sarawak,2,2,0,"Tanzania, United Republic of"
79855,11/1/2023,TZA,Selangor,245,133,112,"Tanzania, United Republic of"
79856,11/1/2023,UGA,Johor,15,4,11,Uganda
79857,11/1/2023,UGA,Kedah,0,0,0,Uganda
79858,11/1/2023,UGA,Perak,0,0,0,Uganda
79859,11/1/2023,UGA,Perlis,0,0,0,Uganda
79860,11/1/2023,UGA,Pulau Pinang,2,1,1,Uganda
79861,11/1/2023,UGA,Sabah,0,0,0,Uganda
79862,11/1/2023,UGA,Sarawak,0,0,0,Uganda
79863,11/1/2023,UGA,Selangor,132,55,77,Uganda
79864,11/1/2023,UKR,Johor,105,50,55,Ukraine
79865,11/1/2023,UKR,Kedah,36,15,21,Ukraine
79866,11/1/2023,UKR,Kelantan,4,4,0,Ukraine
79867,11/1/2023,UKR,Melaka,6,6,0,Ukraine
79868,11/1/2023,UKR,Negeri Sembilan,0,0,0,Ukraine
79869,11/1/2023,UKR,Pahang,5,4,1,Ukraine
79870,11/1/2023,UKR,Perak,3,1,2,Ukraine
79871,11/1/2023,UKR,Perlis,3,2,1,Ukraine
79872,11/1/2023,UKR,Pulau Pinang,21,11,10,Ukraine
79873,11/1/2023,UKR,Sabah,4,1,3,Ukraine
79874,11/1/2023,UKR,Sarawak,1,1,0,Ukraine
79875,11/1/2023,UKR,Selangor,920,455,465,Ukraine
79876,11/1/2023,UKR,W.P. Labuan,0,0,0,Ukraine
79877,11/1/2023,URY,Johor,4,1,3,Uruguay
79878,11/1/2023,URY,Kedah,1,0,1,Uruguay
79879,11/1/2023,URY,Kelantan,0,0,0,Uruguay
79880,11/1/2023,URY,Perak,0,0,0,Uruguay
79881,11/1/2023,URY,Perlis,0,0,0,Uruguay
79882,11/1/2023,URY,Pulau Pinang,0,0,0,Uruguay
79883,11/1/2023,URY,Sabah,0,0,0,Uruguay
79884,11/1/2023,URY,Sarawak,0,0,0,Uruguay
79885,11/1/2023,URY,Selangor,77,33,44,Uruguay
79886,11/1/2023,URY,W.P. Labuan,0,0,0,Uruguay
79887,11/1/2023,USA,Johor,4676,2673,2003,United States Of America
79888,11/1/2023,USA,Kedah,460,256,204,United States Of America
79889,11/1/2023,USA,Kelantan,18,13,5,United States Of America
79890,11/1/2023,USA,Melaka,3,2,1,United States Of America
79891,11/1/2023,USA,Negeri Sembilan,0,0,0,United States Of America
79892,11/1/2023,USA,Pahang,11,5,6,United States Of America
79893,11/1/2023,USA,Perak,170,87,83,United States Of America
79894,11/1/2023,USA,Perlis,70,46,24,United States Of America
79895,11/1/2023,USA,Pulau Pinang,2101,1305,796,United States Of America
79896,11/1/2023,USA,Sabah,259,144,115,United States Of America
79897,11/1/2023,USA,Sarawak,246,130,116,United States Of America
79898,11/1/2023,USA,Selangor,15372,9055,6317,United States Of America
79899,11/1/2023,USA,Terengganu,3,3,0,United States Of America
79900,11/1/2023,USA,W.P. Labuan,7,5,2,United States Of America
79901,11/1/2023,UZB,Johor,81,69,12,Uzbekistan
79902,11/1/2023,UZB,Kedah,20,12,8,Uzbekistan
79903,11/1/2023,UZB,Kelantan,0,0,0,Uzbekistan
79904,11/1/2023,UZB,Perak,1,0,1,Uzbekistan
79905,11/1/2023,UZB,Perlis,4,1,3,Uzbekistan
79906,11/1/2023,UZB,Pulau Pinang,11,6,5,Uzbekistan
79907,11/1/2023,UZB,Sabah,2,1,1,Uzbekistan
79908,11/1/2023,UZB,Sarawak,0,0,0,Uzbekistan
79909,11/1/2023,UZB,Selangor,1260,763,497,Uzbekistan
79910,11/1/2023,VAT,Johor,0,0,0,Holy See (Vatican City State)
79911,11/1/2023,VAT,Sarawak,0,0,0,Holy See (Vatican City State)
79912,11/1/2023,VAT,Selangor,0,0,0,Holy See (Vatican City State)
79913,11/1/2023,VCT,Johor,0,0,0,Saint Vincent and the Grenadines
79914,11/1/2023,VCT,Kedah,0,0,0,Saint Vincent and the Grenadines
79915,11/1/2023,VCT,Pulau Pinang,0,0,0,Saint Vincent and the Grenadines
79916,11/1/2023,VCT,Sarawak,0,0,0,Saint Vincent and the Grenadines
79917,11/1/2023,VCT,Selangor,0,0,0,Saint Vincent and the Grenadines
79918,11/1/2023,VEN,Johor,13,8,5,Venezuela
79919,11/1/2023,VEN,Kedah,1,0,1,Venezuela
79920,11/1/2023,VEN,Kelantan,0,0,0,Venezuela
79921,11/1/2023,VEN,Melaka,0,0,0,Venezuela
79922,11/1/2023,VEN,Perak,0,0,0,Venezuela
79923,11/1/2023,VEN,Perlis,1,0,1,Venezuela
79924,11/1/2023,VEN,Pulau Pinang,2,1,1,Venezuela
79925,11/1/2023,VEN,Sabah,0,0,0,Venezuela
79926,11/1/2023,VEN,Sarawak,1,0,1,Venezuela
79927,11/1/2023,VEN,Selangor,78,45,33,Venezuela
79928,11/1/2023,VEN,W.P. Labuan,0,0,0,Venezuela
79929,11/1/2023,VNM,Johor,12151,3617,8534,Vietnam
79930,11/1/2023,VNM,Kedah,296,42,254,Vietnam
79931,11/1/2023,VNM,Kelantan,13,3,10,Vietnam
79932,11/1/2023,VNM,Melaka,0,0,0,Vietnam
79933,11/1/2023,VNM,Negeri Sembilan,0,0,0,Vietnam
79934,11/1/2023,VNM,Pahang,1,0,1,Vietnam
79935,11/1/2023,VNM,Perak,190,12,178,Vietnam
79936,11/1/2023,VNM,Perlis,186,19,167,Vietnam
79937,11/1/2023,VNM,Pulau Pinang,1156,367,789,Vietnam
79938,11/1/2023,VNM,Sabah,29,10,19,Vietnam
79939,11/1/2023,VNM,Sarawak,248,44,204,Vietnam
79940,11/1/2023,VNM,Selangor,14854,5712,9142,Vietnam
79941,11/1/2023,VNM,Terengganu,0,0,0,Vietnam
79942,11/1/2023,VNM,W.P. Labuan,0,0,0,Vietnam
79943,11/1/2023,VUT,Johor,58,43,15,Vanuatu
79944,11/1/2023,VUT,Kedah,0,0,0,Vanuatu
79945,11/1/2023,VUT,Pulau Pinang,0,0,0,Vanuatu
79946,11/1/2023,VUT,Sabah,2,2,0,Vanuatu
79947,11/1/2023,VUT,Sarawak,0,0,0,Vanuatu
79948,11/1/2023,VUT,Selangor,71,62,9,Vanuatu
79949,11/1/2023,WSM,Johor,2,2,0,Samoa
79950,11/1/2023,WSM,Sarawak,0,0,0,Samoa
79951,11/1/2023,WSM,Selangor,8,0,8,Samoa
79952,11/1/2023,YEM,Johor,37,29,8,Yemen
79953,11/1/2023,YEM,Kedah,8,6,2,Yemen
79954,11/1/2023,YEM,Kelantan,0,0,0,Yemen
79955,11/1/2023,YEM,Melaka,0,0,0,Yemen
79956,11/1/2023,YEM,Pahang,0,0,0,Yemen
79957,11/1/2023,YEM,Perak,1,1,0,Yemen
79958,11/1/2023,YEM,Perlis,3,3,0,Yemen
79959,11/1/2023,YEM,Pulau Pinang,5,4,1,Yemen
79960,11/1/2023,YEM,Sabah,0,0,0,Yemen
79961,11/1/2023,YEM,Sarawak,4,4,0,Yemen
79962,11/1/2023,YEM,Selangor,1595,1117,478,Yemen
79963,11/1/2023,YEM,W.P. Labuan,0,0,0,Yemen
79964,11/1/2023,ZAF,Johor,228,142,86,South Africa
79965,11/1/2023,ZAF,Kedah,32,18,14,South Africa
79966,11/1/2023,ZAF,Kelantan,0,0,0,South Africa
79967,11/1/2023,ZAF,Melaka,0,0,0,South Africa
79968,11/1/2023,ZAF,Pahang,1,1,0,South Africa
79969,11/1/2023,ZAF,Perak,2,0,2,South Africa
79970,11/1/2023,ZAF,Perlis,10,7,3,South Africa
79971,11/1/2023,ZAF,Pulau Pinang,46,27,19,South Africa
79972,11/1/2023,ZAF,Sabah,7,4,3,South Africa
79973,11/1/2023,ZAF,Sarawak,81,35,46,South Africa
79974,11/1/2023,ZAF,Selangor,1178,756,422,South Africa
79975,11/1/2023,ZAF,Terengganu,2,2,0,South Africa
79976,11/1/2023,ZAF,W.P. Labuan,0,0,0,South Africa
79977,11/1/2023,ZMB,Johor,2,1,1,Zambia
79978,11/1/2023,ZMB,Kedah,0,0,0,Zambia
79979,11/1/2023,ZMB,Perak,0,0,0,Zambia
79980,11/1/2023,ZMB,Perlis,0,0,0,Zambia
79981,11/1/2023,ZMB,Pulau Pinang,4,1,3,Zambia
79982,11/1/2023,ZMB,Sabah,1,0,1,Zambia
79983,11/1/2023,ZMB,Sarawak,0,0,0,Zambia
79984,11/1/2023,ZMB,Selangor,102,61,41,Zambia
79985,11/1/2023,ZWE,Johor,12,7,5,Zimbabwe
79986,11/1/2023,ZWE,Kedah,0,0,0,Zimbabwe
79987,11/1/2023,ZWE,Kelantan,0,0,0,Zimbabwe
79988,11/1/2023,ZWE,Perak,0,0,0,Zimbabwe
79989,11/1/2023,ZWE,Perlis,0,0,0,Zimbabwe
79990,11/1/2023,ZWE,Pulau Pinang,0,0,0,Zimbabwe
79991,11/1/2023,ZWE,Sabah,1,0,1,Zimbabwe
79992,11/1/2023,ZWE,Sarawak,0,0,0,Zimbabwe
79993,11/1/2023,ZWE,Selangor,169,73,96,Zimbabwe
79994,12/1/2023,AFG,Perlis,1,1,0,Afghanistan
79995,12/1/2023,AFG,Sarawak,2,2,0,Afghanistan
79996,12/1/2023,AFG,Selangor,70,51,19,Afghanistan
79997,12/1/2023,AGO,Johor,1,0,1,Angola
79998,12/1/2023,AGO,Selangor,2,1,1,Angola
79999,12/1/2023,ALB,Johor,17,15,2,Albania
80000,12/1/2023,ALB,Kedah,5,3,2,Albania
80001,12/1/2023,ALB,Pulau Pinang,1,1,0,Albania
80002,12/1/2023,ALB,Sabah,1,0,1,Albania
80003,12/1/2023,ALB,Selangor,50,34,16,Albania
80004,12/1/2023,AND,Pulau Pinang,6,3,3,Andorra
80005,12/1/2023,AND,Selangor,10,5,5,Andorra
80006,12/1/2023,ARE,Johor,45,22,23,United Arab Emirates
80007,12/1/2023,ARE,Kedah,3,1,2,United Arab Emirates
80008,12/1/2023,ARE,Selangor,1108,580,528,United Arab Emirates
80009,12/1/2023,ARG,Johor,83,51,32,Argentina
80010,12/1/2023,ARG,Kedah,45,21,24,Argentina
80011,12/1/2023,ARG,Perlis,3,2,1,Argentina
80012,12/1/2023,ARG,Pulau Pinang,8,3,5,Argentina
80013,12/1/2023,ARG,Sabah,3,2,1,Argentina
80014,12/1/2023,ARG,Sarawak,1,1,0,Argentina
80015,12/1/2023,ARG,Selangor,485,236,249,Argentina
80016,12/1/2023,ARM,Johor,3,2,1,Armenia
80017,12/1/2023,ARM,Pulau Pinang,4,0,4,Armenia
80018,12/1/2023,ARM,Selangor,56,28,28,Armenia
80019,12/1/2023,ATA,Selangor,2,1,1,Antarctica
80020,12/1/2023,ATG,Johor,5,3,2,Antigua and Barbuda
80021,12/1/2023,ATG,Sabah,1,0,1,Antigua and Barbuda
80022,12/1/2023,ATG,Selangor,24,14,10,Antigua and Barbuda
80023,12/1/2023,AUS,Johor,7092,3949,3143,Australia
80024,12/1/2023,AUS,Kedah,1182,632,550,Australia
80025,12/1/2023,AUS,Kelantan,8,5,3,Australia
80026,12/1/2023,AUS,Pahang,34,20,14,Australia
80027,12/1/2023,AUS,Perak,356,187,169,Australia
80028,12/1/2023,AUS,Perlis,100,56,44,Australia
80029,12/1/2023,AUS,Pulau Pinang,2988,1536,1452,Australia
80030,12/1/2023,AUS,Sabah,590,302,288,Australia
80031,12/1/2023,AUS,Sarawak,864,472,392,Australia
80032,12/1/2023,AUS,Selangor,41444,23064,18380,Australia
80033,12/1/2023,AUS,W.P. Labuan,15,13,2,Australia
80034,12/1/2023,AUT,Johor,201,131,70,Austria
80035,12/1/2023,AUT,Kedah,167,82,85,Austria
80036,12/1/2023,AUT,Kelantan,2,1,1,Austria
80037,12/1/2023,AUT,Perlis,11,6,5,Austria
80038,12/1/2023,AUT,Pulau Pinang,74,50,24,Austria
80039,12/1/2023,AUT,Sabah,7,5,2,Austria
80040,12/1/2023,AUT,Sarawak,18,13,5,Austria
80041,12/1/2023,AUT,Selangor,997,578,419,Austria
80042,12/1/2023,AUT,W.P. Labuan,1,1,0,Austria
80043,12/1/2023,AZE,Johor,20,15,5,Azerbaijan
80044,12/1/2023,AZE,Kedah,5,2,3,Azerbaijan
80045,12/1/2023,AZE,Sarawak,3,1,2,Azerbaijan
80046,12/1/2023,AZE,Selangor,208,98,110,Azerbaijan
80047,12/1/2023,BDI,Selangor,8,4,4,Burundi
80048,12/1/2023,BEL,Johor,192,116,76,Belgium
80049,12/1/2023,BEL,Kedah,155,82,73,Belgium
80050,12/1/2023,BEL,Kelantan,3,3,0,Belgium
80051,12/1/2023,BEL,Perak,5,2,3,Belgium
80052,12/1/2023,BEL,Perlis,18,12,6,Belgium
80053,12/1/2023,BEL,Pulau Pinang,88,61,27,Belgium
80054,12/1/2023,BEL,Sabah,17,9,8,Belgium
80055,12/1/2023,BEL,Sarawak,23,17,6,Belgium
80056,12/1/2023,BEL,Selangor,1138,720,418,Belgium
80057,12/1/2023,BEL,W.P. Labuan,2,2,0,Belgium
80058,12/1/2023,BEN,Johor,1,1,0,Benin
80059,12/1/2023,BEN,Sarawak,1,0,1,Benin
80060,12/1/2023,BEN,Selangor,14,7,7,Benin
80061,12/1/2023,BFA,Johor,2,2,0,Burkina Faso
80062,12/1/2023,BFA,Selangor,4,4,0,Burkina Faso
80063,12/1/2023,BGD,Johor,2916,2203,713,Bangladesh
80064,12/1/2023,BGD,Kedah,58,36,22,Bangladesh
80065,12/1/2023,BGD,Kelantan,2,2,0,Bangladesh
80066,12/1/2023,BGD,Perak,4,2,2,Bangladesh
80067,12/1/2023,BGD,Perlis,3,2,1,Bangladesh
80068,12/1/2023,BGD,Pulau Pinang,176,155,21,Bangladesh
80069,12/1/2023,BGD,Sabah,6,4,2,Bangladesh
80070,12/1/2023,BGD,Sarawak,80,49,31,Bangladesh
80071,12/1/2023,BGD,Selangor,38847,36343,2504,Bangladesh
80072,12/1/2023,BGD,W.P. Labuan,21,20,1,Bangladesh
80073,12/1/2023,BGR,Johor,44,27,17,Bulgaria
80074,12/1/2023,BGR,Kedah,35,18,17,Bulgaria
80075,12/1/2023,BGR,Perak,1,0,1,Bulgaria
80076,12/1/2023,BGR,Pulau Pinang,16,11,5,Bulgaria
80077,12/1/2023,BGR,Sabah,5,4,1,Bulgaria
80078,12/1/2023,BGR,Sarawak,2,2,0,Bulgaria
80079,12/1/2023,BGR,Selangor,409,215,194,Bulgaria
80080,12/1/2023,BHR,Johor,9,4,5,Bahrain
80081,12/1/2023,BHR,Kedah,8,4,4,Bahrain
80082,12/1/2023,BHR,Selangor,149,82,67,Bahrain
80083,12/1/2023,BHS,Kedah,2,1,1,Bahamas
80084,12/1/2023,BHS,Selangor,20,13,7,Bahamas
80085,12/1/2023,BIH,Johor,11,7,4,Bosnia and Herzegovina
80086,12/1/2023,BIH,Kedah,5,3,2,Bosnia and Herzegovina
80087,12/1/2023,BIH,Pulau Pinang,1,1,0,Bosnia and Herzegovina
80088,12/1/2023,BIH,Sabah,1,0,1,Bosnia and Herzegovina
80089,12/1/2023,BIH,Sarawak,1,1,0,Bosnia and Herzegovina
80090,12/1/2023,BIH,Selangor,60,30,30,Bosnia and Herzegovina
80091,12/1/2023,BLR,Johor,16,6,10,Belarus
80092,12/1/2023,BLR,Kedah,20,8,12,Belarus
80093,12/1/2023,BLR,Kelantan,1,1,0,Belarus
80094,12/1/2023,BLR,Pulau Pinang,8,4,4,Belarus
80095,12/1/2023,BLR,Sabah,2,1,1,Belarus
80096,12/1/2023,BLR,Sarawak,4,1,3,Belarus
80097,12/1/2023,BLR,Selangor,393,183,210,Belarus
80098,12/1/2023,BLZ,Johor,12,6,6,Belize
80099,12/1/2023,BLZ,Pulau Pinang,2,1,1,Belize
80100,12/1/2023,BLZ,Sarawak,1,1,0,Belize
80101,12/1/2023,BLZ,Selangor,6,5,1,Belize
80102,12/1/2023,BOL,Kedah,2,0,2,Bolivia
80103,12/1/2023,BOL,Pulau Pinang,2,1,1,Bolivia
80104,12/1/2023,BOL,Sabah,1,1,0,Bolivia
80105,12/1/2023,BOL,Selangor,24,12,12,Bolivia
80106,12/1/2023,BRA,Johor,297,152,145,Brazil
80107,12/1/2023,BRA,Kedah,163,88,75,Brazil
80108,12/1/2023,BRA,Pahang,3,2,1,Brazil
80109,12/1/2023,BRA,Perlis,6,3,3,Brazil
80110,12/1/2023,BRA,Pulau Pinang,44,27,17,Brazil
80111,12/1/2023,BRA,Sabah,14,6,8,Brazil
80112,12/1/2023,BRA,Sarawak,1,0,1,Brazil
80113,12/1/2023,BRA,Selangor,1193,626,567,Brazil
80114,12/1/2023,BRB,Johor,1,0,1,Barbados
80115,12/1/2023,BRB,Selangor,6,3,3,Barbados
80116,12/1/2023,BRN,Johor,1917,975,942,Brunei Darussalam
80117,12/1/2023,BRN,Kedah,105,51,54,Brunei Darussalam
80118,12/1/2023,BRN,Kelantan,22,8,14,Brunei Darussalam
80119,12/1/2023,BRN,Melaka,5,2,3,Brunei Darussalam
80120,12/1/2023,BRN,Perak,5,2,3,Brunei Darussalam
80121,12/1/2023,BRN,Perlis,116,58,58,Brunei Darussalam
80122,12/1/2023,BRN,Pulau Pinang,31,15,16,Brunei Darussalam
80123,12/1/2023,BRN,Sabah,2833,1266,1567,Brunei Darussalam
80124,12/1/2023,BRN,Sarawak,151340,81793,69547,Brunei Darussalam
80125,12/1/2023,BRN,Selangor,10737,5165,5572,Brunei Darussalam
80126,12/1/2023,BRN,W.P. Labuan,3106,1821,1285,Brunei Darussalam
80127,12/1/2023,BTN,Johor,16,16,0,Bhutan
80128,12/1/2023,BTN,Selangor,48,32,16,Bhutan
80129,12/1/2023,BVT,Selangor,1,0,1,Bouvet Island
80130,12/1/2023,BWA,Selangor,16,6,10,Botswana
80131,12/1/2023,CAN,Johor,1513,832,681,Canada
80132,12/1/2023,CAN,Kedah,431,230,201,Canada
80133,12/1/2023,CAN,Kelantan,2,2,0,Canada
80134,12/1/2023,CAN,Pahang,5,3,2,Canada
80135,12/1/2023,CAN,Perak,44,19,25,Canada
80136,12/1/2023,CAN,Perlis,43,25,18,Canada
80137,12/1/2023,CAN,Pulau Pinang,644,331,313,Canada
80138,12/1/2023,CAN,Sabah,205,107,98,Canada
80139,12/1/2023,CAN,Sarawak,311,167,144,Canada
80140,12/1/2023,CAN,Selangor,6274,3453,2821,Canada
80141,12/1/2023,CAN,W.P. Labuan,5,1,4,Canada
80142,12/1/2023,CHE,Johor,384,208,176,Switzerland
80143,12/1/2023,CHE,Kedah,310,161,149,Switzerland
80144,12/1/2023,CHE,Kelantan,3,3,0,Switzerland
80145,12/1/2023,CHE,Perak,2,1,1,Switzerland
80146,12/1/2023,CHE,Perlis,27,18,9,Switzerland
80147,12/1/2023,CHE,Pulau Pinang,168,102,66,Switzerland
80148,12/1/2023,CHE,Sabah,21,9,12,Switzerland
80149,12/1/2023,CHE,Sarawak,22,10,12,Switzerland
80150,12/1/2023,CHE,Selangor,1707,1020,687,Switzerland
80151,12/1/2023,CHL,Johor,32,18,14,Chile
80152,12/1/2023,CHL,Kedah,26,13,13,Chile
80153,12/1/2023,CHL,Perlis,6,3,3,Chile
80154,12/1/2023,CHL,Pulau Pinang,6,4,2,Chile
80155,12/1/2023,CHL,Sabah,4,1,3,Chile
80156,12/1/2023,CHL,Selangor,267,125,142,Chile
80157,12/1/2023,CHN,Johor,57202,25651,31551,China
80158,12/1/2023,CHN,Kedah,1430,646,784,China
80159,12/1/2023,CHN,Kelantan,28,21,7,China
80160,12/1/2023,CHN,Melaka,2,0,2,China
80161,12/1/2023,CHN,Negeri Sembilan,5,4,1,China
80162,12/1/2023,CHN,Pahang,52,24,28,China
80163,12/1/2023,CHN,Perak,357,169,188,China
80164,12/1/2023,CHN,Perlis,328,171,157,China
80165,12/1/2023,CHN,Pulau Pinang,8862,4588,4274,China
80166,12/1/2023,CHN,Sabah,7294,3348,3946,China
80167,12/1/2023,CHN,Sarawak,1634,877,757,China
80168,12/1/2023,CHN,Selangor,102109,52914,49195,China
80169,12/1/2023,CHN,W.P. Labuan,91,77,14,China
80170,12/1/2023,CIV,Johor,3,3,0,C��te d'Iv
80171,12/1/2023,CIV,Selangor,5,1,4,C��te d'Iv
80172,12/1/2023,CMR,Kedah,1,1,0,Cameroon
80173,12/1/2023,CMR,Selangor,21,14,7,Cameroon
80174,12/1/2023,COD,Johor,2,2,0,"Congo, the Democratic Republic of the"
80175,12/1/2023,COD,Selangor,15,7,8,"Congo, the Democratic Republic of the"
80176,12/1/2023,COG,Selangor,4,4,0,Congo
80177,12/1/2023,COL,Johor,20,9,11,Colombia
80178,12/1/2023,COL,Kedah,8,4,4,Colombia
80179,12/1/2023,COL,Perlis,1,1,0,Colombia
80180,12/1/2023,COL,Pulau Pinang,10,2,8,Colombia
80181,12/1/2023,COL,Sabah,1,0,1,Colombia
80182,12/1/2023,COL,Sarawak,4,4,0,Colombia
80183,12/1/2023,COL,Selangor,227,123,104,Colombia
80184,12/1/2023,COM,Johor,5,0,5,Comoros
80185,12/1/2023,COM,Kedah,1,1,0,Comoros
80186,12/1/2023,COM,Selangor,12,8,4,Comoros
80187,12/1/2023,CPV,Selangor,1,0,1,Cape Verde
80188,12/1/2023,CRI,Johor,10,3,7,Costa Rica
80189,12/1/2023,CRI,Kedah,6,4,2,Costa Rica
80190,12/1/2023,CRI,Pulau Pinang,12,8,4,Costa Rica
80191,12/1/2023,CRI,Sabah,1,1,0,Costa Rica
80192,12/1/2023,CRI,Selangor,52,33,19,Costa Rica
80193,12/1/2023,CUB,Johor,7,6,1,Cuba
80194,12/1/2023,CUB,Pulau Pinang,1,1,0,Cuba
80195,12/1/2023,CUB,Selangor,20,13,7,Cuba
80196,12/1/2023,CYP,Johor,6,4,2,Cyprus
80197,12/1/2023,CYP,Kedah,7,3,4,Cyprus
80198,12/1/2023,CYP,Pulau Pinang,2,0,2,Cyprus
80199,12/1/2023,CYP,Sabah,7,3,4,Cyprus
80200,12/1/2023,CYP,Sarawak,1,0,1,Cyprus
80201,12/1/2023,CYP,Selangor,81,43,38,Cyprus
80202,12/1/2023,CZE,Johor,105,66,39,Czech Republic
80203,12/1/2023,CZE,Kedah,181,105,76,Czech Republic
80204,12/1/2023,CZE,Perak,1,0,1,Czech Republic
80205,12/1/2023,CZE,Perlis,6,3,3,Czech Republic
80206,12/1/2023,CZE,Pulau Pinang,29,19,10,Czech Republic
80207,12/1/2023,CZE,Sabah,10,7,3,Czech Republic
80208,12/1/2023,CZE,Sarawak,4,2,2,Czech Republic
80209,12/1/2023,CZE,Selangor,960,536,424,Czech Republic
80210,12/1/2023,DEU,Johor,2039,1351,688,Germany
80211,12/1/2023,DEU,Kedah,2860,1463,1397,Germany
80212,12/1/2023,DEU,Kelantan,17,12,5,Germany
80213,12/1/2023,DEU,Melaka,4,2,2,Germany
80214,12/1/2023,DEU,Pahang,6,3,3,Germany
80215,12/1/2023,DEU,Perak,15,11,4,Germany
80216,12/1/2023,DEU,Perlis,127,78,49,Germany
80217,12/1/2023,DEU,Pulau Pinang,660,422,238,Germany
80218,12/1/2023,DEU,Sabah,150,99,51,Germany
80219,12/1/2023,DEU,Sarawak,146,85,61,Germany
80220,12/1/2023,DEU,Selangor,10513,6023,4490,Germany
80221,12/1/2023,DEU,W.P. Labuan,6,5,1,Germany
80222,12/1/2023,DJI,Selangor,13,6,7,Djibouti
80223,12/1/2023,DMA,Johor,9,7,2,Dominica
80224,12/1/2023,DMA,Sarawak,2,1,1,Dominica
80225,12/1/2023,DMA,Selangor,60,40,20,Dominica
80226,12/1/2023,DNK,Johor,258,184,74,Denmark
80227,12/1/2023,DNK,Kedah,177,86,91,Denmark
80228,12/1/2023,DNK,Kelantan,1,1,0,Denmark
80229,12/1/2023,DNK,Melaka,6,3,3,Denmark
80230,12/1/2023,DNK,Perak,3,2,1,Denmark
80231,12/1/2023,DNK,Perlis,11,9,2,Denmark
80232,12/1/2023,DNK,Pulau Pinang,66,41,25,Denmark
80233,12/1/2023,DNK,Sabah,23,14,9,Denmark
80234,12/1/2023,DNK,Sarawak,13,6,7,Denmark
80235,12/1/2023,DNK,Selangor,1176,689,487,Denmark
80236,12/1/2023,DOM,Johor,2,0,2,Dominican Republic
80237,12/1/2023,DOM,Pulau Pinang,2,0,2,Dominican Republic
80238,12/1/2023,DOM,Sarawak,1,0,1,Dominican Republic
80239,12/1/2023,DOM,Selangor,10,5,5,Dominican Republic
80240,12/1/2023,DZA,Johor,41,25,16,Algeria
80241,12/1/2023,DZA,Kedah,6,6,0,Algeria
80242,12/1/2023,DZA,Perlis,2,2,0,Algeria
80243,12/1/2023,DZA,Pulau Pinang,3,2,1,Algeria
80244,12/1/2023,DZA,Sabah,2,1,1,Algeria
80245,12/1/2023,DZA,Sarawak,9,8,1,Algeria
80246,12/1/2023,DZA,Selangor,924,537,387,Algeria
80247,12/1/2023,ECU,Johor,17,7,10,Ecuador
80248,12/1/2023,ECU,Kedah,2,0,2,Ecuador
80249,12/1/2023,ECU,Perlis,2,0,2,Ecuador
80250,12/1/2023,ECU,Pulau Pinang,5,2,3,Ecuador
80251,12/1/2023,ECU,Selangor,78,40,38,Ecuador
80252,12/1/2023,EGY,Johor,266,207,59,Egypt
80253,12/1/2023,EGY,Kedah,5,3,2,Egypt
80254,12/1/2023,EGY,Perak,2,1,1,Egypt
80255,12/1/2023,EGY,Perlis,1,0,1,Egypt
80256,12/1/2023,EGY,Pulau Pinang,14,10,4,Egypt
80257,12/1/2023,EGY,Sabah,16,10,6,Egypt
80258,12/1/2023,EGY,Sarawak,220,132,88,Egypt
80259,12/1/2023,EGY,Selangor,1888,1258,630,Egypt
80260,12/1/2023,EGY,W.P. Labuan,1,1,0,Egypt
80261,12/1/2023,ERI,Selangor,14,5,9,Eritrea
80262,12/1/2023,ESP,Johor,348,209,139,Spain
80263,12/1/2023,ESP,Kedah,266,129,137,Spain
80264,12/1/2023,ESP,Kelantan,2,2,0,Spain
80265,12/1/2023,ESP,Pahang,1,1,0,Spain
80266,12/1/2023,ESP,Perlis,18,14,4,Spain
80267,12/1/2023,ESP,Pulau Pinang,105,55,50,Spain
80268,12/1/2023,ESP,Sabah,38,21,17,Spain
80269,12/1/2023,ESP,Sarawak,37,24,13,Spain
80270,12/1/2023,ESP,Selangor,2692,1471,1221,Spain
80271,12/1/2023,ESP,W.P. Labuan,5,3,2,Spain
80272,12/1/2023,EST,Johor,32,15,17,Estonia
80273,12/1/2023,EST,Kedah,32,12,20,Estonia
80274,12/1/2023,EST,Perlis,5,2,3,Estonia
80275,12/1/2023,EST,Pulau Pinang,8,5,3,Estonia
80276,12/1/2023,EST,Sabah,5,4,1,Estonia
80277,12/1/2023,EST,Sarawak,4,1,3,Estonia
80278,12/1/2023,EST,Selangor,424,215,209,Estonia
80279,12/1/2023,ETH,Sabah,1,0,1,Ethiopia
80280,12/1/2023,ETH,Selangor,27,15,12,Ethiopia
80281,12/1/2023,FIN,Johor,164,102,62,Finland
80282,12/1/2023,FIN,Kedah,117,64,53,Finland
80283,12/1/2023,FIN,Melaka,3,3,0,Finland
80284,12/1/2023,FIN,Perlis,12,8,4,Finland
80285,12/1/2023,FIN,Pulau Pinang,69,41,28,Finland
80286,12/1/2023,FIN,Sabah,18,9,9,Finland
80287,12/1/2023,FIN,Sarawak,16,12,4,Finland
80288,12/1/2023,FIN,Selangor,835,463,372,Finland
80289,12/1/2023,FJI,Johor,184,79,105,Fiji
80290,12/1/2023,FJI,Kedah,4,2,2,Fiji
80291,12/1/2023,FJI,Pulau Pinang,2,2,0,Fiji
80292,12/1/2023,FJI,Sabah,1,0,1,Fiji
80293,12/1/2023,FJI,Sarawak,3,0,3,Fiji
80294,12/1/2023,FJI,Selangor,295,134,161,Fiji
80295,12/1/2023,FRA,Johor,1773,1137,636,France
80296,12/1/2023,FRA,Kedah,770,425,345,France
80297,12/1/2023,FRA,Kelantan,13,8,5,France
80298,12/1/2023,FRA,Melaka,1,1,0,France
80299,12/1/2023,FRA,Negeri Sembilan,5,3,2,France
80300,12/1/2023,FRA,Pahang,37,17,20,France
80301,12/1/2023,FRA,Perak,44,25,19,France
80302,12/1/2023,FRA,Perlis,71,49,22,France
80303,12/1/2023,FRA,Pulau Pinang,459,280,179,France
80304,12/1/2023,FRA,Sabah,143,86,57,France
80305,12/1/2023,FRA,Sarawak,72,51,21,France
80306,12/1/2023,FRA,Selangor,7563,4513,3050,France
80307,12/1/2023,FRA,W.P. Labuan,3,2,1,France
80308,12/1/2023,GAB,Selangor,8,4,4,Gabon
80309,12/1/2023,GBR,Johor,4739,3036,1703,United Kingdom
80310,12/1/2023,GBR,Kedah,3896,2029,1867,United Kingdom
80311,12/1/2023,GBR,Kelantan,13,10,3,United Kingdom
80312,12/1/2023,GBR,Melaka,1,0,1,United Kingdom
80313,12/1/2023,GBR,Pahang,33,18,15,United Kingdom
80314,12/1/2023,GBR,Perak,96,52,44,United Kingdom
80315,12/1/2023,GBR,Perlis,153,102,51,United Kingdom
80316,12/1/2023,GBR,Pulau Pinang,1877,1116,761,United Kingdom
80317,12/1/2023,GBR,Sabah,492,277,215,United Kingdom
80318,12/1/2023,GBR,Sarawak,1579,921,658,United Kingdom
80319,12/1/2023,GBR,Selangor,22293,12978,9315,United Kingdom
80320,12/1/2023,GBR,W.P. Labuan,34,23,11,United Kingdom
80321,12/1/2023,GEO,Johor,3,2,1,Georgia
80322,12/1/2023,GEO,Kedah,3,1,2,Georgia
80323,12/1/2023,GEO,Pulau Pinang,1,1,0,Georgia
80324,12/1/2023,GEO,Selangor,68,37,31,Georgia
80325,12/1/2023,GHA,Johor,7,6,1,Ghana
80326,12/1/2023,GHA,Kedah,6,2,4,Ghana
80327,12/1/2023,GHA,Perlis,2,1,1,Ghana
80328,12/1/2023,GHA,Pulau Pinang,3,2,1,Ghana
80329,12/1/2023,GHA,Sabah,1,1,0,Ghana
80330,12/1/2023,GHA,Sarawak,1,1,0,Ghana
80331,12/1/2023,GHA,Selangor,127,68,59,Ghana
80332,12/1/2023,GIN,Johor,11,8,3,Guinea
80333,12/1/2023,GIN,Perlis,1,0,1,Guinea
80334,12/1/2023,GIN,Sabah,1,1,0,Guinea
80335,12/1/2023,GIN,Selangor,55,42,13,Guinea
80336,12/1/2023,GMB,Johor,1,1,0,Gambia
80337,12/1/2023,GMB,Selangor,25,17,8,Gambia
80338,12/1/2023,GNQ,Johor,1,1,0,Equatorial Guinea
80339,12/1/2023,GRC,Johor,51,33,18,Greece
80340,12/1/2023,GRC,Kedah,34,20,14,Greece
80341,12/1/2023,GRC,Perlis,2,2,0,Greece
80342,12/1/2023,GRC,Pulau Pinang,10,5,5,Greece
80343,12/1/2023,GRC,Sabah,5,2,3,Greece
80344,12/1/2023,GRC,Sarawak,4,3,1,Greece
80345,12/1/2023,GRC,Selangor,463,275,188,Greece
80346,12/1/2023,GRD,Kedah,4,1,3,Grenada
80347,12/1/2023,GRD,Selangor,10,6,4,Grenada
80348,12/1/2023,GTM,Johor,4,2,2,Guatemala
80349,12/1/2023,GTM,Kedah,5,2,3,Guatemala
80350,12/1/2023,GTM,Selangor,38,20,18,Guatemala
80351,12/1/2023,GUY,Johor,7,4,3,Guyana
80352,12/1/2023,GUY,Selangor,9,6,3,Guyana
80353,12/1/2023,HKG,Johor,1,0,1,Hong Kong
80354,12/1/2023,HKG,Kedah,3,1,2,Hong Kong
80355,12/1/2023,HKG,Pahang,3,1,2,Hong Kong
80356,12/1/2023,HKG,Perak,51,24,27,Hong Kong
80357,12/1/2023,HKG,Sabah,6470,2834,3636,Hong Kong
80358,12/1/2023,HKG,Selangor,2750,1481,1269,Hong Kong
80359,12/1/2023,HND,Johor,3,3,0,Honduras
80360,12/1/2023,HND,Kedah,1,1,0,Honduras
80361,12/1/2023,HND,Selangor,9,6,3,Honduras
80362,12/1/2023,HRV,Johor,27,19,8,Croatia
80363,12/1/2023,HRV,Kedah,9,5,4,Croatia
80364,12/1/2023,HRV,Pulau Pinang,6,5,1,Croatia
80365,12/1/2023,HRV,Sabah,1,1,0,Croatia
80366,12/1/2023,HRV,Sarawak,5,5,0,Croatia
80367,12/1/2023,HRV,Selangor,325,181,144,Croatia
80368,12/1/2023,HTI,Johor,5,3,2,Haiti
80369,12/1/2023,HTI,Selangor,8,5,3,Haiti
80370,12/1/2023,HUN,Johor,102,66,36,Hungary
80371,12/1/2023,HUN,Kedah,78,44,34,Hungary
80372,12/1/2023,HUN,Kelantan,2,1,1,Hungary
80373,12/1/2023,HUN,Perak,1,1,0,Hungary
80374,12/1/2023,HUN,Perlis,6,5,1,Hungary
80375,12/1/2023,HUN,Pulau Pinang,47,25,22,Hungary
80376,12/1/2023,HUN,Sabah,3,0,3,Hungary
80377,12/1/2023,HUN,Sarawak,8,5,3,Hungary
80378,12/1/2023,HUN,Selangor,843,423,420,Hungary
80379,12/1/2023,IDN,Johor,120074,52520,67554,Indonesia
80380,12/1/2023,IDN,Kedah,6403,2358,4045,Indonesia
80381,12/1/2023,IDN,Kelantan,124,83,41,Indonesia
80382,12/1/2023,IDN,Melaka,5327,2256,3071,Indonesia
80383,12/1/2023,IDN,Negeri Sembilan,5111,2637,2474,Indonesia
80384,12/1/2023,IDN,Pahang,45,34,11,Indonesia
80385,12/1/2023,IDN,Perak,338,87,251,Indonesia
80386,12/1/2023,IDN,Perlis,719,257,462,Indonesia
80387,12/1/2023,IDN,Pulau Pinang,40678,16866,23812,Indonesia
80388,12/1/2023,IDN,Sabah,7170,3155,4015,Indonesia
80389,12/1/2023,IDN,Sarawak,55980,26397,29583,Indonesia
80390,12/1/2023,IDN,Selangor,161439,74219,87220,Indonesia
80391,12/1/2023,IDN,W.P. Labuan,73,38,35,Indonesia
80392,12/1/2023,IND,Johor,37891,24550,13341,India
80393,12/1/2023,IND,Kedah,1460,805,655,India
80394,12/1/2023,IND,Kelantan,4,3,1,India
80395,12/1/2023,IND,Melaka,3,2,1,India
80396,12/1/2023,IND,Pahang,19,9,10,India
80397,12/1/2023,IND,Perak,399,279,120,India
80398,12/1/2023,IND,Perlis,60,46,14,India
80399,12/1/2023,IND,Pulau Pinang,1269,776,493,India
80400,12/1/2023,IND,Sabah,230,156,74,India
80401,12/1/2023,IND,Sarawak,3061,2401,660,India
80402,12/1/2023,IND,Selangor,67889,43330,24559,India
80403,12/1/2023,IND,W.P. Labuan,121,107,14,India
80404,12/1/2023,IOT,Selangor,2,0,2,British Indian Ocean Territory
80405,12/1/2023,IRL,Johor,208,122,86,Ireland
80406,12/1/2023,IRL,Kedah,151,79,72,Ireland
80407,12/1/2023,IRL,Kelantan,3,3,0,Ireland
80408,12/1/2023,IRL,Perak,8,6,2,Ireland
80409,12/1/2023,IRL,Perlis,10,6,4,Ireland
80410,12/1/2023,IRL,Pulau Pinang,130,72,58,Ireland
80411,12/1/2023,IRL,Sabah,14,9,5,Ireland
80412,12/1/2023,IRL,Sarawak,43,26,17,Ireland
80413,12/1/2023,IRL,Selangor,1330,795,535,Ireland
80414,12/1/2023,IRN,Johor,352,193,159,Iran
80415,12/1/2023,IRN,Kedah,11,6,5,Iran
80416,12/1/2023,IRN,Perlis,3,3,0,Iran
80417,12/1/2023,IRN,Pulau Pinang,10,6,4,Iran
80418,12/1/2023,IRN,Sabah,2,1,1,Iran
80419,12/1/2023,IRN,Sarawak,6,4,2,Iran
80420,12/1/2023,IRN,Selangor,2481,1322,1159,Iran
80421,12/1/2023,IRQ,Johor,72,49,23,Iraq
80422,12/1/2023,IRQ,Pulau Pinang,1,1,0,Iraq
80423,12/1/2023,IRQ,Sabah,1,1,0,Iraq
80424,12/1/2023,IRQ,Sarawak,4,3,1,Iraq
80425,12/1/2023,IRQ,Selangor,1498,1038,460,Iraq
80426,12/1/2023,ISL,Johor,10,8,2,Iceland
80427,12/1/2023,ISL,Kedah,1,1,0,Iceland
80428,12/1/2023,ISL,Perak,6,3,3,Iceland
80429,12/1/2023,ISL,Pulau Pinang,7,3,4,Iceland
80430,12/1/2023,ISL,Sabah,1,1,0,Iceland
80431,12/1/2023,ISL,Sarawak,1,1,0,Iceland
80432,12/1/2023,ISL,Selangor,47,28,19,Iceland
80433,12/1/2023,ISR,Pulau Pinang,1,0,1,Israel
80434,12/1/2023,ITA,Johor,576,358,218,Italy
80435,12/1/2023,ITA,Kedah,441,251,190,Italy
80436,12/1/2023,ITA,Kelantan,3,3,0,Italy
80437,12/1/2023,ITA,Negeri Sembilan,1,1,0,Italy
80438,12/1/2023,ITA,Perak,6,5,1,Italy
80439,12/1/2023,ITA,Perlis,27,23,4,Italy
80440,12/1/2023,ITA,Pulau Pinang,144,95,49,Italy
80441,12/1/2023,ITA,Sabah,38,27,11,Italy
80442,12/1/2023,ITA,Sarawak,51,34,17,Italy
80443,12/1/2023,ITA,Selangor,3479,2093,1386,Italy
80444,12/1/2023,ITA,W.P. Labuan,2,2,0,Italy
80445,12/1/2023,JAM,Johor,3,1,2,Jamaica
80446,12/1/2023,JAM,Kedah,1,0,1,Jamaica
80447,12/1/2023,JAM,Pulau Pinang,1,0,1,Jamaica
80448,12/1/2023,JAM,Selangor,12,7,5,Jamaica
80449,12/1/2023,JOR,Johor,15,14,1,Jordan
80450,12/1/2023,JOR,Kedah,2,2,0,Jordan
80451,12/1/2023,JOR,Pahang,1,1,0,Jordan
80452,12/1/2023,JOR,Perak,1,1,0,Jordan
80453,12/1/2023,JOR,Pulau Pinang,18,8,10,Jordan
80454,12/1/2023,JOR,Sabah,1,1,0,Jordan
80455,12/1/2023,JOR,Selangor,897,529,368,Jordan
80456,12/1/2023,JPN,Johor,6394,4020,2374,Japan
80457,12/1/2023,JPN,Kedah,508,262,246,Japan
80458,12/1/2023,JPN,Kelantan,10,7,3,Japan
80459,12/1/2023,JPN,Melaka,1,1,0,Japan
80460,12/1/2023,JPN,Negeri Sembilan,1,1,0,Japan
80461,12/1/2023,JPN,Pahang,24,15,9,Japan
80462,12/1/2023,JPN,Perak,53,27,26,Japan
80463,12/1/2023,JPN,Perlis,76,60,16,Japan
80464,12/1/2023,JPN,Pulau Pinang,1614,1023,591,Japan
80465,12/1/2023,JPN,Sabah,507,275,232,Japan
80466,12/1/2023,JPN,Sarawak,212,116,96,Japan
80467,12/1/2023,JPN,Selangor,20372,12029,8343,Japan
80468,12/1/2023,JPN,W.P. Labuan,19,13,6,Japan
80469,12/1/2023,KAZ,Johor,68,29,39,Kazakhstan
80470,12/1/2023,KAZ,Kedah,25,13,12,Kazakhstan
80471,12/1/2023,KAZ,Kelantan,2,1,1,Kazakhstan
80472,12/1/2023,KAZ,Perlis,8,3,5,Kazakhstan
80473,12/1/2023,KAZ,Pulau Pinang,9,3,6,Kazakhstan
80474,12/1/2023,KAZ,Sabah,1,0,1,Kazakhstan
80475,12/1/2023,KAZ,Sarawak,3,0,3,Kazakhstan
80476,12/1/2023,KAZ,Selangor,1156,478,678,Kazakhstan
80477,12/1/2023,KAZ,W.P. Labuan,1,0,1,Kazakhstan
80478,12/1/2023,KEN,Johor,96,52,44,Kenya
80479,12/1/2023,KEN,Kedah,10,6,4,Kenya
80480,12/1/2023,KEN,Pulau Pinang,20,9,11,Kenya
80481,12/1/2023,KEN,Selangor,800,406,394,Kenya
80482,12/1/2023,KGZ,Johor,37,27,10,Kyrgyzstan
80483,12/1/2023,KGZ,Kedah,6,4,2,Kyrgyzstan
80484,12/1/2023,KGZ,Pulau Pinang,6,2,4,Kyrgyzstan
80485,12/1/2023,KGZ,Sabah,5,3,2,Kyrgyzstan
80486,12/1/2023,KGZ,Selangor,311,136,175,Kyrgyzstan
80487,12/1/2023,KHM,Johor,2487,1059,1428,Cambodia
80488,12/1/2023,KHM,Kedah,334,263,71,Cambodia
80489,12/1/2023,KHM,Kelantan,423,231,192,Cambodia
80490,12/1/2023,KHM,Melaka,1,0,1,Cambodia
80491,12/1/2023,KHM,Perak,7,1,6,Cambodia
80492,12/1/2023,KHM,Perlis,551,327,224,Cambodia
80493,12/1/2023,KHM,Pulau Pinang,36,17,19,Cambodia
80494,12/1/2023,KHM,Sabah,3,2,1,Cambodia
80495,12/1/2023,KHM,Sarawak,9,3,6,Cambodia
80496,12/1/2023,KHM,Selangor,4017,1746,2271,Cambodia
80497,12/1/2023,KIR,Johor,1,0,1,Kiribati
80498,12/1/2023,KIR,Selangor,7,2,5,Kiribati
80499,12/1/2023,KNA,Johor,18,12,6,Saint Kitts and Nevis
80500,12/1/2023,KNA,Kedah,3,2,1,Saint Kitts and Nevis
80501,12/1/2023,KNA,Perak,1,0,1,Saint Kitts and Nevis
80502,12/1/2023,KNA,Pulau Pinang,2,2,0,Saint Kitts and Nevis
80503,12/1/2023,KNA,Sabah,7,3,4,Saint Kitts and Nevis
80504,12/1/2023,KNA,Selangor,83,59,24,Saint Kitts and Nevis
80505,12/1/2023,KOR,Johor,12417,6647,5770,"Korea, Republic of (South Korea)"
80506,12/1/2023,KOR,Kedah,371,173,198,"Korea, Republic of (South Korea)"
80507,12/1/2023,KOR,Kelantan,6,4,2,"Korea, Republic of (South Korea)"
80508,12/1/2023,KOR,Pahang,3,1,2,"Korea, Republic of (South Korea)"
80509,12/1/2023,KOR,Perak,32,18,14,"Korea, Republic of (South Korea)"
80510,12/1/2023,KOR,Perlis,131,77,54,"Korea, Republic of (South Korea)"
80511,12/1/2023,KOR,Pulau Pinang,567,283,284,"Korea, Republic of (South Korea)"
80512,12/1/2023,KOR,Sabah,17290,7509,9781,"Korea, Republic of (South Korea)"
80513,12/1/2023,KOR,Sarawak,319,175,144,"Korea, Republic of (South Korea)"
80514,12/1/2023,KOR,Selangor,18135,9782,8353,"Korea, Republic of (South Korea)"
80515,12/1/2023,KOR,W.P. Labuan,10,5,5,"Korea, Republic of (South Korea)"
80516,12/1/2023,KWT,Johor,13,10,3,Kuwait
80517,12/1/2023,KWT,Kedah,1,1,0,Kuwait
80518,12/1/2023,KWT,Pulau Pinang,3,2,1,Kuwait
80519,12/1/2023,KWT,Sarawak,1,1,0,Kuwait
80520,12/1/2023,KWT,Selangor,375,226,149,Kuwait
80521,12/1/2023,LAO,Johor,211,73,138,Lao People's Democratic Republic
80522,12/1/2023,LAO,Kedah,994,76,918,Lao People's Democratic Republic
80523,12/1/2023,LAO,Kelantan,166,8,158,Lao People's Democratic Republic
80524,12/1/2023,LAO,Perak,43,7,36,Lao People's Democratic Republic
80525,12/1/2023,LAO,Perlis,347,63,284,Lao People's Democratic Republic
80526,12/1/2023,LAO,Pulau Pinang,29,3,26,Lao People's Democratic Republic
80527,12/1/2023,LAO,Sabah,1,0,1,Lao People's Democratic Republic
80528,12/1/2023,LAO,Sarawak,28,9,19,Lao People's Democratic Republic
80529,12/1/2023,LAO,Selangor,257,88,169,Lao People's Democratic Republic
80530,12/1/2023,LBN,Johor,43,25,18,Lebanon
80531,12/1/2023,LBN,Kedah,8,4,4,Lebanon
80532,12/1/2023,LBN,Pulau Pinang,9,5,4,Lebanon
80533,12/1/2023,LBN,Sarawak,6,5,1,Lebanon
80534,12/1/2023,LBN,Selangor,424,258,166,Lebanon
80535,12/1/2023,LBR,Johor,2,2,0,Liberia
80536,12/1/2023,LBR,Selangor,9,9,0,Liberia
80537,12/1/2023,LBY,Johor,5,4,1,Libyan Arab Jamahiriya
80538,12/1/2023,LBY,Pulau Pinang,7,5,2,Libyan Arab Jamahiriya
80539,12/1/2023,LBY,Sarawak,1,1,0,Libyan Arab Jamahiriya
80540,12/1/2023,LBY,Selangor,375,274,101,Libyan Arab Jamahiriya
80541,12/1/2023,LCA,Johor,5,3,2,Saint Lucia
80542,12/1/2023,LCA,Kedah,1,0,1,Saint Lucia
80543,12/1/2023,LCA,Sarawak,5,3,2,Saint Lucia
80544,12/1/2023,LCA,Selangor,15,12,3,Saint Lucia
80545,12/1/2023,LIE,Pulau Pinang,5,4,1,Liechtenstein
80546,12/1/2023,LIE,Selangor,3,1,2,Liechtenstein
80547,12/1/2023,LKA,Johor,1132,660,472,Sri Lanka
80548,12/1/2023,LKA,Kedah,39,19,20,Sri Lanka
80549,12/1/2023,LKA,Melaka,1,1,0,Sri Lanka
80550,12/1/2023,LKA,Perak,10,6,4,Sri Lanka
80551,12/1/2023,LKA,Perlis,9,6,3,Sri Lanka
80552,12/1/2023,LKA,Pulau Pinang,75,43,32,Sri Lanka
80553,12/1/2023,LKA,Sabah,7,4,3,Sri Lanka
80554,12/1/2023,LKA,Sarawak,53,40,13,Sri Lanka
80555,12/1/2023,LKA,Selangor,5552,3192,2360,Sri Lanka
80556,12/1/2023,LKA,W.P. Labuan,3,3,0,Sri Lanka
80557,12/1/2023,LSO,Selangor,4,1,3,Lesotho
80558,12/1/2023,LTU,Johor,43,20,23,Lithuania
80559,12/1/2023,LTU,Kedah,88,43,45,Lithuania
80560,12/1/2023,LTU,Kelantan,1,1,0,Lithuania
80561,12/1/2023,LTU,Perlis,7,4,3,Lithuania
80562,12/1/2023,LTU,Pulau Pinang,19,9,10,Lithuania
80563,12/1/2023,LTU,Sabah,2,1,1,Lithuania
80564,12/1/2023,LTU,Sarawak,24,7,17,Lithuania
80565,12/1/2023,LTU,Selangor,589,303,286,Lithuania
80566,12/1/2023,LUX,Johor,5,4,1,Luxembourg
80567,12/1/2023,LUX,Kedah,9,6,3,Luxembourg
80568,12/1/2023,LUX,Pulau Pinang,2,2,0,Luxembourg
80569,12/1/2023,LUX,Sabah,1,1,0,Luxembourg
80570,12/1/2023,LUX,Selangor,43,24,19,Luxembourg
80571,12/1/2023,LVA,Johor,29,13,16,Latvia
80572,12/1/2023,LVA,Kedah,20,9,11,Latvia
80573,12/1/2023,LVA,Perak,1,0,1,Latvia
80574,12/1/2023,LVA,Perlis,1,1,0,Latvia
80575,12/1/2023,LVA,Pulau Pinang,3,1,2,Latvia
80576,12/1/2023,LVA,Sabah,2,1,1,Latvia
80577,12/1/2023,LVA,Sarawak,10,4,6,Latvia
80578,12/1/2023,LVA,Selangor,254,129,125,Latvia
80579,12/1/2023,MAC,Selangor,25,14,11,Macao
80580,12/1/2023,MAR,Johor,113,70,43,Morocco
80581,12/1/2023,MAR,Kedah,10,4,6,Morocco
80582,12/1/2023,MAR,Kelantan,3,2,1,Morocco
80583,12/1/2023,MAR,Perak,1,0,1,Morocco
80584,12/1/2023,MAR,Perlis,4,3,1,Morocco
80585,12/1/2023,MAR,Pulau Pinang,10,8,2,Morocco
80586,12/1/2023,MAR,Sabah,5,4,1,Morocco
80587,12/1/2023,MAR,Sarawak,14,12,2,Morocco
80588,12/1/2023,MAR,Selangor,952,486,466,Morocco
80589,12/1/2023,MCO,Johor,1,1,0,Monaco
80590,12/1/2023,MCO,Selangor,2,2,0,Monaco
80591,12/1/2023,MDA,Johor,8,4,4,"Moldova, Republic of"
80592,12/1/2023,MDA,Pulau Pinang,1,1,0,"Moldova, Republic of"
80593,12/1/2023,MDA,Selangor,28,18,10,"Moldova, Republic of"
80594,12/1/2023,MDG,Johor,16,6,10,Madagascar
80595,12/1/2023,MDG,Pulau Pinang,4,1,3,Madagascar
80596,12/1/2023,MDG,Selangor,73,37,36,Madagascar
80597,12/1/2023,MDV,Johor,299,138,161,Maldives
80598,12/1/2023,MDV,Kedah,4,4,0,Maldives
80599,12/1/2023,MDV,Pulau Pinang,1,1,0,Maldives
80600,12/1/2023,MDV,Sabah,8,4,4,Maldives
80601,12/1/2023,MDV,Sarawak,4,4,0,Maldives
80602,12/1/2023,MDV,Selangor,4511,2194,2317,Maldives
80603,12/1/2023,MEX,Johor,174,76,98,Mexico
80604,12/1/2023,MEX,Kedah,103,49,54,Mexico
80605,12/1/2023,MEX,Kelantan,1,0,1,Mexico
80606,12/1/2023,MEX,Pahang,1,1,0,Mexico
80607,12/1/2023,MEX,Perak,6,4,2,Mexico
80608,12/1/2023,MEX,Perlis,3,2,1,Mexico
80609,12/1/2023,MEX,Pulau Pinang,24,16,8,Mexico
80610,12/1/2023,MEX,Sabah,3,1,2,Mexico
80611,12/1/2023,MEX,Sarawak,3,2,1,Mexico
80612,12/1/2023,MEX,Selangor,836,419,417,Mexico
80613,12/1/2023,MHL,Sarawak,1,1,0,Marshall Islands
80614,12/1/2023,MHL,Selangor,2,1,1,Marshall Islands
80615,12/1/2023,MKD,Johor,10,4,6,"Macedonia, the former Yugoslav Republic of"
80616,12/1/2023,MKD,Kedah,3,2,1,"Macedonia, the former Yugoslav Republic of"
80617,12/1/2023,MKD,Pulau Pinang,1,0,1,"Macedonia, the former Yugoslav Republic of"
80618,12/1/2023,MKD,Sarawak,2,1,1,"Macedonia, the former Yugoslav Republic of"
80619,12/1/2023,MKD,Selangor,50,26,24,"Macedonia, the former Yugoslav Republic of"
80620,12/1/2023,MLI,Selangor,13,12,1,Mali
80621,12/1/2023,MLT,Johor,11,6,5,Malta
80622,12/1/2023,MLT,Kedah,12,8,4,Malta
80623,12/1/2023,MLT,Selangor,61,32,29,Malta
80624,12/1/2023,MMR,Johor,8500,2412,6088,Myanmar
80625,12/1/2023,MMR,Kedah,91,20,71,Myanmar
80626,12/1/2023,MMR,Kelantan,3,3,0,Myanmar
80627,12/1/2023,MMR,Pahang,3,1,2,Myanmar
80628,12/1/2023,MMR,Perak,40,7,33,Myanmar
80629,12/1/2023,MMR,Perlis,5,1,4,Myanmar
80630,12/1/2023,MMR,Pulau Pinang,551,243,308,Myanmar
80631,12/1/2023,MMR,Sabah,28,11,17,Myanmar
80632,12/1/2023,MMR,Sarawak,117,57,60,Myanmar
80633,12/1/2023,MMR,Selangor,6539,4251,2288,Myanmar
80634,12/1/2023,MMR,W.P. Labuan,1,1,0,Myanmar
80635,12/1/2023,MNE,Selangor,26,20,6,Montenegro
80636,12/1/2023,MNG,Johor,293,137,156,Mongolia
80637,12/1/2023,MNG,Kedah,22,11,11,Mongolia
80638,12/1/2023,MNG,Perlis,6,3,3,Mongolia
80639,12/1/2023,MNG,Pulau Pinang,13,5,8,Mongolia
80640,12/1/2023,MNG,Sabah,17,5,12,Mongolia
80641,12/1/2023,MNG,Selangor,622,273,349,Mongolia
80642,12/1/2023,MOZ,Selangor,41,22,19,Mozambique
80643,12/1/2023,MRT,Selangor,30,22,8,Mauritania
80644,12/1/2023,MUS,Johor,443,221,222,Mauritius
80645,12/1/2023,MUS,Kedah,5,3,2,Mauritius
80646,12/1/2023,MUS,Pahang,1,1,0,Mauritius
80647,12/1/2023,MUS,Pulau Pinang,11,6,5,Mauritius
80648,12/1/2023,MUS,Sabah,2,1,1,Mauritius
80649,12/1/2023,MUS,Selangor,2884,1374,1510,Mauritius
80650,12/1/2023,MWI,Sabah,1,0,1,Malawi
80651,12/1/2023,MWI,Selangor,37,21,16,Malawi
80652,12/1/2023,NAM,Johor,4,1,3,Namibia
80653,12/1/2023,NAM,Kedah,1,1,0,Namibia
80654,12/1/2023,NAM,Sabah,1,0,1,Namibia
80655,12/1/2023,NAM,Selangor,25,14,11,Namibia
80656,12/1/2023,NER,Selangor,1,1,0,Niger
80657,12/1/2023,NGA,Johor,28,25,3,Nigeria
80658,12/1/2023,NGA,Pulau Pinang,5,3,2,Nigeria
80659,12/1/2023,NGA,Sabah,1,1,0,Nigeria
80660,12/1/2023,NGA,Sarawak,22,17,5,Nigeria
80661,12/1/2023,NGA,Selangor,346,261,85,Nigeria
80662,12/1/2023,NIC,Johor,5,3,2,Nicaragua
80663,12/1/2023,NIC,Selangor,4,2,2,Nicaragua
80664,12/1/2023,NLD,Johor,861,546,315,Netherlands
80665,12/1/2023,NLD,Kedah,397,201,196,Netherlands
80666,12/1/2023,NLD,Melaka,1,1,0,Netherlands
80667,12/1/2023,NLD,Pahang,11,5,6,Netherlands
80668,12/1/2023,NLD,Perak,13,9,4,Netherlands
80669,12/1/2023,NLD,Perlis,29,19,10,Netherlands
80670,12/1/2023,NLD,Pulau Pinang,268,157,111,Netherlands
80671,12/1/2023,NLD,Sabah,74,45,29,Netherlands
80672,12/1/2023,NLD,Sarawak,114,67,47,Netherlands
80673,12/1/2023,NLD,Selangor,4556,2656,1900,Netherlands
80674,12/1/2023,NLD,W.P. Labuan,4,2,2,Netherlands
80675,12/1/2023,NOR,Johor,135,75,60,Norway
80676,12/1/2023,NOR,Kedah,124,58,66,Norway
80677,12/1/2023,NOR,Kelantan,3,3,0,Norway
80678,12/1/2023,NOR,Perlis,5,2,3,Norway
80679,12/1/2023,NOR,Pulau Pinang,42,24,18,Norway
80680,12/1/2023,NOR,Sabah,7,3,4,Norway
80681,12/1/2023,NOR,Sarawak,14,11,3,Norway
80682,12/1/2023,NOR,Selangor,946,514,432,Norway
80683,12/1/2023,NPL,Johor,759,621,138,Nepal
80684,12/1/2023,NPL,Kedah,4,2,2,Nepal
80685,12/1/2023,NPL,Perak,1,1,0,Nepal
80686,12/1/2023,NPL,Pulau Pinang,20,15,5,Nepal
80687,12/1/2023,NPL,Sabah,9,8,1,Nepal
80688,12/1/2023,NPL,Sarawak,496,347,149,Nepal
80689,12/1/2023,NPL,Selangor,10982,10428,554,Nepal
80690,12/1/2023,NPL,W.P. Labuan,71,65,6,Nepal
80691,12/1/2023,NRU,Selangor,2,2,0,Nauru
80692,12/1/2023,NZL,Johor,1101,615,486,New Zealand
80693,12/1/2023,NZL,Kedah,200,115,85,New Zealand
80694,12/1/2023,NZL,Kelantan,1,1,0,New Zealand
80695,12/1/2023,NZL,Melaka,2,1,1,New Zealand
80696,12/1/2023,NZL,Pahang,4,3,1,New Zealand
80697,12/1/2023,NZL,Perak,37,16,21,New Zealand
80698,12/1/2023,NZL,Perlis,20,17,3,New Zealand
80699,12/1/2023,NZL,Pulau Pinang,364,194,170,New Zealand
80700,12/1/2023,NZL,Sabah,118,64,54,New Zealand
80701,12/1/2023,NZL,Sarawak,216,125,91,New Zealand
80702,12/1/2023,NZL,Selangor,4693,2618,2075,New Zealand
80703,12/1/2023,NZL,W.P. Labuan,1,0,1,New Zealand
80704,12/1/2023,OMN,Johor,41,20,21,Oman
80705,12/1/2023,OMN,Kedah,7,5,2,Oman
80706,12/1/2023,OMN,Pulau Pinang,3,2,1,Oman
80707,12/1/2023,OMN,Sabah,4,0,4,Oman
80708,12/1/2023,OMN,Sarawak,8,4,4,Oman
80709,12/1/2023,OMN,Selangor,1852,1094,758,Oman
80710,12/1/2023,OMN,W.P. Labuan,1,1,0,Oman
80711,12/1/2023,PAK,Johor,695,480,215,Pakistan
80712,12/1/2023,PAK,Kedah,69,58,11,Pakistan
80713,12/1/2023,PAK,Kelantan,16,16,0,Pakistan
80714,12/1/2023,PAK,Melaka,1,1,0,Pakistan
80715,12/1/2023,PAK,Perak,14,14,0,Pakistan
80716,12/1/2023,PAK,Perlis,18,18,0,Pakistan
80717,12/1/2023,PAK,Pulau Pinang,95,86,9,Pakistan
80718,12/1/2023,PAK,Sabah,24,21,3,Pakistan
80719,12/1/2023,PAK,Sarawak,215,168,47,Pakistan
80720,12/1/2023,PAK,Selangor,11072,8723,2349,Pakistan
80721,12/1/2023,PAK,W.P. Labuan,7,4,3,Pakistan
80722,12/1/2023,PAN,Johor,1,1,0,Panama
80723,12/1/2023,PAN,Selangor,22,10,12,Panama
80724,12/1/2023,PER,Johor,23,13,10,Peru
80725,12/1/2023,PER,Kedah,21,8,13,Peru
80726,12/1/2023,PER,Perlis,1,0,1,Peru
80727,12/1/2023,PER,Pulau Pinang,3,3,0,Peru
80728,12/1/2023,PER,Sabah,6,4,2,Peru
80729,12/1/2023,PER,Selangor,161,75,86,Peru
80730,12/1/2023,PHL,Johor,27937,8557,19380,Philippines
80731,12/1/2023,PHL,Kedah,586,193,393,Philippines
80732,12/1/2023,PHL,Kelantan,20,7,13,Philippines
80733,12/1/2023,PHL,Negeri Sembilan,1,1,0,Philippines
80734,12/1/2023,PHL,Pahang,10,1,9,Philippines
80735,12/1/2023,PHL,Perak,78,18,60,Philippines
80736,12/1/2023,PHL,Perlis,248,72,176,Philippines
80737,12/1/2023,PHL,Pulau Pinang,818,320,498,Philippines
80738,12/1/2023,PHL,Sabah,1733,712,1021,Philippines
80739,12/1/2023,PHL,Sarawak,4368,1836,2532,Philippines
80740,12/1/2023,PHL,Selangor,19207,7604,11603,Philippines
80741,12/1/2023,PHL,Terengganu,1,1,0,Philippines
80742,12/1/2023,PHL,W.P. Labuan,139,52,87,Philippines
80743,12/1/2023,PNG,Johor,31,15,16,Papua New Guinea
80744,12/1/2023,PNG,Perak,2,1,1,Papua New Guinea
80745,12/1/2023,PNG,Pulau Pinang,2,2,0,Papua New Guinea
80746,12/1/2023,PNG,Sarawak,2,0,2,Papua New Guinea
80747,12/1/2023,PNG,Selangor,39,22,17,Papua New Guinea
80748,12/1/2023,POL,Johor,365,196,169,Poland
80749,12/1/2023,POL,Kedah,197,102,95,Poland
80750,12/1/2023,POL,Kelantan,1,1,0,Poland
80751,12/1/2023,POL,Pahang,7,3,4,Poland
80752,12/1/2023,POL,Perlis,18,10,8,Poland
80753,12/1/2023,POL,Pulau Pinang,65,42,23,Poland
80754,12/1/2023,POL,Sabah,41,21,20,Poland
80755,12/1/2023,POL,Sarawak,24,15,9,Poland
80756,12/1/2023,POL,Selangor,1705,883,822,Poland
80757,12/1/2023,POL,W.P. Labuan,1,1,0,Poland
80758,12/1/2023,PRT,Johor,162,91,71,Portugal
80759,12/1/2023,PRT,Kedah,83,47,36,Portugal
80760,12/1/2023,PRT,Perak,1,1,0,Portugal
80761,12/1/2023,PRT,Perlis,8,6,2,Portugal
80762,12/1/2023,PRT,Pulau Pinang,54,25,29,Portugal
80763,12/1/2023,PRT,Sabah,23,9,14,Portugal
80764,12/1/2023,PRT,Sarawak,13,7,6,Portugal
80765,12/1/2023,PRT,Selangor,848,484,364,Portugal
80766,12/1/2023,PRY,Johor,10,4,6,Paraguay
80767,12/1/2023,PRY,Selangor,19,15,4,Paraguay
80768,12/1/2023,PSE,Johor,15,14,1,"Palestinian Territory, Occupied"
80769,12/1/2023,PSE,Pulau Pinang,1,1,0,"Palestinian Territory, Occupied"
80770,12/1/2023,PSE,Sabah,2,2,0,"Palestinian Territory, Occupied"
80771,12/1/2023,PSE,Sarawak,3,2,1,"Palestinian Territory, Occupied"
80772,12/1/2023,PSE,Selangor,287,205,82,"Palestinian Territory, Occupied"
80773,12/1/2023,QAT,Johor,9,6,3,Qatar
80774,12/1/2023,QAT,Perlis,1,1,0,Qatar
80775,12/1/2023,QAT,Pulau Pinang,10,7,3,Qatar
80776,12/1/2023,QAT,Sarawak,2,2,0,Qatar
80777,12/1/2023,QAT,Selangor,164,96,68,Qatar
80778,12/1/2023,ROU,Johor,136,76,60,Romania
80779,12/1/2023,ROU,Kedah,166,75,91,Romania
80780,12/1/2023,ROU,Perak,1,1,0,Romania
80781,12/1/2023,ROU,Perlis,1,0,1,Romania
80782,12/1/2023,ROU,Pulau Pinang,28,16,12,Romania
80783,12/1/2023,ROU,Sabah,8,5,3,Romania
80784,12/1/2023,ROU,Sarawak,10,6,4,Romania
80785,12/1/2023,ROU,Selangor,1517,761,756,Romania
80786,12/1/2023,ROU,W.P. Labuan,2,1,1,Romania
80787,12/1/2023,RUS,Johor,537,255,282,Russia
80788,12/1/2023,RUS,Kedah,444,206,238,Russia
80789,12/1/2023,RUS,Kelantan,12,7,5,Russia
80790,12/1/2023,RUS,Melaka,1,1,0,Russia
80791,12/1/2023,RUS,Perak,8,4,4,Russia
80792,12/1/2023,RUS,Perlis,39,26,13,Russia
80793,12/1/2023,RUS,Pulau Pinang,190,96,94,Russia
80794,12/1/2023,RUS,Sabah,69,34,35,Russia
80795,12/1/2023,RUS,Sarawak,72,43,29,Russia
80796,12/1/2023,RUS,Selangor,9263,4486,4777,Russia
80797,12/1/2023,RUS,W.P. Labuan,11,6,5,Russia
80798,12/1/2023,RWA,Kedah,1,0,1,Rwanda
80799,12/1/2023,RWA,Selangor,5,1,4,Rwanda
80800,12/1/2023,SAU,Johor,180,100,80,Saudi Arabia
80801,12/1/2023,SAU,Kedah,33,25,8,Saudi Arabia
80802,12/1/2023,SAU,Kelantan,1,1,0,Saudi Arabia
80803,12/1/2023,SAU,Pulau Pinang,29,13,16,Saudi Arabia
80804,12/1/2023,SAU,Sarawak,30,16,14,Saudi Arabia
80805,12/1/2023,SAU,Selangor,3297,1938,1359,Saudi Arabia
80806,12/1/2023,SDN,Johor,25,13,12,Sudan
80807,12/1/2023,SDN,Kelantan,3,2,1,Sudan
80808,12/1/2023,SDN,Perlis,1,1,0,Sudan
80809,12/1/2023,SDN,Pulau Pinang,6,4,2,Sudan
80810,12/1/2023,SDN,Sabah,2,2,0,Sudan
80811,12/1/2023,SDN,Sarawak,13,8,5,Sudan
80812,12/1/2023,SDN,Selangor,1318,723,595,Sudan
80813,12/1/2023,SEN,Johor,10,5,5,Senegal
80814,12/1/2023,SEN,Selangor,41,29,12,Senegal
80815,12/1/2023,SGP,Johor,1414194,776492,637702,Singapore
80816,12/1/2023,SGP,Kedah,10509,5328,5181,Singapore
80817,12/1/2023,SGP,Kelantan,87,54,33,Singapore
80818,12/1/2023,SGP,Melaka,51,40,11,Singapore
80819,12/1/2023,SGP,Negeri Sembilan,3,2,1,Singapore
80820,12/1/2023,SGP,Pahang,943,459,484,Singapore
80821,12/1/2023,SGP,Perak,8880,4055,4825,Singapore
80822,12/1/2023,SGP,Perlis,698,382,316,Singapore
80823,12/1/2023,SGP,Pulau Pinang,33751,16522,17229,Singapore
80824,12/1/2023,SGP,Sabah,4733,2311,2422,Singapore
80825,12/1/2023,SGP,Sarawak,6550,3388,3162,Singapore
80826,12/1/2023,SGP,Selangor,75052,37116,37936,Singapore
80827,12/1/2023,SGP,W.P. Labuan,25,18,7,Singapore
80828,12/1/2023,SLB,Johor,1,1,0,Solomon Islands
80829,12/1/2023,SLB,Sabah,3,2,1,Solomon Islands
80830,12/1/2023,SLB,Sarawak,5,1,4,Solomon Islands
80831,12/1/2023,SLB,Selangor,2,2,0,Solomon Islands
80832,12/1/2023,SLE,Johor,11,9,2,Sierra Leone
80833,12/1/2023,SLE,Perlis,1,1,0,Sierra Leone
80834,12/1/2023,SLE,Selangor,20,12,8,Sierra Leone
80835,12/1/2023,SLV,Pulau Pinang,3,2,1,El Salvador
80836,12/1/2023,SLV,Selangor,12,6,6,El Salvador
80837,12/1/2023,SMR,Kedah,2,0,2,San Marino
80838,12/1/2023,SMR,Selangor,2,0,2,San Marino
80839,12/1/2023,SOM,Selangor,202,123,79,Somalia
80840,12/1/2023,SRB,Johor,15,11,4,Serbia
80841,12/1/2023,SRB,Kedah,9,4,5,Serbia
80842,12/1/2023,SRB,Pulau Pinang,7,4,3,Serbia
80843,12/1/2023,SRB,Sabah,4,2,2,Serbia
80844,12/1/2023,SRB,Sarawak,1,1,0,Serbia
80845,12/1/2023,SRB,Selangor,108,54,54,Serbia
80846,12/1/2023,STP,Selangor,3,1,2,Sao Tome and Principe
80847,12/1/2023,SUR,Johor,4,2,2,Suriname
80848,12/1/2023,SUR,Selangor,15,8,7,Suriname
80849,12/1/2023,SVK,Johor,41,23,18,Slovakia
80850,12/1/2023,SVK,Kedah,65,35,30,Slovakia
80851,12/1/2023,SVK,Perlis,5,4,1,Slovakia
80852,12/1/2023,SVK,Pulau Pinang,9,5,4,Slovakia
80853,12/1/2023,SVK,Sabah,6,4,2,Slovakia
80854,12/1/2023,SVK,Selangor,411,222,189,Slovakia
80855,12/1/2023,SVN,Johor,24,13,11,Slovenia
80856,12/1/2023,SVN,Kedah,18,9,9,Slovenia
80857,12/1/2023,SVN,Pulau Pinang,2,2,0,Slovenia
80858,12/1/2023,SVN,Sabah,2,2,0,Slovenia
80859,12/1/2023,SVN,Sarawak,1,0,1,Slovenia
80860,12/1/2023,SVN,Selangor,208,118,90,Slovenia
80861,12/1/2023,SWE,Johor,240,144,96,Sweden
80862,12/1/2023,SWE,Kedah,295,154,141,Sweden
80863,12/1/2023,SWE,Kelantan,2,2,0,Sweden
80864,12/1/2023,SWE,Perak,4,2,2,Sweden
80865,12/1/2023,SWE,Perlis,20,14,6,Sweden
80866,12/1/2023,SWE,Pulau Pinang,121,75,46,Sweden
80867,12/1/2023,SWE,Sabah,24,16,8,Sweden
80868,12/1/2023,SWE,Sarawak,15,12,3,Sweden
80869,12/1/2023,SWE,Selangor,2055,1153,902,Sweden
80870,12/1/2023,SWZ,Johor,4,4,0,Swaziland
80871,12/1/2023,SWZ,Selangor,21,9,12,Swaziland
80872,12/1/2023,SYC,Johor,34,14,20,Seychelles
80873,12/1/2023,SYC,Kedah,2,1,1,Seychelles
80874,12/1/2023,SYC,Sarawak,1,0,1,Seychelles
80875,12/1/2023,SYC,Selangor,207,86,121,Seychelles
80876,12/1/2023,SYR,Johor,24,18,6,Syrian Arab Republic
80877,12/1/2023,SYR,Kedah,2,2,0,Syrian Arab Republic
80878,12/1/2023,SYR,Kelantan,2,2,0,Syrian Arab Republic
80879,12/1/2023,SYR,Melaka,1,1,0,Syrian Arab Republic
80880,12/1/2023,SYR,Pahang,1,1,0,Syrian Arab Republic
80881,12/1/2023,SYR,Perlis,1,1,0,Syrian Arab Republic
80882,12/1/2023,SYR,Pulau Pinang,2,1,1,Syrian Arab Republic
80883,12/1/2023,SYR,Sarawak,7,6,1,Syrian Arab Republic
80884,12/1/2023,SYR,Selangor,749,462,287,Syrian Arab Republic
80885,12/1/2023,TCA,Selangor,1,0,1,Turks and Caicos
80886,12/1/2023,TCD,Johor,5,5,0,Chad
80887,12/1/2023,TCD,Selangor,24,21,3,Chad
80888,12/1/2023,TGO,Johor,3,1,2,Togo
80889,12/1/2023,TGO,Selangor,13,11,2,Togo
80890,12/1/2023,THA,Johor,8857,2797,6060,Thailand
80891,12/1/2023,THA,Kedah,67463,40200,27263,Thailand
80892,12/1/2023,THA,Kelantan,41287,21144,20143,Thailand
80893,12/1/2023,THA,Melaka,2,1,1,Thailand
80894,12/1/2023,THA,Pahang,11,5,6,Thailand
80895,12/1/2023,THA,Perak,11252,5080,6172,Thailand
80896,12/1/2023,THA,Perlis,49380,28480,20900,Thailand
80897,12/1/2023,THA,Pulau Pinang,2619,989,1630,Thailand
80898,12/1/2023,THA,Sabah,26,7,19,Thailand
80899,12/1/2023,THA,Sarawak,478,188,290,Thailand
80900,12/1/2023,THA,Selangor,14102,5309,8793,Thailand
80901,12/1/2023,THA,W.P. Labuan,8,4,4,Thailand
80902,12/1/2023,TJK,Johor,6,6,0,Tajikistan
80903,12/1/2023,TJK,Kelantan,1,1,0,Tajikistan
80904,12/1/2023,TJK,Perlis,2,1,1,Tajikistan
80905,12/1/2023,TJK,Sabah,1,0,1,Tajikistan
80906,12/1/2023,TJK,Selangor,203,145,58,Tajikistan
80907,12/1/2023,TKM,Johor,3,2,1,Turkmenistan
80908,12/1/2023,TKM,Perlis,1,1,0,Turkmenistan
80909,12/1/2023,TKM,Sarawak,2,2,0,Turkmenistan
80910,12/1/2023,TKM,Selangor,117,81,36,Turkmenistan
80911,12/1/2023,TLS,Johor,9,4,5,Timor-Leste
80912,12/1/2023,TLS,Kedah,5,1,4,Timor-Leste
80913,12/1/2023,TLS,Sarawak,3,3,0,Timor-Leste
80914,12/1/2023,TLS,Selangor,305,167,138,Timor-Leste
80915,12/1/2023,TON,Pulau Pinang,2,2,0,Tonga
80916,12/1/2023,TON,Selangor,17,7,10,Tonga
80917,12/1/2023,TTO,Johor,4,2,2,Trinidad and Tobago
80918,12/1/2023,TTO,Kedah,1,0,1,Trinidad and Tobago
80919,12/1/2023,TTO,Sarawak,2,0,2,Trinidad and Tobago
80920,12/1/2023,TTO,Selangor,32,18,14,Trinidad and Tobago
80921,12/1/2023,TUN,Johor,9,4,5,Tunisia
80922,12/1/2023,TUN,Kedah,7,2,5,Tunisia
80923,12/1/2023,TUN,Perlis,2,2,0,Tunisia
80924,12/1/2023,TUN,Pulau Pinang,16,11,5,Tunisia
80925,12/1/2023,TUN,Sabah,2,1,1,Tunisia
80926,12/1/2023,TUN,Selangor,837,429,408,Tunisia
80927,12/1/2023,TUR,Johor,254,192,62,Turkey
80928,12/1/2023,TUR,Kedah,69,42,27,Turkey
80929,12/1/2023,TUR,Kelantan,2,2,0,Turkey
80930,12/1/2023,TUR,Pahang,1,1,0,Turkey
80931,12/1/2023,TUR,Perak,1,1,0,Turkey
80932,12/1/2023,TUR,Perlis,17,15,2,Turkey
80933,12/1/2023,TUR,Pulau Pinang,57,34,23,Turkey
80934,12/1/2023,TUR,Sabah,3,3,0,Turkey
80935,12/1/2023,TUR,Sarawak,31,22,9,Turkey
80936,12/1/2023,TUR,Selangor,1614,1082,532,Turkey
80937,12/1/2023,TWN,Johor,5075,2193,2882,Taiwan
80938,12/1/2023,TWN,Kedah,145,74,71,Taiwan
80939,12/1/2023,TWN,Kelantan,2,1,1,Taiwan
80940,12/1/2023,TWN,Pahang,3,2,1,Taiwan
80941,12/1/2023,TWN,Perak,53,32,21,Taiwan
80942,12/1/2023,TWN,Perlis,22,10,12,Taiwan
80943,12/1/2023,TWN,Pulau Pinang,3595,1795,1800,Taiwan
80944,12/1/2023,TWN,Sabah,1012,480,532,Taiwan
80945,12/1/2023,TWN,Sarawak,327,155,172,Taiwan
80946,12/1/2023,TWN,Selangor,10872,5373,5499,Taiwan
80947,12/1/2023,TWN,W.P. Labuan,6,2,4,Taiwan
80948,12/1/2023,TZA,Johor,44,19,25,"Tanzania, United Republic of"
80949,12/1/2023,TZA,Kedah,4,0,4,"Tanzania, United Republic of"
80950,12/1/2023,TZA,Pulau Pinang,1,1,0,"Tanzania, United Republic of"
80951,12/1/2023,TZA,Selangor,384,190,194,"Tanzania, United Republic of"
80952,12/1/2023,TZA,W.P. Labuan,1,1,0,"Tanzania, United Republic of"
80953,12/1/2023,UGA,Johor,32,15,17,Uganda
80954,12/1/2023,UGA,Kedah,1,0,1,Uganda
80955,12/1/2023,UGA,Sarawak,2,2,0,Uganda
80956,12/1/2023,UGA,Selangor,202,100,102,Uganda
80957,12/1/2023,UKR,Johor,122,59,63,Ukraine
80958,12/1/2023,UKR,Kedah,41,17,24,Ukraine
80959,12/1/2023,UKR,Kelantan,2,1,1,Ukraine
80960,12/1/2023,UKR,Perlis,3,1,2,Ukraine
80961,12/1/2023,UKR,Pulau Pinang,26,12,14,Ukraine
80962,12/1/2023,UKR,Sabah,7,5,2,Ukraine
80963,12/1/2023,UKR,Sarawak,6,3,3,Ukraine
80964,12/1/2023,UKR,Selangor,1188,568,620,Ukraine
80965,12/1/2023,URY,Johor,2,0,2,Uruguay
80966,12/1/2023,URY,Perlis,1,1,0,Uruguay
80967,12/1/2023,URY,Pulau Pinang,2,2,0,Uruguay
80968,12/1/2023,URY,Selangor,46,25,21,Uruguay
80969,12/1/2023,USA,Johor,4742,2712,2030,United States Of America
80970,12/1/2023,USA,Kedah,1579,787,792,United States Of America
80971,12/1/2023,USA,Kelantan,12,8,4,United States Of America
80972,12/1/2023,USA,Melaka,1,1,0,United States Of America
80973,12/1/2023,USA,Pahang,8,6,2,United States Of America
80974,12/1/2023,USA,Perak,142,78,64,United States Of America
80975,12/1/2023,USA,Perlis,110,72,38,United States Of America
80976,12/1/2023,USA,Pulau Pinang,2548,1342,1206,United States Of America
80977,12/1/2023,USA,Sabah,470,268,202,United States Of America
80978,12/1/2023,USA,Sarawak,327,205,122,United States Of America
80979,12/1/2023,USA,Selangor,21722,11794,9928,United States Of America
80980,12/1/2023,USA,W.P. Labuan,9,8,1,United States Of America
80981,12/1/2023,UZB,Johor,137,92,45,Uzbekistan
80982,12/1/2023,UZB,Kedah,28,17,11,Uzbekistan
80983,12/1/2023,UZB,Kelantan,4,2,2,Uzbekistan
80984,12/1/2023,UZB,Pulau Pinang,9,5,4,Uzbekistan
80985,12/1/2023,UZB,Sabah,7,4,3,Uzbekistan
80986,12/1/2023,UZB,Sarawak,1,0,1,Uzbekistan
80987,12/1/2023,UZB,Selangor,1682,979,703,Uzbekistan
80988,12/1/2023,VAT,Pulau Pinang,1,1,0,Holy See (Vatican City State)
80989,12/1/2023,VAT,Sarawak,1,1,0,Holy See (Vatican City State)
80990,12/1/2023,VCT,Selangor,3,2,1,Saint Vincent and the Grenadines
80991,12/1/2023,VEN,Johor,23,14,9,Venezuela
80992,12/1/2023,VEN,Kedah,2,1,1,Venezuela
80993,12/1/2023,VEN,Pulau Pinang,1,0,1,Venezuela
80994,12/1/2023,VEN,Sabah,2,1,1,Venezuela
80995,12/1/2023,VEN,Sarawak,1,0,1,Venezuela
80996,12/1/2023,VEN,Selangor,86,40,46,Venezuela
80997,12/1/2023,VNM,Johor,11258,3169,8089,Vietnam
80998,12/1/2023,VNM,Kedah,347,46,301,Vietnam
80999,12/1/2023,VNM,Kelantan,9,3,6,Vietnam
81000,12/1/2023,VNM,Pahang,9,8,1,Vietnam
81001,12/1/2023,VNM,Perak,238,20,218,Vietnam
81002,12/1/2023,VNM,Perlis,186,15,171,Vietnam
81003,12/1/2023,VNM,Pulau Pinang,848,214,634,Vietnam
81004,12/1/2023,VNM,Sabah,30,9,21,Vietnam
81005,12/1/2023,VNM,Sarawak,375,60,315,Vietnam
81006,12/1/2023,VNM,Selangor,11849,3991,7858,Vietnam
81007,12/1/2023,VNM,W.P. Labuan,3,3,0,Vietnam
81008,12/1/2023,VUT,Johor,49,33,16,Vanuatu
81009,12/1/2023,VUT,Pulau Pinang,4,4,0,Vanuatu
81010,12/1/2023,VUT,Sabah,1,1,0,Vanuatu
81011,12/1/2023,VUT,Selangor,111,82,29,Vanuatu
81012,12/1/2023,WSM,Johor,1,0,1,Samoa
81013,12/1/2023,WSM,Selangor,4,2,2,Samoa
81014,12/1/2023,YEM,Johor,30,21,9,Yemen
81015,12/1/2023,YEM,Kedah,9,9,0,Yemen
81016,12/1/2023,YEM,Kelantan,1,1,0,Yemen
81017,12/1/2023,YEM,Melaka,4,2,2,Yemen
81018,12/1/2023,YEM,Perlis,3,3,0,Yemen
81019,12/1/2023,YEM,Pulau Pinang,7,4,3,Yemen
81020,12/1/2023,YEM,Sarawak,4,2,2,Yemen
81021,12/1/2023,YEM,Selangor,1283,869,414,Yemen
81022,12/1/2023,ZAF,Johor,402,229,173,South Africa
81023,12/1/2023,ZAF,Kedah,123,68,55,South Africa
81024,12/1/2023,ZAF,Kelantan,1,0,1,South Africa
81025,12/1/2023,ZAF,Pahang,5,3,2,South Africa
81026,12/1/2023,ZAF,Perak,3,3,0,South Africa
81027,12/1/2023,ZAF,Perlis,14,6,8,South Africa
81028,12/1/2023,ZAF,Pulau Pinang,111,53,58,South Africa
81029,12/1/2023,ZAF,Sabah,35,16,19,South Africa
81030,12/1/2023,ZAF,Sarawak,203,98,105,South Africa
81031,12/1/2023,ZAF,Selangor,2743,1358,1385,South Africa
81032,12/1/2023,ZAF,W.P. Labuan,8,2,6,South Africa
81033,12/1/2023,ZMB,Johor,18,9,9,Zambia
81034,12/1/2023,ZMB,Selangor,161,74,87,Zambia
81035,12/1/2023,ZWE,Johor,28,15,13,Zimbabwe
81036,12/1/2023,ZWE,Kedah,1,0,1,Zimbabwe
81037,12/1/2023,ZWE,Pulau Pinang,7,3,4,Zimbabwe
81038,12/1/2023,ZWE,Sabah,1,1,0,Zimbabwe
81039,12/1/2023,ZWE,Selangor,274,132,142,Zimbabwe
81040,1/1/2024,AFG,Selangor,74,62,12,Afghanistan
81041,1/1/2024,AGO,Johor,1,1,0,Angola
81042,1/1/2024,AGO,Selangor,9,6,3,Angola
81043,1/1/2024,ALB,Johor,18,15,3,Albania
81044,1/1/2024,ALB,Kedah,7,4,3,Albania
81045,1/1/2024,ALB,Pulau Pinang,3,1,2,Albania
81046,1/1/2024,ALB,Sabah,2,1,1,Albania
81047,1/1/2024,ALB,Selangor,43,26,17,Albania
81048,1/1/2024,AND,Selangor,1,1,0,Andorra
81049,1/1/2024,ANT,Selangor,1,0,1,Netherlands Antilles
81050,1/1/2024,ARE,Johor,7,3,4,United Arab Emirates
81051,1/1/2024,ARE,Pulau Pinang,1,1,0,United Arab Emirates
81052,1/1/2024,ARE,Selangor,358,240,118,United Arab Emirates
81053,1/1/2024,ARG,Johor,116,59,57,Argentina
81054,1/1/2024,ARG,Kedah,209,93,116,Argentina
81055,1/1/2024,ARG,Kelantan,1,0,1,Argentina
81056,1/1/2024,ARG,Perlis,7,6,1,Argentina
81057,1/1/2024,ARG,Pulau Pinang,13,3,10,Argentina
81058,1/1/2024,ARG,Sabah,8,4,4,Argentina
81059,1/1/2024,ARG,Sarawak,2,2,0,Argentina
81060,1/1/2024,ARG,Selangor,855,419,436,Argentina
81061,1/1/2024,ARM,Johor,3,3,0,Armenia
81062,1/1/2024,ARM,Kedah,2,0,2,Armenia
81063,1/1/2024,ARM,Pulau Pinang,1,1,0,Armenia
81064,1/1/2024,ARM,Sabah,3,3,0,Armenia
81065,1/1/2024,ARM,Selangor,110,50,60,Armenia
81066,1/1/2024,ATG,Johor,2,2,0,Antigua and Barbuda
81067,1/1/2024,ATG,Kedah,3,0,3,Antigua and Barbuda
81068,1/1/2024,ATG,Selangor,13,8,5,Antigua and Barbuda
81069,1/1/2024,AUS,Johor,5856,3319,2537,Australia
81070,1/1/2024,AUS,Kedah,1431,742,689,Australia
81071,1/1/2024,AUS,Kelantan,7,4,3,Australia
81072,1/1/2024,AUS,Melaka,3,2,1,Australia
81073,1/1/2024,AUS,Pahang,55,32,23,Australia
81074,1/1/2024,AUS,Perak,280,142,138,Australia
81075,1/1/2024,AUS,Perlis,112,72,40,Australia
81076,1/1/2024,AUS,Pulau Pinang,2575,1317,1258,Australia
81077,1/1/2024,AUS,Sabah,473,242,231,Australia
81078,1/1/2024,AUS,Sarawak,884,476,408,Australia
81079,1/1/2024,AUS,Selangor,38688,21461,17227,Australia
81080,1/1/2024,AUS,Terengganu,1,1,0,Australia
81081,1/1/2024,AUS,W.P. Labuan,9,5,4,Australia
81082,1/1/2024,AUT,Johor,205,131,74,Austria
81083,1/1/2024,AUT,Kedah,190,100,90,Austria
81084,1/1/2024,AUT,Kelantan,2,2,0,Austria
81085,1/1/2024,AUT,Perak,1,0,1,Austria
81086,1/1/2024,AUT,Perlis,25,15,10,Austria
81087,1/1/2024,AUT,Pulau Pinang,94,67,27,Austria
81088,1/1/2024,AUT,Sabah,14,6,8,Austria
81089,1/1/2024,AUT,Sarawak,14,8,6,Austria
81090,1/1/2024,AUT,Selangor,1104,688,416,Austria
81091,1/1/2024,AZE,Johor,8,7,1,Azerbaijan
81092,1/1/2024,AZE,Kedah,5,2,3,Azerbaijan
81093,1/1/2024,AZE,Pulau Pinang,2,1,1,Azerbaijan
81094,1/1/2024,AZE,Sabah,1,1,0,Azerbaijan
81095,1/1/2024,AZE,Selangor,188,107,81,Azerbaijan
81096,1/1/2024,BDI,Sarawak,2,1,1,Burundi
81097,1/1/2024,BDI,Selangor,8,8,0,Burundi
81098,1/1/2024,BEL,Johor,192,120,72,Belgium
81099,1/1/2024,BEL,Kedah,166,94,72,Belgium
81100,1/1/2024,BEL,Kelantan,2,2,0,Belgium
81101,1/1/2024,BEL,Melaka,2,2,0,Belgium
81102,1/1/2024,BEL,Pahang,1,0,1,Belgium
81103,1/1/2024,BEL,Perak,4,2,2,Belgium
81104,1/1/2024,BEL,Perlis,18,11,7,Belgium
81105,1/1/2024,BEL,Pulau Pinang,88,56,32,Belgium
81106,1/1/2024,BEL,Sabah,19,10,9,Belgium
81107,1/1/2024,BEL,Sarawak,21,11,10,Belgium
81108,1/1/2024,BEL,Selangor,1547,894,653,Belgium
81109,1/1/2024,BEN,Johor,2,2,0,Benin
81110,1/1/2024,BEN,Sarawak,1,0,1,Benin
81111,1/1/2024,BEN,Selangor,12,10,2,Benin
81112,1/1/2024,BFA,Selangor,9,8,1,Burkina Faso
81113,1/1/2024,BGD,Johor,2202,1729,473,Bangladesh
81114,1/1/2024,BGD,Kedah,129,71,58,Bangladesh
81115,1/1/2024,BGD,Kelantan,1,1,0,Bangladesh
81116,1/1/2024,BGD,Perak,3,3,0,Bangladesh
81117,1/1/2024,BGD,Pulau Pinang,234,208,26,Bangladesh
81118,1/1/2024,BGD,Sabah,9,8,1,Bangladesh
81119,1/1/2024,BGD,Sarawak,67,51,16,Bangladesh
81120,1/1/2024,BGD,Selangor,38752,35941,2811,Bangladesh
81121,1/1/2024,BGD,W.P. Labuan,15,14,1,Bangladesh
81122,1/1/2024,BGR,Johor,61,36,25,Bulgaria
81123,1/1/2024,BGR,Kedah,63,30,33,Bulgaria
81124,1/1/2024,BGR,Perak,1,1,0,Bulgaria
81125,1/1/2024,BGR,Perlis,1,1,0,Bulgaria
81126,1/1/2024,BGR,Pulau Pinang,32,17,15,Bulgaria
81127,1/1/2024,BGR,Sabah,4,3,1,Bulgaria
81128,1/1/2024,BGR,Sarawak,1,1,0,Bulgaria
81129,1/1/2024,BGR,Selangor,515,270,245,Bulgaria
81130,1/1/2024,BHR,Kedah,8,5,3,Bahrain
81131,1/1/2024,BHR,Pulau Pinang,1,1,0,Bahrain
81132,1/1/2024,BHR,Selangor,256,134,122,Bahrain
81133,1/1/2024,BHS,Selangor,8,4,4,Bahamas
81134,1/1/2024,BIH,Johor,21,9,12,Bosnia and Herzegovina
81135,1/1/2024,BIH,Perlis,1,1,0,Bosnia and Herzegovina
81136,1/1/2024,BIH,Pulau Pinang,2,2,0,Bosnia and Herzegovina
81137,1/1/2024,BIH,Sabah,2,2,0,Bosnia and Herzegovina
81138,1/1/2024,BIH,Selangor,116,69,47,Bosnia and Herzegovina
81139,1/1/2024,BLR,Johor,11,4,7,Belarus
81140,1/1/2024,BLR,Kedah,21,9,12,Belarus
81141,1/1/2024,BLR,Perlis,1,0,1,Belarus
81142,1/1/2024,BLR,Pulau Pinang,19,8,11,Belarus
81143,1/1/2024,BLR,Sabah,4,2,2,Belarus
81144,1/1/2024,BLR,Sarawak,4,3,1,Belarus
81145,1/1/2024,BLR,Selangor,570,270,300,Belarus
81146,1/1/2024,BLZ,Johor,3,3,0,Belize
81147,1/1/2024,BLZ,Pulau Pinang,1,1,0,Belize
81148,1/1/2024,BLZ,Selangor,9,5,4,Belize
81149,1/1/2024,BOL,Johor,6,4,2,Bolivia
81150,1/1/2024,BOL,Kedah,1,1,0,Bolivia
81151,1/1/2024,BOL,Selangor,41,24,17,Bolivia
81152,1/1/2024,BRA,Johor,208,114,94,Brazil
81153,1/1/2024,BRA,Kedah,198,84,114,Brazil
81154,1/1/2024,BRA,Kelantan,1,0,1,Brazil
81155,1/1/2024,BRA,Perlis,5,4,1,Brazil
81156,1/1/2024,BRA,Pulau Pinang,23,10,13,Brazil
81157,1/1/2024,BRA,Sabah,5,4,1,Brazil
81158,1/1/2024,BRA,Sarawak,8,5,3,Brazil
81159,1/1/2024,BRA,Selangor,1467,766,701,Brazil
81160,1/1/2024,BRB,Johor,1,0,1,Barbados
81161,1/1/2024,BRB,Selangor,6,5,1,Barbados
81162,1/1/2024,BRN,Johor,390,207,183,Brunei Darussalam
81163,1/1/2024,BRN,Kedah,34,13,21,Brunei Darussalam
81164,1/1/2024,BRN,Pahang,1,0,1,Brunei Darussalam
81165,1/1/2024,BRN,Perak,2,0,2,Brunei Darussalam
81166,1/1/2024,BRN,Perlis,61,33,28,Brunei Darussalam
81167,1/1/2024,BRN,Pulau Pinang,16,6,10,Brunei Darussalam
81168,1/1/2024,BRN,Sabah,1269,555,714,Brunei Darussalam
81169,1/1/2024,BRN,Sarawak,118380,65041,53339,Brunei Darussalam
81170,1/1/2024,BRN,Selangor,4745,2388,2357,Brunei Darussalam
81171,1/1/2024,BRN,W.P. Labuan,906,612,294,Brunei Darussalam
81172,1/1/2024,BTN,Perak,2,1,1,Bhutan
81173,1/1/2024,BTN,Perlis,2,1,1,Bhutan
81174,1/1/2024,BTN,Selangor,52,28,24,Bhutan
81175,1/1/2024,BWA,Johor,2,1,1,Botswana
81176,1/1/2024,BWA,Selangor,17,9,8,Botswana
81177,1/1/2024,CAN,Johor,1512,864,648,Canada
81178,1/1/2024,CAN,Kedah,499,272,227,Canada
81179,1/1/2024,CAN,Kelantan,4,4,0,Canada
81180,1/1/2024,CAN,Melaka,2,1,1,Canada
81181,1/1/2024,CAN,Pahang,1,0,1,Canada
81182,1/1/2024,CAN,Perak,42,27,15,Canada
81183,1/1/2024,CAN,Perlis,81,48,33,Canada
81184,1/1/2024,CAN,Pulau Pinang,706,363,343,Canada
81185,1/1/2024,CAN,Sabah,175,83,92,Canada
81186,1/1/2024,CAN,Sarawak,349,178,171,Canada
81187,1/1/2024,CAN,Selangor,6136,3491,2645,Canada
81188,1/1/2024,CAN,W.P. Labuan,7,5,2,Canada
81189,1/1/2024,CHE,Johor,355,201,154,Switzerland
81190,1/1/2024,CHE,Kedah,327,168,159,Switzerland
81191,1/1/2024,CHE,Kelantan,1,1,0,Switzerland
81192,1/1/2024,CHE,Melaka,1,1,0,Switzerland
81193,1/1/2024,CHE,Negeri Sembilan,2,1,1,Switzerland
81194,1/1/2024,CHE,Pahang,4,2,2,Switzerland
81195,1/1/2024,CHE,Perak,6,3,3,Switzerland
81196,1/1/2024,CHE,Perlis,41,22,19,Switzerland
81197,1/1/2024,CHE,Pulau Pinang,170,115,55,Switzerland
81198,1/1/2024,CHE,Sabah,44,26,18,Switzerland
81199,1/1/2024,CHE,Sarawak,20,11,9,Switzerland
81200,1/1/2024,CHE,Selangor,1824,1104,720,Switzerland
81201,1/1/2024,CHL,Johor,35,16,19,Chile
81202,1/1/2024,CHL,Kedah,37,12,25,Chile
81203,1/1/2024,CHL,Perlis,4,3,1,Chile
81204,1/1/2024,CHL,Pulau Pinang,8,6,2,Chile
81205,1/1/2024,CHL,Sabah,4,3,1,Chile
81206,1/1/2024,CHL,Sarawak,3,3,0,Chile
81207,1/1/2024,CHL,Selangor,439,212,227,Chile
81208,1/1/2024,CHN,Johor,59992,25949,34043,China
81209,1/1/2024,CHN,Kedah,2247,998,1249,China
81210,1/1/2024,CHN,Kelantan,13,10,3,China
81211,1/1/2024,CHN,Melaka,6,5,1,China
81212,1/1/2024,CHN,Pahang,62,39,23,China
81213,1/1/2024,CHN,Perak,293,145,148,China
81214,1/1/2024,CHN,Perlis,393,213,180,China
81215,1/1/2024,CHN,Pulau Pinang,11748,5901,5847,China
81216,1/1/2024,CHN,Sabah,12533,5464,7069,China
81217,1/1/2024,CHN,Sarawak,1576,831,745,China
81218,1/1/2024,CHN,Selangor,139974,68413,71561,China
81219,1/1/2024,CHN,W.P. Labuan,63,55,8,China
81220,1/1/2024,CIV,Johor,1,1,0,C��te d'Iv
81221,1/1/2024,CIV,Selangor,17,13,4,C��te d'Iv
81222,1/1/2024,CMR,Sabah,1,1,0,Cameroon
81223,1/1/2024,CMR,Selangor,29,21,8,Cameroon
81224,1/1/2024,COD,Sarawak,1,1,0,"Congo, the Democratic Republic of the"
81225,1/1/2024,COD,Selangor,29,17,12,"Congo, the Democratic Republic of the"
81226,1/1/2024,COG,Selangor,4,3,1,Congo
81227,1/1/2024,COL,Johor,29,12,17,Colombia
81228,1/1/2024,COL,Kedah,1,1,0,Colombia
81229,1/1/2024,COL,Perak,1,1,0,Colombia
81230,1/1/2024,COL,Pulau Pinang,10,2,8,Colombia
81231,1/1/2024,COL,Sabah,1,1,0,Colombia
81232,1/1/2024,COL,Sarawak,2,2,0,Colombia
81233,1/1/2024,COL,Selangor,281,152,129,Colombia
81234,1/1/2024,COM,Selangor,16,10,6,Comoros
81235,1/1/2024,CPV,Selangor,1,0,1,Cape Verde
81236,1/1/2024,CRI,Johor,30,20,10,Costa Rica
81237,1/1/2024,CRI,Kedah,4,2,2,Costa Rica
81238,1/1/2024,CRI,Pulau Pinang,18,10,8,Costa Rica
81239,1/1/2024,CRI,Selangor,101,46,55,Costa Rica
81240,1/1/2024,CUB,Johor,13,10,3,Cuba
81241,1/1/2024,CUB,Pulau Pinang,1,1,0,Cuba
81242,1/1/2024,CUB,Sabah,2,0,2,Cuba
81243,1/1/2024,CUB,Selangor,28,14,14,Cuba
81244,1/1/2024,CYP,Johor,4,1,3,Cyprus
81245,1/1/2024,CYP,Kedah,8,5,3,Cyprus
81246,1/1/2024,CYP,Pulau Pinang,2,1,1,Cyprus
81247,1/1/2024,CYP,Sabah,2,2,0,Cyprus
81248,1/1/2024,CYP,Sarawak,2,0,2,Cyprus
81249,1/1/2024,CYP,Selangor,80,48,32,Cyprus
81250,1/1/2024,CZE,Johor,106,54,52,Czech Republic
81251,1/1/2024,CZE,Kedah,214,109,105,Czech Republic
81252,1/1/2024,CZE,Perlis,18,14,4,Czech Republic
81253,1/1/2024,CZE,Pulau Pinang,40,27,13,Czech Republic
81254,1/1/2024,CZE,Sabah,17,11,6,Czech Republic
81255,1/1/2024,CZE,Sarawak,22,13,9,Czech Republic
81256,1/1/2024,CZE,Selangor,1140,644,496,Czech Republic
81257,1/1/2024,CZE,W.P. Labuan,4,4,0,Czech Republic
81258,1/1/2024,DEU,Johor,2027,1247,780,Germany
81259,1/1/2024,DEU,Kedah,1533,791,742,Germany
81260,1/1/2024,DEU,Kelantan,9,8,1,Germany
81261,1/1/2024,DEU,Melaka,4,4,0,Germany
81262,1/1/2024,DEU,Negeri Sembilan,4,2,2,Germany
81263,1/1/2024,DEU,Pahang,8,5,3,Germany
81264,1/1/2024,DEU,Perak,23,17,6,Germany
81265,1/1/2024,DEU,Perlis,185,115,70,Germany
81266,1/1/2024,DEU,Pulau Pinang,975,674,301,Germany
81267,1/1/2024,DEU,Sabah,144,83,61,Germany
81268,1/1/2024,DEU,Sarawak,201,129,72,Germany
81269,1/1/2024,DEU,Selangor,8986,5517,3469,Germany
81270,1/1/2024,DEU,W.P. Labuan,13,4,9,Germany
81271,1/1/2024,DJI,Selangor,12,7,5,Djibouti
81272,1/1/2024,DMA,Johor,5,5,0,Dominica
81273,1/1/2024,DMA,Kedah,1,1,0,Dominica
81274,1/1/2024,DMA,Pulau Pinang,2,1,1,Dominica
81275,1/1/2024,DMA,Selangor,57,47,10,Dominica
81276,1/1/2024,DNK,Johor,291,209,82,Denmark
81277,1/1/2024,DNK,Kedah,382,185,197,Denmark
81278,1/1/2024,DNK,Pahang,21,5,16,Denmark
81279,1/1/2024,DNK,Perak,13,6,7,Denmark
81280,1/1/2024,DNK,Perlis,26,17,9,Denmark
81281,1/1/2024,DNK,Pulau Pinang,100,57,43,Denmark
81282,1/1/2024,DNK,Sabah,43,25,18,Denmark
81283,1/1/2024,DNK,Sarawak,22,13,9,Denmark
81284,1/1/2024,DNK,Selangor,1921,1033,888,Denmark
81285,1/1/2024,DNK,W.P. Labuan,2,1,1,Denmark
81286,1/1/2024,DOM,Johor,1,0,1,Dominican Republic
81287,1/1/2024,DOM,Kedah,1,1,0,Dominican Republic
81288,1/1/2024,DOM,Perlis,1,1,0,Dominican Republic
81289,1/1/2024,DOM,Selangor,15,8,7,Dominican Republic
81290,1/1/2024,DZA,Johor,33,27,6,Algeria
81291,1/1/2024,DZA,Kedah,10,8,2,Algeria
81292,1/1/2024,DZA,Kelantan,4,4,0,Algeria
81293,1/1/2024,DZA,Perlis,5,4,1,Algeria
81294,1/1/2024,DZA,Sarawak,7,6,1,Algeria
81295,1/1/2024,DZA,Selangor,958,604,354,Algeria
81296,1/1/2024,DZA,W.P. Labuan,1,1,0,Algeria
81297,1/1/2024,ECU,Johor,20,12,8,Ecuador
81298,1/1/2024,ECU,Kedah,4,2,2,Ecuador
81299,1/1/2024,ECU,Pulau Pinang,1,1,0,Ecuador
81300,1/1/2024,ECU,Sabah,1,1,0,Ecuador
81301,1/1/2024,ECU,Selangor,52,28,24,Ecuador
81302,1/1/2024,EGY,Johor,181,133,48,Egypt
81303,1/1/2024,EGY,Kedah,13,8,5,Egypt
81304,1/1/2024,EGY,Perak,1,1,0,Egypt
81305,1/1/2024,EGY,Perlis,2,2,0,Egypt
81306,1/1/2024,EGY,Pulau Pinang,14,11,3,Egypt
81307,1/1/2024,EGY,Sabah,6,2,4,Egypt
81308,1/1/2024,EGY,Sarawak,87,62,25,Egypt
81309,1/1/2024,EGY,Selangor,2088,1379,709,Egypt
81310,1/1/2024,ERI,Johor,1,1,0,Eritrea
81311,1/1/2024,ERI,Selangor,16,9,7,Eritrea
81312,1/1/2024,ESP,Johor,435,243,192,Spain
81313,1/1/2024,ESP,Kedah,416,184,232,Spain
81314,1/1/2024,ESP,Kelantan,1,1,0,Spain
81315,1/1/2024,ESP,Pahang,6,4,2,Spain
81316,1/1/2024,ESP,Perak,10,2,8,Spain
81317,1/1/2024,ESP,Perlis,35,18,17,Spain
81318,1/1/2024,ESP,Pulau Pinang,97,56,41,Spain
81319,1/1/2024,ESP,Sabah,35,18,17,Spain
81320,1/1/2024,ESP,Sarawak,51,35,16,Spain
81321,1/1/2024,ESP,Selangor,2866,1619,1247,Spain
81322,1/1/2024,ESP,W.P. Labuan,1,1,0,Spain
81323,1/1/2024,EST,Johor,54,32,22,Estonia
81324,1/1/2024,EST,Kedah,106,49,57,Estonia
81325,1/1/2024,EST,Kelantan,3,1,2,Estonia
81326,1/1/2024,EST,Perlis,2,1,1,Estonia
81327,1/1/2024,EST,Pulau Pinang,20,10,10,Estonia
81328,1/1/2024,EST,Sabah,1,0,1,Estonia
81329,1/1/2024,EST,Sarawak,1,0,1,Estonia
81330,1/1/2024,EST,Selangor,440,209,231,Estonia
81331,1/1/2024,ETH,Johor,1,0,1,Ethiopia
81332,1/1/2024,ETH,Sarawak,2,1,1,Ethiopia
81333,1/1/2024,ETH,Selangor,67,38,29,Ethiopia
81334,1/1/2024,FIN,Johor,267,142,125,Finland
81335,1/1/2024,FIN,Kedah,334,167,167,Finland
81336,1/1/2024,FIN,Perak,2,1,1,Finland
81337,1/1/2024,FIN,Perlis,11,9,2,Finland
81338,1/1/2024,FIN,Pulau Pinang,92,60,32,Finland
81339,1/1/2024,FIN,Sabah,27,12,15,Finland
81340,1/1/2024,FIN,Sarawak,14,5,9,Finland
81341,1/1/2024,FIN,Selangor,1139,645,494,Finland
81342,1/1/2024,FJI,Johor,125,60,65,Fiji
81343,1/1/2024,FJI,Perlis,1,0,1,Fiji
81344,1/1/2024,FJI,Pulau Pinang,7,2,5,Fiji
81345,1/1/2024,FJI,Selangor,196,98,98,Fiji
81346,1/1/2024,FRA,Johor,1497,964,533,France
81347,1/1/2024,FRA,Kedah,1125,586,539,France
81348,1/1/2024,FRA,Kelantan,16,10,6,France
81349,1/1/2024,FRA,Melaka,3,2,1,France
81350,1/1/2024,FRA,Negeri Sembilan,1,0,1,France
81351,1/1/2024,FRA,Pahang,10,6,4,France
81352,1/1/2024,FRA,Perak,31,19,12,France
81353,1/1/2024,FRA,Perlis,132,85,47,France
81354,1/1/2024,FRA,Pulau Pinang,479,309,170,France
81355,1/1/2024,FRA,Sabah,93,59,34,France
81356,1/1/2024,FRA,Sarawak,86,56,30,France
81357,1/1/2024,FRA,Selangor,10580,6168,4412,France
81358,1/1/2024,FRA,W.P. Labuan,2,2,0,France
81359,1/1/2024,FSM,Selangor,2,2,0,"Micronesia, Federated States of"
81360,1/1/2024,GAB,Johor,1,1,0,Gabon
81361,1/1/2024,GAB,Selangor,10,5,5,Gabon
81362,1/1/2024,GBR,Johor,4074,2603,1471,United Kingdom
81363,1/1/2024,GBR,Kedah,5649,2811,2838,United Kingdom
81364,1/1/2024,GBR,Kelantan,14,11,3,United Kingdom
81365,1/1/2024,GBR,Melaka,4,2,2,United Kingdom
81366,1/1/2024,GBR,Pahang,10,9,1,United Kingdom
81367,1/1/2024,GBR,Perak,113,72,41,United Kingdom
81368,1/1/2024,GBR,Perlis,249,166,83,United Kingdom
81369,1/1/2024,GBR,Pulau Pinang,1979,1191,788,United Kingdom
81370,1/1/2024,GBR,Sabah,430,243,187,United Kingdom
81371,1/1/2024,GBR,Sarawak,841,537,304,United Kingdom
81372,1/1/2024,GBR,Selangor,22403,13391,9012,United Kingdom
81373,1/1/2024,GBR,W.P. Labuan,26,22,4,United Kingdom
81374,1/1/2024,GEO,Johor,8,7,1,Georgia
81375,1/1/2024,GEO,Kedah,4,0,4,Georgia
81376,1/1/2024,GEO,Pulau Pinang,6,6,0,Georgia
81377,1/1/2024,GEO,Selangor,88,45,43,Georgia
81378,1/1/2024,GHA,Johor,6,6,0,Ghana
81379,1/1/2024,GHA,Pulau Pinang,3,3,0,Ghana
81380,1/1/2024,GHA,Selangor,70,51,19,Ghana
81381,1/1/2024,GIN,Johor,5,5,0,Guinea
81382,1/1/2024,GIN,Kedah,1,1,0,Guinea
81383,1/1/2024,GIN,Sarawak,1,1,0,Guinea
81384,1/1/2024,GIN,Selangor,68,40,28,Guinea
81385,1/1/2024,GMB,Selangor,36,31,5,Gambia
81386,1/1/2024,GNB,Selangor,1,1,0,Guinea-Bissau
81387,1/1/2024,GNQ,Johor,1,1,0,Equatorial Guinea
81388,1/1/2024,GNQ,Selangor,1,1,0,Equatorial Guinea
81389,1/1/2024,GRC,Johor,53,37,16,Greece
81390,1/1/2024,GRC,Kedah,42,28,14,Greece
81391,1/1/2024,GRC,Pahang,1,1,0,Greece
81392,1/1/2024,GRC,Perak,2,1,1,Greece
81393,1/1/2024,GRC,Perlis,5,4,1,Greece
81394,1/1/2024,GRC,Pulau Pinang,17,9,8,Greece
81395,1/1/2024,GRC,Sabah,3,2,1,Greece
81396,1/1/2024,GRC,Sarawak,6,1,5,Greece
81397,1/1/2024,GRC,Selangor,406,263,143,Greece
81398,1/1/2024,GRD,Johor,6,3,3,Grenada
81399,1/1/2024,GRD,Selangor,15,12,3,Grenada
81400,1/1/2024,GTM,Johor,1,0,1,Guatemala
81401,1/1/2024,GTM,Kedah,1,0,1,Guatemala
81402,1/1/2024,GTM,Pulau Pinang,1,1,0,Guatemala
81403,1/1/2024,GTM,Selangor,21,11,10,Guatemala
81404,1/1/2024,GUY,Johor,1,1,0,Guyana
81405,1/1/2024,GUY,Selangor,7,6,1,Guyana
81406,1/1/2024,HKG,Johor,2,0,2,Hong Kong
81407,1/1/2024,HKG,Kedah,9,5,4,Hong Kong
81408,1/1/2024,HKG,Pahang,1,0,1,Hong Kong
81409,1/1/2024,HKG,Perak,50,24,26,Hong Kong
81410,1/1/2024,HKG,Perlis,1,0,1,Hong Kong
81411,1/1/2024,HKG,Sabah,12327,5388,6939,Hong Kong
81412,1/1/2024,HKG,Selangor,752,349,403,Hong Kong
81413,1/1/2024,HND,Johor,7,6,1,Honduras
81414,1/1/2024,HND,Kedah,1,1,0,Honduras
81415,1/1/2024,HND,Selangor,21,14,7,Honduras
81416,1/1/2024,HRV,Johor,32,22,10,Croatia
81417,1/1/2024,HRV,Kedah,22,8,14,Croatia
81418,1/1/2024,HRV,Perlis,1,1,0,Croatia
81419,1/1/2024,HRV,Pulau Pinang,10,4,6,Croatia
81420,1/1/2024,HRV,Sabah,4,4,0,Croatia
81421,1/1/2024,HRV,Sarawak,1,1,0,Croatia
81422,1/1/2024,HRV,Selangor,417,243,174,Croatia
81423,1/1/2024,HTI,Johor,4,3,1,Haiti
81424,1/1/2024,HTI,Selangor,12,9,3,Haiti
81425,1/1/2024,HUN,Johor,104,68,36,Hungary
81426,1/1/2024,HUN,Kedah,159,86,73,Hungary
81427,1/1/2024,HUN,Perak,11,6,5,Hungary
81428,1/1/2024,HUN,Perlis,10,6,4,Hungary
81429,1/1/2024,HUN,Pulau Pinang,36,19,17,Hungary
81430,1/1/2024,HUN,Sabah,42,21,21,Hungary
81431,1/1/2024,HUN,Sarawak,17,10,7,Hungary
81432,1/1/2024,HUN,Selangor,1273,671,602,Hungary
81433,1/1/2024,IDN,Johor,102215,47181,55034,Indonesia
81434,1/1/2024,IDN,Kedah,7243,2820,4423,Indonesia
81435,1/1/2024,IDN,Kelantan,109,59,50,Indonesia
81436,1/1/2024,IDN,Melaka,3401,1596,1805,Indonesia
81437,1/1/2024,IDN,Negeri Sembilan,4818,2786,2032,Indonesia
81438,1/1/2024,IDN,Pahang,8,4,4,Indonesia
81439,1/1/2024,IDN,Perak,138,53,85,Indonesia
81440,1/1/2024,IDN,Perlis,902,259,643,Indonesia
81441,1/1/2024,IDN,Pulau Pinang,45790,17228,28562,Indonesia
81442,1/1/2024,IDN,Sabah,4598,2209,2389,Indonesia
81443,1/1/2024,IDN,Sarawak,42070,21713,20357,Indonesia
81444,1/1/2024,IDN,Selangor,169899,77105,92794,Indonesia
81445,1/1/2024,IDN,W.P. Labuan,60,37,23,Indonesia
81446,1/1/2024,IND,Johor,18984,12989,5995,India
81447,1/1/2024,IND,Kedah,1224,736,488,India
81448,1/1/2024,IND,Kelantan,4,4,0,India
81449,1/1/2024,IND,Melaka,1,1,0,India
81450,1/1/2024,IND,Pahang,9,8,1,India
81451,1/1/2024,IND,Perak,245,185,60,India
81452,1/1/2024,IND,Perlis,90,71,19,India
81453,1/1/2024,IND,Pulau Pinang,1406,964,442,India
81454,1/1/2024,IND,Sabah,213,149,64,India
81455,1/1/2024,IND,Sarawak,2348,1914,434,India
81456,1/1/2024,IND,Selangor,70540,46989,23551,India
81457,1/1/2024,IND,W.P. Labuan,52,49,3,India
81458,1/1/2024,IRL,Johor,242,156,86,Ireland
81459,1/1/2024,IRL,Kedah,144,72,72,Ireland
81460,1/1/2024,IRL,Kelantan,2,1,1,Ireland
81461,1/1/2024,IRL,Perak,7,4,3,Ireland
81462,1/1/2024,IRL,Perlis,24,16,8,Ireland
81463,1/1/2024,IRL,Pulau Pinang,168,120,48,Ireland
81464,1/1/2024,IRL,Sabah,27,12,15,Ireland
81465,1/1/2024,IRL,Sarawak,21,11,10,Ireland
81466,1/1/2024,IRL,Selangor,1698,999,699,Ireland
81467,1/1/2024,IRN,Johor,274,146,128,Iran
81468,1/1/2024,IRN,Kedah,9,4,5,Iran
81469,1/1/2024,IRN,Perak,1,1,0,Iran
81470,1/1/2024,IRN,Perlis,3,3,0,Iran
81471,1/1/2024,IRN,Pulau Pinang,17,7,10,Iran
81472,1/1/2024,IRN,Sabah,1,0,1,Iran
81473,1/1/2024,IRN,Sarawak,2,2,0,Iran
81474,1/1/2024,IRN,Selangor,2263,1244,1019,Iran
81475,1/1/2024,IRQ,Johor,23,16,7,Iraq
81476,1/1/2024,IRQ,Kedah,4,2,2,Iraq
81477,1/1/2024,IRQ,Perlis,1,1,0,Iraq
81478,1/1/2024,IRQ,Pulau Pinang,11,10,1,Iraq
81479,1/1/2024,IRQ,Sabah,2,2,0,Iraq
81480,1/1/2024,IRQ,Selangor,1115,739,376,Iraq
81481,1/1/2024,ISL,Johor,4,4,0,Iceland
81482,1/1/2024,ISL,Kedah,7,3,4,Iceland
81483,1/1/2024,ISL,Perak,2,1,1,Iceland
81484,1/1/2024,ISL,Pulau Pinang,4,1,3,Iceland
81485,1/1/2024,ISL,Selangor,51,30,21,Iceland
81486,1/1/2024,ITA,Johor,528,337,191,Italy
81487,1/1/2024,ITA,Kedah,1073,545,528,Italy
81488,1/1/2024,ITA,Kelantan,3,3,0,Italy
81489,1/1/2024,ITA,Melaka,2,1,1,Italy
81490,1/1/2024,ITA,Pahang,2,2,0,Italy
81491,1/1/2024,ITA,Perak,12,8,4,Italy
81492,1/1/2024,ITA,Perlis,45,31,14,Italy
81493,1/1/2024,ITA,Pulau Pinang,172,117,55,Italy
81494,1/1/2024,ITA,Sabah,51,33,18,Italy
81495,1/1/2024,ITA,Sarawak,25,17,8,Italy
81496,1/1/2024,ITA,Selangor,4427,2846,1581,Italy
81497,1/1/2024,JAM,Johor,6,3,3,Jamaica
81498,1/1/2024,JAM,Kedah,1,0,1,Jamaica
81499,1/1/2024,JAM,Pulau Pinang,4,3,1,Jamaica
81500,1/1/2024,JAM,Selangor,18,8,10,Jamaica
81501,1/1/2024,JOR,Johor,8,3,5,Jordan
81502,1/1/2024,JOR,Kedah,1,1,0,Jordan
81503,1/1/2024,JOR,Perlis,2,2,0,Jordan
81504,1/1/2024,JOR,Pulau Pinang,4,4,0,Jordan
81505,1/1/2024,JOR,Sabah,1,1,0,Jordan
81506,1/1/2024,JOR,Selangor,898,551,347,Jordan
81507,1/1/2024,JPN,Johor,5512,3508,2004,Japan
81508,1/1/2024,JPN,Kedah,576,284,292,Japan
81509,1/1/2024,JPN,Kelantan,16,13,3,Japan
81510,1/1/2024,JPN,Melaka,2,2,0,Japan
81511,1/1/2024,JPN,Pahang,6,4,2,Japan
81512,1/1/2024,JPN,Perak,74,44,30,Japan
81513,1/1/2024,JPN,Perlis,113,85,28,Japan
81514,1/1/2024,JPN,Pulau Pinang,1556,1045,511,Japan
81515,1/1/2024,JPN,Sabah,383,187,196,Japan
81516,1/1/2024,JPN,Sarawak,229,128,101,Japan
81517,1/1/2024,JPN,Selangor,22006,13135,8871,Japan
81518,1/1/2024,JPN,W.P. Labuan,16,13,3,Japan
81519,1/1/2024,KAZ,Johor,29,10,19,Kazakhstan
81520,1/1/2024,KAZ,Kedah,26,11,15,Kazakhstan
81521,1/1/2024,KAZ,Perlis,8,2,6,Kazakhstan
81522,1/1/2024,KAZ,Pulau Pinang,15,6,9,Kazakhstan
81523,1/1/2024,KAZ,Sabah,11,5,6,Kazakhstan
81524,1/1/2024,KAZ,Sarawak,6,4,2,Kazakhstan
81525,1/1/2024,KAZ,Selangor,1544,636,908,Kazakhstan
81526,1/1/2024,KEN,Johor,32,14,18,Kenya
81527,1/1/2024,KEN,Kedah,1,1,0,Kenya
81528,1/1/2024,KEN,Pulau Pinang,8,4,4,Kenya
81529,1/1/2024,KEN,Sarawak,1,1,0,Kenya
81530,1/1/2024,KEN,Selangor,433,214,219,Kenya
81531,1/1/2024,KGZ,Johor,42,30,12,Kyrgyzstan
81532,1/1/2024,KGZ,Kedah,35,15,20,Kyrgyzstan
81533,1/1/2024,KGZ,Kelantan,4,4,0,Kyrgyzstan
81534,1/1/2024,KGZ,Perlis,1,0,1,Kyrgyzstan
81535,1/1/2024,KGZ,Pulau Pinang,8,5,3,Kyrgyzstan
81536,1/1/2024,KGZ,Sabah,6,4,2,Kyrgyzstan
81537,1/1/2024,KGZ,Selangor,586,262,324,Kyrgyzstan
81538,1/1/2024,KHM,Johor,1736,710,1026,Cambodia
81539,1/1/2024,KHM,Kedah,204,143,61,Cambodia
81540,1/1/2024,KHM,Kelantan,740,577,163,Cambodia
81541,1/1/2024,KHM,Melaka,1,1,0,Cambodia
81542,1/1/2024,KHM,Perak,5,3,2,Cambodia
81543,1/1/2024,KHM,Perlis,861,594,267,Cambodia
81544,1/1/2024,KHM,Pulau Pinang,22,10,12,Cambodia
81545,1/1/2024,KHM,Sabah,1,1,0,Cambodia
81546,1/1/2024,KHM,Sarawak,8,4,4,Cambodia
81547,1/1/2024,KHM,Selangor,3311,1600,1711,Cambodia
81548,1/1/2024,KIR,Selangor,5,3,2,Kiribati
81549,1/1/2024,KNA,Johor,18,15,3,Saint Kitts and Nevis
81550,1/1/2024,KNA,Selangor,59,46,13,Saint Kitts and Nevis
81551,1/1/2024,KOR,Johor,19717,9417,10300,"Korea, Republic of (South Korea)"
81552,1/1/2024,KOR,Kedah,551,261,290,"Korea, Republic of (South Korea)"
81553,1/1/2024,KOR,Kelantan,3,2,1,"Korea, Republic of (South Korea)"
81554,1/1/2024,KOR,Melaka,30,15,15,"Korea, Republic of (South Korea)"
81555,1/1/2024,KOR,Pahang,8,4,4,"Korea, Republic of (South Korea)"
81556,1/1/2024,KOR,Perak,32,16,16,"Korea, Republic of (South Korea)"
81557,1/1/2024,KOR,Perlis,108,79,29,"Korea, Republic of (South Korea)"
81558,1/1/2024,KOR,Pulau Pinang,1006,510,496,"Korea, Republic of (South Korea)"
81559,1/1/2024,KOR,Sabah,26519,11123,15396,"Korea, Republic of (South Korea)"
81560,1/1/2024,KOR,Sarawak,440,219,221,"Korea, Republic of (South Korea)"
81561,1/1/2024,KOR,Selangor,30481,15121,15360,"Korea, Republic of (South Korea)"
81562,1/1/2024,KOR,W.P. Labuan,5,4,1,"Korea, Republic of (South Korea)"
81563,1/1/2024,KWT,Johor,99,42,57,Kuwait
81564,1/1/2024,KWT,Kedah,19,7,12,Kuwait
81565,1/1/2024,KWT,Pulau Pinang,6,4,2,Kuwait
81566,1/1/2024,KWT,Sabah,2,2,0,Kuwait
81567,1/1/2024,KWT,Sarawak,1,1,0,Kuwait
81568,1/1/2024,KWT,Selangor,1242,658,584,Kuwait
81569,1/1/2024,LAO,Johor,169,38,131,Lao People's Democratic Republic
81570,1/1/2024,LAO,Kedah,1075,82,993,Lao People's Democratic Republic
81571,1/1/2024,LAO,Kelantan,162,17,145,Lao People's Democratic Republic
81572,1/1/2024,LAO,Perak,24,1,23,Lao People's Democratic Republic
81573,1/1/2024,LAO,Perlis,331,93,238,Lao People's Democratic Republic
81574,1/1/2024,LAO,Pulau Pinang,20,6,14,Lao People's Democratic Republic
81575,1/1/2024,LAO,Sarawak,13,5,8,Lao People's Democratic Republic
81576,1/1/2024,LAO,Selangor,255,81,174,Lao People's Democratic Republic
81577,1/1/2024,LBN,Johor,22,12,10,Lebanon
81578,1/1/2024,LBN,Kedah,7,7,0,Lebanon
81579,1/1/2024,LBN,Pulau Pinang,5,4,1,Lebanon
81580,1/1/2024,LBN,Sabah,1,1,0,Lebanon
81581,1/1/2024,LBN,Sarawak,7,7,0,Lebanon
81582,1/1/2024,LBN,Selangor,323,195,128,Lebanon
81583,1/1/2024,LBR,Johor,1,1,0,Liberia
81584,1/1/2024,LBR,Selangor,4,4,0,Liberia
81585,1/1/2024,LBY,Johor,2,1,1,Libyan Arab Jamahiriya
81586,1/1/2024,LBY,Perlis,3,3,0,Libyan Arab Jamahiriya
81587,1/1/2024,LBY,Pulau Pinang,1,1,0,Libyan Arab Jamahiriya
81588,1/1/2024,LBY,Sabah,1,0,1,Libyan Arab Jamahiriya
81589,1/1/2024,LBY,Selangor,425,300,125,Libyan Arab Jamahiriya
81590,1/1/2024,LCA,Johor,6,3,3,Saint Lucia
81591,1/1/2024,LCA,Selangor,10,8,2,Saint Lucia
81592,1/1/2024,LIE,Johor,1,0,1,Liechtenstein
81593,1/1/2024,LIE,Kedah,2,1,1,Liechtenstein
81594,1/1/2024,LIE,Pulau Pinang,2,2,0,Liechtenstein
81595,1/1/2024,LIE,Selangor,9,9,0,Liechtenstein
81596,1/1/2024,LKA,Johor,662,427,235,Sri Lanka
81597,1/1/2024,LKA,Kedah,72,45,27,Sri Lanka
81598,1/1/2024,LKA,Perak,10,10,0,Sri Lanka
81599,1/1/2024,LKA,Perlis,2,2,0,Sri Lanka
81600,1/1/2024,LKA,Pulau Pinang,28,21,7,Sri Lanka
81601,1/1/2024,LKA,Sabah,10,6,4,Sri Lanka
81602,1/1/2024,LKA,Sarawak,17,15,2,Sri Lanka
81603,1/1/2024,LKA,Selangor,4369,2733,1636,Sri Lanka
81604,1/1/2024,LSO,Selangor,7,0,7,Lesotho
81605,1/1/2024,LTU,Johor,48,19,29,Lithuania
81606,1/1/2024,LTU,Kedah,141,69,72,Lithuania
81607,1/1/2024,LTU,Perlis,9,6,3,Lithuania
81608,1/1/2024,LTU,Pulau Pinang,17,9,8,Lithuania
81609,1/1/2024,LTU,Sabah,9,6,3,Lithuania
81610,1/1/2024,LTU,Sarawak,12,4,8,Lithuania
81611,1/1/2024,LTU,Selangor,792,377,415,Lithuania
81612,1/1/2024,LUX,Johor,5,3,2,Luxembourg
81613,1/1/2024,LUX,Kedah,3,2,1,Luxembourg
81614,1/1/2024,LUX,Pahang,2,2,0,Luxembourg
81615,1/1/2024,LUX,Perlis,2,1,1,Luxembourg
81616,1/1/2024,LUX,Pulau Pinang,5,3,2,Luxembourg
81617,1/1/2024,LUX,Sarawak,5,3,2,Luxembourg
81618,1/1/2024,LUX,Selangor,74,37,37,Luxembourg
81619,1/1/2024,LVA,Johor,48,17,31,Latvia
81620,1/1/2024,LVA,Kedah,24,11,13,Latvia
81621,1/1/2024,LVA,Perlis,3,3,0,Latvia
81622,1/1/2024,LVA,Pulau Pinang,10,4,6,Latvia
81623,1/1/2024,LVA,Sabah,4,2,2,Latvia
81624,1/1/2024,LVA,Sarawak,5,3,2,Latvia
81625,1/1/2024,LVA,Selangor,346,167,179,Latvia
81626,1/1/2024,MAC,Johor,1,1,0,Macao
81627,1/1/2024,MAC,Perak,1,1,0,Macao
81628,1/1/2024,MAC,Selangor,1,0,1,Macao
81629,1/1/2024,MAR,Johor,92,56,36,Morocco
81630,1/1/2024,MAR,Kedah,11,4,7,Morocco
81631,1/1/2024,MAR,Perlis,1,0,1,Morocco
81632,1/1/2024,MAR,Pulau Pinang,15,8,7,Morocco
81633,1/1/2024,MAR,Sabah,10,5,5,Morocco
81634,1/1/2024,MAR,Sarawak,8,6,2,Morocco
81635,1/1/2024,MAR,Selangor,1123,607,516,Morocco
81636,1/1/2024,MCO,Johor,2,1,1,Monaco
81637,1/1/2024,MCO,Kedah,2,1,1,Monaco
81638,1/1/2024,MCO,Selangor,3,3,0,Monaco
81639,1/1/2024,MDA,Johor,4,4,0,"Moldova, Republic of"
81640,1/1/2024,MDA,Kedah,2,1,1,"Moldova, Republic of"
81641,1/1/2024,MDA,Sabah,2,0,2,"Moldova, Republic of"
81642,1/1/2024,MDA,Selangor,52,24,28,"Moldova, Republic of"
81643,1/1/2024,MDG,Johor,25,12,13,Madagascar
81644,1/1/2024,MDG,Kedah,1,0,1,Madagascar
81645,1/1/2024,MDG,Sabah,1,0,1,Madagascar
81646,1/1/2024,MDG,Sarawak,1,0,1,Madagascar
81647,1/1/2024,MDG,Selangor,47,21,26,Madagascar
81648,1/1/2024,MDV,Johor,133,60,73,Maldives
81649,1/1/2024,MDV,Kedah,6,2,4,Maldives
81650,1/1/2024,MDV,Kelantan,1,1,0,Maldives
81651,1/1/2024,MDV,Pulau Pinang,7,7,0,Maldives
81652,1/1/2024,MDV,Sabah,1,1,0,Maldives
81653,1/1/2024,MDV,Selangor,2991,1553,1438,Maldives
81654,1/1/2024,MEX,Johor,143,76,67,Mexico
81655,1/1/2024,MEX,Kedah,16,10,6,Mexico
81656,1/1/2024,MEX,Perak,2,1,1,Mexico
81657,1/1/2024,MEX,Perlis,2,2,0,Mexico
81658,1/1/2024,MEX,Pulau Pinang,42,29,13,Mexico
81659,1/1/2024,MEX,Sabah,9,7,2,Mexico
81660,1/1/2024,MEX,Sarawak,2,2,0,Mexico
81661,1/1/2024,MEX,Selangor,624,317,307,Mexico
81662,1/1/2024,MHL,Selangor,4,2,2,Marshall Islands
81663,1/1/2024,MKD,Johor,5,4,1,"Macedonia, the former Yugoslav Republic of"
81664,1/1/2024,MKD,Kedah,8,4,4,"Macedonia, the former Yugoslav Republic of"
81665,1/1/2024,MKD,Pulau Pinang,1,1,0,"Macedonia, the former Yugoslav Republic of"
81666,1/1/2024,MKD,Selangor,90,51,39,"Macedonia, the former Yugoslav Republic of"
81667,1/1/2024,MLI,Selangor,9,5,4,Mali
81668,1/1/2024,MLT,Johor,4,2,2,Malta
81669,1/1/2024,MLT,Kedah,15,8,7,Malta
81670,1/1/2024,MLT,Pulau Pinang,2,1,1,Malta
81671,1/1/2024,MLT,Selangor,71,45,26,Malta
81672,1/1/2024,MMR,Johor,4154,1282,2872,Myanmar
81673,1/1/2024,MMR,Kedah,78,16,62,Myanmar
81674,1/1/2024,MMR,Kelantan,5,2,3,Myanmar
81675,1/1/2024,MMR,Pahang,3,0,3,Myanmar
81676,1/1/2024,MMR,Perak,24,5,19,Myanmar
81677,1/1/2024,MMR,Perlis,3,1,2,Myanmar
81678,1/1/2024,MMR,Pulau Pinang,450,229,221,Myanmar
81679,1/1/2024,MMR,Sabah,21,8,13,Myanmar
81680,1/1/2024,MMR,Sarawak,76,40,36,Myanmar
81681,1/1/2024,MMR,Selangor,6276,4235,2041,Myanmar
81682,1/1/2024,MMR,W.P. Labuan,2,2,0,Myanmar
81683,1/1/2024,MNE,Johor,10,9,1,Montenegro
81684,1/1/2024,MNE,Pulau Pinang,1,1,0,Montenegro
81685,1/1/2024,MNE,Selangor,26,16,10,Montenegro
81686,1/1/2024,MNG,Johor,667,311,356,Mongolia
81687,1/1/2024,MNG,Kedah,37,14,23,Mongolia
81688,1/1/2024,MNG,Perlis,2,2,0,Mongolia
81689,1/1/2024,MNG,Pulau Pinang,40,20,20,Mongolia
81690,1/1/2024,MNG,Sabah,24,9,15,Mongolia
81691,1/1/2024,MNG,Selangor,1327,592,735,Mongolia
81692,1/1/2024,MOZ,Johor,1,0,1,Mozambique
81693,1/1/2024,MOZ,Selangor,96,44,52,Mozambique
81694,1/1/2024,MRT,Johor,3,3,0,Mauritania
81695,1/1/2024,MRT,Selangor,29,20,9,Mauritania
81696,1/1/2024,MUS,Johor,178,95,83,Mauritius
81697,1/1/2024,MUS,Kedah,8,6,2,Mauritius
81698,1/1/2024,MUS,Perak,1,0,1,Mauritius
81699,1/1/2024,MUS,Perlis,1,1,0,Mauritius
81700,1/1/2024,MUS,Pulau Pinang,11,4,7,Mauritius
81701,1/1/2024,MUS,Sabah,3,1,2,Mauritius
81702,1/1/2024,MUS,Selangor,1712,877,835,Mauritius
81703,1/1/2024,MWI,Johor,1,0,1,Malawi
81704,1/1/2024,MWI,Selangor,23,14,9,Malawi
81705,1/1/2024,NAM,Johor,1,1,0,Namibia
81706,1/1/2024,NAM,Selangor,13,6,7,Namibia
81707,1/1/2024,NER,Selangor,3,3,0,Niger
81708,1/1/2024,NGA,Johor,17,17,0,Nigeria
81709,1/1/2024,NGA,Kedah,1,0,1,Nigeria
81710,1/1/2024,NGA,Pulau Pinang,7,7,0,Nigeria
81711,1/1/2024,NGA,Sarawak,5,3,2,Nigeria
81712,1/1/2024,NGA,Selangor,434,335,99,Nigeria
81713,1/1/2024,NIC,Johor,1,1,0,Nicaragua
81714,1/1/2024,NIC,Selangor,4,2,2,Nicaragua
81715,1/1/2024,NLD,Johor,826,512,314,Netherlands
81716,1/1/2024,NLD,Kedah,582,289,293,Netherlands
81717,1/1/2024,NLD,Kelantan,3,2,1,Netherlands
81718,1/1/2024,NLD,Melaka,1,1,0,Netherlands
81719,1/1/2024,NLD,Pahang,3,3,0,Netherlands
81720,1/1/2024,NLD,Perak,19,13,6,Netherlands
81721,1/1/2024,NLD,Perlis,57,38,19,Netherlands
81722,1/1/2024,NLD,Pulau Pinang,282,185,97,Netherlands
81723,1/1/2024,NLD,Sabah,92,44,48,Netherlands
81724,1/1/2024,NLD,Sarawak,135,87,48,Netherlands
81725,1/1/2024,NLD,Selangor,5119,2981,2138,Netherlands
81726,1/1/2024,NLD,W.P. Labuan,1,1,0,Netherlands
81727,1/1/2024,NOR,Johor,139,82,57,Norway
81728,1/1/2024,NOR,Kedah,130,55,75,Norway
81729,1/1/2024,NOR,Perlis,8,4,4,Norway
81730,1/1/2024,NOR,Pulau Pinang,72,43,29,Norway
81731,1/1/2024,NOR,Sabah,14,7,7,Norway
81732,1/1/2024,NOR,Sarawak,19,13,6,Norway
81733,1/1/2024,NOR,Selangor,1123,657,466,Norway
81734,1/1/2024,NPL,Johor,808,586,222,Nepal
81735,1/1/2024,NPL,Kedah,32,27,5,Nepal
81736,1/1/2024,NPL,Perlis,1,1,0,Nepal
81737,1/1/2024,NPL,Pulau Pinang,48,44,4,Nepal
81738,1/1/2024,NPL,Sabah,5,2,3,Nepal
81739,1/1/2024,NPL,Sarawak,196,136,60,Nepal
81740,1/1/2024,NPL,Selangor,9756,9121,635,Nepal
81741,1/1/2024,NPL,W.P. Labuan,62,59,3,Nepal
81742,1/1/2024,NRU,Selangor,1,1,0,Nauru
81743,1/1/2024,NZL,Johor,959,546,413,New Zealand
81744,1/1/2024,NZL,Kedah,234,121,113,New Zealand
81745,1/1/2024,NZL,Kelantan,4,1,3,New Zealand
81746,1/1/2024,NZL,Melaka,3,0,3,New Zealand
81747,1/1/2024,NZL,Perak,26,15,11,New Zealand
81748,1/1/2024,NZL,Perlis,23,9,14,New Zealand
81749,1/1/2024,NZL,Pulau Pinang,278,150,128,New Zealand
81750,1/1/2024,NZL,Sabah,62,32,30,New Zealand
81751,1/1/2024,NZL,Sarawak,162,91,71,New Zealand
81752,1/1/2024,NZL,Selangor,4346,2460,1886,New Zealand
81753,1/1/2024,NZL,W.P. Labuan,1,1,0,New Zealand
81754,1/1/2024,OMN,Johor,24,16,8,Oman
81755,1/1/2024,OMN,Kedah,13,9,4,Oman
81756,1/1/2024,OMN,Perlis,1,0,1,Oman
81757,1/1/2024,OMN,Pulau Pinang,11,7,4,Oman
81758,1/1/2024,OMN,Sabah,1,1,0,Oman
81759,1/1/2024,OMN,Sarawak,4,3,1,Oman
81760,1/1/2024,OMN,Selangor,3378,1770,1608,Oman
81761,1/1/2024,PAK,Johor,692,520,172,Pakistan
81762,1/1/2024,PAK,Kedah,97,78,19,Pakistan
81763,1/1/2024,PAK,Kelantan,20,20,0,Pakistan
81764,1/1/2024,PAK,Perak,7,7,0,Pakistan
81765,1/1/2024,PAK,Perlis,28,26,2,Pakistan
81766,1/1/2024,PAK,Pulau Pinang,90,73,17,Pakistan
81767,1/1/2024,PAK,Sabah,21,19,2,Pakistan
81768,1/1/2024,PAK,Sarawak,139,120,19,Pakistan
81769,1/1/2024,PAK,Selangor,10855,8781,2074,Pakistan
81770,1/1/2024,PAK,W.P. Labuan,1,1,0,Pakistan
81771,1/1/2024,PAN,Johor,12,7,5,Panama
81772,1/1/2024,PAN,Pulau Pinang,1,1,0,Panama
81773,1/1/2024,PAN,Sarawak,2,2,0,Panama
81774,1/1/2024,PAN,Selangor,35,20,15,Panama
81775,1/1/2024,PER,Johor,32,15,17,Peru
81776,1/1/2024,PER,Kedah,9,3,6,Peru
81777,1/1/2024,PER,Pulau Pinang,6,5,1,Peru
81778,1/1/2024,PER,Selangor,163,83,80,Peru
81779,1/1/2024,PHL,Johor,14022,4383,9639,Philippines
81780,1/1/2024,PHL,Kedah,477,167,310,Philippines
81781,1/1/2024,PHL,Kelantan,24,11,13,Philippines
81782,1/1/2024,PHL,Negeri Sembilan,4,4,0,Philippines
81783,1/1/2024,PHL,Pahang,13,11,2,Philippines
81784,1/1/2024,PHL,Perak,69,33,36,Philippines
81785,1/1/2024,PHL,Perlis,213,70,143,Philippines
81786,1/1/2024,PHL,Pulau Pinang,657,304,353,Philippines
81787,1/1/2024,PHL,Sabah,1990,835,1155,Philippines
81788,1/1/2024,PHL,Sarawak,2820,1246,1574,Philippines
81789,1/1/2024,PHL,Selangor,18073,7354,10719,Philippines
81790,1/1/2024,PHL,W.P. Labuan,107,34,73,Philippines
81791,1/1/2024,PLW,Selangor,11,9,2,Palau
81792,1/1/2024,PNG,Johor,14,4,10,Papua New Guinea
81793,1/1/2024,PNG,Pulau Pinang,2,0,2,Papua New Guinea
81794,1/1/2024,PNG,Sarawak,18,8,10,Papua New Guinea
81795,1/1/2024,PNG,Selangor,91,48,43,Papua New Guinea
81796,1/1/2024,POL,Johor,684,363,321,Poland
81797,1/1/2024,POL,Kedah,530,265,265,Poland
81798,1/1/2024,POL,Kelantan,1,1,0,Poland
81799,1/1/2024,POL,Melaka,1,1,0,Poland
81800,1/1/2024,POL,Perak,3,2,1,Poland
81801,1/1/2024,POL,Perlis,42,23,19,Poland
81802,1/1/2024,POL,Pulau Pinang,149,67,82,Poland
81803,1/1/2024,POL,Sabah,69,36,33,Poland
81804,1/1/2024,POL,Sarawak,52,26,26,Poland
81805,1/1/2024,POL,Selangor,2850,1510,1340,Poland
81806,1/1/2024,POL,W.P. Labuan,22,9,13,Poland
81807,1/1/2024,PRT,Johor,136,75,61,Portugal
81808,1/1/2024,PRT,Kedah,95,48,47,Portugal
81809,1/1/2024,PRT,Perlis,3,3,0,Portugal
81810,1/1/2024,PRT,Pulau Pinang,42,12,30,Portugal
81811,1/1/2024,PRT,Sabah,12,9,3,Portugal
81812,1/1/2024,PRT,Sarawak,8,6,2,Portugal
81813,1/1/2024,PRT,Selangor,856,493,363,Portugal
81814,1/1/2024,PRY,Johor,4,0,4,Paraguay
81815,1/1/2024,PRY,Kedah,4,0,4,Paraguay
81816,1/1/2024,PRY,Perlis,1,1,0,Paraguay
81817,1/1/2024,PRY,Pulau Pinang,1,0,1,Paraguay
81818,1/1/2024,PRY,Sabah,2,1,1,Paraguay
81819,1/1/2024,PRY,Selangor,22,15,7,Paraguay
81820,1/1/2024,PSE,Johor,20,20,0,"Palestinian Territory, Occupied"
81821,1/1/2024,PSE,Pulau Pinang,5,5,0,"Palestinian Territory, Occupied"
81822,1/1/2024,PSE,Selangor,237,172,65,"Palestinian Territory, Occupied"
81823,1/1/2024,QAT,Johor,2,1,1,Qatar
81824,1/1/2024,QAT,Sarawak,1,1,0,Qatar
81825,1/1/2024,QAT,Selangor,131,82,49,Qatar
81826,1/1/2024,ROU,Johor,169,100,69,Romania
81827,1/1/2024,ROU,Kedah,200,101,99,Romania
81828,1/1/2024,ROU,Kelantan,1,1,0,Romania
81829,1/1/2024,ROU,Perlis,9,5,4,Romania
81830,1/1/2024,ROU,Pulau Pinang,68,32,36,Romania
81831,1/1/2024,ROU,Sabah,6,4,2,Romania
81832,1/1/2024,ROU,Sarawak,10,7,3,Romania
81833,1/1/2024,ROU,Selangor,1548,804,744,Romania
81834,1/1/2024,RUS,Johor,416,221,195,Russia
81835,1/1/2024,RUS,Kedah,749,358,391,Russia
81836,1/1/2024,RUS,Kelantan,9,5,4,Russia
81837,1/1/2024,RUS,Pahang,6,2,4,Russia
81838,1/1/2024,RUS,Perak,3,3,0,Russia
81839,1/1/2024,RUS,Perlis,84,48,36,Russia
81840,1/1/2024,RUS,Pulau Pinang,280,139,141,Russia
81841,1/1/2024,RUS,Sabah,165,76,89,Russia
81842,1/1/2024,RUS,Sarawak,57,30,27,Russia
81843,1/1/2024,RUS,Selangor,13391,6449,6942,Russia
81844,1/1/2024,RUS,W.P. Labuan,7,2,5,Russia
81845,1/1/2024,RWA,Selangor,11,4,7,Rwanda
81846,1/1/2024,SAU,Johor,151,80,71,Saudi Arabia
81847,1/1/2024,SAU,Kedah,38,18,20,Saudi Arabia
81848,1/1/2024,SAU,Kelantan,4,3,1,Saudi Arabia
81849,1/1/2024,SAU,Perak,2,1,1,Saudi Arabia
81850,1/1/2024,SAU,Perlis,2,1,1,Saudi Arabia
81851,1/1/2024,SAU,Pulau Pinang,45,27,18,Saudi Arabia
81852,1/1/2024,SAU,Sabah,5,4,1,Saudi Arabia
81853,1/1/2024,SAU,Sarawak,8,6,2,Saudi Arabia
81854,1/1/2024,SAU,Selangor,6118,3404,2714,Saudi Arabia
81855,1/1/2024,SDN,Johor,7,6,1,Sudan
81856,1/1/2024,SDN,Kedah,2,2,0,Sudan
81857,1/1/2024,SDN,Kelantan,2,2,0,Sudan
81858,1/1/2024,SDN,Pulau Pinang,1,1,0,Sudan
81859,1/1/2024,SDN,Sarawak,11,8,3,Sudan
81860,1/1/2024,SDN,Selangor,1460,797,663,Sudan
81861,1/1/2024,SEN,Johor,12,8,4,Senegal
81862,1/1/2024,SEN,Perlis,1,1,0,Senegal
81863,1/1/2024,SEN,Sabah,1,1,0,Senegal
81864,1/1/2024,SEN,Selangor,57,44,13,Senegal
81865,1/1/2024,SGP,Johor,871844,505563,366281,Singapore
81866,1/1/2024,SGP,Kedah,3673,2000,1673,Singapore
81867,1/1/2024,SGP,Kelantan,43,29,14,Singapore
81868,1/1/2024,SGP,Melaka,24,20,4,Singapore
81869,1/1/2024,SGP,Negeri Sembilan,7,5,2,Singapore
81870,1/1/2024,SGP,Pahang,290,150,140,Singapore
81871,1/1/2024,SGP,Perak,4291,2076,2215,Singapore
81872,1/1/2024,SGP,Perlis,183,122,61,Singapore
81873,1/1/2024,SGP,Pulau Pinang,14410,7407,7003,Singapore
81874,1/1/2024,SGP,Sabah,2271,1214,1057,Singapore
81875,1/1/2024,SGP,Sarawak,3071,1732,1339,Singapore
81876,1/1/2024,SGP,Selangor,41630,21994,19636,Singapore
81877,1/1/2024,SGP,W.P. Labuan,11,9,2,Singapore
81878,1/1/2024,SHN,Johor,1,1,0,"Saint Helena, Ascension and Tristan da Cunha"
81879,1/1/2024,SLB,Pulau Pinang,4,2,2,Solomon Islands
81880,1/1/2024,SLB,Selangor,7,3,4,Solomon Islands
81881,1/1/2024,SLE,Johor,4,2,2,Sierra Leone
81882,1/1/2024,SLE,Kedah,2,1,1,Sierra Leone
81883,1/1/2024,SLE,Selangor,20,11,9,Sierra Leone
81884,1/1/2024,SLV,Johor,2,1,1,El Salvador
81885,1/1/2024,SLV,Kedah,15,5,10,El Salvador
81886,1/1/2024,SLV,Selangor,29,13,16,El Salvador
81887,1/1/2024,SMR,Selangor,5,5,0,San Marino
81888,1/1/2024,SOM,Johor,1,1,0,Somalia
81889,1/1/2024,SOM,Kedah,1,1,0,Somalia
81890,1/1/2024,SOM,Selangor,240,119,121,Somalia
81891,1/1/2024,SPM,Johor,1,0,1,Saint Pierre and Miquelon
81892,1/1/2024,SRB,Johor,9,6,3,Serbia
81893,1/1/2024,SRB,Kedah,14,5,9,Serbia
81894,1/1/2024,SRB,Pulau Pinang,4,2,2,Serbia
81895,1/1/2024,SRB,Selangor,181,85,96,Serbia
81896,1/1/2024,STP,Selangor,1,0,1,Sao Tome and Principe
81897,1/1/2024,SUR,Johor,1,1,0,Suriname
81898,1/1/2024,SUR,Pulau Pinang,1,1,0,Suriname
81899,1/1/2024,SUR,Selangor,12,9,3,Suriname
81900,1/1/2024,SVK,Johor,49,24,25,Slovakia
81901,1/1/2024,SVK,Kedah,106,49,57,Slovakia
81902,1/1/2024,SVK,Kelantan,2,2,0,Slovakia
81903,1/1/2024,SVK,Perak,2,2,0,Slovakia
81904,1/1/2024,SVK,Perlis,4,3,1,Slovakia
81905,1/1/2024,SVK,Pulau Pinang,36,18,18,Slovakia
81906,1/1/2024,SVK,Sarawak,3,1,2,Slovakia
81907,1/1/2024,SVK,Selangor,559,314,245,Slovakia
81908,1/1/2024,SVN,Johor,17,8,9,Slovenia
81909,1/1/2024,SVN,Kedah,71,39,32,Slovenia
81910,1/1/2024,SVN,Perlis,7,3,4,Slovenia
81911,1/1/2024,SVN,Pulau Pinang,7,2,5,Slovenia
81912,1/1/2024,SVN,Sabah,4,2,2,Slovenia
81913,1/1/2024,SVN,Selangor,318,170,148,Slovenia
81914,1/1/2024,SWE,Johor,311,154,157,Sweden
81915,1/1/2024,SWE,Kedah,547,271,276,Sweden
81916,1/1/2024,SWE,Kelantan,6,5,1,Sweden
81917,1/1/2024,SWE,Perak,5,5,0,Sweden
81918,1/1/2024,SWE,Perlis,39,29,10,Sweden
81919,1/1/2024,SWE,Pulau Pinang,119,77,42,Sweden
81920,1/1/2024,SWE,Sabah,27,12,15,Sweden
81921,1/1/2024,SWE,Sarawak,18,9,9,Sweden
81922,1/1/2024,SWE,Selangor,2018,1174,844,Sweden
81923,1/1/2024,SWZ,Selangor,14,5,9,Swaziland
81924,1/1/2024,SYC,Johor,17,5,12,Seychelles
81925,1/1/2024,SYC,Pulau Pinang,2,2,0,Seychelles
81926,1/1/2024,SYC,Selangor,152,64,88,Seychelles
81927,1/1/2024,SYR,Johor,9,5,4,Syrian Arab Republic
81928,1/1/2024,SYR,Kedah,4,2,2,Syrian Arab Republic
81929,1/1/2024,SYR,Pahang,6,6,0,Syrian Arab Republic
81930,1/1/2024,SYR,Pulau Pinang,1,1,0,Syrian Arab Republic
81931,1/1/2024,SYR,Sabah,2,2,0,Syrian Arab Republic
81932,1/1/2024,SYR,Sarawak,1,1,0,Syrian Arab Republic
81933,1/1/2024,SYR,Selangor,740,467,273,Syrian Arab Republic
81934,1/1/2024,TCD,Johor,11,10,1,Chad
81935,1/1/2024,TCD,Selangor,29,20,9,Chad
81936,1/1/2024,TGO,Johor,1,1,0,Togo
81937,1/1/2024,TGO,Selangor,10,9,1,Togo
81938,1/1/2024,THA,Johor,5582,1486,4096,Thailand
81939,1/1/2024,THA,Kedah,72272,43955,28317,Thailand
81940,1/1/2024,THA,Kelantan,52401,27259,25142,Thailand
81941,1/1/2024,THA,Pahang,3,1,2,Thailand
81942,1/1/2024,THA,Perak,10688,4919,5769,Thailand
81943,1/1/2024,THA,Perlis,53832,32478,21354,Thailand
81944,1/1/2024,THA,Pulau Pinang,2439,988,1451,Thailand
81945,1/1/2024,THA,Sabah,29,7,22,Thailand
81946,1/1/2024,THA,Sarawak,407,147,260,Thailand
81947,1/1/2024,THA,Selangor,13251,5035,8216,Thailand
81948,1/1/2024,THA,W.P. Labuan,7,4,3,Thailand
81949,1/1/2024,TJK,Pulau Pinang,1,1,0,Tajikistan
81950,1/1/2024,TJK,Sabah,1,1,0,Tajikistan
81951,1/1/2024,TJK,Selangor,209,138,71,Tajikistan
81952,1/1/2024,TKM,Pulau Pinang,1,1,0,Turkmenistan
81953,1/1/2024,TKM,Sabah,4,3,1,Turkmenistan
81954,1/1/2024,TKM,Selangor,180,100,80,Turkmenistan
81955,1/1/2024,TLS,Johor,20,12,8,Timor-Leste
81956,1/1/2024,TLS,Pulau Pinang,2,2,0,Timor-Leste
81957,1/1/2024,TLS,Sabah,1,0,1,Timor-Leste
81958,1/1/2024,TLS,Selangor,253,117,136,Timor-Leste
81959,1/1/2024,TON,Johor,12,7,5,Tonga
81960,1/1/2024,TON,Pulau Pinang,2,0,2,Tonga
81961,1/1/2024,TON,Selangor,27,15,12,Tonga
81962,1/1/2024,TTO,Johor,3,2,1,Trinidad and Tobago
81963,1/1/2024,TTO,Sarawak,3,0,3,Trinidad and Tobago
81964,1/1/2024,TTO,Selangor,26,15,11,Trinidad and Tobago
81965,1/1/2024,TTO,W.P. Labuan,1,1,0,Trinidad and Tobago
81966,1/1/2024,TUN,Johor,15,7,8,Tunisia
81967,1/1/2024,TUN,Kelantan,1,1,0,Tunisia
81968,1/1/2024,TUN,Pulau Pinang,10,10,0,Tunisia
81969,1/1/2024,TUN,Sabah,1,0,1,Tunisia
81970,1/1/2024,TUN,Selangor,833,464,369,Tunisia
81971,1/1/2024,TUR,Johor,280,208,72,Turkey
81972,1/1/2024,TUR,Kedah,118,67,51,Turkey
81973,1/1/2024,TUR,Kelantan,2,2,0,Turkey
81974,1/1/2024,TUR,Melaka,1,1,0,Turkey
81975,1/1/2024,TUR,Perak,5,4,1,Turkey
81976,1/1/2024,TUR,Perlis,24,19,5,Turkey
81977,1/1/2024,TUR,Pulau Pinang,56,40,16,Turkey
81978,1/1/2024,TUR,Sabah,6,4,2,Turkey
81979,1/1/2024,TUR,Sarawak,19,13,6,Turkey
81980,1/1/2024,TUR,Selangor,2017,1281,736,Turkey
81981,1/1/2024,TUV,Selangor,1,1,0,Tuvalu
81982,1/1/2024,TWN,Johor,6749,2907,3842,Taiwan
81983,1/1/2024,TWN,Kedah,239,114,125,Taiwan
81984,1/1/2024,TWN,Melaka,3,3,0,Taiwan
81985,1/1/2024,TWN,Negeri Sembilan,6,3,3,Taiwan
81986,1/1/2024,TWN,Pahang,5,3,2,Taiwan
81987,1/1/2024,TWN,Perak,56,20,36,Taiwan
81988,1/1/2024,TWN,Perlis,37,22,15,Taiwan
81989,1/1/2024,TWN,Pulau Pinang,4522,2074,2448,Taiwan
81990,1/1/2024,TWN,Sabah,2351,1060,1291,Taiwan
81991,1/1/2024,TWN,Sarawak,469,194,275,Taiwan
81992,1/1/2024,TWN,Selangor,19108,8892,10216,Taiwan
81993,1/1/2024,TWN,W.P. Labuan,1,1,0,Taiwan
81994,1/1/2024,TZA,Johor,40,18,22,"Tanzania, United Republic of"
81995,1/1/2024,TZA,Pulau Pinang,1,0,1,"Tanzania, United Republic of"
81996,1/1/2024,TZA,Selangor,244,112,132,"Tanzania, United Republic of"
81997,1/1/2024,UGA,Johor,51,28,23,Uganda
81998,1/1/2024,UGA,Kedah,2,1,1,Uganda
81999,1/1/2024,UGA,Perlis,1,0,1,Uganda
82000,1/1/2024,UGA,Pulau Pinang,3,1,2,Uganda
82001,1/1/2024,UGA,Sabah,2,2,0,Uganda
82002,1/1/2024,UGA,Sarawak,4,0,4,Uganda
82003,1/1/2024,UGA,Selangor,164,81,83,Uganda
82004,1/1/2024,UKR,Johor,89,43,46,Ukraine
82005,1/1/2024,UKR,Kedah,70,30,40,Ukraine
82006,1/1/2024,UKR,Kelantan,3,1,2,Ukraine
82007,1/1/2024,UKR,Pahang,1,0,1,Ukraine
82008,1/1/2024,UKR,Perak,1,1,0,Ukraine
82009,1/1/2024,UKR,Perlis,7,4,3,Ukraine
82010,1/1/2024,UKR,Pulau Pinang,49,27,22,Ukraine
82011,1/1/2024,UKR,Sabah,13,6,7,Ukraine
82012,1/1/2024,UKR,Sarawak,3,2,1,Ukraine
82013,1/1/2024,UKR,Selangor,1546,691,855,Ukraine
82014,1/1/2024,URY,Johor,18,4,14,Uruguay
82015,1/1/2024,URY,Kedah,8,3,5,Uruguay
82016,1/1/2024,URY,Pulau Pinang,1,0,1,Uruguay
82017,1/1/2024,URY,Selangor,55,28,27,Uruguay
82018,1/1/2024,USA,Johor,4068,2281,1787,United States Of America
82019,1/1/2024,USA,Kedah,1502,749,753,United States Of America
82020,1/1/2024,USA,Kelantan,7,4,3,United States Of America
82021,1/1/2024,USA,Melaka,1,1,0,United States Of America
82022,1/1/2024,USA,Negeri Sembilan,2,1,1,United States Of America
82023,1/1/2024,USA,Pahang,8,8,0,United States Of America
82024,1/1/2024,USA,Perak,98,57,41,United States Of America
82025,1/1/2024,USA,Perlis,114,76,38,United States Of America
82026,1/1/2024,USA,Pulau Pinang,2863,1612,1251,United States Of America
82027,1/1/2024,USA,Sabah,359,199,160,United States Of America
82028,1/1/2024,USA,Sarawak,253,147,106,United States Of America
82029,1/1/2024,USA,Selangor,16734,9807,6927,United States Of America
82030,1/1/2024,USA,W.P. Labuan,5,3,2,United States Of America
82031,1/1/2024,UZB,Johor,89,65,24,Uzbekistan
82032,1/1/2024,UZB,Kedah,72,41,31,Uzbekistan
82033,1/1/2024,UZB,Perak,1,1,0,Uzbekistan
82034,1/1/2024,UZB,Perlis,1,1,0,Uzbekistan
82035,1/1/2024,UZB,Pulau Pinang,9,6,3,Uzbekistan
82036,1/1/2024,UZB,Sabah,3,2,1,Uzbekistan
82037,1/1/2024,UZB,Selangor,3107,1949,1158,Uzbekistan
82038,1/1/2024,VAT,Pulau Pinang,1,1,0,Holy See (Vatican City State)
82039,1/1/2024,VCT,Johor,2,2,0,Saint Vincent and the Grenadines
82040,1/1/2024,VCT,Sabah,1,1,0,Saint Vincent and the Grenadines
82041,1/1/2024,VCT,Selangor,4,4,0,Saint Vincent and the Grenadines
82042,1/1/2024,VEN,Johor,22,8,14,Venezuela
82043,1/1/2024,VEN,Kedah,2,1,1,Venezuela
82044,1/1/2024,VEN,Pulau Pinang,2,1,1,Venezuela
82045,1/1/2024,VEN,Sarawak,1,1,0,Venezuela
82046,1/1/2024,VEN,Selangor,88,51,37,Venezuela
82047,1/1/2024,VNM,Johor,9973,3085,6888,Vietnam
82048,1/1/2024,VNM,Kedah,276,33,243,Vietnam
82049,1/1/2024,VNM,Kelantan,8,3,5,Vietnam
82050,1/1/2024,VNM,Pahang,1,1,0,Vietnam
82051,1/1/2024,VNM,Perak,221,7,214,Vietnam
82052,1/1/2024,VNM,Perlis,216,17,199,Vietnam
82053,1/1/2024,VNM,Pulau Pinang,949,295,654,Vietnam
82054,1/1/2024,VNM,Sabah,59,22,37,Vietnam
82055,1/1/2024,VNM,Sarawak,351,74,277,Vietnam
82056,1/1/2024,VNM,Selangor,12157,4359,7798,Vietnam
82057,1/1/2024,VNM,Terengganu,14,14,0,Vietnam
82058,1/1/2024,VNM,W.P. Labuan,2,2,0,Vietnam
82059,1/1/2024,VUT,Johor,43,36,7,Vanuatu
82060,1/1/2024,VUT,Pulau Pinang,2,2,0,Vanuatu
82061,1/1/2024,VUT,Sabah,2,2,0,Vanuatu
82062,1/1/2024,VUT,Selangor,73,65,8,Vanuatu
82063,1/1/2024,WSM,Selangor,3,0,3,Samoa
82064,1/1/2024,YEM,Johor,30,20,10,Yemen
82065,1/1/2024,YEM,Kedah,7,5,2,Yemen
82066,1/1/2024,YEM,Kelantan,2,1,1,Yemen
82067,1/1/2024,YEM,Melaka,1,1,0,Yemen
82068,1/1/2024,YEM,Perak,1,1,0,Yemen
82069,1/1/2024,YEM,Perlis,3,3,0,Yemen
82070,1/1/2024,YEM,Pulau Pinang,3,1,2,Yemen
82071,1/1/2024,YEM,Sarawak,7,6,1,Yemen
82072,1/1/2024,YEM,Selangor,1487,968,519,Yemen
82073,1/1/2024,ZAF,Johor,347,196,151,South Africa
82074,1/1/2024,ZAF,Kedah,68,31,37,South Africa
82075,1/1/2024,ZAF,Pahang,1,1,0,South Africa
82076,1/1/2024,ZAF,Perak,2,2,0,South Africa
82077,1/1/2024,ZAF,Perlis,4,1,3,South Africa
82078,1/1/2024,ZAF,Pulau Pinang,78,41,37,South Africa
82079,1/1/2024,ZAF,Sabah,37,20,17,South Africa
82080,1/1/2024,ZAF,Sarawak,56,30,26,South Africa
82081,1/1/2024,ZAF,Selangor,1549,814,735,South Africa
82082,1/1/2024,ZMB,Johor,10,5,5,Zambia
82083,1/1/2024,ZMB,Kedah,1,0,1,Zambia
82084,1/1/2024,ZMB,Pulau Pinang,5,1,4,Zambia
82085,1/1/2024,ZMB,Sarawak,2,1,1,Zambia
82086,1/1/2024,ZMB,Selangor,93,51,42,Zambia
82087,1/1/2024,ZWE,Johor,13,5,8,Zimbabwe
82088,1/1/2024,ZWE,Kedah,1,1,0,Zimbabwe
82089,1/1/2024,ZWE,Pulau Pinang,2,0,2,Zimbabwe
82090,1/1/2024,ZWE,Sarawak,1,0,1,Zimbabwe
82091,1/1/2024,ZWE,Selangor,199,103,96,Zimbabwe
82092,2/1/2024,AFG,Perlis,1,0,1,Afghanistan
82093,2/1/2024,AFG,Selangor,53,38,15,Afghanistan
82094,2/1/2024,AGO,Selangor,1,1,0,Angola
82095,2/1/2024,ALB,Johor,14,10,4,Albania
82096,2/1/2024,ALB,Kedah,2,1,1,Albania
82097,2/1/2024,ALB,Pulau Pinang,2,1,1,Albania
82098,2/1/2024,ALB,Selangor,28,17,11,Albania
82099,2/1/2024,AND,Johor,1,0,1,Andorra
82100,2/1/2024,AND,Selangor,5,2,3,Andorra
82101,2/1/2024,ARE,Johor,9,6,3,United Arab Emirates
82102,2/1/2024,ARE,Kedah,5,4,1,United Arab Emirates
82103,2/1/2024,ARE,Selangor,378,237,141,United Arab Emirates
82104,2/1/2024,ARG,Johor,92,46,46,Argentina
82105,2/1/2024,ARG,Kedah,98,47,51,Argentina
82106,2/1/2024,ARG,Perak,1,1,0,Argentina
82107,2/1/2024,ARG,Perlis,4,4,0,Argentina
82108,2/1/2024,ARG,Pulau Pinang,6,4,2,Argentina
82109,2/1/2024,ARG,Sabah,4,2,2,Argentina
82110,2/1/2024,ARG,Selangor,576,294,282,Argentina
82111,2/1/2024,ARG,Terengganu,1,1,0,Argentina
82112,2/1/2024,ARM,Johor,1,0,1,Armenia
82113,2/1/2024,ARM,Kedah,5,4,1,Armenia
82114,2/1/2024,ARM,Pulau Pinang,3,0,3,Armenia
82115,2/1/2024,ARM,Sabah,1,0,1,Armenia
82116,2/1/2024,ARM,Selangor,166,61,105,Armenia
82117,2/1/2024,ATG,Johor,4,2,2,Antigua and Barbuda
82118,2/1/2024,ATG,Pulau Pinang,1,1,0,Antigua and Barbuda
82119,2/1/2024,ATG,Selangor,20,13,7,Antigua and Barbuda
82120,2/1/2024,AUS,Johor,4763,2792,1971,Australia
82121,2/1/2024,AUS,Kedah,613,336,277,Australia
82122,2/1/2024,AUS,Kelantan,8,6,2,Australia
82123,2/1/2024,AUS,Melaka,2,2,0,Australia
82124,2/1/2024,AUS,Negeri Sembilan,2,1,1,Australia
82125,2/1/2024,AUS,Pahang,14,9,5,Australia
82126,2/1/2024,AUS,Perak,274,148,126,Australia
82127,2/1/2024,AUS,Perlis,127,78,49,Australia
82128,2/1/2024,AUS,Pulau Pinang,1851,1000,851,Australia
82129,2/1/2024,AUS,Sabah,370,194,176,Australia
82130,2/1/2024,AUS,Sarawak,603,359,244,Australia
82131,2/1/2024,AUS,Selangor,21486,12654,8832,Australia
82132,2/1/2024,AUS,Terengganu,3,1,2,Australia
82133,2/1/2024,AUS,W.P. Labuan,12,5,7,Australia
82134,2/1/2024,AUT,Johor,261,175,86,Austria
82135,2/1/2024,AUT,Kedah,282,156,126,Austria
82136,2/1/2024,AUT,Kelantan,4,3,1,Austria
82137,2/1/2024,AUT,Perak,5,3,2,Austria
82138,2/1/2024,AUT,Perlis,26,16,10,Austria
82139,2/1/2024,AUT,Pulau Pinang,122,79,43,Austria
82140,2/1/2024,AUT,Sabah,29,19,10,Austria
82141,2/1/2024,AUT,Sarawak,33,20,13,Austria
82142,2/1/2024,AUT,Selangor,1402,800,602,Austria
82143,2/1/2024,AUT,W.P. Labuan,2,1,1,Austria
82144,2/1/2024,AZE,Johor,13,8,5,Azerbaijan
82145,2/1/2024,AZE,Kedah,5,2,3,Azerbaijan
82146,2/1/2024,AZE,Kelantan,1,1,0,Azerbaijan
82147,2/1/2024,AZE,Sabah,1,1,0,Azerbaijan
82148,2/1/2024,AZE,Sarawak,3,1,2,Azerbaijan
82149,2/1/2024,AZE,Selangor,118,65,53,Azerbaijan
82150,2/1/2024,BDI,Selangor,4,0,4,Burundi
82151,2/1/2024,BEL,Johor,209,128,81,Belgium
82152,2/1/2024,BEL,Kedah,186,93,93,Belgium
82153,2/1/2024,BEL,Kelantan,2,1,1,Belgium
82154,2/1/2024,BEL,Melaka,1,1,0,Belgium
82155,2/1/2024,BEL,Pahang,2,0,2,Belgium
82156,2/1/2024,BEL,Perak,1,1,0,Belgium
82157,2/1/2024,BEL,Perlis,17,15,2,Belgium
82158,2/1/2024,BEL,Pulau Pinang,92,60,32,Belgium
82159,2/1/2024,BEL,Sabah,34,19,15,Belgium
82160,2/1/2024,BEL,Sarawak,26,15,11,Belgium
82161,2/1/2024,BEL,Selangor,1553,945,608,Belgium
82162,2/1/2024,BEL,Terengganu,1,1,0,Belgium
82163,2/1/2024,BEL,W.P. Labuan,5,2,3,Belgium
82164,2/1/2024,BEN,Selangor,10,9,1,Benin
82165,2/1/2024,BFA,Johor,2,1,1,Burkina Faso
82166,2/1/2024,BFA,Selangor,7,5,2,Burkina Faso
82167,2/1/2024,BGD,Johor,4241,3702,539,Bangladesh
82168,2/1/2024,BGD,Kedah,130,78,52,Bangladesh
82169,2/1/2024,BGD,Kelantan,4,4,0,Bangladesh
82170,2/1/2024,BGD,Pahang,3,1,2,Bangladesh
82171,2/1/2024,BGD,Perak,6,4,2,Bangladesh
82172,2/1/2024,BGD,Perlis,3,3,0,Bangladesh
82173,2/1/2024,BGD,Pulau Pinang,83,76,7,Bangladesh
82174,2/1/2024,BGD,Sabah,4,3,1,Bangladesh
82175,2/1/2024,BGD,Sarawak,111,76,35,Bangladesh
82176,2/1/2024,BGD,Selangor,27189,25198,1991,Bangladesh
82177,2/1/2024,BGD,Terengganu,1,1,0,Bangladesh
82178,2/1/2024,BGD,W.P. Labuan,18,18,0,Bangladesh
82179,2/1/2024,BGR,Johor,85,43,42,Bulgaria
82180,2/1/2024,BGR,Kedah,17,8,9,Bulgaria
82181,2/1/2024,BGR,Kelantan,1,1,0,Bulgaria
82182,2/1/2024,BGR,Perak,1,1,0,Bulgaria
82183,2/1/2024,BGR,Perlis,1,1,0,Bulgaria
82184,2/1/2024,BGR,Pulau Pinang,17,12,5,Bulgaria
82185,2/1/2024,BGR,Sabah,2,1,1,Bulgaria
82186,2/1/2024,BGR,Sarawak,2,2,0,Bulgaria
82187,2/1/2024,BGR,Selangor,474,223,251,Bulgaria
82188,2/1/2024,BHR,Johor,9,6,3,Bahrain
82189,2/1/2024,BHR,Kedah,2,2,0,Bahrain
82190,2/1/2024,BHR,Pulau Pinang,2,2,0,Bahrain
82191,2/1/2024,BHR,Selangor,140,76,64,Bahrain
82192,2/1/2024,BHS,Johor,2,2,0,Bahamas
82193,2/1/2024,BHS,Pulau Pinang,1,0,1,Bahamas
82194,2/1/2024,BHS,Selangor,8,2,6,Bahamas
82195,2/1/2024,BIH,Johor,8,5,3,Bosnia and Herzegovina
82196,2/1/2024,BIH,Kedah,2,1,1,Bosnia and Herzegovina
82197,2/1/2024,BIH,Pulau Pinang,1,1,0,Bosnia and Herzegovina
82198,2/1/2024,BIH,Sabah,1,1,0,Bosnia and Herzegovina
82199,2/1/2024,BIH,Sarawak,2,2,0,Bosnia and Herzegovina
82200,2/1/2024,BIH,Selangor,76,49,27,Bosnia and Herzegovina
82201,2/1/2024,BLR,Johor,19,9,10,Belarus
82202,2/1/2024,BLR,Kedah,66,29,37,Belarus
82203,2/1/2024,BLR,Kelantan,2,1,1,Belarus
82204,2/1/2024,BLR,Perak,1,1,0,Belarus
82205,2/1/2024,BLR,Pulau Pinang,14,8,6,Belarus
82206,2/1/2024,BLR,Sabah,5,2,3,Belarus
82207,2/1/2024,BLR,Sarawak,1,1,0,Belarus
82208,2/1/2024,BLR,Selangor,592,282,310,Belarus
82209,2/1/2024,BLZ,Johor,3,2,1,Belize
82210,2/1/2024,BLZ,Selangor,11,3,8,Belize
82211,2/1/2024,BOL,Pulau Pinang,2,2,0,Bolivia
82212,2/1/2024,BOL,Selangor,15,8,7,Bolivia
82213,2/1/2024,BRA,Johor,365,208,157,Brazil
82214,2/1/2024,BRA,Kedah,98,49,49,Brazil
82215,2/1/2024,BRA,Perak,5,3,2,Brazil
82216,2/1/2024,BRA,Perlis,10,3,7,Brazil
82217,2/1/2024,BRA,Pulau Pinang,48,22,26,Brazil
82218,2/1/2024,BRA,Sabah,13,6,7,Brazil
82219,2/1/2024,BRA,Sarawak,7,4,3,Brazil
82220,2/1/2024,BRA,Selangor,929,530,399,Brazil
82221,2/1/2024,BRB,Johor,2,2,0,Barbados
82222,2/1/2024,BRB,Pulau Pinang,3,0,3,Barbados
82223,2/1/2024,BRB,Selangor,8,2,6,Barbados
82224,2/1/2024,BRN,Johor,389,206,183,Brunei Darussalam
82225,2/1/2024,BRN,Kedah,32,12,20,Brunei Darussalam
82226,2/1/2024,BRN,Kelantan,6,2,4,Brunei Darussalam
82227,2/1/2024,BRN,Perak,7,3,4,Brunei Darussalam
82228,2/1/2024,BRN,Perlis,47,20,27,Brunei Darussalam
82229,2/1/2024,BRN,Pulau Pinang,20,10,10,Brunei Darussalam
82230,2/1/2024,BRN,Sabah,1109,460,649,Brunei Darussalam
82231,2/1/2024,BRN,Sarawak,131382,70633,60749,Brunei Darussalam
82232,2/1/2024,BRN,Selangor,5785,2764,3021,Brunei Darussalam
82233,2/1/2024,BRN,W.P. Labuan,1729,1058,671,Brunei Darussalam
82234,2/1/2024,BTN,Johor,3,3,0,Bhutan
82235,2/1/2024,BTN,Kedah,1,1,0,Bhutan
82236,2/1/2024,BTN,Perlis,3,1,2,Bhutan
82237,2/1/2024,BTN,Pulau Pinang,1,1,0,Bhutan
82238,2/1/2024,BTN,Sarawak,3,3,0,Bhutan
82239,2/1/2024,BTN,Selangor,74,38,36,Bhutan
82240,2/1/2024,BWA,Johor,1,1,0,Botswana
82241,2/1/2024,BWA,Selangor,16,7,9,Botswana
82242,2/1/2024,CAN,Johor,1764,958,806,Canada
82243,2/1/2024,CAN,Kedah,418,217,201,Canada
82244,2/1/2024,CAN,Kelantan,12,8,4,Canada
82245,2/1/2024,CAN,Negeri Sembilan,7,5,2,Canada
82246,2/1/2024,CAN,Pahang,2,2,0,Canada
82247,2/1/2024,CAN,Perak,33,18,15,Canada
82248,2/1/2024,CAN,Perlis,83,48,35,Canada
82249,2/1/2024,CAN,Pulau Pinang,642,358,284,Canada
82250,2/1/2024,CAN,Sabah,257,118,139,Canada
82251,2/1/2024,CAN,Sarawak,368,190,178,Canada
82252,2/1/2024,CAN,Selangor,6300,3539,2761,Canada
82253,2/1/2024,CAN,W.P. Labuan,11,9,2,Canada
82254,2/1/2024,CHE,Johor,491,285,206,Switzerland
82255,2/1/2024,CHE,Kedah,316,169,147,Switzerland
82256,2/1/2024,CHE,Kelantan,1,0,1,Switzerland
82257,2/1/2024,CHE,Negeri Sembilan,1,1,0,Switzerland
82258,2/1/2024,CHE,Pahang,1,1,0,Switzerland
82259,2/1/2024,CHE,Perak,19,13,6,Switzerland
82260,2/1/2024,CHE,Perlis,26,18,8,Switzerland
82261,2/1/2024,CHE,Pulau Pinang,178,104,74,Switzerland
82262,2/1/2024,CHE,Sabah,47,25,22,Switzerland
82263,2/1/2024,CHE,Sarawak,40,18,22,Switzerland
82264,2/1/2024,CHE,Selangor,1798,1037,761,Switzerland
82265,2/1/2024,CHE,W.P. Labuan,1,1,0,Switzerland
82266,2/1/2024,CHL,Johor,65,37,28,Chile
82267,2/1/2024,CHL,Kedah,28,11,17,Chile
82268,2/1/2024,CHL,Kelantan,1,1,0,Chile
82269,2/1/2024,CHL,Perlis,5,4,1,Chile
82270,2/1/2024,CHL,Pulau Pinang,11,5,6,Chile
82271,2/1/2024,CHL,Sabah,6,3,3,Chile
82272,2/1/2024,CHL,Sarawak,2,2,0,Chile
82273,2/1/2024,CHL,Selangor,501,232,269,Chile
82274,2/1/2024,CHN,Johor,78786,34787,43999,China
82275,2/1/2024,CHN,Kedah,6529,2856,3673,China
82276,2/1/2024,CHN,Kelantan,56,32,24,China
82277,2/1/2024,CHN,Melaka,8,4,4,China
82278,2/1/2024,CHN,Pahang,58,36,22,China
82279,2/1/2024,CHN,Perak,288,122,166,China
82280,2/1/2024,CHN,Perlis,620,336,284,China
82281,2/1/2024,CHN,Pulau Pinang,13500,6614,6886,China
82282,2/1/2024,CHN,Sabah,34953,15397,19556,China
82283,2/1/2024,CHN,Sarawak,1919,885,1034,China
82284,2/1/2024,CHN,Selangor,205226,97688,107538,China
82285,2/1/2024,CHN,W.P. Labuan,60,46,14,China
82286,2/1/2024,CIV,Selangor,34,24,10,C��te d'Iv
82287,2/1/2024,CMR,Kedah,3,1,2,Cameroon
82288,2/1/2024,CMR,Pulau Pinang,3,1,2,Cameroon
82289,2/1/2024,CMR,Selangor,18,15,3,Cameroon
82290,2/1/2024,COD,Johor,2,2,0,"Congo, the Democratic Republic of the"
82291,2/1/2024,COD,Selangor,17,13,4,"Congo, the Democratic Republic of the"
82292,2/1/2024,COG,Selangor,6,5,1,Congo
82293,2/1/2024,COL,Johor,29,17,12,Colombia
82294,2/1/2024,COL,Kedah,5,0,5,Colombia
82295,2/1/2024,COL,Perak,1,1,0,Colombia
82296,2/1/2024,COL,Pulau Pinang,5,4,1,Colombia
82297,2/1/2024,COL,Sabah,4,2,2,Colombia
82298,2/1/2024,COL,Selangor,160,89,71,Colombia
82299,2/1/2024,COM,Johor,1,1,0,Comoros
82300,2/1/2024,COM,Selangor,11,10,1,Comoros
82301,2/1/2024,CPV,Johor,1,0,1,Cape Verde
82302,2/1/2024,CPV,Selangor,6,4,2,Cape Verde
82303,2/1/2024,CRI,Johor,10,6,4,Costa Rica
82304,2/1/2024,CRI,Kedah,1,0,1,Costa Rica
82305,2/1/2024,CRI,Pulau Pinang,7,2,5,Costa Rica
82306,2/1/2024,CRI,Sabah,3,2,1,Costa Rica
82307,2/1/2024,CRI,Selangor,69,40,29,Costa Rica
82308,2/1/2024,CUB,Johor,6,4,2,Cuba
82309,2/1/2024,CUB,Pulau Pinang,1,1,0,Cuba
82310,2/1/2024,CUB,Sabah,1,1,0,Cuba
82311,2/1/2024,CUB,Selangor,24,8,16,Cuba
82312,2/1/2024,CYP,Johor,4,3,1,Cyprus
82313,2/1/2024,CYP,Pulau Pinang,1,1,0,Cyprus
82314,2/1/2024,CYP,Selangor,90,57,33,Cyprus
82315,2/1/2024,CZE,Johor,201,90,111,Czech Republic
82316,2/1/2024,CZE,Kedah,326,153,173,Czech Republic
82317,2/1/2024,CZE,Perlis,18,9,9,Czech Republic
82318,2/1/2024,CZE,Pulau Pinang,62,31,31,Czech Republic
82319,2/1/2024,CZE,Sabah,22,12,10,Czech Republic
82320,2/1/2024,CZE,Sarawak,18,12,6,Czech Republic
82321,2/1/2024,CZE,Selangor,1244,692,552,Czech Republic
82322,2/1/2024,DEU,Johor,2768,1641,1127,Germany
82323,2/1/2024,DEU,Kedah,3358,1657,1701,Germany
82324,2/1/2024,DEU,Kelantan,19,14,5,Germany
82325,2/1/2024,DEU,Melaka,3,2,1,Germany
82326,2/1/2024,DEU,Negeri Sembilan,3,2,1,Germany
82327,2/1/2024,DEU,Pahang,9,6,3,Germany
82328,2/1/2024,DEU,Perak,30,21,9,Germany
82329,2/1/2024,DEU,Perlis,229,140,89,Germany
82330,2/1/2024,DEU,Pulau Pinang,889,605,284,Germany
82331,2/1/2024,DEU,Sabah,139,92,47,Germany
82332,2/1/2024,DEU,Sarawak,270,145,125,Germany
82333,2/1/2024,DEU,Selangor,15593,8534,7059,Germany
82334,2/1/2024,DEU,W.P. Labuan,16,11,5,Germany
82335,2/1/2024,DJI,Kedah,2,1,1,Djibouti
82336,2/1/2024,DJI,Selangor,6,2,4,Djibouti
82337,2/1/2024,DMA,Johor,3,2,1,Dominica
82338,2/1/2024,DMA,Pulau Pinang,4,4,0,Dominica
82339,2/1/2024,DMA,Sarawak,1,0,1,Dominica
82340,2/1/2024,DMA,Selangor,45,34,11,Dominica
82341,2/1/2024,DNK,Johor,354,230,124,Denmark
82342,2/1/2024,DNK,Kedah,427,194,233,Denmark
82343,2/1/2024,DNK,Kelantan,7,7,0,Denmark
82344,2/1/2024,DNK,Perak,6,4,2,Denmark
82345,2/1/2024,DNK,Perlis,16,9,7,Denmark
82346,2/1/2024,DNK,Pulau Pinang,106,65,41,Denmark
82347,2/1/2024,DNK,Sabah,38,19,19,Denmark
82348,2/1/2024,DNK,Sarawak,20,11,9,Denmark
82349,2/1/2024,DNK,Selangor,1627,917,710,Denmark
82350,2/1/2024,DNK,W.P. Labuan,3,1,2,Denmark
82351,2/1/2024,DOM,Johor,2,0,2,Dominican Republic
82352,2/1/2024,DOM,Sabah,1,0,1,Dominican Republic
82353,2/1/2024,DOM,Selangor,15,10,5,Dominican Republic
82354,2/1/2024,DZA,Johor,37,30,7,Algeria
82355,2/1/2024,DZA,Kedah,9,7,2,Algeria
82356,2/1/2024,DZA,Kelantan,1,1,0,Algeria
82357,2/1/2024,DZA,Perlis,1,0,1,Algeria
82358,2/1/2024,DZA,Pulau Pinang,1,1,0,Algeria
82359,2/1/2024,DZA,Sabah,2,1,1,Algeria
82360,2/1/2024,DZA,Sarawak,3,3,0,Algeria
82361,2/1/2024,DZA,Selangor,811,522,289,Algeria
82362,2/1/2024,ECU,Johor,10,5,5,Ecuador
82363,2/1/2024,ECU,Pulau Pinang,1,0,1,Ecuador
82364,2/1/2024,ECU,Selangor,75,42,33,Ecuador
82365,2/1/2024,EGY,Johor,167,142,25,Egypt
82366,2/1/2024,EGY,Kedah,23,14,9,Egypt
82367,2/1/2024,EGY,Kelantan,2,0,2,Egypt
82368,2/1/2024,EGY,Perlis,1,1,0,Egypt
82369,2/1/2024,EGY,Pulau Pinang,20,12,8,Egypt
82370,2/1/2024,EGY,Sabah,5,4,1,Egypt
82371,2/1/2024,EGY,Sarawak,139,78,61,Egypt
82372,2/1/2024,EGY,Selangor,2355,1499,856,Egypt
82373,2/1/2024,ERI,Selangor,22,12,10,Eritrea
82374,2/1/2024,ESP,Johor,547,340,207,Spain
82375,2/1/2024,ESP,Kedah,279,140,139,Spain
82376,2/1/2024,ESP,Kelantan,3,2,1,Spain
82377,2/1/2024,ESP,Melaka,1,1,0,Spain
82378,2/1/2024,ESP,Perak,2,1,1,Spain
82379,2/1/2024,ESP,Perlis,31,18,13,Spain
82380,2/1/2024,ESP,Pulau Pinang,170,99,71,Spain
82381,2/1/2024,ESP,Sabah,81,50,31,Spain
82382,2/1/2024,ESP,Sarawak,59,39,20,Spain
82383,2/1/2024,ESP,Selangor,2441,1420,1021,Spain
82384,2/1/2024,ESP,W.P. Labuan,5,3,2,Spain
82385,2/1/2024,EST,Johor,91,47,44,Estonia
82386,2/1/2024,EST,Kedah,158,77,81,Estonia
82387,2/1/2024,EST,Perlis,2,1,1,Estonia
82388,2/1/2024,EST,Pulau Pinang,34,17,17,Estonia
82389,2/1/2024,EST,Sabah,6,2,4,Estonia
82390,2/1/2024,EST,Selangor,525,247,278,Estonia
82391,2/1/2024,ETH,Johor,6,4,2,Ethiopia
82392,2/1/2024,ETH,Pulau Pinang,1,1,0,Ethiopia
82393,2/1/2024,ETH,Selangor,51,43,8,Ethiopia
82394,2/1/2024,FIN,Johor,324,181,143,Finland
82395,2/1/2024,FIN,Kedah,291,125,166,Finland
82396,2/1/2024,FIN,Kelantan,1,0,1,Finland
82397,2/1/2024,FIN,Perak,6,3,3,Finland
82398,2/1/2024,FIN,Perlis,25,15,10,Finland
82399,2/1/2024,FIN,Pulau Pinang,63,36,27,Finland
82400,2/1/2024,FIN,Sabah,35,17,18,Finland
82401,2/1/2024,FIN,Sarawak,8,4,4,Finland
82402,2/1/2024,FIN,Selangor,936,513,423,Finland
82403,2/1/2024,FJI,Johor,43,24,19,Fiji
82404,2/1/2024,FJI,Kedah,2,1,1,Fiji
82405,2/1/2024,FJI,Pulau Pinang,2,0,2,Fiji
82406,2/1/2024,FJI,Selangor,69,34,35,Fiji
82407,2/1/2024,FJI,Terengganu,1,1,0,Fiji
82408,2/1/2024,FRA,Johor,2574,1459,1115,France
82409,2/1/2024,FRA,Kedah,1729,889,840,France
82410,2/1/2024,FRA,Kelantan,28,17,11,France
82411,2/1/2024,FRA,Melaka,8,5,3,France
82412,2/1/2024,FRA,Pahang,18,7,11,France
82413,2/1/2024,FRA,Perak,26,18,8,France
82414,2/1/2024,FRA,Perlis,145,89,56,France
82415,2/1/2024,FRA,Pulau Pinang,527,307,220,France
82416,2/1/2024,FRA,Sabah,207,111,96,France
82417,2/1/2024,FRA,Sarawak,96,68,28,France
82418,2/1/2024,FRA,Selangor,12007,6802,5205,France
82419,2/1/2024,FRA,W.P. Labuan,5,5,0,France
82420,2/1/2024,FSM,Johor,1,0,1,"Micronesia, Federated States of"
82421,2/1/2024,GAB,Sabah,1,0,1,Gabon
82422,2/1/2024,GAB,Selangor,12,9,3,Gabon
82423,2/1/2024,GBR,Johor,5087,3143,1944,United Kingdom
82424,2/1/2024,GBR,Kedah,3642,1813,1829,United Kingdom
82425,2/1/2024,GBR,Kelantan,29,16,13,United Kingdom
82426,2/1/2024,GBR,Melaka,10,5,5,United Kingdom
82427,2/1/2024,GBR,Negeri Sembilan,1,1,0,United Kingdom
82428,2/1/2024,GBR,Pahang,18,13,5,United Kingdom
82429,2/1/2024,GBR,Perak,137,85,52,United Kingdom
82430,2/1/2024,GBR,Perlis,268,170,98,United Kingdom
82431,2/1/2024,GBR,Pulau Pinang,2040,1194,846,United Kingdom
82432,2/1/2024,GBR,Sabah,553,301,252,United Kingdom
82433,2/1/2024,GBR,Sarawak,1250,748,502,United Kingdom
82434,2/1/2024,GBR,Selangor,26155,15188,10967,United Kingdom
82435,2/1/2024,GBR,W.P. Labuan,116,73,43,United Kingdom
82436,2/1/2024,GEO,Johor,4,3,1,Georgia
82437,2/1/2024,GEO,Kedah,7,3,4,Georgia
82438,2/1/2024,GEO,Pulau Pinang,1,1,0,Georgia
82439,2/1/2024,GEO,Sabah,2,0,2,Georgia
82440,2/1/2024,GEO,Selangor,73,37,36,Georgia
82441,2/1/2024,GHA,Johor,7,6,1,Ghana
82442,2/1/2024,GHA,Pulau Pinang,1,1,0,Ghana
82443,2/1/2024,GHA,Sabah,2,1,1,Ghana
82444,2/1/2024,GHA,Selangor,86,60,26,Ghana
82445,2/1/2024,GIN,Johor,7,4,3,Guinea
82446,2/1/2024,GIN,Selangor,71,52,19,Guinea
82447,2/1/2024,GMB,Johor,3,2,1,Gambia
82448,2/1/2024,GMB,Sabah,1,1,0,Gambia
82449,2/1/2024,GMB,Selangor,24,16,8,Gambia
82450,2/1/2024,GNQ,Selangor,2,1,1,Equatorial Guinea
82451,2/1/2024,GRC,Johor,55,35,20,Greece
82452,2/1/2024,GRC,Kedah,38,19,19,Greece
82453,2/1/2024,GRC,Perak,2,2,0,Greece
82454,2/1/2024,GRC,Perlis,5,4,1,Greece
82455,2/1/2024,GRC,Pulau Pinang,19,8,11,Greece
82456,2/1/2024,GRC,Sabah,8,5,3,Greece
82457,2/1/2024,GRC,Sarawak,4,1,3,Greece
82458,2/1/2024,GRC,Selangor,331,212,119,Greece
82459,2/1/2024,GRD,Johor,7,4,3,Grenada
82460,2/1/2024,GRD,Pulau Pinang,1,1,0,Grenada
82461,2/1/2024,GRD,Selangor,3,2,1,Grenada
82462,2/1/2024,GRL,Johor,1,0,1,Greenland
82463,2/1/2024,GTM,Johor,9,7,2,Guatemala
82464,2/1/2024,GTM,Pulau Pinang,2,0,2,Guatemala
82465,2/1/2024,GTM,Selangor,18,11,7,Guatemala
82466,2/1/2024,GUY,Johor,4,3,1,Guyana
82467,2/1/2024,GUY,Sabah,1,1,0,Guyana
82468,2/1/2024,GUY,Selangor,8,4,4,Guyana
82469,2/1/2024,HKG,Johor,17,11,6,Hong Kong
82470,2/1/2024,HKG,Pahang,1,0,1,Hong Kong
82471,2/1/2024,HKG,Perak,20,12,8,Hong Kong
82472,2/1/2024,HKG,Pulau Pinang,2,2,0,Hong Kong
82473,2/1/2024,HKG,Sabah,1141,504,637,Hong Kong
82474,2/1/2024,HKG,Selangor,380,188,192,Hong Kong
82475,2/1/2024,HND,Johor,6,4,2,Honduras
82476,2/1/2024,HND,Sabah,2,0,2,Honduras
82477,2/1/2024,HND,Selangor,17,8,9,Honduras
82478,2/1/2024,HRV,Johor,29,22,7,Croatia
82479,2/1/2024,HRV,Kedah,9,7,2,Croatia
82480,2/1/2024,HRV,Perlis,2,1,1,Croatia
82481,2/1/2024,HRV,Pulau Pinang,7,5,2,Croatia
82482,2/1/2024,HRV,Sabah,6,4,2,Croatia
82483,2/1/2024,HRV,Selangor,257,139,118,Croatia
82484,2/1/2024,HTI,Sabah,1,1,0,Haiti
82485,2/1/2024,HTI,Selangor,8,7,1,Haiti
82486,2/1/2024,HUN,Johor,142,82,60,Hungary
82487,2/1/2024,HUN,Kedah,157,77,80,Hungary
82488,2/1/2024,HUN,Kelantan,1,1,0,Hungary
82489,2/1/2024,HUN,Perak,1,1,0,Hungary
82490,2/1/2024,HUN,Perlis,18,10,8,Hungary
82491,2/1/2024,HUN,Pulau Pinang,49,22,27,Hungary
82492,2/1/2024,HUN,Sabah,40,19,21,Hungary
82493,2/1/2024,HUN,Sarawak,55,25,30,Hungary
82494,2/1/2024,HUN,Selangor,1051,581,470,Hungary
82495,2/1/2024,HUN,W.P. Labuan,1,0,1,Hungary
82496,2/1/2024,IDN,Johor,94247,42469,51778,Indonesia
82497,2/1/2024,IDN,Kedah,6860,2604,4256,Indonesia
82498,2/1/2024,IDN,Kelantan,180,101,79,Indonesia
82499,2/1/2024,IDN,Melaka,3199,1425,1774,Indonesia
82500,2/1/2024,IDN,Negeri Sembilan,4386,2547,1839,Indonesia
82501,2/1/2024,IDN,Pahang,17,4,13,Indonesia
82502,2/1/2024,IDN,Perak,242,63,179,Indonesia
82503,2/1/2024,IDN,Perlis,806,248,558,Indonesia
82504,2/1/2024,IDN,Pulau Pinang,35586,14042,21544,Indonesia
82505,2/1/2024,IDN,Sabah,4787,2293,2494,Indonesia
82506,2/1/2024,IDN,Sarawak,40468,20489,19979,Indonesia
82507,2/1/2024,IDN,Selangor,142789,65413,77376,Indonesia
82508,2/1/2024,IDN,Terengganu,1,1,0,Indonesia
82509,2/1/2024,IDN,W.P. Labuan,57,27,30,Indonesia
82510,2/1/2024,IND,Johor,30844,22017,8827,India
82511,2/1/2024,IND,Kedah,1229,747,482,India
82512,2/1/2024,IND,Kelantan,14,10,4,India
82513,2/1/2024,IND,Melaka,2,2,0,India
82514,2/1/2024,IND,Negeri Sembilan,2,2,0,India
82515,2/1/2024,IND,Pahang,5,3,2,India
82516,2/1/2024,IND,Perak,190,140,50,India
82517,2/1/2024,IND,Perlis,93,76,17,India
82518,2/1/2024,IND,Pulau Pinang,964,683,281,India
82519,2/1/2024,IND,Sabah,186,123,63,India
82520,2/1/2024,IND,Sarawak,2755,2150,605,India
82521,2/1/2024,IND,Selangor,53318,36675,16643,India
82522,2/1/2024,IND,Terengganu,2,1,1,India
82523,2/1/2024,IND,W.P. Labuan,141,101,40,India
82524,2/1/2024,IOT,Selangor,1,0,1,British Indian Ocean Territory
82525,2/1/2024,IRL,Johor,287,173,114,Ireland
82526,2/1/2024,IRL,Kedah,127,66,61,Ireland
82527,2/1/2024,IRL,Kelantan,1,1,0,Ireland
82528,2/1/2024,IRL,Perak,9,3,6,Ireland
82529,2/1/2024,IRL,Perlis,19,12,7,Ireland
82530,2/1/2024,IRL,Pulau Pinang,163,111,52,Ireland
82531,2/1/2024,IRL,Sabah,27,16,11,Ireland
82532,2/1/2024,IRL,Sarawak,36,17,19,Ireland
82533,2/1/2024,IRL,Selangor,1532,894,638,Ireland
82534,2/1/2024,IRL,W.P. Labuan,6,5,1,Ireland
82535,2/1/2024,IRN,Johor,362,164,198,Iran
82536,2/1/2024,IRN,Kedah,6,2,4,Iran
82537,2/1/2024,IRN,Kelantan,4,3,1,Iran
82538,2/1/2024,IRN,Pulau Pinang,10,6,4,Iran
82539,2/1/2024,IRN,Sabah,5,2,3,Iran
82540,2/1/2024,IRN,Sarawak,1,1,0,Iran
82541,2/1/2024,IRN,Selangor,1754,896,858,Iran
82542,2/1/2024,IRQ,Johor,45,25,20,Iraq
82543,2/1/2024,IRQ,Kelantan,2,1,1,Iraq
82544,2/1/2024,IRQ,Perlis,2,2,0,Iraq
82545,2/1/2024,IRQ,Pulau Pinang,2,1,1,Iraq
82546,2/1/2024,IRQ,Sarawak,10,6,4,Iraq
82547,2/1/2024,IRQ,Selangor,1755,1117,638,Iraq
82548,2/1/2024,ISL,Johor,2,2,0,Iceland
82549,2/1/2024,ISL,Kedah,6,4,2,Iceland
82550,2/1/2024,ISL,Pulau Pinang,3,2,1,Iceland
82551,2/1/2024,ISL,Sabah,3,2,1,Iceland
82552,2/1/2024,ISL,Selangor,41,22,19,Iceland
82553,2/1/2024,ISR,Selangor,1,1,0,Israel
82554,2/1/2024,ITA,Johor,580,373,207,Italy
82555,2/1/2024,ITA,Kedah,838,450,388,Italy
82556,2/1/2024,ITA,Kelantan,4,3,1,Italy
82557,2/1/2024,ITA,Melaka,3,2,1,Italy
82558,2/1/2024,ITA,Negeri Sembilan,1,1,0,Italy
82559,2/1/2024,ITA,Pahang,2,2,0,Italy
82560,2/1/2024,ITA,Perak,5,5,0,Italy
82561,2/1/2024,ITA,Perlis,58,43,15,Italy
82562,2/1/2024,ITA,Pulau Pinang,149,107,42,Italy
82563,2/1/2024,ITA,Sabah,63,45,18,Italy
82564,2/1/2024,ITA,Sarawak,61,41,20,Italy
82565,2/1/2024,ITA,Selangor,3972,2480,1492,Italy
82566,2/1/2024,ITA,Terengganu,2,1,1,Italy
82567,2/1/2024,ITA,W.P. Labuan,3,2,1,Italy
82568,2/1/2024,JAM,Johor,10,3,7,Jamaica
82569,2/1/2024,JAM,Kedah,1,1,0,Jamaica
82570,2/1/2024,JAM,Pulau Pinang,2,0,2,Jamaica
82571,2/1/2024,JAM,Sabah,1,0,1,Jamaica
82572,2/1/2024,JAM,Selangor,50,18,32,Jamaica
82573,2/1/2024,JOR,Johor,29,23,6,Jordan
82574,2/1/2024,JOR,Kedah,12,6,6,Jordan
82575,2/1/2024,JOR,Perak,1,0,1,Jordan
82576,2/1/2024,JOR,Pulau Pinang,10,5,5,Jordan
82577,2/1/2024,JOR,Sabah,2,2,0,Jordan
82578,2/1/2024,JOR,Selangor,761,475,286,Jordan
82579,2/1/2024,JPN,Johor,5913,3749,2164,Japan
82580,2/1/2024,JPN,Kedah,509,259,250,Japan
82581,2/1/2024,JPN,Kelantan,17,12,5,Japan
82582,2/1/2024,JPN,Pahang,8,4,4,Japan
82583,2/1/2024,JPN,Perak,64,37,27,Japan
82584,2/1/2024,JPN,Perlis,166,123,43,Japan
82585,2/1/2024,JPN,Pulau Pinang,1607,1020,587,Japan
82586,2/1/2024,JPN,Sabah,632,328,304,Japan
82587,2/1/2024,JPN,Sarawak,210,129,81,Japan
82588,2/1/2024,JPN,Selangor,22366,13330,9036,Japan
82589,2/1/2024,JPN,Terengganu,3,3,0,Japan
82590,2/1/2024,JPN,W.P. Labuan,23,12,11,Japan
82591,2/1/2024,KAZ,Johor,53,17,36,Kazakhstan
82592,2/1/2024,KAZ,Kedah,32,11,21,Kazakhstan
82593,2/1/2024,KAZ,Kelantan,1,1,0,Kazakhstan
82594,2/1/2024,KAZ,Perlis,6,4,2,Kazakhstan
82595,2/1/2024,KAZ,Pulau Pinang,14,7,7,Kazakhstan
82596,2/1/2024,KAZ,Sabah,5,3,2,Kazakhstan
82597,2/1/2024,KAZ,Sarawak,15,10,5,Kazakhstan
82598,2/1/2024,KAZ,Selangor,1524,654,870,Kazakhstan
82599,2/1/2024,KAZ,W.P. Labuan,1,1,0,Kazakhstan
82600,2/1/2024,KEN,Johor,28,14,14,Kenya
82601,2/1/2024,KEN,Kedah,4,4,0,Kenya
82602,2/1/2024,KEN,Perlis,2,0,2,Kenya
82603,2/1/2024,KEN,Pulau Pinang,24,9,15,Kenya
82604,2/1/2024,KEN,Sabah,6,2,4,Kenya
82605,2/1/2024,KEN,Sarawak,3,2,1,Kenya
82606,2/1/2024,KEN,Selangor,343,202,141,Kenya
82607,2/1/2024,KGZ,Johor,40,27,13,Kyrgyzstan
82608,2/1/2024,KGZ,Kedah,4,3,1,Kyrgyzstan
82609,2/1/2024,KGZ,Pulau Pinang,3,0,3,Kyrgyzstan
82610,2/1/2024,KGZ,Sabah,2,1,1,Kyrgyzstan
82611,2/1/2024,KGZ,Selangor,374,176,198,Kyrgyzstan
82612,2/1/2024,KHM,Johor,1442,614,828,Cambodia
82613,2/1/2024,KHM,Kedah,299,235,64,Cambodia
82614,2/1/2024,KHM,Kelantan,1379,1223,156,Cambodia
82615,2/1/2024,KHM,Perak,7,6,1,Cambodia
82616,2/1/2024,KHM,Perlis,1021,753,268,Cambodia
82617,2/1/2024,KHM,Pulau Pinang,30,5,25,Cambodia
82618,2/1/2024,KHM,Sabah,2,0,2,Cambodia
82619,2/1/2024,KHM,Sarawak,4,1,3,Cambodia
82620,2/1/2024,KHM,Selangor,3187,1500,1687,Cambodia
82621,2/1/2024,KIR,Johor,5,2,3,Kiribati
82622,2/1/2024,KNA,Johor,18,11,7,Saint Kitts and Nevis
82623,2/1/2024,KNA,Kedah,4,2,2,Saint Kitts and Nevis
82624,2/1/2024,KNA,Pulau Pinang,1,1,0,Saint Kitts and Nevis
82625,2/1/2024,KNA,Sarawak,1,1,0,Saint Kitts and Nevis
82626,2/1/2024,KNA,Selangor,62,43,19,Saint Kitts and Nevis
82627,2/1/2024,KOR,Johor,14699,7432,7267,"Korea, Republic of (South Korea)"
82628,2/1/2024,KOR,Kedah,412,178,234,"Korea, Republic of (South Korea)"
82629,2/1/2024,KOR,Kelantan,7,5,2,"Korea, Republic of (South Korea)"
82630,2/1/2024,KOR,Melaka,2,1,1,"Korea, Republic of (South Korea)"
82631,2/1/2024,KOR,Negeri Sembilan,1,0,1,"Korea, Republic of (South Korea)"
82632,2/1/2024,KOR,Pahang,2,0,2,"Korea, Republic of (South Korea)"
82633,2/1/2024,KOR,Perak,31,11,20,"Korea, Republic of (South Korea)"
82634,2/1/2024,KOR,Perlis,62,49,13,"Korea, Republic of (South Korea)"
82635,2/1/2024,KOR,Pulau Pinang,614,341,273,"Korea, Republic of (South Korea)"
82636,2/1/2024,KOR,Sabah,16079,6940,9139,"Korea, Republic of (South Korea)"
82637,2/1/2024,KOR,Sarawak,305,164,141,"Korea, Republic of (South Korea)"
82638,2/1/2024,KOR,Selangor,18849,10064,8785,"Korea, Republic of (South Korea)"
82639,2/1/2024,KOR,W.P. Labuan,23,18,5,"Korea, Republic of (South Korea)"
82640,2/1/2024,KWT,Johor,6,2,4,Kuwait
82641,2/1/2024,KWT,Kedah,4,2,2,Kuwait
82642,2/1/2024,KWT,Kelantan,1,1,0,Kuwait
82643,2/1/2024,KWT,Perlis,1,1,0,Kuwait
82644,2/1/2024,KWT,Pulau Pinang,4,2,2,Kuwait
82645,2/1/2024,KWT,Sarawak,1,1,0,Kuwait
82646,2/1/2024,KWT,Selangor,393,253,140,Kuwait
82647,2/1/2024,KWT,W.P. Labuan,1,1,0,Kuwait
82648,2/1/2024,LAO,Johor,133,28,105,Lao People's Democratic Republic
82649,2/1/2024,LAO,Kedah,1228,96,1132,Lao People's Democratic Republic
82650,2/1/2024,LAO,Kelantan,1075,971,104,Lao People's Democratic Republic
82651,2/1/2024,LAO,Perak,37,1,36,Lao People's Democratic Republic
82652,2/1/2024,LAO,Perlis,522,83,439,Lao People's Democratic Republic
82653,2/1/2024,LAO,Pulau Pinang,18,2,16,Lao People's Democratic Republic
82654,2/1/2024,LAO,Sarawak,16,7,9,Lao People's Democratic Republic
82655,2/1/2024,LAO,Selangor,259,98,161,Lao People's Democratic Republic
82656,2/1/2024,LBN,Johor,27,21,6,Lebanon
82657,2/1/2024,LBN,Kedah,7,3,4,Lebanon
82658,2/1/2024,LBN,Pulau Pinang,4,3,1,Lebanon
82659,2/1/2024,LBN,Sabah,4,4,0,Lebanon
82660,2/1/2024,LBN,Sarawak,7,7,0,Lebanon
82661,2/1/2024,LBN,Selangor,324,203,121,Lebanon
82662,2/1/2024,LBR,Selangor,6,5,1,Liberia
82663,2/1/2024,LBY,Johor,9,6,3,Libyan Arab Jamahiriya
82664,2/1/2024,LBY,Kedah,3,3,0,Libyan Arab Jamahiriya
82665,2/1/2024,LBY,Pulau Pinang,1,1,0,Libyan Arab Jamahiriya
82666,2/1/2024,LBY,Selangor,264,190,74,Libyan Arab Jamahiriya
82667,2/1/2024,LCA,Johor,2,2,0,Saint Lucia
82668,2/1/2024,LCA,Pulau Pinang,1,1,0,Saint Lucia
82669,2/1/2024,LCA,Selangor,16,11,5,Saint Lucia
82670,2/1/2024,LIE,Johor,2,1,1,Liechtenstein
82671,2/1/2024,LIE,Selangor,2,2,0,Liechtenstein
82672,2/1/2024,LKA,Johor,688,442,246,Sri Lanka
82673,2/1/2024,LKA,Kedah,16,14,2,Sri Lanka
82674,2/1/2024,LKA,Melaka,1,1,0,Sri Lanka
82675,2/1/2024,LKA,Perak,5,3,2,Sri Lanka
82676,2/1/2024,LKA,Perlis,1,1,0,Sri Lanka
82677,2/1/2024,LKA,Pulau Pinang,31,20,11,Sri Lanka
82678,2/1/2024,LKA,Sabah,5,3,2,Sri Lanka
82679,2/1/2024,LKA,Sarawak,24,15,9,Sri Lanka
82680,2/1/2024,LKA,Selangor,3784,2425,1359,Sri Lanka
82681,2/1/2024,LSO,Selangor,7,4,3,Lesotho
82682,2/1/2024,LTU,Johor,123,55,68,Lithuania
82683,2/1/2024,LTU,Kedah,194,90,104,Lithuania
82684,2/1/2024,LTU,Kelantan,1,1,0,Lithuania
82685,2/1/2024,LTU,Perlis,14,6,8,Lithuania
82686,2/1/2024,LTU,Pulau Pinang,35,14,21,Lithuania
82687,2/1/2024,LTU,Sabah,19,10,9,Lithuania
82688,2/1/2024,LTU,Sarawak,10,4,6,Lithuania
82689,2/1/2024,LTU,Selangor,1510,697,813,Lithuania
82690,2/1/2024,LTU,W.P. Labuan,31,11,20,Lithuania
82691,2/1/2024,LUX,Johor,19,13,6,Luxembourg
82692,2/1/2024,LUX,Kedah,9,5,4,Luxembourg
82693,2/1/2024,LUX,Pulau Pinang,4,4,0,Luxembourg
82694,2/1/2024,LUX,Sabah,5,2,3,Luxembourg
82695,2/1/2024,LUX,Sarawak,3,2,1,Luxembourg
82696,2/1/2024,LUX,Selangor,56,31,25,Luxembourg
82697,2/1/2024,LVA,Johor,60,25,35,Latvia
82698,2/1/2024,LVA,Kedah,62,25,37,Latvia
82699,2/1/2024,LVA,Perlis,2,1,1,Latvia
82700,2/1/2024,LVA,Pulau Pinang,6,3,3,Latvia
82701,2/1/2024,LVA,Sabah,36,7,29,Latvia
82702,2/1/2024,LVA,Sarawak,53,19,34,Latvia
82703,2/1/2024,LVA,Selangor,346,172,174,Latvia
82704,2/1/2024,MAC,Johor,1,0,1,Macao
82705,2/1/2024,MAC,Perak,2,2,0,Macao
82706,2/1/2024,MAC,Selangor,18,7,11,Macao
82707,2/1/2024,MAR,Johor,69,42,27,Morocco
82708,2/1/2024,MAR,Kedah,17,10,7,Morocco
82709,2/1/2024,MAR,Kelantan,1,1,0,Morocco
82710,2/1/2024,MAR,Perlis,1,1,0,Morocco
82711,2/1/2024,MAR,Pulau Pinang,11,7,4,Morocco
82712,2/1/2024,MAR,Sabah,2,2,0,Morocco
82713,2/1/2024,MAR,Sarawak,9,6,3,Morocco
82714,2/1/2024,MAR,Selangor,1079,615,464,Morocco
82715,2/1/2024,MCO,Pulau Pinang,1,1,0,Monaco
82716,2/1/2024,MCO,Selangor,7,4,3,Monaco
82717,2/1/2024,MDA,Johor,5,2,3,"Moldova, Republic of"
82718,2/1/2024,MDA,Kedah,5,1,4,"Moldova, Republic of"
82719,2/1/2024,MDA,Sarawak,2,0,2,"Moldova, Republic of"
82720,2/1/2024,MDA,Selangor,37,15,22,"Moldova, Republic of"
82721,2/1/2024,MDG,Johor,14,6,8,Madagascar
82722,2/1/2024,MDG,Kedah,1,1,0,Madagascar
82723,2/1/2024,MDG,Selangor,48,24,24,Madagascar
82724,2/1/2024,MDV,Johor,153,70,83,Maldives
82725,2/1/2024,MDV,Kedah,2,2,0,Maldives
82726,2/1/2024,MDV,Sabah,1,1,0,Maldives
82727,2/1/2024,MDV,Sarawak,5,1,4,Maldives
82728,2/1/2024,MDV,Selangor,2466,1338,1128,Maldives
82729,2/1/2024,MEX,Johor,153,76,77,Mexico
82730,2/1/2024,MEX,Kedah,8,2,6,Mexico
82731,2/1/2024,MEX,Kelantan,1,0,1,Mexico
82732,2/1/2024,MEX,Perlis,2,1,1,Mexico
82733,2/1/2024,MEX,Pulau Pinang,24,23,1,Mexico
82734,2/1/2024,MEX,Sabah,11,6,5,Mexico
82735,2/1/2024,MEX,Sarawak,4,3,1,Mexico
82736,2/1/2024,MEX,Selangor,650,319,331,Mexico
82737,2/1/2024,MHL,Johor,1,1,0,Marshall Islands
82738,2/1/2024,MHL,Selangor,7,6,1,Marshall Islands
82739,2/1/2024,MKD,Johor,9,6,3,"Macedonia, the former Yugoslav Republic of"
82740,2/1/2024,MKD,Kedah,7,4,3,"Macedonia, the former Yugoslav Republic of"
82741,2/1/2024,MKD,Selangor,61,25,36,"Macedonia, the former Yugoslav Republic of"
82742,2/1/2024,MLI,Selangor,22,16,6,Mali
82743,2/1/2024,MLT,Johor,3,1,2,Malta
82744,2/1/2024,MLT,Kedah,2,1,1,Malta
82745,2/1/2024,MLT,Perlis,1,1,0,Malta
82746,2/1/2024,MLT,Selangor,51,31,20,Malta
82747,2/1/2024,MMR,Johor,6855,2155,4700,Myanmar
82748,2/1/2024,MMR,Kedah,107,24,83,Myanmar
82749,2/1/2024,MMR,Kelantan,4,2,2,Myanmar
82750,2/1/2024,MMR,Melaka,1,0,1,Myanmar
82751,2/1/2024,MMR,Negeri Sembilan,1,1,0,Myanmar
82752,2/1/2024,MMR,Pahang,3,2,1,Myanmar
82753,2/1/2024,MMR,Perak,32,5,27,Myanmar
82754,2/1/2024,MMR,Perlis,14,1,13,Myanmar
82755,2/1/2024,MMR,Pulau Pinang,379,184,195,Myanmar
82756,2/1/2024,MMR,Sabah,26,5,21,Myanmar
82757,2/1/2024,MMR,Sarawak,107,44,63,Myanmar
82758,2/1/2024,MMR,Selangor,5438,3506,1932,Myanmar
82759,2/1/2024,MMR,W.P. Labuan,7,1,6,Myanmar
82760,2/1/2024,MNE,Pulau Pinang,1,1,0,Montenegro
82761,2/1/2024,MNE,Selangor,19,14,5,Montenegro
82762,2/1/2024,MNG,Johor,282,118,164,Mongolia
82763,2/1/2024,MNG,Kedah,6,3,3,Mongolia
82764,2/1/2024,MNG,Perak,1,0,1,Mongolia
82765,2/1/2024,MNG,Perlis,2,0,2,Mongolia
82766,2/1/2024,MNG,Pulau Pinang,3,1,2,Mongolia
82767,2/1/2024,MNG,Sabah,5,0,5,Mongolia
82768,2/1/2024,MNG,Selangor,407,179,228,Mongolia
82769,2/1/2024,MOZ,Selangor,23,9,14,Mozambique
82770,2/1/2024,MRT,Johor,3,2,1,Mauritania
82771,2/1/2024,MRT,Sabah,1,1,0,Mauritania
82772,2/1/2024,MRT,Selangor,28,19,9,Mauritania
82773,2/1/2024,MUS,Johor,115,59,56,Mauritius
82774,2/1/2024,MUS,Kedah,5,4,1,Mauritius
82775,2/1/2024,MUS,Kelantan,3,2,1,Mauritius
82776,2/1/2024,MUS,Pulau Pinang,3,1,2,Mauritius
82777,2/1/2024,MUS,Sarawak,3,1,2,Mauritius
82778,2/1/2024,MUS,Selangor,1476,732,744,Mauritius
82779,2/1/2024,MWI,Pulau Pinang,1,0,1,Malawi
82780,2/1/2024,MWI,Sabah,1,1,0,Malawi
82781,2/1/2024,MWI,Sarawak,1,0,1,Malawi
82782,2/1/2024,MWI,Selangor,18,9,9,Malawi
82783,2/1/2024,NAM,Selangor,12,7,5,Namibia
82784,2/1/2024,NCL,Selangor,1,1,0,New Caledonia
82785,2/1/2024,NER,Johor,4,4,0,Niger
82786,2/1/2024,NER,Selangor,3,3,0,Niger
82787,2/1/2024,NGA,Johor,23,19,4,Nigeria
82788,2/1/2024,NGA,Kedah,2,2,0,Nigeria
82789,2/1/2024,NGA,Kelantan,3,2,1,Nigeria
82790,2/1/2024,NGA,Pulau Pinang,4,3,1,Nigeria
82791,2/1/2024,NGA,Sabah,1,1,0,Nigeria
82792,2/1/2024,NGA,Sarawak,18,14,4,Nigeria
82793,2/1/2024,NGA,Selangor,363,294,69,Nigeria
82794,2/1/2024,NIC,Johor,2,1,1,Nicaragua
82795,2/1/2024,NIC,Selangor,11,4,7,Nicaragua
82796,2/1/2024,NLD,Johor,1028,687,341,Netherlands
82797,2/1/2024,NLD,Kedah,548,297,251,Netherlands
82798,2/1/2024,NLD,Kelantan,9,6,3,Netherlands
82799,2/1/2024,NLD,Melaka,1,1,0,Netherlands
82800,2/1/2024,NLD,Negeri Sembilan,1,1,0,Netherlands
82801,2/1/2024,NLD,Perak,17,10,7,Netherlands
82802,2/1/2024,NLD,Perlis,70,46,24,Netherlands
82803,2/1/2024,NLD,Pulau Pinang,329,206,123,Netherlands
82804,2/1/2024,NLD,Sabah,76,43,33,Netherlands
82805,2/1/2024,NLD,Sarawak,139,86,53,Netherlands
82806,2/1/2024,NLD,Selangor,4942,2834,2108,Netherlands
82807,2/1/2024,NLD,W.P. Labuan,10,7,3,Netherlands
82808,2/1/2024,NOR,Johor,199,117,82,Norway
82809,2/1/2024,NOR,Kedah,193,77,116,Norway
82810,2/1/2024,NOR,Perak,2,0,2,Norway
82811,2/1/2024,NOR,Perlis,23,11,12,Norway
82812,2/1/2024,NOR,Pulau Pinang,62,34,28,Norway
82813,2/1/2024,NOR,Sabah,8,6,2,Norway
82814,2/1/2024,NOR,Sarawak,17,13,4,Norway
82815,2/1/2024,NOR,Selangor,1112,608,504,Norway
82816,2/1/2024,NOR,W.P. Labuan,1,1,0,Norway
82817,2/1/2024,NPL,Johor,1336,1028,308,Nepal
82818,2/1/2024,NPL,Kedah,16,14,2,Nepal
82819,2/1/2024,NPL,Kelantan,1,1,0,Nepal
82820,2/1/2024,NPL,Perlis,2,2,0,Nepal
82821,2/1/2024,NPL,Pulau Pinang,44,41,3,Nepal
82822,2/1/2024,NPL,Sabah,1,1,0,Nepal
82823,2/1/2024,NPL,Sarawak,196,134,62,Nepal
82824,2/1/2024,NPL,Selangor,7542,6998,544,Nepal
82825,2/1/2024,NPL,W.P. Labuan,91,77,14,Nepal
82826,2/1/2024,NRU,Selangor,1,1,0,Nauru
82827,2/1/2024,NZL,Johor,809,468,341,New Zealand
82828,2/1/2024,NZL,Kedah,79,46,33,New Zealand
82829,2/1/2024,NZL,Kelantan,4,3,1,New Zealand
82830,2/1/2024,NZL,Melaka,2,1,1,New Zealand
82831,2/1/2024,NZL,Perak,17,10,7,New Zealand
82832,2/1/2024,NZL,Perlis,17,9,8,New Zealand
82833,2/1/2024,NZL,Pulau Pinang,184,101,83,New Zealand
82834,2/1/2024,NZL,Sabah,75,44,31,New Zealand
82835,2/1/2024,NZL,Sarawak,110,62,48,New Zealand
82836,2/1/2024,NZL,Selangor,2534,1536,998,New Zealand
82837,2/1/2024,NZL,Terengganu,2,1,1,New Zealand
82838,2/1/2024,NZL,W.P. Labuan,6,3,3,New Zealand
82839,2/1/2024,OMN,Johor,30,20,10,Oman
82840,2/1/2024,OMN,Kedah,9,7,2,Oman
82841,2/1/2024,OMN,Perak,2,1,1,Oman
82842,2/1/2024,OMN,Perlis,7,5,2,Oman
82843,2/1/2024,OMN,Sarawak,16,9,7,Oman
82844,2/1/2024,OMN,Selangor,1168,709,459,Oman
82845,2/1/2024,PAK,Johor,721,558,163,Pakistan
82846,2/1/2024,PAK,Kedah,122,101,21,Pakistan
82847,2/1/2024,PAK,Kelantan,25,24,1,Pakistan
82848,2/1/2024,PAK,Perak,3,1,2,Pakistan
82849,2/1/2024,PAK,Perlis,25,22,3,Pakistan
82850,2/1/2024,PAK,Pulau Pinang,107,101,6,Pakistan
82851,2/1/2024,PAK,Sabah,18,15,3,Pakistan
82852,2/1/2024,PAK,Sarawak,116,90,26,Pakistan
82853,2/1/2024,PAK,Selangor,10478,8760,1718,Pakistan
82854,2/1/2024,PAK,W.P. Labuan,4,3,1,Pakistan
82855,2/1/2024,PAN,Johor,8,5,3,Panama
82856,2/1/2024,PAN,Kedah,2,1,1,Panama
82857,2/1/2024,PAN,Pulau Pinang,3,2,1,Panama
82858,2/1/2024,PAN,Selangor,45,15,30,Panama
82859,2/1/2024,PER,Johor,42,22,20,Peru
82860,2/1/2024,PER,Kedah,3,3,0,Peru
82861,2/1/2024,PER,Perlis,4,3,1,Peru
82862,2/1/2024,PER,Pulau Pinang,3,2,1,Peru
82863,2/1/2024,PER,Sarawak,3,1,2,Peru
82864,2/1/2024,PER,Selangor,139,65,74,Peru
82865,2/1/2024,PHL,Johor,20285,5943,14342,Philippines
82866,2/1/2024,PHL,Kedah,448,122,326,Philippines
82867,2/1/2024,PHL,Kelantan,16,7,9,Philippines
82868,2/1/2024,PHL,Melaka,1,0,1,Philippines
82869,2/1/2024,PHL,Negeri Sembilan,2,2,0,Philippines
82870,2/1/2024,PHL,Pahang,19,16,3,Philippines
82871,2/1/2024,PHL,Perak,49,10,39,Philippines
82872,2/1/2024,PHL,Perlis,283,86,197,Philippines
82873,2/1/2024,PHL,Pulau Pinang,633,242,391,Philippines
82874,2/1/2024,PHL,Sabah,1445,584,861,Philippines
82875,2/1/2024,PHL,Sarawak,3229,1334,1895,Philippines
82876,2/1/2024,PHL,Selangor,14564,5668,8896,Philippines
82877,2/1/2024,PHL,Terengganu,2,0,2,Philippines
82878,2/1/2024,PHL,W.P. Labuan,111,47,64,Philippines
82879,2/1/2024,PNG,Johor,17,5,12,Papua New Guinea
82880,2/1/2024,PNG,Perak,1,1,0,Papua New Guinea
82881,2/1/2024,PNG,Pulau Pinang,1,1,0,Papua New Guinea
82882,2/1/2024,PNG,Sarawak,10,5,5,Papua New Guinea
82883,2/1/2024,PNG,Selangor,88,51,37,Papua New Guinea
82884,2/1/2024,POL,Johor,943,486,457,Poland
82885,2/1/2024,POL,Kedah,601,299,302,Poland
82886,2/1/2024,POL,Kelantan,11,6,5,Poland
82887,2/1/2024,POL,Melaka,1,1,0,Poland
82888,2/1/2024,POL,Perak,1,0,1,Poland
82889,2/1/2024,POL,Perlis,49,28,21,Poland
82890,2/1/2024,POL,Pulau Pinang,110,56,54,Poland
82891,2/1/2024,POL,Sabah,110,49,61,Poland
82892,2/1/2024,POL,Sarawak,47,27,20,Poland
82893,2/1/2024,POL,Selangor,2980,1499,1481,Poland
82894,2/1/2024,POL,W.P. Labuan,3,3,0,Poland
82895,2/1/2024,PRT,Johor,281,152,129,Portugal
82896,2/1/2024,PRT,Kedah,124,63,61,Portugal
82897,2/1/2024,PRT,Kelantan,1,1,0,Portugal
82898,2/1/2024,PRT,Perak,1,1,0,Portugal
82899,2/1/2024,PRT,Perlis,6,3,3,Portugal
82900,2/1/2024,PRT,Pulau Pinang,55,29,26,Portugal
82901,2/1/2024,PRT,Sabah,20,11,9,Portugal
82902,2/1/2024,PRT,Sarawak,9,6,3,Portugal
82903,2/1/2024,PRT,Selangor,811,435,376,Portugal
82904,2/1/2024,PRY,Johor,5,1,4,Paraguay
82905,2/1/2024,PRY,Perlis,1,0,1,Paraguay
82906,2/1/2024,PRY,Pulau Pinang,2,1,1,Paraguay
82907,2/1/2024,PRY,Selangor,12,5,7,Paraguay
82908,2/1/2024,PSE,Johor,14,14,0,"Palestinian Territory, Occupied"
82909,2/1/2024,PSE,Kedah,2,1,1,"Palestinian Territory, Occupied"
82910,2/1/2024,PSE,Sarawak,2,2,0,"Palestinian Territory, Occupied"
82911,2/1/2024,PSE,Selangor,272,193,79,"Palestinian Territory, Occupied"
82912,2/1/2024,QAT,Johor,5,5,0,Qatar
82913,2/1/2024,QAT,Kedah,1,1,0,Qatar
82914,2/1/2024,QAT,Selangor,150,121,29,Qatar
82915,2/1/2024,ROU,Johor,145,94,51,Romania
82916,2/1/2024,ROU,Kedah,92,42,50,Romania
82917,2/1/2024,ROU,Perak,1,0,1,Romania
82918,2/1/2024,ROU,Perlis,4,3,1,Romania
82919,2/1/2024,ROU,Pulau Pinang,36,19,17,Romania
82920,2/1/2024,ROU,Sabah,16,13,3,Romania
82921,2/1/2024,ROU,Sarawak,10,8,2,Romania
82922,2/1/2024,ROU,Selangor,1226,603,623,Romania
82923,2/1/2024,RUS,Johor,409,201,208,Russia
82924,2/1/2024,RUS,Kedah,690,329,361,Russia
82925,2/1/2024,RUS,Kelantan,29,11,18,Russia
82926,2/1/2024,RUS,Melaka,1,1,0,Russia
82927,2/1/2024,RUS,Perak,3,1,2,Russia
82928,2/1/2024,RUS,Perlis,114,64,50,Russia
82929,2/1/2024,RUS,Pulau Pinang,204,101,103,Russia
82930,2/1/2024,RUS,Sabah,76,40,36,Russia
82931,2/1/2024,RUS,Sarawak,75,40,35,Russia
82932,2/1/2024,RUS,Selangor,12209,5796,6413,Russia
82933,2/1/2024,RUS,W.P. Labuan,5,3,2,Russia
82934,2/1/2024,RWA,Selangor,6,3,3,Rwanda
82935,2/1/2024,SAU,Johor,202,124,78,Saudi Arabia
82936,2/1/2024,SAU,Kedah,57,32,25,Saudi Arabia
82937,2/1/2024,SAU,Kelantan,3,2,1,Saudi Arabia
82938,2/1/2024,SAU,Perlis,8,4,4,Saudi Arabia
82939,2/1/2024,SAU,Pulau Pinang,37,23,14,Saudi Arabia
82940,2/1/2024,SAU,Sarawak,24,14,10,Saudi Arabia
82941,2/1/2024,SAU,Selangor,4286,2428,1858,Saudi Arabia
82942,2/1/2024,SDN,Johor,11,5,6,Sudan
82943,2/1/2024,SDN,Kedah,6,3,3,Sudan
82944,2/1/2024,SDN,Pulau Pinang,12,4,8,Sudan
82945,2/1/2024,SDN,Sabah,2,2,0,Sudan
82946,2/1/2024,SDN,Sarawak,1,1,0,Sudan
82947,2/1/2024,SDN,Selangor,1077,607,470,Sudan
82948,2/1/2024,SDN,W.P. Labuan,1,1,0,Sudan
82949,2/1/2024,SEN,Johor,6,5,1,Senegal
82950,2/1/2024,SEN,Sabah,1,1,0,Senegal
82951,2/1/2024,SEN,Selangor,73,51,22,Senegal
82952,2/1/2024,SGP,Johor,1069298,614417,454881,Singapore
82953,2/1/2024,SGP,Kedah,3712,2013,1699,Singapore
82954,2/1/2024,SGP,Kelantan,155,80,75,Singapore
82955,2/1/2024,SGP,Melaka,25,14,11,Singapore
82956,2/1/2024,SGP,Negeri Sembilan,1,1,0,Singapore
82957,2/1/2024,SGP,Pahang,511,250,261,Singapore
82958,2/1/2024,SGP,Perak,5490,2694,2796,Singapore
82959,2/1/2024,SGP,Perlis,266,166,100,Singapore
82960,2/1/2024,SGP,Pulau Pinang,15992,8254,7738,Singapore
82961,2/1/2024,SGP,Sabah,2383,1215,1168,Singapore
82962,2/1/2024,SGP,Sarawak,4161,2212,1949,Singapore
82963,2/1/2024,SGP,Selangor,44117,23037,21080,Singapore
82964,2/1/2024,SGP,W.P. Labuan,14,10,4,Singapore
82965,2/1/2024,SLB,Johor,3,2,1,Solomon Islands
82966,2/1/2024,SLB,Pulau Pinang,1,0,1,Solomon Islands
82967,2/1/2024,SLB,Sarawak,6,1,5,Solomon Islands
82968,2/1/2024,SLB,Selangor,10,6,4,Solomon Islands
82969,2/1/2024,SLE,Johor,4,3,1,Sierra Leone
82970,2/1/2024,SLE,Kedah,1,1,0,Sierra Leone
82971,2/1/2024,SLE,Selangor,15,13,2,Sierra Leone
82972,2/1/2024,SLV,Johor,8,5,3,El Salvador
82973,2/1/2024,SLV,Sarawak,1,1,0,El Salvador
82974,2/1/2024,SLV,Selangor,12,9,3,El Salvador
82975,2/1/2024,SMR,Selangor,6,4,2,San Marino
82976,2/1/2024,SOM,Johor,3,3,0,Somalia
82977,2/1/2024,SOM,Kelantan,1,1,0,Somalia
82978,2/1/2024,SOM,Selangor,265,145,120,Somalia
82979,2/1/2024,SRB,Johor,13,9,4,Serbia
82980,2/1/2024,SRB,Kedah,10,4,6,Serbia
82981,2/1/2024,SRB,Perlis,1,0,1,Serbia
82982,2/1/2024,SRB,Pulau Pinang,14,13,1,Serbia
82983,2/1/2024,SRB,Sabah,2,1,1,Serbia
82984,2/1/2024,SRB,Selangor,181,87,94,Serbia
82985,2/1/2024,SUR,Pulau Pinang,1,1,0,Suriname
82986,2/1/2024,SUR,Selangor,13,7,6,Suriname
82987,2/1/2024,SVK,Johor,51,33,18,Slovakia
82988,2/1/2024,SVK,Kedah,185,92,93,Slovakia
82989,2/1/2024,SVK,Pahang,1,0,1,Slovakia
82990,2/1/2024,SVK,Perlis,2,1,1,Slovakia
82991,2/1/2024,SVK,Pulau Pinang,28,20,8,Slovakia
82992,2/1/2024,SVK,Sabah,12,5,7,Slovakia
82993,2/1/2024,SVK,Sarawak,4,2,2,Slovakia
82994,2/1/2024,SVK,Selangor,641,350,291,Slovakia
82995,2/1/2024,SVK,W.P. Labuan,1,1,0,Slovakia
82996,2/1/2024,SVN,Johor,26,15,11,Slovenia
82997,2/1/2024,SVN,Kedah,75,40,35,Slovenia
82998,2/1/2024,SVN,Perlis,1,1,0,Slovenia
82999,2/1/2024,SVN,Pulau Pinang,7,5,2,Slovenia
83000,2/1/2024,SVN,Sabah,3,1,2,Slovenia
83001,2/1/2024,SVN,Selangor,387,215,172,Slovenia
83002,2/1/2024,SWE,Johor,336,184,152,Sweden
83003,2/1/2024,SWE,Kedah,539,235,304,Sweden
83004,2/1/2024,SWE,Kelantan,12,10,2,Sweden
83005,2/1/2024,SWE,Melaka,1,0,1,Sweden
83006,2/1/2024,SWE,Perak,4,2,2,Sweden
83007,2/1/2024,SWE,Perlis,28,19,9,Sweden
83008,2/1/2024,SWE,Pulau Pinang,110,67,43,Sweden
83009,2/1/2024,SWE,Sabah,46,30,16,Sweden
83010,2/1/2024,SWE,Sarawak,8,7,1,Sweden
83011,2/1/2024,SWE,Selangor,1928,1050,878,Sweden
83012,2/1/2024,SWZ,Johor,3,1,2,Swaziland
83013,2/1/2024,SWZ,Selangor,13,5,8,Swaziland
83014,2/1/2024,SYC,Johor,13,2,11,Seychelles
83015,2/1/2024,SYC,Selangor,88,32,56,Seychelles
83016,2/1/2024,SYR,Johor,22,14,8,Syrian Arab Republic
83017,2/1/2024,SYR,Kedah,8,5,3,Syrian Arab Republic
83018,2/1/2024,SYR,Pulau Pinang,15,12,3,Syrian Arab Republic
83019,2/1/2024,SYR,Sabah,1,1,0,Syrian Arab Republic
83020,2/1/2024,SYR,Sarawak,1,1,0,Syrian Arab Republic
83021,2/1/2024,SYR,Selangor,737,472,265,Syrian Arab Republic
83022,2/1/2024,TCA,Selangor,1,0,1,Turks and Caicos
83023,2/1/2024,TCD,Johor,5,4,1,Chad
83024,2/1/2024,TCD,Selangor,30,23,7,Chad
83025,2/1/2024,TGO,Selangor,5,2,3,Togo
83026,2/1/2024,THA,Johor,6228,1632,4596,Thailand
83027,2/1/2024,THA,Kedah,63910,37844,26066,Thailand
83028,2/1/2024,THA,Kelantan,52876,26261,26615,Thailand
83029,2/1/2024,THA,Pahang,2,0,2,Thailand
83030,2/1/2024,THA,Perak,11982,5506,6476,Thailand
83031,2/1/2024,THA,Perlis,52916,30639,22277,Thailand
83032,2/1/2024,THA,Pulau Pinang,2123,735,1388,Thailand
83033,2/1/2024,THA,Sabah,58,16,42,Thailand
83034,2/1/2024,THA,Sarawak,479,148,331,Thailand
83035,2/1/2024,THA,Selangor,12217,4642,7575,Thailand
83036,2/1/2024,THA,W.P. Labuan,8,4,4,Thailand
83037,2/1/2024,TJK,Johor,2,1,1,Tajikistan
83038,2/1/2024,TJK,Kedah,4,2,2,Tajikistan
83039,2/1/2024,TJK,Pulau Pinang,1,1,0,Tajikistan
83040,2/1/2024,TJK,Sabah,5,3,2,Tajikistan
83041,2/1/2024,TJK,Selangor,218,149,69,Tajikistan
83042,2/1/2024,TKM,Johor,5,5,0,Turkmenistan
83043,2/1/2024,TKM,Kedah,1,0,1,Turkmenistan
83044,2/1/2024,TKM,Sarawak,1,1,0,Turkmenistan
83045,2/1/2024,TKM,Selangor,541,322,219,Turkmenistan
83046,2/1/2024,TLS,Johor,13,6,7,Timor-Leste
83047,2/1/2024,TLS,Pulau Pinang,5,3,2,Timor-Leste
83048,2/1/2024,TLS,Sarawak,1,0,1,Timor-Leste
83049,2/1/2024,TLS,Selangor,186,110,76,Timor-Leste
83050,2/1/2024,TON,Johor,1,1,0,Tonga
83051,2/1/2024,TON,Pulau Pinang,1,1,0,Tonga
83052,2/1/2024,TON,Sabah,1,0,1,Tonga
83053,2/1/2024,TON,Selangor,18,14,4,Tonga
83054,2/1/2024,TTO,Johor,2,1,1,Trinidad and Tobago
83055,2/1/2024,TTO,Kedah,3,0,3,Trinidad and Tobago
83056,2/1/2024,TTO,Pulau Pinang,3,1,2,Trinidad and Tobago
83057,2/1/2024,TTO,Selangor,46,28,18,Trinidad and Tobago
83058,2/1/2024,TUN,Johor,12,7,5,Tunisia
83059,2/1/2024,TUN,Kedah,9,8,1,Tunisia
83060,2/1/2024,TUN,Melaka,2,0,2,Tunisia
83061,2/1/2024,TUN,Pulau Pinang,13,8,5,Tunisia
83062,2/1/2024,TUN,Sabah,1,1,0,Tunisia
83063,2/1/2024,TUN,Sarawak,1,1,0,Tunisia
83064,2/1/2024,TUN,Selangor,723,380,343,Tunisia
83065,2/1/2024,TUR,Johor,349,235,114,Turkey
83066,2/1/2024,TUR,Kedah,70,44,26,Turkey
83067,2/1/2024,TUR,Kelantan,5,3,2,Turkey
83068,2/1/2024,TUR,Pahang,2,2,0,Turkey
83069,2/1/2024,TUR,Perak,1,1,0,Turkey
83070,2/1/2024,TUR,Perlis,27,21,6,Turkey
83071,2/1/2024,TUR,Pulau Pinang,34,26,8,Turkey
83072,2/1/2024,TUR,Sabah,8,6,2,Turkey
83073,2/1/2024,TUR,Sarawak,29,24,5,Turkey
83074,2/1/2024,TUR,Selangor,2033,1392,641,Turkey
83075,2/1/2024,TUR,Terengganu,1,1,0,Turkey
83076,2/1/2024,TWN,Johor,7987,3561,4426,Taiwan
83077,2/1/2024,TWN,Kedah,350,160,190,Taiwan
83078,2/1/2024,TWN,Kelantan,4,0,4,Taiwan
83079,2/1/2024,TWN,Melaka,5,2,3,Taiwan
83080,2/1/2024,TWN,Pahang,7,2,5,Taiwan
83081,2/1/2024,TWN,Perak,97,57,40,Taiwan
83082,2/1/2024,TWN,Perlis,50,22,28,Taiwan
83083,2/1/2024,TWN,Pulau Pinang,4226,2064,2162,Taiwan
83084,2/1/2024,TWN,Sabah,2958,1358,1600,Taiwan
83085,2/1/2024,TWN,Sarawak,512,198,314,Taiwan
83086,2/1/2024,TWN,Selangor,18869,9041,9828,Taiwan
83087,2/1/2024,TWN,W.P. Labuan,3,2,1,Taiwan
83088,2/1/2024,TZA,Johor,30,9,21,"Tanzania, United Republic of"
83089,2/1/2024,TZA,Kedah,1,0,1,"Tanzania, United Republic of"
83090,2/1/2024,TZA,Sabah,3,3,0,"Tanzania, United Republic of"
83091,2/1/2024,TZA,Sarawak,2,2,0,"Tanzania, United Republic of"
83092,2/1/2024,TZA,Selangor,201,104,97,"Tanzania, United Republic of"
83093,2/1/2024,UGA,Johor,22,11,11,Uganda
83094,2/1/2024,UGA,Pahang,1,0,1,Uganda
83095,2/1/2024,UGA,Perlis,1,1,0,Uganda
83096,2/1/2024,UGA,Pulau Pinang,1,0,1,Uganda
83097,2/1/2024,UGA,Sarawak,2,1,1,Uganda
83098,2/1/2024,UGA,Selangor,99,38,61,Uganda
83099,2/1/2024,UKR,Johor,124,52,72,Ukraine
83100,2/1/2024,UKR,Kedah,75,30,45,Ukraine
83101,2/1/2024,UKR,Kelantan,29,14,15,Ukraine
83102,2/1/2024,UKR,Pahang,3,3,0,Ukraine
83103,2/1/2024,UKR,Perlis,21,9,12,Ukraine
83104,2/1/2024,UKR,Pulau Pinang,50,20,30,Ukraine
83105,2/1/2024,UKR,Sabah,15,8,7,Ukraine
83106,2/1/2024,UKR,Sarawak,1,1,0,Ukraine
83107,2/1/2024,UKR,Selangor,1411,604,807,Ukraine
83108,2/1/2024,UKR,W.P. Labuan,1,0,1,Ukraine
83109,2/1/2024,URY,Johor,10,7,3,Uruguay
83110,2/1/2024,URY,Kedah,4,3,1,Uruguay
83111,2/1/2024,URY,Perlis,1,0,1,Uruguay
83112,2/1/2024,URY,Sarawak,1,0,1,Uruguay
83113,2/1/2024,URY,Selangor,43,23,20,Uruguay
83114,2/1/2024,USA,Johor,4880,2780,2100,United States Of America
83115,2/1/2024,USA,Kedah,712,397,315,United States Of America
83116,2/1/2024,USA,Kelantan,34,12,22,United States Of America
83117,2/1/2024,USA,Melaka,6,5,1,United States Of America
83118,2/1/2024,USA,Negeri Sembilan,2,2,0,United States Of America
83119,2/1/2024,USA,Pahang,4,4,0,United States Of America
83120,2/1/2024,USA,Perak,146,77,69,United States Of America
83121,2/1/2024,USA,Perlis,157,108,49,United States Of America
83122,2/1/2024,USA,Pulau Pinang,2250,1383,867,United States Of America
83123,2/1/2024,USA,Sabah,505,293,212,United States Of America
83124,2/1/2024,USA,Sarawak,333,161,172,United States Of America
83125,2/1/2024,USA,Selangor,16666,9622,7044,United States Of America
83126,2/1/2024,USA,Terengganu,3,1,2,United States Of America
83127,2/1/2024,USA,W.P. Labuan,12,6,6,United States Of America
83128,2/1/2024,UZB,Johor,68,52,16,Uzbekistan
83129,2/1/2024,UZB,Kedah,29,18,11,Uzbekistan
83130,2/1/2024,UZB,Perlis,1,0,1,Uzbekistan
83131,2/1/2024,UZB,Pulau Pinang,8,5,3,Uzbekistan
83132,2/1/2024,UZB,Sabah,4,3,1,Uzbekistan
83133,2/1/2024,UZB,Sarawak,1,0,1,Uzbekistan
83134,2/1/2024,UZB,Selangor,2049,1304,745,Uzbekistan
83135,2/1/2024,VAT,Selangor,1,1,0,Holy See (Vatican City State)
83136,2/1/2024,VCT,Pulau Pinang,1,1,0,Saint Vincent and the Grenadines
83137,2/1/2024,VCT,Selangor,1,1,0,Saint Vincent and the Grenadines
83138,2/1/2024,VEN,Johor,17,11,6,Venezuela
83139,2/1/2024,VEN,Kedah,2,1,1,Venezuela
83140,2/1/2024,VEN,Pulau Pinang,2,1,1,Venezuela
83141,2/1/2024,VEN,Sabah,2,0,2,Venezuela
83142,2/1/2024,VEN,Sarawak,2,1,1,Venezuela
83143,2/1/2024,VEN,Selangor,98,56,42,Venezuela
83144,2/1/2024,VNM,Johor,11772,3810,7962,Vietnam
83145,2/1/2024,VNM,Kedah,336,56,280,Vietnam
83146,2/1/2024,VNM,Kelantan,18,7,11,Vietnam
83147,2/1/2024,VNM,Pahang,1,0,1,Vietnam
83148,2/1/2024,VNM,Perak,215,8,207,Vietnam
83149,2/1/2024,VNM,Perlis,224,21,203,Vietnam
83150,2/1/2024,VNM,Pulau Pinang,1151,266,885,Vietnam
83151,2/1/2024,VNM,Sabah,25,12,13,Vietnam
83152,2/1/2024,VNM,Sarawak,367,76,291,Vietnam
83153,2/1/2024,VNM,Selangor,18917,6545,12372,Vietnam
83154,2/1/2024,VNM,W.P. Labuan,7,4,3,Vietnam
83155,2/1/2024,VUT,Johor,36,28,8,Vanuatu
83156,2/1/2024,VUT,Kedah,2,2,0,Vanuatu
83157,2/1/2024,VUT,Pulau Pinang,4,4,0,Vanuatu
83158,2/1/2024,VUT,Sabah,1,1,0,Vanuatu
83159,2/1/2024,VUT,Sarawak,1,1,0,Vanuatu
83160,2/1/2024,VUT,Selangor,106,92,14,Vanuatu
83161,2/1/2024,WSM,Selangor,2,1,1,Samoa
83162,2/1/2024,YEM,Johor,39,31,8,Yemen
83163,2/1/2024,YEM,Kedah,10,8,2,Yemen
83164,2/1/2024,YEM,Kelantan,1,1,0,Yemen
83165,2/1/2024,YEM,Melaka,5,3,2,Yemen
83166,2/1/2024,YEM,Pulau Pinang,12,8,4,Yemen
83167,2/1/2024,YEM,Sabah,4,3,1,Yemen
83168,2/1/2024,YEM,Sarawak,9,7,2,Yemen
83169,2/1/2024,YEM,Selangor,1339,952,387,Yemen
83170,2/1/2024,ZAF,Johor,221,140,81,South Africa
83171,2/1/2024,ZAF,Kedah,24,14,10,South Africa
83172,2/1/2024,ZAF,Kelantan,3,2,1,South Africa
83173,2/1/2024,ZAF,Perak,3,2,1,South Africa
83174,2/1/2024,ZAF,Perlis,16,10,6,South Africa
83175,2/1/2024,ZAF,Pulau Pinang,57,33,24,South Africa
83176,2/1/2024,ZAF,Sabah,23,11,12,South Africa
83177,2/1/2024,ZAF,Sarawak,134,62,72,South Africa
83178,2/1/2024,ZAF,Selangor,1010,571,439,South Africa
83179,2/1/2024,ZAF,Terengganu,1,1,0,South Africa
83180,2/1/2024,ZAF,W.P. Labuan,21,6,15,South Africa
83181,2/1/2024,ZMB,Johor,1,1,0,Zambia
83182,2/1/2024,ZMB,Selangor,42,13,29,Zambia
83183,2/1/2024,ZWE,Johor,21,2,19,Zimbabwe
83184,2/1/2024,ZWE,Kedah,3,2,1,Zimbabwe
83185,2/1/2024,ZWE,Pulau Pinang,9,4,5,Zimbabwe
83186,2/1/2024,ZWE,Selangor,153,77,76,Zimbabwe
83187,3/1/2024,AFG,Perlis,2,2,0,Afghanistan
83188,3/1/2024,AFG,Pulau Pinang,1,1,0,Afghanistan
83189,3/1/2024,AFG,Selangor,44,39,5,Afghanistan
83190,3/1/2024,AGO,Selangor,10,4,6,Angola
83191,3/1/2024,AIA,Selangor,1,0,1,Anguilla
83192,3/1/2024,ALB,Johor,12,8,4,Albania
83193,3/1/2024,ALB,Perak,1,1,0,Albania
83194,3/1/2024,ALB,Pulau Pinang,48,14,34,Albania
83195,3/1/2024,ALB,Sabah,1,1,0,Albania
83196,3/1/2024,ALB,Selangor,40,25,15,Albania
83197,3/1/2024,AND,Pulau Pinang,1,1,0,Andorra
83198,3/1/2024,AND,Selangor,13,7,6,Andorra
83199,3/1/2024,ARE,Johor,11,5,6,United Arab Emirates
83200,3/1/2024,ARE,Kedah,7,4,3,United Arab Emirates
83201,3/1/2024,ARE,Pulau Pinang,4,3,1,United Arab Emirates
83202,3/1/2024,ARE,Selangor,154,98,56,United Arab Emirates
83203,3/1/2024,ARG,Johor,100,52,48,Argentina
83204,3/1/2024,ARG,Kedah,85,42,43,Argentina
83205,3/1/2024,ARG,Kelantan,1,1,0,Argentina
83206,3/1/2024,ARG,Perlis,7,4,3,Argentina
83207,3/1/2024,ARG,Pulau Pinang,23,13,10,Argentina
83208,3/1/2024,ARG,Sabah,9,3,6,Argentina
83209,3/1/2024,ARG,Sarawak,4,4,0,Argentina
83210,3/1/2024,ARG,Selangor,538,286,252,Argentina
83211,3/1/2024,ARM,Johor,2,1,1,Armenia
83212,3/1/2024,ARM,Kedah,1,0,1,Armenia
83213,3/1/2024,ARM,Pulau Pinang,2,1,1,Armenia
83214,3/1/2024,ARM,Sabah,2,0,2,Armenia
83215,3/1/2024,ARM,Selangor,60,21,39,Armenia
83216,3/1/2024,ATA,Selangor,1,1,0,Antarctica
83217,3/1/2024,ATG,Johor,1,1,0,Antigua and Barbuda
83218,3/1/2024,ATG,Pulau Pinang,1,1,0,Antigua and Barbuda
83219,3/1/2024,ATG,Selangor,10,4,6,Antigua and Barbuda
83220,3/1/2024,AUS,Johor,5612,3252,2360,Australia
83221,3/1/2024,AUS,Kedah,687,380,307,Australia
83222,3/1/2024,AUS,Kelantan,10,5,5,Australia
83223,3/1/2024,AUS,Melaka,2,2,0,Australia
83224,3/1/2024,AUS,Negeri Sembilan,4,3,1,Australia
83225,3/1/2024,AUS,Pahang,33,15,18,Australia
83226,3/1/2024,AUS,Perak,309,155,154,Australia
83227,3/1/2024,AUS,Perlis,78,43,35,Australia
83228,3/1/2024,AUS,Pulau Pinang,2709,1374,1335,Australia
83229,3/1/2024,AUS,Sabah,518,280,238,Australia
83230,3/1/2024,AUS,Sarawak,631,345,286,Australia
83231,3/1/2024,AUS,Selangor,23682,13755,9927,Australia
83232,3/1/2024,AUS,Terengganu,7,3,4,Australia
83233,3/1/2024,AUS,W.P. Labuan,6,4,2,Australia
83234,3/1/2024,AUT,Johor,264,182,82,Austria
83235,3/1/2024,AUT,Kedah,161,73,88,Austria
83236,3/1/2024,AUT,Kelantan,3,3,0,Austria
83237,3/1/2024,AUT,Perak,5,3,2,Austria
83238,3/1/2024,AUT,Perlis,9,5,4,Austria
83239,3/1/2024,AUT,Pulau Pinang,108,79,29,Austria
83240,3/1/2024,AUT,Sabah,26,13,13,Austria
83241,3/1/2024,AUT,Sarawak,15,10,5,Austria
83242,3/1/2024,AUT,Selangor,1013,586,427,Austria
83243,3/1/2024,AUT,W.P. Labuan,3,2,1,Austria
83244,3/1/2024,AZE,Johor,44,16,28,Azerbaijan
83245,3/1/2024,AZE,Kedah,20,9,11,Azerbaijan
83246,3/1/2024,AZE,Pulau Pinang,14,10,4,Azerbaijan
83247,3/1/2024,AZE,Sarawak,1,0,1,Azerbaijan
83248,3/1/2024,AZE,Selangor,317,144,173,Azerbaijan
83249,3/1/2024,AZE,W.P. Labuan,1,0,1,Azerbaijan
83250,3/1/2024,BDI,Pulau Pinang,1,1,0,Burundi
83251,3/1/2024,BDI,Selangor,4,4,0,Burundi
83252,3/1/2024,BEL,Johor,308,170,138,Belgium
83253,3/1/2024,BEL,Kedah,165,83,82,Belgium
83254,3/1/2024,BEL,Kelantan,5,0,5,Belgium
83255,3/1/2024,BEL,Pahang,2,2,0,Belgium
83256,3/1/2024,BEL,Perak,4,3,1,Belgium
83257,3/1/2024,BEL,Perlis,19,9,10,Belgium
83258,3/1/2024,BEL,Pulau Pinang,113,71,42,Belgium
83259,3/1/2024,BEL,Sabah,24,13,11,Belgium
83260,3/1/2024,BEL,Sarawak,26,19,7,Belgium
83261,3/1/2024,BEL,Selangor,1513,923,590,Belgium
83262,3/1/2024,BEN,Johor,3,2,1,Benin
83263,3/1/2024,BEN,Selangor,13,8,5,Benin
83264,3/1/2024,BFA,Selangor,1,0,1,Burkina Faso
83265,3/1/2024,BGD,Johor,1999,1565,434,Bangladesh
83266,3/1/2024,BGD,Kedah,69,48,21,Bangladesh
83267,3/1/2024,BGD,Kelantan,3,3,0,Bangladesh
83268,3/1/2024,BGD,Negeri Sembilan,2,2,0,Bangladesh
83269,3/1/2024,BGD,Perak,4,4,0,Bangladesh
83270,3/1/2024,BGD,Perlis,2,2,0,Bangladesh
83271,3/1/2024,BGD,Pulau Pinang,73,60,13,Bangladesh
83272,3/1/2024,BGD,Sabah,3,3,0,Bangladesh
83273,3/1/2024,BGD,Sarawak,114,92,22,Bangladesh
83274,3/1/2024,BGD,Selangor,24350,22705,1645,Bangladesh
83275,3/1/2024,BGD,W.P. Labuan,6,6,0,Bangladesh
83276,3/1/2024,BGR,Johor,56,34,22,Bulgaria
83277,3/1/2024,BGR,Kedah,20,9,11,Bulgaria
83278,3/1/2024,BGR,Kelantan,1,1,0,Bulgaria
83279,3/1/2024,BGR,Perlis,1,1,0,Bulgaria
83280,3/1/2024,BGR,Pulau Pinang,30,25,5,Bulgaria
83281,3/1/2024,BGR,Sabah,1,1,0,Bulgaria
83282,3/1/2024,BGR,Sarawak,4,3,1,Bulgaria
83283,3/1/2024,BGR,Selangor,476,238,238,Bulgaria
83284,3/1/2024,BHR,Johor,6,3,3,Bahrain
83285,3/1/2024,BHR,Kedah,1,1,0,Bahrain
83286,3/1/2024,BHR,Perlis,1,1,0,Bahrain
83287,3/1/2024,BHR,Selangor,29,19,10,Bahrain
83288,3/1/2024,BHS,Selangor,11,7,4,Bahamas
83289,3/1/2024,BIH,Johor,7,4,3,Bosnia and Herzegovina
83290,3/1/2024,BIH,Kedah,1,1,0,Bosnia and Herzegovina
83291,3/1/2024,BIH,Selangor,51,32,19,Bosnia and Herzegovina
83292,3/1/2024,BLR,Johor,10,2,8,Belarus
83293,3/1/2024,BLR,Kedah,39,17,22,Belarus
83294,3/1/2024,BLR,Kelantan,3,2,1,Belarus
83295,3/1/2024,BLR,Pulau Pinang,22,7,15,Belarus
83296,3/1/2024,BLR,Sabah,9,4,5,Belarus
83297,3/1/2024,BLR,Selangor,674,323,351,Belarus
83298,3/1/2024,BLR,W.P. Labuan,1,1,0,Belarus
83299,3/1/2024,BLZ,Johor,2,2,0,Belize
83300,3/1/2024,BLZ,Selangor,9,4,5,Belize
83301,3/1/2024,BOL,Johor,1,0,1,Bolivia
83302,3/1/2024,BOL,Sarawak,1,1,0,Bolivia
83303,3/1/2024,BOL,Selangor,18,12,6,Bolivia
83304,3/1/2024,BRA,Johor,287,165,122,Brazil
83305,3/1/2024,BRA,Kedah,150,76,74,Brazil
83306,3/1/2024,BRA,Kelantan,1,1,0,Brazil
83307,3/1/2024,BRA,Pahang,1,0,1,Brazil
83308,3/1/2024,BRA,Perak,3,1,2,Brazil
83309,3/1/2024,BRA,Perlis,10,4,6,Brazil
83310,3/1/2024,BRA,Pulau Pinang,51,29,22,Brazil
83311,3/1/2024,BRA,Sabah,18,9,9,Brazil
83312,3/1/2024,BRA,Sarawak,8,5,3,Brazil
83313,3/1/2024,BRA,Selangor,1148,667,481,Brazil
83314,3/1/2024,BRB,Selangor,6,2,4,Barbados
83315,3/1/2024,BRN,Johor,445,210,235,Brunei Darussalam
83316,3/1/2024,BRN,Kedah,39,28,11,Brunei Darussalam
83317,3/1/2024,BRN,Kelantan,14,7,7,Brunei Darussalam
83318,3/1/2024,BRN,Perak,5,2,3,Brunei Darussalam
83319,3/1/2024,BRN,Perlis,27,13,14,Brunei Darussalam
83320,3/1/2024,BRN,Pulau Pinang,41,15,26,Brunei Darussalam
83321,3/1/2024,BRN,Sabah,1043,439,604,Brunei Darussalam
83322,3/1/2024,BRN,Sarawak,157523,82638,74885,Brunei Darussalam
83323,3/1/2024,BRN,Selangor,6365,2912,3453,Brunei Darussalam
83324,3/1/2024,BRN,W.P. Labuan,988,659,329,Brunei Darussalam
83325,3/1/2024,BTN,Johor,7,7,0,Bhutan
83326,3/1/2024,BTN,Kedah,3,3,0,Bhutan
83327,3/1/2024,BTN,Pulau Pinang,4,4,0,Bhutan
83328,3/1/2024,BTN,Selangor,53,35,18,Bhutan
83329,3/1/2024,BWA,Selangor,25,11,14,Botswana
83330,3/1/2024,CAF,Selangor,1,1,0,Central African Republic
83331,3/1/2024,CAN,Johor,1949,1046,903,Canada
83332,3/1/2024,CAN,Kedah,366,196,170,Canada
83333,3/1/2024,CAN,Kelantan,7,5,2,Canada
83334,3/1/2024,CAN,Pahang,7,4,3,Canada
83335,3/1/2024,CAN,Perak,30,15,15,Canada
83336,3/1/2024,CAN,Perlis,47,30,17,Canada
83337,3/1/2024,CAN,Pulau Pinang,887,465,422,Canada
83338,3/1/2024,CAN,Sabah,253,131,122,Canada
83339,3/1/2024,CAN,Sarawak,445,238,207,Canada
83340,3/1/2024,CAN,Selangor,5842,3335,2507,Canada
83341,3/1/2024,CAN,Terengganu,1,1,0,Canada
83342,3/1/2024,CAN,W.P. Labuan,6,3,3,Canada
83343,3/1/2024,CHE,Johor,508,316,192,Switzerland
83344,3/1/2024,CHE,Kedah,282,154,128,Switzerland
83345,3/1/2024,CHE,Kelantan,4,1,3,Switzerland
83346,3/1/2024,CHE,Negeri Sembilan,2,1,1,Switzerland
83347,3/1/2024,CHE,Pahang,2,1,1,Switzerland
83348,3/1/2024,CHE,Perak,10,7,3,Switzerland
83349,3/1/2024,CHE,Perlis,31,20,11,Switzerland
83350,3/1/2024,CHE,Pulau Pinang,186,102,84,Switzerland
83351,3/1/2024,CHE,Sabah,69,36,33,Switzerland
83352,3/1/2024,CHE,Sarawak,59,27,32,Switzerland
83353,3/1/2024,CHE,Selangor,1795,1040,755,Switzerland
83354,3/1/2024,CHL,Johor,48,24,24,Chile
83355,3/1/2024,CHL,Kedah,23,12,11,Chile
83356,3/1/2024,CHL,Kelantan,1,1,0,Chile
83357,3/1/2024,CHL,Perlis,2,1,1,Chile
83358,3/1/2024,CHL,Pulau Pinang,14,8,6,Chile
83359,3/1/2024,CHL,Sabah,4,2,2,Chile
83360,3/1/2024,CHL,Selangor,384,168,216,Chile
83361,3/1/2024,CHN,Johor,91075,39596,51479,China
83362,3/1/2024,CHN,Kedah,2101,927,1174,China
83363,3/1/2024,CHN,Kelantan,12,8,4,China
83364,3/1/2024,CHN,Melaka,5,5,0,China
83365,3/1/2024,CHN,Negeri Sembilan,5,5,0,China
83366,3/1/2024,CHN,Pahang,54,35,19,China
83367,3/1/2024,CHN,Perak,344,131,213,China
83368,3/1/2024,CHN,Perlis,444,243,201,China
83369,3/1/2024,CHN,Pulau Pinang,13137,6529,6608,China
83370,3/1/2024,CHN,Sabah,18833,7888,10945,China
83371,3/1/2024,CHN,Sarawak,1693,878,815,China
83372,3/1/2024,CHN,Selangor,135069,68396,66673,China
83373,3/1/2024,CHN,W.P. Labuan,54,46,8,China
83374,3/1/2024,CIV,Johor,2,1,1,C��te d'Iv
83375,3/1/2024,CIV,Pulau Pinang,1,0,1,C��te d'Iv
83376,3/1/2024,CIV,Sabah,1,0,1,C��te d'Iv
83377,3/1/2024,CIV,Selangor,9,5,4,C��te d'Iv
83378,3/1/2024,CMR,Kedah,1,0,1,Cameroon
83379,3/1/2024,CMR,Selangor,27,16,11,Cameroon
83380,3/1/2024,COD,Johor,3,3,0,"Congo, the Democratic Republic of the"
83381,3/1/2024,COD,Sabah,2,2,0,"Congo, the Democratic Republic of the"
83382,3/1/2024,COD,Selangor,19,17,2,"Congo, the Democratic Republic of the"
83383,3/1/2024,COL,Johor,52,21,31,Colombia
83384,3/1/2024,COL,Kedah,10,4,6,Colombia
83385,3/1/2024,COL,Pulau Pinang,15,7,8,Colombia
83386,3/1/2024,COL,Sabah,4,2,2,Colombia
83387,3/1/2024,COL,Sarawak,1,1,0,Colombia
83388,3/1/2024,COL,Selangor,225,123,102,Colombia
83389,3/1/2024,COM,Selangor,6,2,4,Comoros
83390,3/1/2024,CPV,Selangor,1,0,1,Cape Verde
83391,3/1/2024,CRI,Johor,17,11,6,Costa Rica
83392,3/1/2024,CRI,Pulau Pinang,26,21,5,Costa Rica
83393,3/1/2024,CRI,Sabah,2,1,1,Costa Rica
83394,3/1/2024,CRI,Selangor,87,40,47,Costa Rica
83395,3/1/2024,CUB,Johor,9,6,3,Cuba
83396,3/1/2024,CUB,Selangor,25,13,12,Cuba
83397,3/1/2024,CYP,Johor,10,8,2,Cyprus
83398,3/1/2024,CYP,Kedah,1,1,0,Cyprus
83399,3/1/2024,CYP,Sabah,2,1,1,Cyprus
83400,3/1/2024,CYP,Sarawak,1,1,0,Cyprus
83401,3/1/2024,CYP,Selangor,87,56,31,Cyprus
83402,3/1/2024,CZE,Johor,181,103,78,Czech Republic
83403,3/1/2024,CZE,Kedah,322,147,175,Czech Republic
83404,3/1/2024,CZE,Kelantan,3,3,0,Czech Republic
83405,3/1/2024,CZE,Perlis,10,5,5,Czech Republic
83406,3/1/2024,CZE,Pulau Pinang,45,26,19,Czech Republic
83407,3/1/2024,CZE,Sabah,11,4,7,Czech Republic
83408,3/1/2024,CZE,Sarawak,13,10,3,Czech Republic
83409,3/1/2024,CZE,Selangor,987,562,425,Czech Republic
83410,3/1/2024,CZE,W.P. Labuan,15,4,11,Czech Republic
83411,3/1/2024,DEU,Johor,3173,1876,1297,Germany
83412,3/1/2024,DEU,Kedah,1907,975,932,Germany
83413,3/1/2024,DEU,Kelantan,11,6,5,Germany
83414,3/1/2024,DEU,Melaka,8,6,2,Germany
83415,3/1/2024,DEU,Pahang,15,8,7,Germany
83416,3/1/2024,DEU,Perak,34,25,9,Germany
83417,3/1/2024,DEU,Perlis,178,104,74,Germany
83418,3/1/2024,DEU,Pulau Pinang,1156,784,372,Germany
83419,3/1/2024,DEU,Sabah,203,108,95,Germany
83420,3/1/2024,DEU,Sarawak,278,160,118,Germany
83421,3/1/2024,DEU,Selangor,11716,6773,4943,Germany
83422,3/1/2024,DEU,W.P. Labuan,11,7,4,Germany
83423,3/1/2024,DJI,Johor,4,2,2,Djibouti
83424,3/1/2024,DJI,Selangor,22,15,7,Djibouti
83425,3/1/2024,DMA,Johor,10,6,4,Dominica
83426,3/1/2024,DMA,Kedah,8,3,5,Dominica
83427,3/1/2024,DMA,Pulau Pinang,1,1,0,Dominica
83428,3/1/2024,DMA,Selangor,55,41,14,Dominica
83429,3/1/2024,DNK,Johor,359,236,123,Denmark
83430,3/1/2024,DNK,Kedah,403,184,219,Denmark
83431,3/1/2024,DNK,Kelantan,4,2,2,Denmark
83432,3/1/2024,DNK,Perak,2,2,0,Denmark
83433,3/1/2024,DNK,Perlis,9,6,3,Denmark
83434,3/1/2024,DNK,Pulau Pinang,106,68,38,Denmark
83435,3/1/2024,DNK,Sabah,67,29,38,Denmark
83436,3/1/2024,DNK,Sarawak,17,10,7,Denmark
83437,3/1/2024,DNK,Selangor,1588,917,671,Denmark
83438,3/1/2024,DOM,Johor,7,0,7,Dominican Republic
83439,3/1/2024,DOM,Pulau Pinang,2,0,2,Dominican Republic
83440,3/1/2024,DOM,Selangor,17,11,6,Dominican Republic
83441,3/1/2024,DZA,Johor,24,16,8,Algeria
83442,3/1/2024,DZA,Kedah,4,1,3,Algeria
83443,3/1/2024,DZA,Kelantan,1,1,0,Algeria
83444,3/1/2024,DZA,Pulau Pinang,4,2,2,Algeria
83445,3/1/2024,DZA,Sabah,2,0,2,Algeria
83446,3/1/2024,DZA,Sarawak,5,4,1,Algeria
83447,3/1/2024,DZA,Selangor,355,270,85,Algeria
83448,3/1/2024,ECU,Johor,6,3,3,Ecuador
83449,3/1/2024,ECU,Kedah,1,0,1,Ecuador
83450,3/1/2024,ECU,Pulau Pinang,5,0,5,Ecuador
83451,3/1/2024,ECU,Sabah,1,0,1,Ecuador
83452,3/1/2024,ECU,Selangor,77,29,48,Ecuador
83453,3/1/2024,EGY,Johor,194,173,21,Egypt
83454,3/1/2024,EGY,Kedah,18,12,6,Egypt
83455,3/1/2024,EGY,Melaka,1,1,0,Egypt
83456,3/1/2024,EGY,Pulau Pinang,28,23,5,Egypt
83457,3/1/2024,EGY,Sabah,2,2,0,Egypt
83458,3/1/2024,EGY,Sarawak,83,55,28,Egypt
83459,3/1/2024,EGY,Selangor,1124,857,267,Egypt
83460,3/1/2024,ERI,Johor,1,1,0,Eritrea
83461,3/1/2024,ERI,Selangor,20,5,15,Eritrea
83462,3/1/2024,ESP,Johor,619,371,248,Spain
83463,3/1/2024,ESP,Kedah,289,148,141,Spain
83464,3/1/2024,ESP,Kelantan,8,6,2,Spain
83465,3/1/2024,ESP,Negeri Sembilan,6,3,3,Spain
83466,3/1/2024,ESP,Pahang,3,3,0,Spain
83467,3/1/2024,ESP,Perak,11,7,4,Spain
83468,3/1/2024,ESP,Perlis,17,8,9,Spain
83469,3/1/2024,ESP,Pulau Pinang,180,90,90,Spain
83470,3/1/2024,ESP,Sabah,73,38,35,Spain
83471,3/1/2024,ESP,Sarawak,32,18,14,Spain
83472,3/1/2024,ESP,Selangor,3257,1785,1472,Spain
83473,3/1/2024,ESP,W.P. Labuan,4,1,3,Spain
83474,3/1/2024,EST,Johor,47,24,23,Estonia
83475,3/1/2024,EST,Kedah,87,40,47,Estonia
83476,3/1/2024,EST,Perlis,4,3,1,Estonia
83477,3/1/2024,EST,Pulau Pinang,10,6,4,Estonia
83478,3/1/2024,EST,Sabah,6,4,2,Estonia
83479,3/1/2024,EST,Sarawak,3,2,1,Estonia
83480,3/1/2024,EST,Selangor,390,202,188,Estonia
83481,3/1/2024,EST,W.P. Labuan,3,1,2,Estonia
83482,3/1/2024,ETH,Johor,5,5,0,Ethiopia
83483,3/1/2024,ETH,Pulau Pinang,2,1,1,Ethiopia
83484,3/1/2024,ETH,Selangor,24,10,14,Ethiopia
83485,3/1/2024,FIN,Johor,340,178,162,Finland
83486,3/1/2024,FIN,Kedah,217,98,119,Finland
83487,3/1/2024,FIN,Kelantan,2,2,0,Finland
83488,3/1/2024,FIN,Perak,1,0,1,Finland
83489,3/1/2024,FIN,Perlis,13,11,2,Finland
83490,3/1/2024,FIN,Pulau Pinang,87,59,28,Finland
83491,3/1/2024,FIN,Sabah,17,11,6,Finland
83492,3/1/2024,FIN,Sarawak,20,9,11,Finland
83493,3/1/2024,FIN,Selangor,744,400,344,Finland
83494,3/1/2024,FIN,W.P. Labuan,3,2,1,Finland
83495,3/1/2024,FJI,Johor,53,27,26,Fiji
83496,3/1/2024,FJI,Pulau Pinang,4,3,1,Fiji
83497,3/1/2024,FJI,Selangor,102,44,58,Fiji
83498,3/1/2024,FRA,Johor,2690,1620,1070,France
83499,3/1/2024,FRA,Kedah,1383,697,686,France
83500,3/1/2024,FRA,Kelantan,43,25,18,France
83501,3/1/2024,FRA,Melaka,1,0,1,France
83502,3/1/2024,FRA,Negeri Sembilan,2,1,1,France
83503,3/1/2024,FRA,Pahang,43,26,17,France
83504,3/1/2024,FRA,Perak,32,20,12,France
83505,3/1/2024,FRA,Perlis,114,75,39,France
83506,3/1/2024,FRA,Pulau Pinang,552,318,234,France
83507,3/1/2024,FRA,Sabah,193,104,89,France
83508,3/1/2024,FRA,Sarawak,131,79,52,France
83509,3/1/2024,FRA,Selangor,9820,5816,4004,France
83510,3/1/2024,FRA,Terengganu,1,1,0,France
83511,3/1/2024,FRA,W.P. Labuan,4,3,1,France
83512,3/1/2024,FSM,Selangor,3,3,0,"Micronesia, Federated States of"
83513,3/1/2024,GAB,Johor,1,1,0,Gabon
83514,3/1/2024,GAB,Selangor,5,3,2,Gabon
83515,3/1/2024,GBR,Johor,6084,3807,2277,United Kingdom
83516,3/1/2024,GBR,Kedah,2514,1295,1219,United Kingdom
83517,3/1/2024,GBR,Kelantan,30,25,5,United Kingdom
83518,3/1/2024,GBR,Melaka,5,2,3,United Kingdom
83519,3/1/2024,GBR,Negeri Sembilan,4,4,0,United Kingdom
83520,3/1/2024,GBR,Pahang,34,19,15,United Kingdom
83521,3/1/2024,GBR,Perak,123,70,53,United Kingdom
83522,3/1/2024,GBR,Perlis,221,145,76,United Kingdom
83523,3/1/2024,GBR,Pulau Pinang,5327,2756,2571,United Kingdom
83524,3/1/2024,GBR,Sabah,913,472,441,United Kingdom
83525,3/1/2024,GBR,Sarawak,1589,958,631,United Kingdom
83526,3/1/2024,GBR,Selangor,27149,15609,11540,United Kingdom
83527,3/1/2024,GBR,Terengganu,1,1,0,United Kingdom
83528,3/1/2024,GBR,W.P. Labuan,46,30,16,United Kingdom
83529,3/1/2024,GEO,Johor,6,3,3,Georgia
83530,3/1/2024,GEO,Kedah,3,1,2,Georgia
83531,3/1/2024,GEO,Pulau Pinang,2,1,1,Georgia
83532,3/1/2024,GEO,Sabah,3,1,2,Georgia
83533,3/1/2024,GEO,Sarawak,1,0,1,Georgia
83534,3/1/2024,GEO,Selangor,63,30,33,Georgia
83535,3/1/2024,GHA,Johor,8,8,0,Ghana
83536,3/1/2024,GHA,Kedah,3,3,0,Ghana
83537,3/1/2024,GHA,Perak,1,1,0,Ghana
83538,3/1/2024,GHA,Pulau Pinang,21,16,5,Ghana
83539,3/1/2024,GHA,Sarawak,1,1,0,Ghana
83540,3/1/2024,GHA,Selangor,83,58,25,Ghana
83541,3/1/2024,GIN,Johor,6,5,1,Guinea
83542,3/1/2024,GIN,Kedah,2,2,0,Guinea
83543,3/1/2024,GIN,Pulau Pinang,2,1,1,Guinea
83544,3/1/2024,GIN,Selangor,43,32,11,Guinea
83545,3/1/2024,GMB,Johor,1,1,0,Gambia
83546,3/1/2024,GMB,Selangor,23,19,4,Gambia
83547,3/1/2024,GNB,Selangor,1,1,0,Guinea-Bissau
83548,3/1/2024,GNQ,Selangor,3,1,2,Equatorial Guinea
83549,3/1/2024,GRC,Johor,83,62,21,Greece
83550,3/1/2024,GRC,Kedah,18,12,6,Greece
83551,3/1/2024,GRC,Negeri Sembilan,1,1,0,Greece
83552,3/1/2024,GRC,Perak,1,1,0,Greece
83553,3/1/2024,GRC,Perlis,1,0,1,Greece
83554,3/1/2024,GRC,Pulau Pinang,15,7,8,Greece
83555,3/1/2024,GRC,Sabah,5,4,1,Greece
83556,3/1/2024,GRC,Sarawak,3,1,2,Greece
83557,3/1/2024,GRC,Selangor,334,228,106,Greece
83558,3/1/2024,GRC,W.P. Labuan,2,2,0,Greece
83559,3/1/2024,GRD,Johor,3,3,0,Grenada
83560,3/1/2024,GRD,Selangor,9,8,1,Grenada
83561,3/1/2024,GRL,Selangor,1,1,0,Greenland
83562,3/1/2024,GTM,Johor,4,3,1,Guatemala
83563,3/1/2024,GTM,Kedah,1,1,0,Guatemala
83564,3/1/2024,GTM,Pulau Pinang,1,1,0,Guatemala
83565,3/1/2024,GTM,Sabah,1,1,0,Guatemala
83566,3/1/2024,GTM,Selangor,29,17,12,Guatemala
83567,3/1/2024,GUY,Johor,1,1,0,Guyana
83568,3/1/2024,GUY,Pulau Pinang,4,0,4,Guyana
83569,3/1/2024,GUY,Selangor,10,7,3,Guyana
83570,3/1/2024,HKG,Johor,8,4,4,Hong Kong
83571,3/1/2024,HKG,Kedah,1,0,1,Hong Kong
83572,3/1/2024,HKG,Pahang,3,2,1,Hong Kong
83573,3/1/2024,HKG,Perak,37,15,22,Hong Kong
83574,3/1/2024,HKG,Pulau Pinang,133,56,77,Hong Kong
83575,3/1/2024,HKG,Sabah,170,75,95,Hong Kong
83576,3/1/2024,HKG,Selangor,79,41,38,Hong Kong
83577,3/1/2024,HKG,W.P. Labuan,2,2,0,Hong Kong
83578,3/1/2024,HND,Johor,9,4,5,Honduras
83579,3/1/2024,HND,Selangor,16,11,5,Honduras
83580,3/1/2024,HRV,Johor,42,33,9,Croatia
83581,3/1/2024,HRV,Kedah,9,4,5,Croatia
83582,3/1/2024,HRV,Perlis,1,0,1,Croatia
83583,3/1/2024,HRV,Pulau Pinang,14,10,4,Croatia
83584,3/1/2024,HRV,Sabah,1,1,0,Croatia
83585,3/1/2024,HRV,Sarawak,1,1,0,Croatia
83586,3/1/2024,HRV,Selangor,266,152,114,Croatia
83587,3/1/2024,HTI,Selangor,14,9,5,Haiti
83588,3/1/2024,HUN,Johor,146,83,63,Hungary
83589,3/1/2024,HUN,Kedah,101,47,54,Hungary
83590,3/1/2024,HUN,Kelantan,3,3,0,Hungary
83591,3/1/2024,HUN,Perlis,5,4,1,Hungary
83592,3/1/2024,HUN,Pulau Pinang,50,30,20,Hungary
83593,3/1/2024,HUN,Sabah,9,6,3,Hungary
83594,3/1/2024,HUN,Sarawak,25,14,11,Hungary
83595,3/1/2024,HUN,Selangor,1048,540,508,Hungary
83596,3/1/2024,IDN,Johor,93412,40044,53368,Indonesia
83597,3/1/2024,IDN,Kedah,3830,1463,2367,Indonesia
83598,3/1/2024,IDN,Kelantan,151,104,47,Indonesia
83599,3/1/2024,IDN,Melaka,2994,1357,1637,Indonesia
83600,3/1/2024,IDN,Negeri Sembilan,4894,2767,2127,Indonesia
83601,3/1/2024,IDN,Pahang,20,13,7,Indonesia
83602,3/1/2024,IDN,Perak,161,50,111,Indonesia
83603,3/1/2024,IDN,Perlis,508,199,309,Indonesia
83604,3/1/2024,IDN,Pulau Pinang,43542,17443,26099,Indonesia
83605,3/1/2024,IDN,Sabah,4945,2485,2460,Indonesia
83606,3/1/2024,IDN,Sarawak,38775,19579,19196,Indonesia
83607,3/1/2024,IDN,Selangor,122614,57603,65011,Indonesia
83608,3/1/2024,IDN,W.P. Labuan,39,22,17,Indonesia
83609,3/1/2024,IND,Johor,37284,23812,13472,India
83610,3/1/2024,IND,Kedah,2083,1110,973,India
83611,3/1/2024,IND,Kelantan,13,10,3,India
83612,3/1/2024,IND,Melaka,4,3,1,India
83613,3/1/2024,IND,Negeri Sembilan,9,9,0,India
83614,3/1/2024,IND,Pahang,15,13,2,India
83615,3/1/2024,IND,Perak,253,178,75,India
83616,3/1/2024,IND,Perlis,68,60,8,India
83617,3/1/2024,IND,Pulau Pinang,3357,2000,1357,India
83618,3/1/2024,IND,Sabah,314,198,116,India
83619,3/1/2024,IND,Sarawak,2378,1947,431,India
83620,3/1/2024,IND,Selangor,66629,44197,22432,India
83621,3/1/2024,IND,Terengganu,2,1,1,India
83622,3/1/2024,IND,W.P. Labuan,33,30,3,India
83623,3/1/2024,IOT,Selangor,1,1,0,British Indian Ocean Territory
83624,3/1/2024,IRL,Johor,352,212,140,Ireland
83625,3/1/2024,IRL,Kedah,147,71,76,Ireland
83626,3/1/2024,IRL,Kelantan,2,1,1,Ireland
83627,3/1/2024,IRL,Perak,7,5,2,Ireland
83628,3/1/2024,IRL,Perlis,26,20,6,Ireland
83629,3/1/2024,IRL,Pulau Pinang,226,123,103,Ireland
83630,3/1/2024,IRL,Sabah,44,23,21,Ireland
83631,3/1/2024,IRL,Sarawak,30,15,15,Ireland
83632,3/1/2024,IRL,Selangor,1626,951,675,Ireland
83633,3/1/2024,IRN,Johor,765,362,403,Iran
83634,3/1/2024,IRN,Kedah,38,19,19,Iran
83635,3/1/2024,IRN,Perlis,4,4,0,Iran
83636,3/1/2024,IRN,Pulau Pinang,39,19,20,Iran
83637,3/1/2024,IRN,Sabah,4,0,4,Iran
83638,3/1/2024,IRN,Sarawak,2,2,0,Iran
83639,3/1/2024,IRN,Selangor,5497,2702,2795,Iran
83640,3/1/2024,IRQ,Johor,39,33,6,Iraq
83641,3/1/2024,IRQ,Kedah,2,2,0,Iraq
83642,3/1/2024,IRQ,Pulau Pinang,1,1,0,Iraq
83643,3/1/2024,IRQ,Sarawak,6,4,2,Iraq
83644,3/1/2024,IRQ,Selangor,802,555,247,Iraq
83645,3/1/2024,ISL,Johor,3,1,2,Iceland
83646,3/1/2024,ISL,Kedah,6,1,5,Iceland
83647,3/1/2024,ISL,Negeri Sembilan,1,0,1,Iceland
83648,3/1/2024,ISL,Perlis,1,0,1,Iceland
83649,3/1/2024,ISL,Pulau Pinang,5,3,2,Iceland
83650,3/1/2024,ISL,Selangor,46,25,21,Iceland
83651,3/1/2024,ITA,Johor,747,520,227,Italy
83652,3/1/2024,ITA,Kedah,598,323,275,Italy
83653,3/1/2024,ITA,Kelantan,6,6,0,Italy
83654,3/1/2024,ITA,Pahang,1,1,0,Italy
83655,3/1/2024,ITA,Perak,9,5,4,Italy
83656,3/1/2024,ITA,Perlis,35,22,13,Italy
83657,3/1/2024,ITA,Pulau Pinang,198,148,50,Italy
83658,3/1/2024,ITA,Sabah,66,40,26,Italy
83659,3/1/2024,ITA,Sarawak,43,28,15,Italy
83660,3/1/2024,ITA,Selangor,3641,2371,1270,Italy
83661,3/1/2024,ITA,W.P. Labuan,4,4,0,Italy
83662,3/1/2024,JAM,Johor,4,0,4,Jamaica
83663,3/1/2024,JAM,Selangor,16,11,5,Jamaica
83664,3/1/2024,JOR,Johor,18,14,4,Jordan
83665,3/1/2024,JOR,Kedah,4,4,0,Jordan
83666,3/1/2024,JOR,Pulau Pinang,4,4,0,Jordan
83667,3/1/2024,JOR,Selangor,414,310,104,Jordan
83668,3/1/2024,JPN,Johor,8379,5268,3111,Japan
83669,3/1/2024,JPN,Kedah,498,255,243,Japan
83670,3/1/2024,JPN,Kelantan,11,10,1,Japan
83671,3/1/2024,JPN,Melaka,1,1,0,Japan
83672,3/1/2024,JPN,Negeri Sembilan,12,10,2,Japan
83673,3/1/2024,JPN,Pahang,24,15,9,Japan
83674,3/1/2024,JPN,Perak,64,39,25,Japan
83675,3/1/2024,JPN,Perlis,137,115,22,Japan
83676,3/1/2024,JPN,Pulau Pinang,3232,1783,1449,Japan
83677,3/1/2024,JPN,Sabah,780,394,386,Japan
83678,3/1/2024,JPN,Sarawak,210,127,83,Japan
83679,3/1/2024,JPN,Selangor,23771,14159,9612,Japan
83680,3/1/2024,JPN,W.P. Labuan,11,7,4,Japan
83681,3/1/2024,KAZ,Johor,62,21,41,Kazakhstan
83682,3/1/2024,KAZ,Kedah,51,27,24,Kazakhstan
83683,3/1/2024,KAZ,Kelantan,5,2,3,Kazakhstan
83684,3/1/2024,KAZ,Perlis,11,5,6,Kazakhstan
83685,3/1/2024,KAZ,Pulau Pinang,15,7,8,Kazakhstan
83686,3/1/2024,KAZ,Sabah,6,1,5,Kazakhstan
83687,3/1/2024,KAZ,Sarawak,8,1,7,Kazakhstan
83688,3/1/2024,KAZ,Selangor,3044,1253,1791,Kazakhstan
83689,3/1/2024,KEN,Johor,31,11,20,Kenya
83690,3/1/2024,KEN,Kedah,4,1,3,Kenya
83691,3/1/2024,KEN,Pulau Pinang,17,7,10,Kenya
83692,3/1/2024,KEN,Selangor,337,194,143,Kenya
83693,3/1/2024,KGZ,Johor,37,27,10,Kyrgyzstan
83694,3/1/2024,KGZ,Kedah,5,3,2,Kyrgyzstan
83695,3/1/2024,KGZ,Kelantan,2,2,0,Kyrgyzstan
83696,3/1/2024,KGZ,Pulau Pinang,3,0,3,Kyrgyzstan
83697,3/1/2024,KGZ,Sabah,1,1,0,Kyrgyzstan
83698,3/1/2024,KGZ,Selangor,490,205,285,Kyrgyzstan
83699,3/1/2024,KHM,Johor,1921,830,1091,Cambodia
83700,3/1/2024,KHM,Kedah,147,77,70,Cambodia
83701,3/1/2024,KHM,Kelantan,624,463,161,Cambodia
83702,3/1/2024,KHM,Melaka,3,2,1,Cambodia
83703,3/1/2024,KHM,Perak,5,1,4,Cambodia
83704,3/1/2024,KHM,Perlis,725,411,314,Cambodia
83705,3/1/2024,KHM,Pulau Pinang,42,15,27,Cambodia
83706,3/1/2024,KHM,Sabah,2,1,1,Cambodia
83707,3/1/2024,KHM,Sarawak,10,7,3,Cambodia
83708,3/1/2024,KHM,Selangor,3361,1630,1731,Cambodia
83709,3/1/2024,KNA,Johor,11,8,3,Saint Kitts and Nevis
83710,3/1/2024,KNA,Kedah,4,3,1,Saint Kitts and Nevis
83711,3/1/2024,KNA,Pulau Pinang,2,2,0,Saint Kitts and Nevis
83712,3/1/2024,KNA,Sabah,1,0,1,Saint Kitts and Nevis
83713,3/1/2024,KNA,Selangor,60,47,13,Saint Kitts and Nevis
83714,3/1/2024,KOR,Johor,10615,5810,4805,"Korea, Republic of (South Korea)"
83715,3/1/2024,KOR,Kedah,293,132,161,"Korea, Republic of (South Korea)"
83716,3/1/2024,KOR,Kelantan,1,0,1,"Korea, Republic of (South Korea)"
83717,3/1/2024,KOR,Negeri Sembilan,1,1,0,"Korea, Republic of (South Korea)"
83718,3/1/2024,KOR,Perak,24,11,13,"Korea, Republic of (South Korea)"
83719,3/1/2024,KOR,Perlis,79,52,27,"Korea, Republic of (South Korea)"
83720,3/1/2024,KOR,Pulau Pinang,1421,680,741,"Korea, Republic of (South Korea)"
83721,3/1/2024,KOR,Sabah,13537,5160,8377,"Korea, Republic of (South Korea)"
83722,3/1/2024,KOR,Sarawak,175,101,74,"Korea, Republic of (South Korea)"
83723,3/1/2024,KOR,Selangor,12886,7246,5640,"Korea, Republic of (South Korea)"
83724,3/1/2024,KOR,W.P. Labuan,17,11,6,"Korea, Republic of (South Korea)"
83725,3/1/2024,KWT,Johor,13,9,4,Kuwait
83726,3/1/2024,KWT,Kedah,1,1,0,Kuwait
83727,3/1/2024,KWT,Kelantan,1,0,1,Kuwait
83728,3/1/2024,KWT,Pulau Pinang,1,0,1,Kuwait
83729,3/1/2024,KWT,Selangor,109,79,30,Kuwait
83730,3/1/2024,LAO,Johor,156,33,123,Lao People's Democratic Republic
83731,3/1/2024,LAO,Kedah,1302,107,1195,Lao People's Democratic Republic
83732,3/1/2024,LAO,Kelantan,508,391,117,Lao People's Democratic Republic
83733,3/1/2024,LAO,Perak,26,3,23,Lao People's Democratic Republic
83734,3/1/2024,LAO,Perlis,406,65,341,Lao People's Democratic Republic
83735,3/1/2024,LAO,Pulau Pinang,31,11,20,Lao People's Democratic Republic
83736,3/1/2024,LAO,Sarawak,14,10,4,Lao People's Democratic Republic
83737,3/1/2024,LAO,Selangor,271,95,176,Lao People's Democratic Republic
83738,3/1/2024,LBN,Johor,36,23,13,Lebanon
83739,3/1/2024,LBN,Kedah,9,5,4,Lebanon
83740,3/1/2024,LBN,Pulau Pinang,8,4,4,Lebanon
83741,3/1/2024,LBN,Sabah,2,2,0,Lebanon
83742,3/1/2024,LBN,Sarawak,7,7,0,Lebanon
83743,3/1/2024,LBN,Selangor,210,140,70,Lebanon
83744,3/1/2024,LBR,Johor,2,2,0,Liberia
83745,3/1/2024,LBR,Selangor,10,7,3,Liberia
83746,3/1/2024,LBY,Perlis,1,1,0,Libyan Arab Jamahiriya
83747,3/1/2024,LBY,Pulau Pinang,1,1,0,Libyan Arab Jamahiriya
83748,3/1/2024,LBY,Selangor,197,146,51,Libyan Arab Jamahiriya
83749,3/1/2024,LCA,Johor,4,3,1,Saint Lucia
83750,3/1/2024,LCA,Kedah,1,1,0,Saint Lucia
83751,3/1/2024,LCA,Pulau Pinang,4,4,0,Saint Lucia
83752,3/1/2024,LCA,Selangor,14,8,6,Saint Lucia
83753,3/1/2024,LIE,Pulau Pinang,2,1,1,Liechtenstein
83754,3/1/2024,LIE,Selangor,5,4,1,Liechtenstein
83755,3/1/2024,LKA,Johor,674,427,247,Sri Lanka
83756,3/1/2024,LKA,Kedah,47,29,18,Sri Lanka
83757,3/1/2024,LKA,Melaka,1,1,0,Sri Lanka
83758,3/1/2024,LKA,Perak,4,1,3,Sri Lanka
83759,3/1/2024,LKA,Perlis,8,6,2,Sri Lanka
83760,3/1/2024,LKA,Pulau Pinang,45,22,23,Sri Lanka
83761,3/1/2024,LKA,Sabah,5,3,2,Sri Lanka
83762,3/1/2024,LKA,Sarawak,36,28,8,Sri Lanka
83763,3/1/2024,LKA,Selangor,3380,2117,1263,Sri Lanka
83764,3/1/2024,LSO,Johor,1,0,1,Lesotho
83765,3/1/2024,LSO,Selangor,4,3,1,Lesotho
83766,3/1/2024,LTU,Johor,83,32,51,Lithuania
83767,3/1/2024,LTU,Kedah,153,66,87,Lithuania
83768,3/1/2024,LTU,Pahang,1,1,0,Lithuania
83769,3/1/2024,LTU,Perlis,2,2,0,Lithuania
83770,3/1/2024,LTU,Pulau Pinang,18,9,9,Lithuania
83771,3/1/2024,LTU,Sabah,7,1,6,Lithuania
83772,3/1/2024,LTU,Sarawak,15,7,8,Lithuania
83773,3/1/2024,LTU,Selangor,1102,527,575,Lithuania
83774,3/1/2024,LTU,W.P. Labuan,12,3,9,Lithuania
83775,3/1/2024,LUX,Johor,11,8,3,Luxembourg
83776,3/1/2024,LUX,Kedah,5,2,3,Luxembourg
83777,3/1/2024,LUX,Pulau Pinang,3,1,2,Luxembourg
83778,3/1/2024,LUX,Sabah,3,2,1,Luxembourg
83779,3/1/2024,LUX,Sarawak,2,1,1,Luxembourg
83780,3/1/2024,LUX,Selangor,68,37,31,Luxembourg
83781,3/1/2024,LVA,Johor,69,32,37,Latvia
83782,3/1/2024,LVA,Kedah,33,15,18,Latvia
83783,3/1/2024,LVA,Perak,2,1,1,Latvia
83784,3/1/2024,LVA,Perlis,3,2,1,Latvia
83785,3/1/2024,LVA,Pulau Pinang,11,6,5,Latvia
83786,3/1/2024,LVA,Sabah,5,3,2,Latvia
83787,3/1/2024,LVA,Sarawak,2,0,2,Latvia
83788,3/1/2024,LVA,Selangor,327,178,149,Latvia
83789,3/1/2024,LVA,W.P. Labuan,18,7,11,Latvia
83790,3/1/2024,MAC,Pulau Pinang,1,0,1,Macao
83791,3/1/2024,MAR,Johor,84,47,37,Morocco
83792,3/1/2024,MAR,Kedah,15,11,4,Morocco
83793,3/1/2024,MAR,Kelantan,5,4,1,Morocco
83794,3/1/2024,MAR,Perlis,2,2,0,Morocco
83795,3/1/2024,MAR,Pulau Pinang,13,6,7,Morocco
83796,3/1/2024,MAR,Sabah,3,0,3,Morocco
83797,3/1/2024,MAR,Sarawak,5,4,1,Morocco
83798,3/1/2024,MAR,Selangor,516,324,192,Morocco
83799,3/1/2024,MCO,Johor,1,1,0,Monaco
83800,3/1/2024,MCO,Selangor,2,2,0,Monaco
83801,3/1/2024,MDA,Johor,9,1,8,"Moldova, Republic of"
83802,3/1/2024,MDA,Kedah,1,0,1,"Moldova, Republic of"
83803,3/1/2024,MDA,Kelantan,1,1,0,"Moldova, Republic of"
83804,3/1/2024,MDA,Sarawak,1,1,0,"Moldova, Republic of"
83805,3/1/2024,MDA,Selangor,59,24,35,"Moldova, Republic of"
83806,3/1/2024,MDG,Johor,8,6,2,Madagascar
83807,3/1/2024,MDG,Selangor,111,55,56,Madagascar
83808,3/1/2024,MDV,Johor,108,47,61,Maldives
83809,3/1/2024,MDV,Pulau Pinang,24,21,3,Maldives
83810,3/1/2024,MDV,Sabah,1,1,0,Maldives
83811,3/1/2024,MDV,Selangor,1618,916,702,Maldives
83812,3/1/2024,MEX,Johor,260,124,136,Mexico
83813,3/1/2024,MEX,Kedah,11,5,6,Mexico
83814,3/1/2024,MEX,Kelantan,1,0,1,Mexico
83815,3/1/2024,MEX,Perak,1,1,0,Mexico
83816,3/1/2024,MEX,Perlis,3,2,1,Mexico
83817,3/1/2024,MEX,Pulau Pinang,75,42,33,Mexico
83818,3/1/2024,MEX,Sabah,10,5,5,Mexico
83819,3/1/2024,MEX,Sarawak,1,0,1,Mexico
83820,3/1/2024,MEX,Selangor,1021,498,523,Mexico
83821,3/1/2024,MHL,Sabah,1,1,0,Marshall Islands
83822,3/1/2024,MKD,Johor,10,7,3,"Macedonia, the former Yugoslav Republic of"
83823,3/1/2024,MKD,Kedah,1,0,1,"Macedonia, the former Yugoslav Republic of"
83824,3/1/2024,MKD,Pulau Pinang,1,0,1,"Macedonia, the former Yugoslav Republic of"
83825,3/1/2024,MKD,Sabah,1,1,0,"Macedonia, the former Yugoslav Republic of"
83826,3/1/2024,MKD,Sarawak,2,1,1,"Macedonia, the former Yugoslav Republic of"
83827,3/1/2024,MKD,Selangor,32,15,17,"Macedonia, the former Yugoslav Republic of"
83828,3/1/2024,MLI,Selangor,5,4,1,Mali
83829,3/1/2024,MLT,Johor,17,8,9,Malta
83830,3/1/2024,MLT,Kedah,14,10,4,Malta
83831,3/1/2024,MLT,Perlis,2,0,2,Malta
83832,3/1/2024,MLT,Pulau Pinang,9,6,3,Malta
83833,3/1/2024,MLT,Sarawak,1,0,1,Malta
83834,3/1/2024,MLT,Selangor,50,30,20,Malta
83835,3/1/2024,MMR,Johor,8072,2349,5723,Myanmar
83836,3/1/2024,MMR,Kedah,128,26,102,Myanmar
83837,3/1/2024,MMR,Kelantan,4,2,2,Myanmar
83838,3/1/2024,MMR,Pahang,4,2,2,Myanmar
83839,3/1/2024,MMR,Perak,33,7,26,Myanmar
83840,3/1/2024,MMR,Perlis,9,1,8,Myanmar
83841,3/1/2024,MMR,Pulau Pinang,453,162,291,Myanmar
83842,3/1/2024,MMR,Sabah,18,6,12,Myanmar
83843,3/1/2024,MMR,Sarawak,95,48,47,Myanmar
83844,3/1/2024,MMR,Selangor,8089,5371,2718,Myanmar
83845,3/1/2024,MNE,Johor,3,3,0,Montenegro
83846,3/1/2024,MNE,Pulau Pinang,1,0,1,Montenegro
83847,3/1/2024,MNE,Selangor,18,12,6,Montenegro
83848,3/1/2024,MNG,Johor,153,60,93,Mongolia
83849,3/1/2024,MNG,Kedah,7,5,2,Mongolia
83850,3/1/2024,MNG,Perlis,6,2,4,Mongolia
83851,3/1/2024,MNG,Pulau Pinang,22,12,10,Mongolia
83852,3/1/2024,MNG,Sabah,2,0,2,Mongolia
83853,3/1/2024,MNG,Sarawak,1,0,1,Mongolia
83854,3/1/2024,MNG,Selangor,443,201,242,Mongolia
83855,3/1/2024,MOZ,Selangor,26,14,12,Mozambique
83856,3/1/2024,MRT,Johor,5,4,1,Mauritania
83857,3/1/2024,MRT,Selangor,21,18,3,Mauritania
83858,3/1/2024,MUS,Johor,130,62,68,Mauritius
83859,3/1/2024,MUS,Kedah,5,2,3,Mauritius
83860,3/1/2024,MUS,Pahang,6,2,4,Mauritius
83861,3/1/2024,MUS,Perlis,1,0,1,Mauritius
83862,3/1/2024,MUS,Pulau Pinang,16,10,6,Mauritius
83863,3/1/2024,MUS,Sabah,3,2,1,Mauritius
83864,3/1/2024,MUS,Selangor,1376,726,650,Mauritius
83865,3/1/2024,MWI,Pulau Pinang,3,2,1,Malawi
83866,3/1/2024,MWI,Selangor,20,14,6,Malawi
83867,3/1/2024,NAM,Johor,3,2,1,Namibia
83868,3/1/2024,NAM,Selangor,12,8,4,Namibia
83869,3/1/2024,NER,Selangor,2,1,1,Niger
83870,3/1/2024,NGA,Johor,30,27,3,Nigeria
83871,3/1/2024,NGA,Kedah,1,1,0,Nigeria
83872,3/1/2024,NGA,Pulau Pinang,18,11,7,Nigeria
83873,3/1/2024,NGA,Sarawak,7,7,0,Nigeria
83874,3/1/2024,NGA,Selangor,473,392,81,Nigeria
83875,3/1/2024,NIC,Johor,5,3,2,Nicaragua
83876,3/1/2024,NIC,Kedah,2,1,1,Nicaragua
83877,3/1/2024,NIC,Selangor,9,5,4,Nicaragua
83878,3/1/2024,NLD,Johor,1120,746,374,Netherlands
83879,3/1/2024,NLD,Kedah,515,256,259,Netherlands
83880,3/1/2024,NLD,Kelantan,7,6,1,Netherlands
83881,3/1/2024,NLD,Melaka,1,1,0,Netherlands
83882,3/1/2024,NLD,Pahang,5,3,2,Netherlands
83883,3/1/2024,NLD,Perak,21,11,10,Netherlands
83884,3/1/2024,NLD,Perlis,56,28,28,Netherlands
83885,3/1/2024,NLD,Pulau Pinang,382,223,159,Netherlands
83886,3/1/2024,NLD,Sabah,70,38,32,Netherlands
83887,3/1/2024,NLD,Sarawak,125,84,41,Netherlands
83888,3/1/2024,NLD,Selangor,4284,2507,1777,Netherlands
83889,3/1/2024,NLD,W.P. Labuan,4,2,2,Netherlands
83890,3/1/2024,NOR,Johor,218,130,88,Norway
83891,3/1/2024,NOR,Kedah,181,78,103,Norway
83892,3/1/2024,NOR,Kelantan,1,1,0,Norway
83893,3/1/2024,NOR,Perak,3,3,0,Norway
83894,3/1/2024,NOR,Perlis,12,6,6,Norway
83895,3/1/2024,NOR,Pulau Pinang,53,28,25,Norway
83896,3/1/2024,NOR,Sabah,26,14,12,Norway
83897,3/1/2024,NOR,Sarawak,16,13,3,Norway
83898,3/1/2024,NOR,Selangor,1053,541,512,Norway
83899,3/1/2024,NPL,Johor,697,458,239,Nepal
83900,3/1/2024,NPL,Kedah,24,12,12,Nepal
83901,3/1/2024,NPL,Perlis,1,1,0,Nepal
83902,3/1/2024,NPL,Pulau Pinang,34,25,9,Nepal
83903,3/1/2024,NPL,Sabah,4,2,2,Nepal
83904,3/1/2024,NPL,Sarawak,296,203,93,Nepal
83905,3/1/2024,NPL,Selangor,10524,9813,711,Nepal
83906,3/1/2024,NPL,W.P. Labuan,74,70,4,Nepal
83907,3/1/2024,NZL,Johor,800,484,316,New Zealand
83908,3/1/2024,NZL,Kedah,109,53,56,New Zealand
83909,3/1/2024,NZL,Kelantan,2,2,0,New Zealand
83910,3/1/2024,NZL,Pahang,3,3,0,New Zealand
83911,3/1/2024,NZL,Perak,24,13,11,New Zealand
83912,3/1/2024,NZL,Perlis,28,16,12,New Zealand
83913,3/1/2024,NZL,Pulau Pinang,284,149,135,New Zealand
83914,3/1/2024,NZL,Sabah,62,36,26,New Zealand
83915,3/1/2024,NZL,Sarawak,113,62,51,New Zealand
83916,3/1/2024,NZL,Selangor,2673,1645,1028,New Zealand
83917,3/1/2024,NZL,W.P. Labuan,1,1,0,New Zealand
83918,3/1/2024,OMN,Johor,2,1,1,Oman
83919,3/1/2024,OMN,Perlis,1,1,0,Oman
83920,3/1/2024,OMN,Pulau Pinang,3,1,2,Oman
83921,3/1/2024,OMN,Sabah,1,1,0,Oman
83922,3/1/2024,OMN,Sarawak,6,4,2,Oman
83923,3/1/2024,OMN,Selangor,232,163,69,Oman
83924,3/1/2024,PAK,Johor,574,453,121,Pakistan
83925,3/1/2024,PAK,Kedah,88,72,16,Pakistan
83926,3/1/2024,PAK,Kelantan,20,20,0,Pakistan
83927,3/1/2024,PAK,Perak,5,5,0,Pakistan
83928,3/1/2024,PAK,Perlis,14,14,0,Pakistan
83929,3/1/2024,PAK,Pulau Pinang,73,69,4,Pakistan
83930,3/1/2024,PAK,Sabah,7,6,1,Pakistan
83931,3/1/2024,PAK,Sarawak,154,134,20,Pakistan
83932,3/1/2024,PAK,Selangor,7606,6586,1020,Pakistan
83933,3/1/2024,PAK,W.P. Labuan,4,2,2,Pakistan
83934,3/1/2024,PAN,Johor,7,4,3,Panama
83935,3/1/2024,PAN,Kedah,4,3,1,Panama
83936,3/1/2024,PAN,Sabah,3,0,3,Panama
83937,3/1/2024,PAN,Selangor,27,12,15,Panama
83938,3/1/2024,PER,Johor,30,21,9,Peru
83939,3/1/2024,PER,Kedah,12,7,5,Peru
83940,3/1/2024,PER,Kelantan,2,1,1,Peru
83941,3/1/2024,PER,Pulau Pinang,4,2,2,Peru
83942,3/1/2024,PER,Sabah,1,1,0,Peru
83943,3/1/2024,PER,Sarawak,1,1,0,Peru
83944,3/1/2024,PER,Selangor,132,74,58,Peru
83945,3/1/2024,PHL,Johor,33147,10008,23139,Philippines
83946,3/1/2024,PHL,Kedah,587,170,417,Philippines
83947,3/1/2024,PHL,Kelantan,31,13,18,Philippines
83948,3/1/2024,PHL,Melaka,1,0,1,Philippines
83949,3/1/2024,PHL,Pahang,14,12,2,Philippines
83950,3/1/2024,PHL,Perak,83,21,62,Philippines
83951,3/1/2024,PHL,Perlis,177,67,110,Philippines
83952,3/1/2024,PHL,Pulau Pinang,1846,772,1074,Philippines
83953,3/1/2024,PHL,Sabah,2848,1111,1737,Philippines
83954,3/1/2024,PHL,Sarawak,3224,1321,1903,Philippines
83955,3/1/2024,PHL,Selangor,19596,7329,12267,Philippines
83956,3/1/2024,PHL,W.P. Labuan,117,47,70,Philippines
83957,3/1/2024,PNG,Johor,13,4,9,Papua New Guinea
83958,3/1/2024,PNG,Perak,3,2,1,Papua New Guinea
83959,3/1/2024,PNG,Pulau Pinang,1,0,1,Papua New Guinea
83960,3/1/2024,PNG,Selangor,85,57,28,Papua New Guinea
83961,3/1/2024,POL,Johor,555,319,236,Poland
83962,3/1/2024,POL,Kedah,349,174,175,Poland
83963,3/1/2024,POL,Kelantan,2,0,2,Poland
83964,3/1/2024,POL,Melaka,1,1,0,Poland
83965,3/1/2024,POL,Pahang,2,1,1,Poland
83966,3/1/2024,POL,Perak,3,1,2,Poland
83967,3/1/2024,POL,Perlis,48,24,24,Poland
83968,3/1/2024,POL,Pulau Pinang,115,60,55,Poland
83969,3/1/2024,POL,Sabah,33,16,17,Poland
83970,3/1/2024,POL,Sarawak,70,33,37,Poland
83971,3/1/2024,POL,Selangor,2549,1353,1196,Poland
83972,3/1/2024,POL,W.P. Labuan,1,1,0,Poland
83973,3/1/2024,PRT,Johor,211,119,92,Portugal
83974,3/1/2024,PRT,Kedah,110,58,52,Portugal
83975,3/1/2024,PRT,Melaka,3,2,1,Portugal
83976,3/1/2024,PRT,Pahang,2,1,1,Portugal
83977,3/1/2024,PRT,Perak,3,2,1,Portugal
83978,3/1/2024,PRT,Perlis,9,8,1,Portugal
83979,3/1/2024,PRT,Pulau Pinang,60,32,28,Portugal
83980,3/1/2024,PRT,Sabah,32,15,17,Portugal
83981,3/1/2024,PRT,Sarawak,14,10,4,Portugal
83982,3/1/2024,PRT,Selangor,1072,576,496,Portugal
83983,3/1/2024,PRY,Johor,6,5,1,Paraguay
83984,3/1/2024,PRY,Pulau Pinang,1,0,1,Paraguay
83985,3/1/2024,PRY,Selangor,12,5,7,Paraguay
83986,3/1/2024,PSE,Johor,23,21,2,"Palestinian Territory, Occupied"
83987,3/1/2024,PSE,Kedah,3,3,0,"Palestinian Territory, Occupied"
83988,3/1/2024,PSE,Pulau Pinang,1,1,0,"Palestinian Territory, Occupied"
83989,3/1/2024,PSE,Selangor,187,133,54,"Palestinian Territory, Occupied"
83990,3/1/2024,QAT,Sarawak,2,1,1,Qatar
83991,3/1/2024,QAT,Selangor,27,25,2,Qatar
83992,3/1/2024,ROU,Johor,184,102,82,Romania
83993,3/1/2024,ROU,Kedah,106,48,58,Romania
83994,3/1/2024,ROU,Kelantan,1,1,0,Romania
83995,3/1/2024,ROU,Perak,3,3,0,Romania
83996,3/1/2024,ROU,Perlis,1,1,0,Romania
83997,3/1/2024,ROU,Pulau Pinang,38,19,19,Romania
83998,3/1/2024,ROU,Sabah,23,12,11,Romania
83999,3/1/2024,ROU,Sarawak,6,5,1,Romania
84000,3/1/2024,ROU,Selangor,982,501,481,Romania
84001,3/1/2024,RUS,Johor,531,251,280,Russia
84002,3/1/2024,RUS,Kedah,736,350,386,Russia
84003,3/1/2024,RUS,Kelantan,47,24,23,Russia
84004,3/1/2024,RUS,Melaka,2,2,0,Russia
84005,3/1/2024,RUS,Perak,17,8,9,Russia
84006,3/1/2024,RUS,Perlis,94,61,33,Russia
84007,3/1/2024,RUS,Pulau Pinang,181,84,97,Russia
84008,3/1/2024,RUS,Sabah,75,36,39,Russia
84009,3/1/2024,RUS,Sarawak,45,24,21,Russia
84010,3/1/2024,RUS,Selangor,13160,6212,6948,Russia
84011,3/1/2024,RUS,W.P. Labuan,14,5,9,Russia
84012,3/1/2024,RWA,Johor,1,0,1,Rwanda
84013,3/1/2024,RWA,Selangor,12,9,3,Rwanda
84014,3/1/2024,SAU,Johor,141,79,62,Saudi Arabia
84015,3/1/2024,SAU,Kedah,6,5,1,Saudi Arabia
84016,3/1/2024,SAU,Kelantan,2,2,0,Saudi Arabia
84017,3/1/2024,SAU,Pulau Pinang,13,11,2,Saudi Arabia
84018,3/1/2024,SAU,Sarawak,23,14,9,Saudi Arabia
84019,3/1/2024,SAU,Selangor,954,647,307,Saudi Arabia
84020,3/1/2024,SDN,Johor,14,11,3,Sudan
84021,3/1/2024,SDN,Kedah,5,2,3,Sudan
84022,3/1/2024,SDN,Pulau Pinang,6,2,4,Sudan
84023,3/1/2024,SDN,Sarawak,7,4,3,Sudan
84024,3/1/2024,SDN,Selangor,856,554,302,Sudan
84025,3/1/2024,SEN,Johor,5,5,0,Senegal
84026,3/1/2024,SEN,Selangor,44,30,14,Senegal
84027,3/1/2024,SGP,Johor,1526600,847751,678849,Singapore
84028,3/1/2024,SGP,Kedah,4647,2479,2168,Singapore
84029,3/1/2024,SGP,Kelantan,79,53,26,Singapore
84030,3/1/2024,SGP,Melaka,16,12,4,Singapore
84031,3/1/2024,SGP,Negeri Sembilan,7,5,2,Singapore
84032,3/1/2024,SGP,Pahang,773,399,374,Singapore
84033,3/1/2024,SGP,Perak,7501,3513,3988,Singapore
84034,3/1/2024,SGP,Perlis,214,123,91,Singapore
84035,3/1/2024,SGP,Pulau Pinang,29565,14270,15295,Singapore
84036,3/1/2024,SGP,Sabah,2587,1296,1291,Singapore
84037,3/1/2024,SGP,Sarawak,4245,2244,2001,Singapore
84038,3/1/2024,SGP,Selangor,50305,26052,24253,Singapore
84039,3/1/2024,SGP,W.P. Labuan,13,12,1,Singapore
84040,3/1/2024,SLB,Johor,1,1,0,Solomon Islands
84041,3/1/2024,SLB,Pulau Pinang,1,1,0,Solomon Islands
84042,3/1/2024,SLB,Sarawak,20,2,18,Solomon Islands
84043,3/1/2024,SLB,Selangor,10,7,3,Solomon Islands
84044,3/1/2024,SLE,Johor,2,2,0,Sierra Leone
84045,3/1/2024,SLE,Selangor,28,24,4,Sierra Leone
84046,3/1/2024,SLV,Johor,1,1,0,El Salvador
84047,3/1/2024,SLV,Pulau Pinang,1,0,1,El Salvador
84048,3/1/2024,SLV,Sarawak,1,1,0,El Salvador
84049,3/1/2024,SLV,Selangor,13,9,4,El Salvador
84050,3/1/2024,SMR,Kedah,2,1,1,San Marino
84051,3/1/2024,SMR,Selangor,3,2,1,San Marino
84052,3/1/2024,SOM,Selangor,230,135,95,Somalia
84053,3/1/2024,SRB,Johor,15,12,3,Serbia
84054,3/1/2024,SRB,Kedah,7,5,2,Serbia
84055,3/1/2024,SRB,Pulau Pinang,4,2,2,Serbia
84056,3/1/2024,SRB,Sabah,1,0,1,Serbia
84057,3/1/2024,SRB,Sarawak,2,0,2,Serbia
84058,3/1/2024,SRB,Selangor,124,62,62,Serbia
84059,3/1/2024,SUR,Johor,1,1,0,Suriname
84060,3/1/2024,SUR,Kedah,4,1,3,Suriname
84061,3/1/2024,SUR,Pulau Pinang,2,2,0,Suriname
84062,3/1/2024,SUR,Selangor,16,15,1,Suriname
84063,3/1/2024,SVK,Johor,49,29,20,Slovakia
84064,3/1/2024,SVK,Kedah,266,146,120,Slovakia
84065,3/1/2024,SVK,Kelantan,3,2,1,Slovakia
84066,3/1/2024,SVK,Perak,2,1,1,Slovakia
84067,3/1/2024,SVK,Perlis,1,1,0,Slovakia
84068,3/1/2024,SVK,Pulau Pinang,30,15,15,Slovakia
84069,3/1/2024,SVK,Sabah,17,7,10,Slovakia
84070,3/1/2024,SVK,Sarawak,4,3,1,Slovakia
84071,3/1/2024,SVK,Selangor,671,336,335,Slovakia
84072,3/1/2024,SVK,W.P. Labuan,12,8,4,Slovakia
84073,3/1/2024,SVN,Johor,31,16,15,Slovenia
84074,3/1/2024,SVN,Kedah,60,30,30,Slovenia
84075,3/1/2024,SVN,Perak,2,1,1,Slovenia
84076,3/1/2024,SVN,Perlis,3,2,1,Slovenia
84077,3/1/2024,SVN,Pulau Pinang,3,2,1,Slovenia
84078,3/1/2024,SVN,Sabah,5,3,2,Slovenia
84079,3/1/2024,SVN,Sarawak,1,0,1,Slovenia
84080,3/1/2024,SVN,Selangor,269,137,132,Slovenia
84081,3/1/2024,SVN,W.P. Labuan,2,1,1,Slovenia
84082,3/1/2024,SWE,Johor,296,172,124,Sweden
84083,3/1/2024,SWE,Kedah,429,190,239,Sweden
84084,3/1/2024,SWE,Perak,7,6,1,Sweden
84085,3/1/2024,SWE,Perlis,18,13,5,Sweden
84086,3/1/2024,SWE,Pulau Pinang,109,72,37,Sweden
84087,3/1/2024,SWE,Sabah,41,19,22,Sweden
84088,3/1/2024,SWE,Sarawak,16,11,5,Sweden
84089,3/1/2024,SWE,Selangor,1518,862,656,Sweden
84090,3/1/2024,SWE,W.P. Labuan,2,2,0,Sweden
84091,3/1/2024,SWZ,Johor,1,1,0,Swaziland
84092,3/1/2024,SWZ,Pulau Pinang,1,1,0,Swaziland
84093,3/1/2024,SWZ,Selangor,22,10,12,Swaziland
84094,3/1/2024,SYC,Johor,3,2,1,Seychelles
84095,3/1/2024,SYC,Selangor,56,19,37,Seychelles
84096,3/1/2024,SYR,Johor,22,19,3,Syrian Arab Republic
84097,3/1/2024,SYR,Kedah,9,6,3,Syrian Arab Republic
84098,3/1/2024,SYR,Kelantan,1,0,1,Syrian Arab Republic
84099,3/1/2024,SYR,Pahang,1,1,0,Syrian Arab Republic
84100,3/1/2024,SYR,Pulau Pinang,8,4,4,Syrian Arab Republic
84101,3/1/2024,SYR,Sabah,4,4,0,Syrian Arab Republic
84102,3/1/2024,SYR,Sarawak,4,4,0,Syrian Arab Republic
84103,3/1/2024,SYR,Selangor,414,283,131,Syrian Arab Republic
84104,3/1/2024,TCD,Johor,3,2,1,Chad
84105,3/1/2024,TCD,Selangor,26,20,6,Chad
84106,3/1/2024,TGO,Pulau Pinang,1,1,0,Togo
84107,3/1/2024,TGO,Selangor,10,9,1,Togo
84108,3/1/2024,THA,Johor,7453,1938,5515,Thailand
84109,3/1/2024,THA,Kedah,70841,41721,29120,Thailand
84110,3/1/2024,THA,Kelantan,59952,29221,30731,Thailand
84111,3/1/2024,THA,Melaka,1,1,0,Thailand
84112,3/1/2024,THA,Negeri Sembilan,2,2,0,Thailand
84113,3/1/2024,THA,Pahang,10,10,0,Thailand
84114,3/1/2024,THA,Perak,12720,5999,6721,Thailand
84115,3/1/2024,THA,Perlis,55102,32181,22921,Thailand
84116,3/1/2024,THA,Pulau Pinang,3414,1357,2057,Thailand
84117,3/1/2024,THA,Sabah,46,20,26,Thailand
84118,3/1/2024,THA,Sarawak,457,152,305,Thailand
84119,3/1/2024,THA,Selangor,15000,5812,9188,Thailand
84120,3/1/2024,THA,Terengganu,2,2,0,Thailand
84121,3/1/2024,THA,W.P. Labuan,12,6,6,Thailand
84122,3/1/2024,TJK,Johor,2,2,0,Tajikistan
84123,3/1/2024,TJK,Sabah,2,2,0,Tajikistan
84124,3/1/2024,TJK,Selangor,104,60,44,Tajikistan
84125,3/1/2024,TKM,Johor,11,5,6,Turkmenistan
84126,3/1/2024,TKM,Kelantan,1,1,0,Turkmenistan
84127,3/1/2024,TKM,Selangor,1093,456,637,Turkmenistan
84128,3/1/2024,TLS,Johor,3,3,0,Timor-Leste
84129,3/1/2024,TLS,Kedah,6,1,5,Timor-Leste
84130,3/1/2024,TLS,Pulau Pinang,1,1,0,Timor-Leste
84131,3/1/2024,TLS,Sabah,1,0,1,Timor-Leste
84132,3/1/2024,TLS,Sarawak,7,7,0,Timor-Leste
84133,3/1/2024,TLS,Selangor,288,142,146,Timor-Leste
84134,3/1/2024,TON,Pulau Pinang,2,0,2,Tonga
84135,3/1/2024,TON,Selangor,12,6,6,Tonga
84136,3/1/2024,TTO,Johor,4,2,2,Trinidad and Tobago
84137,3/1/2024,TTO,Pulau Pinang,2,1,1,Trinidad and Tobago
84138,3/1/2024,TTO,Sabah,2,0,2,Trinidad and Tobago
84139,3/1/2024,TTO,Selangor,30,17,13,Trinidad and Tobago
84140,3/1/2024,TUN,Johor,17,9,8,Tunisia
84141,3/1/2024,TUN,Kedah,13,7,6,Tunisia
84142,3/1/2024,TUN,Perlis,2,0,2,Tunisia
84143,3/1/2024,TUN,Pulau Pinang,4,2,2,Tunisia
84144,3/1/2024,TUN,Sabah,4,3,1,Tunisia
84145,3/1/2024,TUN,Sarawak,1,1,0,Tunisia
84146,3/1/2024,TUN,Selangor,332,202,130,Tunisia
84147,3/1/2024,TUR,Johor,324,249,75,Turkey
84148,3/1/2024,TUR,Kedah,64,43,21,Turkey
84149,3/1/2024,TUR,Kelantan,8,7,1,Turkey
84150,3/1/2024,TUR,Melaka,1,1,0,Turkey
84151,3/1/2024,TUR,Pahang,3,2,1,Turkey
84152,3/1/2024,TUR,Perak,2,1,1,Turkey
84153,3/1/2024,TUR,Perlis,21,15,6,Turkey
84154,3/1/2024,TUR,Pulau Pinang,45,32,13,Turkey
84155,3/1/2024,TUR,Sabah,6,3,3,Turkey
84156,3/1/2024,TUR,Sarawak,26,19,7,Turkey
84157,3/1/2024,TUR,Selangor,1769,1281,488,Turkey
84158,3/1/2024,TUV,Selangor,2,1,1,Tuvalu
84159,3/1/2024,TWN,Johor,7056,3014,4042,Taiwan
84160,3/1/2024,TWN,Kedah,204,103,101,Taiwan
84161,3/1/2024,TWN,Kelantan,2,1,1,Taiwan
84162,3/1/2024,TWN,Melaka,8,5,3,Taiwan
84163,3/1/2024,TWN,Pahang,6,6,0,Taiwan
84164,3/1/2024,TWN,Perak,63,23,40,Taiwan
84165,3/1/2024,TWN,Perlis,27,14,13,Taiwan
84166,3/1/2024,TWN,Pulau Pinang,4309,2023,2286,Taiwan
84167,3/1/2024,TWN,Sabah,2173,992,1181,Taiwan
84168,3/1/2024,TWN,Sarawak,473,200,273,Taiwan
84169,3/1/2024,TWN,Selangor,16818,7775,9043,Taiwan
84170,3/1/2024,TWN,W.P. Labuan,2,1,1,Taiwan
84171,3/1/2024,TZA,Johor,25,12,13,"Tanzania, United Republic of"
84172,3/1/2024,TZA,Kedah,3,1,2,"Tanzania, United Republic of"
84173,3/1/2024,TZA,Pulau Pinang,4,3,1,"Tanzania, United Republic of"
84174,3/1/2024,TZA,Sarawak,1,1,0,"Tanzania, United Republic of"
84175,3/1/2024,TZA,Selangor,168,93,75,"Tanzania, United Republic of"
84176,3/1/2024,UGA,Johor,44,29,15,Uganda
84177,3/1/2024,UGA,Kedah,2,0,2,Uganda
84178,3/1/2024,UGA,Pulau Pinang,9,7,2,Uganda
84179,3/1/2024,UGA,Sarawak,1,1,0,Uganda
84180,3/1/2024,UGA,Selangor,123,50,73,Uganda
84181,3/1/2024,UKR,Johor,134,56,78,Ukraine
84182,3/1/2024,UKR,Kedah,63,26,37,Ukraine
84183,3/1/2024,UKR,Kelantan,21,9,12,Ukraine
84184,3/1/2024,UKR,Pahang,2,2,0,Ukraine
84185,3/1/2024,UKR,Perak,1,0,1,Ukraine
84186,3/1/2024,UKR,Perlis,9,2,7,Ukraine
84187,3/1/2024,UKR,Pulau Pinang,36,17,19,Ukraine
84188,3/1/2024,UKR,Sabah,7,2,5,Ukraine
84189,3/1/2024,UKR,Selangor,1528,685,843,Ukraine
84190,3/1/2024,URY,Johor,85,39,46,Uruguay
84191,3/1/2024,URY,Kedah,4,3,1,Uruguay
84192,3/1/2024,URY,Pulau Pinang,1,0,1,Uruguay
84193,3/1/2024,URY,Selangor,81,43,38,Uruguay
84194,3/1/2024,USA,Johor,5854,3228,2626,United States Of America
84195,3/1/2024,USA,Kedah,645,331,314,United States Of America
84196,3/1/2024,USA,Kelantan,18,13,5,United States Of America
84197,3/1/2024,USA,Melaka,9,5,4,United States Of America
84198,3/1/2024,USA,Negeri Sembilan,2,2,0,United States Of America
84199,3/1/2024,USA,Pahang,20,12,8,United States Of America
84200,3/1/2024,USA,Perak,122,73,49,United States Of America
84201,3/1/2024,USA,Perlis,134,85,49,United States Of America
84202,3/1/2024,USA,Pulau Pinang,3836,2089,1747,United States Of America
84203,3/1/2024,USA,Sabah,535,278,257,United States Of America
84204,3/1/2024,USA,Sarawak,344,205,139,United States Of America
84205,3/1/2024,USA,Selangor,17483,10097,7386,United States Of America
84206,3/1/2024,USA,Terengganu,2,1,1,United States Of America
84207,3/1/2024,USA,W.P. Labuan,1,0,1,United States Of America
84208,3/1/2024,UZB,Johor,106,83,23,Uzbekistan
84209,3/1/2024,UZB,Kedah,15,8,7,Uzbekistan
84210,3/1/2024,UZB,Kelantan,6,5,1,Uzbekistan
84211,3/1/2024,UZB,Perlis,1,0,1,Uzbekistan
84212,3/1/2024,UZB,Pulau Pinang,4,3,1,Uzbekistan
84213,3/1/2024,UZB,Sabah,6,2,4,Uzbekistan
84214,3/1/2024,UZB,Sarawak,1,0,1,Uzbekistan
84215,3/1/2024,UZB,Selangor,1092,602,490,Uzbekistan
84216,3/1/2024,VAT,Johor,1,1,0,Holy See (Vatican City State)
84217,3/1/2024,VCT,Selangor,5,3,2,Saint Vincent and the Grenadines
84218,3/1/2024,VEN,Johor,17,5,12,Venezuela
84219,3/1/2024,VEN,Kedah,1,1,0,Venezuela
84220,3/1/2024,VEN,Kelantan,1,0,1,Venezuela
84221,3/1/2024,VEN,Pulau Pinang,1,1,0,Venezuela
84222,3/1/2024,VEN,Sabah,2,0,2,Venezuela
84223,3/1/2024,VEN,Sarawak,2,2,0,Venezuela
84224,3/1/2024,VEN,Selangor,112,60,52,Venezuela
84225,3/1/2024,VNM,Johor,14980,4606,10374,Vietnam
84226,3/1/2024,VNM,Kedah,346,45,301,Vietnam
84227,3/1/2024,VNM,Kelantan,10,7,3,Vietnam
84228,3/1/2024,VNM,Melaka,3,1,2,Vietnam
84229,3/1/2024,VNM,Pahang,2,0,2,Vietnam
84230,3/1/2024,VNM,Perak,113,2,111,Vietnam
84231,3/1/2024,VNM,Perlis,231,19,212,Vietnam
84232,3/1/2024,VNM,Pulau Pinang,1509,462,1047,Vietnam
84233,3/1/2024,VNM,Sabah,39,9,30,Vietnam
84234,3/1/2024,VNM,Sarawak,369,57,312,Vietnam
84235,3/1/2024,VNM,Selangor,18672,6372,12300,Vietnam
84236,3/1/2024,VNM,W.P. Labuan,4,4,0,Vietnam
84237,3/1/2024,VUT,Johor,32,21,11,Vanuatu
84238,3/1/2024,VUT,Kedah,1,1,0,Vanuatu
84239,3/1/2024,VUT,Perlis,1,1,0,Vanuatu
84240,3/1/2024,VUT,Pulau Pinang,6,4,2,Vanuatu
84241,3/1/2024,VUT,Sabah,5,4,1,Vanuatu
84242,3/1/2024,VUT,Selangor,84,72,12,Vanuatu
84243,3/1/2024,WSM,Sarawak,1,0,1,Samoa
84244,3/1/2024,WSM,Selangor,2,1,1,Samoa
84245,3/1/2024,YEM,Johor,24,19,5,Yemen
84246,3/1/2024,YEM,Kedah,3,2,1,Yemen
84247,3/1/2024,YEM,Kelantan,1,0,1,Yemen
84248,3/1/2024,YEM,Melaka,3,2,1,Yemen
84249,3/1/2024,YEM,Pulau Pinang,7,7,0,Yemen
84250,3/1/2024,YEM,Selangor,801,626,175,Yemen
84251,3/1/2024,ZAF,Johor,245,150,95,South Africa
84252,3/1/2024,ZAF,Kedah,68,40,28,South Africa
84253,3/1/2024,ZAF,Perak,2,2,0,South Africa
84254,3/1/2024,ZAF,Perlis,18,9,9,South Africa
84255,3/1/2024,ZAF,Pulau Pinang,111,54,57,South Africa
84256,3/1/2024,ZAF,Sabah,33,16,17,South Africa
84257,3/1/2024,ZAF,Sarawak,142,60,82,South Africa
84258,3/1/2024,ZAF,Selangor,1020,588,432,South Africa
84259,3/1/2024,ZAF,W.P. Labuan,38,21,17,South Africa
84260,3/1/2024,ZMB,Johor,3,1,2,Zambia
84261,3/1/2024,ZMB,Pulau Pinang,2,0,2,Zambia
84262,3/1/2024,ZMB,Selangor,69,39,30,Zambia
84263,3/1/2024,ZWE,Johor,21,11,10,Zimbabwe
84264,3/1/2024,ZWE,Kelantan,1,0,1,Zimbabwe
84265,3/1/2024,ZWE,Pulau Pinang,4,1,3,Zimbabwe
84266,3/1/2024,ZWE,Selangor,114,57,57,Zimbabwe
84267,4/1/2024,AFG,Pulau Pinang,1,1,0,Afghanistan
84268,4/1/2024,AFG,Sarawak,1,1,0,Afghanistan
84269,4/1/2024,AFG,Selangor,75,54,21,Afghanistan
84270,4/1/2024,AGO,Selangor,2,1,1,Angola
84271,4/1/2024,ALB,Johor,14,9,5,Albania
84272,4/1/2024,ALB,Perlis,1,0,1,Albania
84273,4/1/2024,ALB,Selangor,36,19,17,Albania
84274,4/1/2024,AND,Selangor,5,3,2,Andorra
84275,4/1/2024,ARE,Johor,20,8,12,United Arab Emirates
84276,4/1/2024,ARE,Kedah,14,9,5,United Arab Emirates
84277,4/1/2024,ARE,Pulau Pinang,5,5,0,United Arab Emirates
84278,4/1/2024,ARE,Sabah,3,3,0,United Arab Emirates
84279,4/1/2024,ARE,Selangor,486,278,208,United Arab Emirates
84280,4/1/2024,ARG,Johor,91,51,40,Argentina
84281,4/1/2024,ARG,Kedah,75,35,40,Argentina
84282,4/1/2024,ARG,Perak,1,0,1,Argentina
84283,4/1/2024,ARG,Perlis,5,2,3,Argentina
84284,4/1/2024,ARG,Pulau Pinang,9,4,5,Argentina
84285,4/1/2024,ARG,Sarawak,6,3,3,Argentina
84286,4/1/2024,ARG,Selangor,470,228,242,Argentina
84287,4/1/2024,ARM,Johor,32,9,23,Armenia
84288,4/1/2024,ARM,Kedah,1,0,1,Armenia
84289,4/1/2024,ARM,Pulau Pinang,1,1,0,Armenia
84290,4/1/2024,ARM,Sabah,1,0,1,Armenia
84291,4/1/2024,ARM,Selangor,74,24,50,Armenia
84292,4/1/2024,ATG,Johor,2,1,1,Antigua and Barbuda
84293,4/1/2024,ATG,Pulau Pinang,1,1,0,Antigua and Barbuda
84294,4/1/2024,ATG,Selangor,11,6,5,Antigua and Barbuda
84295,4/1/2024,AUS,Johor,6363,3674,2689,Australia
84296,4/1/2024,AUS,Kedah,872,436,436,Australia
84297,4/1/2024,AUS,Kelantan,37,30,7,Australia
84298,4/1/2024,AUS,Negeri Sembilan,3,3,0,Australia
84299,4/1/2024,AUS,Pahang,38,19,19,Australia
84300,4/1/2024,AUS,Perak,198,102,96,Australia
84301,4/1/2024,AUS,Perlis,98,67,31,Australia
84302,4/1/2024,AUS,Pulau Pinang,1762,940,822,Australia
84303,4/1/2024,AUS,Sabah,440,213,227,Australia
84304,4/1/2024,AUS,Sarawak,541,318,223,Australia
84305,4/1/2024,AUS,Selangor,22503,12906,9597,Australia
84306,4/1/2024,AUS,W.P. Labuan,13,7,6,Australia
84307,4/1/2024,AUT,Johor,178,122,56,Austria
84308,4/1/2024,AUT,Kedah,73,39,34,Austria
84309,4/1/2024,AUT,Kelantan,3,3,0,Austria
84310,4/1/2024,AUT,Perak,2,1,1,Austria
84311,4/1/2024,AUT,Perlis,3,2,1,Austria
84312,4/1/2024,AUT,Pulau Pinang,58,37,21,Austria
84313,4/1/2024,AUT,Sabah,11,7,4,Austria
84314,4/1/2024,AUT,Sarawak,44,25,19,Austria
84315,4/1/2024,AUT,Selangor,790,472,318,Austria
84316,4/1/2024,AZE,Johor,14,9,5,Azerbaijan
84317,4/1/2024,AZE,Kedah,3,2,1,Azerbaijan
84318,4/1/2024,AZE,Pulau Pinang,1,0,1,Azerbaijan
84319,4/1/2024,AZE,Sarawak,2,2,0,Azerbaijan
84320,4/1/2024,AZE,Selangor,145,88,57,Azerbaijan
84321,4/1/2024,BDI,Selangor,4,2,2,Burundi
84322,4/1/2024,BEL,Johor,285,167,118,Belgium
84323,4/1/2024,BEL,Kedah,133,71,62,Belgium
84324,4/1/2024,BEL,Kelantan,2,2,0,Belgium
84325,4/1/2024,BEL,Melaka,2,0,2,Belgium
84326,4/1/2024,BEL,Perak,3,2,1,Belgium
84327,4/1/2024,BEL,Perlis,12,10,2,Belgium
84328,4/1/2024,BEL,Pulau Pinang,79,45,34,Belgium
84329,4/1/2024,BEL,Sabah,27,16,11,Belgium
84330,4/1/2024,BEL,Sarawak,32,20,12,Belgium
84331,4/1/2024,BEL,Selangor,1378,813,565,Belgium
84332,4/1/2024,BEN,Johor,1,1,0,Benin
84333,4/1/2024,BEN,Selangor,11,5,6,Benin
84334,4/1/2024,BFA,Selangor,6,5,1,Burkina Faso
84335,4/1/2024,BGD,Johor,2893,2245,648,Bangladesh
84336,4/1/2024,BGD,Kedah,132,77,55,Bangladesh
84337,4/1/2024,BGD,Kelantan,2,2,0,Bangladesh
84338,4/1/2024,BGD,Perak,4,4,0,Bangladesh
84339,4/1/2024,BGD,Perlis,3,3,0,Bangladesh
84340,4/1/2024,BGD,Pulau Pinang,124,95,29,Bangladesh
84341,4/1/2024,BGD,Sabah,2,2,0,Bangladesh
84342,4/1/2024,BGD,Sarawak,115,81,34,Bangladesh
84343,4/1/2024,BGD,Selangor,25169,22729,2440,Bangladesh
84344,4/1/2024,BGD,W.P. Labuan,5,2,3,Bangladesh
84345,4/1/2024,BGR,Johor,76,42,34,Bulgaria
84346,4/1/2024,BGR,Kedah,23,13,10,Bulgaria
84347,4/1/2024,BGR,Kelantan,1,1,0,Bulgaria
84348,4/1/2024,BGR,Perak,4,3,1,Bulgaria
84349,4/1/2024,BGR,Pulau Pinang,1,1,0,Bulgaria
84350,4/1/2024,BGR,Sabah,1,1,0,Bulgaria
84351,4/1/2024,BGR,Sarawak,1,0,1,Bulgaria
84352,4/1/2024,BGR,Selangor,302,158,144,Bulgaria
84353,4/1/2024,BHR,Johor,15,10,5,Bahrain
84354,4/1/2024,BHR,Kedah,12,4,8,Bahrain
84355,4/1/2024,BHR,Pulau Pinang,2,1,1,Bahrain
84356,4/1/2024,BHR,Selangor,79,48,31,Bahrain
84357,4/1/2024,BHS,Johor,1,0,1,Bahamas
84358,4/1/2024,BHS,Selangor,12,7,5,Bahamas
84359,4/1/2024,BIH,Johor,11,6,5,Bosnia and Herzegovina
84360,4/1/2024,BIH,Kedah,3,0,3,Bosnia and Herzegovina
84361,4/1/2024,BIH,Pulau Pinang,3,1,2,Bosnia and Herzegovina
84362,4/1/2024,BIH,Sabah,1,1,0,Bosnia and Herzegovina
84363,4/1/2024,BIH,Sarawak,3,3,0,Bosnia and Herzegovina
84364,4/1/2024,BIH,Selangor,50,30,20,Bosnia and Herzegovina
84365,4/1/2024,BLR,Johor,11,5,6,Belarus
84366,4/1/2024,BLR,Kedah,19,8,11,Belarus
84367,4/1/2024,BLR,Kelantan,2,1,1,Belarus
84368,4/1/2024,BLR,Perlis,1,1,0,Belarus
84369,4/1/2024,BLR,Pulau Pinang,9,4,5,Belarus
84370,4/1/2024,BLR,Sabah,3,1,2,Belarus
84371,4/1/2024,BLR,Sarawak,5,2,3,Belarus
84372,4/1/2024,BLR,Selangor,493,218,275,Belarus
84373,4/1/2024,BLZ,Johor,3,2,1,Belize
84374,4/1/2024,BLZ,Selangor,3,2,1,Belize
84375,4/1/2024,BMU,Selangor,3,0,3,Bermuda
84376,4/1/2024,BOL,Johor,1,1,0,Bolivia
84377,4/1/2024,BOL,Pulau Pinang,3,1,2,Bolivia
84378,4/1/2024,BOL,Sarawak,5,3,2,Bolivia
84379,4/1/2024,BOL,Selangor,22,10,12,Bolivia
84380,4/1/2024,BRA,Johor,281,142,139,Brazil
84381,4/1/2024,BRA,Kedah,105,47,58,Brazil
84382,4/1/2024,BRA,Pahang,3,1,2,Brazil
84383,4/1/2024,BRA,Perak,3,1,2,Brazil
84384,4/1/2024,BRA,Perlis,5,1,4,Brazil
84385,4/1/2024,BRA,Pulau Pinang,25,20,5,Brazil
84386,4/1/2024,BRA,Sabah,11,4,7,Brazil
84387,4/1/2024,BRA,Sarawak,9,6,3,Brazil
84388,4/1/2024,BRA,Selangor,1077,592,485,Brazil
84389,4/1/2024,BRB,Johor,1,0,1,Barbados
84390,4/1/2024,BRB,Kedah,1,1,0,Barbados
84391,4/1/2024,BRB,Selangor,8,5,3,Barbados
84392,4/1/2024,BRN,Johor,389,200,189,Brunei Darussalam
84393,4/1/2024,BRN,Kedah,24,16,8,Brunei Darussalam
84394,4/1/2024,BRN,Kelantan,23,9,14,Brunei Darussalam
84395,4/1/2024,BRN,Melaka,5,2,3,Brunei Darussalam
84396,4/1/2024,BRN,Perak,2,2,0,Brunei Darussalam
84397,4/1/2024,BRN,Perlis,10,6,4,Brunei Darussalam
84398,4/1/2024,BRN,Pulau Pinang,15,7,8,Brunei Darussalam
84399,4/1/2024,BRN,Sabah,1126,473,653,Brunei Darussalam
84400,4/1/2024,BRN,Sarawak,160441,84838,75603,Brunei Darussalam
84401,4/1/2024,BRN,Selangor,5530,2753,2777,Brunei Darussalam
84402,4/1/2024,BRN,W.P. Labuan,1402,840,562,Brunei Darussalam
84403,4/1/2024,BTN,Johor,15,12,3,Bhutan
84404,4/1/2024,BTN,Pulau Pinang,1,1,0,Bhutan
84405,4/1/2024,BTN,Selangor,38,22,16,Bhutan
84406,4/1/2024,BWA,Johor,1,1,0,Botswana
84407,4/1/2024,BWA,Pulau Pinang,1,0,1,Botswana
84408,4/1/2024,BWA,Selangor,11,3,8,Botswana
84409,4/1/2024,CAN,Johor,1586,887,699,Canada
84410,4/1/2024,CAN,Kedah,253,132,121,Canada
84411,4/1/2024,CAN,Kelantan,7,5,2,Canada
84412,4/1/2024,CAN,Negeri Sembilan,6,3,3,Canada
84413,4/1/2024,CAN,Pahang,7,3,4,Canada
84414,4/1/2024,CAN,Perak,33,17,16,Canada
84415,4/1/2024,CAN,Perlis,50,34,16,Canada
84416,4/1/2024,CAN,Pulau Pinang,485,259,226,Canada
84417,4/1/2024,CAN,Sabah,159,87,72,Canada
84418,4/1/2024,CAN,Sarawak,415,242,173,Canada
84419,4/1/2024,CAN,Selangor,4897,2741,2156,Canada
84420,4/1/2024,CAN,W.P. Labuan,9,3,6,Canada
84421,4/1/2024,CHE,Johor,539,303,236,Switzerland
84422,4/1/2024,CHE,Kedah,241,115,126,Switzerland
84423,4/1/2024,CHE,Kelantan,3,2,1,Switzerland
84424,4/1/2024,CHE,Negeri Sembilan,2,1,1,Switzerland
84425,4/1/2024,CHE,Pahang,9,4,5,Switzerland
84426,4/1/2024,CHE,Perak,10,8,2,Switzerland
84427,4/1/2024,CHE,Perlis,47,23,24,Switzerland
84428,4/1/2024,CHE,Pulau Pinang,155,94,61,Switzerland
84429,4/1/2024,CHE,Sabah,41,24,17,Switzerland
84430,4/1/2024,CHE,Sarawak,42,22,20,Switzerland
84431,4/1/2024,CHE,Selangor,1589,909,680,Switzerland
84432,4/1/2024,CHL,Johor,35,17,18,Chile
84433,4/1/2024,CHL,Kedah,28,11,17,Chile
84434,4/1/2024,CHL,Kelantan,2,0,2,Chile
84435,4/1/2024,CHL,Perlis,1,0,1,Chile
84436,4/1/2024,CHL,Pulau Pinang,10,6,4,Chile
84437,4/1/2024,CHL,Sabah,6,3,3,Chile
84438,4/1/2024,CHL,Selangor,307,157,150,Chile
84439,4/1/2024,CHN,Johor,76729,33387,43342,China
84440,4/1/2024,CHN,Kedah,2005,843,1162,China
84441,4/1/2024,CHN,Kelantan,38,21,17,China
84442,4/1/2024,CHN,Melaka,6,6,0,China
84443,4/1/2024,CHN,Negeri Sembilan,1,1,0,China
84444,4/1/2024,CHN,Pahang,31,16,15,China
84445,4/1/2024,CHN,Perak,402,190,212,China
84446,4/1/2024,CHN,Perlis,443,241,202,China
84447,4/1/2024,CHN,Pulau Pinang,9358,4725,4633,China
84448,4/1/2024,CHN,Sabah,12460,5379,7081,China
84449,4/1/2024,CHN,Sarawak,1634,825,809,China
84450,4/1/2024,CHN,Selangor,125281,62052,63229,China
84451,4/1/2024,CHN,W.P. Labuan,38,33,5,China
84452,4/1/2024,CIV,Johor,3,3,0,C��te d'Iv
84453,4/1/2024,CIV,Sabah,1,0,1,C��te d'Iv
84454,4/1/2024,CIV,Sarawak,1,0,1,C��te d'Iv
84455,4/1/2024,CIV,Selangor,21,12,9,C��te d'Iv
84456,4/1/2024,CMR,Pulau Pinang,1,1,0,Cameroon
84457,4/1/2024,CMR,Selangor,38,15,23,Cameroon
84458,4/1/2024,COD,Johor,2,2,0,"Congo, the Democratic Republic of the"
84459,4/1/2024,COD,Selangor,32,14,18,"Congo, the Democratic Republic of the"
84460,4/1/2024,COG,Selangor,1,0,1,Congo
84461,4/1/2024,COL,Johor,33,15,18,Colombia
84462,4/1/2024,COL,Kedah,9,6,3,Colombia
84463,4/1/2024,COL,Perak,2,2,0,Colombia
84464,4/1/2024,COL,Pulau Pinang,3,2,1,Colombia
84465,4/1/2024,COL,Sabah,1,0,1,Colombia
84466,4/1/2024,COL,Sarawak,7,3,4,Colombia
84467,4/1/2024,COL,Selangor,246,120,126,Colombia
84468,4/1/2024,COM,Johor,5,2,3,Comoros
84469,4/1/2024,COM,Selangor,21,15,6,Comoros
84470,4/1/2024,CRI,Johor,13,7,6,Costa Rica
84471,4/1/2024,CRI,Kedah,2,1,1,Costa Rica
84472,4/1/2024,CRI,Pulau Pinang,10,6,4,Costa Rica
84473,4/1/2024,CRI,Sabah,1,1,0,Costa Rica
84474,4/1/2024,CRI,Selangor,66,37,29,Costa Rica
84475,4/1/2024,CUB,Johor,9,5,4,Cuba
84476,4/1/2024,CUB,Sabah,1,0,1,Cuba
84477,4/1/2024,CUB,Selangor,17,14,3,Cuba
84478,4/1/2024,CYP,Johor,9,4,5,Cyprus
84479,4/1/2024,CYP,Kedah,2,1,1,Cyprus
84480,4/1/2024,CYP,Pulau Pinang,4,4,0,Cyprus
84481,4/1/2024,CYP,Selangor,63,38,25,Cyprus
84482,4/1/2024,CZE,Johor,110,66,44,Czech Republic
84483,4/1/2024,CZE,Kedah,49,23,26,Czech Republic
84484,4/1/2024,CZE,Perak,2,1,1,Czech Republic
84485,4/1/2024,CZE,Perlis,9,6,3,Czech Republic
84486,4/1/2024,CZE,Pulau Pinang,33,19,14,Czech Republic
84487,4/1/2024,CZE,Sabah,17,10,7,Czech Republic
84488,4/1/2024,CZE,Sarawak,10,7,3,Czech Republic
84489,4/1/2024,CZE,Selangor,576,319,257,Czech Republic
84490,4/1/2024,DEU,Johor,2634,1573,1061,Germany
84491,4/1/2024,DEU,Kedah,1076,556,520,Germany
84492,4/1/2024,DEU,Kelantan,12,8,4,Germany
84493,4/1/2024,DEU,Pahang,8,4,4,Germany
84494,4/1/2024,DEU,Perak,30,20,10,Germany
84495,4/1/2024,DEU,Perlis,105,58,47,Germany
84496,4/1/2024,DEU,Pulau Pinang,627,430,197,Germany
84497,4/1/2024,DEU,Sabah,150,83,67,Germany
84498,4/1/2024,DEU,Sarawak,236,133,103,Germany
84499,4/1/2024,DEU,Selangor,9864,5527,4337,Germany
84500,4/1/2024,DEU,W.P. Labuan,7,6,1,Germany
84501,4/1/2024,DJI,Selangor,9,6,3,Djibouti
84502,4/1/2024,DMA,Johor,2,2,0,Dominica
84503,4/1/2024,DMA,Kedah,2,1,1,Dominica
84504,4/1/2024,DMA,Pulau Pinang,1,1,0,Dominica
84505,4/1/2024,DMA,Sarawak,2,1,1,Dominica
84506,4/1/2024,DMA,Selangor,64,44,20,Dominica
84507,4/1/2024,DNK,Johor,293,216,77,Denmark
84508,4/1/2024,DNK,Kedah,166,81,85,Denmark
84509,4/1/2024,DNK,Kelantan,3,1,2,Denmark
84510,4/1/2024,DNK,Perak,2,1,1,Denmark
84511,4/1/2024,DNK,Perlis,6,3,3,Denmark
84512,4/1/2024,DNK,Pulau Pinang,51,32,19,Denmark
84513,4/1/2024,DNK,Sabah,16,9,7,Denmark
84514,4/1/2024,DNK,Sarawak,8,6,2,Denmark
84515,4/1/2024,DNK,Selangor,1167,639,528,Denmark
84516,4/1/2024,DNK,Terengganu,19,4,15,Denmark
84517,4/1/2024,DOM,Johor,1,0,1,Dominican Republic
84518,4/1/2024,DOM,Pulau Pinang,1,1,0,Dominican Republic
84519,4/1/2024,DOM,Sabah,1,0,1,Dominican Republic
84520,4/1/2024,DOM,Selangor,11,4,7,Dominican Republic
84521,4/1/2024,DZA,Johor,28,19,9,Algeria
84522,4/1/2024,DZA,Kedah,3,1,2,Algeria
84523,4/1/2024,DZA,Sabah,1,1,0,Algeria
84524,4/1/2024,DZA,Sarawak,2,2,0,Algeria
84525,4/1/2024,DZA,Selangor,479,313,166,Algeria
84526,4/1/2024,ECU,Johor,12,7,5,Ecuador
84527,4/1/2024,ECU,Kedah,1,0,1,Ecuador
84528,4/1/2024,ECU,Pulau Pinang,6,2,4,Ecuador
84529,4/1/2024,ECU,Selangor,118,49,69,Ecuador
84530,4/1/2024,EGY,Johor,262,221,41,Egypt
84531,4/1/2024,EGY,Kedah,39,22,17,Egypt
84532,4/1/2024,EGY,Kelantan,4,2,2,Egypt
84533,4/1/2024,EGY,Perlis,1,1,0,Egypt
84534,4/1/2024,EGY,Pulau Pinang,18,13,5,Egypt
84535,4/1/2024,EGY,Sabah,3,3,0,Egypt
84536,4/1/2024,EGY,Sarawak,162,105,57,Egypt
84537,4/1/2024,EGY,Selangor,1469,967,502,Egypt
84538,4/1/2024,ERI,Selangor,15,10,5,Eritrea
84539,4/1/2024,ESP,Johor,511,323,188,Spain
84540,4/1/2024,ESP,Kedah,175,84,91,Spain
84541,4/1/2024,ESP,Kelantan,8,5,3,Spain
84542,4/1/2024,ESP,Melaka,1,0,1,Spain
84543,4/1/2024,ESP,Pahang,1,1,0,Spain
84544,4/1/2024,ESP,Perak,3,1,2,Spain
84545,4/1/2024,ESP,Perlis,21,12,9,Spain
84546,4/1/2024,ESP,Pulau Pinang,84,52,32,Spain
84547,4/1/2024,ESP,Sabah,35,22,13,Spain
84548,4/1/2024,ESP,Sarawak,42,31,11,Spain
84549,4/1/2024,ESP,Selangor,2749,1556,1193,Spain
84550,4/1/2024,ESP,W.P. Labuan,1,1,0,Spain
84551,4/1/2024,EST,Johor,24,13,11,Estonia
84552,4/1/2024,EST,Kedah,19,8,11,Estonia
84553,4/1/2024,EST,Perlis,2,2,0,Estonia
84554,4/1/2024,EST,Pulau Pinang,11,7,4,Estonia
84555,4/1/2024,EST,Sabah,4,2,2,Estonia
84556,4/1/2024,EST,Sarawak,9,4,5,Estonia
84557,4/1/2024,EST,Selangor,135,80,55,Estonia
84558,4/1/2024,EST,W.P. Labuan,1,0,1,Estonia
84559,4/1/2024,ETH,Johor,5,3,2,Ethiopia
84560,4/1/2024,ETH,Selangor,26,20,6,Ethiopia
84561,4/1/2024,FIN,Johor,238,134,104,Finland
84562,4/1/2024,FIN,Kedah,69,29,40,Finland
84563,4/1/2024,FIN,Perak,9,4,5,Finland
84564,4/1/2024,FIN,Perlis,2,2,0,Finland
84565,4/1/2024,FIN,Pulau Pinang,34,21,13,Finland
84566,4/1/2024,FIN,Sabah,8,5,3,Finland
84567,4/1/2024,FIN,Sarawak,2,0,2,Finland
84568,4/1/2024,FIN,Selangor,434,222,212,Finland
84569,4/1/2024,FJI,Johor,71,30,41,Fiji
84570,4/1/2024,FJI,Kedah,2,2,0,Fiji
84571,4/1/2024,FJI,Perlis,1,0,1,Fiji
84572,4/1/2024,FJI,Pulau Pinang,5,4,1,Fiji
84573,4/1/2024,FJI,Selangor,149,70,79,Fiji
84574,4/1/2024,FRA,Johor,2567,1498,1069,France
84575,4/1/2024,FRA,Kedah,942,474,468,France
84576,4/1/2024,FRA,Kelantan,20,11,9,France
84577,4/1/2024,FRA,Melaka,9,5,4,France
84578,4/1/2024,FRA,Negeri Sembilan,2,1,1,France
84579,4/1/2024,FRA,Pahang,56,28,28,France
84580,4/1/2024,FRA,Perak,28,16,12,France
84581,4/1/2024,FRA,Perlis,91,59,32,France
84582,4/1/2024,FRA,Pulau Pinang,342,198,144,France
84583,4/1/2024,FRA,Sabah,166,96,70,France
84584,4/1/2024,FRA,Sarawak,141,86,55,France
84585,4/1/2024,FRA,Selangor,10465,5753,4712,France
84586,4/1/2024,FRA,W.P. Labuan,9,4,5,France
84587,4/1/2024,GAB,Johor,3,1,2,Gabon
84588,4/1/2024,GAB,Selangor,9,4,5,Gabon
84589,4/1/2024,GBR,Johor,5383,3339,2044,United Kingdom
84590,4/1/2024,GBR,Kedah,2112,1118,994,United Kingdom
84591,4/1/2024,GBR,Kelantan,9,8,1,United Kingdom
84592,4/1/2024,GBR,Melaka,2,1,1,United Kingdom
84593,4/1/2024,GBR,Pahang,10,9,1,United Kingdom
84594,4/1/2024,GBR,Perak,114,68,46,United Kingdom
84595,4/1/2024,GBR,Perlis,173,112,61,United Kingdom
84596,4/1/2024,GBR,Pulau Pinang,5968,2945,3023,United Kingdom
84597,4/1/2024,GBR,Sabah,654,349,305,United Kingdom
84598,4/1/2024,GBR,Sarawak,1134,676,458,United Kingdom
84599,4/1/2024,GBR,Selangor,19008,11101,7907,United Kingdom
84600,4/1/2024,GBR,W.P. Labuan,39,31,8,United Kingdom
84601,4/1/2024,GEO,Johor,22,17,5,Georgia
84602,4/1/2024,GEO,Kelantan,1,1,0,Georgia
84603,4/1/2024,GEO,Perlis,1,1,0,Georgia
84604,4/1/2024,GEO,Pulau Pinang,2,1,1,Georgia
84605,4/1/2024,GEO,Sabah,2,1,1,Georgia
84606,4/1/2024,GEO,Sarawak,1,0,1,Georgia
84607,4/1/2024,GEO,Selangor,45,29,16,Georgia
84608,4/1/2024,GHA,Johor,4,3,1,Ghana
84609,4/1/2024,GHA,Kedah,1,1,0,Ghana
84610,4/1/2024,GHA,Pulau Pinang,1,0,1,Ghana
84611,4/1/2024,GHA,Selangor,95,59,36,Ghana
84612,4/1/2024,GIN,Johor,4,3,1,Guinea
84613,4/1/2024,GIN,Selangor,34,28,6,Guinea
84614,4/1/2024,GMB,Selangor,20,16,4,Gambia
84615,4/1/2024,GNB,Selangor,2,1,1,Guinea-Bissau
84616,4/1/2024,GNQ,Johor,1,1,0,Equatorial Guinea
84617,4/1/2024,GNQ,Selangor,2,1,1,Equatorial Guinea
84618,4/1/2024,GRC,Johor,53,36,17,Greece
84619,4/1/2024,GRC,Kedah,11,10,1,Greece
84620,4/1/2024,GRC,Perak,1,1,0,Greece
84621,4/1/2024,GRC,Perlis,2,2,0,Greece
84622,4/1/2024,GRC,Pulau Pinang,8,4,4,Greece
84623,4/1/2024,GRC,Sabah,4,3,1,Greece
84624,4/1/2024,GRC,Sarawak,4,3,1,Greece
84625,4/1/2024,GRC,Selangor,298,190,108,Greece
84626,4/1/2024,GRD,Johor,6,2,4,Grenada
84627,4/1/2024,GRD,Kedah,4,2,2,Grenada
84628,4/1/2024,GRD,Selangor,7,5,2,Grenada
84629,4/1/2024,GTM,Johor,2,1,1,Guatemala
84630,4/1/2024,GTM,Kedah,1,1,0,Guatemala
84631,4/1/2024,GTM,Pulau Pinang,1,0,1,Guatemala
84632,4/1/2024,GTM,Sabah,1,1,0,Guatemala
84633,4/1/2024,GTM,Selangor,25,13,12,Guatemala
84634,4/1/2024,GUY,Selangor,8,5,3,Guyana
84635,4/1/2024,HKG,Johor,6,4,2,Hong Kong
84636,4/1/2024,HKG,Pahang,1,1,0,Hong Kong
84637,4/1/2024,HKG,Perak,44,21,23,Hong Kong
84638,4/1/2024,HKG,Perlis,3,2,1,Hong Kong
84639,4/1/2024,HKG,Pulau Pinang,3,0,3,Hong Kong
84640,4/1/2024,HKG,Sabah,22,13,9,Hong Kong
84641,4/1/2024,HKG,Selangor,52,23,29,Hong Kong
84642,4/1/2024,HND,Johor,3,3,0,Honduras
84643,4/1/2024,HND,Selangor,22,15,7,Honduras
84644,4/1/2024,HRV,Johor,32,24,8,Croatia
84645,4/1/2024,HRV,Kedah,9,4,5,Croatia
84646,4/1/2024,HRV,Perlis,1,1,0,Croatia
84647,4/1/2024,HRV,Pulau Pinang,7,7,0,Croatia
84648,4/1/2024,HRV,Sabah,7,6,1,Croatia
84649,4/1/2024,HRV,Sarawak,4,2,2,Croatia
84650,4/1/2024,HRV,Selangor,215,129,86,Croatia
84651,4/1/2024,HTI,Sabah,1,1,0,Haiti
84652,4/1/2024,HTI,Selangor,11,5,6,Haiti
84653,4/1/2024,HUN,Johor,128,74,54,Hungary
84654,4/1/2024,HUN,Kedah,35,15,20,Hungary
84655,4/1/2024,HUN,Perlis,4,2,2,Hungary
84656,4/1/2024,HUN,Pulau Pinang,13,9,4,Hungary
84657,4/1/2024,HUN,Sabah,2,1,1,Hungary
84658,4/1/2024,HUN,Sarawak,29,15,14,Hungary
84659,4/1/2024,HUN,Selangor,549,301,248,Hungary
84660,4/1/2024,IDN,Johor,100989,46197,54792,Indonesia
84661,4/1/2024,IDN,Kedah,2583,962,1621,Indonesia
84662,4/1/2024,IDN,Kelantan,167,80,87,Indonesia
84663,4/1/2024,IDN,Melaka,4697,2070,2627,Indonesia
84664,4/1/2024,IDN,Negeri Sembilan,5176,3149,2027,Indonesia
84665,4/1/2024,IDN,Pahang,19,14,5,Indonesia
84666,4/1/2024,IDN,Perak,217,77,140,Indonesia
84667,4/1/2024,IDN,Perlis,707,263,444,Indonesia
84668,4/1/2024,IDN,Pulau Pinang,36706,15143,21563,Indonesia
84669,4/1/2024,IDN,Sabah,6268,3121,3147,Indonesia
84670,4/1/2024,IDN,Sarawak,54088,28166,25922,Indonesia
84671,4/1/2024,IDN,Selangor,166132,77610,88522,Indonesia
84672,4/1/2024,IDN,W.P. Labuan,66,24,42,Indonesia
84673,4/1/2024,IND,Johor,32493,20972,11521,India
84674,4/1/2024,IND,Kedah,1701,942,759,India
84675,4/1/2024,IND,Kelantan,4,4,0,India
84676,4/1/2024,IND,Melaka,3,3,0,India
84677,4/1/2024,IND,Negeri Sembilan,1,1,0,India
84678,4/1/2024,IND,Pahang,11,9,2,India
84679,4/1/2024,IND,Perak,200,119,81,India
84680,4/1/2024,IND,Perlis,79,61,18,India
84681,4/1/2024,IND,Pulau Pinang,1870,1186,684,India
84682,4/1/2024,IND,Sabah,234,139,95,India
84683,4/1/2024,IND,Sarawak,2593,1994,599,India
84684,4/1/2024,IND,Selangor,75329,48165,27164,India
84685,4/1/2024,IND,W.P. Labuan,75,63,12,India
84686,4/1/2024,IOT,Selangor,1,0,1,British Indian Ocean Territory
84687,4/1/2024,IRL,Johor,315,197,118,Ireland
84688,4/1/2024,IRL,Kedah,142,70,72,Ireland
84689,4/1/2024,IRL,Kelantan,4,3,1,Ireland
84690,4/1/2024,IRL,Perak,7,6,1,Ireland
84691,4/1/2024,IRL,Perlis,12,5,7,Ireland
84692,4/1/2024,IRL,Pulau Pinang,134,74,60,Ireland
84693,4/1/2024,IRL,Sabah,27,12,15,Ireland
84694,4/1/2024,IRL,Sarawak,31,14,17,Ireland
84695,4/1/2024,IRL,Selangor,1409,804,605,Ireland
84696,4/1/2024,IRL,W.P. Labuan,1,0,1,Ireland
84697,4/1/2024,IRN,Johor,336,166,170,Iran
84698,4/1/2024,IRN,Kedah,15,2,13,Iran
84699,4/1/2024,IRN,Melaka,1,1,0,Iran
84700,4/1/2024,IRN,Perak,1,0,1,Iran
84701,4/1/2024,IRN,Perlis,10,6,4,Iran
84702,4/1/2024,IRN,Pulau Pinang,11,5,6,Iran
84703,4/1/2024,IRN,Sabah,2,1,1,Iran
84704,4/1/2024,IRN,Sarawak,7,7,0,Iran
84705,4/1/2024,IRN,Selangor,1965,1060,905,Iran
84706,4/1/2024,IRQ,Johor,32,27,5,Iraq
84707,4/1/2024,IRQ,Kedah,10,8,2,Iraq
84708,4/1/2024,IRQ,Pulau Pinang,6,4,2,Iraq
84709,4/1/2024,IRQ,Sabah,1,0,1,Iraq
84710,4/1/2024,IRQ,Sarawak,3,1,2,Iraq
84711,4/1/2024,IRQ,Selangor,1193,839,354,Iraq
84712,4/1/2024,ISL,Johor,6,2,4,Iceland
84713,4/1/2024,ISL,Perak,2,1,1,Iceland
84714,4/1/2024,ISL,Pulau Pinang,4,2,2,Iceland
84715,4/1/2024,ISL,Selangor,31,14,17,Iceland
84716,4/1/2024,ISR,Selangor,6,6,0,Israel
84717,4/1/2024,ITA,Johor,639,421,218,Italy
84718,4/1/2024,ITA,Kedah,240,135,105,Italy
84719,4/1/2024,ITA,Kelantan,3,2,1,Italy
84720,4/1/2024,ITA,Melaka,1,1,0,Italy
84721,4/1/2024,ITA,Negeri Sembilan,3,3,0,Italy
84722,4/1/2024,ITA,Pahang,1,1,0,Italy
84723,4/1/2024,ITA,Perak,17,6,11,Italy
84724,4/1/2024,ITA,Perlis,21,14,7,Italy
84725,4/1/2024,ITA,Pulau Pinang,83,57,26,Italy
84726,4/1/2024,ITA,Sabah,57,35,22,Italy
84727,4/1/2024,ITA,Sarawak,57,35,22,Italy
84728,4/1/2024,ITA,Selangor,3403,2022,1381,Italy
84729,4/1/2024,ITA,W.P. Labuan,2,0,2,Italy
84730,4/1/2024,JAM,Johor,4,2,2,Jamaica
84731,4/1/2024,JAM,Kedah,5,1,4,Jamaica
84732,4/1/2024,JAM,Pulau Pinang,1,0,1,Jamaica
84733,4/1/2024,JAM,Selangor,20,8,12,Jamaica
84734,4/1/2024,JOR,Johor,13,6,7,Jordan
84735,4/1/2024,JOR,Kedah,12,8,4,Jordan
84736,4/1/2024,JOR,Kelantan,1,1,0,Jordan
84737,4/1/2024,JOR,Pahang,1,1,0,Jordan
84738,4/1/2024,JOR,Perlis,1,0,1,Jordan
84739,4/1/2024,JOR,Pulau Pinang,12,7,5,Jordan
84740,4/1/2024,JOR,Sarawak,5,3,2,Jordan
84741,4/1/2024,JOR,Selangor,862,530,332,Jordan
84742,4/1/2024,JPN,Johor,5777,3801,1976,Japan
84743,4/1/2024,JPN,Kedah,463,234,229,Japan
84744,4/1/2024,JPN,Kelantan,9,8,1,Japan
84745,4/1/2024,JPN,Pahang,12,7,5,Japan
84746,4/1/2024,JPN,Perak,60,35,25,Japan
84747,4/1/2024,JPN,Perlis,85,57,28,Japan
84748,4/1/2024,JPN,Pulau Pinang,1143,753,390,Japan
84749,4/1/2024,JPN,Sabah,581,291,290,Japan
84750,4/1/2024,JPN,Sarawak,144,84,60,Japan
84751,4/1/2024,JPN,Selangor,18647,10830,7817,Japan
84752,4/1/2024,JPN,W.P. Labuan,13,10,3,Japan
84753,4/1/2024,KAZ,Johor,48,16,32,Kazakhstan
84754,4/1/2024,KAZ,Kedah,55,21,34,Kazakhstan
84755,4/1/2024,KAZ,Kelantan,2,0,2,Kazakhstan
84756,4/1/2024,KAZ,Perlis,11,2,9,Kazakhstan
84757,4/1/2024,KAZ,Pulau Pinang,8,3,5,Kazakhstan
84758,4/1/2024,KAZ,Sabah,4,2,2,Kazakhstan
84759,4/1/2024,KAZ,Sarawak,18,9,9,Kazakhstan
84760,4/1/2024,KAZ,Selangor,3521,1378,2143,Kazakhstan
84761,4/1/2024,KEN,Johor,56,21,35,Kenya
84762,4/1/2024,KEN,Kedah,9,4,5,Kenya
84763,4/1/2024,KEN,Melaka,1,0,1,Kenya
84764,4/1/2024,KEN,Pulau Pinang,5,2,3,Kenya
84765,4/1/2024,KEN,Sarawak,1,1,0,Kenya
84766,4/1/2024,KEN,Selangor,344,162,182,Kenya
84767,4/1/2024,KGZ,Johor,33,22,11,Kyrgyzstan
84768,4/1/2024,KGZ,Kedah,13,5,8,Kyrgyzstan
84769,4/1/2024,KGZ,Perlis,1,1,0,Kyrgyzstan
84770,4/1/2024,KGZ,Pulau Pinang,8,0,8,Kyrgyzstan
84771,4/1/2024,KGZ,Sarawak,2,2,0,Kyrgyzstan
84772,4/1/2024,KGZ,Selangor,467,205,262,Kyrgyzstan
84773,4/1/2024,KHM,Johor,2424,1048,1376,Cambodia
84774,4/1/2024,KHM,Kedah,194,162,32,Cambodia
84775,4/1/2024,KHM,Kelantan,357,200,157,Cambodia
84776,4/1/2024,KHM,Perak,6,1,5,Cambodia
84777,4/1/2024,KHM,Perlis,822,531,291,Cambodia
84778,4/1/2024,KHM,Pulau Pinang,25,5,20,Cambodia
84779,4/1/2024,KHM,Sarawak,5,3,2,Cambodia
84780,4/1/2024,KHM,Selangor,4428,2115,2313,Cambodia
84781,4/1/2024,KIR,Johor,2,0,2,Kiribati
84782,4/1/2024,KNA,Johor,25,14,11,Saint Kitts and Nevis
84783,4/1/2024,KNA,Kedah,9,3,6,Saint Kitts and Nevis
84784,4/1/2024,KNA,Pulau Pinang,1,1,0,Saint Kitts and Nevis
84785,4/1/2024,KNA,Selangor,53,38,15,Saint Kitts and Nevis
84786,4/1/2024,KOR,Johor,9475,5211,4264,"Korea, Republic of (South Korea)"
84787,4/1/2024,KOR,Kedah,269,109,160,"Korea, Republic of (South Korea)"
84788,4/1/2024,KOR,Kelantan,5,2,3,"Korea, Republic of (South Korea)"
84789,4/1/2024,KOR,Melaka,1,1,0,"Korea, Republic of (South Korea)"
84790,4/1/2024,KOR,Perak,25,13,12,"Korea, Republic of (South Korea)"
84791,4/1/2024,KOR,Perlis,65,43,22,"Korea, Republic of (South Korea)"
84792,4/1/2024,KOR,Pulau Pinang,557,300,257,"Korea, Republic of (South Korea)"
84793,4/1/2024,KOR,Sabah,11009,4304,6705,"Korea, Republic of (South Korea)"
84794,4/1/2024,KOR,Sarawak,216,123,93,"Korea, Republic of (South Korea)"
84795,4/1/2024,KOR,Selangor,12860,6999,5861,"Korea, Republic of (South Korea)"
84796,4/1/2024,KOR,W.P. Labuan,3,2,1,"Korea, Republic of (South Korea)"
84797,4/1/2024,KWT,Johor,14,5,9,Kuwait
84798,4/1/2024,KWT,Kedah,11,7,4,Kuwait
84799,4/1/2024,KWT,Pulau Pinang,4,3,1,Kuwait
84800,4/1/2024,KWT,Selangor,201,127,74,Kuwait
84801,4/1/2024,LAO,Johor,214,62,152,Lao People's Democratic Republic
84802,4/1/2024,LAO,Kedah,676,51,625,Lao People's Democratic Republic
84803,4/1/2024,LAO,Kelantan,177,44,133,Lao People's Democratic Republic
84804,4/1/2024,LAO,Perak,33,5,28,Lao People's Democratic Republic
84805,4/1/2024,LAO,Perlis,264,45,219,Lao People's Democratic Republic
84806,4/1/2024,LAO,Pulau Pinang,20,4,16,Lao People's Democratic Republic
84807,4/1/2024,LAO,Sarawak,17,9,8,Lao People's Democratic Republic
84808,4/1/2024,LAO,Selangor,310,125,185,Lao People's Democratic Republic
84809,4/1/2024,LBN,Johor,28,18,10,Lebanon
84810,4/1/2024,LBN,Kedah,16,10,6,Lebanon
84811,4/1/2024,LBN,Pulau Pinang,14,7,7,Lebanon
84812,4/1/2024,LBN,Sabah,2,1,1,Lebanon
84813,4/1/2024,LBN,Sarawak,4,3,1,Lebanon
84814,4/1/2024,LBN,Selangor,352,223,129,Lebanon
84815,4/1/2024,LBR,Johor,2,2,0,Liberia
84816,4/1/2024,LBR,Selangor,4,3,1,Liberia
84817,4/1/2024,LBY,Johor,6,6,0,Libyan Arab Jamahiriya
84818,4/1/2024,LBY,Kedah,2,2,0,Libyan Arab Jamahiriya
84819,4/1/2024,LBY,Sabah,1,0,1,Libyan Arab Jamahiriya
84820,4/1/2024,LBY,Selangor,283,204,79,Libyan Arab Jamahiriya
84821,4/1/2024,LCA,Johor,3,1,2,Saint Lucia
84822,4/1/2024,LCA,Pulau Pinang,4,1,3,Saint Lucia
84823,4/1/2024,LCA,Selangor,7,4,3,Saint Lucia
84824,4/1/2024,LIE,Kedah,7,1,6,Liechtenstein
84825,4/1/2024,LIE,Perak,1,1,0,Liechtenstein
84826,4/1/2024,LIE,Selangor,12,7,5,Liechtenstein
84827,4/1/2024,LKA,Johor,721,427,294,Sri Lanka
84828,4/1/2024,LKA,Kedah,6,6,0,Sri Lanka
84829,4/1/2024,LKA,Perlis,1,1,0,Sri Lanka
84830,4/1/2024,LKA,Pulau Pinang,30,18,12,Sri Lanka
84831,4/1/2024,LKA,Sabah,7,6,1,Sri Lanka
84832,4/1/2024,LKA,Sarawak,37,27,10,Sri Lanka
84833,4/1/2024,LKA,Selangor,4904,2875,2029,Sri Lanka
84834,4/1/2024,LKA,W.P. Labuan,1,1,0,Sri Lanka
84835,4/1/2024,LSO,Selangor,12,5,7,Lesotho
84836,4/1/2024,LTU,Johor,92,49,43,Lithuania
84837,4/1/2024,LTU,Kedah,41,18,23,Lithuania
84838,4/1/2024,LTU,Perlis,4,2,2,Lithuania
84839,4/1/2024,LTU,Pulau Pinang,15,7,8,Lithuania
84840,4/1/2024,LTU,Sabah,4,3,1,Lithuania
84841,4/1/2024,LTU,Sarawak,2,1,1,Lithuania
84842,4/1/2024,LTU,Selangor,357,186,171,Lithuania
84843,4/1/2024,LTU,Terengganu,1,1,0,Lithuania
84844,4/1/2024,LTU,W.P. Labuan,6,1,5,Lithuania
84845,4/1/2024,LUX,Johor,11,8,3,Luxembourg
84846,4/1/2024,LUX,Kedah,13,7,6,Luxembourg
84847,4/1/2024,LUX,Perlis,1,1,0,Luxembourg
84848,4/1/2024,LUX,Pulau Pinang,3,3,0,Luxembourg
84849,4/1/2024,LUX,Sabah,1,1,0,Luxembourg
84850,4/1/2024,LUX,Selangor,75,40,35,Luxembourg
84851,4/1/2024,LVA,Johor,52,24,28,Latvia
84852,4/1/2024,LVA,Kedah,10,5,5,Latvia
84853,4/1/2024,LVA,Perlis,4,3,1,Latvia
84854,4/1/2024,LVA,Pulau Pinang,10,5,5,Latvia
84855,4/1/2024,LVA,Sabah,1,0,1,Latvia
84856,4/1/2024,LVA,Sarawak,1,1,0,Latvia
84857,4/1/2024,LVA,Selangor,186,78,108,Latvia
84858,4/1/2024,LVA,W.P. Labuan,5,2,3,Latvia
84859,4/1/2024,MAC,Perak,1,1,0,Macao
84860,4/1/2024,MAC,Selangor,2,1,1,Macao
84861,4/1/2024,MAR,Johor,111,70,41,Morocco
84862,4/1/2024,MAR,Kedah,16,10,6,Morocco
84863,4/1/2024,MAR,Kelantan,2,0,2,Morocco
84864,4/1/2024,MAR,Perlis,4,2,2,Morocco
84865,4/1/2024,MAR,Pulau Pinang,12,7,5,Morocco
84866,4/1/2024,MAR,Sabah,2,1,1,Morocco
84867,4/1/2024,MAR,Sarawak,7,3,4,Morocco
84868,4/1/2024,MAR,Selangor,978,526,452,Morocco
84869,4/1/2024,MCO,Selangor,6,4,2,Monaco
84870,4/1/2024,MDA,Johor,6,2,4,"Moldova, Republic of"
84871,4/1/2024,MDA,Sabah,1,1,0,"Moldova, Republic of"
84872,4/1/2024,MDA,Selangor,34,16,18,"Moldova, Republic of"
84873,4/1/2024,MDG,Johor,7,2,5,Madagascar
84874,4/1/2024,MDG,Selangor,133,58,75,Madagascar
84875,4/1/2024,MDV,Johor,134,67,67,Maldives
84876,4/1/2024,MDV,Sabah,4,3,1,Maldives
84877,4/1/2024,MDV,Sarawak,6,4,2,Maldives
84878,4/1/2024,MDV,Selangor,3206,1725,1481,Maldives
84879,4/1/2024,MEX,Johor,233,95,138,Mexico
84880,4/1/2024,MEX,Kedah,15,7,8,Mexico
84881,4/1/2024,MEX,Perlis,5,3,2,Mexico
84882,4/1/2024,MEX,Pulau Pinang,31,23,8,Mexico
84883,4/1/2024,MEX,Sabah,5,3,2,Mexico
84884,4/1/2024,MEX,Selangor,841,391,450,Mexico
84885,4/1/2024,MHL,Selangor,2,2,0,Marshall Islands
84886,4/1/2024,MKD,Johor,8,3,5,"Macedonia, the former Yugoslav Republic of"
84887,4/1/2024,MKD,Kedah,3,2,1,"Macedonia, the former Yugoslav Republic of"
84888,4/1/2024,MKD,Perlis,2,2,0,"Macedonia, the former Yugoslav Republic of"
84889,4/1/2024,MKD,Pulau Pinang,4,1,3,"Macedonia, the former Yugoslav Republic of"
84890,4/1/2024,MKD,Sarawak,3,2,1,"Macedonia, the former Yugoslav Republic of"
84891,4/1/2024,MKD,Selangor,49,20,29,"Macedonia, the former Yugoslav Republic of"
84892,4/1/2024,MLI,Pulau Pinang,1,0,1,Mali
84893,4/1/2024,MLI,Selangor,9,8,1,Mali
84894,4/1/2024,MLT,Johor,9,5,4,Malta
84895,4/1/2024,MLT,Sabah,1,1,0,Malta
84896,4/1/2024,MLT,Selangor,55,35,20,Malta
84897,4/1/2024,MMR,Johor,6833,2245,4588,Myanmar
84898,4/1/2024,MMR,Kedah,79,21,58,Myanmar
84899,4/1/2024,MMR,Kelantan,5,2,3,Myanmar
84900,4/1/2024,MMR,Melaka,1,0,1,Myanmar
84901,4/1/2024,MMR,Pahang,4,0,4,Myanmar
84902,4/1/2024,MMR,Perak,27,7,20,Myanmar
84903,4/1/2024,MMR,Perlis,15,2,13,Myanmar
84904,4/1/2024,MMR,Pulau Pinang,215,89,126,Myanmar
84905,4/1/2024,MMR,Sabah,9,4,5,Myanmar
84906,4/1/2024,MMR,Sarawak,65,35,30,Myanmar
84907,4/1/2024,MMR,Selangor,6877,4522,2355,Myanmar
84908,4/1/2024,MNE,Johor,3,3,0,Montenegro
84909,4/1/2024,MNE,Pulau Pinang,3,2,1,Montenegro
84910,4/1/2024,MNE,Selangor,19,14,5,Montenegro
84911,4/1/2024,MNG,Johor,170,72,98,Mongolia
84912,4/1/2024,MNG,Kedah,11,7,4,Mongolia
84913,4/1/2024,MNG,Perak,4,1,3,Mongolia
84914,4/1/2024,MNG,Pulau Pinang,3,1,2,Mongolia
84915,4/1/2024,MNG,Sabah,3,1,2,Mongolia
84916,4/1/2024,MNG,Sarawak,1,0,1,Mongolia
84917,4/1/2024,MNG,Selangor,354,147,207,Mongolia
84918,4/1/2024,MOZ,Johor,1,0,1,Mozambique
84919,4/1/2024,MOZ,Selangor,20,10,10,Mozambique
84920,4/1/2024,MRT,Johor,1,1,0,Mauritania
84921,4/1/2024,MRT,Selangor,14,12,2,Mauritania
84922,4/1/2024,MUS,Johor,290,139,151,Mauritius
84923,4/1/2024,MUS,Kedah,13,7,6,Mauritius
84924,4/1/2024,MUS,Perlis,3,3,0,Mauritius
84925,4/1/2024,MUS,Pulau Pinang,10,5,5,Mauritius
84926,4/1/2024,MUS,Sabah,1,1,0,Mauritius
84927,4/1/2024,MUS,Sarawak,1,0,1,Mauritius
84928,4/1/2024,MUS,Selangor,2205,1094,1111,Mauritius
84929,4/1/2024,MWI,Pulau Pinang,3,2,1,Malawi
84930,4/1/2024,MWI,Selangor,22,12,10,Malawi
84931,4/1/2024,NAM,Johor,1,1,0,Namibia
84932,4/1/2024,NAM,Selangor,8,3,5,Namibia
84933,4/1/2024,NER,Selangor,4,0,4,Niger
84934,4/1/2024,NGA,Johor,19,17,2,Nigeria
84935,4/1/2024,NGA,Pulau Pinang,8,8,0,Nigeria
84936,4/1/2024,NGA,Sabah,2,2,0,Nigeria
84937,4/1/2024,NGA,Sarawak,6,5,1,Nigeria
84938,4/1/2024,NGA,Selangor,428,332,96,Nigeria
84939,4/1/2024,NIC,Johor,3,2,1,Nicaragua
84940,4/1/2024,NIC,Kedah,1,0,1,Nicaragua
84941,4/1/2024,NIC,Pulau Pinang,2,1,1,Nicaragua
84942,4/1/2024,NIC,Selangor,3,2,1,Nicaragua
84943,4/1/2024,NLD,Johor,1123,694,429,Netherlands
84944,4/1/2024,NLD,Kedah,428,210,218,Netherlands
84945,4/1/2024,NLD,Kelantan,4,3,1,Netherlands
84946,4/1/2024,NLD,Melaka,2,2,0,Netherlands
84947,4/1/2024,NLD,Negeri Sembilan,1,1,0,Netherlands
84948,4/1/2024,NLD,Pahang,5,3,2,Netherlands
84949,4/1/2024,NLD,Perak,12,6,6,Netherlands
84950,4/1/2024,NLD,Perlis,41,20,21,Netherlands
84951,4/1/2024,NLD,Pulau Pinang,247,143,104,Netherlands
84952,4/1/2024,NLD,Sabah,96,55,41,Netherlands
84953,4/1/2024,NLD,Sarawak,146,90,56,Netherlands
84954,4/1/2024,NLD,Selangor,4591,2597,1994,Netherlands
84955,4/1/2024,NLD,W.P. Labuan,1,1,0,Netherlands
84956,4/1/2024,NOR,Johor,173,110,63,Norway
84957,4/1/2024,NOR,Kedah,66,20,46,Norway
84958,4/1/2024,NOR,Kelantan,1,1,0,Norway
84959,4/1/2024,NOR,Perak,1,1,0,Norway
84960,4/1/2024,NOR,Perlis,17,8,9,Norway
84961,4/1/2024,NOR,Pulau Pinang,35,27,8,Norway
84962,4/1/2024,NOR,Sabah,7,4,3,Norway
84963,4/1/2024,NOR,Sarawak,18,13,5,Norway
84964,4/1/2024,NOR,Selangor,630,371,259,Norway
84965,4/1/2024,NOR,W.P. Labuan,1,1,0,Norway
84966,4/1/2024,NPL,Johor,1077,835,242,Nepal
84967,4/1/2024,NPL,Kedah,17,10,7,Nepal
84968,4/1/2024,NPL,Perak,1,1,0,Nepal
84969,4/1/2024,NPL,Perlis,10,10,0,Nepal
84970,4/1/2024,NPL,Pulau Pinang,9,8,1,Nepal
84971,4/1/2024,NPL,Sabah,2,2,0,Nepal
84972,4/1/2024,NPL,Sarawak,306,206,100,Nepal
84973,4/1/2024,NPL,Selangor,10072,9561,511,Nepal
84974,4/1/2024,NPL,W.P. Labuan,56,50,6,Nepal
84975,4/1/2024,NRU,Selangor,4,3,1,Nauru
84976,4/1/2024,NZL,Johor,915,559,356,New Zealand
84977,4/1/2024,NZL,Kedah,149,81,68,New Zealand
84978,4/1/2024,NZL,Kelantan,1,1,0,New Zealand
84979,4/1/2024,NZL,Negeri Sembilan,1,1,0,New Zealand
84980,4/1/2024,NZL,Pahang,11,5,6,New Zealand
84981,4/1/2024,NZL,Perak,26,18,8,New Zealand
84982,4/1/2024,NZL,Perlis,20,11,9,New Zealand
84983,4/1/2024,NZL,Pulau Pinang,196,104,92,New Zealand
84984,4/1/2024,NZL,Sabah,72,32,40,New Zealand
84985,4/1/2024,NZL,Sarawak,130,73,57,New Zealand
84986,4/1/2024,NZL,Selangor,2802,1640,1162,New Zealand
84987,4/1/2024,NZL,Terengganu,1,0,1,New Zealand
84988,4/1/2024,NZL,W.P. Labuan,6,3,3,New Zealand
84989,4/1/2024,OMN,Johor,18,9,9,Oman
84990,4/1/2024,OMN,Kedah,5,3,2,Oman
84991,4/1/2024,OMN,Kelantan,1,1,0,Oman
84992,4/1/2024,OMN,Perak,1,1,0,Oman
84993,4/1/2024,OMN,Pulau Pinang,2,2,0,Oman
84994,4/1/2024,OMN,Sarawak,10,3,7,Oman
84995,4/1/2024,OMN,Selangor,682,427,255,Oman
84996,4/1/2024,PAK,Johor,602,463,139,Pakistan
84997,4/1/2024,PAK,Kedah,90,59,31,Pakistan
84998,4/1/2024,PAK,Kelantan,16,15,1,Pakistan
84999,4/1/2024,PAK,Pahang,2,2,0,Pakistan
85000,4/1/2024,PAK,Perak,3,3,0,Pakistan
85001,4/1/2024,PAK,Perlis,18,17,1,Pakistan
85002,4/1/2024,PAK,Pulau Pinang,74,60,14,Pakistan
85003,4/1/2024,PAK,Sabah,23,18,5,Pakistan
85004,4/1/2024,PAK,Sarawak,218,177,41,Pakistan
85005,4/1/2024,PAK,Selangor,6853,5607,1246,Pakistan
85006,4/1/2024,PAK,W.P. Labuan,3,3,0,Pakistan
85007,4/1/2024,PAN,Johor,10,4,6,Panama
85008,4/1/2024,PAN,Sabah,2,0,2,Panama
85009,4/1/2024,PAN,Sarawak,1,0,1,Panama
85010,4/1/2024,PAN,Selangor,28,15,13,Panama
85011,4/1/2024,PER,Johor,24,13,11,Peru
85012,4/1/2024,PER,Kedah,7,3,4,Peru
85013,4/1/2024,PER,Perak,2,1,1,Peru
85014,4/1/2024,PER,Perlis,1,0,1,Peru
85015,4/1/2024,PER,Pulau Pinang,1,1,0,Peru
85016,4/1/2024,PER,Sabah,1,0,1,Peru
85017,4/1/2024,PER,Selangor,148,78,70,Peru
85018,4/1/2024,PHL,Johor,23651,7539,16112,Philippines
85019,4/1/2024,PHL,Kedah,410,121,289,Philippines
85020,4/1/2024,PHL,Kelantan,49,24,25,Philippines
85021,4/1/2024,PHL,Negeri Sembilan,6,5,1,Philippines
85022,4/1/2024,PHL,Pahang,17,9,8,Philippines
85023,4/1/2024,PHL,Perak,63,22,41,Philippines
85024,4/1/2024,PHL,Perlis,180,49,131,Philippines
85025,4/1/2024,PHL,Pulau Pinang,670,278,392,Philippines
85026,4/1/2024,PHL,Sabah,1084,560,524,Philippines
85027,4/1/2024,PHL,Sarawak,3189,1262,1927,Philippines
85028,4/1/2024,PHL,Selangor,15292,6063,9229,Philippines
85029,4/1/2024,PHL,W.P. Labuan,146,46,100,Philippines
85030,4/1/2024,PNG,Johor,13,6,7,Papua New Guinea
85031,4/1/2024,PNG,Sabah,4,2,2,Papua New Guinea
85032,4/1/2024,PNG,Sarawak,3,2,1,Papua New Guinea
85033,4/1/2024,PNG,Selangor,81,48,33,Papua New Guinea
85034,4/1/2024,POL,Johor,377,223,154,Poland
85035,4/1/2024,POL,Kedah,194,94,100,Poland
85036,4/1/2024,POL,Kelantan,3,3,0,Poland
85037,4/1/2024,POL,Pahang,1,0,1,Poland
85038,4/1/2024,POL,Perak,4,1,3,Poland
85039,4/1/2024,POL,Perlis,13,9,4,Poland
85040,4/1/2024,POL,Pulau Pinang,88,47,41,Poland
85041,4/1/2024,POL,Sabah,59,27,32,Poland
85042,4/1/2024,POL,Sarawak,67,38,29,Poland
85043,4/1/2024,POL,Selangor,1570,807,763,Poland
85044,4/1/2024,POL,W.P. Labuan,3,2,1,Poland
85045,4/1/2024,PRI,Sabah,1,0,1,Puerto Rico
85046,4/1/2024,PRT,Johor,208,117,91,Portugal
85047,4/1/2024,PRT,Kedah,128,62,66,Portugal
85048,4/1/2024,PRT,Kelantan,1,0,1,Portugal
85049,4/1/2024,PRT,Pahang,1,1,0,Portugal
85050,4/1/2024,PRT,Perak,2,1,1,Portugal
85051,4/1/2024,PRT,Perlis,10,3,7,Portugal
85052,4/1/2024,PRT,Pulau Pinang,46,30,16,Portugal
85053,4/1/2024,PRT,Sabah,97,54,43,Portugal
85054,4/1/2024,PRT,Sarawak,14,8,6,Portugal
85055,4/1/2024,PRT,Selangor,961,557,404,Portugal
85056,4/1/2024,PRY,Johor,3,2,1,Paraguay
85057,4/1/2024,PRY,Sabah,3,2,1,Paraguay
85058,4/1/2024,PRY,Selangor,9,5,4,Paraguay
85059,4/1/2024,PSE,Johor,29,28,1,"Palestinian Territory, Occupied"
85060,4/1/2024,PSE,Kedah,2,1,1,"Palestinian Territory, Occupied"
85061,4/1/2024,PSE,Pulau Pinang,2,2,0,"Palestinian Territory, Occupied"
85062,4/1/2024,PSE,Sabah,1,1,0,"Palestinian Territory, Occupied"
85063,4/1/2024,PSE,Sarawak,1,1,0,"Palestinian Territory, Occupied"
85064,4/1/2024,PSE,Selangor,270,205,65,"Palestinian Territory, Occupied"
85065,4/1/2024,QAT,Johor,2,2,0,Qatar
85066,4/1/2024,QAT,Kedah,2,1,1,Qatar
85067,4/1/2024,QAT,Selangor,137,86,51,Qatar
85068,4/1/2024,ROU,Johor,215,110,105,Romania
85069,4/1/2024,ROU,Kedah,27,12,15,Romania
85070,4/1/2024,ROU,Pahang,2,2,0,Romania
85071,4/1/2024,ROU,Perak,3,1,2,Romania
85072,4/1/2024,ROU,Perlis,2,2,0,Romania
85073,4/1/2024,ROU,Pulau Pinang,14,9,5,Romania
85074,4/1/2024,ROU,Sabah,9,6,3,Romania
85075,4/1/2024,ROU,Sarawak,8,7,1,Romania
85076,4/1/2024,ROU,Selangor,765,365,400,Romania
85077,4/1/2024,RUS,Johor,465,222,243,Russia
85078,4/1/2024,RUS,Kedah,454,214,240,Russia
85079,4/1/2024,RUS,Kelantan,29,16,13,Russia
85080,4/1/2024,RUS,Melaka,1,0,1,Russia
85081,4/1/2024,RUS,Pahang,3,1,2,Russia
85082,4/1/2024,RUS,Perak,6,3,3,Russia
85083,4/1/2024,RUS,Perlis,86,51,35,Russia
85084,4/1/2024,RUS,Pulau Pinang,147,83,64,Russia
85085,4/1/2024,RUS,Sabah,54,27,27,Russia
85086,4/1/2024,RUS,Sarawak,49,28,21,Russia
85087,4/1/2024,RUS,Selangor,10143,4933,5210,Russia
85088,4/1/2024,RUS,W.P. Labuan,7,3,4,Russia
85089,4/1/2024,RWA,Johor,5,1,4,Rwanda
85090,4/1/2024,RWA,Selangor,9,6,3,Rwanda
85091,4/1/2024,SAU,Johor,157,79,78,Saudi Arabia
85092,4/1/2024,SAU,Kedah,21,16,5,Saudi Arabia
85093,4/1/2024,SAU,Kelantan,2,2,0,Saudi Arabia
85094,4/1/2024,SAU,Perlis,2,2,0,Saudi Arabia
85095,4/1/2024,SAU,Pulau Pinang,12,8,4,Saudi Arabia
85096,4/1/2024,SAU,Sabah,4,2,2,Saudi Arabia
85097,4/1/2024,SAU,Sarawak,12,7,5,Saudi Arabia
85098,4/1/2024,SAU,Selangor,2426,1444,982,Saudi Arabia
85099,4/1/2024,SDN,Johor,18,13,5,Sudan
85100,4/1/2024,SDN,Kedah,6,2,4,Sudan
85101,4/1/2024,SDN,Pulau Pinang,3,2,1,Sudan
85102,4/1/2024,SDN,Sarawak,7,5,2,Sudan
85103,4/1/2024,SDN,Selangor,819,499,320,Sudan
85104,4/1/2024,SDN,W.P. Labuan,2,2,0,Sudan
85105,4/1/2024,SEN,Johor,2,2,0,Senegal
85106,4/1/2024,SEN,Selangor,82,50,32,Senegal
85107,4/1/2024,SGP,Johor,1306727,756435,550292,Singapore
85108,4/1/2024,SGP,Kedah,2536,1314,1222,Singapore
85109,4/1/2024,SGP,Kelantan,49,33,16,Singapore
85110,4/1/2024,SGP,Melaka,39,27,12,Singapore
85111,4/1/2024,SGP,Negeri Sembilan,1,0,1,Singapore
85112,4/1/2024,SGP,Pahang,423,224,199,Singapore
85113,4/1/2024,SGP,Perak,5174,2415,2759,Singapore
85114,4/1/2024,SGP,Perlis,159,107,52,Singapore
85115,4/1/2024,SGP,Pulau Pinang,14246,7028,7218,Singapore
85116,4/1/2024,SGP,Sabah,1504,788,716,Singapore
85117,4/1/2024,SGP,Sarawak,3293,1867,1426,Singapore
85118,4/1/2024,SGP,Selangor,45315,23122,22193,Singapore
85119,4/1/2024,SGP,W.P. Labuan,3,3,0,Singapore
85120,4/1/2024,SLB,Johor,3,3,0,Solomon Islands
85121,4/1/2024,SLB,Pulau Pinang,1,0,1,Solomon Islands
85122,4/1/2024,SLB,Sarawak,10,2,8,Solomon Islands
85123,4/1/2024,SLB,Selangor,5,4,1,Solomon Islands
85124,4/1/2024,SLE,Johor,2,1,1,Sierra Leone
85125,4/1/2024,SLE,Selangor,10,6,4,Sierra Leone
85126,4/1/2024,SLV,Kedah,1,0,1,El Salvador
85127,4/1/2024,SLV,Selangor,15,11,4,El Salvador
85128,4/1/2024,SMR,Selangor,7,5,2,San Marino
85129,4/1/2024,SOM,Kelantan,2,0,2,Somalia
85130,4/1/2024,SOM,Pulau Pinang,5,1,4,Somalia
85131,4/1/2024,SOM,Selangor,194,107,87,Somalia
85132,4/1/2024,SRB,Johor,15,11,4,Serbia
85133,4/1/2024,SRB,Kedah,1,1,0,Serbia
85134,4/1/2024,SRB,Pahang,1,1,0,Serbia
85135,4/1/2024,SRB,Perak,1,1,0,Serbia
85136,4/1/2024,SRB,Perlis,1,0,1,Serbia
85137,4/1/2024,SRB,Pulau Pinang,2,2,0,Serbia
85138,4/1/2024,SRB,Sabah,1,1,0,Serbia
85139,4/1/2024,SRB,Sarawak,4,2,2,Serbia
85140,4/1/2024,SRB,Selangor,87,51,36,Serbia
85141,4/1/2024,STP,Selangor,1,0,1,Sao Tome and Principe
85142,4/1/2024,SUR,Johor,3,2,1,Suriname
85143,4/1/2024,SUR,Pulau Pinang,3,2,1,Suriname
85144,4/1/2024,SUR,Selangor,23,14,9,Suriname
85145,4/1/2024,SVK,Johor,56,31,25,Slovakia
85146,4/1/2024,SVK,Kedah,77,41,36,Slovakia
85147,4/1/2024,SVK,Perlis,2,1,1,Slovakia
85148,4/1/2024,SVK,Pulau Pinang,20,14,6,Slovakia
85149,4/1/2024,SVK,Sabah,3,3,0,Slovakia
85150,4/1/2024,SVK,Sarawak,6,3,3,Slovakia
85151,4/1/2024,SVK,Selangor,327,163,164,Slovakia
85152,4/1/2024,SVN,Johor,38,16,22,Slovenia
85153,4/1/2024,SVN,Kedah,14,6,8,Slovenia
85154,4/1/2024,SVN,Sabah,1,0,1,Slovenia
85155,4/1/2024,SVN,Sarawak,2,0,2,Slovenia
85156,4/1/2024,SVN,Selangor,205,110,95,Slovenia
85157,4/1/2024,SWE,Johor,243,147,96,Sweden
85158,4/1/2024,SWE,Kedah,160,61,99,Sweden
85159,4/1/2024,SWE,Kelantan,5,5,0,Sweden
85160,4/1/2024,SWE,Perak,6,3,3,Sweden
85161,4/1/2024,SWE,Perlis,5,4,1,Sweden
85162,4/1/2024,SWE,Pulau Pinang,64,42,22,Sweden
85163,4/1/2024,SWE,Sabah,14,10,4,Sweden
85164,4/1/2024,SWE,Sarawak,18,13,5,Sweden
85165,4/1/2024,SWE,Selangor,965,558,407,Sweden
85166,4/1/2024,SWE,W.P. Labuan,1,1,0,Sweden
85167,4/1/2024,SWZ,Johor,1,1,0,Swaziland
85168,4/1/2024,SWZ,Selangor,21,8,13,Swaziland
85169,4/1/2024,SYC,Johor,10,4,6,Seychelles
85170,4/1/2024,SYC,Selangor,132,57,75,Seychelles
85171,4/1/2024,SYR,Johor,27,20,7,Syrian Arab Republic
85172,4/1/2024,SYR,Kedah,24,9,15,Syrian Arab Republic
85173,4/1/2024,SYR,Perlis,1,1,0,Syrian Arab Republic
85174,4/1/2024,SYR,Pulau Pinang,7,6,1,Syrian Arab Republic
85175,4/1/2024,SYR,Sabah,1,1,0,Syrian Arab Republic
85176,4/1/2024,SYR,Sarawak,2,2,0,Syrian Arab Republic
85177,4/1/2024,SYR,Selangor,529,345,184,Syrian Arab Republic
85178,4/1/2024,TCD,Selangor,22,18,4,Chad
85179,4/1/2024,TGO,Johor,1,1,0,Togo
85180,4/1/2024,TGO,Sarawak,1,0,1,Togo
85181,4/1/2024,TGO,Selangor,7,3,4,Togo
85182,4/1/2024,THA,Johor,10451,3285,7166,Thailand
85183,4/1/2024,THA,Kedah,46961,26232,20729,Thailand
85184,4/1/2024,THA,Kelantan,54643,27067,27576,Thailand
85185,4/1/2024,THA,Negeri Sembilan,1,0,1,Thailand
85186,4/1/2024,THA,Pahang,7,4,3,Thailand
85187,4/1/2024,THA,Perak,11918,5467,6451,Thailand
85188,4/1/2024,THA,Perlis,51523,29059,22464,Thailand
85189,4/1/2024,THA,Pulau Pinang,2627,977,1650,Thailand
85190,4/1/2024,THA,Sabah,32,13,19,Thailand
85191,4/1/2024,THA,Sarawak,405,123,282,Thailand
85192,4/1/2024,THA,Selangor,15232,5653,9579,Thailand
85193,4/1/2024,THA,W.P. Labuan,11,5,6,Thailand
85194,4/1/2024,TJK,Johor,1,0,1,Tajikistan
85195,4/1/2024,TJK,Kedah,3,3,0,Tajikistan
85196,4/1/2024,TJK,Sabah,5,4,1,Tajikistan
85197,4/1/2024,TJK,Selangor,108,70,38,Tajikistan
85198,4/1/2024,TKM,Johor,6,3,3,Turkmenistan
85199,4/1/2024,TKM,Kedah,8,4,4,Turkmenistan
85200,4/1/2024,TKM,Sarawak,1,1,0,Turkmenistan
85201,4/1/2024,TKM,Selangor,325,173,152,Turkmenistan
85202,4/1/2024,TLS,Johor,5,4,1,Timor-Leste
85203,4/1/2024,TLS,Pulau Pinang,6,3,3,Timor-Leste
85204,4/1/2024,TLS,Sarawak,6,5,1,Timor-Leste
85205,4/1/2024,TLS,Selangor,178,101,77,Timor-Leste
85206,4/1/2024,TON,Johor,1,1,0,Tonga
85207,4/1/2024,TON,Kedah,1,0,1,Tonga
85208,4/1/2024,TON,Pulau Pinang,2,0,2,Tonga
85209,4/1/2024,TON,Selangor,21,8,13,Tonga
85210,4/1/2024,TTO,Johor,8,3,5,Trinidad and Tobago
85211,4/1/2024,TTO,Sarawak,1,1,0,Trinidad and Tobago
85212,4/1/2024,TTO,Selangor,28,14,14,Trinidad and Tobago
85213,4/1/2024,TUN,Johor,17,11,6,Tunisia
85214,4/1/2024,TUN,Kedah,4,2,2,Tunisia
85215,4/1/2024,TUN,Pulau Pinang,6,1,5,Tunisia
85216,4/1/2024,TUN,Sabah,1,1,0,Tunisia
85217,4/1/2024,TUN,Sarawak,1,1,0,Tunisia
85218,4/1/2024,TUN,Selangor,655,338,317,Tunisia
85219,4/1/2024,TUR,Johor,404,238,166,Turkey
85220,4/1/2024,TUR,Kedah,61,39,22,Turkey
85221,4/1/2024,TUR,Kelantan,2,2,0,Turkey
85222,4/1/2024,TUR,Melaka,1,1,0,Turkey
85223,4/1/2024,TUR,Perak,3,3,0,Turkey
85224,4/1/2024,TUR,Perlis,22,17,5,Turkey
85225,4/1/2024,TUR,Pulau Pinang,41,31,10,Turkey
85226,4/1/2024,TUR,Sabah,4,2,2,Turkey
85227,4/1/2024,TUR,Sarawak,30,22,8,Turkey
85228,4/1/2024,TUR,Selangor,2000,1280,720,Turkey
85229,4/1/2024,TUV,Johor,1,1,0,Tuvalu
85230,4/1/2024,TWN,Johor,7988,3317,4671,Taiwan
85231,4/1/2024,TWN,Kedah,232,96,136,Taiwan
85232,4/1/2024,TWN,Kelantan,11,10,1,Taiwan
85233,4/1/2024,TWN,Pahang,3,3,0,Taiwan
85234,4/1/2024,TWN,Perak,89,38,51,Taiwan
85235,4/1/2024,TWN,Perlis,36,21,15,Taiwan
85236,4/1/2024,TWN,Pulau Pinang,3454,1741,1713,Taiwan
85237,4/1/2024,TWN,Sabah,2136,1016,1120,Taiwan
85238,4/1/2024,TWN,Sarawak,328,125,203,Taiwan
85239,4/1/2024,TWN,Selangor,14443,6867,7576,Taiwan
85240,4/1/2024,TWN,W.P. Labuan,2,1,1,Taiwan
85241,4/1/2024,TZA,Johor,16,9,7,"Tanzania, United Republic of"
85242,4/1/2024,TZA,Perak,1,1,0,"Tanzania, United Republic of"
85243,4/1/2024,TZA,Selangor,148,81,67,"Tanzania, United Republic of"
85244,4/1/2024,UGA,Johor,11,6,5,Uganda
85245,4/1/2024,UGA,Kedah,1,1,0,Uganda
85246,4/1/2024,UGA,Sarawak,2,2,0,Uganda
85247,4/1/2024,UGA,Selangor,109,41,68,Uganda
85248,4/1/2024,UKR,Johor,114,50,64,Ukraine
85249,4/1/2024,UKR,Kedah,46,24,22,Ukraine
85250,4/1/2024,UKR,Kelantan,6,3,3,Ukraine
85251,4/1/2024,UKR,Pahang,1,1,0,Ukraine
85252,4/1/2024,UKR,Perak,2,2,0,Ukraine
85253,4/1/2024,UKR,Perlis,11,7,4,Ukraine
85254,4/1/2024,UKR,Pulau Pinang,18,8,10,Ukraine
85255,4/1/2024,UKR,Sabah,8,5,3,Ukraine
85256,4/1/2024,UKR,Sarawak,5,4,1,Ukraine
85257,4/1/2024,UKR,Selangor,1165,568,597,Ukraine
85258,4/1/2024,UKR,W.P. Labuan,1,1,0,Ukraine
85259,4/1/2024,URY,Johor,62,25,37,Uruguay
85260,4/1/2024,URY,Kedah,4,3,1,Uruguay
85261,4/1/2024,URY,Selangor,112,37,75,Uruguay
85262,4/1/2024,USA,Johor,4625,2661,1964,United States Of America
85263,4/1/2024,USA,Kedah,490,271,219,United States Of America
85264,4/1/2024,USA,Kelantan,16,16,0,United States Of America
85265,4/1/2024,USA,Melaka,1,1,0,United States Of America
85266,4/1/2024,USA,Pahang,6,3,3,United States Of America
85267,4/1/2024,USA,Perak,125,72,53,United States Of America
85268,4/1/2024,USA,Perlis,117,82,35,United States Of America
85269,4/1/2024,USA,Pulau Pinang,1890,1121,769,United States Of America
85270,4/1/2024,USA,Sabah,441,226,215,United States Of America
85271,4/1/2024,USA,Sarawak,263,151,112,United States Of America
85272,4/1/2024,USA,Selangor,15326,8680,6646,United States Of America
85273,4/1/2024,USA,W.P. Labuan,4,3,1,United States Of America
85274,4/1/2024,UZB,Johor,77,63,14,Uzbekistan
85275,4/1/2024,UZB,Kedah,12,4,8,Uzbekistan
85276,4/1/2024,UZB,Kelantan,2,1,1,Uzbekistan
85277,4/1/2024,UZB,Perlis,1,1,0,Uzbekistan
85278,4/1/2024,UZB,Sabah,6,5,1,Uzbekistan
85279,4/1/2024,UZB,Sarawak,1,0,1,Uzbekistan
85280,4/1/2024,UZB,Selangor,1006,633,373,Uzbekistan
85281,4/1/2024,VAT,Johor,2,2,0,Holy See (Vatican City State)
85282,4/1/2024,VAT,Selangor,1,1,0,Holy See (Vatican City State)
85283,4/1/2024,VCT,Selangor,2,2,0,Saint Vincent and the Grenadines
85284,4/1/2024,VEN,Johor,19,11,8,Venezuela
85285,4/1/2024,VEN,Kedah,8,6,2,Venezuela
85286,4/1/2024,VEN,Pulau Pinang,1,1,0,Venezuela
85287,4/1/2024,VEN,Sarawak,5,2,3,Venezuela
85288,4/1/2024,VEN,Selangor,99,51,48,Venezuela
85289,4/1/2024,VNM,Johor,13689,4083,9606,Vietnam
85290,4/1/2024,VNM,Kedah,289,52,237,Vietnam
85291,4/1/2024,VNM,Kelantan,10,5,5,Vietnam
85292,4/1/2024,VNM,Perak,117,7,110,Vietnam
85293,4/1/2024,VNM,Perlis,188,18,170,Vietnam
85294,4/1/2024,VNM,Pulau Pinang,1295,367,928,Vietnam
85295,4/1/2024,VNM,Sabah,27,7,20,Vietnam
85296,4/1/2024,VNM,Sarawak,428,72,356,Vietnam
85297,4/1/2024,VNM,Selangor,16746,5613,11133,Vietnam
85298,4/1/2024,VNM,W.P. Labuan,1,0,1,Vietnam
85299,4/1/2024,VUT,Johor,24,20,4,Vanuatu
85300,4/1/2024,VUT,Kedah,1,1,0,Vanuatu
85301,4/1/2024,VUT,Perlis,1,1,0,Vanuatu
85302,4/1/2024,VUT,Pulau Pinang,6,5,1,Vanuatu
85303,4/1/2024,VUT,Selangor,92,80,12,Vanuatu
85304,4/1/2024,WSM,Selangor,3,0,3,Samoa
85305,4/1/2024,YEM,Johor,30,25,5,Yemen
85306,4/1/2024,YEM,Kedah,4,3,1,Yemen
85307,4/1/2024,YEM,Melaka,2,1,1,Yemen
85308,4/1/2024,YEM,Perlis,1,1,0,Yemen
85309,4/1/2024,YEM,Pulau Pinang,2,1,1,Yemen
85310,4/1/2024,YEM,Sarawak,4,4,0,Yemen
85311,4/1/2024,YEM,Selangor,1081,746,335,Yemen
85312,4/1/2024,ZAF,Johor,248,153,95,South Africa
85313,4/1/2024,ZAF,Kedah,38,24,14,South Africa
85314,4/1/2024,ZAF,Kelantan,1,0,1,South Africa
85315,4/1/2024,ZAF,Perlis,6,4,2,South Africa
85316,4/1/2024,ZAF,Pulau Pinang,55,27,28,South Africa
85317,4/1/2024,ZAF,Sabah,28,15,13,South Africa
85318,4/1/2024,ZAF,Sarawak,95,38,57,South Africa
85319,4/1/2024,ZAF,Selangor,943,516,427,South Africa
85320,4/1/2024,ZAF,W.P. Labuan,15,5,10,South Africa
85321,4/1/2024,ZMB,Johor,4,3,1,Zambia
85322,4/1/2024,ZMB,Kedah,2,1,1,Zambia
85323,4/1/2024,ZMB,Perak,1,0,1,Zambia
85324,4/1/2024,ZMB,Pulau Pinang,2,1,1,Zambia
85325,4/1/2024,ZMB,Selangor,56,25,31,Zambia
85326,4/1/2024,ZWE,Johor,20,7,13,Zimbabwe
85327,4/1/2024,ZWE,Kedah,2,0,2,Zimbabwe
85328,4/1/2024,ZWE,Pulau Pinang,1,0,1,Zimbabwe
85329,4/1/2024,ZWE,Selangor,144,63,81,Zimbabwe
85330,5/1/2024,AFG,Johor,1,1,0,Afghanistan
85331,5/1/2024,AFG,Pulau Pinang,2,2,0,Afghanistan
85332,5/1/2024,AFG,Selangor,42,26,16,Afghanistan
85333,5/1/2024,AGO,Selangor,2,2,0,Angola
85334,5/1/2024,ALB,Johor,14,12,2,Albania
85335,5/1/2024,ALB,Pulau Pinang,1,1,0,Albania
85336,5/1/2024,ALB,Sabah,1,1,0,Albania
85337,5/1/2024,ALB,Selangor,26,11,15,Albania
85338,5/1/2024,AND,Perlis,1,1,0,Andorra
85339,5/1/2024,AND,Pulau Pinang,1,1,0,Andorra
85340,5/1/2024,AND,Selangor,13,11,2,Andorra
85341,5/1/2024,ARE,Johor,20,7,13,United Arab Emirates
85342,5/1/2024,ARE,Kedah,6,5,1,United Arab Emirates
85343,5/1/2024,ARE,Perak,1,1,0,United Arab Emirates
85344,5/1/2024,ARE,Pulau Pinang,7,5,2,United Arab Emirates
85345,5/1/2024,ARE,Sabah,2,1,1,United Arab Emirates
85346,5/1/2024,ARE,Selangor,284,182,102,United Arab Emirates
85347,5/1/2024,ARG,Johor,85,51,34,Argentina
85348,5/1/2024,ARG,Kedah,48,27,21,Argentina
85349,5/1/2024,ARG,Kelantan,1,0,1,Argentina
85350,5/1/2024,ARG,Perak,1,1,0,Argentina
85351,5/1/2024,ARG,Perlis,1,0,1,Argentina
85352,5/1/2024,ARG,Pulau Pinang,8,6,2,Argentina
85353,5/1/2024,ARG,Sarawak,5,5,0,Argentina
85354,5/1/2024,ARG,Selangor,422,217,205,Argentina
85355,5/1/2024,ARM,Johor,1,1,0,Armenia
85356,5/1/2024,ARM,Kedah,3,0,3,Armenia
85357,5/1/2024,ARM,Pulau Pinang,1,0,1,Armenia
85358,5/1/2024,ARM,Selangor,63,36,27,Armenia
85359,5/1/2024,ATG,Johor,7,6,1,Antigua and Barbuda
85360,5/1/2024,ATG,Pulau Pinang,1,1,0,Antigua and Barbuda
85361,5/1/2024,ATG,Sabah,1,0,1,Antigua and Barbuda
85362,5/1/2024,ATG,Selangor,11,10,1,Antigua and Barbuda
85363,5/1/2024,AUS,Johor,4697,2892,1805,Australia
85364,5/1/2024,AUS,Kedah,566,328,238,Australia
85365,5/1/2024,AUS,Kelantan,5,4,1,Australia
85366,5/1/2024,AUS,Melaka,4,3,1,Australia
85367,5/1/2024,AUS,Pahang,55,25,30,Australia
85368,5/1/2024,AUS,Perak,170,90,80,Australia
85369,5/1/2024,AUS,Perlis,60,40,20,Australia
85370,5/1/2024,AUS,Pulau Pinang,1719,915,804,Australia
85371,5/1/2024,AUS,Sabah,310,165,145,Australia
85372,5/1/2024,AUS,Sarawak,575,341,234,Australia
85373,5/1/2024,AUS,Selangor,18706,11064,7642,Australia
85374,5/1/2024,AUS,W.P. Labuan,3,3,0,Australia
85375,5/1/2024,AUT,Johor,196,136,60,Austria
85376,5/1/2024,AUT,Kedah,49,27,22,Austria
85377,5/1/2024,AUT,Kelantan,9,7,2,Austria
85378,5/1/2024,AUT,Pahang,1,0,1,Austria
85379,5/1/2024,AUT,Perak,2,2,0,Austria
85380,5/1/2024,AUT,Perlis,8,5,3,Austria
85381,5/1/2024,AUT,Pulau Pinang,66,46,20,Austria
85382,5/1/2024,AUT,Sabah,13,5,8,Austria
85383,5/1/2024,AUT,Sarawak,17,12,5,Austria
85384,5/1/2024,AUT,Selangor,736,453,283,Austria
85385,5/1/2024,AZE,Johor,7,5,2,Azerbaijan
85386,5/1/2024,AZE,Kedah,4,1,3,Azerbaijan
85387,5/1/2024,AZE,Perlis,1,1,0,Azerbaijan
85388,5/1/2024,AZE,Pulau Pinang,1,1,0,Azerbaijan
85389,5/1/2024,AZE,Selangor,68,33,35,Azerbaijan
85390,5/1/2024,BDI,Pulau Pinang,1,1,0,Burundi
85391,5/1/2024,BDI,Selangor,2,2,0,Burundi
85392,5/1/2024,BEL,Johor,302,185,117,Belgium
85393,5/1/2024,BEL,Kedah,64,30,34,Belgium
85394,5/1/2024,BEL,Kelantan,2,1,1,Belgium
85395,5/1/2024,BEL,Pahang,1,0,1,Belgium
85396,5/1/2024,BEL,Perak,3,2,1,Belgium
85397,5/1/2024,BEL,Perlis,11,5,6,Belgium
85398,5/1/2024,BEL,Pulau Pinang,75,55,20,Belgium
85399,5/1/2024,BEL,Sabah,31,15,16,Belgium
85400,5/1/2024,BEL,Sarawak,31,16,15,Belgium
85401,5/1/2024,BEL,Selangor,1470,839,631,Belgium
85402,5/1/2024,BEN,Johor,3,1,2,Benin
85403,5/1/2024,BEN,Pulau Pinang,1,1,0,Benin
85404,5/1/2024,BEN,Selangor,13,10,3,Benin
85405,5/1/2024,BFA,Selangor,5,5,0,Burkina Faso
85406,5/1/2024,BGD,Johor,2612,2060,552,Bangladesh
85407,5/1/2024,BGD,Kedah,82,52,30,Bangladesh
85408,5/1/2024,BGD,Kelantan,1,1,0,Bangladesh
85409,5/1/2024,BGD,Perak,2,2,0,Bangladesh
85410,5/1/2024,BGD,Perlis,5,1,4,Bangladesh
85411,5/1/2024,BGD,Pulau Pinang,590,556,34,Bangladesh
85412,5/1/2024,BGD,Sabah,9,8,1,Bangladesh
85413,5/1/2024,BGD,Sarawak,144,116,28,Bangladesh
85414,5/1/2024,BGD,Selangor,63866,62404,1462,Bangladesh
85415,5/1/2024,BGD,W.P. Labuan,5,4,1,Bangladesh
85416,5/1/2024,BGR,Johor,51,29,22,Bulgaria
85417,5/1/2024,BGR,Kedah,7,3,4,Bulgaria
85418,5/1/2024,BGR,Perak,2,1,1,Bulgaria
85419,5/1/2024,BGR,Sabah,3,1,2,Bulgaria
85420,5/1/2024,BGR,Sarawak,1,1,0,Bulgaria
85421,5/1/2024,BGR,Selangor,253,132,121,Bulgaria
85422,5/1/2024,BHR,Johor,3,2,1,Bahrain
85423,5/1/2024,BHR,Kedah,2,2,0,Bahrain
85424,5/1/2024,BHR,Sarawak,1,1,0,Bahrain
85425,5/1/2024,BHR,Selangor,101,76,25,Bahrain
85426,5/1/2024,BHS,Johor,2,1,1,Bahamas
85427,5/1/2024,BHS,Selangor,8,4,4,Bahamas
85428,5/1/2024,BIH,Johor,9,7,2,Bosnia and Herzegovina
85429,5/1/2024,BIH,Kedah,1,0,1,Bosnia and Herzegovina
85430,5/1/2024,BIH,Pulau Pinang,2,2,0,Bosnia and Herzegovina
85431,5/1/2024,BIH,Sarawak,1,1,0,Bosnia and Herzegovina
85432,5/1/2024,BIH,Selangor,86,40,46,Bosnia and Herzegovina
85433,5/1/2024,BLR,Johor,18,10,8,Belarus
85434,5/1/2024,BLR,Kedah,9,2,7,Belarus
85435,5/1/2024,BLR,Kelantan,6,4,2,Belarus
85436,5/1/2024,BLR,Perlis,1,0,1,Belarus
85437,5/1/2024,BLR,Pulau Pinang,2,1,1,Belarus
85438,5/1/2024,BLR,Sabah,4,2,2,Belarus
85439,5/1/2024,BLR,Selangor,349,162,187,Belarus
85440,5/1/2024,BLZ,Johor,2,2,0,Belize
85441,5/1/2024,BLZ,Selangor,4,1,3,Belize
85442,5/1/2024,BOL,Johor,6,2,4,Bolivia
85443,5/1/2024,BOL,Selangor,21,11,10,Bolivia
85444,5/1/2024,BRA,Johor,307,155,152,Brazil
85445,5/1/2024,BRA,Kedah,68,36,32,Brazil
85446,5/1/2024,BRA,Kelantan,1,1,0,Brazil
85447,5/1/2024,BRA,Perak,5,2,3,Brazil
85448,5/1/2024,BRA,Perlis,10,3,7,Brazil
85449,5/1/2024,BRA,Pulau Pinang,22,14,8,Brazil
85450,5/1/2024,BRA,Sabah,7,1,6,Brazil
85451,5/1/2024,BRA,Sarawak,3,3,0,Brazil
85452,5/1/2024,BRA,Selangor,958,560,398,Brazil
85453,5/1/2024,BRB,Johor,2,0,2,Barbados
85454,5/1/2024,BRB,Selangor,11,5,6,Barbados
85455,5/1/2024,BRN,Johor,369,190,179,Brunei Darussalam
85456,5/1/2024,BRN,Kedah,41,25,16,Brunei Darussalam
85457,5/1/2024,BRN,Kelantan,15,7,8,Brunei Darussalam
85458,5/1/2024,BRN,Perak,7,4,3,Brunei Darussalam
85459,5/1/2024,BRN,Perlis,17,7,10,Brunei Darussalam
85460,5/1/2024,BRN,Pulau Pinang,9,3,6,Brunei Darussalam
85461,5/1/2024,BRN,Sabah,1066,488,578,Brunei Darussalam
85462,5/1/2024,BRN,Sarawak,136931,74214,62717,Brunei Darussalam
85463,5/1/2024,BRN,Selangor,4778,2312,2466,Brunei Darussalam
85464,5/1/2024,BRN,W.P. Labuan,1549,907,642,Brunei Darussalam
85465,5/1/2024,BTN,Johor,13,9,4,Bhutan
85466,5/1/2024,BTN,Perak,2,1,1,Bhutan
85467,5/1/2024,BTN,Pulau Pinang,78,38,40,Bhutan
85468,5/1/2024,BTN,Sabah,1,0,1,Bhutan
85469,5/1/2024,BTN,Selangor,155,104,51,Bhutan
85470,5/1/2024,BWA,Selangor,7,5,2,Botswana
85471,5/1/2024,CAN,Johor,1608,908,700,Canada
85472,5/1/2024,CAN,Kedah,149,78,71,Canada
85473,5/1/2024,CAN,Kelantan,8,7,1,Canada
85474,5/1/2024,CAN,Pahang,5,4,1,Canada
85475,5/1/2024,CAN,Perak,26,12,14,Canada
85476,5/1/2024,CAN,Perlis,19,9,10,Canada
85477,5/1/2024,CAN,Pulau Pinang,466,259,207,Canada
85478,5/1/2024,CAN,Sabah,151,73,78,Canada
85479,5/1/2024,CAN,Sarawak,413,234,179,Canada
85480,5/1/2024,CAN,Selangor,4131,2351,1780,Canada
85481,5/1/2024,CAN,W.P. Labuan,3,1,2,Canada
85482,5/1/2024,CCK,Selangor,1,0,1,Cocos (Keeling) Islands
85483,5/1/2024,CHE,Johor,426,264,162,Switzerland
85484,5/1/2024,CHE,Kedah,107,58,49,Switzerland
85485,5/1/2024,CHE,Kelantan,5,3,2,Switzerland
85486,5/1/2024,CHE,Perak,12,6,6,Switzerland
85487,5/1/2024,CHE,Perlis,14,5,9,Switzerland
85488,5/1/2024,CHE,Pulau Pinang,150,112,38,Switzerland
85489,5/1/2024,CHE,Sabah,26,11,15,Switzerland
85490,5/1/2024,CHE,Sarawak,34,18,16,Switzerland
85491,5/1/2024,CHE,Selangor,1244,777,467,Switzerland
85492,5/1/2024,CHL,Johor,30,13,17,Chile
85493,5/1/2024,CHL,Kedah,18,10,8,Chile
85494,5/1/2024,CHL,Kelantan,1,1,0,Chile
85495,5/1/2024,CHL,Perlis,4,3,1,Chile
85496,5/1/2024,CHL,Pulau Pinang,5,3,2,Chile
85497,5/1/2024,CHL,Sabah,4,1,3,Chile
85498,5/1/2024,CHL,Sarawak,3,2,1,Chile
85499,5/1/2024,CHL,Selangor,295,160,135,Chile
85500,5/1/2024,CHN,Johor,80957,35666,45291,China
85501,5/1/2024,CHN,Kedah,2085,907,1178,China
85502,5/1/2024,CHN,Kelantan,36,18,18,China
85503,5/1/2024,CHN,Melaka,15,12,3,China
85504,5/1/2024,CHN,Negeri Sembilan,2,2,0,China
85505,5/1/2024,CHN,Pahang,70,49,21,China
85506,5/1/2024,CHN,Perak,457,211,246,China
85507,5/1/2024,CHN,Perlis,375,200,175,China
85508,5/1/2024,CHN,Pulau Pinang,12562,6366,6196,China
85509,5/1/2024,CHN,Sabah,19901,8484,11417,China
85510,5/1/2024,CHN,Sarawak,1718,924,794,China
85511,5/1/2024,CHN,Selangor,151040,75790,75250,China
85512,5/1/2024,CHN,W.P. Labuan,38,33,5,China
85513,5/1/2024,CIV,Sarawak,1,1,0,C��te d'Iv
85514,5/1/2024,CIV,Selangor,29,17,12,C��te d'Iv
85515,5/1/2024,CMR,Johor,1,0,1,Cameroon
85516,5/1/2024,CMR,Selangor,36,23,13,Cameroon
85517,5/1/2024,COD,Johor,2,1,1,"Congo, the Democratic Republic of the"
85518,5/1/2024,COD,Selangor,14,11,3,"Congo, the Democratic Republic of the"
85519,5/1/2024,COG,Selangor,5,4,1,Congo
85520,5/1/2024,COL,Johor,32,14,18,Colombia
85521,5/1/2024,COL,Kedah,2,0,2,Colombia
85522,5/1/2024,COL,Pulau Pinang,6,5,1,Colombia
85523,5/1/2024,COL,Sabah,3,1,2,Colombia
85524,5/1/2024,COL,Sarawak,1,1,0,Colombia
85525,5/1/2024,COL,Selangor,185,100,85,Colombia
85526,5/1/2024,COM,Kedah,1,0,1,Comoros
85527,5/1/2024,COM,Pulau Pinang,1,1,0,Comoros
85528,5/1/2024,COM,Selangor,18,10,8,Comoros
85529,5/1/2024,CPV,Selangor,2,1,1,Cape Verde
85530,5/1/2024,CRI,Johor,17,9,8,Costa Rica
85531,5/1/2024,CRI,Pulau Pinang,4,4,0,Costa Rica
85532,5/1/2024,CRI,Sarawak,2,2,0,Costa Rica
85533,5/1/2024,CRI,Selangor,57,29,28,Costa Rica
85534,5/1/2024,CUB,Johor,12,9,3,Cuba
85535,5/1/2024,CUB,Kedah,1,0,1,Cuba
85536,5/1/2024,CUB,Pulau Pinang,3,0,3,Cuba
85537,5/1/2024,CUB,Selangor,20,10,10,Cuba
85538,5/1/2024,CYP,Johor,6,5,1,Cyprus
85539,5/1/2024,CYP,Pulau Pinang,4,0,4,Cyprus
85540,5/1/2024,CYP,Sabah,1,0,1,Cyprus
85541,5/1/2024,CYP,Selangor,83,59,24,Cyprus
85542,5/1/2024,CZE,Johor,82,37,45,Czech Republic
85543,5/1/2024,CZE,Kedah,55,24,31,Czech Republic
85544,5/1/2024,CZE,Perak,2,1,1,Czech Republic
85545,5/1/2024,CZE,Perlis,4,3,1,Czech Republic
85546,5/1/2024,CZE,Pulau Pinang,26,12,14,Czech Republic
85547,5/1/2024,CZE,Sabah,9,4,5,Czech Republic
85548,5/1/2024,CZE,Sarawak,18,11,7,Czech Republic
85549,5/1/2024,CZE,Selangor,385,239,146,Czech Republic
85550,5/1/2024,DEU,Johor,2233,1349,884,Germany
85551,5/1/2024,DEU,Kedah,659,346,313,Germany
85552,5/1/2024,DEU,Kelantan,11,9,2,Germany
85553,5/1/2024,DEU,Pahang,19,10,9,Germany
85554,5/1/2024,DEU,Perak,28,19,9,Germany
85555,5/1/2024,DEU,Perlis,68,42,26,Germany
85556,5/1/2024,DEU,Pulau Pinang,618,422,196,Germany
85557,5/1/2024,DEU,Sabah,129,69,60,Germany
85558,5/1/2024,DEU,Sarawak,226,138,88,Germany
85559,5/1/2024,DEU,Selangor,9314,5358,3956,Germany
85560,5/1/2024,DEU,W.P. Labuan,4,2,2,Germany
85561,5/1/2024,DJI,Selangor,15,5,10,Djibouti
85562,5/1/2024,DMA,Johor,10,5,5,Dominica
85563,5/1/2024,DMA,Kedah,1,1,0,Dominica
85564,5/1/2024,DMA,Perak,1,1,0,Dominica
85565,5/1/2024,DMA,Pulau Pinang,5,3,2,Dominica
85566,5/1/2024,DMA,Sabah,2,1,1,Dominica
85567,5/1/2024,DMA,Selangor,43,31,12,Dominica
85568,5/1/2024,DNK,Johor,274,216,58,Denmark
85569,5/1/2024,DNK,Kedah,66,31,35,Denmark
85570,5/1/2024,DNK,Kelantan,2,2,0,Denmark
85571,5/1/2024,DNK,Melaka,1,1,0,Denmark
85572,5/1/2024,DNK,Pahang,1,1,0,Denmark
85573,5/1/2024,DNK,Perak,1,1,0,Denmark
85574,5/1/2024,DNK,Perlis,6,1,5,Denmark
85575,5/1/2024,DNK,Pulau Pinang,61,40,21,Denmark
85576,5/1/2024,DNK,Sabah,12,9,3,Denmark
85577,5/1/2024,DNK,Sarawak,7,5,2,Denmark
85578,5/1/2024,DNK,Selangor,678,430,248,Denmark
85579,5/1/2024,DOM,Johor,1,0,1,Dominican Republic
85580,5/1/2024,DOM,Pulau Pinang,2,0,2,Dominican Republic
85581,5/1/2024,DOM,Sabah,2,2,0,Dominican Republic
85582,5/1/2024,DOM,Selangor,24,10,14,Dominican Republic
85583,5/1/2024,DZA,Johor,36,30,6,Algeria
85584,5/1/2024,DZA,Kedah,8,5,3,Algeria
85585,5/1/2024,DZA,Kelantan,1,1,0,Algeria
85586,5/1/2024,DZA,Pulau Pinang,3,3,0,Algeria
85587,5/1/2024,DZA,Sabah,4,2,2,Algeria
85588,5/1/2024,DZA,Sarawak,4,3,1,Algeria
85589,5/1/2024,DZA,Selangor,906,582,324,Algeria
85590,5/1/2024,ECU,Johor,7,3,4,Ecuador
85591,5/1/2024,ECU,Pulau Pinang,1,1,0,Ecuador
85592,5/1/2024,ECU,Selangor,87,45,42,Ecuador
85593,5/1/2024,EGY,Johor,233,196,37,Egypt
85594,5/1/2024,EGY,Kedah,12,8,4,Egypt
85595,5/1/2024,EGY,Kelantan,2,1,1,Egypt
85596,5/1/2024,EGY,Pulau Pinang,9,8,1,Egypt
85597,5/1/2024,EGY,Sabah,2,2,0,Egypt
85598,5/1/2024,EGY,Sarawak,134,96,38,Egypt
85599,5/1/2024,EGY,Selangor,1639,1141,498,Egypt
85600,5/1/2024,ERI,Selangor,19,12,7,Eritrea
85601,5/1/2024,ESP,Johor,493,317,176,Spain
85602,5/1/2024,ESP,Kedah,88,49,39,Spain
85603,5/1/2024,ESP,Kelantan,6,4,2,Spain
85604,5/1/2024,ESP,Pahang,2,1,1,Spain
85605,5/1/2024,ESP,Perak,5,5,0,Spain
85606,5/1/2024,ESP,Perlis,18,11,7,Spain
85607,5/1/2024,ESP,Pulau Pinang,137,89,48,Spain
85608,5/1/2024,ESP,Sabah,32,17,15,Spain
85609,5/1/2024,ESP,Sarawak,59,37,22,Spain
85610,5/1/2024,ESP,Selangor,2548,1456,1092,Spain
85611,5/1/2024,ESP,W.P. Labuan,4,2,2,Spain
85612,5/1/2024,EST,Johor,33,14,19,Estonia
85613,5/1/2024,EST,Kedah,5,1,4,Estonia
85614,5/1/2024,EST,Kelantan,3,3,0,Estonia
85615,5/1/2024,EST,Perlis,1,1,0,Estonia
85616,5/1/2024,EST,Pulau Pinang,2,2,0,Estonia
85617,5/1/2024,EST,Sabah,3,1,2,Estonia
85618,5/1/2024,EST,Sarawak,1,0,1,Estonia
85619,5/1/2024,EST,Selangor,85,58,27,Estonia
85620,5/1/2024,ETH,Johor,8,7,1,Ethiopia
85621,5/1/2024,ETH,Pulau Pinang,4,1,3,Ethiopia
85622,5/1/2024,ETH,Selangor,30,24,6,Ethiopia
85623,5/1/2024,FIN,Johor,226,133,93,Finland
85624,5/1/2024,FIN,Kedah,39,19,20,Finland
85625,5/1/2024,FIN,Perak,3,2,1,Finland
85626,5/1/2024,FIN,Perlis,1,1,0,Finland
85627,5/1/2024,FIN,Pulau Pinang,30,20,10,Finland
85628,5/1/2024,FIN,Sabah,10,8,2,Finland
85629,5/1/2024,FIN,Sarawak,11,5,6,Finland
85630,5/1/2024,FIN,Selangor,379,223,156,Finland
85631,5/1/2024,FJI,Johor,217,93,124,Fiji
85632,5/1/2024,FJI,Kedah,1,1,0,Fiji
85633,5/1/2024,FJI,Pulau Pinang,2,0,2,Fiji
85634,5/1/2024,FJI,Sarawak,2,2,0,Fiji
85635,5/1/2024,FJI,Selangor,147,72,75,Fiji
85636,5/1/2024,FRA,Johor,2476,1490,986,France
85637,5/1/2024,FRA,Kedah,743,385,358,France
85638,5/1/2024,FRA,Kelantan,32,18,14,France
85639,5/1/2024,FRA,Melaka,2,1,1,France
85640,5/1/2024,FRA,Negeri Sembilan,2,1,1,France
85641,5/1/2024,FRA,Pahang,32,13,19,France
85642,5/1/2024,FRA,Perak,36,25,11,France
85643,5/1/2024,FRA,Perlis,74,53,21,France
85644,5/1/2024,FRA,Pulau Pinang,391,270,121,France
85645,5/1/2024,FRA,Sabah,114,66,48,France
85646,5/1/2024,FRA,Sarawak,117,69,48,France
85647,5/1/2024,FRA,Selangor,9455,5310,4145,France
85648,5/1/2024,FRA,W.P. Labuan,1,1,0,France
85649,5/1/2024,FSM,Johor,1,0,1,"Micronesia, Federated States of"
85650,5/1/2024,FSM,Selangor,1,0,1,"Micronesia, Federated States of"
85651,5/1/2024,GAB,Johor,7,4,3,Gabon
85652,5/1/2024,GAB,Selangor,7,5,2,Gabon
85653,5/1/2024,GBR,Johor,5541,3574,1967,United Kingdom
85654,5/1/2024,GBR,Kedah,1144,577,567,United Kingdom
85655,5/1/2024,GBR,Kelantan,13,8,5,United Kingdom
85656,5/1/2024,GBR,Melaka,2,1,1,United Kingdom
85657,5/1/2024,GBR,Pahang,29,19,10,United Kingdom
85658,5/1/2024,GBR,Perak,96,54,42,United Kingdom
85659,5/1/2024,GBR,Perlis,138,90,48,United Kingdom
85660,5/1/2024,GBR,Pulau Pinang,1367,814,553,United Kingdom
85661,5/1/2024,GBR,Sabah,482,243,239,United Kingdom
85662,5/1/2024,GBR,Sarawak,1621,1018,603,United Kingdom
85663,5/1/2024,GBR,Selangor,17493,10538,6955,United Kingdom
85664,5/1/2024,GBR,W.P. Labuan,47,26,21,United Kingdom
85665,5/1/2024,GEO,Johor,19,3,16,Georgia
85666,5/1/2024,GEO,Selangor,71,37,34,Georgia
85667,5/1/2024,GHA,Johor,5,5,0,Ghana
85668,5/1/2024,GHA,Pulau Pinang,29,11,18,Ghana
85669,5/1/2024,GHA,Sarawak,1,1,0,Ghana
85670,5/1/2024,GHA,Selangor,166,105,61,Ghana
85671,5/1/2024,GIN,Johor,3,2,1,Guinea
85672,5/1/2024,GIN,Selangor,65,49,16,Guinea
85673,5/1/2024,GMB,Johor,4,2,2,Gambia
85674,5/1/2024,GMB,Sabah,1,1,0,Gambia
85675,5/1/2024,GMB,Selangor,26,20,6,Gambia
85676,5/1/2024,GNB,Selangor,1,1,0,Guinea-Bissau
85677,5/1/2024,GNQ,Selangor,2,1,1,Equatorial Guinea
85678,5/1/2024,GRC,Johor,58,43,15,Greece
85679,5/1/2024,GRC,Kedah,10,6,4,Greece
85680,5/1/2024,GRC,Perak,2,1,1,Greece
85681,5/1/2024,GRC,Pulau Pinang,10,7,3,Greece
85682,5/1/2024,GRC,Sabah,2,1,1,Greece
85683,5/1/2024,GRC,Sarawak,3,2,1,Greece
85684,5/1/2024,GRC,Selangor,262,178,84,Greece
85685,5/1/2024,GRD,Johor,8,5,3,Grenada
85686,5/1/2024,GRD,Selangor,12,12,0,Grenada
85687,5/1/2024,GTM,Johor,3,2,1,Guatemala
85688,5/1/2024,GTM,Kedah,1,1,0,Guatemala
85689,5/1/2024,GTM,Pulau Pinang,1,1,0,Guatemala
85690,5/1/2024,GTM,Selangor,26,16,10,Guatemala
85691,5/1/2024,GUY,Johor,2,1,1,Guyana
85692,5/1/2024,GUY,Selangor,10,6,4,Guyana
85693,5/1/2024,HKG,Johor,3,2,1,Hong Kong
85694,5/1/2024,HKG,Pahang,2,2,0,Hong Kong
85695,5/1/2024,HKG,Perak,71,31,40,Hong Kong
85696,5/1/2024,HKG,Perlis,1,1,0,Hong Kong
85697,5/1/2024,HKG,Pulau Pinang,5,2,3,Hong Kong
85698,5/1/2024,HKG,Sabah,108,58,50,Hong Kong
85699,5/1/2024,HKG,Selangor,17,9,8,Hong Kong
85700,5/1/2024,HND,Johor,2,2,0,Honduras
85701,5/1/2024,HND,Kedah,1,1,0,Honduras
85702,5/1/2024,HND,Pulau Pinang,1,1,0,Honduras
85703,5/1/2024,HND,Selangor,18,9,9,Honduras
85704,5/1/2024,HRV,Johor,32,28,4,Croatia
85705,5/1/2024,HRV,Kedah,2,1,1,Croatia
85706,5/1/2024,HRV,Kelantan,1,1,0,Croatia
85707,5/1/2024,HRV,Perlis,2,1,1,Croatia
85708,5/1/2024,HRV,Pulau Pinang,7,5,2,Croatia
85709,5/1/2024,HRV,Sabah,4,4,0,Croatia
85710,5/1/2024,HRV,Sarawak,2,2,0,Croatia
85711,5/1/2024,HRV,Selangor,154,110,44,Croatia
85712,5/1/2024,HTI,Johor,2,1,1,Haiti
85713,5/1/2024,HTI,Selangor,17,12,5,Haiti
85714,5/1/2024,HUN,Johor,84,55,29,Hungary
85715,5/1/2024,HUN,Kedah,24,8,16,Hungary
85716,5/1/2024,HUN,Kelantan,2,1,1,Hungary
85717,5/1/2024,HUN,Perlis,2,2,0,Hungary
85718,5/1/2024,HUN,Pulau Pinang,51,30,21,Hungary
85719,5/1/2024,HUN,Sabah,8,4,4,Hungary
85720,5/1/2024,HUN,Sarawak,6,2,4,Hungary
85721,5/1/2024,HUN,Selangor,332,190,142,Hungary
85722,5/1/2024,IDN,Johor,107867,50906,56961,Indonesia
85723,5/1/2024,IDN,Kedah,4552,1554,2998,Indonesia
85724,5/1/2024,IDN,Kelantan,122,61,61,Indonesia
85725,5/1/2024,IDN,Melaka,3906,1716,2190,Indonesia
85726,5/1/2024,IDN,Negeri Sembilan,9682,6421,3261,Indonesia
85727,5/1/2024,IDN,Pahang,69,45,24,Indonesia
85728,5/1/2024,IDN,Perak,213,81,132,Indonesia
85729,5/1/2024,IDN,Perlis,636,218,418,Indonesia
85730,5/1/2024,IDN,Pulau Pinang,38621,15442,23179,Indonesia
85731,5/1/2024,IDN,Sabah,6524,3401,3123,Indonesia
85732,5/1/2024,IDN,Sarawak,52364,29522,22842,Indonesia
85733,5/1/2024,IDN,Selangor,150031,71800,78231,Indonesia
85734,5/1/2024,IDN,W.P. Labuan,66,31,35,Indonesia
85735,5/1/2024,IND,Johor,51512,30254,21258,India
85736,5/1/2024,IND,Kedah,3071,1676,1395,India
85737,5/1/2024,IND,Kelantan,7,6,1,India
85738,5/1/2024,IND,Melaka,3,2,1,India
85739,5/1/2024,IND,Pahang,26,20,6,India
85740,5/1/2024,IND,Perak,225,140,85,India
85741,5/1/2024,IND,Perlis,66,50,16,India
85742,5/1/2024,IND,Pulau Pinang,4192,2575,1617,India
85743,5/1/2024,IND,Sabah,201,148,53,India
85744,5/1/2024,IND,Sarawak,2653,2025,628,India
85745,5/1/2024,IND,Selangor,104981,66299,38682,India
85746,5/1/2024,IND,W.P. Labuan,50,37,13,India
85747,5/1/2024,IRL,Johor,302,200,102,Ireland
85748,5/1/2024,IRL,Kedah,74,38,36,Ireland
85749,5/1/2024,IRL,Pahang,2,1,1,Ireland
85750,5/1/2024,IRL,Perak,6,5,1,Ireland
85751,5/1/2024,IRL,Perlis,10,10,0,Ireland
85752,5/1/2024,IRL,Pulau Pinang,119,71,48,Ireland
85753,5/1/2024,IRL,Sabah,22,14,8,Ireland
85754,5/1/2024,IRL,Sarawak,29,15,14,Ireland
85755,5/1/2024,IRL,Selangor,1326,796,530,Ireland
85756,5/1/2024,IRL,W.P. Labuan,4,2,2,Ireland
85757,5/1/2024,IRN,Johor,163,93,70,Iran
85758,5/1/2024,IRN,Kedah,14,6,8,Iran
85759,5/1/2024,IRN,Perak,1,1,0,Iran
85760,5/1/2024,IRN,Perlis,3,2,1,Iran
85761,5/1/2024,IRN,Pulau Pinang,22,16,6,Iran
85762,5/1/2024,IRN,Sabah,1,1,0,Iran
85763,5/1/2024,IRN,Sarawak,7,5,2,Iran
85764,5/1/2024,IRN,Selangor,1193,670,523,Iran
85765,5/1/2024,IRQ,Johor,34,22,12,Iraq
85766,5/1/2024,IRQ,Pulau Pinang,11,7,4,Iraq
85767,5/1/2024,IRQ,Sabah,1,1,0,Iraq
85768,5/1/2024,IRQ,Sarawak,6,3,3,Iraq
85769,5/1/2024,IRQ,Selangor,967,635,332,Iraq
85770,5/1/2024,ISL,Johor,4,2,2,Iceland
85771,5/1/2024,ISL,Kedah,1,1,0,Iceland
85772,5/1/2024,ISL,Pulau Pinang,4,1,3,Iceland
85773,5/1/2024,ISL,Selangor,28,17,11,Iceland
85774,5/1/2024,ITA,Johor,587,368,219,Italy
85775,5/1/2024,ITA,Kedah,127,61,66,Italy
85776,5/1/2024,ITA,Perak,11,8,3,Italy
85777,5/1/2024,ITA,Perlis,13,9,4,Italy
85778,5/1/2024,ITA,Pulau Pinang,111,82,29,Italy
85779,5/1/2024,ITA,Sabah,24,14,10,Italy
85780,5/1/2024,ITA,Sarawak,67,39,28,Italy
85781,5/1/2024,ITA,Selangor,2738,1771,967,Italy
85782,5/1/2024,ITA,W.P. Labuan,4,3,1,Italy
85783,5/1/2024,JAM,Johor,12,3,9,Jamaica
85784,5/1/2024,JAM,Pulau Pinang,1,0,1,Jamaica
85785,5/1/2024,JAM,Sarawak,3,1,2,Jamaica
85786,5/1/2024,JAM,Selangor,26,16,10,Jamaica
85787,5/1/2024,JOR,Johor,8,4,4,Jordan
85788,5/1/2024,JOR,Kedah,10,6,4,Jordan
85789,5/1/2024,JOR,Pahang,4,3,1,Jordan
85790,5/1/2024,JOR,Perlis,1,1,0,Jordan
85791,5/1/2024,JOR,Pulau Pinang,15,8,7,Jordan
85792,5/1/2024,JOR,Sarawak,1,1,0,Jordan
85793,5/1/2024,JOR,Selangor,765,485,280,Jordan
85794,5/1/2024,JPN,Johor,6543,4368,2175,Japan
85795,5/1/2024,JPN,Kedah,302,157,145,Japan
85796,5/1/2024,JPN,Kelantan,6,6,0,Japan
85797,5/1/2024,JPN,Pahang,16,12,4,Japan
85798,5/1/2024,JPN,Perak,78,51,27,Japan
85799,5/1/2024,JPN,Perlis,77,52,25,Japan
85800,5/1/2024,JPN,Pulau Pinang,1382,1017,365,Japan
85801,5/1/2024,JPN,Sabah,328,168,160,Japan
85802,5/1/2024,JPN,Sarawak,249,156,93,Japan
85803,5/1/2024,JPN,Selangor,18766,11453,7313,Japan
85804,5/1/2024,JPN,W.P. Labuan,18,14,4,Japan
85805,5/1/2024,KAZ,Johor,46,16,30,Kazakhstan
85806,5/1/2024,KAZ,Kedah,24,6,18,Kazakhstan
85807,5/1/2024,KAZ,Kelantan,1,1,0,Kazakhstan
85808,5/1/2024,KAZ,Perlis,3,3,0,Kazakhstan
85809,5/1/2024,KAZ,Pulau Pinang,9,5,4,Kazakhstan
85810,5/1/2024,KAZ,Sabah,2,1,1,Kazakhstan
85811,5/1/2024,KAZ,Sarawak,7,1,6,Kazakhstan
85812,5/1/2024,KAZ,Selangor,3198,1234,1964,Kazakhstan
85813,5/1/2024,KEN,Johor,221,77,144,Kenya
85814,5/1/2024,KEN,Kedah,3,1,2,Kenya
85815,5/1/2024,KEN,Pulau Pinang,11,6,5,Kenya
85816,5/1/2024,KEN,Sarawak,2,2,0,Kenya
85817,5/1/2024,KEN,Selangor,546,247,299,Kenya
85818,5/1/2024,KGZ,Johor,37,24,13,Kyrgyzstan
85819,5/1/2024,KGZ,Kedah,10,6,4,Kyrgyzstan
85820,5/1/2024,KGZ,Pulau Pinang,5,3,2,Kyrgyzstan
85821,5/1/2024,KGZ,Selangor,468,221,247,Kyrgyzstan
85822,5/1/2024,KHM,Johor,1719,798,921,Cambodia
85823,5/1/2024,KHM,Kedah,228,143,85,Cambodia
85824,5/1/2024,KHM,Kelantan,594,371,223,Cambodia
85825,5/1/2024,KHM,Perak,13,6,7,Cambodia
85826,5/1/2024,KHM,Perlis,666,382,284,Cambodia
85827,5/1/2024,KHM,Pulau Pinang,63,27,36,Cambodia
85828,5/1/2024,KHM,Sabah,1,0,1,Cambodia
85829,5/1/2024,KHM,Sarawak,8,4,4,Cambodia
85830,5/1/2024,KHM,Selangor,3651,1794,1857,Cambodia
85831,5/1/2024,KHM,W.P. Labuan,2,2,0,Cambodia
85832,5/1/2024,KNA,Johor,35,25,10,Saint Kitts and Nevis
85833,5/1/2024,KNA,Pulau Pinang,1,1,0,Saint Kitts and Nevis
85834,5/1/2024,KNA,Sabah,1,0,1,Saint Kitts and Nevis
85835,5/1/2024,KNA,Selangor,41,36,5,Saint Kitts and Nevis
85836,5/1/2024,KOR,Johor,9188,5165,4023,"Korea, Republic of (South Korea)"
85837,5/1/2024,KOR,Kedah,229,118,111,"Korea, Republic of (South Korea)"
85838,5/1/2024,KOR,Kelantan,3,3,0,"Korea, Republic of (South Korea)"
85839,5/1/2024,KOR,Melaka,2,1,1,"Korea, Republic of (South Korea)"
85840,5/1/2024,KOR,Negeri Sembilan,14,5,9,"Korea, Republic of (South Korea)"
85841,5/1/2024,KOR,Perak,17,8,9,"Korea, Republic of (South Korea)"
85842,5/1/2024,KOR,Perlis,34,19,15,"Korea, Republic of (South Korea)"
85843,5/1/2024,KOR,Pulau Pinang,505,294,211,"Korea, Republic of (South Korea)"
85844,5/1/2024,KOR,Sabah,11551,4754,6797,"Korea, Republic of (South Korea)"
85845,5/1/2024,KOR,Sarawak,229,123,106,"Korea, Republic of (South Korea)"
85846,5/1/2024,KOR,Selangor,11944,7122,4822,"Korea, Republic of (South Korea)"
85847,5/1/2024,KOR,W.P. Labuan,5,5,0,"Korea, Republic of (South Korea)"
85848,5/1/2024,KWT,Johor,14,7,7,Kuwait
85849,5/1/2024,KWT,Kedah,1,1,0,Kuwait
85850,5/1/2024,KWT,Pulau Pinang,6,5,1,Kuwait
85851,5/1/2024,KWT,Selangor,312,197,115,Kuwait
85852,5/1/2024,LAO,Johor,142,29,113,Lao People's Democratic Republic
85853,5/1/2024,LAO,Kedah,1240,98,1142,Lao People's Democratic Republic
85854,5/1/2024,LAO,Kelantan,238,63,175,Lao People's Democratic Republic
85855,5/1/2024,LAO,Perak,38,4,34,Lao People's Democratic Republic
85856,5/1/2024,LAO,Perlis,285,81,204,Lao People's Democratic Republic
85857,5/1/2024,LAO,Pulau Pinang,30,8,22,Lao People's Democratic Republic
85858,5/1/2024,LAO,Sabah,1,0,1,Lao People's Democratic Republic
85859,5/1/2024,LAO,Sarawak,20,11,9,Lao People's Democratic Republic
85860,5/1/2024,LAO,Selangor,272,108,164,Lao People's Democratic Republic
85861,5/1/2024,LBN,Johor,16,9,7,Lebanon
85862,5/1/2024,LBN,Kedah,4,1,3,Lebanon
85863,5/1/2024,LBN,Pulau Pinang,7,6,1,Lebanon
85864,5/1/2024,LBN,Sabah,2,2,0,Lebanon
85865,5/1/2024,LBN,Sarawak,3,3,0,Lebanon
85866,5/1/2024,LBN,Selangor,283,185,98,Lebanon
85867,5/1/2024,LBR,Johor,1,1,0,Liberia
85868,5/1/2024,LBR,Sarawak,1,1,0,Liberia
85869,5/1/2024,LBR,Selangor,10,6,4,Liberia
85870,5/1/2024,LBY,Johor,1,1,0,Libyan Arab Jamahiriya
85871,5/1/2024,LBY,Selangor,438,286,152,Libyan Arab Jamahiriya
85872,5/1/2024,LCA,Johor,3,1,2,Saint Lucia
85873,5/1/2024,LCA,Pulau Pinang,2,2,0,Saint Lucia
85874,5/1/2024,LCA,Sarawak,1,0,1,Saint Lucia
85875,5/1/2024,LCA,Selangor,16,11,5,Saint Lucia
85876,5/1/2024,LIE,Johor,2,0,2,Liechtenstein
85877,5/1/2024,LIE,Kedah,2,0,2,Liechtenstein
85878,5/1/2024,LIE,Pulau Pinang,4,4,0,Liechtenstein
85879,5/1/2024,LIE,Selangor,6,5,1,Liechtenstein
85880,5/1/2024,LKA,Johor,637,419,218,Sri Lanka
85881,5/1/2024,LKA,Kedah,62,35,27,Sri Lanka
85882,5/1/2024,LKA,Pahang,2,2,0,Sri Lanka
85883,5/1/2024,LKA,Perak,9,4,5,Sri Lanka
85884,5/1/2024,LKA,Pulau Pinang,49,32,17,Sri Lanka
85885,5/1/2024,LKA,Sabah,11,5,6,Sri Lanka
85886,5/1/2024,LKA,Sarawak,21,13,8,Sri Lanka
85887,5/1/2024,LKA,Selangor,5307,3292,2015,Sri Lanka
85888,5/1/2024,LKA,W.P. Labuan,4,3,1,Sri Lanka
85889,5/1/2024,LSO,Kedah,1,0,1,Lesotho
85890,5/1/2024,LSO,Selangor,5,3,2,Lesotho
85891,5/1/2024,LTU,Johor,56,37,19,Lithuania
85892,5/1/2024,LTU,Kedah,19,6,13,Lithuania
85893,5/1/2024,LTU,Perak,1,1,0,Lithuania
85894,5/1/2024,LTU,Perlis,2,1,1,Lithuania
85895,5/1/2024,LTU,Pulau Pinang,7,5,2,Lithuania
85896,5/1/2024,LTU,Sabah,22,10,12,Lithuania
85897,5/1/2024,LTU,Sarawak,4,3,1,Lithuania
85898,5/1/2024,LTU,Selangor,266,138,128,Lithuania
85899,5/1/2024,LUX,Johor,3,2,1,Luxembourg
85900,5/1/2024,LUX,Kedah,4,2,2,Luxembourg
85901,5/1/2024,LUX,Kelantan,1,1,0,Luxembourg
85902,5/1/2024,LUX,Pulau Pinang,2,1,1,Luxembourg
85903,5/1/2024,LUX,Sabah,1,1,0,Luxembourg
85904,5/1/2024,LUX,Sarawak,2,1,1,Luxembourg
85905,5/1/2024,LUX,Selangor,50,29,21,Luxembourg
85906,5/1/2024,LVA,Johor,12,5,7,Latvia
85907,5/1/2024,LVA,Kedah,7,4,3,Latvia
85908,5/1/2024,LVA,Pulau Pinang,7,7,0,Latvia
85909,5/1/2024,LVA,Sabah,2,1,1,Latvia
85910,5/1/2024,LVA,Sarawak,4,1,3,Latvia
85911,5/1/2024,LVA,Selangor,165,101,64,Latvia
85912,5/1/2024,MAC,Pulau Pinang,1,0,1,Macao
85913,5/1/2024,MAC,Selangor,1,0,1,Macao
85914,5/1/2024,MAR,Johor,116,63,53,Morocco
85915,5/1/2024,MAR,Kedah,10,5,5,Morocco
85916,5/1/2024,MAR,Kelantan,1,1,0,Morocco
85917,5/1/2024,MAR,Pahang,1,1,0,Morocco
85918,5/1/2024,MAR,Perlis,2,1,1,Morocco
85919,5/1/2024,MAR,Pulau Pinang,8,3,5,Morocco
85920,5/1/2024,MAR,Sabah,2,0,2,Morocco
85921,5/1/2024,MAR,Sarawak,7,3,4,Morocco
85922,5/1/2024,MAR,Selangor,1652,843,809,Morocco
85923,5/1/2024,MCO,Johor,4,4,0,Monaco
85924,5/1/2024,MCO,Perlis,1,0,1,Monaco
85925,5/1/2024,MCO,Selangor,2,2,0,Monaco
85926,5/1/2024,MDA,Johor,5,1,4,"Moldova, Republic of"
85927,5/1/2024,MDA,Selangor,37,15,22,"Moldova, Republic of"
85928,5/1/2024,MDG,Johor,13,3,10,Madagascar
85929,5/1/2024,MDG,Pulau Pinang,2,1,1,Madagascar
85930,5/1/2024,MDG,Sabah,1,0,1,Madagascar
85931,5/1/2024,MDG,Selangor,99,41,58,Madagascar
85932,5/1/2024,MDV,Johor,437,210,227,Maldives
85933,5/1/2024,MDV,Kedah,6,2,4,Maldives
85934,5/1/2024,MDV,Perak,5,0,5,Maldives
85935,5/1/2024,MDV,Pulau Pinang,3,1,2,Maldives
85936,5/1/2024,MDV,Sabah,1,0,1,Maldives
85937,5/1/2024,MDV,Selangor,5278,2653,2625,Maldives
85938,5/1/2024,MEX,Johor,152,78,74,Mexico
85939,5/1/2024,MEX,Kedah,21,12,9,Mexico
85940,5/1/2024,MEX,Pulau Pinang,37,29,8,Mexico
85941,5/1/2024,MEX,Sabah,7,2,5,Mexico
85942,5/1/2024,MEX,Sarawak,6,4,2,Mexico
85943,5/1/2024,MEX,Selangor,660,312,348,Mexico
85944,5/1/2024,MHL,Johor,2,2,0,Marshall Islands
85945,5/1/2024,MHL,Pulau Pinang,2,1,1,Marshall Islands
85946,5/1/2024,MHL,Selangor,1,1,0,Marshall Islands
85947,5/1/2024,MKD,Johor,7,5,2,"Macedonia, the former Yugoslav Republic of"
85948,5/1/2024,MKD,Sarawak,5,2,3,"Macedonia, the former Yugoslav Republic of"
85949,5/1/2024,MKD,Selangor,56,25,31,"Macedonia, the former Yugoslav Republic of"
85950,5/1/2024,MLI,Johor,1,1,0,Mali
85951,5/1/2024,MLI,Sarawak,1,1,0,Mali
85952,5/1/2024,MLI,Selangor,12,7,5,Mali
85953,5/1/2024,MLT,Johor,2,1,1,Malta
85954,5/1/2024,MLT,Pulau Pinang,3,3,0,Malta
85955,5/1/2024,MLT,Selangor,45,23,22,Malta
85956,5/1/2024,MMR,Johor,7267,2050,5217,Myanmar
85957,5/1/2024,MMR,Kedah,87,15,72,Myanmar
85958,5/1/2024,MMR,Kelantan,3,1,2,Myanmar
85959,5/1/2024,MMR,Pahang,3,1,2,Myanmar
85960,5/1/2024,MMR,Perak,37,6,31,Myanmar
85961,5/1/2024,MMR,Perlis,9,1,8,Myanmar
85962,5/1/2024,MMR,Pulau Pinang,349,153,196,Myanmar
85963,5/1/2024,MMR,Sabah,17,2,15,Myanmar
85964,5/1/2024,MMR,Sarawak,81,39,42,Myanmar
85965,5/1/2024,MMR,Selangor,11520,8112,3408,Myanmar
85966,5/1/2024,MMR,W.P. Labuan,1,1,0,Myanmar
85967,5/1/2024,MNE,Johor,4,4,0,Montenegro
85968,5/1/2024,MNE,Selangor,17,16,1,Montenegro
85969,5/1/2024,MNG,Johor,128,39,89,Mongolia
85970,5/1/2024,MNG,Kedah,7,3,4,Mongolia
85971,5/1/2024,MNG,Perak,1,1,0,Mongolia
85972,5/1/2024,MNG,Perlis,2,2,0,Mongolia
85973,5/1/2024,MNG,Pulau Pinang,7,6,1,Mongolia
85974,5/1/2024,MNG,Sarawak,2,2,0,Mongolia
85975,5/1/2024,MNG,Selangor,353,138,215,Mongolia
85976,5/1/2024,MOZ,Selangor,58,38,20,Mozambique
85977,5/1/2024,MRT,Johor,1,1,0,Mauritania
85978,5/1/2024,MRT,Kedah,2,1,1,Mauritania
85979,5/1/2024,MRT,Selangor,20,14,6,Mauritania
85980,5/1/2024,MUS,Johor,182,90,92,Mauritius
85981,5/1/2024,MUS,Kedah,9,5,4,Mauritius
85982,5/1/2024,MUS,Pahang,1,1,0,Mauritius
85983,5/1/2024,MUS,Perlis,4,3,1,Mauritius
85984,5/1/2024,MUS,Pulau Pinang,16,6,10,Mauritius
85985,5/1/2024,MUS,Sabah,2,2,0,Mauritius
85986,5/1/2024,MUS,Selangor,921,501,420,Mauritius
85987,5/1/2024,MWI,Johor,1,1,0,Malawi
85988,5/1/2024,MWI,Pulau Pinang,1,0,1,Malawi
85989,5/1/2024,MWI,Selangor,18,15,3,Malawi
85990,5/1/2024,NAM,Selangor,18,10,8,Namibia
85991,5/1/2024,NER,Selangor,1,1,0,Niger
85992,5/1/2024,NGA,Johor,14,13,1,Nigeria
85993,5/1/2024,NGA,Kedah,2,2,0,Nigeria
85994,5/1/2024,NGA,Pulau Pinang,10,7,3,Nigeria
85995,5/1/2024,NGA,Sarawak,13,12,1,Nigeria
85996,5/1/2024,NGA,Selangor,505,407,98,Nigeria
85997,5/1/2024,NIC,Johor,2,1,1,Nicaragua
85998,5/1/2024,NIC,Selangor,4,2,2,Nicaragua
85999,5/1/2024,NLD,Johor,1239,755,484,Netherlands
86000,5/1/2024,NLD,Kedah,376,188,188,Netherlands
86001,5/1/2024,NLD,Kelantan,11,7,4,Netherlands
86002,5/1/2024,NLD,Melaka,1,1,0,Netherlands
86003,5/1/2024,NLD,Pahang,6,4,2,Netherlands
86004,5/1/2024,NLD,Perak,19,10,9,Netherlands
86005,5/1/2024,NLD,Perlis,43,26,17,Netherlands
86006,5/1/2024,NLD,Pulau Pinang,266,175,91,Netherlands
86007,5/1/2024,NLD,Sabah,93,57,36,Netherlands
86008,5/1/2024,NLD,Sarawak,169,99,70,Netherlands
86009,5/1/2024,NLD,Selangor,4230,2455,1775,Netherlands
86010,5/1/2024,NLD,W.P. Labuan,2,1,1,Netherlands
86011,5/1/2024,NOR,Johor,136,84,52,Norway
86012,5/1/2024,NOR,Kedah,36,16,20,Norway
86013,5/1/2024,NOR,Kelantan,1,1,0,Norway
86014,5/1/2024,NOR,Perak,1,0,1,Norway
86015,5/1/2024,NOR,Perlis,6,1,5,Norway
86016,5/1/2024,NOR,Pulau Pinang,20,13,7,Norway
86017,5/1/2024,NOR,Sabah,8,5,3,Norway
86018,5/1/2024,NOR,Sarawak,32,20,12,Norway
86019,5/1/2024,NOR,Selangor,529,331,198,Norway
86020,5/1/2024,NPL,Johor,665,421,244,Nepal
86021,5/1/2024,NPL,Kedah,24,14,10,Nepal
86022,5/1/2024,NPL,Perak,5,3,2,Nepal
86023,5/1/2024,NPL,Pulau Pinang,29,22,7,Nepal
86024,5/1/2024,NPL,Sabah,3,1,2,Nepal
86025,5/1/2024,NPL,Sarawak,268,189,79,Nepal
86026,5/1/2024,NPL,Selangor,20680,19936,744,Nepal
86027,5/1/2024,NPL,W.P. Labuan,77,77,0,Nepal
86028,5/1/2024,NRU,Selangor,2,2,0,Nauru
86029,5/1/2024,NZL,Johor,763,467,296,New Zealand
86030,5/1/2024,NZL,Kedah,87,52,35,New Zealand
86031,5/1/2024,NZL,Kelantan,4,2,2,New Zealand
86032,5/1/2024,NZL,Melaka,1,0,1,New Zealand
86033,5/1/2024,NZL,Pahang,5,5,0,New Zealand
86034,5/1/2024,NZL,Perak,19,9,10,New Zealand
86035,5/1/2024,NZL,Perlis,22,14,8,New Zealand
86036,5/1/2024,NZL,Pulau Pinang,241,133,108,New Zealand
86037,5/1/2024,NZL,Sabah,55,28,27,New Zealand
86038,5/1/2024,NZL,Sarawak,141,89,52,New Zealand
86039,5/1/2024,NZL,Selangor,2485,1487,998,New Zealand
86040,5/1/2024,OMN,Johor,24,23,1,Oman
86041,5/1/2024,OMN,Perak,4,3,1,Oman
86042,5/1/2024,OMN,Pulau Pinang,4,4,0,Oman
86043,5/1/2024,OMN,Sarawak,8,7,1,Oman
86044,5/1/2024,OMN,Selangor,965,607,358,Oman
86045,5/1/2024,PAK,Johor,617,455,162,Pakistan
86046,5/1/2024,PAK,Kedah,129,96,33,Pakistan
86047,5/1/2024,PAK,Kelantan,15,15,0,Pakistan
86048,5/1/2024,PAK,Pahang,2,2,0,Pakistan
86049,5/1/2024,PAK,Perak,1,0,1,Pakistan
86050,5/1/2024,PAK,Perlis,18,17,1,Pakistan
86051,5/1/2024,PAK,Pulau Pinang,278,240,38,Pakistan
86052,5/1/2024,PAK,Sabah,13,12,1,Pakistan
86053,5/1/2024,PAK,Sarawak,182,148,34,Pakistan
86054,5/1/2024,PAK,Selangor,13638,12047,1591,Pakistan
86055,5/1/2024,PAK,W.P. Labuan,2,2,0,Pakistan
86056,5/1/2024,PAN,Johor,5,4,1,Panama
86057,5/1/2024,PAN,Kedah,1,0,1,Panama
86058,5/1/2024,PAN,Selangor,14,7,7,Panama
86059,5/1/2024,PER,Johor,29,14,15,Peru
86060,5/1/2024,PER,Kedah,4,3,1,Peru
86061,5/1/2024,PER,Perlis,3,2,1,Peru
86062,5/1/2024,PER,Pulau Pinang,10,6,4,Peru
86063,5/1/2024,PER,Sarawak,3,3,0,Peru
86064,5/1/2024,PER,Selangor,191,104,87,Peru
86065,5/1/2024,PHL,Johor,25289,7974,17315,Philippines
86066,5/1/2024,PHL,Kedah,498,146,352,Philippines
86067,5/1/2024,PHL,Kelantan,65,31,34,Philippines
86068,5/1/2024,PHL,Pahang,22,14,8,Philippines
86069,5/1/2024,PHL,Perak,88,31,57,Philippines
86070,5/1/2024,PHL,Perlis,125,45,80,Philippines
86071,5/1/2024,PHL,Pulau Pinang,1024,392,632,Philippines
86072,5/1/2024,PHL,Sabah,1422,718,704,Philippines
86073,5/1/2024,PHL,Sarawak,2747,1046,1701,Philippines
86074,5/1/2024,PHL,Selangor,16032,6565,9467,Philippines
86075,5/1/2024,PHL,W.P. Labuan,112,27,85,Philippines
86076,5/1/2024,PLW,Johor,2,2,0,Palau
86077,5/1/2024,PNG,Johor,17,10,7,Papua New Guinea
86078,5/1/2024,PNG,Kedah,1,1,0,Papua New Guinea
86079,5/1/2024,PNG,Sarawak,6,6,0,Papua New Guinea
86080,5/1/2024,PNG,Selangor,54,30,24,Papua New Guinea
86081,5/1/2024,POL,Johor,283,159,124,Poland
86082,5/1/2024,POL,Kedah,85,44,41,Poland
86083,5/1/2024,POL,Kelantan,1,1,0,Poland
86084,5/1/2024,POL,Perak,6,5,1,Poland
86085,5/1/2024,POL,Perlis,16,12,4,Poland
86086,5/1/2024,POL,Pulau Pinang,55,27,28,Poland
86087,5/1/2024,POL,Sabah,34,16,18,Poland
86088,5/1/2024,POL,Sarawak,53,29,24,Poland
86089,5/1/2024,POL,Selangor,1270,654,616,Poland
86090,5/1/2024,POL,W.P. Labuan,2,2,0,Poland
86091,5/1/2024,PRT,Johor,145,89,56,Portugal
86092,5/1/2024,PRT,Kedah,55,26,29,Portugal
86093,5/1/2024,PRT,Pahang,1,1,0,Portugal
86094,5/1/2024,PRT,Perak,2,1,1,Portugal
86095,5/1/2024,PRT,Perlis,1,1,0,Portugal
86096,5/1/2024,PRT,Pulau Pinang,41,25,16,Portugal
86097,5/1/2024,PRT,Sabah,12,8,4,Portugal
86098,5/1/2024,PRT,Sarawak,9,6,3,Portugal
86099,5/1/2024,PRT,Selangor,861,516,345,Portugal
86100,5/1/2024,PRY,Johor,4,1,3,Paraguay
86101,5/1/2024,PRY,Sabah,1,1,0,Paraguay
86102,5/1/2024,PRY,Selangor,14,2,12,Paraguay
86103,5/1/2024,PSE,Johor,30,20,10,"Palestinian Territory, Occupied"
86104,5/1/2024,PSE,Kedah,4,2,2,"Palestinian Territory, Occupied"
86105,5/1/2024,PSE,Perak,1,1,0,"Palestinian Territory, Occupied"
86106,5/1/2024,PSE,Pulau Pinang,3,3,0,"Palestinian Territory, Occupied"
86107,5/1/2024,PSE,Selangor,352,230,122,"Palestinian Territory, Occupied"
86108,5/1/2024,QAT,Johor,6,6,0,Qatar
86109,5/1/2024,QAT,Selangor,112,83,29,Qatar
86110,5/1/2024,ROU,Johor,128,69,59,Romania
86111,5/1/2024,ROU,Kedah,21,9,12,Romania
86112,5/1/2024,ROU,Kelantan,4,2,2,Romania
86113,5/1/2024,ROU,Melaka,1,1,0,Romania
86114,5/1/2024,ROU,Perak,1,0,1,Romania
86115,5/1/2024,ROU,Perlis,1,0,1,Romania
86116,5/1/2024,ROU,Pulau Pinang,34,17,17,Romania
86117,5/1/2024,ROU,Sabah,5,3,2,Romania
86118,5/1/2024,ROU,Sarawak,9,5,4,Romania
86119,5/1/2024,ROU,Selangor,628,337,291,Romania
86120,5/1/2024,RUS,Johor,437,226,211,Russia
86121,5/1/2024,RUS,Kedah,250,114,136,Russia
86122,5/1/2024,RUS,Kelantan,36,21,15,Russia
86123,5/1/2024,RUS,Pahang,1,0,1,Russia
86124,5/1/2024,RUS,Perak,5,2,3,Russia
86125,5/1/2024,RUS,Perlis,53,37,16,Russia
86126,5/1/2024,RUS,Pulau Pinang,109,63,46,Russia
86127,5/1/2024,RUS,Sabah,38,19,19,Russia
86128,5/1/2024,RUS,Sarawak,47,24,23,Russia
86129,5/1/2024,RUS,Selangor,7876,3930,3946,Russia
86130,5/1/2024,RUS,W.P. Labuan,3,2,1,Russia
86131,5/1/2024,RWA,Pulau Pinang,1,1,0,Rwanda
86132,5/1/2024,RWA,Selangor,6,6,0,Rwanda
86133,5/1/2024,SAU,Johor,164,93,71,Saudi Arabia
86134,5/1/2024,SAU,Kedah,28,21,7,Saudi Arabia
86135,5/1/2024,SAU,Kelantan,1,1,0,Saudi Arabia
86136,5/1/2024,SAU,Perak,8,8,0,Saudi Arabia
86137,5/1/2024,SAU,Perlis,1,1,0,Saudi Arabia
86138,5/1/2024,SAU,Pulau Pinang,22,13,9,Saudi Arabia
86139,5/1/2024,SAU,Sarawak,16,7,9,Saudi Arabia
86140,5/1/2024,SAU,Selangor,3984,2474,1510,Saudi Arabia
86141,5/1/2024,SDN,Johor,11,8,3,Sudan
86142,5/1/2024,SDN,Kedah,2,1,1,Sudan
86143,5/1/2024,SDN,Pulau Pinang,2,1,1,Sudan
86144,5/1/2024,SDN,Sarawak,8,2,6,Sudan
86145,5/1/2024,SDN,Selangor,811,482,329,Sudan
86146,5/1/2024,SDN,W.P. Labuan,1,1,0,Sudan
86147,5/1/2024,SEN,Johor,14,12,2,Senegal
86148,5/1/2024,SEN,Selangor,90,63,27,Senegal
86149,5/1/2024,SGP,Johor,1432787,817386,615401,Singapore
86150,5/1/2024,SGP,Kedah,5368,2742,2626,Singapore
86151,5/1/2024,SGP,Kelantan,99,64,35,Singapore
86152,5/1/2024,SGP,Melaka,22,18,4,Singapore
86153,5/1/2024,SGP,Pahang,696,363,333,Singapore
86154,5/1/2024,SGP,Perak,6096,2748,3348,Singapore
86155,5/1/2024,SGP,Perlis,240,144,96,Singapore
86156,5/1/2024,SGP,Pulau Pinang,21664,10285,11379,Singapore
86157,5/1/2024,SGP,Sabah,2770,1356,1414,Singapore
86158,5/1/2024,SGP,Sarawak,4386,2597,1789,Singapore
86159,5/1/2024,SGP,Selangor,52931,27341,25590,Singapore
86160,5/1/2024,SGP,W.P. Labuan,6,4,2,Singapore
86161,5/1/2024,SLB,Johor,5,5,0,Solomon Islands
86162,5/1/2024,SLB,Pulau Pinang,1,1,0,Solomon Islands
86163,5/1/2024,SLB,Sarawak,10,3,7,Solomon Islands
86164,5/1/2024,SLB,Selangor,8,5,3,Solomon Islands
86165,5/1/2024,SLE,Johor,7,5,2,Sierra Leone
86166,5/1/2024,SLE,Kedah,1,1,0,Sierra Leone
86167,5/1/2024,SLE,Pulau Pinang,5,1,4,Sierra Leone
86168,5/1/2024,SLE,Selangor,25,12,13,Sierra Leone
86169,5/1/2024,SLV,Johor,2,2,0,El Salvador
86170,5/1/2024,SLV,Selangor,13,6,7,El Salvador
86171,5/1/2024,SMR,Selangor,3,2,1,San Marino
86172,5/1/2024,SOM,Selangor,208,116,92,Somalia
86173,5/1/2024,SRB,Johor,5,5,0,Serbia
86174,5/1/2024,SRB,Kedah,2,0,2,Serbia
86175,5/1/2024,SRB,Perak,1,1,0,Serbia
86176,5/1/2024,SRB,Pulau Pinang,5,5,0,Serbia
86177,5/1/2024,SRB,Selangor,180,82,98,Serbia
86178,5/1/2024,STP,Selangor,2,0,2,Sao Tome and Principe
86179,5/1/2024,SUR,Johor,4,3,1,Suriname
86180,5/1/2024,SUR,Pulau Pinang,2,1,1,Suriname
86181,5/1/2024,SUR,Selangor,27,13,14,Suriname
86182,5/1/2024,SVK,Johor,53,29,24,Slovakia
86183,5/1/2024,SVK,Kedah,47,22,25,Slovakia
86184,5/1/2024,SVK,Perlis,2,1,1,Slovakia
86185,5/1/2024,SVK,Pulau Pinang,15,13,2,Slovakia
86186,5/1/2024,SVK,Sabah,10,4,6,Slovakia
86187,5/1/2024,SVK,Sarawak,9,8,1,Slovakia
86188,5/1/2024,SVK,Selangor,256,146,110,Slovakia
86189,5/1/2024,SVN,Johor,13,9,4,Slovenia
86190,5/1/2024,SVN,Kedah,8,3,5,Slovenia
86191,5/1/2024,SVN,Perak,1,1,0,Slovenia
86192,5/1/2024,SVN,Pulau Pinang,1,1,0,Slovenia
86193,5/1/2024,SVN,Sabah,3,2,1,Slovenia
86194,5/1/2024,SVN,Sarawak,4,0,4,Slovenia
86195,5/1/2024,SVN,Selangor,129,72,57,Slovenia
86196,5/1/2024,SWE,Johor,184,114,70,Sweden
86197,5/1/2024,SWE,Kedah,64,36,28,Sweden
86198,5/1/2024,SWE,Kelantan,1,1,0,Sweden
86199,5/1/2024,SWE,Perak,1,1,0,Sweden
86200,5/1/2024,SWE,Perlis,5,3,2,Sweden
86201,5/1/2024,SWE,Pulau Pinang,81,59,22,Sweden
86202,5/1/2024,SWE,Sabah,20,13,7,Sweden
86203,5/1/2024,SWE,Sarawak,30,23,7,Sweden
86204,5/1/2024,SWE,Selangor,704,455,249,Sweden
86205,5/1/2024,SWE,W.P. Labuan,2,1,1,Sweden
86206,5/1/2024,SWZ,Johor,2,2,0,Swaziland
86207,5/1/2024,SWZ,Selangor,28,12,16,Swaziland
86208,5/1/2024,SYC,Johor,3,1,2,Seychelles
86209,5/1/2024,SYC,Pahang,1,1,0,Seychelles
86210,5/1/2024,SYC,Selangor,59,27,32,Seychelles
86211,5/1/2024,SYR,Johor,37,32,5,Syrian Arab Republic
86212,5/1/2024,SYR,Kedah,6,4,2,Syrian Arab Republic
86213,5/1/2024,SYR,Pulau Pinang,11,10,1,Syrian Arab Republic
86214,5/1/2024,SYR,Sarawak,11,9,2,Syrian Arab Republic
86215,5/1/2024,SYR,Selangor,618,398,220,Syrian Arab Republic
86216,5/1/2024,TCD,Johor,4,3,1,Chad
86217,5/1/2024,TCD,Selangor,32,26,6,Chad
86218,5/1/2024,TGO,Kedah,1,1,0,Togo
86219,5/1/2024,TGO,Selangor,12,9,3,Togo
86220,5/1/2024,THA,Johor,8267,2210,6057,Thailand
86221,5/1/2024,THA,Kedah,64267,35657,28610,Thailand
86222,5/1/2024,THA,Kelantan,55889,28354,27535,Thailand
86223,5/1/2024,THA,Melaka,4,1,3,Thailand
86224,5/1/2024,THA,Pahang,21,11,10,Thailand
86225,5/1/2024,THA,Perak,8614,4017,4597,Thailand
86226,5/1/2024,THA,Perlis,47853,27639,20214,Thailand
86227,5/1/2024,THA,Pulau Pinang,3045,1105,1940,Thailand
86228,5/1/2024,THA,Sabah,23,5,18,Thailand
86229,5/1/2024,THA,Sarawak,500,180,320,Thailand
86230,5/1/2024,THA,Selangor,14834,5812,9022,Thailand
86231,5/1/2024,THA,Terengganu,1,1,0,Thailand
86232,5/1/2024,THA,W.P. Labuan,14,6,8,Thailand
86233,5/1/2024,TJK,Johor,7,5,2,Tajikistan
86234,5/1/2024,TJK,Kedah,2,1,1,Tajikistan
86235,5/1/2024,TJK,Sabah,1,1,0,Tajikistan
86236,5/1/2024,TJK,Selangor,140,110,30,Tajikistan
86237,5/1/2024,TKM,Johor,4,3,1,Turkmenistan
86238,5/1/2024,TKM,Kedah,6,1,5,Turkmenistan
86239,5/1/2024,TKM,Pulau Pinang,2,2,0,Turkmenistan
86240,5/1/2024,TKM,Sarawak,1,1,0,Turkmenistan
86241,5/1/2024,TKM,Selangor,333,205,128,Turkmenistan
86242,5/1/2024,TLS,Johor,15,7,8,Timor-Leste
86243,5/1/2024,TLS,Kedah,1,0,1,Timor-Leste
86244,5/1/2024,TLS,Perak,3,0,3,Timor-Leste
86245,5/1/2024,TLS,Pulau Pinang,10,5,5,Timor-Leste
86246,5/1/2024,TLS,Sabah,1,0,1,Timor-Leste
86247,5/1/2024,TLS,Selangor,197,105,92,Timor-Leste
86248,5/1/2024,TON,Johor,1,1,0,Tonga
86249,5/1/2024,TON,Kedah,1,1,0,Tonga
86250,5/1/2024,TON,Pulau Pinang,1,0,1,Tonga
86251,5/1/2024,TON,Sarawak,1,1,0,Tonga
86252,5/1/2024,TON,Selangor,12,6,6,Tonga
86253,5/1/2024,TTO,Johor,7,4,3,Trinidad and Tobago
86254,5/1/2024,TTO,Kedah,1,0,1,Trinidad and Tobago
86255,5/1/2024,TTO,Perak,1,1,0,Trinidad and Tobago
86256,5/1/2024,TTO,Sarawak,2,0,2,Trinidad and Tobago
86257,5/1/2024,TTO,Selangor,34,17,17,Trinidad and Tobago
86258,5/1/2024,TUN,Johor,26,15,11,Tunisia
86259,5/1/2024,TUN,Kedah,2,0,2,Tunisia
86260,5/1/2024,TUN,Kelantan,1,1,0,Tunisia
86261,5/1/2024,TUN,Pulau Pinang,12,5,7,Tunisia
86262,5/1/2024,TUN,Sarawak,1,1,0,Tunisia
86263,5/1/2024,TUN,Selangor,816,435,381,Tunisia
86264,5/1/2024,TUR,Johor,327,228,99,Turkey
86265,5/1/2024,TUR,Kedah,38,23,15,Turkey
86266,5/1/2024,TUR,Kelantan,11,9,2,Turkey
86267,5/1/2024,TUR,Perak,3,1,2,Turkey
86268,5/1/2024,TUR,Perlis,15,13,2,Turkey
86269,5/1/2024,TUR,Pulau Pinang,35,29,6,Turkey
86270,5/1/2024,TUR,Sabah,7,6,1,Turkey
86271,5/1/2024,TUR,Sarawak,25,16,9,Turkey
86272,5/1/2024,TUR,Selangor,1772,1302,470,Turkey
86273,5/1/2024,TUR,W.P. Labuan,1,0,1,Turkey
86274,5/1/2024,TUV,Pulau Pinang,2,0,2,Tuvalu
86275,5/1/2024,TUV,Selangor,2,1,1,Tuvalu
86276,5/1/2024,TWN,Johor,8338,3582,4756,Taiwan
86277,5/1/2024,TWN,Kedah,168,87,81,Taiwan
86278,5/1/2024,TWN,Kelantan,4,3,1,Taiwan
86279,5/1/2024,TWN,Melaka,13,9,4,Taiwan
86280,5/1/2024,TWN,Pahang,5,3,2,Taiwan
86281,5/1/2024,TWN,Perak,60,25,35,Taiwan
86282,5/1/2024,TWN,Perlis,23,16,7,Taiwan
86283,5/1/2024,TWN,Pulau Pinang,4147,2036,2111,Taiwan
86284,5/1/2024,TWN,Sabah,1517,706,811,Taiwan
86285,5/1/2024,TWN,Sarawak,269,132,137,Taiwan
86286,5/1/2024,TWN,Selangor,14570,7068,7502,Taiwan
86287,5/1/2024,TWN,W.P. Labuan,4,3,1,Taiwan
86288,5/1/2024,TZA,Johor,12,9,3,"Tanzania, United Republic of"
86289,5/1/2024,TZA,Pulau Pinang,2,1,1,"Tanzania, United Republic of"
86290,5/1/2024,TZA,Sarawak,4,3,1,"Tanzania, United Republic of"
86291,5/1/2024,TZA,Selangor,167,75,92,"Tanzania, United Republic of"
86292,5/1/2024,UGA,Johor,308,127,181,Uganda
86293,5/1/2024,UGA,Kedah,1,0,1,Uganda
86294,5/1/2024,UGA,Sarawak,2,2,0,Uganda
86295,5/1/2024,UGA,Selangor,390,148,242,Uganda
86296,5/1/2024,UKR,Johor,120,61,59,Ukraine
86297,5/1/2024,UKR,Kedah,36,16,20,Ukraine
86298,5/1/2024,UKR,Kelantan,12,5,7,Ukraine
86299,5/1/2024,UKR,Pahang,3,2,1,Ukraine
86300,5/1/2024,UKR,Perlis,6,3,3,Ukraine
86301,5/1/2024,UKR,Pulau Pinang,19,7,12,Ukraine
86302,5/1/2024,UKR,Sabah,5,3,2,Ukraine
86303,5/1/2024,UKR,Sarawak,4,2,2,Ukraine
86304,5/1/2024,UKR,Selangor,1101,530,571,Ukraine
86305,5/1/2024,URY,Johor,14,6,8,Uruguay
86306,5/1/2024,URY,Kedah,2,1,1,Uruguay
86307,5/1/2024,URY,Sabah,2,1,1,Uruguay
86308,5/1/2024,URY,Selangor,51,21,30,Uruguay
86309,5/1/2024,USA,Johor,5196,2974,2222,United States Of America
86310,5/1/2024,USA,Kedah,522,279,243,United States Of America
86311,5/1/2024,USA,Kelantan,24,17,7,United States Of America
86312,5/1/2024,USA,Melaka,5,3,2,United States Of America
86313,5/1/2024,USA,Pahang,9,7,2,United States Of America
86314,5/1/2024,USA,Perak,143,84,59,United States Of America
86315,5/1/2024,USA,Perlis,107,56,51,United States Of America
86316,5/1/2024,USA,Pulau Pinang,2332,1419,913,United States Of America
86317,5/1/2024,USA,Sabah,320,164,156,United States Of America
86318,5/1/2024,USA,Sarawak,313,206,107,United States Of America
86319,5/1/2024,USA,Selangor,14291,8418,5873,United States Of America
86320,5/1/2024,USA,W.P. Labuan,5,4,1,United States Of America
86321,5/1/2024,UZB,Johor,82,58,24,Uzbekistan
86322,5/1/2024,UZB,Kedah,8,7,1,Uzbekistan
86323,5/1/2024,UZB,Kelantan,2,2,0,Uzbekistan
86324,5/1/2024,UZB,Perlis,1,1,0,Uzbekistan
86325,5/1/2024,UZB,Pulau Pinang,13,11,2,Uzbekistan
86326,5/1/2024,UZB,Sabah,6,4,2,Uzbekistan
86327,5/1/2024,UZB,Selangor,924,580,344,Uzbekistan
86328,5/1/2024,VAT,Selangor,1,1,0,Holy See (Vatican City State)
86329,5/1/2024,VCT,Selangor,1,1,0,Saint Vincent and the Grenadines
86330,5/1/2024,VEN,Johor,12,8,4,Venezuela
86331,5/1/2024,VEN,Kedah,1,0,1,Venezuela
86332,5/1/2024,VEN,Pulau Pinang,1,1,0,Venezuela
86333,5/1/2024,VEN,Sabah,2,1,1,Venezuela
86334,5/1/2024,VEN,Sarawak,4,1,3,Venezuela
86335,5/1/2024,VEN,Selangor,106,56,50,Venezuela
86336,5/1/2024,VNM,Johor,15481,4745,10736,Vietnam
86337,5/1/2024,VNM,Kedah,372,43,329,Vietnam
86338,5/1/2024,VNM,Kelantan,29,14,15,Vietnam
86339,5/1/2024,VNM,Pahang,10,9,1,Vietnam
86340,5/1/2024,VNM,Perak,142,34,108,Vietnam
86341,5/1/2024,VNM,Perlis,220,14,206,Vietnam
86342,5/1/2024,VNM,Pulau Pinang,1837,482,1355,Vietnam
86343,5/1/2024,VNM,Sabah,16,2,14,Vietnam
86344,5/1/2024,VNM,Sarawak,361,47,314,Vietnam
86345,5/1/2024,VNM,Selangor,14207,4898,9309,Vietnam
86346,5/1/2024,VNM,W.P. Labuan,4,2,2,Vietnam
86347,5/1/2024,VUT,Johor,19,11,8,Vanuatu
86348,5/1/2024,VUT,Pulau Pinang,5,5,0,Vanuatu
86349,5/1/2024,VUT,Sabah,1,1,0,Vanuatu
86350,5/1/2024,VUT,Selangor,102,89,13,Vanuatu
86351,5/1/2024,WSM,Johor,1,0,1,Samoa
86352,5/1/2024,WSM,Pulau Pinang,1,0,1,Samoa
86353,5/1/2024,YEM,Johor,39,29,10,Yemen
86354,5/1/2024,YEM,Kedah,6,4,2,Yemen
86355,5/1/2024,YEM,Kelantan,3,3,0,Yemen
86356,5/1/2024,YEM,Perlis,1,1,0,Yemen
86357,5/1/2024,YEM,Pulau Pinang,4,3,1,Yemen
86358,5/1/2024,YEM,Sarawak,3,2,1,Yemen
86359,5/1/2024,YEM,Selangor,1203,832,371,Yemen
86360,5/1/2024,ZAF,Johor,293,187,106,South Africa
86361,5/1/2024,ZAF,Kedah,46,26,20,South Africa
86362,5/1/2024,ZAF,Kelantan,2,2,0,South Africa
86363,5/1/2024,ZAF,Perak,3,2,1,South Africa
86364,5/1/2024,ZAF,Perlis,4,2,2,South Africa
86365,5/1/2024,ZAF,Pulau Pinang,71,41,30,South Africa
86366,5/1/2024,ZAF,Sabah,19,11,8,South Africa
86367,5/1/2024,ZAF,Sarawak,101,41,60,South Africa
86368,5/1/2024,ZAF,Selangor,814,489,325,South Africa
86369,5/1/2024,ZMB,Johor,7,4,3,Zambia
86370,5/1/2024,ZMB,Kedah,1,1,0,Zambia
86371,5/1/2024,ZMB,Pulau Pinang,1,0,1,Zambia
86372,5/1/2024,ZMB,Selangor,44,28,16,Zambia
86373,5/1/2024,ZWE,Johor,14,8,6,Zimbabwe
86374,5/1/2024,ZWE,Kedah,2,0,2,Zimbabwe
86375,5/1/2024,ZWE,Pulau Pinang,6,4,2,Zimbabwe
86376,5/1/2024,ZWE,Sabah,2,1,1,Zimbabwe
86377,5/1/2024,ZWE,Selangor,139,70,69,Zimbabwe
86378,6/1/2024,AFG,Sarawak,2,2,0,Afghanistan
86379,6/1/2024,AFG,Selangor,34,25,9,Afghanistan
86380,6/1/2024,AGO,Selangor,9,7,2,Angola
86381,6/1/2024,AIA,Selangor,1,1,0,Anguilla
86382,6/1/2024,ALB,Johor,11,7,4,Albania
86383,6/1/2024,ALB,Kedah,1,1,0,Albania
86384,6/1/2024,ALB,Pulau Pinang,1,1,0,Albania
86385,6/1/2024,ALB,Sarawak,1,1,0,Albania
86386,6/1/2024,ALB,Selangor,32,18,14,Albania
86387,6/1/2024,AND,Pulau Pinang,1,1,0,Andorra
86388,6/1/2024,AND,Selangor,13,9,4,Andorra
86389,6/1/2024,ARE,Johor,36,17,19,United Arab Emirates
86390,6/1/2024,ARE,Kedah,19,13,6,United Arab Emirates
86391,6/1/2024,ARE,Kelantan,1,0,1,United Arab Emirates
86392,6/1/2024,ARE,Pulau Pinang,11,9,2,United Arab Emirates
86393,6/1/2024,ARE,Selangor,659,371,288,United Arab Emirates
86394,6/1/2024,ARG,Johor,93,46,47,Argentina
86395,6/1/2024,ARG,Kedah,11,5,6,Argentina
86396,6/1/2024,ARG,Kelantan,1,0,1,Argentina
86397,6/1/2024,ARG,Perlis,7,3,4,Argentina
86398,6/1/2024,ARG,Pulau Pinang,6,2,4,Argentina
86399,6/1/2024,ARG,Sabah,3,2,1,Argentina
86400,6/1/2024,ARG,Sarawak,11,9,2,Argentina
86401,6/1/2024,ARG,Selangor,417,225,192,Argentina
86402,6/1/2024,ARM,Johor,2,1,1,Armenia
86403,6/1/2024,ARM,Kedah,3,2,1,Armenia
86404,6/1/2024,ARM,Pulau Pinang,2,1,1,Armenia
86405,6/1/2024,ARM,Selangor,63,33,30,Armenia
86406,6/1/2024,ATG,Johor,5,2,3,Antigua and Barbuda
86407,6/1/2024,ATG,Sabah,1,0,1,Antigua and Barbuda
86408,6/1/2024,ATG,Selangor,16,8,8,Antigua and Barbuda
86409,6/1/2024,AUS,Johor,5362,3141,2221,Australia
86410,6/1/2024,AUS,Kedah,505,277,228,Australia
86411,6/1/2024,AUS,Kelantan,13,8,5,Australia
86412,6/1/2024,AUS,Melaka,2,1,1,Australia
86413,6/1/2024,AUS,Pahang,62,34,28,Australia
86414,6/1/2024,AUS,Perak,212,110,102,Australia
86415,6/1/2024,AUS,Perlis,75,43,32,Australia
86416,6/1/2024,AUS,Pulau Pinang,2182,1125,1057,Australia
86417,6/1/2024,AUS,Sabah,583,303,280,Australia
86418,6/1/2024,AUS,Sarawak,631,360,271,Australia
86419,6/1/2024,AUS,Selangor,29383,16434,12949,Australia
86420,6/1/2024,AUS,W.P. Labuan,12,10,2,Australia
86421,6/1/2024,AUT,Johor,136,98,38,Austria
86422,6/1/2024,AUT,Kedah,12,6,6,Austria
86423,6/1/2024,AUT,Kelantan,7,7,0,Austria
86424,6/1/2024,AUT,Negeri Sembilan,2,1,1,Austria
86425,6/1/2024,AUT,Perak,2,2,0,Austria
86426,6/1/2024,AUT,Perlis,2,2,0,Austria
86427,6/1/2024,AUT,Pulau Pinang,48,35,13,Austria
86428,6/1/2024,AUT,Sabah,9,5,4,Austria
86429,6/1/2024,AUT,Sarawak,11,5,6,Austria
86430,6/1/2024,AUT,Selangor,568,369,199,Austria
86431,6/1/2024,AZE,Johor,7,4,3,Azerbaijan
86432,6/1/2024,AZE,Kedah,11,3,8,Azerbaijan
86433,6/1/2024,AZE,Selangor,203,100,103,Azerbaijan
86434,6/1/2024,BDI,Johor,1,1,0,Burundi
86435,6/1/2024,BDI,Selangor,1,0,1,Burundi
86436,6/1/2024,BEL,Johor,288,174,114,Belgium
86437,6/1/2024,BEL,Kedah,150,80,70,Belgium
86438,6/1/2024,BEL,Kelantan,2,1,1,Belgium
86439,6/1/2024,BEL,Pahang,1,0,1,Belgium
86440,6/1/2024,BEL,Perak,1,1,0,Belgium
86441,6/1/2024,BEL,Perlis,13,8,5,Belgium
86442,6/1/2024,BEL,Pulau Pinang,80,56,24,Belgium
86443,6/1/2024,BEL,Sabah,29,14,15,Belgium
86444,6/1/2024,BEL,Sarawak,42,20,22,Belgium
86445,6/1/2024,BEL,Selangor,1754,1006,748,Belgium
86446,6/1/2024,BEL,W.P. Labuan,1,1,0,Belgium
86447,6/1/2024,BEN,Selangor,8,6,2,Benin
86448,6/1/2024,BFA,Pulau Pinang,1,1,0,Burkina Faso
86449,6/1/2024,BFA,Selangor,29,26,3,Burkina Faso
86450,6/1/2024,BGD,Johor,3628,2861,767,Bangladesh
86451,6/1/2024,BGD,Kedah,162,104,58,Bangladesh
86452,6/1/2024,BGD,Kelantan,3,3,0,Bangladesh
86453,6/1/2024,BGD,Perak,2,2,0,Bangladesh
86454,6/1/2024,BGD,Perlis,1,1,0,Bangladesh
86455,6/1/2024,BGD,Pulau Pinang,227,187,40,Bangladesh
86456,6/1/2024,BGD,Sabah,2,1,1,Bangladesh
86457,6/1/2024,BGD,Sarawak,140,101,39,Bangladesh
86458,6/1/2024,BGD,Selangor,25217,21920,3297,Bangladesh
86459,6/1/2024,BGD,W.P. Labuan,5,5,0,Bangladesh
86460,6/1/2024,BGR,Johor,44,22,22,Bulgaria
86461,6/1/2024,BGR,Pulau Pinang,4,3,1,Bulgaria
86462,6/1/2024,BGR,Sabah,4,2,2,Bulgaria
86463,6/1/2024,BGR,Sarawak,5,5,0,Bulgaria
86464,6/1/2024,BGR,Selangor,173,101,72,Bulgaria
86465,6/1/2024,BHR,Johor,43,22,21,Bahrain
86466,6/1/2024,BHR,Kedah,2,1,1,Bahrain
86467,6/1/2024,BHR,Pulau Pinang,20,5,15,Bahrain
86468,6/1/2024,BHR,Sabah,1,0,1,Bahrain
86469,6/1/2024,BHR,Selangor,427,211,216,Bahrain
86470,6/1/2024,BHS,Perlis,1,1,0,Bahamas
86471,6/1/2024,BHS,Selangor,3,1,2,Bahamas
86472,6/1/2024,BIH,Johor,6,4,2,Bosnia and Herzegovina
86473,6/1/2024,BIH,Pulau Pinang,1,1,0,Bosnia and Herzegovina
86474,6/1/2024,BIH,Selangor,67,42,25,Bosnia and Herzegovina
86475,6/1/2024,BLR,Johor,10,6,4,Belarus
86476,6/1/2024,BLR,Kedah,11,4,7,Belarus
86477,6/1/2024,BLR,Kelantan,4,1,3,Belarus
86478,6/1/2024,BLR,Pulau Pinang,2,0,2,Belarus
86479,6/1/2024,BLR,Sarawak,1,1,0,Belarus
86480,6/1/2024,BLR,Selangor,343,147,196,Belarus
86481,6/1/2024,BLZ,Johor,4,4,0,Belize
86482,6/1/2024,BLZ,Selangor,5,4,1,Belize
86483,6/1/2024,BOL,Johor,7,2,5,Bolivia
86484,6/1/2024,BOL,Pulau Pinang,2,1,1,Bolivia
86485,6/1/2024,BOL,Sarawak,4,1,3,Bolivia
86486,6/1/2024,BOL,Selangor,19,8,11,Bolivia
86487,6/1/2024,BRA,Johor,316,182,134,Brazil
86488,6/1/2024,BRA,Kedah,31,19,12,Brazil
86489,6/1/2024,BRA,Kelantan,1,1,0,Brazil
86490,6/1/2024,BRA,Perlis,8,3,5,Brazil
86491,6/1/2024,BRA,Pulau Pinang,21,17,4,Brazil
86492,6/1/2024,BRA,Sabah,5,4,1,Brazil
86493,6/1/2024,BRA,Sarawak,5,3,2,Brazil
86494,6/1/2024,BRA,Selangor,966,581,385,Brazil
86495,6/1/2024,BRB,Johor,10,2,8,Barbados
86496,6/1/2024,BRB,Kedah,1,1,0,Barbados
86497,6/1/2024,BRB,Selangor,5,2,3,Barbados
86498,6/1/2024,BRN,Johor,367,191,176,Brunei Darussalam
86499,6/1/2024,BRN,Kedah,12,7,5,Brunei Darussalam
86500,6/1/2024,BRN,Kelantan,5,2,3,Brunei Darussalam
86501,6/1/2024,BRN,Perak,4,2,2,Brunei Darussalam
86502,6/1/2024,BRN,Perlis,29,14,15,Brunei Darussalam
86503,6/1/2024,BRN,Pulau Pinang,18,7,11,Brunei Darussalam
86504,6/1/2024,BRN,Sabah,1087,454,633,Brunei Darussalam
86505,6/1/2024,BRN,Sarawak,131317,71327,59990,Brunei Darussalam
86506,6/1/2024,BRN,Selangor,4831,2452,2379,Brunei Darussalam
86507,6/1/2024,BRN,W.P. Labuan,1059,701,358,Brunei Darussalam
86508,6/1/2024,BTN,Johor,11,6,5,Bhutan
86509,6/1/2024,BTN,Selangor,50,39,11,Bhutan
86510,6/1/2024,BWA,Kedah,3,1,2,Botswana
86511,6/1/2024,BWA,Sarawak,1,1,0,Botswana
86512,6/1/2024,BWA,Selangor,15,5,10,Botswana
86513,6/1/2024,CAN,Johor,1461,830,631,Canada
86514,6/1/2024,CAN,Kedah,125,68,57,Canada
86515,6/1/2024,CAN,Kelantan,3,3,0,Canada
86516,6/1/2024,CAN,Melaka,2,2,0,Canada
86517,6/1/2024,CAN,Pahang,9,5,4,Canada
86518,6/1/2024,CAN,Perak,25,13,12,Canada
86519,6/1/2024,CAN,Perlis,22,13,9,Canada
86520,6/1/2024,CAN,Pulau Pinang,459,259,200,Canada
86521,6/1/2024,CAN,Sabah,175,90,85,Canada
86522,6/1/2024,CAN,Sarawak,281,151,130,Canada
86523,6/1/2024,CAN,Selangor,3855,2232,1623,Canada
86524,6/1/2024,CAN,W.P. Labuan,7,4,3,Canada
86525,6/1/2024,CHE,Johor,366,217,149,Switzerland
86526,6/1/2024,CHE,Kedah,41,23,18,Switzerland
86527,6/1/2024,CHE,Negeri Sembilan,3,2,1,Switzerland
86528,6/1/2024,CHE,Pahang,5,3,2,Switzerland
86529,6/1/2024,CHE,Perak,5,2,3,Switzerland
86530,6/1/2024,CHE,Perlis,29,17,12,Switzerland
86531,6/1/2024,CHE,Pulau Pinang,113,80,33,Switzerland
86532,6/1/2024,CHE,Sabah,39,18,21,Switzerland
86533,6/1/2024,CHE,Sarawak,47,23,24,Switzerland
86534,6/1/2024,CHE,Selangor,1340,796,544,Switzerland
86535,6/1/2024,CHL,Johor,59,24,35,Chile
86536,6/1/2024,CHL,Kedah,8,3,5,Chile
86537,6/1/2024,CHL,Kelantan,2,1,1,Chile
86538,6/1/2024,CHL,Pahang,1,1,0,Chile
86539,6/1/2024,CHL,Perlis,9,7,2,Chile
86540,6/1/2024,CHL,Pulau Pinang,8,6,2,Chile
86541,6/1/2024,CHL,Sabah,2,1,1,Chile
86542,6/1/2024,CHL,Selangor,318,178,140,Chile
86543,6/1/2024,CHN,Johor,81971,35785,46186,China
86544,6/1/2024,CHN,Kedah,1450,647,803,China
86545,6/1/2024,CHN,Kelantan,36,26,10,China
86546,6/1/2024,CHN,Melaka,12,11,1,China
86547,6/1/2024,CHN,Negeri Sembilan,2,2,0,China
86548,6/1/2024,CHN,Pahang,45,21,24,China
86549,6/1/2024,CHN,Perak,380,187,193,China
86550,6/1/2024,CHN,Perlis,504,243,261,China
86551,6/1/2024,CHN,Pulau Pinang,15103,7353,7750,China
86552,6/1/2024,CHN,Sabah,24694,10340,14354,China
86553,6/1/2024,CHN,Sarawak,1706,891,815,China
86554,6/1/2024,CHN,Selangor,184267,87650,96617,China
86555,6/1/2024,CHN,W.P. Labuan,34,25,9,China
86556,6/1/2024,CIV,Selangor,5,4,1,C��te d'Iv
86557,6/1/2024,CMR,Johor,3,1,2,Cameroon
86558,6/1/2024,CMR,Selangor,24,20,4,Cameroon
86559,6/1/2024,COD,Johor,6,5,1,"Congo, the Democratic Republic of the"
86560,6/1/2024,COD,Selangor,14,11,3,"Congo, the Democratic Republic of the"
86561,6/1/2024,COG,Selangor,1,1,0,Congo
86562,6/1/2024,COL,Johor,27,13,14,Colombia
86563,6/1/2024,COL,Kedah,15,7,8,Colombia
86564,6/1/2024,COL,Perak,1,1,0,Colombia
86565,6/1/2024,COL,Pulau Pinang,5,3,2,Colombia
86566,6/1/2024,COL,Sabah,3,2,1,Colombia
86567,6/1/2024,COL,Sarawak,1,0,1,Colombia
86568,6/1/2024,COL,Selangor,227,118,109,Colombia
86569,6/1/2024,COL,W.P. Labuan,1,1,0,Colombia
86570,6/1/2024,COM,Kedah,1,0,1,Comoros
86571,6/1/2024,COM,Selangor,38,16,22,Comoros
86572,6/1/2024,CPV,Johor,2,1,1,Cape Verde
86573,6/1/2024,CPV,Selangor,5,3,2,Cape Verde
86574,6/1/2024,CRI,Johor,13,10,3,Costa Rica
86575,6/1/2024,CRI,Kedah,1,0,1,Costa Rica
86576,6/1/2024,CRI,Pulau Pinang,10,9,1,Costa Rica
86577,6/1/2024,CRI,Sabah,1,0,1,Costa Rica
86578,6/1/2024,CRI,Sarawak,2,2,0,Costa Rica
86579,6/1/2024,CRI,Selangor,41,19,22,Costa Rica
86580,6/1/2024,CUB,Johor,12,7,5,Cuba
86581,6/1/2024,CUB,Pulau Pinang,3,3,0,Cuba
86582,6/1/2024,CUB,Selangor,22,12,10,Cuba
86583,6/1/2024,CYP,Johor,6,3,3,Cyprus
86584,6/1/2024,CYP,Kedah,1,0,1,Cyprus
86585,6/1/2024,CYP,Pulau Pinang,5,2,3,Cyprus
86586,6/1/2024,CYP,Selangor,79,60,19,Cyprus
86587,6/1/2024,CZE,Johor,86,50,36,Czech Republic
86588,6/1/2024,CZE,Kedah,39,20,19,Czech Republic
86589,6/1/2024,CZE,Kelantan,2,2,0,Czech Republic
86590,6/1/2024,CZE,Perlis,1,0,1,Czech Republic
86591,6/1/2024,CZE,Pulau Pinang,13,9,4,Czech Republic
86592,6/1/2024,CZE,Sabah,3,2,1,Czech Republic
86593,6/1/2024,CZE,Sarawak,17,12,5,Czech Republic
86594,6/1/2024,CZE,Selangor,484,281,203,Czech Republic
86595,6/1/2024,DEU,Johor,2004,1255,749,Germany
86596,6/1/2024,DEU,Kedah,295,166,129,Germany
86597,6/1/2024,DEU,Kelantan,10,7,3,Germany
86598,6/1/2024,DEU,Melaka,3,0,3,Germany
86599,6/1/2024,DEU,Negeri Sembilan,6,2,4,Germany
86600,6/1/2024,DEU,Pahang,11,9,2,Germany
86601,6/1/2024,DEU,Perak,36,25,11,Germany
86602,6/1/2024,DEU,Perlis,84,49,35,Germany
86603,6/1/2024,DEU,Pulau Pinang,527,370,157,Germany
86604,6/1/2024,DEU,Sabah,158,85,73,Germany
86605,6/1/2024,DEU,Sarawak,217,132,85,Germany
86606,6/1/2024,DEU,Selangor,6228,3790,2438,Germany
86607,6/1/2024,DEU,W.P. Labuan,1,0,1,Germany
86608,6/1/2024,DJI,Selangor,14,11,3,Djibouti
86609,6/1/2024,DMA,Johor,4,2,2,Dominica
86610,6/1/2024,DMA,Kedah,1,1,0,Dominica
86611,6/1/2024,DMA,Pulau Pinang,2,2,0,Dominica
86612,6/1/2024,DMA,Selangor,44,34,10,Dominica
86613,6/1/2024,DNK,Johor,271,209,62,Denmark
86614,6/1/2024,DNK,Kedah,24,15,9,Denmark
86615,6/1/2024,DNK,Kelantan,4,3,1,Denmark
86616,6/1/2024,DNK,Pahang,3,2,1,Denmark
86617,6/1/2024,DNK,Perlis,12,9,3,Denmark
86618,6/1/2024,DNK,Pulau Pinang,61,42,19,Denmark
86619,6/1/2024,DNK,Sabah,18,13,5,Denmark
86620,6/1/2024,DNK,Sarawak,19,9,10,Denmark
86621,6/1/2024,DNK,Selangor,897,535,362,Denmark
86622,6/1/2024,DOM,Johor,7,1,6,Dominican Republic
86623,6/1/2024,DOM,Pulau Pinang,1,0,1,Dominican Republic
86624,6/1/2024,DOM,Sabah,1,0,1,Dominican Republic
86625,6/1/2024,DOM,Selangor,12,8,4,Dominican Republic
86626,6/1/2024,DZA,Johor,31,24,7,Algeria
86627,6/1/2024,DZA,Kedah,10,6,4,Algeria
86628,6/1/2024,DZA,Perlis,1,0,1,Algeria
86629,6/1/2024,DZA,Pulau Pinang,3,3,0,Algeria
86630,6/1/2024,DZA,Selangor,770,488,282,Algeria
86631,6/1/2024,ECU,Johor,32,14,18,Ecuador
86632,6/1/2024,ECU,Kedah,1,1,0,Ecuador
86633,6/1/2024,ECU,Perlis,1,0,1,Ecuador
86634,6/1/2024,ECU,Pulau Pinang,3,2,1,Ecuador
86635,6/1/2024,ECU,Sabah,1,0,1,Ecuador
86636,6/1/2024,ECU,Sarawak,2,2,0,Ecuador
86637,6/1/2024,ECU,Selangor,81,46,35,Ecuador
86638,6/1/2024,EGY,Johor,255,216,39,Egypt
86639,6/1/2024,EGY,Kedah,15,7,8,Egypt
86640,6/1/2024,EGY,Kelantan,1,1,0,Egypt
86641,6/1/2024,EGY,Perlis,1,1,0,Egypt
86642,6/1/2024,EGY,Pulau Pinang,37,22,15,Egypt
86643,6/1/2024,EGY,Sabah,4,2,2,Egypt
86644,6/1/2024,EGY,Sarawak,96,70,26,Egypt
86645,6/1/2024,EGY,Selangor,2160,1291,869,Egypt
86646,6/1/2024,ERI,Selangor,34,20,14,Eritrea
86647,6/1/2024,ESP,Johor,541,321,220,Spain
86648,6/1/2024,ESP,Kedah,71,35,36,Spain
86649,6/1/2024,ESP,Kelantan,5,3,2,Spain
86650,6/1/2024,ESP,Perak,5,2,3,Spain
86651,6/1/2024,ESP,Perlis,12,5,7,Spain
86652,6/1/2024,ESP,Pulau Pinang,120,59,61,Spain
86653,6/1/2024,ESP,Sabah,50,24,26,Spain
86654,6/1/2024,ESP,Sarawak,79,39,40,Spain
86655,6/1/2024,ESP,Selangor,3625,1959,1666,Spain
86656,6/1/2024,ESP,W.P. Labuan,10,7,3,Spain
86657,6/1/2024,EST,Johor,22,13,9,Estonia
86658,6/1/2024,EST,Kelantan,1,0,1,Estonia
86659,6/1/2024,EST,Pulau Pinang,5,2,3,Estonia
86660,6/1/2024,EST,Sabah,4,2,2,Estonia
86661,6/1/2024,EST,Sarawak,1,0,1,Estonia
86662,6/1/2024,EST,Selangor,106,65,41,Estonia
86663,6/1/2024,ETH,Pulau Pinang,2,1,1,Ethiopia
86664,6/1/2024,ETH,Selangor,37,21,16,Ethiopia
86665,6/1/2024,FIN,Johor,180,107,73,Finland
86666,6/1/2024,FIN,Kedah,29,13,16,Finland
86667,6/1/2024,FIN,Kelantan,3,1,2,Finland
86668,6/1/2024,FIN,Perak,2,2,0,Finland
86669,6/1/2024,FIN,Perlis,5,4,1,Finland
86670,6/1/2024,FIN,Pulau Pinang,46,30,16,Finland
86671,6/1/2024,FIN,Sabah,5,2,3,Finland
86672,6/1/2024,FIN,Sarawak,8,4,4,Finland
86673,6/1/2024,FIN,Selangor,349,200,149,Finland
86674,6/1/2024,FJI,Johor,60,26,34,Fiji
86675,6/1/2024,FJI,Pulau Pinang,4,1,3,Fiji
86676,6/1/2024,FJI,Sabah,4,3,1,Fiji
86677,6/1/2024,FJI,Sarawak,4,4,0,Fiji
86678,6/1/2024,FJI,Selangor,94,54,40,Fiji
86679,6/1/2024,FJI,W.P. Labuan,1,1,0,Fiji
86680,6/1/2024,FRA,Johor,2395,1439,956,France
86681,6/1/2024,FRA,Kedah,267,141,126,France
86682,6/1/2024,FRA,Kelantan,36,26,10,France
86683,6/1/2024,FRA,Melaka,7,4,3,France
86684,6/1/2024,FRA,Negeri Sembilan,1,0,1,France
86685,6/1/2024,FRA,Pahang,10,4,6,France
86686,6/1/2024,FRA,Perak,23,16,7,France
86687,6/1/2024,FRA,Perlis,94,49,45,France
86688,6/1/2024,FRA,Pulau Pinang,406,246,160,France
86689,6/1/2024,FRA,Sabah,121,66,55,France
86690,6/1/2024,FRA,Sarawak,144,77,67,France
86691,6/1/2024,FRA,Selangor,9921,5520,4401,France
86692,6/1/2024,FRA,Terengganu,1,1,0,France
86693,6/1/2024,FRA,W.P. Labuan,3,2,1,France
86694,6/1/2024,FSM,Selangor,1,0,1,"Micronesia, Federated States of"
86695,6/1/2024,GAB,Johor,5,2,3,Gabon
86696,6/1/2024,GBR,Johor,4939,3195,1744,United Kingdom
86697,6/1/2024,GBR,Kedah,764,414,350,United Kingdom
86698,6/1/2024,GBR,Kelantan,22,14,8,United Kingdom
86699,6/1/2024,GBR,Melaka,6,5,1,United Kingdom
86700,6/1/2024,GBR,Negeri Sembilan,2,2,0,United Kingdom
86701,6/1/2024,GBR,Pahang,23,21,2,United Kingdom
86702,6/1/2024,GBR,Perak,104,61,43,United Kingdom
86703,6/1/2024,GBR,Perlis,190,118,72,United Kingdom
86704,6/1/2024,GBR,Pulau Pinang,1403,836,567,United Kingdom
86705,6/1/2024,GBR,Sabah,563,309,254,United Kingdom
86706,6/1/2024,GBR,Sarawak,1145,773,372,United Kingdom
86707,6/1/2024,GBR,Selangor,19486,11397,8089,United Kingdom
86708,6/1/2024,GBR,Terengganu,1,1,0,United Kingdom
86709,6/1/2024,GBR,W.P. Labuan,20,17,3,United Kingdom
86710,6/1/2024,GEO,Johor,12,3,9,Georgia
86711,6/1/2024,GEO,Sarawak,3,1,2,Georgia
86712,6/1/2024,GEO,Selangor,57,36,21,Georgia
86713,6/1/2024,GHA,Johor,10,8,2,Ghana
86714,6/1/2024,GHA,Pulau Pinang,2,1,1,Ghana
86715,6/1/2024,GHA,Selangor,105,68,37,Ghana
86716,6/1/2024,GIN,Johor,10,9,1,Guinea
86717,6/1/2024,GIN,Kedah,1,1,0,Guinea
86718,6/1/2024,GIN,Kelantan,1,1,0,Guinea
86719,6/1/2024,GIN,Selangor,54,40,14,Guinea
86720,6/1/2024,GMB,Johor,5,0,5,Gambia
86721,6/1/2024,GMB,Selangor,27,14,13,Gambia
86722,6/1/2024,GNB,Selangor,1,1,0,Guinea-Bissau
86723,6/1/2024,GNQ,Selangor,2,1,1,Equatorial Guinea
86724,6/1/2024,GRC,Johor,97,78,19,Greece
86725,6/1/2024,GRC,Kedah,4,3,1,Greece
86726,6/1/2024,GRC,Kelantan,1,1,0,Greece
86727,6/1/2024,GRC,Pulau Pinang,6,4,2,Greece
86728,6/1/2024,GRC,Sabah,4,2,2,Greece
86729,6/1/2024,GRC,Sarawak,5,5,0,Greece
86730,6/1/2024,GRC,Selangor,199,137,62,Greece
86731,6/1/2024,GRD,Johor,7,5,2,Grenada
86732,6/1/2024,GRD,Selangor,9,6,3,Grenada
86733,6/1/2024,GTM,Johor,8,6,2,Guatemala
86734,6/1/2024,GTM,Pulau Pinang,2,1,1,Guatemala
86735,6/1/2024,GTM,Sabah,1,0,1,Guatemala
86736,6/1/2024,GTM,Selangor,23,16,7,Guatemala
86737,6/1/2024,GUY,Johor,1,1,0,Guyana
86738,6/1/2024,GUY,Selangor,3,2,1,Guyana
86739,6/1/2024,HKG,Johor,6,4,2,Hong Kong
86740,6/1/2024,HKG,Perak,61,20,41,Hong Kong
86741,6/1/2024,HKG,Perlis,1,1,0,Hong Kong
86742,6/1/2024,HKG,Pulau Pinang,6,1,5,Hong Kong
86743,6/1/2024,HKG,Sarawak,1,1,0,Hong Kong
86744,6/1/2024,HKG,Selangor,93,70,23,Hong Kong
86745,6/1/2024,HND,Johor,3,2,1,Honduras
86746,6/1/2024,HND,Pulau Pinang,2,1,1,Honduras
86747,6/1/2024,HND,Selangor,14,7,7,Honduras
86748,6/1/2024,HRV,Johor,29,27,2,Croatia
86749,6/1/2024,HRV,Kedah,2,2,0,Croatia
86750,6/1/2024,HRV,Kelantan,1,1,0,Croatia
86751,6/1/2024,HRV,Sabah,2,2,0,Croatia
86752,6/1/2024,HRV,Sarawak,2,1,1,Croatia
86753,6/1/2024,HRV,Selangor,150,102,48,Croatia
86754,6/1/2024,HTI,Johor,1,1,0,Haiti
86755,6/1/2024,HTI,Selangor,16,13,3,Haiti
86756,6/1/2024,HUN,Johor,76,51,25,Hungary
86757,6/1/2024,HUN,Kedah,7,3,4,Hungary
86758,6/1/2024,HUN,Perlis,1,1,0,Hungary
86759,6/1/2024,HUN,Pulau Pinang,30,19,11,Hungary
86760,6/1/2024,HUN,Sabah,7,5,2,Hungary
86761,6/1/2024,HUN,Sarawak,7,3,4,Hungary
86762,6/1/2024,HUN,Selangor,430,230,200,Hungary
86763,6/1/2024,IDN,Johor,117386,51562,65824,Indonesia
86764,6/1/2024,IDN,Kedah,5316,1843,3473,Indonesia
86765,6/1/2024,IDN,Kelantan,213,112,101,Indonesia
86766,6/1/2024,IDN,Melaka,5262,2356,2906,Indonesia
86767,6/1/2024,IDN,Negeri Sembilan,7155,4291,2864,Indonesia
86768,6/1/2024,IDN,Pahang,25,13,12,Indonesia
86769,6/1/2024,IDN,Perak,202,38,164,Indonesia
86770,6/1/2024,IDN,Perlis,702,188,514,Indonesia
86771,6/1/2024,IDN,Pulau Pinang,42689,17075,25614,Indonesia
86772,6/1/2024,IDN,Sabah,6036,2910,3126,Indonesia
86773,6/1/2024,IDN,Sarawak,54953,27092,27861,Indonesia
86774,6/1/2024,IDN,Selangor,165487,74754,90733,Indonesia
86775,6/1/2024,IDN,W.P. Labuan,63,39,24,Indonesia
86776,6/1/2024,IND,Johor,50758,31531,19227,India
86777,6/1/2024,IND,Kedah,1905,1059,846,India
86778,6/1/2024,IND,Kelantan,5,4,1,India
86779,6/1/2024,IND,Melaka,2,2,0,India
86780,6/1/2024,IND,Pahang,18,17,1,India
86781,6/1/2024,IND,Perak,284,155,129,India
86782,6/1/2024,IND,Perlis,114,90,24,India
86783,6/1/2024,IND,Pulau Pinang,1854,1091,763,India
86784,6/1/2024,IND,Sabah,219,135,84,India
86785,6/1/2024,IND,Sarawak,2493,1907,586,India
86786,6/1/2024,IND,Selangor,89482,56049,33433,India
86787,6/1/2024,IND,W.P. Labuan,79,57,22,India
86788,6/1/2024,IRL,Johor,304,197,107,Ireland
86789,6/1/2024,IRL,Kedah,54,31,23,Ireland
86790,6/1/2024,IRL,Kelantan,1,1,0,Ireland
86791,6/1/2024,IRL,Pahang,1,0,1,Ireland
86792,6/1/2024,IRL,Perak,7,4,3,Ireland
86793,6/1/2024,IRL,Perlis,24,15,9,Ireland
86794,6/1/2024,IRL,Pulau Pinang,166,93,73,Ireland
86795,6/1/2024,IRL,Sabah,28,17,11,Ireland
86796,6/1/2024,IRL,Sarawak,31,23,8,Ireland
86797,6/1/2024,IRL,Selangor,1755,986,769,Ireland
86798,6/1/2024,IRL,W.P. Labuan,1,0,1,Ireland
86799,6/1/2024,IRN,Johor,200,115,85,Iran
86800,6/1/2024,IRN,Kedah,14,4,10,Iran
86801,6/1/2024,IRN,Perlis,8,7,1,Iran
86802,6/1/2024,IRN,Pulau Pinang,12,8,4,Iran
86803,6/1/2024,IRN,Sabah,1,1,0,Iran
86804,6/1/2024,IRN,Sarawak,3,1,2,Iran
86805,6/1/2024,IRN,Selangor,1672,899,773,Iran
86806,6/1/2024,IRQ,Johor,39,30,9,Iraq
86807,6/1/2024,IRQ,Kedah,14,5,9,Iraq
86808,6/1/2024,IRQ,Pulau Pinang,2,1,1,Iraq
86809,6/1/2024,IRQ,Selangor,2478,1560,918,Iraq
86810,6/1/2024,ISL,Johor,3,2,1,Iceland
86811,6/1/2024,ISL,Selangor,42,22,20,Iceland
86812,6/1/2024,ITA,Johor,643,408,235,Italy
86813,6/1/2024,ITA,Kedah,57,35,22,Italy
86814,6/1/2024,ITA,Kelantan,3,2,1,Italy
86815,6/1/2024,ITA,Melaka,2,2,0,Italy
86816,6/1/2024,ITA,Pahang,2,2,0,Italy
86817,6/1/2024,ITA,Perak,5,2,3,Italy
86818,6/1/2024,ITA,Perlis,15,11,4,Italy
86819,6/1/2024,ITA,Pulau Pinang,103,73,30,Italy
86820,6/1/2024,ITA,Sabah,57,32,25,Italy
86821,6/1/2024,ITA,Sarawak,54,30,24,Italy
86822,6/1/2024,ITA,Selangor,3628,2215,1413,Italy
86823,6/1/2024,ITA,W.P. Labuan,2,1,1,Italy
86824,6/1/2024,JAM,Johor,3,1,2,Jamaica
86825,6/1/2024,JAM,Pulau Pinang,1,1,0,Jamaica
86826,6/1/2024,JAM,Selangor,13,8,5,Jamaica
86827,6/1/2024,JOR,Johor,25,18,7,Jordan
86828,6/1/2024,JOR,Kedah,24,14,10,Jordan
86829,6/1/2024,JOR,Kelantan,1,1,0,Jordan
86830,6/1/2024,JOR,Pahang,1,1,0,Jordan
86831,6/1/2024,JOR,Pulau Pinang,15,7,8,Jordan
86832,6/1/2024,JOR,Sarawak,1,1,0,Jordan
86833,6/1/2024,JOR,Selangor,1600,870,730,Jordan
86834,6/1/2024,JPN,Johor,6192,4164,2028,Japan
86835,6/1/2024,JPN,Kedah,142,76,66,Japan
86836,6/1/2024,JPN,Kelantan,7,4,3,Japan
86837,6/1/2024,JPN,Melaka,2,2,0,Japan
86838,6/1/2024,JPN,Pahang,16,12,4,Japan
86839,6/1/2024,JPN,Perak,63,43,20,Japan
86840,6/1/2024,JPN,Perlis,83,61,22,Japan
86841,6/1/2024,JPN,Pulau Pinang,1259,924,335,Japan
86842,6/1/2024,JPN,Sabah,347,163,184,Japan
86843,6/1/2024,JPN,Sarawak,192,111,81,Japan
86844,6/1/2024,JPN,Selangor,20914,12345,8569,Japan
86845,6/1/2024,JPN,W.P. Labuan,10,6,4,Japan
86846,6/1/2024,KAZ,Johor,74,37,37,Kazakhstan
86847,6/1/2024,KAZ,Kedah,13,6,7,Kazakhstan
86848,6/1/2024,KAZ,Kelantan,2,0,2,Kazakhstan
86849,6/1/2024,KAZ,Perlis,5,2,3,Kazakhstan
86850,6/1/2024,KAZ,Pulau Pinang,10,6,4,Kazakhstan
86851,6/1/2024,KAZ,Sabah,3,2,1,Kazakhstan
86852,6/1/2024,KAZ,Sarawak,4,1,3,Kazakhstan
86853,6/1/2024,KAZ,Selangor,3717,1485,2232,Kazakhstan
86854,6/1/2024,KAZ,W.P. Labuan,1,1,0,Kazakhstan
86855,6/1/2024,KEN,Johor,56,27,29,Kenya
86856,6/1/2024,KEN,Kedah,7,2,5,Kenya
86857,6/1/2024,KEN,Pulau Pinang,10,5,5,Kenya
86858,6/1/2024,KEN,Sabah,2,0,2,Kenya
86859,6/1/2024,KEN,Sarawak,2,2,0,Kenya
86860,6/1/2024,KEN,Selangor,872,423,449,Kenya
86861,6/1/2024,KGZ,Johor,34,25,9,Kyrgyzstan
86862,6/1/2024,KGZ,Kedah,6,3,3,Kyrgyzstan
86863,6/1/2024,KGZ,Kelantan,1,0,1,Kyrgyzstan
86864,6/1/2024,KGZ,Pulau Pinang,9,5,4,Kyrgyzstan
86865,6/1/2024,KGZ,Sabah,4,2,2,Kyrgyzstan
86866,6/1/2024,KGZ,Selangor,371,180,191,Kyrgyzstan
86867,6/1/2024,KHM,Johor,1562,659,903,Cambodia
86868,6/1/2024,KHM,Kedah,152,97,55,Cambodia
86869,6/1/2024,KHM,Kelantan,431,229,202,Cambodia
86870,6/1/2024,KHM,Perak,11,4,7,Cambodia
86871,6/1/2024,KHM,Perlis,727,419,308,Cambodia
86872,6/1/2024,KHM,Pulau Pinang,42,15,27,Cambodia
86873,6/1/2024,KHM,Sabah,4,0,4,Cambodia
86874,6/1/2024,KHM,Sarawak,18,10,8,Cambodia
86875,6/1/2024,KHM,Selangor,3813,1852,1961,Cambodia
86876,6/1/2024,KNA,Johor,22,14,8,Saint Kitts and Nevis
86877,6/1/2024,KNA,Kedah,2,0,2,Saint Kitts and Nevis
86878,6/1/2024,KNA,Pulau Pinang,1,1,0,Saint Kitts and Nevis
86879,6/1/2024,KNA,Selangor,59,48,11,Saint Kitts and Nevis
86880,6/1/2024,KOR,Johor,9723,5374,4349,"Korea, Republic of (South Korea)"
86881,6/1/2024,KOR,Kedah,116,67,49,"Korea, Republic of (South Korea)"
86882,6/1/2024,KOR,Kelantan,7,4,3,"Korea, Republic of (South Korea)"
86883,6/1/2024,KOR,Pahang,2,2,0,"Korea, Republic of (South Korea)"
86884,6/1/2024,KOR,Perak,14,10,4,"Korea, Republic of (South Korea)"
86885,6/1/2024,KOR,Perlis,66,47,19,"Korea, Republic of (South Korea)"
86886,6/1/2024,KOR,Pulau Pinang,580,348,232,"Korea, Republic of (South Korea)"
86887,6/1/2024,KOR,Sabah,15562,6116,9446,"Korea, Republic of (South Korea)"
86888,6/1/2024,KOR,Sarawak,262,159,103,"Korea, Republic of (South Korea)"
86889,6/1/2024,KOR,Selangor,15547,8567,6980,"Korea, Republic of (South Korea)"
86890,6/1/2024,KOR,W.P. Labuan,3,0,3,"Korea, Republic of (South Korea)"
86891,6/1/2024,KWT,Johor,88,45,43,Kuwait
86892,6/1/2024,KWT,Kedah,21,10,11,Kuwait
86893,6/1/2024,KWT,Perlis,1,1,0,Kuwait
86894,6/1/2024,KWT,Pulau Pinang,26,16,10,Kuwait
86895,6/1/2024,KWT,Selangor,1117,608,509,Kuwait
86896,6/1/2024,LAO,Johor,185,61,124,Lao People's Democratic Republic
86897,6/1/2024,LAO,Kedah,1041,84,957,Lao People's Democratic Republic
86898,6/1/2024,LAO,Kelantan,168,18,150,Lao People's Democratic Republic
86899,6/1/2024,LAO,Perak,43,5,38,Lao People's Democratic Republic
86900,6/1/2024,LAO,Perlis,458,94,364,Lao People's Democratic Republic
86901,6/1/2024,LAO,Pulau Pinang,66,30,36,Lao People's Democratic Republic
86902,6/1/2024,LAO,Sabah,1,0,1,Lao People's Democratic Republic
86903,6/1/2024,LAO,Sarawak,25,17,8,Lao People's Democratic Republic
86904,6/1/2024,LAO,Selangor,361,115,246,Lao People's Democratic Republic
86905,6/1/2024,LBN,Johor,21,12,9,Lebanon
86906,6/1/2024,LBN,Kedah,7,2,5,Lebanon
86907,6/1/2024,LBN,Pulau Pinang,5,2,3,Lebanon
86908,6/1/2024,LBN,Sabah,1,1,0,Lebanon
86909,6/1/2024,LBN,Sarawak,2,2,0,Lebanon
86910,6/1/2024,LBN,Selangor,402,234,168,Lebanon
86911,6/1/2024,LBR,Johor,2,2,0,Liberia
86912,6/1/2024,LBR,Sarawak,1,1,0,Liberia
86913,6/1/2024,LBR,Selangor,5,4,1,Liberia
86914,6/1/2024,LBY,Johor,4,2,2,Libyan Arab Jamahiriya
86915,6/1/2024,LBY,Kedah,1,1,0,Libyan Arab Jamahiriya
86916,6/1/2024,LBY,Selangor,363,254,109,Libyan Arab Jamahiriya
86917,6/1/2024,LCA,Johor,4,4,0,Saint Lucia
86918,6/1/2024,LCA,Pulau Pinang,3,3,0,Saint Lucia
86919,6/1/2024,LCA,Sarawak,4,2,2,Saint Lucia
86920,6/1/2024,LCA,Selangor,13,9,4,Saint Lucia
86921,6/1/2024,LIE,Johor,1,1,0,Liechtenstein
86922,6/1/2024,LIE,Sabah,1,0,1,Liechtenstein
86923,6/1/2024,LIE,Selangor,2,1,1,Liechtenstein
86924,6/1/2024,LKA,Johor,804,494,310,Sri Lanka
86925,6/1/2024,LKA,Kedah,37,21,16,Sri Lanka
86926,6/1/2024,LKA,Kelantan,1,1,0,Sri Lanka
86927,6/1/2024,LKA,Melaka,1,1,0,Sri Lanka
86928,6/1/2024,LKA,Pahang,1,0,1,Sri Lanka
86929,6/1/2024,LKA,Perlis,7,3,4,Sri Lanka
86930,6/1/2024,LKA,Pulau Pinang,114,73,41,Sri Lanka
86931,6/1/2024,LKA,Sabah,5,1,4,Sri Lanka
86932,6/1/2024,LKA,Sarawak,31,22,9,Sri Lanka
86933,6/1/2024,LKA,Selangor,4448,2720,1728,Sri Lanka
86934,6/1/2024,LKA,W.P. Labuan,1,1,0,Sri Lanka
86935,6/1/2024,LSO,Selangor,7,5,2,Lesotho
86936,6/1/2024,LTU,Johor,40,24,16,Lithuania
86937,6/1/2024,LTU,Kedah,10,4,6,Lithuania
86938,6/1/2024,LTU,Pahang,1,1,0,Lithuania
86939,6/1/2024,LTU,Perlis,2,1,1,Lithuania
86940,6/1/2024,LTU,Pulau Pinang,9,4,5,Lithuania
86941,6/1/2024,LTU,Sabah,2,2,0,Lithuania
86942,6/1/2024,LTU,Sarawak,2,2,0,Lithuania
86943,6/1/2024,LTU,Selangor,267,125,142,Lithuania
86944,6/1/2024,LUX,Johor,5,4,1,Luxembourg
86945,6/1/2024,LUX,Kedah,2,0,2,Luxembourg
86946,6/1/2024,LUX,Kelantan,1,1,0,Luxembourg
86947,6/1/2024,LUX,Perlis,1,1,0,Luxembourg
86948,6/1/2024,LUX,Pulau Pinang,1,0,1,Luxembourg
86949,6/1/2024,LUX,Sabah,3,2,1,Luxembourg
86950,6/1/2024,LUX,Sarawak,2,2,0,Luxembourg
86951,6/1/2024,LUX,Selangor,52,28,24,Luxembourg
86952,6/1/2024,LVA,Johor,9,7,2,Latvia
86953,6/1/2024,LVA,Perak,1,0,1,Latvia
86954,6/1/2024,LVA,Pulau Pinang,2,1,1,Latvia
86955,6/1/2024,LVA,Sabah,3,1,2,Latvia
86956,6/1/2024,LVA,Sarawak,5,4,1,Latvia
86957,6/1/2024,LVA,Selangor,141,62,79,Latvia
86958,6/1/2024,LVA,W.P. Labuan,3,2,1,Latvia
86959,6/1/2024,MAC,Perak,1,0,1,Macao
86960,6/1/2024,MAC,Pulau Pinang,1,0,1,Macao
86961,6/1/2024,MAC,Selangor,1,0,1,Macao
86962,6/1/2024,MAR,Johor,92,54,38,Morocco
86963,6/1/2024,MAR,Kedah,12,7,5,Morocco
86964,6/1/2024,MAR,Pulau Pinang,16,11,5,Morocco
86965,6/1/2024,MAR,Sabah,4,1,3,Morocco
86966,6/1/2024,MAR,Sarawak,11,6,5,Morocco
86967,6/1/2024,MAR,Selangor,1226,694,532,Morocco
86968,6/1/2024,MCO,Johor,1,1,0,Monaco
86969,6/1/2024,MCO,Selangor,1,1,0,Monaco
86970,6/1/2024,MDA,Johor,11,4,7,"Moldova, Republic of"
86971,6/1/2024,MDA,Kedah,2,1,1,"Moldova, Republic of"
86972,6/1/2024,MDA,Pahang,1,1,0,"Moldova, Republic of"
86973,6/1/2024,MDA,Pulau Pinang,1,0,1,"Moldova, Republic of"
86974,6/1/2024,MDA,Sabah,1,1,0,"Moldova, Republic of"
86975,6/1/2024,MDA,Selangor,26,16,10,"Moldova, Republic of"
86976,6/1/2024,MDG,Johor,18,7,11,Madagascar
86977,6/1/2024,MDG,Selangor,120,45,75,Madagascar
86978,6/1/2024,MDV,Johor,142,85,57,Maldives
86979,6/1/2024,MDV,Kedah,1,1,0,Maldives
86980,6/1/2024,MDV,Kelantan,1,1,0,Maldives
86981,6/1/2024,MDV,Perlis,1,1,0,Maldives
86982,6/1/2024,MDV,Pulau Pinang,6,3,3,Maldives
86983,6/1/2024,MDV,Sarawak,1,1,0,Maldives
86984,6/1/2024,MDV,Selangor,4053,2193,1860,Maldives
86985,6/1/2024,MEX,Johor,148,73,75,Mexico
86986,6/1/2024,MEX,Kedah,20,12,8,Mexico
86987,6/1/2024,MEX,Kelantan,2,1,1,Mexico
86988,6/1/2024,MEX,Perak,3,3,0,Mexico
86989,6/1/2024,MEX,Perlis,3,2,1,Mexico
86990,6/1/2024,MEX,Pulau Pinang,27,17,10,Mexico
86991,6/1/2024,MEX,Sabah,3,2,1,Mexico
86992,6/1/2024,MEX,Sarawak,2,2,0,Mexico
86993,6/1/2024,MEX,Selangor,639,323,316,Mexico
86994,6/1/2024,MHL,Selangor,6,3,3,Marshall Islands
86995,6/1/2024,MKD,Johor,11,9,2,"Macedonia, the former Yugoslav Republic of"
86996,6/1/2024,MKD,Kedah,3,2,1,"Macedonia, the former Yugoslav Republic of"
86997,6/1/2024,MKD,Pulau Pinang,1,0,1,"Macedonia, the former Yugoslav Republic of"
86998,6/1/2024,MKD,Sarawak,3,2,1,"Macedonia, the former Yugoslav Republic of"
86999,6/1/2024,MKD,Selangor,25,14,11,"Macedonia, the former Yugoslav Republic of"
87000,6/1/2024,MLI,Johor,3,3,0,Mali
87001,6/1/2024,MLI,Selangor,7,4,3,Mali
87002,6/1/2024,MLT,Johor,12,5,7,Malta
87003,6/1/2024,MLT,Kedah,5,3,2,Malta
87004,6/1/2024,MLT,Pulau Pinang,2,2,0,Malta
87005,6/1/2024,MLT,Sabah,1,1,0,Malta
87006,6/1/2024,MLT,Sarawak,3,3,0,Malta
87007,6/1/2024,MLT,Selangor,50,29,21,Malta
87008,6/1/2024,MMR,Johor,10838,3120,7718,Myanmar
87009,6/1/2024,MMR,Kedah,105,27,78,Myanmar
87010,6/1/2024,MMR,Kelantan,1,0,1,Myanmar
87011,6/1/2024,MMR,Pahang,4,3,1,Myanmar
87012,6/1/2024,MMR,Perak,44,7,37,Myanmar
87013,6/1/2024,MMR,Perlis,8,3,5,Myanmar
87014,6/1/2024,MMR,Pulau Pinang,355,134,221,Myanmar
87015,6/1/2024,MMR,Sabah,36,15,21,Myanmar
87016,6/1/2024,MMR,Sarawak,115,52,63,Myanmar
87017,6/1/2024,MMR,Selangor,4861,2798,2063,Myanmar
87018,6/1/2024,MNE,Johor,4,3,1,Montenegro
87019,6/1/2024,MNE,Selangor,7,2,5,Montenegro
87020,6/1/2024,MNG,Johor,211,73,138,Mongolia
87021,6/1/2024,MNG,Kedah,9,6,3,Mongolia
87022,6/1/2024,MNG,Pulau Pinang,4,2,2,Mongolia
87023,6/1/2024,MNG,Selangor,407,151,256,Mongolia
87024,6/1/2024,MOZ,Selangor,21,8,13,Mozambique
87025,6/1/2024,MRT,Selangor,26,22,4,Mauritania
87026,6/1/2024,MUS,Johor,126,71,55,Mauritius
87027,6/1/2024,MUS,Kedah,7,4,3,Mauritius
87028,6/1/2024,MUS,Kelantan,2,1,1,Mauritius
87029,6/1/2024,MUS,Pahang,1,1,0,Mauritius
87030,6/1/2024,MUS,Perlis,4,2,2,Mauritius
87031,6/1/2024,MUS,Pulau Pinang,3,1,2,Mauritius
87032,6/1/2024,MUS,Sabah,1,1,0,Mauritius
87033,6/1/2024,MUS,Sarawak,1,1,0,Mauritius
87034,6/1/2024,MUS,Selangor,1223,656,567,Mauritius
87035,6/1/2024,MWI,Johor,1,1,0,Malawi
87036,6/1/2024,MWI,Selangor,19,12,7,Malawi
87037,6/1/2024,NAM,Johor,4,2,2,Namibia
87038,6/1/2024,NAM,Pulau Pinang,1,1,0,Namibia
87039,6/1/2024,NAM,Selangor,19,11,8,Namibia
87040,6/1/2024,NGA,Johor,37,27,10,Nigeria
87041,6/1/2024,NGA,Pulau Pinang,3,2,1,Nigeria
87042,6/1/2024,NGA,Sarawak,8,7,1,Nigeria
87043,6/1/2024,NGA,Selangor,429,331,98,Nigeria
87044,6/1/2024,NIC,Johor,3,2,1,Nicaragua
87045,6/1/2024,NIC,Kedah,4,1,3,Nicaragua
87046,6/1/2024,NIC,Sabah,1,1,0,Nicaragua
87047,6/1/2024,NIC,Selangor,7,2,5,Nicaragua
87048,6/1/2024,NLD,Johor,948,620,328,Netherlands
87049,6/1/2024,NLD,Kedah,165,94,71,Netherlands
87050,6/1/2024,NLD,Kelantan,4,3,1,Netherlands
87051,6/1/2024,NLD,Melaka,1,1,0,Netherlands
87052,6/1/2024,NLD,Negeri Sembilan,2,0,2,Netherlands
87053,6/1/2024,NLD,Pahang,1,0,1,Netherlands
87054,6/1/2024,NLD,Perak,14,9,5,Netherlands
87055,6/1/2024,NLD,Perlis,38,19,19,Netherlands
87056,6/1/2024,NLD,Pulau Pinang,193,117,76,Netherlands
87057,6/1/2024,NLD,Sabah,86,49,37,Netherlands
87058,6/1/2024,NLD,Sarawak,92,63,29,Netherlands
87059,6/1/2024,NLD,Selangor,4142,2424,1718,Netherlands
87060,6/1/2024,NOR,Johor,218,132,86,Norway
87061,6/1/2024,NOR,Kedah,18,12,6,Norway
87062,6/1/2024,NOR,Pahang,1,1,0,Norway
87063,6/1/2024,NOR,Perak,5,3,2,Norway
87064,6/1/2024,NOR,Perlis,3,3,0,Norway
87065,6/1/2024,NOR,Pulau Pinang,48,30,18,Norway
87066,6/1/2024,NOR,Sabah,10,8,2,Norway
87067,6/1/2024,NOR,Sarawak,18,14,4,Norway
87068,6/1/2024,NOR,Selangor,974,573,401,Norway
87069,6/1/2024,NPL,Johor,1126,789,337,Nepal
87070,6/1/2024,NPL,Kedah,24,13,11,Nepal
87071,6/1/2024,NPL,Perlis,1,1,0,Nepal
87072,6/1/2024,NPL,Pulau Pinang,25,22,3,Nepal
87073,6/1/2024,NPL,Sabah,3,1,2,Nepal
87074,6/1/2024,NPL,Sarawak,143,91,52,Nepal
87075,6/1/2024,NPL,Selangor,2965,2593,372,Nepal
87076,6/1/2024,NPL,W.P. Labuan,78,75,3,Nepal
87077,6/1/2024,NRU,Selangor,4,3,1,Nauru
87078,6/1/2024,NZL,Johor,870,512,358,New Zealand
87079,6/1/2024,NZL,Kedah,68,39,29,New Zealand
87080,6/1/2024,NZL,Kelantan,1,0,1,New Zealand
87081,6/1/2024,NZL,Pahang,4,2,2,New Zealand
87082,6/1/2024,NZL,Perak,25,16,9,New Zealand
87083,6/1/2024,NZL,Perlis,12,8,4,New Zealand
87084,6/1/2024,NZL,Pulau Pinang,301,151,150,New Zealand
87085,6/1/2024,NZL,Sabah,77,36,41,New Zealand
87086,6/1/2024,NZL,Sarawak,144,87,57,New Zealand
87087,6/1/2024,NZL,Selangor,3262,1904,1358,New Zealand
87088,6/1/2024,NZL,Terengganu,1,1,0,New Zealand
87089,6/1/2024,NZL,W.P. Labuan,5,3,2,New Zealand
87090,6/1/2024,OMN,Johor,87,59,28,Oman
87091,6/1/2024,OMN,Kedah,21,10,11,Oman
87092,6/1/2024,OMN,Perlis,6,2,4,Oman
87093,6/1/2024,OMN,Pulau Pinang,50,47,3,Oman
87094,6/1/2024,OMN,Sabah,1,0,1,Oman
87095,6/1/2024,OMN,Sarawak,20,19,1,Oman
87096,6/1/2024,OMN,Selangor,2375,1303,1072,Oman
87097,6/1/2024,PAK,Johor,711,484,227,Pakistan
87098,6/1/2024,PAK,Kedah,189,114,75,Pakistan
87099,6/1/2024,PAK,Kelantan,9,8,1,Pakistan
87100,6/1/2024,PAK,Melaka,1,1,0,Pakistan
87101,6/1/2024,PAK,Perak,4,4,0,Pakistan
87102,6/1/2024,PAK,Perlis,11,10,1,Pakistan
87103,6/1/2024,PAK,Pulau Pinang,101,69,32,Pakistan
87104,6/1/2024,PAK,Sabah,15,9,6,Pakistan
87105,6/1/2024,PAK,Sarawak,185,161,24,Pakistan
87106,6/1/2024,PAK,Selangor,11403,8760,2643,Pakistan
87107,6/1/2024,PAK,W.P. Labuan,3,3,0,Pakistan
87108,6/1/2024,PAN,Johor,10,4,6,Panama
87109,6/1/2024,PAN,Pulau Pinang,4,3,1,Panama
87110,6/1/2024,PAN,Selangor,23,9,14,Panama
87111,6/1/2024,PER,Johor,26,15,11,Peru
87112,6/1/2024,PER,Kedah,3,2,1,Peru
87113,6/1/2024,PER,Perak,1,0,1,Peru
87114,6/1/2024,PER,Perlis,2,2,0,Peru
87115,6/1/2024,PER,Pulau Pinang,3,3,0,Peru
87116,6/1/2024,PER,Sabah,3,1,2,Peru
87117,6/1/2024,PER,Selangor,131,71,60,Peru
87118,6/1/2024,PHL,Johor,36097,11682,24415,Philippines
87119,6/1/2024,PHL,Kedah,563,181,382,Philippines
87120,6/1/2024,PHL,Kelantan,89,45,44,Philippines
87121,6/1/2024,PHL,Melaka,2,1,1,Philippines
87122,6/1/2024,PHL,Pahang,30,22,8,Philippines
87123,6/1/2024,PHL,Perak,127,46,81,Philippines
87124,6/1/2024,PHL,Perlis,282,101,181,Philippines
87125,6/1/2024,PHL,Pulau Pinang,958,364,594,Philippines
87126,6/1/2024,PHL,Sabah,1453,688,765,Philippines
87127,6/1/2024,PHL,Sarawak,3054,1232,1822,Philippines
87128,6/1/2024,PHL,Selangor,21674,8398,13276,Philippines
87129,6/1/2024,PHL,W.P. Labuan,138,56,82,Philippines
87130,6/1/2024,PLW,Johor,3,3,0,Palau
87131,6/1/2024,PLW,Pulau Pinang,1,1,0,Palau
87132,6/1/2024,PLW,Selangor,1,0,1,Palau
87133,6/1/2024,PNG,Johor,47,7,40,Papua New Guinea
87134,6/1/2024,PNG,Pulau Pinang,1,0,1,Papua New Guinea
87135,6/1/2024,PNG,Sabah,1,1,0,Papua New Guinea
87136,6/1/2024,PNG,Sarawak,3,1,2,Papua New Guinea
87137,6/1/2024,PNG,Selangor,142,67,75,Papua New Guinea
87138,6/1/2024,POL,Johor,342,201,141,Poland
87139,6/1/2024,POL,Kedah,60,31,29,Poland
87140,6/1/2024,POL,Kelantan,1,1,0,Poland
87141,6/1/2024,POL,Pahang,2,2,0,Poland
87142,6/1/2024,POL,Perak,4,2,2,Poland
87143,6/1/2024,POL,Perlis,3,2,1,Poland
87144,6/1/2024,POL,Pulau Pinang,45,23,22,Poland
87145,6/1/2024,POL,Sabah,30,16,14,Poland
87146,6/1/2024,POL,Sarawak,46,27,19,Poland
87147,6/1/2024,POL,Selangor,1529,772,757,Poland
87148,6/1/2024,PRT,Johor,184,105,79,Portugal
87149,6/1/2024,PRT,Kedah,17,8,9,Portugal
87150,6/1/2024,PRT,Kelantan,1,1,0,Portugal
87151,6/1/2024,PRT,Perlis,2,0,2,Portugal
87152,6/1/2024,PRT,Pulau Pinang,30,17,13,Portugal
87153,6/1/2024,PRT,Sabah,26,12,14,Portugal
87154,6/1/2024,PRT,Sarawak,12,6,6,Portugal
87155,6/1/2024,PRT,Selangor,782,447,335,Portugal
87156,6/1/2024,PRT,W.P. Labuan,3,1,2,Portugal
87157,6/1/2024,PRY,Johor,1,1,0,Paraguay
87158,6/1/2024,PRY,Selangor,21,12,9,Paraguay
87159,6/1/2024,PSE,Johor,12,11,1,"Palestinian Territory, Occupied"
87160,6/1/2024,PSE,Kedah,13,9,4,"Palestinian Territory, Occupied"
87161,6/1/2024,PSE,Pulau Pinang,3,2,1,"Palestinian Territory, Occupied"
87162,6/1/2024,PSE,Selangor,491,293,198,"Palestinian Territory, Occupied"
87163,6/1/2024,QAT,Johor,24,8,16,Qatar
87164,6/1/2024,QAT,Kedah,7,3,4,Qatar
87165,6/1/2024,QAT,Perlis,2,2,0,Qatar
87166,6/1/2024,QAT,Pulau Pinang,6,4,2,Qatar
87167,6/1/2024,QAT,Sarawak,1,1,0,Qatar
87168,6/1/2024,QAT,Selangor,389,230,159,Qatar
87169,6/1/2024,ROU,Johor,115,69,46,Romania
87170,6/1/2024,ROU,Kedah,13,5,8,Romania
87171,6/1/2024,ROU,Pahang,1,1,0,Romania
87172,6/1/2024,ROU,Perak,1,0,1,Romania
87173,6/1/2024,ROU,Perlis,3,2,1,Romania
87174,6/1/2024,ROU,Pulau Pinang,23,12,11,Romania
87175,6/1/2024,ROU,Sabah,7,1,6,Romania
87176,6/1/2024,ROU,Sarawak,2,0,2,Romania
87177,6/1/2024,ROU,Selangor,480,272,208,Romania
87178,6/1/2024,RUS,Johor,473,216,257,Russia
87179,6/1/2024,RUS,Kedah,129,72,57,Russia
87180,6/1/2024,RUS,Kelantan,34,19,15,Russia
87181,6/1/2024,RUS,Melaka,1,1,0,Russia
87182,6/1/2024,RUS,Pahang,1,0,1,Russia
87183,6/1/2024,RUS,Perak,5,3,2,Russia
87184,6/1/2024,RUS,Perlis,57,39,18,Russia
87185,6/1/2024,RUS,Pulau Pinang,80,34,46,Russia
87186,6/1/2024,RUS,Sabah,62,30,32,Russia
87187,6/1/2024,RUS,Sarawak,42,19,23,Russia
87188,6/1/2024,RUS,Selangor,7576,3710,3866,Russia
87189,6/1/2024,RUS,W.P. Labuan,9,4,5,Russia
87190,6/1/2024,RWA,Johor,1,1,0,Rwanda
87191,6/1/2024,RWA,Selangor,6,4,2,Rwanda
87192,6/1/2024,SAU,Johor,394,209,185,Saudi Arabia
87193,6/1/2024,SAU,Kedah,158,82,76,Saudi Arabia
87194,6/1/2024,SAU,Kelantan,4,3,1,Saudi Arabia
87195,6/1/2024,SAU,Perak,4,1,3,Saudi Arabia
87196,6/1/2024,SAU,Perlis,2,1,1,Saudi Arabia
87197,6/1/2024,SAU,Pulau Pinang,135,58,77,Saudi Arabia
87198,6/1/2024,SAU,Sabah,3,2,1,Saudi Arabia
87199,6/1/2024,SAU,Sarawak,4,3,1,Saudi Arabia
87200,6/1/2024,SAU,Selangor,10757,5812,4945,Saudi Arabia
87201,6/1/2024,SDN,Johor,15,13,2,Sudan
87202,6/1/2024,SDN,Kedah,4,3,1,Sudan
87203,6/1/2024,SDN,Perlis,1,1,0,Sudan
87204,6/1/2024,SDN,Pulau Pinang,3,1,2,Sudan
87205,6/1/2024,SDN,Sarawak,2,0,2,Sudan
87206,6/1/2024,SDN,Selangor,1506,838,668,Sudan
87207,6/1/2024,SDN,W.P. Labuan,2,2,0,Sudan
87208,6/1/2024,SEN,Johor,6,5,1,Senegal
87209,6/1/2024,SEN,Kedah,1,1,0,Senegal
87210,6/1/2024,SEN,Pulau Pinang,1,0,1,Senegal
87211,6/1/2024,SEN,Selangor,54,39,15,Senegal
87212,6/1/2024,SGP,Johor,1684536,931196,753340,Singapore
87213,6/1/2024,SGP,Kedah,8231,4175,4056,Singapore
87214,6/1/2024,SGP,Kelantan,212,124,88,Singapore
87215,6/1/2024,SGP,Melaka,49,35,14,Singapore
87216,6/1/2024,SGP,Negeri Sembilan,3,0,3,Singapore
87217,6/1/2024,SGP,Pahang,882,439,443,Singapore
87218,6/1/2024,SGP,Perak,8977,4127,4850,Singapore
87219,6/1/2024,SGP,Perlis,522,286,236,Singapore
87220,6/1/2024,SGP,Pulau Pinang,28598,13835,14763,Singapore
87221,6/1/2024,SGP,Sabah,4053,2008,2045,Singapore
87222,6/1/2024,SGP,Sarawak,5684,3078,2606,Singapore
87223,6/1/2024,SGP,Selangor,63733,32034,31699,Singapore
87224,6/1/2024,SGP,W.P. Labuan,12,11,1,Singapore
87225,6/1/2024,SLB,Johor,8,2,6,Solomon Islands
87226,6/1/2024,SLB,Pulau Pinang,1,1,0,Solomon Islands
87227,6/1/2024,SLB,Sarawak,4,1,3,Solomon Islands
87228,6/1/2024,SLB,Selangor,13,5,8,Solomon Islands
87229,6/1/2024,SLE,Johor,3,1,2,Sierra Leone
87230,6/1/2024,SLE,Kedah,1,1,0,Sierra Leone
87231,6/1/2024,SLE,Kelantan,1,1,0,Sierra Leone
87232,6/1/2024,SLE,Selangor,34,18,16,Sierra Leone
87233,6/1/2024,SLV,Johor,1,1,0,El Salvador
87234,6/1/2024,SLV,Pulau Pinang,2,2,0,El Salvador
87235,6/1/2024,SLV,Sabah,1,0,1,El Salvador
87236,6/1/2024,SLV,Selangor,13,4,9,El Salvador
87237,6/1/2024,SMR,Selangor,1,1,0,San Marino
87238,6/1/2024,SOM,Selangor,232,144,88,Somalia
87239,6/1/2024,SRB,Johor,5,4,1,Serbia
87240,6/1/2024,SRB,Perlis,1,1,0,Serbia
87241,6/1/2024,SRB,Selangor,101,50,51,Serbia
87242,6/1/2024,STP,Selangor,1,1,0,Sao Tome and Principe
87243,6/1/2024,SUR,Johor,5,3,2,Suriname
87244,6/1/2024,SUR,Sabah,2,2,0,Suriname
87245,6/1/2024,SUR,Selangor,14,11,3,Suriname
87246,6/1/2024,SVK,Johor,56,34,22,Slovakia
87247,6/1/2024,SVK,Kedah,29,13,16,Slovakia
87248,6/1/2024,SVK,Perlis,1,0,1,Slovakia
87249,6/1/2024,SVK,Pulau Pinang,10,5,5,Slovakia
87250,6/1/2024,SVK,Sabah,2,1,1,Slovakia
87251,6/1/2024,SVK,Sarawak,5,3,2,Slovakia
87252,6/1/2024,SVK,Selangor,285,156,129,Slovakia
87253,6/1/2024,SVN,Johor,10,6,4,Slovenia
87254,6/1/2024,SVN,Kedah,4,1,3,Slovenia
87255,6/1/2024,SVN,Pulau Pinang,7,3,4,Slovenia
87256,6/1/2024,SVN,Sarawak,2,1,1,Slovenia
87257,6/1/2024,SVN,Selangor,194,97,97,Slovenia
87258,6/1/2024,SWE,Johor,313,195,118,Sweden
87259,6/1/2024,SWE,Kedah,33,12,21,Sweden
87260,6/1/2024,SWE,Kelantan,17,8,9,Sweden
87261,6/1/2024,SWE,Pahang,2,2,0,Sweden
87262,6/1/2024,SWE,Perak,5,1,4,Sweden
87263,6/1/2024,SWE,Perlis,7,6,1,Sweden
87264,6/1/2024,SWE,Pulau Pinang,133,87,46,Sweden
87265,6/1/2024,SWE,Sabah,16,8,8,Sweden
87266,6/1/2024,SWE,Sarawak,28,17,11,Sweden
87267,6/1/2024,SWE,Selangor,1018,593,425,Sweden
87268,6/1/2024,SWE,W.P. Labuan,5,2,3,Sweden
87269,6/1/2024,SWZ,Johor,3,2,1,Swaziland
87270,6/1/2024,SWZ,Selangor,53,28,25,Swaziland
87271,6/1/2024,SYC,Johor,3,2,1,Seychelles
87272,6/1/2024,SYC,Pulau Pinang,1,1,0,Seychelles
87273,6/1/2024,SYC,Selangor,92,33,59,Seychelles
87274,6/1/2024,SYR,Johor,23,16,7,Syrian Arab Republic
87275,6/1/2024,SYR,Kedah,32,17,15,Syrian Arab Republic
87276,6/1/2024,SYR,Pulau Pinang,4,3,1,Syrian Arab Republic
87277,6/1/2024,SYR,Sabah,4,1,3,Syrian Arab Republic
87278,6/1/2024,SYR,Sarawak,8,6,2,Syrian Arab Republic
87279,6/1/2024,SYR,Selangor,912,514,398,Syrian Arab Republic
87280,6/1/2024,TCD,Johor,9,7,2,Chad
87281,6/1/2024,TCD,Pulau Pinang,1,1,0,Chad
87282,6/1/2024,TCD,Selangor,31,26,5,Chad
87283,6/1/2024,TGO,Johor,2,2,0,Togo
87284,6/1/2024,TGO,Sabah,1,1,0,Togo
87285,6/1/2024,TGO,Selangor,5,4,1,Togo
87286,6/1/2024,THA,Johor,7062,1622,5440,Thailand
87287,6/1/2024,THA,Kedah,47857,26418,21439,Thailand
87288,6/1/2024,THA,Kelantan,50235,25102,25133,Thailand
87289,6/1/2024,THA,Melaka,6,4,2,Thailand
87290,6/1/2024,THA,Pahang,29,23,6,Thailand
87291,6/1/2024,THA,Perak,9023,4335,4688,Thailand
87292,6/1/2024,THA,Perlis,47503,26921,20582,Thailand
87293,6/1/2024,THA,Pulau Pinang,3132,1231,1901,Thailand
87294,6/1/2024,THA,Sabah,25,6,19,Thailand
87295,6/1/2024,THA,Sarawak,418,128,290,Thailand
87296,6/1/2024,THA,Selangor,13695,5023,8672,Thailand
87297,6/1/2024,THA,W.P. Labuan,11,4,7,Thailand
87298,6/1/2024,TJK,Selangor,201,139,62,Tajikistan
87299,6/1/2024,TKM,Johor,1,0,1,Turkmenistan
87300,6/1/2024,TKM,Pulau Pinang,2,2,0,Turkmenistan
87301,6/1/2024,TKM,Sarawak,1,1,0,Turkmenistan
87302,6/1/2024,TKM,Selangor,580,318,262,Turkmenistan
87303,6/1/2024,TLS,Johor,12,6,6,Timor-Leste
87304,6/1/2024,TLS,Perak,6,2,4,Timor-Leste
87305,6/1/2024,TLS,Pulau Pinang,12,2,10,Timor-Leste
87306,6/1/2024,TLS,Selangor,296,171,125,Timor-Leste
87307,6/1/2024,TON,Johor,1,1,0,Tonga
87308,6/1/2024,TON,Pulau Pinang,1,0,1,Tonga
87309,6/1/2024,TON,Selangor,15,8,7,Tonga
87310,6/1/2024,TTO,Johor,6,5,1,Trinidad and Tobago
87311,6/1/2024,TTO,Kedah,1,1,0,Trinidad and Tobago
87312,6/1/2024,TTO,Pulau Pinang,1,1,0,Trinidad and Tobago
87313,6/1/2024,TTO,Sabah,1,1,0,Trinidad and Tobago
87314,6/1/2024,TTO,Sarawak,1,0,1,Trinidad and Tobago
87315,6/1/2024,TTO,Selangor,29,13,16,Trinidad and Tobago
87316,6/1/2024,TUN,Johor,20,12,8,Tunisia
87317,6/1/2024,TUN,Kedah,6,3,3,Tunisia
87318,6/1/2024,TUN,Kelantan,1,1,0,Tunisia
87319,6/1/2024,TUN,Pulau Pinang,5,1,4,Tunisia
87320,6/1/2024,TUN,Sarawak,1,1,0,Tunisia
87321,6/1/2024,TUN,Selangor,476,244,232,Tunisia
87322,6/1/2024,TUR,Johor,357,243,114,Turkey
87323,6/1/2024,TUR,Kedah,51,34,17,Turkey
87324,6/1/2024,TUR,Kelantan,6,5,1,Turkey
87325,6/1/2024,TUR,Melaka,1,1,0,Turkey
87326,6/1/2024,TUR,Perak,3,2,1,Turkey
87327,6/1/2024,TUR,Perlis,7,6,1,Turkey
87328,6/1/2024,TUR,Pulau Pinang,35,25,10,Turkey
87329,6/1/2024,TUR,Sabah,2,2,0,Turkey
87330,6/1/2024,TUR,Sarawak,26,19,7,Turkey
87331,6/1/2024,TUR,Selangor,2549,1509,1040,Turkey
87332,6/1/2024,TUV,Selangor,1,0,1,Tuvalu
87333,6/1/2024,TWN,Johor,9187,3913,5274,Taiwan
87334,6/1/2024,TWN,Kedah,224,112,112,Taiwan
87335,6/1/2024,TWN,Kelantan,3,3,0,Taiwan
87336,6/1/2024,TWN,Melaka,3,1,2,Taiwan
87337,6/1/2024,TWN,Pahang,6,5,1,Taiwan
87338,6/1/2024,TWN,Perak,77,38,39,Taiwan
87339,6/1/2024,TWN,Perlis,45,22,23,Taiwan
87340,6/1/2024,TWN,Pulau Pinang,5005,2385,2620,Taiwan
87341,6/1/2024,TWN,Sabah,3056,1431,1625,Taiwan
87342,6/1/2024,TWN,Sarawak,307,125,182,Taiwan
87343,6/1/2024,TWN,Selangor,22555,10704,11851,Taiwan
87344,6/1/2024,TWN,W.P. Labuan,1,1,0,Taiwan
87345,6/1/2024,TZA,Johor,36,17,19,"Tanzania, United Republic of"
87346,6/1/2024,TZA,Pulau Pinang,1,0,1,"Tanzania, United Republic of"
87347,6/1/2024,TZA,Sarawak,4,4,0,"Tanzania, United Republic of"
87348,6/1/2024,TZA,Selangor,225,112,113,"Tanzania, United Republic of"
87349,6/1/2024,UGA,Johor,16,6,10,Uganda
87350,6/1/2024,UGA,Kedah,1,0,1,Uganda
87351,6/1/2024,UGA,Pahang,1,1,0,Uganda
87352,6/1/2024,UGA,Pulau Pinang,1,0,1,Uganda
87353,6/1/2024,UGA,Sabah,1,0,1,Uganda
87354,6/1/2024,UGA,Selangor,154,62,92,Uganda
87355,6/1/2024,UKR,Johor,106,50,56,Ukraine
87356,6/1/2024,UKR,Kedah,8,4,4,Ukraine
87357,6/1/2024,UKR,Kelantan,18,7,11,Ukraine
87358,6/1/2024,UKR,Perak,1,0,1,Ukraine
87359,6/1/2024,UKR,Perlis,1,0,1,Ukraine
87360,6/1/2024,UKR,Pulau Pinang,38,18,20,Ukraine
87361,6/1/2024,UKR,Sabah,9,3,6,Ukraine
87362,6/1/2024,UKR,Sarawak,2,1,1,Ukraine
87363,6/1/2024,UKR,Selangor,921,460,461,Ukraine
87364,6/1/2024,URY,Johor,7,1,6,Uruguay
87365,6/1/2024,URY,Kedah,2,0,2,Uruguay
87366,6/1/2024,URY,Pulau Pinang,1,1,0,Uruguay
87367,6/1/2024,URY,Selangor,61,30,31,Uruguay
87368,6/1/2024,USA,Johor,5886,3360,2526,United States Of America
87369,6/1/2024,USA,Kedah,431,212,219,United States Of America
87370,6/1/2024,USA,Kelantan,20,15,5,United States Of America
87371,6/1/2024,USA,Pahang,13,10,3,United States Of America
87372,6/1/2024,USA,Perak,180,105,75,United States Of America
87373,6/1/2024,USA,Perlis,148,103,45,United States Of America
87374,6/1/2024,USA,Pulau Pinang,2644,1547,1097,United States Of America
87375,6/1/2024,USA,Sabah,787,502,285,United States Of America
87376,6/1/2024,USA,Sarawak,402,198,204,United States Of America
87377,6/1/2024,USA,Selangor,18228,10175,8053,United States Of America
87378,6/1/2024,USA,Terengganu,2,2,0,United States Of America
87379,6/1/2024,USA,W.P. Labuan,5,5,0,United States Of America
87380,6/1/2024,UZB,Johor,83,62,21,Uzbekistan
87381,6/1/2024,UZB,Kedah,3,2,1,Uzbekistan
87382,6/1/2024,UZB,Kelantan,2,2,0,Uzbekistan
87383,6/1/2024,UZB,Pulau Pinang,1,1,0,Uzbekistan
87384,6/1/2024,UZB,Sabah,5,2,3,Uzbekistan
87385,6/1/2024,UZB,Selangor,1225,673,552,Uzbekistan
87386,6/1/2024,VAT,Selangor,1,0,1,Holy See (Vatican City State)
87387,6/1/2024,VCT,Selangor,1,1,0,Saint Vincent and the Grenadines
87388,6/1/2024,VEN,Johor,11,9,2,Venezuela
87389,6/1/2024,VEN,Kedah,2,2,0,Venezuela
87390,6/1/2024,VEN,Perlis,1,0,1,Venezuela
87391,6/1/2024,VEN,Pulau Pinang,4,3,1,Venezuela
87392,6/1/2024,VEN,Sabah,1,1,0,Venezuela
87393,6/1/2024,VEN,Sarawak,4,3,1,Venezuela
87394,6/1/2024,VEN,Selangor,76,40,36,Venezuela
87395,6/1/2024,VNM,Johor,22007,7263,14744,Vietnam
87396,6/1/2024,VNM,Kedah,421,51,370,Vietnam
87397,6/1/2024,VNM,Kelantan,15,7,8,Vietnam
87398,6/1/2024,VNM,Melaka,1,1,0,Vietnam
87399,6/1/2024,VNM,Pahang,1,0,1,Vietnam
87400,6/1/2024,VNM,Perak,83,7,76,Vietnam
87401,6/1/2024,VNM,Perlis,301,23,278,Vietnam
87402,6/1/2024,VNM,Pulau Pinang,1886,573,1313,Vietnam
87403,6/1/2024,VNM,Sabah,24,4,20,Vietnam
87404,6/1/2024,VNM,Sarawak,296,44,252,Vietnam
87405,6/1/2024,VNM,Selangor,18665,6462,12203,Vietnam
87406,6/1/2024,VNM,W.P. Labuan,3,0,3,Vietnam
87407,6/1/2024,VUT,Johor,40,32,8,Vanuatu
87408,6/1/2024,VUT,Pulau Pinang,10,7,3,Vanuatu
87409,6/1/2024,VUT,Sabah,2,1,1,Vanuatu
87410,6/1/2024,VUT,Selangor,118,103,15,Vanuatu
87411,6/1/2024,WSM,Selangor,2,2,0,Samoa
87412,6/1/2024,YEM,Johor,57,36,21,Yemen
87413,6/1/2024,YEM,Kedah,7,5,2,Yemen
87414,6/1/2024,YEM,Melaka,1,1,0,Yemen
87415,6/1/2024,YEM,Perlis,5,5,0,Yemen
87416,6/1/2024,YEM,Pulau Pinang,10,6,4,Yemen
87417,6/1/2024,YEM,Sabah,1,1,0,Yemen
87418,6/1/2024,YEM,Sarawak,3,2,1,Yemen
87419,6/1/2024,YEM,Selangor,1731,1065,666,Yemen
87420,6/1/2024,ZAF,Johor,404,230,174,South Africa
87421,6/1/2024,ZAF,Kedah,61,30,31,South Africa
87422,6/1/2024,ZAF,Pahang,9,5,4,South Africa
87423,6/1/2024,ZAF,Perak,2,1,1,South Africa
87424,6/1/2024,ZAF,Perlis,25,15,10,South Africa
87425,6/1/2024,ZAF,Pulau Pinang,84,43,41,South Africa
87426,6/1/2024,ZAF,Sabah,27,16,11,South Africa
87427,6/1/2024,ZAF,Sarawak,88,39,49,South Africa
87428,6/1/2024,ZAF,Selangor,1178,637,541,South Africa
87429,6/1/2024,ZAF,W.P. Labuan,3,1,2,South Africa
87430,6/1/2024,ZMB,Johor,6,5,1,Zambia
87431,6/1/2024,ZMB,Pulau Pinang,1,1,0,Zambia
87432,6/1/2024,ZMB,Selangor,70,33,37,Zambia
87433,6/1/2024,ZWE,Johor,14,8,6,Zimbabwe
87434,6/1/2024,ZWE,Pulau Pinang,3,1,2,Zimbabwe
87435,6/1/2024,ZWE,Selangor,164,82,82,Zimbabwe
